description	bettype	pattern	bet_kumiban	betcnt	hitcnt	betamt	hitamt	incomeamt	hitrate	incomerate	daily_betamt	daily_hitamt	daily_incomeamt
0024	1T	nopattern	1	67548	38697	6754800	6207670	-547130	0.57	0.92	11955	10987	-968
0024	1T	nopattern	2	5710	2196	571000	509820	-61180	0.38	0.89	1010	902	-108
0024	2F	nopattern	12	38199	12407	3819900	3229250	-590650	0.32	0.85	6760	5715	-1045
0024	2F	nopattern	13	15829	4871	1582900	1256110	-326790	0.31	0.79	2801	2223	-578
0024	2F	nopattern	14	8619	2361	861900	668570	-193330	0.27	0.78	1525	1183	-342
0024	2F	nopattern	15	2234	500	223400	205920	-17480	0.22	0.92	395	364	-31
0024	2F	nopattern	16	1719	333	171900	166410	-5490	0.19	0.97	304	294	-10
0024	2F	nopattern	23	316	66	31600	24520	-7080	0.21	0.78	55	43	-12
0024	2F	nopattern	24	283	54	28300	18960	-9340	0.19	0.67	50	33	-17
0024	2F	nopattern	25	252	39	25200	15960	-9240	0.15	0.63	44	28	-16
0024	2F	nopattern	26	339	61	33900	33170	-730	0.18	0.98	60	58	-2
0024	2T	nopattern	12	38152	9292	3815200	3109990	-705210	0.24	0.82	6752	5504	-1248
0024	2T	nopattern	13	15829	3535	1582900	1233240	-349660	0.22	0.78	2801	2182	-619
0024	2T	nopattern	14	8619	1696	861900	685420	-176480	0.20	0.80	1525	1213	-312
0024	2T	nopattern	15	2234	343	223400	207730	-15670	0.15	0.93	395	367	-28
0024	2T	nopattern	16	1719	238	171900	177340	5440	0.14	1.03	304	313	9
0024	2T	nopattern	21	47	3	4700	3380	-1320	0.06	0.72	8	5	-3
0024	2T	nopattern	23	316	38	31600	24900	-6700	0.12	0.79	55	44	-11
0024	2T	nopattern	24	283	26	28300	15710	-12590	0.09	0.56	50	27	-23
0024	2T	nopattern	25	252	28	25200	17800	-7400	0.11	0.71	44	31	-13
0024	2T	nopattern	26	339	37	33900	31390	-2510	0.11	0.93	60	55	-5
0024	3F	nopattern	123	9610	2520	961000	769610	-191390	0.26	0.80	1700	1362	-338
0024	3F	nopattern	124	15772	3293	1577200	1182350	-394850	0.21	0.75	2791	2092	-699
0024	3F	nopattern	125	6037	1075	603700	497330	-106370	0.18	0.82	1068	880	-188
0024	3F	nopattern	126	5377	773	537700	454760	-82940	0.14	0.85	951	804	-147
0024	3F	nopattern	134	5052	1137	505200	383500	-121700	0.23	0.76	894	678	-216
0024	3F	nopattern	135	3401	639	340100	238850	-101250	0.19	0.70	601	422	-179
0024	3F	nopattern	136	3327	526	332700	262620	-70080	0.16	0.79	588	464	-124
0024	3F	nopattern	145	1387	264	138700	111840	-26860	0.19	0.81	245	197	-48
0024	3F	nopattern	146	1176	151	117600	79140	-38460	0.13	0.67	208	140	-68
0024	3F	nopattern	156	392	57	39200	38820	-380	0.15	0.99	69	68	-1
0024	3F	nopattern	234	65	11	6500	5510	-990	0.17	0.85	11	9	-2
0024	3F	nopattern	235	62	10	6200	3300	-2900	0.16	0.53	10	5	-5
0024	3F	nopattern	236	98	14	9800	10470	670	0.14	1.07	17	18	1
0024	3F	nopattern	245	47	6	4700	2110	-2590	0.13	0.45	8	3	-5
0024	3F	nopattern	246	65	4	6500	1220	-5280	0.06	0.19	11	2	-9
0024	3F	nopattern	256	43	6	4300	2230	-2070	0.14	0.52	7	3	-4
0024	3T	nopattern	123	9372	1085	937200	783220	-153980	0.12	0.84	1658	1386	-272
0024	3T	nopattern	124	15662	1368	1566200	1182210	-383990	0.09	0.75	2772	2092	-680
0024	3T	nopattern	125	6027	450	602700	529140	-73560	0.07	0.88	1066	936	-130
0024	3T	nopattern	126	5331	305	533100	457350	-75750	0.06	0.86	943	809	-134
0024	3T	nopattern	132	237	25	23700	17100	-6600	0.11	0.72	41	30	-11
0024	3T	nopattern	134	4940	489	494000	402750	-91250	0.10	0.82	874	712	-162
0024	3T	nopattern	135	3368	255	336800	248140	-88660	0.08	0.74	596	439	-157
0024	3T	nopattern	136	3306	220	330600	272570	-58030	0.07	0.82	585	482	-103
0024	3T	nopattern	142	100	5	10000	6500	-3500	0.05	0.65	17	11	-6
0024	3T	nopattern	143	112	8	11200	13300	2100	0.07	1.19	19	23	4
0024	3T	nopattern	145	1372	94	137200	127200	-10000	0.07	0.93	242	225	-17
0024	3T	nopattern	146	1148	55	114800	74970	-39830	0.05	0.65	203	132	-71
0024	3T	nopattern	152	10	1	1000	1160	160	0.10	1.16	1	2	1
0024	3T	nopattern	153	33	4	3300	6260	2960	0.12	1.90	5	11	6
0024	3T	nopattern	154	15	3	1500	4590	3090	0.20	3.06	2	8	6
0024	3T	nopattern	156	368	17	36800	30150	-6650	0.05	0.82	65	53	-12
0024	3T	nopattern	162	11	0	1100	0	-1100	0.00	0.00	1	0	-1
0024	3T	nopattern	163	21	3	2100	22080	19980	0.14	10.51	3	39	36
0024	3T	nopattern	164	28	1	2800	1700	-1100	0.04	0.61	4	3	-1
0024	3T	nopattern	165	24	0	2400	0	-2400	0.00	0.00	4	0	-4
0024	3T	nopattern	213	1	0	100	0	-100	0.00	0.00	0	0	0
0024	3T	nopattern	214	10	0	1000	0	-1000	0.00	0.00	1	0	-1
0024	3T	nopattern	216	35	2	3500	11500	8000	0.06	3.29	6	20	14
0024	3T	nopattern	234	64	2	6400	1710	-4690	0.03	0.27	11	3	-8
0024	3T	nopattern	235	57	2	5700	2210	-3490	0.04	0.39	10	3	-7
0024	3T	nopattern	236	96	5	9600	9130	-470	0.05	0.95	16	16	0
0024	3T	nopattern	243	1	0	100	0	-100	0.00	0.00	0	0	0
0024	3T	nopattern	245	44	2	4400	3010	-1390	0.05	0.68	7	5	-2
0024	3T	nopattern	246	62	1	6200	390	-5810	0.02	0.06	10	0	-10
0024	3T	nopattern	253	5	1	500	960	460	0.20	1.92	0	1	1
0024	3T	nopattern	254	3	0	300	0	-300	0.00	0.00	0	0	0
0024	3T	nopattern	256	39	2	3900	1440	-2460	0.05	0.37	6	2	-4
0024	3T	nopattern	263	2	0	200	0	-200	0.00	0.00	0	0	0
0024	3T	nopattern	264	3	0	300	0	-300	0.00	0.00	0	0	0
0024	3T	nopattern	265	4	0	400	0	-400	0.00	0.00	0	0	0
0037	1T	nopattern	1	67030	38572	6703000	6161870	-541130	0.58	0.92	11863	10905	-958
0037	1T	nopattern	2	5878	2318	587800	542810	-44990	0.39	0.92	1040	960	-80
0037	2F	nopattern	12	38547	12502	3854700	3263120	-591580	0.32	0.85	6822	5775	-1047
0037	2F	nopattern	13	15622	4848	1562200	1248500	-313700	0.31	0.80	2764	2209	-555
0037	2F	nopattern	14	8338	2295	833800	627900	-205900	0.28	0.75	1475	1111	-364
0037	2F	nopattern	15	1906	414	190600	152550	-38050	0.22	0.80	337	270	-67
0037	2F	nopattern	16	1667	316	166700	148670	-18030	0.19	0.89	295	263	-32
0037	2F	nopattern	23	369	75	36900	24980	-11920	0.20	0.68	65	44	-21
0037	2F	nopattern	24	325	67	32500	27410	-5090	0.21	0.84	57	48	-9
0037	2F	nopattern	25	263	39	26300	15580	-10720	0.15	0.59	46	27	-19
0037	2F	nopattern	26	361	57	36100	26850	-9250	0.16	0.74	63	47	-16
0037	2T	nopattern	12	38463	9347	3846300	3127070	-719230	0.24	0.81	6807	5534	-1273
0037	2T	nopattern	13	15622	3467	1562200	1196970	-365230	0.22	0.77	2764	2118	-646
0037	2T	nopattern	14	8338	1650	833800	646690	-187110	0.20	0.78	1475	1144	-331
0037	2T	nopattern	15	1906	282	190600	149640	-40960	0.15	0.79	337	264	-73
0037	2T	nopattern	16	1667	218	166700	151060	-15640	0.13	0.91	295	267	-28
0037	2T	nopattern	21	84	10	8400	9740	1340	0.12	1.16	14	17	3
0037	2T	nopattern	23	369	33	36900	19390	-17510	0.09	0.53	65	34	-31
0037	2T	nopattern	24	325	44	32500	29190	-3310	0.14	0.90	57	51	-6
0037	2T	nopattern	25	263	23	26300	16040	-10260	0.09	0.61	46	28	-18
0037	2T	nopattern	26	361	31	36100	25750	-10350	0.09	0.71	63	45	-18
0037	3F	nopattern	123	9324	2354	932400	762210	-170190	0.25	0.82	1650	1349	-301
0037	3F	nopattern	124	16244	3340	1624400	1245790	-378610	0.21	0.77	2875	2204	-671
0037	3F	nopattern	125	6075	1071	607500	497080	-110420	0.18	0.82	1075	879	-196
0037	3F	nopattern	126	5487	737	548700	451530	-97170	0.13	0.82	971	799	-172
0037	3F	nopattern	134	6244	1366	624400	493140	-131260	0.22	0.79	1105	872	-233
0037	3F	nopattern	135	3234	616	323400	234730	-88670	0.19	0.73	572	415	-157
0037	3F	nopattern	136	3149	457	314900	243800	-71100	0.15	0.77	557	431	-126
0037	3F	nopattern	145	1290	233	129000	90410	-38590	0.18	0.70	228	160	-68
0037	3F	nopattern	146	1160	167	116000	86480	-29520	0.14	0.75	205	153	-52
0037	3F	nopattern	156	348	60	34800	32700	-2100	0.17	0.94	61	57	-4
0037	3F	nopattern	234	108	22	10800	8040	-2760	0.20	0.74	19	14	-5
0037	3F	nopattern	235	67	21	6700	6900	200	0.31	1.03	11	12	1
0037	3F	nopattern	236	115	14	11500	8270	-3230	0.12	0.72	20	14	-6
0037	3F	nopattern	245	46	3	4600	970	-3630	0.07	0.21	8	1	-7
0037	3F	nopattern	246	77	8	7700	2640	-5060	0.10	0.34	13	4	-9
0037	3F	nopattern	256	48	10	4800	5640	840	0.21	1.18	8	9	1
0037	3T	nopattern	123	9211	1047	921100	783910	-137190	0.11	0.85	1630	1387	-243
0037	3T	nopattern	124	16171	1411	1617100	1219640	-397460	0.09	0.75	2862	2158	-704
0037	3T	nopattern	125	6052	442	605200	540470	-64730	0.07	0.89	1071	956	-115
0037	3T	nopattern	126	5420	278	542000	415720	-126280	0.05	0.77	959	735	-224
0037	3T	nopattern	132	112	9	11200	8000	-3200	0.08	0.71	19	14	-5
0037	3T	nopattern	134	6188	590	618800	500300	-118500	0.10	0.81	1095	885	-210
0037	3T	nopattern	135	3195	249	319500	234870	-84630	0.08	0.74	565	415	-150
0037	3T	nopattern	136	3125	186	312500	236350	-76150	0.06	0.76	553	418	-135
0037	3T	nopattern	142	56	2	5600	5540	-60	0.04	0.99	9	9	0
0037	3T	nopattern	143	56	6	5600	13200	7600	0.11	2.36	9	23	14
0037	3T	nopattern	145	1256	65	125600	72620	-52980	0.05	0.58	222	128	-94
0037	3T	nopattern	146	1136	56	113600	74080	-39520	0.05	0.65	201	131	-70
0037	3T	nopattern	152	16	0	1600	0	-1600	0.00	0.00	2	0	-2
0037	3T	nopattern	153	39	1	3900	1420	-2480	0.03	0.36	6	2	-4
0037	3T	nopattern	154	34	0	3400	0	-3400	0.00	0.00	6	0	-6
0037	3T	nopattern	156	341	19	34100	32400	-1700	0.06	0.95	60	57	-3
0037	3T	nopattern	162	11	1	1100	1030	-70	0.09	0.94	1	1	0
0037	3T	nopattern	163	24	1	2400	2880	480	0.04	1.20	4	5	1
0037	3T	nopattern	164	24	1	2400	1700	-700	0.04	0.71	4	3	-1
0037	3T	nopattern	165	7	0	700	0	-700	0.00	0.00	1	0	-1
0037	3T	nopattern	213	1	0	100	0	-100	0.00	0.00	0	0	0
0037	3T	nopattern	214	17	1	1700	1250	-450	0.06	0.74	3	2	-1
0037	3T	nopattern	215	7	0	700	0	-700	0.00	0.00	1	0	-1
0037	3T	nopattern	216	56	3	5600	15750	10150	0.05	2.81	9	27	18
0037	3T	nopattern	234	108	3	10800	2950	-7850	0.03	0.27	19	5	-14
0037	3T	nopattern	235	60	5	6000	9310	3310	0.08	1.55	10	16	6
0037	3T	nopattern	236	114	4	11400	7520	-3880	0.04	0.66	20	13	-7
0037	3T	nopattern	245	44	1	4400	860	-3540	0.02	0.20	7	1	-6
0037	3T	nopattern	246	74	2	7400	1580	-5820	0.03	0.21	13	2	-11
0037	3T	nopattern	253	7	1	700	960	260	0.14	1.37	1	1	0
0037	3T	nopattern	254	2	0	200	0	-200	0.00	0.00	0	0	0
0037	3T	nopattern	256	48	3	4800	6960	2160	0.06	1.45	8	12	4
0037	3T	nopattern	263	1	0	100	0	-100	0.00	0.00	0	0	0
0037	3T	nopattern	264	3	0	300	0	-300	0.00	0.00	0	0	0
0025	1T	01	1	2564	1476	256400	231310	-25090	0.58	0.90	453	409	-44
0025	1T	01	2	249	84	24900	21400	-3500	0.34	0.86	44	37	-7
0025	1T	02	1	2564	1248	256400	225290	-31110	0.49	0.88	453	398	-55
0025	1T	02	2	350	122	35000	26410	-8590	0.35	0.75	61	46	-15
0025	1T	03	1	1908	964	190800	181120	-9680	0.51	0.95	337	320	-17
0025	1T	03	2	277	93	27700	21110	-6590	0.34	0.76	49	37	-12
0025	1T	04	1	2237	1127	223700	201630	-22070	0.50	0.90	395	356	-39
0025	1T	04	2	267	89	26700	21820	-4880	0.33	0.82	47	38	-9
0025	1T	05	1	2577	1496	257700	248270	-9430	0.58	0.96	456	439	-17
0025	1T	05	2	372	135	37200	33550	-3650	0.36	0.90	65	59	-6
0025	1T	06	1	2829	1507	282900	250470	-32430	0.53	0.89	500	443	-57
0025	1T	06	2	357	137	35700	33800	-1900	0.38	0.95	63	59	-4
0025	1T	07	1	2943	1737	294300	281850	-12450	0.59	0.96	520	498	-22
0025	1T	07	2	296	106	29600	25760	-3840	0.36	0.87	52	45	-7
0025	1T	08	1	2842	1697	284200	266380	-17820	0.60	0.94	503	471	-32
0025	1T	08	2	239	83	23900	21060	-2840	0.35	0.88	42	37	-5
0025	1T	09	1	2899	1783	289900	277760	-12140	0.62	0.96	513	491	-22
0025	1T	09	2	326	135	32600	28290	-4310	0.41	0.87	57	50	-7
0025	1T	10	1	2656	1539	265600	237850	-27750	0.58	0.90	470	420	-50
0025	1T	10	2	325	131	32500	29840	-2660	0.40	0.92	57	52	-5
0025	1T	11	1	2337	1272	233700	206890	-26810	0.54	0.89	413	366	-47
0025	1T	11	2	362	123	36200	32840	-3360	0.34	0.91	64	58	-6
0025	1T	12	1	2597	1547	259700	237140	-22560	0.60	0.91	459	419	-40
0025	1T	12	2	244	98	24400	24110	-290	0.40	0.99	43	42	-1
0025	1T	13	1	2499	1526	249900	231510	-18390	0.61	0.93	442	409	-33
0025	1T	13	2	271	95	27100	22150	-4950	0.35	0.82	47	39	-8
0025	1T	14	1	2404	1270	240400	208530	-31870	0.53	0.87	425	369	-56
0025	1T	14	2	298	115	29800	27390	-2410	0.39	0.92	52	48	-4
0025	1T	15	1	2926	1648	292600	258630	-33970	0.56	0.88	517	457	-60
0025	1T	15	2	274	96	27400	23550	-3850	0.35	0.86	48	41	-7
0025	1T	16	1	2984	1783	298400	274190	-24210	0.60	0.92	528	485	-43
0025	1T	16	2	281	94	28100	24620	-3480	0.33	0.88	49	43	-6
0025	1T	17	1	2879	1730	287900	276800	-11100	0.60	0.96	509	489	-20
0025	1T	17	2	292	124	29200	28530	-670	0.42	0.98	51	50	-1
0025	1T	18	1	3040	2097	304000	289030	-14970	0.69	0.95	538	511	-27
0025	1T	18	2	343	148	34300	30010	-4290	0.43	0.87	60	53	-7
0025	1T	19	1	2624	1595	262400	237860	-24540	0.61	0.91	464	420	-44
0025	1T	19	2	249	91	24900	22920	-1980	0.37	0.92	44	40	-4
0025	1T	20	1	2938	1679	293800	266780	-27020	0.57	0.91	520	472	-48
0025	1T	20	2	154	61	15400	14800	-600	0.40	0.96	27	26	-1
0025	1T	21	1	3081	1958	308100	279100	-29000	0.64	0.91	545	493	-52
0025	1T	21	2	129	56	12900	12860	-40	0.43	1.00	22	22	0
0025	1T	22	1	2357	1361	235700	222430	-13270	0.58	0.94	417	393	-24
0025	1T	22	2	344	113	34400	26980	-7420	0.33	0.78	60	47	-13
0025	1T	23	1	2647	1543	264700	247690	-17010	0.58	0.94	468	438	-30
0025	1T	23	2	231	82	23100	18510	-4590	0.35	0.80	40	32	-8
0025	1T	24	1	2907	2058	290700	281180	-9520	0.71	0.97	514	497	-17
0025	1T	24	2	184	81	18400	19380	980	0.44	1.05	32	34	2
0025	2F	01	12	1682	498	168200	132810	-35390	0.30	0.79	297	235	-62
0025	2F	01	13	340	109	34000	28500	-5500	0.32	0.84	60	50	-10
0025	2F	01	14	191	53	19100	15220	-3880	0.28	0.80	33	26	-7
0025	2F	01	15	244	76	24400	19360	-5040	0.31	0.79	43	34	-9
0025	2F	01	16	13	1	1300	130	-1170	0.08	0.10	2	0	-2
0025	2F	01	23	25	5	2500	1760	-740	0.20	0.70	4	3	-1
0025	2F	01	24	14	3	1400	2300	900	0.21	1.64	2	4	2
0025	2F	01	25	8	1	800	300	-500	0.13	0.38	1	0	-1
0025	2F	01	26	8	2	800	960	160	0.25	1.20	1	1	0
0025	2F	02	12	1592	431	159200	135060	-24140	0.27	0.85	281	239	-42
0025	2F	02	13	539	140	53900	44190	-9710	0.26	0.82	95	78	-17
0025	2F	02	14	243	64	24300	21530	-2770	0.26	0.89	43	38	-5
0025	2F	02	15	65	10	6500	4320	-2180	0.15	0.66	11	7	-4
0025	2F	02	16	27	1	2700	230	-2470	0.04	0.09	4	0	-4
0025	2F	02	23	60	17	6000	6940	940	0.28	1.16	10	12	2
0025	2F	02	24	12	0	1200	0	-1200	0.00	0.00	2	0	-2
0025	2F	02	25	10	3	1000	1220	220	0.30	1.22	1	2	1
0025	2F	02	26	1	0	100	0	-100	0.00	0.00	0	0	0
0025	2F	03	12	1038	338	103800	90630	-13170	0.33	0.87	183	160	-23
0025	2F	03	13	419	117	41900	36150	-5750	0.28	0.86	74	63	-11
0025	2F	03	14	221	47	22100	14440	-7660	0.21	0.65	39	25	-14
0025	2F	03	15	107	19	10700	10090	-610	0.18	0.94	18	17	-1
0025	2F	03	16	51	11	5100	8010	2910	0.22	1.57	9	14	5
0025	2F	03	23	32	6	3200	2000	-1200	0.19	0.63	5	3	-2
0025	2F	03	24	12	3	1200	1530	330	0.25	1.28	2	2	0
0025	2F	03	25	18	7	1800	2140	340	0.39	1.19	3	3	0
0025	2F	03	26	7	1	700	290	-410	0.14	0.41	1	0	-1
0025	2F	04	12	1198	350	119800	113170	-6630	0.29	0.94	212	200	-12
0025	2F	04	13	573	157	57300	46440	-10860	0.27	0.81	101	82	-19
0025	2F	04	14	230	45	23000	14550	-8450	0.20	0.63	40	25	-15
0025	2F	04	15	112	23	11200	10870	-330	0.21	0.97	19	19	0
0025	2F	04	16	86	20	8600	9430	830	0.23	1.10	15	16	1
0025	2F	04	23	27	8	2700	2740	40	0.30	1.01	4	4	0
0025	2F	04	24	12	2	1200	600	-600	0.17	0.50	2	1	-1
0025	2F	04	25	10	1	1000	720	-280	0.10	0.72	1	1	0
0025	2F	04	26	14	1	1400	310	-1090	0.07	0.22	2	0	-2
0025	2F	05	12	1453	450	145300	130450	-14850	0.31	0.90	257	230	-27
0025	2F	05	13	556	158	55600	45230	-10370	0.28	0.81	98	80	-18
0025	2F	05	14	366	110	36600	27560	-9040	0.30	0.75	64	48	-16
0025	2F	05	15	96	17	9600	5730	-3870	0.18	0.60	16	10	-6
0025	2F	05	16	42	8	4200	5760	1560	0.19	1.37	7	10	3
0025	2F	05	23	42	11	4200	2920	-1280	0.26	0.70	7	5	-2
0025	2F	05	24	18	2	1800	570	-1230	0.11	0.32	3	1	-2
0025	2F	05	25	18	4	1800	1500	-300	0.22	0.83	3	2	-1
0025	2F	05	26	12	1	1200	240	-960	0.08	0.20	2	0	-2
0025	2F	06	12	1539	478	153900	142960	-10940	0.31	0.93	272	253	-19
0025	2F	06	13	656	179	65600	47670	-17930	0.27	0.73	116	84	-32
0025	2F	06	14	349	88	34900	32450	-2450	0.25	0.93	61	57	-4
0025	2F	06	15	110	28	11000	9730	-1270	0.25	0.88	19	17	-2
0025	2F	06	16	78	19	7800	8500	700	0.24	1.09	13	15	2
0025	2F	06	23	27	4	2700	1060	-1640	0.15	0.39	4	1	-3
0025	2F	06	24	11	2	1100	990	-110	0.18	0.90	1	1	0
0025	2F	06	25	20	2	2000	1400	-600	0.10	0.70	3	2	-1
0025	2F	06	26	13	2	1300	990	-310	0.15	0.76	2	1	-1
0025	2F	07	12	1574	470	157400	132330	-25070	0.30	0.84	278	234	-44
0025	2F	07	13	707	242	70700	62020	-8680	0.34	0.88	125	109	-16
0025	2F	07	14	386	109	38600	29570	-9030	0.28	0.77	68	52	-16
0025	2F	07	15	125	21	12500	6930	-5570	0.17	0.55	22	12	-10
0025	2F	07	16	70	14	7000	5330	-1670	0.20	0.76	12	9	-3
0025	2F	07	23	21	4	2100	1260	-840	0.19	0.60	3	2	-1
0025	2F	07	24	8	1	800	310	-490	0.13	0.39	1	0	-1
0025	2F	07	25	21	1	2100	550	-1550	0.05	0.26	3	0	-3
0025	2F	07	26	10	2	1000	670	-330	0.20	0.67	1	1	0
0025	2F	08	12	1540	497	154000	129720	-24280	0.32	0.84	272	229	-43
0025	2F	08	13	633	189	63300	47920	-15380	0.30	0.76	112	84	-28
0025	2F	08	14	352	89	35200	24720	-10480	0.25	0.70	62	43	-19
0025	2F	08	15	120	30	12000	10790	-1210	0.25	0.90	21	19	-2
0025	2F	08	16	114	23	11400	8480	-2920	0.20	0.74	20	15	-5
0025	2F	08	23	19	0	1900	0	-1900	0.00	0.00	3	0	-3
0025	2F	08	24	8	2	800	500	-300	0.25	0.63	1	0	-1
0025	2F	08	25	9	2	900	810	-90	0.22	0.90	1	1	0
0025	2F	08	26	15	3	1500	1980	480	0.20	1.32	2	3	1
0025	2F	09	12	1801	632	180100	155120	-24980	0.35	0.86	318	274	-44
0025	2F	09	13	650	197	65000	53010	-11990	0.30	0.82	115	93	-22
0025	2F	09	14	262	61	26200	17430	-8770	0.23	0.67	46	30	-16
0025	2F	09	15	67	7	6700	2600	-4100	0.10	0.39	11	4	-7
0025	2F	09	16	70	13	7000	6260	-740	0.19	0.89	12	11	-1
0025	2F	09	23	25	8	2500	3300	800	0.32	1.32	4	5	1
0025	2F	09	24	5	1	500	300	-200	0.20	0.60	0	0	0
0025	2F	09	25	11	0	1100	0	-1100	0.00	0.00	1	0	-1
0025	2F	09	26	28	5	2800	7100	4300	0.18	2.54	4	12	8
0025	2F	10	12	1521	573	152100	130320	-21780	0.38	0.86	269	230	-39
0025	2F	10	13	710	236	71000	55780	-15220	0.33	0.79	125	98	-27
0025	2F	10	14	287	89	28700	24880	-3820	0.31	0.87	50	44	-6
0025	2F	10	15	63	12	6300	5110	-1190	0.19	0.81	11	9	-2
0025	2F	10	16	65	11	6500	6480	-20	0.17	1.00	11	11	0
0025	2F	10	23	23	5	2300	1650	-650	0.22	0.72	4	2	-2
0025	2F	10	24	17	4	1700	1320	-380	0.24	0.78	3	2	-1
0025	2F	10	25	16	2	1600	640	-960	0.13	0.40	2	1	-1
0025	2F	10	26	24	8	2400	3160	760	0.33	1.32	4	5	1
0025	2F	11	12	1648	565	164800	157170	-7630	0.34	0.95	291	278	-13
0025	2F	11	13	488	136	48800	37960	-10840	0.28	0.78	86	67	-19
0025	2F	11	14	129	29	12900	9140	-3760	0.22	0.71	22	16	-6
0025	2F	11	15	32	5	3200	3390	190	0.16	1.06	5	6	1
0025	2F	11	16	19	4	1900	2190	290	0.21	1.15	3	3	0
0025	2F	11	23	102	20	10200	11220	1020	0.20	1.10	18	19	1
0025	2F	11	24	6	0	600	0	-600	0.00	0.00	1	0	-1
0025	2F	11	25	11	1	1100	290	-810	0.09	0.26	1	0	-1
0025	2F	11	26	1	1	100	420	320	1.00	4.20	0	0	0
0025	2F	12	12	1676	536	167600	139470	-28130	0.32	0.83	296	246	-50
0025	2F	12	13	440	132	44000	34560	-9440	0.30	0.79	77	61	-16
0025	2F	12	14	230	58	23000	18420	-4580	0.25	0.80	40	32	-8
0025	2F	12	15	124	25	12400	9540	-2860	0.20	0.77	21	16	-5
0025	2F	12	16	62	13	6200	2990	-3210	0.21	0.48	10	5	-5
0025	2F	12	23	32	10	3200	2210	-990	0.31	0.69	5	3	-2
0025	2F	12	24	18	2	1800	510	-1290	0.11	0.28	3	0	-3
0025	2F	12	25	6	1	600	610	10	0.17	1.02	1	1	0
0025	2F	12	26	4	0	400	0	-400	0.00	0.00	0	0	0
0025	2F	13	12	1393	469	139300	119020	-20280	0.34	0.85	246	210	-36
0025	2F	13	13	579	181	57900	45240	-12660	0.31	0.78	102	80	-22
0025	2F	13	14	325	113	32500	29220	-3280	0.35	0.90	57	51	-6
0025	2F	13	15	96	26	9600	8390	-1210	0.27	0.87	16	14	-2
0025	2F	13	16	48	12	4800	4230	-570	0.25	0.88	8	7	-1
0025	2F	13	23	26	10	2600	3190	590	0.38	1.23	4	5	1
0025	2F	13	24	8	0	800	0	-800	0.00	0.00	1	0	-1
0025	2F	13	25	14	0	1400	0	-1400	0.00	0.00	2	0	-2
0025	2F	13	26	9	0	900	0	-900	0.00	0.00	1	0	-1
0025	2F	14	12	1376	408	137600	109230	-28370	0.30	0.79	243	193	-50
0025	2F	14	13	502	128	50200	34900	-15300	0.25	0.70	88	61	-27
0025	2F	14	14	324	89	32400	22730	-9670	0.27	0.70	57	40	-17
0025	2F	14	15	88	15	8800	6360	-2440	0.17	0.72	15	11	-4
0025	2F	14	16	48	9	4800	3010	-1790	0.19	0.63	8	5	-3
0025	2F	14	23	33	9	3300	3490	190	0.27	1.06	5	6	1
0025	2F	14	24	18	2	1800	380	-1420	0.11	0.21	3	0	-3
0025	2F	14	25	10	1	1000	350	-650	0.10	0.35	1	0	-1
0025	2F	14	26	11	0	1100	0	-1100	0.00	0.00	1	0	-1
0025	2F	15	12	1680	518	168000	134110	-33890	0.31	0.80	297	237	-60
0025	2F	15	13	664	202	66400	50730	-15670	0.30	0.76	117	89	-28
0025	2F	15	14	329	100	32900	31230	-1670	0.30	0.95	58	55	-3
0025	2F	15	15	94	20	9400	8330	-1070	0.21	0.89	16	14	-2
0025	2F	15	16	68	21	6800	10410	3610	0.31	1.53	12	18	6
0025	2F	15	23	21	4	2100	2840	740	0.19	1.35	3	5	2
0025	2F	15	24	5	0	500	0	-500	0.00	0.00	0	0	0
0025	2F	15	25	9	1	900	300	-600	0.11	0.33	1	0	-1
0025	2F	15	26	13	2	1300	1220	-80	0.15	0.94	2	2	0
0025	2F	16	12	1706	578	170600	146240	-24360	0.34	0.86	301	258	-43
0025	2F	16	13	590	157	59000	40040	-18960	0.27	0.68	104	70	-34
0025	2F	16	14	447	155	44700	37770	-6930	0.35	0.84	79	66	-13
0025	2F	16	15	96	21	9600	9580	-20	0.22	1.00	16	16	0
0025	2F	16	16	65	10	6500	5680	-820	0.15	0.87	11	10	-1
0025	2F	16	23	21	5	2100	2330	230	0.24	1.11	3	4	1
0025	2F	16	24	12	2	1200	620	-580	0.17	0.52	2	1	-1
0025	2F	16	25	12	3	1200	990	-210	0.25	0.83	2	1	-1
0025	2F	16	26	15	1	1500	670	-830	0.07	0.45	2	1	-1
0025	2F	17	12	1672	518	167200	125040	-42160	0.31	0.75	295	221	-74
0025	2F	17	13	669	243	66900	57890	-9010	0.36	0.87	118	102	-16
0025	2F	17	14	352	89	35200	26000	-9200	0.25	0.74	62	46	-16
0025	2F	17	15	63	10	6300	3260	-3040	0.16	0.52	11	5	-6
0025	2F	17	16	34	1	3400	110	-3290	0.03	0.03	6	0	-6
0025	2F	17	23	19	3	1900	900	-1000	0.16	0.47	3	1	-2
0025	2F	17	24	14	3	1400	670	-730	0.21	0.48	2	1	-1
0025	2F	17	25	16	4	1600	1510	-90	0.25	0.94	2	2	0
0025	2F	17	26	7	1	700	650	-50	0.14	0.93	1	1	0
0025	2F	18	12	1797	716	179700	161810	-17890	0.40	0.90	318	286	-32
0025	2F	18	13	647	215	64700	58270	-6430	0.33	0.90	114	103	-11
0025	2F	18	14	365	106	36500	30950	-5550	0.29	0.85	64	54	-10
0025	2F	18	15	118	31	11800	14420	2620	0.26	1.22	20	25	5
0025	2F	18	16	80	17	8000	9660	1660	0.21	1.21	14	17	3
0025	2F	18	23	24	4	2400	2320	-80	0.17	0.97	4	4	0
0025	2F	18	24	11	3	1100	1160	60	0.27	1.05	1	2	1
0025	2F	18	25	12	0	1200	0	-1200	0.00	0.00	2	0	-2
0025	2F	18	26	20	5	2000	2760	760	0.25	1.38	3	4	1
0025	2F	19	12	1345	435	134500	112690	-21810	0.32	0.84	238	199	-39
0025	2F	19	13	663	232	66300	50510	-15790	0.35	0.76	117	89	-28
0025	2F	19	14	429	137	42900	32730	-10170	0.32	0.76	75	57	-18
0025	2F	19	15	49	8	4900	3340	-1560	0.16	0.68	8	5	-3
0025	2F	19	16	59	10	5900	5320	-580	0.17	0.90	10	9	-1
0025	2F	19	23	18	3	1800	1290	-510	0.17	0.72	3	2	-1
0025	2F	19	24	8	0	800	0	-800	0.00	0.00	1	0	-1
0025	2F	19	25	4	0	400	0	-400	0.00	0.00	0	0	0
0025	2F	19	26	18	5	1800	2720	920	0.28	1.51	3	4	1
0025	2F	20	12	1623	555	162300	133580	-28720	0.34	0.82	287	236	-51
0025	2F	20	13	681	235	68100	58790	-9310	0.35	0.86	120	104	-16
0025	2F	20	14	367	111	36700	29830	-6870	0.30	0.81	64	52	-12
0025	2F	20	15	113	29	11300	9930	-1370	0.26	0.88	20	17	-3
0025	2F	20	16	92	21	9200	8050	-1150	0.23	0.88	16	14	-2
0025	2F	20	23	10	2	1000	1050	50	0.20	1.05	1	1	0
0025	2F	20	24	6	4	600	1560	960	0.67	2.60	1	2	1
0025	2F	20	25	5	0	500	0	-500	0.00	0.00	0	0	0
0025	2F	20	26	7	1	700	240	-460	0.14	0.34	1	0	-1
0025	2F	21	12	1716	578	171600	133860	-37740	0.34	0.78	303	236	-67
0025	2F	21	13	794	309	79400	70420	-8980	0.39	0.89	140	124	-16
0025	2F	21	14	444	169	44400	35800	-8600	0.38	0.81	78	63	-15
0025	2F	21	15	61	12	6100	4240	-1860	0.20	0.70	10	7	-3
0025	2F	21	16	31	4	3100	3240	140	0.13	1.05	5	5	0
0025	2F	21	23	6	2	600	420	-180	0.33	0.70	1	0	-1
0025	2F	21	24	4	0	400	0	-400	0.00	0.00	0	0	0
0025	2F	21	26	2	1	200	430	230	0.50	2.15	0	0	0
0025	2F	22	12	1440	505	144000	136600	-7400	0.35	0.95	254	241	-13
0025	2F	22	13	447	137	44700	35680	-9020	0.31	0.80	79	63	-16
0025	2F	22	14	289	74	28900	18920	-9980	0.26	0.65	51	33	-18
0025	2F	22	15	35	13	3500	4970	1470	0.37	1.42	6	8	2
0025	2F	22	16	18	3	1800	1660	-140	0.17	0.92	3	2	-1
0025	2F	22	23	31	6	3100	2280	-820	0.19	0.74	5	4	-1
0025	2F	22	24	7	1	700	110	-590	0.14	0.16	1	0	-1
0025	2F	22	25	6	0	600	0	-600	0.00	0.00	1	0	-1
0025	2F	22	26	3	1	300	320	20	0.33	1.07	0	0	0
0025	2F	23	12	1653	538	165300	134150	-31150	0.33	0.81	292	237	-55
0025	2F	23	13	568	199	56800	44200	-12600	0.35	0.78	100	78	-22
0025	2F	23	14	273	80	27300	21140	-6160	0.29	0.77	48	37	-11
0025	2F	23	15	74	20	7400	8920	1520	0.27	1.21	13	15	2
0025	2F	23	16	7	2	700	500	-200	0.29	0.71	1	0	-1
0025	2F	23	23	26	7	2600	3550	950	0.27	1.37	4	6	2
0025	2F	23	24	16	2	1600	870	-730	0.13	0.54	2	1	-1
0025	2F	23	25	13	4	1300	1810	510	0.31	1.39	2	3	1
0025	2F	23	26	2	0	200	0	-200	0.00	0.00	0	0	0
0025	2F	24	12	1709	588	170900	133040	-37860	0.34	0.78	302	235	-67
0025	2F	24	13	664	235	66400	53120	-13280	0.35	0.80	117	94	-23
0025	2F	24	14	307	96	30700	22750	-7950	0.31	0.74	54	40	-14
0025	2F	24	15	85	25	8500	8580	80	0.29	1.01	15	15	0
0025	2F	24	16	59	18	5900	4300	-1600	0.31	0.73	10	7	-3
0025	2F	24	23	20	3	2000	1260	-740	0.15	0.63	3	2	-1
0025	2F	24	24	9	5	900	2510	1610	0.56	2.79	1	4	3
0025	2F	24	25	1	0	100	0	-100	0.00	0.00	0	0	0
0025	2F	24	26	5	1	500	150	-350	0.20	0.30	0	0	0
0025	2T	01	12	1681	392	168100	134710	-33390	0.23	0.80	297	238	-59
0025	2T	01	13	340	73	34000	23270	-10730	0.21	0.68	60	41	-19
0025	2T	01	14	191	34	19100	13590	-5510	0.18	0.71	33	24	-9
0025	2T	01	15	244	54	24400	20130	-4270	0.22	0.83	43	35	-8
0025	2T	01	16	13	1	1300	210	-1090	0.08	0.16	2	0	-2
0025	2T	01	21	1	0	100	0	-100	0.00	0.00	0	0	0
0025	2T	01	23	25	3	2500	1630	-870	0.12	0.65	4	2	-2
0025	2T	01	24	14	0	1400	0	-1400	0.00	0.00	2	0	-2
0025	2T	01	25	8	0	800	0	-800	0.00	0.00	1	0	-1
0025	2T	01	26	8	1	800	730	-70	0.13	0.91	1	1	0
0025	2T	02	12	1592	322	159200	144040	-15160	0.20	0.90	281	254	-27
0025	2T	02	13	539	95	53900	41910	-11990	0.18	0.78	95	74	-21
0025	2T	02	14	243	39	24300	21580	-2720	0.16	0.89	43	38	-5
0025	2T	02	15	65	5	6500	4510	-1990	0.08	0.69	11	7	-4
0025	2T	02	16	27	1	2700	460	-2240	0.04	0.17	4	0	-4
0025	2T	02	23	60	9	6000	4670	-1330	0.15	0.78	10	8	-2
0025	2T	02	24	12	0	1200	0	-1200	0.00	0.00	2	0	-2
0025	2T	02	25	10	1	1000	670	-330	0.10	0.67	1	1	0
0025	2T	02	26	1	0	100	0	-100	0.00	0.00	0	0	0
0025	2T	03	12	1037	233	103700	94760	-8940	0.22	0.91	183	167	-16
0025	2T	03	13	419	90	41900	40250	-1650	0.21	0.96	74	71	-3
0025	2T	03	14	221	37	22100	15860	-6240	0.17	0.72	39	28	-11
0025	2T	03	15	107	13	10700	9960	-740	0.12	0.93	18	17	-1
0025	2T	03	16	51	7	5100	7130	2030	0.14	1.40	9	12	3
0025	2T	03	21	1	0	100	0	-100	0.00	0.00	0	0	0
0025	2T	03	23	32	5	3200	3270	70	0.16	1.02	5	5	0
0025	2T	03	24	12	2	1200	2040	840	0.17	1.70	2	3	1
0025	2T	03	25	18	5	1800	2500	700	0.28	1.39	3	4	1
0025	2T	03	26	7	1	700	610	-90	0.14	0.87	1	1	0
0025	2T	04	12	1197	236	119700	104240	-15460	0.20	0.87	211	184	-27
0025	2T	04	13	573	117	57300	47940	-9360	0.20	0.84	101	84	-17
0025	2T	04	14	230	34	23000	16440	-6560	0.15	0.71	40	29	-11
0025	2T	04	15	112	12	11200	7230	-3970	0.11	0.65	19	12	-7
0025	2T	04	16	86	16	8600	12320	3720	0.19	1.43	15	21	6
0025	2T	04	21	1	0	100	0	-100	0.00	0.00	0	0	0
0025	2T	04	23	27	4	2700	2300	-400	0.15	0.85	4	4	0
0025	2T	04	24	12	1	1200	400	-800	0.08	0.33	2	0	-2
0025	2T	04	25	10	0	1000	0	-1000	0.00	0.00	1	0	-1
0025	2T	04	26	14	0	1400	0	-1400	0.00	0.00	2	0	-2
0025	2T	05	12	1452	337	145200	136750	-8450	0.23	0.94	256	242	-14
0025	2T	05	13	556	109	55600	40820	-14780	0.20	0.73	98	72	-26
0025	2T	05	14	366	80	36600	31060	-5540	0.22	0.85	64	54	-10
0025	2T	05	15	96	13	9600	6700	-2900	0.14	0.70	16	11	-5
0025	2T	05	16	42	7	4200	10130	5930	0.17	2.41	7	17	10
0025	2T	05	21	1	0	100	0	-100	0.00	0.00	0	0	0
0025	2T	05	23	42	5	4200	2090	-2110	0.12	0.50	7	3	-4
0025	2T	05	24	18	1	1800	370	-1430	0.06	0.21	3	0	-3
0025	2T	05	25	18	3	1800	1760	-40	0.17	0.98	3	3	0
0025	2T	05	26	12	1	1200	400	-800	0.08	0.33	2	0	-2
0025	2T	06	12	1536	349	153600	140350	-13250	0.23	0.91	271	248	-23
0025	2T	06	13	656	119	65600	45530	-20070	0.18	0.69	116	80	-36
0025	2T	06	14	349	65	34900	33550	-1350	0.19	0.96	61	59	-2
0025	2T	06	15	110	15	11000	7800	-3200	0.14	0.71	19	13	-6
0025	2T	06	16	78	14	7800	10070	2270	0.18	1.29	13	17	4
0025	2T	06	21	3	0	300	0	-300	0.00	0.00	0	0	0
0025	2T	06	23	27	2	2700	830	-1870	0.07	0.31	4	1	-3
0025	2T	06	24	11	1	1100	290	-810	0.09	0.26	1	0	-1
0025	2T	06	25	20	1	2000	1520	-480	0.05	0.76	3	2	-1
0025	2T	06	26	13	1	1300	810	-490	0.08	0.62	2	1	-1
0025	2T	07	12	1573	358	157300	129800	-27500	0.23	0.83	278	229	-49
0025	2T	07	13	707	178	70700	62270	-8430	0.25	0.88	125	110	-15
0025	2T	07	14	386	84	38600	31580	-7020	0.22	0.82	68	55	-13
0025	2T	07	15	125	15	12500	6590	-5910	0.12	0.53	22	11	-11
0025	2T	07	16	70	9	7000	5650	-1350	0.13	0.81	12	10	-2
0025	2T	07	21	1	1	100	1060	960	1.00	10.60	0	1	1
0025	2T	07	23	21	2	2100	1010	-1090	0.10	0.48	3	1	-2
0025	2T	07	24	8	0	800	0	-800	0.00	0.00	1	0	-1
0025	2T	07	25	21	1	2100	480	-1620	0.05	0.23	3	0	-3
0025	2T	07	26	10	1	1000	240	-760	0.10	0.24	1	0	-1
0025	2T	08	12	1536	397	153600	130570	-23030	0.26	0.85	271	231	-40
0025	2T	08	13	633	133	63300	45230	-18070	0.21	0.71	112	80	-32
0025	2T	08	14	352	59	35200	24080	-11120	0.17	0.68	62	42	-20
0025	2T	08	15	120	21	12000	12080	80	0.18	1.01	21	21	0
0025	2T	08	16	114	17	11400	7830	-3570	0.15	0.69	20	13	-7
0025	2T	08	21	4	0	400	0	-400	0.00	0.00	0	0	0
0025	2T	08	23	19	0	1900	0	-1900	0.00	0.00	3	0	-3
0025	2T	08	24	8	1	800	480	-320	0.13	0.60	1	0	-1
0025	2T	08	25	9	2	900	1280	380	0.22	1.42	1	2	1
0025	2T	08	26	15	2	1500	2500	1000	0.13	1.67	2	4	2
0025	2T	09	12	1797	472	179700	142920	-36780	0.26	0.80	318	252	-66
0025	2T	09	13	650	145	65000	50760	-14240	0.22	0.78	115	89	-26
0025	2T	09	14	262	43	26200	17040	-9160	0.16	0.65	46	30	-16
0025	2T	09	15	67	3	6700	1360	-5340	0.04	0.20	11	2	-9
0025	2T	09	16	70	10	7000	8130	1130	0.14	1.16	12	14	2
0025	2T	09	21	4	0	400	0	-400	0.00	0.00	0	0	0
0025	2T	09	23	25	4	2500	2760	260	0.16	1.10	4	4	0
0025	2T	09	24	5	1	500	870	370	0.20	1.74	0	1	1
0025	2T	09	25	11	0	1100	0	-1100	0.00	0.00	1	0	-1
0025	2T	09	26	28	2	2800	6550	3750	0.07	2.34	4	11	7
0025	2T	10	12	1515	417	151500	121850	-29650	0.28	0.80	268	215	-53
0025	2T	10	13	710	167	71000	54340	-16660	0.24	0.77	125	96	-29
0025	2T	10	14	287	71	28700	27270	-1430	0.25	0.95	50	48	-2
0025	2T	10	15	63	8	6300	5700	-600	0.13	0.90	11	10	-1
0025	2T	10	16	65	6	6500	8490	1990	0.09	1.31	11	15	4
0025	2T	10	21	6	0	600	0	-600	0.00	0.00	1	0	-1
0025	2T	10	23	23	2	2300	790	-1510	0.09	0.34	4	1	-3
0025	2T	10	24	17	1	1700	540	-1160	0.06	0.32	3	0	-3
0025	2T	10	25	16	0	1600	0	-1600	0.00	0.00	2	0	-2
0025	2T	10	26	24	5	2400	2990	590	0.21	1.25	4	5	1
0025	2T	11	12	1640	392	164000	139420	-24580	0.24	0.85	290	246	-44
0025	2T	11	13	488	90	48800	35030	-13770	0.18	0.72	86	62	-24
0025	2T	11	14	129	16	12900	7230	-5670	0.12	0.56	22	12	-10
0025	2T	11	15	32	3	3200	2180	-1020	0.09	0.68	5	3	-2
0025	2T	11	16	19	2	1900	2530	630	0.11	1.33	3	4	1
0025	2T	11	21	8	1	800	1120	320	0.13	1.40	1	1	0
0025	2T	11	23	102	12	10200	7620	-2580	0.12	0.75	18	13	-5
0025	2T	11	24	6	0	600	0	-600	0.00	0.00	1	0	-1
0025	2T	11	25	11	1	1100	770	-330	0.09	0.70	1	1	0
0025	2T	11	26	1	0	100	0	-100	0.00	0.00	0	0	0
0025	2T	12	12	1673	413	167300	137350	-29950	0.25	0.82	296	243	-53
0025	2T	12	13	440	101	44000	35200	-8800	0.23	0.80	77	62	-15
0025	2T	12	14	230	44	23000	18710	-4290	0.19	0.81	40	33	-7
0025	2T	12	15	124	21	12400	11620	-780	0.17	0.94	21	20	-1
0025	2T	12	16	62	12	6200	3530	-2670	0.19	0.57	10	6	-4
0025	2T	12	21	3	0	300	0	-300	0.00	0.00	0	0	0
0025	2T	12	23	32	5	3200	2100	-1100	0.16	0.66	5	3	-2
0025	2T	12	24	18	2	1800	940	-860	0.11	0.52	3	1	-2
0025	2T	12	25	6	0	600	0	-600	0.00	0.00	1	0	-1
0025	2T	12	26	4	0	400	0	-400	0.00	0.00	0	0	0
0025	2T	13	12	1393	365	139300	116940	-22360	0.26	0.84	246	206	-40
0025	2T	13	13	579	118	57900	37110	-20790	0.20	0.64	102	65	-37
0025	2T	13	14	325	93	32500	32440	-60	0.29	1.00	57	57	0
0025	2T	13	15	96	20	9600	9810	210	0.21	1.02	16	17	1
0025	2T	13	16	48	7	4800	3740	-1060	0.15	0.78	8	6	-2
0025	2T	13	23	26	4	2600	2120	-480	0.15	0.82	4	3	-1
0025	2T	13	24	8	0	800	0	-800	0.00	0.00	1	0	-1
0025	2T	13	25	14	0	1400	0	-1400	0.00	0.00	2	0	-2
0025	2T	13	26	9	0	900	0	-900	0.00	0.00	1	0	-1
0025	2T	14	12	1373	279	137300	90100	-47200	0.20	0.66	243	159	-84
0025	2T	14	13	502	93	50200	33730	-16470	0.19	0.67	88	59	-29
0025	2T	14	14	324	67	32400	21330	-11070	0.21	0.66	57	37	-20
0025	2T	14	15	88	10	8800	6420	-2380	0.11	0.73	15	11	-4
0025	2T	14	16	48	4	4800	2120	-2680	0.08	0.44	8	3	-5
0025	2T	14	21	3	0	300	0	-300	0.00	0.00	0	0	0
0025	2T	14	23	33	5	3300	2840	-460	0.15	0.86	5	5	0
0025	2T	14	24	18	0	1800	0	-1800	0.00	0.00	3	0	-3
0025	2T	14	25	10	1	1000	420	-580	0.10	0.42	1	0	-1
0025	2T	14	26	11	0	1100	0	-1100	0.00	0.00	1	0	-1
0025	2T	15	12	1680	381	168000	122770	-45230	0.23	0.73	297	217	-80
0025	2T	15	13	664	144	66400	50940	-15460	0.22	0.77	117	90	-27
0025	2T	15	14	329	63	32900	26510	-6390	0.19	0.81	58	46	-12
0025	2T	15	15	94	11	9400	7930	-1470	0.12	0.84	16	14	-2
0025	2T	15	16	68	19	6800	13070	6270	0.28	1.92	12	23	11
0025	2T	15	23	21	2	2100	4360	2260	0.10	2.08	3	7	4
0025	2T	15	24	5	0	500	0	-500	0.00	0.00	0	0	0
0025	2T	15	25	9	1	900	630	-270	0.11	0.70	1	1	0
0025	2T	15	26	13	1	1300	1160	-140	0.08	0.89	2	2	0
0025	2T	16	12	1705	452	170500	142280	-28220	0.27	0.83	301	251	-50
0025	2T	16	13	590	114	59000	38160	-20840	0.19	0.65	104	67	-37
0025	2T	16	14	447	113	44700	38870	-5830	0.25	0.87	79	68	-11
0025	2T	16	15	96	16	9600	10310	710	0.17	1.07	16	18	2
0025	2T	16	16	65	7	6500	3530	-2970	0.11	0.54	11	6	-5
0025	2T	16	21	1	0	100	0	-100	0.00	0.00	0	0	0
0025	2T	16	23	21	4	2100	2670	570	0.19	1.27	3	4	1
0025	2T	16	24	12	2	1200	1160	-40	0.17	0.97	2	2	0
0025	2T	16	25	12	1	1200	490	-710	0.08	0.41	2	0	-2
0025	2T	16	26	15	0	1500	0	-1500	0.00	0.00	2	0	-2
0025	2T	17	12	1668	409	166800	124200	-42600	0.25	0.74	295	219	-76
0025	2T	17	13	669	191	66900	59740	-7160	0.29	0.89	118	105	-13
0025	2T	17	14	352	61	35200	23590	-11610	0.17	0.67	62	41	-21
0025	2T	17	15	63	7	6300	4020	-2280	0.11	0.64	11	7	-4
0025	2T	17	16	34	0	3400	0	-3400	0.00	0.00	6	0	-6
0025	2T	17	21	4	0	400	0	-400	0.00	0.00	0	0	0
0025	2T	17	23	19	3	1900	1190	-710	0.16	0.63	3	2	-1
0025	2T	17	24	14	2	1400	1040	-360	0.14	0.74	2	1	-1
0025	2T	17	25	16	3	1600	2300	700	0.19	1.44	2	4	2
0025	2T	17	26	7	1	700	1810	1110	0.14	2.59	1	3	2
0025	2T	18	12	1796	579	179600	159670	-19930	0.32	0.89	317	282	-35
0025	2T	18	13	647	167	64700	56140	-8560	0.26	0.87	114	99	-15
0025	2T	18	14	365	90	36500	31350	-5150	0.25	0.86	64	55	-9
0025	2T	18	15	118	27	11800	14240	2440	0.23	1.21	20	25	5
0025	2T	18	16	80	13	8000	10270	2270	0.16	1.28	14	18	4
0025	2T	18	21	1	1	100	420	320	1.00	4.20	0	0	0
0025	2T	18	23	24	4	2400	4610	2210	0.17	1.92	4	8	4
0025	2T	18	24	11	2	1100	1070	-30	0.18	0.97	1	1	0
0025	2T	18	25	12	0	1200	0	-1200	0.00	0.00	2	0	-2
0025	2T	18	26	20	4	2000	2890	890	0.20	1.45	3	5	2
0025	2T	19	12	1340	329	134000	103670	-30330	0.25	0.77	237	183	-54
0025	2T	19	13	663	160	66300	49000	-17300	0.24	0.74	117	86	-31
0025	2T	19	14	429	107	42900	35320	-7580	0.25	0.82	75	62	-13
0025	2T	19	15	49	3	4900	1730	-3170	0.06	0.35	8	3	-5
0025	2T	19	16	59	6	5900	3100	-2800	0.10	0.53	10	5	-5
0025	2T	19	21	5	2	500	3830	3330	0.40	7.66	0	6	6
0025	2T	19	23	18	2	1800	2190	390	0.11	1.22	3	3	0
0025	2T	19	24	8	0	800	0	-800	0.00	0.00	1	0	-1
0025	2T	19	25	4	0	400	0	-400	0.00	0.00	0	0	0
0025	2T	19	26	18	2	1800	910	-890	0.11	0.51	3	1	-2
0025	2T	20	12	1622	406	162200	123770	-38430	0.25	0.76	287	219	-68
0025	2T	20	13	681	172	68100	56210	-11890	0.25	0.83	120	99	-21
0025	2T	20	14	367	76	36700	27520	-9180	0.21	0.75	64	48	-16
0025	2T	20	15	113	23	11300	11530	230	0.20	1.02	20	20	0
0025	2T	20	16	92	9	9200	5120	-4080	0.10	0.56	16	9	-7
0025	2T	20	21	1	0	100	0	-100	0.00	0.00	0	0	0
0025	2T	20	23	10	1	1000	480	-520	0.10	0.48	1	0	-1
0025	2T	20	24	6	0	600	0	-600	0.00	0.00	1	0	-1
0025	2T	20	25	5	0	500	0	-500	0.00	0.00	0	0	0
0025	2T	20	26	7	1	700	650	-50	0.14	0.93	1	1	0
0025	2T	21	12	1715	450	171500	133590	-37910	0.26	0.78	303	236	-67
0025	2T	21	13	794	245	79400	72290	-7110	0.31	0.91	140	127	-13
0025	2T	21	14	444	112	44400	31610	-12790	0.25	0.71	78	55	-23
0025	2T	21	15	61	8	6100	3900	-2200	0.13	0.64	10	6	-4
0025	2T	21	16	31	4	3100	4570	1470	0.13	1.47	5	8	3
0025	2T	21	21	1	0	100	0	-100	0.00	0.00	0	0	0
0025	2T	21	23	6	1	600	300	-300	0.17	0.50	1	0	-1
0025	2T	21	24	4	0	400	0	-400	0.00	0.00	0	0	0
0025	2T	21	26	2	0	200	0	-200	0.00	0.00	0	0	0
0025	2T	22	12	1436	367	143600	133480	-10120	0.26	0.93	254	236	-18
0025	2T	22	13	447	103	44700	36820	-7880	0.23	0.82	79	65	-14
0025	2T	22	14	289	54	28900	18220	-10680	0.19	0.63	51	32	-19
0025	2T	22	15	35	9	3500	5040	1540	0.26	1.44	6	8	2
0025	2T	22	16	18	1	1800	670	-1130	0.06	0.37	3	1	-2
0025	2T	22	21	4	0	400	0	-400	0.00	0.00	0	0	0
0025	2T	22	23	31	2	3100	1780	-1320	0.06	0.57	5	3	-2
0025	2T	22	24	7	1	700	130	-570	0.14	0.19	1	0	-1
0025	2T	22	25	6	0	600	0	-600	0.00	0.00	1	0	-1
0025	2T	22	26	3	0	300	0	-300	0.00	0.00	0	0	0
0025	2T	23	12	1652	379	165200	122110	-43090	0.23	0.74	292	216	-76
0025	2T	23	13	568	137	56800	41430	-15370	0.24	0.73	100	73	-27
0025	2T	23	14	273	55	27300	20630	-6670	0.20	0.76	48	36	-12
0025	2T	23	15	74	15	7400	10860	3460	0.20	1.47	13	19	6
0025	2T	23	16	7	0	700	0	-700	0.00	0.00	1	0	-1
0025	2T	23	21	1	0	100	0	-100	0.00	0.00	0	0	0
0025	2T	23	23	26	3	2600	2720	120	0.12	1.05	4	4	0
0025	2T	23	24	16	0	1600	0	-1600	0.00	0.00	2	0	-2
0025	2T	23	25	13	3	1300	3020	1720	0.23	2.32	2	5	3
0025	2T	23	26	2	0	200	0	-200	0.00	0.00	0	0	0
0025	2T	24	12	1709	488	170900	128830	-42070	0.29	0.75	302	228	-74
0025	2T	24	13	664	175	66400	51530	-14870	0.26	0.78	117	91	-26
0025	2T	24	14	307	75	30700	23060	-7640	0.24	0.75	54	40	-14
0025	2T	24	15	85	21	8500	8540	40	0.25	1.00	15	15	0
0025	2T	24	16	59	11	5900	4110	-1790	0.19	0.70	10	7	-3
0025	2T	24	23	20	2	2000	1530	-470	0.10	0.77	3	2	-1
0025	2T	24	24	9	2	900	2210	1310	0.22	2.46	1	3	2
0025	2T	24	25	1	0	100	0	-100	0.00	0.00	0	0	0
0025	2T	24	26	5	1	500	190	-310	0.20	0.38	0	0	0
0025	3F	01	123	198	54	19800	14560	-5240	0.27	0.74	35	25	-10
0025	3F	01	124	993	152	99300	67660	-31640	0.15	0.68	175	119	-56
0025	3F	01	125	224	46	22400	17880	-4520	0.21	0.80	39	31	-8
0025	3F	01	126	246	34	24600	22510	-2090	0.14	0.92	43	39	-4
0025	3F	01	134	111	21	11100	7870	-3230	0.19	0.71	19	13	-6
0025	3F	01	135	92	14	9200	5580	-3620	0.15	0.61	16	9	-7
0025	3F	01	136	90	19	9000	9210	210	0.21	1.02	15	16	1
0025	3F	01	145	42	6	4200	3230	-970	0.14	0.77	7	5	-2
0025	3F	01	146	34	5	3400	1710	-1690	0.15	0.50	6	3	-3
0025	3F	01	156	23	5	2300	2500	200	0.22	1.09	4	4	0
0025	3F	01	234	12	6	1200	1760	560	0.50	1.47	2	3	1
0025	3F	01	235	1	0	100	0	-100	0.00	0.00	0	0	0
0025	3F	01	236	10	2	1000	2380	1380	0.20	2.38	1	4	3
0025	3F	01	245	4	1	400	640	240	0.25	1.60	0	1	1
0025	3F	01	246	2	1	200	380	180	0.50	1.90	0	0	0
0025	3F	02	123	360	79	36000	28450	-7550	0.22	0.79	63	50	-13
0025	3F	02	124	727	108	72700	52350	-20350	0.15	0.72	128	92	-36
0025	3F	02	125	206	28	20600	13250	-7350	0.14	0.64	36	23	-13
0025	3F	02	126	277	38	27700	23970	-3730	0.14	0.87	49	42	-7
0025	3F	02	134	164	23	16400	9240	-7160	0.14	0.56	29	16	-13
0025	3F	02	135	133	28	13300	15930	2630	0.21	1.20	23	28	5
0025	3F	02	136	181	37	18100	25560	7460	0.20	1.41	32	45	13
0025	3F	02	145	58	8	5800	3510	-2290	0.14	0.61	10	6	-4
0025	3F	02	146	60	9	6000	7050	1050	0.15	1.18	10	12	2
0025	3F	02	156	12	3	1200	4270	3070	0.25	3.56	2	7	5
0025	3F	02	234	25	2	2500	620	-1880	0.08	0.25	4	1	-3
0025	3F	02	235	12	2	1200	1250	50	0.17	1.04	2	2	0
0025	3F	02	236	15	2	1500	1280	-220	0.13	0.85	2	2	0
0025	3F	02	245	3	0	300	0	-300	0.00	0.00	0	0	0
0025	3F	02	246	3	0	300	0	-300	0.00	0.00	0	0	0
0025	3F	02	256	1	0	100	0	-100	0.00	0.00	0	0	0
0025	3F	03	123	242	72	24200	22620	-1580	0.30	0.93	42	40	-2
0025	3F	03	124	350	54	35000	24230	-10770	0.15	0.69	61	42	-19
0025	3F	03	125	218	31	21800	19290	-2510	0.14	0.88	38	34	-4
0025	3F	03	126	186	33	18600	18960	360	0.18	1.02	32	33	1
0025	3F	03	134	100	25	10000	10120	120	0.25	1.01	17	17	0
0025	3F	03	135	117	21	11700	9430	-2270	0.18	0.81	20	16	-4
0025	3F	03	136	95	16	9500	8740	-760	0.17	0.92	16	15	-1
0025	3F	03	145	60	12	6000	4830	-1170	0.20	0.81	10	8	-2
0025	3F	03	146	36	5	3600	2050	-1550	0.14	0.57	6	3	-3
0025	3F	03	156	16	2	1600	820	-780	0.13	0.51	2	1	-1
0025	3F	03	234	6	0	600	0	-600	0.00	0.00	1	0	-1
0025	3F	03	235	5	1	500	490	-10	0.20	0.98	0	0	0
0025	3F	03	236	7	2	700	650	-50	0.29	0.93	1	1	0
0025	3F	03	245	2	1	200	490	290	0.50	2.45	0	0	0
0025	3F	03	246	1	0	100	0	-100	0.00	0.00	0	0	0
0025	3F	03	256	3	0	300	0	-300	0.00	0.00	0	0	0
0025	3F	04	123	222	52	22200	18880	-3320	0.23	0.85	39	33	-6
0025	3F	04	124	477	98	47700	42440	-5260	0.21	0.89	84	75	-9
0025	3F	04	125	201	42	20100	21970	1870	0.21	1.09	35	38	3
0025	3F	04	126	279	46	27900	29330	1430	0.16	1.05	49	51	2
0025	3F	04	134	166	38	16600	16930	330	0.23	1.02	29	29	0
0025	3F	04	135	116	22	11600	9620	-1980	0.19	0.83	20	17	-3
0025	3F	04	136	172	20	17200	9990	-7210	0.12	0.58	30	17	-13
0025	3F	04	145	47	6	4700	2270	-2430	0.13	0.48	8	4	-4
0025	3F	04	146	58	8	5800	4060	-1740	0.14	0.70	10	7	-3
0025	3F	04	156	16	3	1600	1060	-540	0.19	0.66	2	1	-1
0025	3F	04	234	3	0	300	0	-300	0.00	0.00	0	0	0
0025	3F	04	235	6	1	600	180	-420	0.17	0.30	1	0	-1
0025	3F	04	236	8	3	800	2030	1230	0.38	2.54	1	3	2
0025	3F	04	245	2	0	200	0	-200	0.00	0.00	0	0	0
0025	3F	04	246	4	0	400	0	-400	0.00	0.00	0	0	0
0025	3F	04	256	2	0	200	0	-200	0.00	0.00	0	0	0
0025	3F	05	123	216	56	21600	20230	-1370	0.26	0.94	38	35	-3
0025	3F	05	124	521	102	52100	37270	-14830	0.20	0.72	92	65	-27
0025	3F	05	125	290	42	29000	16750	-12250	0.14	0.58	51	29	-22
0025	3F	05	126	374	48	37400	32750	-4650	0.13	0.88	66	57	-9
0025	3F	05	134	158	32	15800	13490	-2310	0.20	0.85	27	23	-4
0025	3F	05	135	161	32	16100	12030	-4070	0.20	0.75	28	21	-7
0025	3F	05	136	141	22	14100	11210	-2890	0.16	0.80	24	19	-5
0025	3F	05	145	62	10	6200	4490	-1710	0.16	0.72	10	7	-3
0025	3F	05	146	46	7	4600	2450	-2150	0.15	0.53	8	4	-4
0025	3F	05	156	17	2	1700	910	-790	0.12	0.54	3	1	-2
0025	3F	05	234	13	4	1300	1200	-100	0.31	0.92	2	2	0
0025	3F	05	235	8	2	800	1200	400	0.25	1.50	1	2	1
0025	3F	05	236	7	1	700	320	-380	0.14	0.46	1	0	-1
0025	3F	05	245	2	1	200	380	180	0.50	1.90	0	0	0
0025	3F	06	123	258	88	25800	29490	3690	0.34	1.14	45	52	7
0025	3F	06	124	573	129	57300	43490	-13810	0.23	0.76	101	76	-25
0025	3F	06	125	276	51	27600	23430	-4170	0.18	0.85	48	41	-7
0025	3F	06	126	379	57	37900	41330	3430	0.15	1.09	67	73	6
0025	3F	06	134	173	36	17300	11760	-5540	0.21	0.68	30	20	-10
0025	3F	06	135	169	35	16900	12090	-4810	0.21	0.72	29	21	-8
0025	3F	06	136	201	28	20100	14140	-5960	0.14	0.70	35	25	-10
0025	3F	06	145	72	16	7200	7150	-50	0.22	0.99	12	12	0
0025	3F	06	146	69	8	6900	6300	-600	0.12	0.91	12	11	-1
0025	3F	06	156	29	4	2900	1620	-1280	0.14	0.56	5	2	-3
0025	3F	06	234	7	0	700	0	-700	0.00	0.00	1	0	-1
0025	3F	06	235	5	2	500	590	90	0.40	1.18	0	1	1
0025	3F	06	236	4	1	400	220	-180	0.25	0.55	0	0	0
0025	3F	06	245	1	0	100	0	-100	0.00	0.00	0	0	0
0025	3F	06	246	4	2	400	2720	2320	0.50	6.80	0	4	4
0025	3F	06	256	6	0	600	0	-600	0.00	0.00	1	0	-1
0025	3F	07	123	251	60	25100	19690	-5410	0.24	0.78	44	34	-10
0025	3F	07	124	627	125	62700	46500	-16200	0.20	0.74	110	82	-28
0025	3F	07	125	352	61	35200	30630	-4570	0.17	0.87	62	54	-8
0025	3F	07	126	298	55	29800	34570	4770	0.18	1.16	52	61	9
0025	3F	07	134	257	70	25700	21700	-4000	0.27	0.84	45	38	-7
0025	3F	07	135	186	27	18600	10940	-7660	0.15	0.59	32	19	-13
0025	3F	07	136	131	29	13100	13190	90	0.22	1.01	23	23	0
0025	3F	07	145	130	35	13000	13770	770	0.27	1.06	23	24	1
0025	3F	07	146	28	5	2800	2110	-690	0.18	0.75	4	3	-1
0025	3F	07	156	12	4	1200	1590	390	0.33	1.33	2	2	0
0025	3F	07	234	6	1	600	420	-180	0.17	0.70	1	0	-1
0025	3F	07	235	7	1	700	280	-420	0.14	0.40	1	0	-1
0025	3F	07	236	3	0	300	0	-300	0.00	0.00	0	0	0
0025	3F	07	245	3	1	300	350	50	0.33	1.17	0	0	0
0025	3F	07	246	2	0	200	0	-200	0.00	0.00	0	0	0
0025	3F	07	256	2	0	200	0	-200	0.00	0.00	0	0	0
0025	3F	08	123	231	72	23100	19020	-4080	0.31	0.82	40	33	-7
0025	3F	08	124	668	150	66800	58050	-8750	0.22	0.87	118	102	-16
0025	3F	08	125	296	40	29600	18590	-11010	0.14	0.63	52	32	-20
0025	3F	08	126	313	49	31300	25740	-5560	0.16	0.82	55	45	-10
0025	3F	08	134	178	52	17800	19360	1560	0.29	1.09	31	34	3
0025	3F	08	135	160	19	16000	7660	-8340	0.12	0.48	28	13	-15
0025	3F	08	136	167	30	16700	11980	-4720	0.18	0.72	29	21	-8
0025	3F	08	145	91	19	9100	6110	-2990	0.21	0.67	16	10	-6
0025	3F	08	146	61	12	6100	5210	-890	0.20	0.85	10	9	-1
0025	3F	08	156	19	2	1900	660	-1240	0.11	0.35	3	1	-2
0025	3F	08	234	5	1	500	360	-140	0.20	0.72	0	0	0
0025	3F	08	235	6	2	600	610	10	0.33	1.02	1	1	0
0025	3F	08	245	2	0	200	0	-200	0.00	0.00	0	0	0
0025	3F	08	246	1	0	100	0	-100	0.00	0.00	0	0	0
0025	3F	08	256	1	0	100	0	-100	0.00	0.00	0	0	0
0025	3F	09	123	403	101	40300	26930	-13370	0.25	0.67	71	47	-24
0025	3F	09	124	761	165	76100	63260	-12840	0.22	0.83	134	111	-23
0025	3F	09	125	286	59	28600	25870	-2730	0.21	0.90	50	45	-5
0025	3F	09	126	267	31	26700	17600	-9100	0.12	0.66	47	31	-16
0025	3F	09	134	220	42	22000	12610	-9390	0.19	0.57	38	22	-16
0025	3F	09	135	161	27	16100	11270	-4830	0.17	0.70	28	19	-9
0025	3F	09	136	121	14	12100	8550	-3550	0.12	0.71	21	15	-6
0025	3F	09	145	55	6	5500	4000	-1500	0.11	0.73	9	7	-2
0025	3F	09	146	36	5	3600	4530	930	0.14	1.26	6	8	2
0025	3F	09	156	16	1	1600	1040	-560	0.06	0.65	2	1	-1
0025	3F	09	234	9	2	900	620	-280	0.22	0.69	1	1	0
0025	3F	09	235	4	0	400	0	-400	0.00	0.00	0	0	0
0025	3F	09	236	9	0	900	0	-900	0.00	0.00	1	0	-1
0025	3F	09	245	2	1	200	610	410	0.50	3.05	0	1	1
0025	3F	09	246	1	0	100	0	-100	0.00	0.00	0	0	0
0025	3F	09	256	3	1	300	330	30	0.33	1.10	0	0	0
0025	3F	10	123	472	146	47200	34620	-12580	0.31	0.73	83	61	-22
0025	3F	10	124	610	140	61000	48530	-12470	0.23	0.80	107	85	-22
0025	3F	10	125	209	42	20900	18630	-2270	0.20	0.89	36	32	-4
0025	3F	10	126	165	21	16500	13330	-3170	0.13	0.81	29	23	-6
0025	3F	10	134	188	39	18800	13630	-5170	0.21	0.73	33	24	-9
0025	3F	10	135	145	20	14500	11150	-3350	0.14	0.77	25	19	-6
0025	3F	10	136	90	11	9000	5910	-3090	0.12	0.66	15	10	-5
0025	3F	10	145	77	14	7700	6470	-1230	0.18	0.84	13	11	-2
0025	3F	10	146	43	5	4300	2490	-1810	0.12	0.58	7	4	-3
0025	3F	10	156	11	1	1100	1100	0	0.09	1.00	1	1	0
0025	3F	10	234	1	0	100	0	-100	0.00	0.00	0	0	0
0025	3F	10	235	7	3	700	900	200	0.43	1.29	1	1	0
0025	3F	10	236	9	2	900	1120	220	0.22	1.24	1	1	0
0025	3F	10	245	3	0	300	0	-300	0.00	0.00	0	0	0
0025	3F	10	246	7	0	700	0	-700	0.00	0.00	1	0	-1
0025	3F	10	256	3	1	300	380	80	0.33	1.27	0	0	0
0025	3F	11	123	348	94	34800	32460	-2340	0.27	0.93	61	57	-4
0025	3F	11	124	834	152	83400	73480	-9920	0.18	0.88	147	130	-17
0025	3F	11	126	466	56	46600	52430	5830	0.12	1.13	82	92	10
0025	3F	11	134	248	56	24800	18230	-6570	0.23	0.74	43	32	-11
0025	3F	11	135	10	1	1000	1440	440	0.10	1.44	1	2	1
0025	3F	11	136	186	6	18600	4790	-13810	0.03	0.26	32	8	-24
0025	3F	11	145	8	2	800	1570	770	0.25	1.96	1	2	1
0025	3F	11	146	40	6	4000	2490	-1510	0.15	0.62	7	4	-3
0025	3F	11	156	14	0	1400	0	-1400	0.00	0.00	2	0	-2
0025	3F	11	234	55	11	5500	7980	2480	0.20	1.45	9	14	5
0025	3F	11	235	4	1	400	1260	860	0.25	3.15	0	2	2
0025	3F	11	236	43	7	4300	3830	-470	0.16	0.89	7	6	-1
0025	3F	11	245	3	0	300	0	-300	0.00	0.00	0	0	0
0025	3F	11	246	6	0	600	0	-600	0.00	0.00	1	0	-1
0025	3F	11	256	4	0	400	0	-400	0.00	0.00	0	0	0
0025	3F	12	123	275	77	27500	23850	-3650	0.28	0.87	48	42	-6
0025	3F	12	124	941	176	94100	70710	-23390	0.19	0.75	166	125	-41
0025	3F	12	125	127	21	12700	12930	230	0.17	1.02	22	22	0
0025	3F	12	126	321	44	32100	24840	-7260	0.14	0.77	56	43	-13
0025	3F	12	134	104	18	10400	6030	-4370	0.17	0.58	18	10	-8
0025	3F	12	135	118	25	11800	8650	-3150	0.21	0.73	20	15	-5
0025	3F	12	136	156	29	15600	13790	-1810	0.19	0.88	27	24	-3
0025	3F	12	145	65	12	6500	4510	-1990	0.18	0.69	11	7	-4
0025	3F	12	146	43	2	4300	1390	-2910	0.05	0.32	7	2	-5
0025	3F	12	156	28	9	2800	3510	710	0.32	1.25	4	6	2
0025	3F	12	234	8	3	800	900	100	0.38	1.13	1	1	0
0025	3F	12	235	1	0	100	0	-100	0.00	0.00	0	0	0
0025	3F	12	236	6	0	600	0	-600	0.00	0.00	1	0	-1
0025	3F	12	245	1	0	100	0	-100	0.00	0.00	0	0	0
0025	3F	12	256	1	0	100	0	-100	0.00	0.00	0	0	0
0025	3F	13	123	182	44	18200	13580	-4620	0.24	0.75	32	24	-8
0025	3F	13	124	809	163	80900	65280	-15620	0.20	0.81	143	115	-28
0025	3F	13	125	202	38	20200	16050	-4150	0.19	0.79	35	28	-7
0025	3F	13	126	205	35	20500	20490	-10	0.17	1.00	36	36	0
0025	3F	13	134	202	53	20200	18470	-1730	0.26	0.91	35	32	-3
0025	3F	13	135	120	27	12000	12080	80	0.23	1.01	21	21	0
0025	3F	13	136	165	32	16500	14830	-1670	0.19	0.90	29	26	-3
0025	3F	13	145	59	7	5900	3570	-2330	0.12	0.61	10	6	-4
0025	3F	13	146	68	9	6800	6310	-490	0.13	0.93	12	11	-1
0025	3F	13	156	16	4	1600	1980	380	0.25	1.24	2	3	1
0025	3F	13	234	13	1	1300	200	-1100	0.08	0.15	2	0	-2
0025	3F	13	235	3	2	300	720	420	0.67	2.40	0	1	1
0025	3F	13	236	2	0	200	0	-200	0.00	0.00	0	0	0
0025	3F	13	245	2	1	200	380	180	0.50	1.90	0	0	0
0025	3F	13	256	1	0	100	0	-100	0.00	0.00	0	0	0
0025	3F	14	123	323	90	32300	30110	-2190	0.28	0.93	57	53	-4
0025	3F	14	124	538	99	53800	36940	-16860	0.18	0.69	95	65	-30
0025	3F	14	125	246	38	24600	13380	-11220	0.15	0.54	43	23	-20
0025	3F	14	126	219	28	21900	18330	-3570	0.13	0.84	38	32	-6
0025	3F	14	134	135	27	13500	11080	-2420	0.20	0.82	23	19	-4
0025	3F	14	135	142	27	14200	10170	-4030	0.19	0.72	25	18	-7
0025	3F	14	136	131	11	13100	4560	-8540	0.08	0.35	23	8	-15
0025	3F	14	145	56	7	5600	2890	-2710	0.13	0.52	9	5	-4
0025	3F	14	146	42	6	4200	3320	-880	0.14	0.79	7	5	-2
0025	3F	14	156	13	4	1300	1910	610	0.31	1.47	2	3	1
0025	3F	14	234	8	3	800	1560	760	0.38	1.95	1	2	1
0025	3F	14	235	8	2	800	730	-70	0.25	0.91	1	1	0
0025	3F	14	236	11	1	1100	1210	110	0.09	1.10	1	2	1
0025	3F	14	245	2	0	200	0	-200	0.00	0.00	0	0	0
0025	3F	14	246	3	0	300	0	-300	0.00	0.00	0	0	0
0025	3F	14	256	1	0	100	0	-100	0.00	0.00	0	0	0
0025	3F	15	123	273	63	27300	21600	-5700	0.23	0.79	48	38	-10
0025	3F	15	124	771	186	77100	52600	-24500	0.24	0.68	136	93	-43
0025	3F	15	125	274	51	27400	26100	-1300	0.19	0.95	48	46	-2
0025	3F	15	126	317	41	31700	25310	-6390	0.13	0.80	56	44	-12
0025	3F	15	134	242	63	24200	19890	-4310	0.26	0.82	42	35	-7
0025	3F	15	135	136	24	13600	8500	-5100	0.18	0.63	24	15	-9
0025	3F	15	136	151	27	15100	12130	-2970	0.18	0.80	26	21	-5
0025	3F	15	145	46	6	4600	2730	-1870	0.13	0.59	8	4	-4
0025	3F	15	146	57	14	5700	13920	8220	0.25	2.44	10	24	14
0025	3F	15	156	30	4	3000	2750	-250	0.13	0.92	5	4	-1
0025	3F	15	234	3	0	300	0	-300	0.00	0.00	0	0	0
0025	3F	15	235	6	2	600	500	-100	0.33	0.83	1	0	-1
0025	3F	15	236	7	1	700	920	220	0.14	1.31	1	1	0
0025	3F	15	245	1	0	100	0	-100	0.00	0.00	0	0	0
0025	3F	15	246	1	0	100	0	-100	0.00	0.00	0	0	0
0025	3F	15	256	3	0	300	0	-300	0.00	0.00	0	0	0
0025	3F	16	123	382	120	38200	26020	-12180	0.31	0.68	67	46	-21
0025	3F	16	124	639	138	63900	53860	-10040	0.22	0.84	113	95	-18
0025	3F	16	125	247	40	24700	17230	-7470	0.16	0.70	43	30	-13
0025	3F	16	126	351	50	35100	25720	-9380	0.14	0.73	62	45	-17
0025	3F	16	134	157	37	15700	12040	-3660	0.24	0.77	27	21	-6
0025	3F	16	135	109	14	10900	5130	-5770	0.13	0.47	19	9	-10
0025	3F	16	136	159	21	15900	10510	-5390	0.13	0.66	28	18	-10
0025	3F	16	145	89	14	8900	5470	-3430	0.16	0.61	15	9	-6
0025	3F	16	146	58	9	5800	5830	30	0.16	1.01	10	10	0
0025	3F	16	156	23	1	2300	700	-1600	0.04	0.30	4	1	-3
0025	3F	16	234	5	0	500	0	-500	0.00	0.00	0	0	0
0025	3F	16	235	4	1	400	240	-160	0.25	0.60	0	0	0
0025	3F	16	236	9	3	900	1350	450	0.33	1.50	1	2	1
0025	3F	16	245	4	0	400	0	-400	0.00	0.00	0	0	0
0025	3F	16	246	1	0	100	0	-100	0.00	0.00	0	0	0
0025	3F	16	256	5	0	500	0	-500	0.00	0.00	0	0	0
0025	3F	17	123	418	137	41800	38830	-2970	0.33	0.93	73	68	-5
0025	3F	17	124	650	136	65000	53140	-11860	0.21	0.82	115	94	-21
0025	3F	17	125	277	56	27700	26470	-1230	0.20	0.96	49	46	-3
0025	3F	17	126	267	31	26700	23480	-3220	0.12	0.88	47	41	-6
0025	3F	17	134	179	44	17900	14640	-3260	0.25	0.82	31	25	-6
0025	3F	17	135	155	28	15500	13810	-1690	0.18	0.89	27	24	-3
0025	3F	17	136	101	15	10100	6480	-3620	0.15	0.64	17	11	-6
0025	3F	17	145	70	12	7000	5600	-1400	0.17	0.80	12	9	-3
0025	3F	17	146	42	7	4200	4190	-10	0.17	1.00	7	7	0
0025	3F	17	156	9	2	900	1110	210	0.22	1.23	1	1	0
0025	3F	17	234	6	1	600	200	-400	0.17	0.33	1	0	-1
0025	3F	17	235	5	1	500	230	-270	0.20	0.46	0	0	0
0025	3F	17	236	2	0	200	0	-200	0.00	0.00	0	0	0
0025	3F	17	245	2	0	200	0	-200	0.00	0.00	0	0	0
0025	3F	17	246	1	0	100	0	-100	0.00	0.00	0	0	0
0025	3F	17	256	2	0	200	0	-200	0.00	0.00	0	0	0
0025	3F	18	123	280	71	28000	23330	-4670	0.25	0.83	49	41	-8
0025	3F	18	124	772	184	77200	62920	-14280	0.24	0.82	136	111	-25
0025	3F	18	125	392	84	39200	30570	-8630	0.21	0.78	69	54	-15
0025	3F	18	126	224	36	22400	15010	-7390	0.16	0.67	39	26	-13
0025	3F	18	134	214	55	21400	19150	-2250	0.26	0.89	37	33	-4
0025	3F	18	135	211	39	21100	11660	-9440	0.18	0.55	37	20	-17
0025	3F	18	136	130	22	13000	11250	-1750	0.17	0.87	23	19	-4
0025	3F	18	145	102	19	10200	8060	-2140	0.19	0.79	18	14	-4
0025	3F	18	146	47	5	4700	1570	-3130	0.11	0.33	8	2	-6
0025	3F	18	156	3	0	300	0	-300	0.00	0.00	0	0	0
0025	3F	18	234	3	1	300	540	240	0.33	1.80	0	0	0
0025	3F	18	235	12	2	1200	470	-730	0.17	0.39	2	0	-2
0025	3F	18	236	6	0	600	0	-600	0.00	0.00	1	0	-1
0025	3F	18	245	3	0	300	0	-300	0.00	0.00	0	0	0
0025	3F	18	246	4	1	400	470	70	0.25	1.18	0	0	0
0025	3F	18	256	1	0	100	0	-100	0.00	0.00	0	0	0
0025	3F	19	123	208	59	20800	18080	-2720	0.28	0.87	36	32	-4
0025	3F	19	124	692	173	69200	55710	-13490	0.25	0.81	122	98	-24
0025	3F	19	125	179	26	17900	13250	-4650	0.15	0.74	31	23	-8
0025	3F	19	126	210	28	21000	20170	-830	0.13	0.96	37	35	-2
0025	3F	19	134	182	50	18200	15380	-2820	0.27	0.85	32	27	-5
0025	3F	19	135	144	27	14400	9790	-4610	0.19	0.68	25	17	-8
0025	3F	19	136	154	30	15400	10060	-5340	0.19	0.65	27	17	-10
0025	3F	19	145	64	14	6400	5880	-520	0.22	0.92	11	10	-1
0025	3F	19	146	28	7	2800	4450	1650	0.25	1.59	4	7	3
0025	3F	19	156	5	0	500	0	-500	0.00	0.00	0	0	0
0025	3F	19	234	3	1	300	220	-80	0.33	0.73	0	0	0
0025	3F	19	235	6	2	600	610	10	0.33	1.02	1	1	0
0025	3F	19	236	3	0	300	0	-300	0.00	0.00	0	0	0
0025	3F	19	245	2	0	200	0	-200	0.00	0.00	0	0	0
0025	3F	19	246	4	1	400	480	80	0.25	1.20	0	0	0
0025	3F	20	123	361	112	36100	29240	-6860	0.31	0.81	63	51	-12
0025	3F	20	124	788	179	78800	51020	-27780	0.23	0.65	139	90	-49
0025	3F	20	125	240	48	24000	19880	-4120	0.20	0.83	42	35	-7
0025	3F	20	126	202	22	20200	18000	-2200	0.11	0.89	35	31	-4
0025	3F	20	134	222	48	22200	14750	-7450	0.22	0.66	39	26	-13
0025	3F	20	135	150	43	15000	17360	2360	0.29	1.16	26	30	4
0025	3F	20	136	143	27	14300	10750	-3550	0.19	0.75	25	19	-6
0025	3F	20	145	79	14	7900	5470	-2430	0.18	0.69	13	9	-4
0025	3F	20	146	61	11	6100	3700	-2400	0.18	0.61	10	6	-4
0025	3F	20	156	19	3	1900	1180	-720	0.16	0.62	3	2	-1
0025	3F	20	234	1	0	100	0	-100	0.00	0.00	0	0	0
0025	3F	20	235	1	0	100	0	-100	0.00	0.00	0	0	0
0025	3F	20	236	2	0	200	0	-200	0.00	0.00	0	0	0
0025	3F	20	245	3	2	300	570	270	0.67	1.90	0	1	1
0025	3F	20	246	1	0	100	0	-100	0.00	0.00	0	0	0
0025	3F	20	256	1	0	100	0	-100	0.00	0.00	0	0	0
0025	3F	21	123	341	103	34100	30160	-3940	0.30	0.88	60	53	-7
0025	3F	21	124	787	150	78700	51710	-26990	0.19	0.66	139	91	-48
0025	3F	21	125	334	65	33400	23400	-10000	0.19	0.70	59	41	-18
0025	3F	21	126	210	32	21000	17200	-3800	0.15	0.82	37	30	-7
0025	3F	21	134	239	71	23900	24230	330	0.30	1.01	42	42	0
0025	3F	21	135	252	60	25200	18210	-6990	0.24	0.72	44	32	-12
0025	3F	21	136	92	11	9200	5420	-3780	0.12	0.59	16	9	-7
0025	3F	21	145	50	10	5000	4880	-120	0.20	0.98	8	8	0
0025	3F	21	146	29	6	2900	3090	190	0.21	1.07	5	5	0
0025	3F	21	156	5	1	500	670	170	0.20	1.34	0	1	1
0025	3F	21	234	3	0	300	0	-300	0.00	0.00	0	0	0
0025	3F	21	235	1	0	100	0	-100	0.00	0.00	0	0	0
0025	3F	21	236	1	0	100	0	-100	0.00	0.00	0	0	0
0025	3F	21	246	1	0	100	0	-100	0.00	0.00	0	0	0
0025	3F	22	123	164	56	16400	15160	-1240	0.34	0.92	29	26	-3
0025	3F	22	124	971	192	97100	79830	-17270	0.20	0.82	171	141	-30
0025	3F	22	125	121	22	12100	8460	-3640	0.18	0.70	21	14	-7
0025	3F	22	126	182	25	18200	22170	3970	0.14	1.22	32	39	7
0025	3F	22	134	277	47	27700	17900	-9800	0.17	0.65	49	31	-18
0025	3F	22	135	55	7	5500	2480	-3020	0.13	0.45	9	4	-5
0025	3F	22	136	64	8	6400	4190	-2210	0.13	0.65	11	7	-4
0025	3F	22	145	15	1	1500	350	-1150	0.07	0.23	2	0	-2
0025	3F	22	146	18	2	1800	1470	-330	0.11	0.82	3	2	-1
0025	3F	22	156	3	0	300	0	-300	0.00	0.00	0	0	0
0025	3F	22	234	12	3	1200	1980	780	0.25	1.65	2	3	1
0025	3F	22	235	7	0	700	0	-700	0.00	0.00	1	0	-1
0025	3F	22	236	6	1	600	220	-380	0.17	0.37	1	0	-1
0025	3F	22	246	3	0	300	0	-300	0.00	0.00	0	0	0
0025	3F	23	123	358	103	35800	28250	-7550	0.29	0.79	63	50	-13
0025	3F	23	124	921	146	92100	58380	-33720	0.16	0.63	163	103	-60
0025	3F	23	125	176	25	17600	12410	-5190	0.14	0.71	31	21	-10
0025	3F	23	126	157	10	15700	11360	-4340	0.06	0.72	27	20	-7
0025	3F	23	134	172	35	17200	15600	-1600	0.20	0.91	30	27	-3
0025	3F	23	135	125	16	12500	4780	-7720	0.13	0.38	22	8	-14
0025	3F	23	136	97	13	9700	7490	-2210	0.13	0.77	17	13	-4
0025	3F	23	145	92	20	9200	6970	-2230	0.22	0.76	16	12	-4
0025	3F	23	146	52	6	5200	2890	-2310	0.12	0.56	9	5	-4
0025	3F	23	156	13	1	1300	410	-890	0.08	0.32	2	0	-2
0025	3F	23	234	18	3	1800	1030	-770	0.17	0.57	3	1	-2
0025	3F	23	235	6	1	600	210	-390	0.17	0.35	1	0	-1
0025	3F	23	236	2	1	200	1040	840	0.50	5.20	0	1	1
0025	3F	23	245	5	0	500	0	-500	0.00	0.00	0	0	0
0025	3F	23	246	1	0	100	0	-100	0.00	0.00	0	0	0
0025	3F	23	256	2	1	200	240	40	0.50	1.20	0	0	0
0025	3F	24	123	440	140	44000	39480	-4520	0.32	0.90	77	69	-8
0025	3F	24	124	697	127	69700	46820	-22880	0.18	0.67	123	82	-41
0025	3F	24	125	254	40	25400	16840	-8560	0.16	0.66	44	29	-15
0025	3F	24	126	244	41	24400	18000	-6400	0.17	0.74	43	31	-12
0025	3F	24	134	206	55	20600	19660	-940	0.27	0.95	36	34	-2
0025	3F	24	135	140	30	14000	9850	-4150	0.21	0.70	24	17	-7
0025	3F	24	136	120	18	12000	6090	-5910	0.15	0.51	21	10	-11
0025	3F	24	145	59	13	5900	3730	-2170	0.22	0.63	10	6	-4
0025	3F	24	146	20	5	2000	1790	-210	0.25	0.90	3	3	0
0025	3F	24	156	5	2	500	790	290	0.40	1.58	0	1	1
0025	3F	24	234	10	2	1000	660	-340	0.20	0.66	1	1	0
0025	3F	24	235	3	0	300	0	-300	0.00	0.00	0	0	0
0025	3F	24	236	4	0	400	0	-400	0.00	0.00	0	0	0
0025	3F	24	245	1	0	100	0	-100	0.00	0.00	0	0	0
0025	3T	01	123	191	21	19100	13430	-5670	0.11	0.70	33	23	-10
0025	3T	01	124	982	63	98200	65380	-32820	0.06	0.67	173	115	-58
0025	3T	01	125	223	20	22300	21610	-690	0.09	0.97	39	38	-1
0025	3T	01	126	245	17	24500	37030	12530	0.07	1.51	43	65	22
0025	3T	01	132	7	2	700	1200	500	0.29	1.71	1	2	1
0025	3T	01	134	99	5	9900	3940	-5960	0.05	0.40	17	6	-11
0025	3T	01	135	91	4	9100	4300	-4800	0.04	0.47	16	7	-9
0025	3T	01	136	90	10	9000	11300	2300	0.11	1.26	15	20	5
0025	3T	01	142	11	0	1100	0	-1100	0.00	0.00	1	0	-1
0025	3T	01	143	12	0	1200	0	-1200	0.00	0.00	2	0	-2
0025	3T	01	145	37	2	3700	3070	-630	0.05	0.83	6	5	-1
0025	3T	01	146	33	2	3300	1400	-1900	0.06	0.42	5	2	-3
0025	3T	01	152	1	0	100	0	-100	0.00	0.00	0	0	0
0025	3T	01	153	1	0	100	0	-100	0.00	0.00	0	0	0
0025	3T	01	154	5	0	500	0	-500	0.00	0.00	0	0	0
0025	3T	01	156	23	1	2300	830	-1470	0.04	0.36	4	1	-3
0025	3T	01	164	1	0	100	0	-100	0.00	0.00	0	0	0
0025	3T	01	216	1	0	100	0	-100	0.00	0.00	0	0	0
0025	3T	01	234	10	1	1000	800	-200	0.10	0.80	1	1	0
0025	3T	01	235	1	0	100	0	-100	0.00	0.00	0	0	0
0025	3T	01	236	10	1	1000	4400	3400	0.10	4.40	1	7	6
0025	3T	01	243	2	0	200	0	-200	0.00	0.00	0	0	0
0025	3T	01	245	3	0	300	0	-300	0.00	0.00	0	0	0
0025	3T	01	246	2	0	200	0	-200	0.00	0.00	0	0	0
0025	3T	01	254	1	0	100	0	-100	0.00	0.00	0	0	0
0025	3T	02	123	349	29	34900	24720	-10180	0.08	0.71	61	43	-18
0025	3T	02	124	717	40	71700	54000	-17700	0.06	0.75	126	95	-31
0025	3T	02	125	200	14	20000	20040	40	0.07	1.00	35	35	0
0025	3T	02	126	277	18	27700	29720	2020	0.06	1.07	49	52	3
0025	3T	02	132	11	0	1100	0	-1100	0.00	0.00	1	0	-1
0025	3T	02	134	157	8	15700	9410	-6290	0.05	0.60	27	16	-11
0025	3T	02	135	131	10	13100	14790	1690	0.08	1.13	23	26	3
0025	3T	02	136	178	14	17800	20090	2290	0.08	1.13	31	35	4
0025	3T	02	142	10	3	1000	3830	2830	0.30	3.83	1	6	5
0025	3T	02	143	7	1	700	1030	330	0.14	1.47	1	1	0
0025	3T	02	145	56	2	5600	5450	-150	0.04	0.97	9	9	0
0025	3T	02	146	60	3	6000	7310	1310	0.05	1.22	10	12	2
0025	3T	02	152	6	0	600	0	-600	0.00	0.00	1	0	-1
0025	3T	02	153	2	0	200	0	-200	0.00	0.00	0	0	0
0025	3T	02	154	2	0	200	0	-200	0.00	0.00	0	0	0
0025	3T	02	156	12	1	1200	2750	1550	0.08	2.29	2	4	2
0025	3T	02	163	3	0	300	0	-300	0.00	0.00	0	0	0
0025	3T	02	234	25	2	2500	1680	-820	0.08	0.67	4	2	-2
0025	3T	02	235	11	0	1100	0	-1100	0.00	0.00	1	0	-1
0025	3T	02	236	15	0	1500	0	-1500	0.00	0.00	2	0	-2
0025	3T	02	245	3	0	300	0	-300	0.00	0.00	0	0	0
0025	3T	02	246	3	0	300	0	-300	0.00	0.00	0	0	0
0025	3T	02	253	1	0	100	0	-100	0.00	0.00	0	0	0
0025	3T	02	256	1	0	100	0	-100	0.00	0.00	0	0	0
0025	3T	03	123	241	32	24100	29640	5540	0.13	1.23	42	52	10
0025	3T	03	124	349	18	34900	21760	-13140	0.05	0.62	61	38	-23
0025	3T	03	125	216	11	21600	14010	-7590	0.05	0.65	38	24	-14
0025	3T	03	126	185	12	18500	24460	5960	0.06	1.32	32	43	11
0025	3T	03	132	1	0	100	0	-100	0.00	0.00	0	0	0
0025	3T	03	134	90	10	9000	11700	2700	0.11	1.30	15	20	5
0025	3T	03	135	113	12	11300	14340	3040	0.11	1.27	20	25	5
0025	3T	03	136	94	8	9400	11910	2510	0.09	1.27	16	21	5
0025	3T	03	142	1	0	100	0	-100	0.00	0.00	0	0	0
0025	3T	03	143	10	1	1000	1100	100	0.10	1.10	1	1	0
0025	3T	03	145	60	3	6000	4840	-1160	0.05	0.81	10	8	-2
0025	3T	03	146	35	2	3500	2550	-950	0.06	0.73	6	4	-2
0025	3T	03	152	2	0	200	0	-200	0.00	0.00	0	0	0
0025	3T	03	153	4	0	400	0	-400	0.00	0.00	0	0	0
0025	3T	03	156	15	1	1500	1910	410	0.07	1.27	2	3	1
0025	3T	03	163	1	0	100	0	-100	0.00	0.00	0	0	0
0025	3T	03	164	1	0	100	0	-100	0.00	0.00	0	0	0
0025	3T	03	165	1	0	100	0	-100	0.00	0.00	0	0	0
0025	3T	03	216	1	0	100	0	-100	0.00	0.00	0	0	0
0025	3T	03	234	6	0	600	0	-600	0.00	0.00	1	0	-1
0025	3T	03	235	3	1	300	2360	2060	0.33	7.87	0	4	4
0025	3T	03	236	7	0	700	0	-700	0.00	0.00	1	0	-1
0025	3T	03	245	2	0	200	0	-200	0.00	0.00	0	0	0
0025	3T	03	246	1	0	100	0	-100	0.00	0.00	0	0	0
0025	3T	03	253	2	0	200	0	-200	0.00	0.00	0	0	0
0025	3T	03	256	3	0	300	0	-300	0.00	0.00	0	0	0
0025	3T	04	123	219	22	21900	21440	-460	0.10	0.98	38	37	-1
0025	3T	04	124	471	36	47100	37140	-9960	0.08	0.79	83	65	-18
0025	3T	04	125	199	14	19900	28090	8190	0.07	1.41	35	49	14
0025	3T	04	126	279	22	27900	33830	5930	0.08	1.21	49	59	10
0025	3T	04	132	3	0	300	0	-300	0.00	0.00	0	0	0
0025	3T	04	134	155	14	15500	13670	-1830	0.09	0.88	27	24	-3
0025	3T	04	135	114	9	11400	10530	-870	0.08	0.92	20	18	-2
0025	3T	04	136	172	7	17200	5890	-11310	0.04	0.34	30	10	-20
0025	3T	04	142	5	1	500	1030	530	0.20	2.06	0	1	1
0025	3T	04	143	11	1	1100	2630	1530	0.09	2.39	1	4	3
0025	3T	04	145	41	0	4100	0	-4100	0.00	0.00	7	0	-7
0025	3T	04	146	56	2	5600	3200	-2400	0.04	0.57	9	5	-4
0025	3T	04	152	2	0	200	0	-200	0.00	0.00	0	0	0
0025	3T	04	153	2	0	200	0	-200	0.00	0.00	0	0	0
0025	3T	04	154	6	0	600	0	-600	0.00	0.00	1	0	-1
0025	3T	04	156	14	0	1400	0	-1400	0.00	0.00	2	0	-2
0025	3T	04	164	2	0	200	0	-200	0.00	0.00	0	0	0
0025	3T	04	165	2	0	200	0	-200	0.00	0.00	0	0	0
0025	3T	04	214	1	0	100	0	-100	0.00	0.00	0	0	0
0025	3T	04	234	3	0	300	0	-300	0.00	0.00	0	0	0
0025	3T	04	235	6	1	600	400	-200	0.17	0.67	1	0	-1
0025	3T	04	236	8	0	800	0	-800	0.00	0.00	1	0	-1
0025	3T	04	245	2	0	200	0	-200	0.00	0.00	0	0	0
0025	3T	04	246	4	0	400	0	-400	0.00	0.00	0	0	0
0025	3T	04	256	2	0	200	0	-200	0.00	0.00	0	0	0
0025	3T	05	123	213	20	21300	22990	1690	0.09	1.08	37	40	3
0025	3T	05	124	511	51	51100	48140	-2960	0.10	0.94	90	85	-5
0025	3T	05	125	289	16	28900	14180	-14720	0.06	0.49	51	25	-26
0025	3T	05	126	373	26	37300	37700	400	0.07	1.01	66	66	0
0025	3T	05	132	3	0	300	0	-300	0.00	0.00	0	0	0
0025	3T	05	134	140	10	14000	10430	-3570	0.07	0.75	24	18	-6
0025	3T	05	135	158	10	15800	11440	-4360	0.06	0.72	27	20	-7
0025	3T	05	136	140	11	14000	13400	-600	0.08	0.96	24	23	-1
0025	3T	05	142	10	1	1000	1050	50	0.10	1.05	1	1	0
0025	3T	05	143	18	1	1800	1560	-240	0.06	0.87	3	2	-1
0025	3T	05	145	60	5	6000	5290	-710	0.08	0.88	10	9	-1
0025	3T	05	146	46	3	4600	2520	-2080	0.07	0.55	8	4	-4
0025	3T	05	152	1	0	100	0	-100	0.00	0.00	0	0	0
0025	3T	05	153	3	0	300	0	-300	0.00	0.00	0	0	0
0025	3T	05	154	2	0	200	0	-200	0.00	0.00	0	0	0
0025	3T	05	156	17	0	1700	0	-1700	0.00	0.00	3	0	-3
0025	3T	05	163	1	0	100	0	-100	0.00	0.00	0	0	0
0025	3T	05	216	1	0	100	0	-100	0.00	0.00	0	0	0
0025	3T	05	234	13	1	1300	1140	-160	0.08	0.88	2	2	0
0025	3T	05	235	8	0	800	0	-800	0.00	0.00	1	0	-1
0025	3T	05	236	7	1	700	740	40	0.14	1.06	1	1	0
0025	3T	05	245	2	0	200	0	-200	0.00	0.00	0	0	0
0025	3T	06	123	257	54	25700	47170	21470	0.21	1.84	45	83	38
0025	3T	06	124	566	45	56600	36390	-20210	0.08	0.64	100	64	-36
0025	3T	06	125	274	17	27400	20000	-7400	0.06	0.73	48	35	-13
0025	3T	06	126	377	24	37700	63340	25640	0.06	1.68	66	112	46
0025	3T	06	132	1	0	100	0	-100	0.00	0.00	0	0	0
0025	3T	06	134	164	16	16400	14650	-1750	0.10	0.89	29	25	-4
0025	3T	06	135	164	12	16400	13110	-3290	0.07	0.80	29	23	-6
0025	3T	06	136	199	10	19900	11900	-8000	0.05	0.60	35	21	-14
0025	3T	06	142	7	0	700	0	-700	0.00	0.00	1	0	-1
0025	3T	06	143	9	0	900	0	-900	0.00	0.00	1	0	-1
0025	3T	06	145	71	5	7100	5260	-1840	0.07	0.74	12	9	-3
0025	3T	06	146	68	3	6800	7030	230	0.04	1.03	12	12	0
0025	3T	06	152	1	0	100	0	-100	0.00	0.00	0	0	0
0025	3T	06	153	5	0	500	0	-500	0.00	0.00	0	0	0
0025	3T	06	154	1	0	100	0	-100	0.00	0.00	0	0	0
0025	3T	06	156	28	0	2800	0	-2800	0.00	0.00	4	0	-4
0025	3T	06	163	2	0	200	0	-200	0.00	0.00	0	0	0
0025	3T	06	164	1	0	100	0	-100	0.00	0.00	0	0	0
0025	3T	06	165	1	0	100	0	-100	0.00	0.00	0	0	0
0025	3T	06	215	1	0	100	0	-100	0.00	0.00	0	0	0
0025	3T	06	216	2	0	200	0	-200	0.00	0.00	0	0	0
0025	3T	06	234	7	0	700	0	-700	0.00	0.00	1	0	-1
0025	3T	06	235	5	0	500	0	-500	0.00	0.00	0	0	0
0025	3T	06	236	4	0	400	0	-400	0.00	0.00	0	0	0
0025	3T	06	245	1	0	100	0	-100	0.00	0.00	0	0	0
0025	3T	06	246	4	0	400	0	-400	0.00	0.00	0	0	0
0025	3T	06	256	6	0	600	0	-600	0.00	0.00	1	0	-1
0025	3T	07	123	243	22	24300	17130	-7170	0.09	0.70	43	30	-13
0025	3T	07	124	626	52	62600	48820	-13780	0.08	0.78	110	86	-24
0025	3T	07	125	350	22	35000	21510	-13490	0.06	0.61	61	38	-23
0025	3T	07	126	298	16	29800	20300	-9500	0.05	0.68	52	35	-17
0025	3T	07	132	7	1	700	620	-80	0.14	0.89	1	1	0
0025	3T	07	134	252	33	25200	24720	-480	0.13	0.98	44	43	-1
0025	3T	07	135	181	9	18100	10030	-8070	0.05	0.55	32	17	-15
0010	1T	1_-1	1	15	9	1500	1380	-120	0.60	0.92	2	2	0
0010	1T	1_-1	2	4	2	400	260	-140	0.50	0.65	0	0	0
0010	1T	1_0	1	701	374	70100	65640	-4460	0.53	0.94	124	116	-8
0010	1T	1_0	2	13	5	1300	1800	500	0.38	1.38	2	3	1
0010	1T	1_1	1	1302	884	130200	119670	-10530	0.68	0.92	230	211	-19
0010	1T	1_1	2	92	35	9200	8000	-1200	0.38	0.87	16	14	-2
0010	1T	1_2	1	1568	885	156800	139870	-16930	0.56	0.89	277	247	-30
0010	1T	1_2	2	461	207	46100	44370	-1730	0.45	0.96	81	78	-3
0010	1T	1_3	1	2824	1510	282400	267720	-14680	0.53	0.95	499	473	-26
0010	1T	1_3	2	1238	428	123800	104720	-19080	0.35	0.85	219	185	-34
0010	1T	1_4	1	1985	1146	198500	170690	-27810	0.58	0.86	351	302	-49
0010	1T	1_4	2	348	102	34800	30560	-4240	0.29	0.88	61	54	-7
0010	1T	1_5	1	415	260	41500	36600	-4900	0.63	0.88	73	64	-9
0010	1T	1_5	2	18	2	1800	540	-1260	0.11	0.30	3	0	-3
0010	1T	1_6	1	1281	880	128100	118510	-9590	0.69	0.93	226	209	-17
0010	1T	1_6	2	3	1	300	270	-30	0.33	0.90	0	0	0
0010	1T	2_-1	1	22	11	2200	1590	-610	0.50	0.72	3	2	-1
0010	1T	2_-1	2	1	0	100	0	-100	0.00	0.00	0	0	0
0010	1T	2_0	1	568	280	56800	48710	-8090	0.49	0.86	100	86	-14
0010	1T	2_0	2	59	16	5900	3720	-2180	0.27	0.63	10	6	-4
0010	1T	2_1	1	1410	899	141000	128190	-12810	0.64	0.91	249	226	-23
0010	1T	2_1	2	77	30	7700	6130	-1570	0.39	0.80	13	10	-3
0010	1T	2_2	1	2051	1026	205100	184840	-20260	0.50	0.90	363	327	-36
0010	1T	2_2	2	358	142	35800	29520	-6280	0.40	0.82	63	52	-11
0010	1T	2_3	1	3619	1737	361900	335120	-26780	0.48	0.93	640	593	-47
0010	1T	2_3	2	764	300	76400	70830	-5570	0.39	0.93	135	125	-10
0010	1T	2_4	1	2684	1452	268400	235600	-32800	0.54	0.88	475	416	-59
0010	1T	2_4	2	166	77	16600	17810	1210	0.46	1.07	29	31	2
0010	1T	2_5	1	707	459	70700	64180	-6520	0.65	0.91	125	113	-12
0010	1T	2_5	2	4	1	400	260	-140	0.25	0.65	0	0	0
0010	1T	2_6	1	500	346	50000	45770	-4230	0.69	0.92	88	81	-7
0010	1T	3_-1	1	51	34	5100	6600	1500	0.67	1.29	9	11	2
0010	1T	3_-1	2	6	2	600	280	-320	0.33	0.47	1	0	-1
0010	1T	3_0	1	581	296	58100	54040	-4060	0.51	0.93	102	95	-7
0010	1T	3_0	2	35	11	3500	3190	-310	0.31	0.91	6	5	-1
0010	1T	3_1	1	1345	891	134500	123090	-11410	0.66	0.92	238	217	-21
0010	1T	3_1	2	120	51	12000	14560	2560	0.43	1.21	21	25	4
0010	1T	3_2	1	1692	947	169200	158840	-10360	0.56	0.94	299	281	-18
0010	1T	3_2	2	478	177	47800	45040	-2760	0.37	0.94	84	79	-5
0010	1T	3_3	1	2937	1604	293700	288240	-5460	0.55	0.98	519	510	-9
0010	1T	3_3	2	1125	391	112500	104930	-7570	0.35	0.93	199	185	-14
0010	1T	3_4	1	2772	1596	277200	252170	-25030	0.58	0.91	490	446	-44
0010	1T	3_4	2	244	88	24400	23330	-1070	0.36	0.96	43	41	-2
0010	1T	3_5	1	811	573	81100	77170	-3930	0.71	0.95	143	136	-7
0010	1T	3_5	2	10	3	1000	800	-200	0.30	0.80	1	1	0
0010	1T	3_6	1	292	195	29200	25040	-4160	0.67	0.86	51	44	-7
0010	1T	3_6	2	1	1	100	300	200	1.00	3.00	0	0	0
0010	1T	4_-1	1	24	10	2400	1750	-650	0.42	0.73	4	3	-1
0010	1T	4_0	1	406	205	40600	35870	-4730	0.50	0.88	71	63	-8
0010	1T	4_0	2	57	21	5700	6540	840	0.37	1.15	10	11	1
0010	1T	4_1	1	1168	784	116800	107930	-8870	0.67	0.92	206	191	-15
0010	1T	4_1	2	110	42	11000	8580	-2420	0.38	0.78	19	15	-4
0010	1T	4_2	1	1675	962	167500	157380	-10120	0.57	0.94	296	278	-18
0010	1T	4_2	2	341	140	34100	28950	-5150	0.41	0.85	60	51	-9
0010	1T	4_3	1	2768	1477	276800	255940	-20860	0.53	0.92	489	452	-37
0010	1T	4_3	2	645	246	64500	59120	-5380	0.38	0.92	114	104	-10
0010	1T	4_4	1	2087	1278	208700	188240	-20460	0.61	0.90	369	333	-36
0010	1T	4_4	2	135	44	13500	10760	-2740	0.33	0.80	23	19	-4
0010	1T	4_5	1	815	558	81500	73400	-8100	0.68	0.90	144	129	-15
0010	1T	4_5	2	2	1	200	250	50	0.50	1.25	0	0	0
0010	1T	4_6	1	307	224	30700	29220	-1480	0.73	0.95	54	51	-3
0010	1T	5_-1	1	21	11	2100	1420	-680	0.52	0.68	3	2	-1
0010	1T	5_-1	2	2	1	200	110	-90	0.50	0.55	0	0	0
0010	1T	5_0	1	464	259	46400	45580	-820	0.56	0.98	82	80	-2
0010	1T	5_0	2	34	9	3400	3300	-100	0.26	0.97	6	5	-1
0010	1T	5_1	1	1002	660	100200	92530	-7670	0.66	0.92	177	163	-14
0010	1T	5_1	2	34	11	3400	3090	-310	0.32	0.91	6	5	-1
0010	1T	5_2	1	1390	858	139000	132650	-6350	0.62	0.95	246	234	-12
0010	1T	5_2	2	129	51	12900	10970	-1930	0.40	0.85	22	19	-3
0010	1T	5_3	1	2289	1369	228900	212200	-16700	0.60	0.93	405	375	-30
0010	1T	5_3	2	193	50	19300	15680	-3620	0.26	0.81	34	27	-7
0010	1T	5_4	1	1499	969	149900	137760	-12140	0.65	0.92	265	243	-22
0010	1T	5_4	2	67	12	6700	2740	-3960	0.18	0.41	11	4	-7
0010	1T	5_5	1	899	626	89900	79010	-10890	0.70	0.88	159	139	-20
0010	1T	5_5	2	4	1	400	130	-270	0.25	0.33	0	0	0
0010	1T	5_6	1	295	212	29500	27530	-1970	0.72	0.93	52	48	-4
0010	1T	5_6	2	2	0	200	0	-200	0.00	0.00	0	0	0
0010	1T	6_0	1	43	26	4300	4300	0	0.60	1.00	7	7	0
0010	1T	6_0	2	2	1	200	300	100	0.50	1.50	0	0	0
0010	1T	6_1	1	74	44	7400	6210	-1190	0.59	0.84	13	10	-3
0010	1T	6_1	2	3	0	300	0	-300	0.00	0.00	0	0	0
0010	1T	6_2	1	85	42	8500	7630	-870	0.49	0.90	15	13	-2
0010	1T	6_2	2	10	5	1000	1260	260	0.50	1.26	1	2	1
0010	1T	6_3	1	189	96	18900	15350	-3550	0.51	0.81	33	27	-6
0010	1T	6_3	2	7	1	700	110	-590	0.14	0.16	1	0	-1
0010	1T	6_4	1	144	93	14400	12630	-1770	0.65	0.88	25	22	-3
0010	1T	6_4	2	5	4	500	1080	580	0.80	2.16	0	1	1
0010	1T	6_5	1	72	53	7200	6430	-770	0.74	0.89	12	11	-1
0010	1T	6_5	2	1	0	100	0	-100	0.00	0.00	0	0	0
0010	1T	6_6	1	30	23	3000	2980	-20	0.77	0.99	5	5	0
0010	1T	7_-1	1	22	11	2200	1680	-520	0.50	0.76	3	2	-1
0010	1T	7_-1	2	1	1	100	270	170	1.00	2.70	0	0	0
0010	1T	7_0	1	968	500	96800	88810	-7990	0.52	0.92	171	157	-14
0010	1T	7_0	2	82	28	8200	9340	1140	0.34	1.14	14	16	2
0010	1T	7_1	1	2198	1453	219800	203560	-16240	0.66	0.93	389	360	-29
0010	1T	7_1	2	157	47	15700	12350	-3350	0.30	0.79	27	21	-6
0010	1T	7_2	1	3059	1825	305900	276560	-29340	0.60	0.90	541	489	-52
0010	1T	7_2	2	315	121	31500	31280	-220	0.38	0.99	55	55	0
0010	1T	7_3	1	3189	1989	318900	302900	-16000	0.62	0.95	564	536	-28
0010	1T	7_3	2	214	71	21400	19880	-1520	0.33	0.93	37	35	-2
0010	1T	7_4	1	1517	939	151700	140530	-11170	0.62	0.93	268	248	-20
0010	1T	7_4	2	59	17	5900	4830	-1070	0.29	0.82	10	8	-2
0010	1T	7_5	1	1034	699	103400	93570	-9830	0.68	0.90	183	165	-18
0010	1T	7_5	2	11	1	1100	180	-920	0.09	0.16	1	0	-1
0010	1T	7_6	1	725	497	72500	65090	-7410	0.69	0.90	128	115	-13
0010	1T	7_6	2	1	0	100	0	-100	0.00	0.00	0	0	0
0010	2F	1_-1	12	11	3	1100	760	-340	0.27	0.69	1	1	0
0010	2F	1_-1	13	3	1	300	420	120	0.33	1.40	0	0	0
0010	2F	1_-1	14	1	0	100	0	-100	0.00	0.00	0	0	0
0010	2F	1_-1	23	2	0	200	0	-200	0.00	0.00	0	0	0
0010	2F	1_0	12	685	169	68500	56930	-11570	0.25	0.83	121	100	-21
0010	2F	1_0	13	16	3	1600	880	-720	0.19	0.55	2	1	-1
0010	2F	1_1	12	726	199	72600	48500	-24100	0.27	0.67	128	85	-43
0010	2F	1_1	13	308	95	30800	26050	-4750	0.31	0.85	54	46	-8
0010	2F	1_1	14	129	27	12900	8900	-4000	0.21	0.69	22	15	-7
0010	2F	1_1	15	99	21	9900	10620	720	0.21	1.07	17	18	1
0010	2F	1_1	16	25	2	2500	1330	-1170	0.08	0.53	4	2	-2
0010	2F	1_1	23	23	5	2300	2590	290	0.22	1.13	4	4	0
0010	2F	1_2	12	708	234	70800	54100	-16700	0.33	0.76	125	95	-30
0010	2F	1_2	13	294	94	29400	24040	-5360	0.32	0.82	52	42	-10
0010	2F	1_2	14	420	124	42000	36810	-5190	0.30	0.88	74	65	-9
0010	2F	1_2	15	62	10	6200	2150	-4050	0.16	0.35	10	3	-7
0001	1T	nopattern	1	20370	11706	2037000	1844290	-192710	0.57	0.91	3605	3264	-341
0001	1T	nopattern	2	1579	612	157900	143100	-14800	0.39	0.91	279	253	-26
0001	2F	nopattern	12	11749	3874	1174900	996910	-177990	0.33	0.85	2079	1764	-315
0001	2F	nopattern	13	4813	1523	481300	391510	-89790	0.32	0.81	851	692	-159
0001	2F	nopattern	14	2443	708	244300	196260	-48040	0.29	0.80	432	347	-85
0001	2F	nopattern	15	709	158	70900	64480	-6420	0.22	0.91	125	114	-11
0001	2F	nopattern	16	478	91	47800	46430	-1370	0.19	0.97	84	82	-2
0001	2F	nopattern	23	63	11	6300	3340	-2960	0.17	0.53	11	5	-6
0001	2F	nopattern	24	61	11	6100	3870	-2230	0.18	0.63	10	6	-4
0001	2F	nopattern	25	77	15	7700	5730	-1970	0.19	0.74	13	10	-3
0001	2F	nopattern	26	84	14	8400	7110	-1290	0.17	0.85	14	12	-2
0001	2T	nopattern	12	11740	2878	1174000	951660	-222340	0.25	0.81	2077	1684	-393
0001	2T	nopattern	13	4813	1112	481300	383730	-97570	0.23	0.80	851	679	-172
0001	2T	nopattern	14	2443	508	244300	200220	-44080	0.21	0.82	432	354	-78
0010	2F	1_2	16	88	14	8800	4120	-4680	0.16	0.47	15	7	-8
0010	2F	1_2	23	56	10	5600	4240	-1360	0.18	0.76	9	7	-2
0010	2F	1_2	24	92	15	9200	6230	-2970	0.16	0.68	16	11	-5
0010	2F	1_2	25	17	2	1700	670	-1030	0.12	0.39	3	1	-2
0010	2F	1_2	26	60	7	6000	4960	-1040	0.12	0.83	10	8	-2
0010	2F	1_3	12	1204	390	120400	112000	-8400	0.32	0.93	213	198	-15
0001	2T	nopattern	15	709	113	70900	73920	3020	0.16	1.04	125	130	5
0001	2T	nopattern	16	478	72	47800	50680	2880	0.15	1.06	84	89	5
0001	2T	nopattern	21	9	0	900	0	-900	0.00	0.00	1	0	-1
0001	2T	nopattern	23	63	4	6300	2460	-3840	0.06	0.39	11	4	-7
0001	2T	nopattern	24	61	6	6100	2940	-3160	0.10	0.48	10	5	-5
0001	2T	nopattern	25	77	11	7700	7150	-550	0.14	0.93	13	12	-1
0001	2T	nopattern	26	84	9	8400	7100	-1300	0.11	0.85	14	12	-2
0001	3F	nopattern	123	3554	947	355400	292360	-63040	0.27	0.82	629	517	-112
0001	3F	nopattern	124	4313	968	431300	330310	-100990	0.22	0.77	763	584	-179
0001	3F	nopattern	125	1887	355	188700	160190	-28510	0.19	0.85	333	283	-50
0001	3F	nopattern	126	1581	256	158100	134180	-23920	0.16	0.85	279	237	-42
0001	3F	nopattern	134	1284	315	128400	99540	-28860	0.25	0.78	227	176	-51
0001	3F	nopattern	135	1115	209	111500	75400	-36100	0.19	0.68	197	133	-64
0001	3F	nopattern	136	1018	158	101800	79940	-21860	0.16	0.79	180	141	-39
0001	3F	nopattern	145	384	77	38400	29230	-9170	0.20	0.76	67	51	-16
0001	3F	nopattern	146	344	51	34400	29080	-5320	0.15	0.85	60	51	-9
0001	3F	nopattern	156	127	21	12700	11460	-1240	0.17	0.90	22	20	-2
0001	3F	nopattern	234	15	2	1500	450	-1050	0.13	0.30	2	0	-2
0001	3F	nopattern	235	13	1	1300	360	-940	0.08	0.28	2	0	-2
0001	3F	nopattern	236	12	3	1200	1500	300	0.25	1.25	2	2	0
0001	3F	nopattern	245	6	2	600	790	190	0.33	1.32	1	1	0
0001	3F	nopattern	246	8	1	800	480	-320	0.13	0.60	1	0	-1
0001	3F	nopattern	256	16	3	1600	830	-770	0.19	0.52	2	1	-1
0001	3T	nopattern	123	3449	398	344900	279810	-65090	0.12	0.81	610	495	-115
0001	3T	nopattern	124	4273	415	427300	339090	-88210	0.10	0.79	756	600	-156
0001	3T	nopattern	125	1887	142	188700	149690	-39010	0.08	0.79	333	264	-69
0001	3T	nopattern	126	1570	103	157000	138630	-18370	0.07	0.88	277	245	-32
0001	3T	nopattern	132	105	10	10500	8050	-2450	0.10	0.77	18	14	-4
0001	3T	nopattern	134	1271	143	127100	114550	-12550	0.11	0.90	224	202	-22
0001	3T	nopattern	135	1113	87	111300	77910	-33390	0.08	0.70	196	137	-59
0001	3T	nopattern	136	1014	66	101400	98740	-2660	0.07	0.97	179	174	-5
0001	3T	nopattern	142	38	5	3800	4760	960	0.13	1.25	6	8	2
0001	3T	nopattern	143	13	1	1300	670	-630	0.08	0.52	2	1	-1
0001	3T	nopattern	145	380	23	38000	28820	-9180	0.06	0.76	67	51	-16
0001	3T	nopattern	146	336	18	33600	21050	-12550	0.05	0.63	59	37	-22
0001	3T	nopattern	153	2	0	200	0	-200	0.00	0.00	0	0	0
0001	3T	nopattern	154	4	0	400	0	-400	0.00	0.00	0	0	0
0001	3T	nopattern	156	115	5	11500	8950	-2550	0.04	0.78	20	15	-5
0001	3T	nopattern	162	5	0	500	0	-500	0.00	0.00	0	0	0
0001	3T	nopattern	163	4	1	400	2180	1780	0.25	5.45	0	3	3
0001	3T	nopattern	164	8	1	800	1260	460	0.13	1.58	1	2	1
0001	3T	nopattern	165	12	0	1200	0	-1200	0.00	0.00	2	0	-2
0001	3T	nopattern	214	2	0	200	0	-200	0.00	0.00	0	0	0
0001	3T	nopattern	216	6	0	600	0	-600	0.00	0.00	1	0	-1
0001	3T	nopattern	234	15	0	1500	0	-1500	0.00	0.00	2	0	-2
0001	3T	nopattern	235	12	0	1200	0	-1200	0.00	0.00	2	0	-2
0001	3T	nopattern	236	11	1	1100	590	-510	0.09	0.54	1	1	0
0001	3T	nopattern	245	6	1	600	850	250	0.17	1.42	1	1	0
0001	3T	nopattern	246	6	1	600	1190	590	0.17	1.98	1	2	1
0001	3T	nopattern	253	1	0	100	0	-100	0.00	0.00	0	0	0
0001	3T	nopattern	256	14	1	1400	730	-670	0.07	0.52	2	1	-1
0001	3T	nopattern	263	1	0	100	0	-100	0.00	0.00	0	0	0
0001	3T	nopattern	264	2	0	200	0	-200	0.00	0.00	0	0	0
0001	3T	nopattern	265	2	0	200	0	-200	0.00	0.00	0	0	0
0010	2F	1_3	13	888	324	88800	76810	-11990	0.36	0.86	157	135	-22
0010	2F	1_3	14	494	128	49400	36800	-12600	0.26	0.74	87	65	-22
0010	2F	1_3	15	222	44	22200	19380	-2820	0.20	0.87	39	34	-5
0010	2F	1_3	16	280	48	28000	23350	-4650	0.17	0.83	49	41	-8
0010	2F	1_3	23	76	18	7600	8920	1320	0.24	1.17	13	15	2
0010	2F	1_3	24	90	16	9000	7620	-1380	0.18	0.85	15	13	-2
0010	2F	1_3	25	64	8	6400	4750	-1650	0.13	0.74	11	8	-3
0010	2F	1_3	26	95	13	9500	5770	-3730	0.14	0.61	16	10	-6
0010	2F	1_4	12	985	312	98500	87670	-10830	0.32	0.89	174	155	-19
0010	2F	1_4	13	497	156	49700	39320	-10380	0.31	0.79	87	69	-18
0010	2F	1_4	14	322	76	32200	24290	-7910	0.24	0.75	56	42	-14
0010	2F	1_4	15	73	12	7300	5860	-1440	0.16	0.80	12	10	-2
0010	2F	1_4	16	41	7	4100	5860	1760	0.17	1.43	7	10	3
0010	2F	1_4	23	10	2	1000	480	-520	0.20	0.48	1	0	-1
0010	2F	1_4	24	13	1	1300	240	-1060	0.08	0.18	2	0	-2
0010	2F	1_4	25	10	1	1000	1240	240	0.10	1.24	1	2	1
0010	2F	1_4	26	10	0	1000	0	-1000	0.00	0.00	1	0	-1
0010	2F	1_5	12	182	48	18200	11310	-6890	0.26	0.62	32	20	-12
0010	2F	1_5	13	99	19	9900	6690	-3210	0.19	0.68	17	11	-6
0010	2F	1_5	14	55	16	5500	5290	-210	0.29	0.96	9	9	0
0010	2F	1_5	15	4	0	400	0	-400	0.00	0.00	0	0	0
0010	2F	1_5	26	1	0	100	0	-100	0.00	0.00	0	0	0
0010	2F	1_6	12	949	267	94900	73070	-21830	0.28	0.77	167	129	-38
0010	2F	1_6	13	131	28	13100	8300	-4800	0.21	0.63	23	14	-9
0010	2F	1_6	14	19	7	1900	2420	520	0.37	1.27	3	4	1
0010	2F	2_-1	12	10	1	1000	200	-800	0.10	0.20	1	0	-1
0010	2F	2_-1	13	3	1	300	170	-130	0.33	0.57	0	0	0
0010	2F	2_-1	14	7	3	700	800	100	0.43	1.14	1	1	0
0010	2F	2_-1	16	1	0	100	0	-100	0.00	0.00	0	0	0
0010	2F	2_0	12	231	78	23100	21760	-1340	0.34	0.94	40	38	-2
0010	2F	2_0	13	158	37	15800	12790	-3010	0.23	0.81	27	22	-5
0008	1T	01	1	2558	1481	255800	230960	-24840	0.58	0.90	452	408	-44
0008	1T	01	2	252	94	25200	24660	-540	0.37	0.98	44	43	-1
0008	1T	02	1	2557	1244	255700	223080	-32620	0.49	0.87	452	394	-58
0008	1T	02	2	337	118	33700	26530	-7170	0.35	0.79	59	46	-13
0008	1T	03	1	1896	953	189600	177780	-11820	0.50	0.94	335	314	-21
0008	1T	03	2	292	98	29200	22920	-6280	0.34	0.78	51	40	-11
0008	1T	04	1	2237	1128	223700	201610	-22090	0.50	0.90	395	356	-39
0008	1T	04	2	277	94	27700	23650	-4050	0.34	0.85	49	41	-8
0008	1T	05	1	2585	1503	258500	252380	-6120	0.58	0.98	457	446	-11
0008	1T	05	2	356	133	35600	31780	-3820	0.37	0.89	63	56	-7
0008	1T	06	1	2822	1504	282200	249010	-33190	0.53	0.88	499	440	-59
0008	1T	06	2	360	130	36000	30380	-5620	0.36	0.84	63	53	-10
0008	1T	07	1	2937	1728	293700	280440	-13260	0.59	0.95	519	496	-23
0008	1T	07	2	291	106	29100	26720	-2380	0.36	0.92	51	47	-4
0008	1T	08	1	2837	1692	283700	265180	-18520	0.60	0.93	502	469	-33
0008	1T	08	2	243	83	24300	20170	-4130	0.34	0.83	43	35	-8
0008	1T	09	1	2912	1791	291200	278640	-12560	0.62	0.96	515	493	-22
0008	1T	09	2	319	131	31900	29110	-2790	0.41	0.91	56	51	-5
0008	1T	10	1	2651	1535	265100	236190	-28910	0.58	0.89	469	418	-51
0008	1T	10	2	323	134	32300	30560	-1740	0.41	0.95	57	54	-3
0008	1T	11	1	2342	1270	234200	205610	-28590	0.54	0.88	414	363	-51
0008	1T	11	2	381	126	38100	33070	-5030	0.33	0.87	67	58	-9
0008	1T	12	1	2606	1550	260600	238770	-21830	0.59	0.92	461	422	-39
0008	1T	12	2	236	99	23600	24650	1050	0.42	1.04	41	43	2
0008	1T	13	1	2508	1534	250800	233550	-17250	0.61	0.93	443	413	-30
0008	1T	13	2	265	89	26500	19570	-6930	0.34	0.74	46	34	-12
0008	1T	14	1	2411	1276	241100	210320	-30780	0.53	0.87	426	372	-54
0008	1T	14	2	284	112	28400	27580	-820	0.39	0.97	50	48	-2
0008	1T	15	1	2936	1650	293600	260850	-32750	0.56	0.89	519	461	-58
0008	1T	15	2	271	92	27100	24290	-2810	0.34	0.90	47	42	-5
0008	1T	16	1	2977	1784	297700	272690	-25010	0.60	0.92	526	482	-44
0008	1T	16	2	284	90	28400	23810	-4590	0.32	0.84	50	42	-8
0008	1T	17	1	2896	1738	289600	278120	-11480	0.60	0.96	512	492	-20
0008	1T	17	2	289	121	28900	28870	-30	0.42	1.00	51	51	0
0008	1T	18	1	3064	2099	306400	290110	-16290	0.69	0.95	542	513	-29
0008	1T	18	2	330	140	33000	26440	-6560	0.42	0.80	58	46	-12
0008	1T	19	1	2639	1605	263900	241780	-22120	0.61	0.92	467	427	-40
0008	1T	19	2	230	86	23000	21570	-1430	0.37	0.94	40	38	-2
0008	1T	20	1	2953	1680	295300	267260	-28040	0.57	0.91	522	473	-49
0008	1T	20	2	140	53	14000	11950	-2050	0.38	0.85	24	21	-3
0008	1T	21	1	3079	1958	307900	279180	-28720	0.64	0.91	544	494	-50
0008	1T	21	2	129	58	12900	12960	60	0.45	1.00	22	22	0
0008	1T	22	1	2348	1346	234800	219020	-15780	0.57	0.93	415	387	-28
0008	1T	22	2	338	114	33800	27130	-6670	0.34	0.80	59	48	-11
0008	1T	23	1	2654	1544	265400	247980	-17420	0.58	0.93	469	438	-31
0008	1T	23	2	224	80	22400	17410	-4990	0.36	0.78	39	30	-9
0008	1T	24	1	2913	2061	291300	283170	-8130	0.71	0.97	515	501	-14
0008	1T	24	2	180	81	18000	17930	-70	0.45	1.00	31	31	0
0008	2F	01	12	1686	504	168600	137020	-31580	0.30	0.81	298	242	-56
0008	2F	01	13	332	107	33200	28060	-5140	0.32	0.85	58	49	-9
0008	2F	01	14	198	58	19800	16430	-3370	0.29	0.83	35	29	-6
0008	2F	01	15	238	75	23800	18350	-5450	0.32	0.77	42	32	-10
0008	2F	01	16	23	4	2300	1420	-880	0.17	0.62	4	2	-2
0008	2F	01	23	18	4	1800	1460	-340	0.22	0.81	3	2	-1
0008	2F	01	24	10	1	1000	350	-650	0.10	0.35	1	0	-1
0008	2F	01	25	2	0	200	0	-200	0.00	0.00	0	0	0
0008	2F	01	26	4	1	400	330	-70	0.25	0.83	0	0	0
0008	2F	02	12	1563	427	156300	135040	-21260	0.27	0.86	276	239	-37
0008	2F	02	13	538	135	53800	44790	-9010	0.25	0.83	95	79	-16
0008	2F	02	14	258	62	25800	20470	-5330	0.24	0.79	45	36	-9
0008	2F	02	15	64	9	6400	4130	-2270	0.14	0.65	11	7	-4
0008	2F	02	16	33	3	3300	940	-2360	0.09	0.28	5	1	-4
0008	2F	02	23	41	11	4100	4660	560	0.27	1.14	7	8	1
0008	2F	02	24	11	0	1100	0	-1100	0.00	0.00	1	0	-1
0008	2F	02	25	15	2	1500	740	-760	0.13	0.49	2	1	-1
0008	2F	02	26	3	0	300	0	-300	0.00	0.00	0	0	0
0008	2F	03	12	1017	326	101700	86020	-15680	0.32	0.85	180	152	-28
0008	2F	03	13	437	111	43700	35830	-7870	0.25	0.82	77	63	-14
0008	2F	03	14	214	55	21400	18340	-3060	0.26	0.86	37	32	-5
0008	2F	03	15	112	24	11200	11090	-110	0.21	0.99	19	19	0
0008	2F	03	16	49	11	4900	7650	2750	0.22	1.56	8	13	5
0008	2F	03	23	28	6	2800	2040	-760	0.21	0.73	4	3	-1
0008	2F	03	24	14	2	1400	1070	-330	0.14	0.76	2	1	-1
0008	2F	03	25	14	5	1400	1620	220	0.36	1.16	2	2	0
0008	2F	03	26	7	1	700	290	-410	0.14	0.41	1	0	-1
0008	2F	04	12	1197	357	119700	116230	-3470	0.30	0.97	211	205	-6
0008	2F	04	13	581	152	58100	46180	-11920	0.26	0.79	102	81	-21
0008	2F	04	14	226	47	22600	14650	-7950	0.21	0.65	40	25	-15
0008	2F	04	15	110	23	11000	9400	-1600	0.21	0.85	19	16	-3
0008	2F	04	16	83	17	8300	6280	-2020	0.20	0.76	14	11	-3
0008	2F	04	23	27	9	2700	2920	220	0.33	1.08	4	5	1
0008	2F	04	24	17	6	1700	1410	-290	0.35	0.83	3	2	-1
0008	2F	04	25	17	1	1700	720	-980	0.06	0.42	3	1	-2
0008	2F	04	26	11	1	1100	310	-790	0.09	0.28	1	0	-1
0008	2F	05	12	1465	447	146500	130210	-16290	0.31	0.89	259	230	-29
0008	2F	05	13	557	155	55700	43860	-11840	0.28	0.79	98	77	-21
0008	2F	05	14	365	101	36500	25910	-10590	0.28	0.71	64	45	-19
0008	2F	05	15	91	17	9100	6560	-2540	0.19	0.72	16	11	-5
0008	2F	05	16	50	9	5000	4600	-400	0.18	0.92	8	8	0
0008	2F	05	23	34	10	3400	2960	-440	0.29	0.87	6	5	-1
0008	2F	05	24	14	2	1400	530	-870	0.14	0.38	2	0	-2
0008	2F	05	25	21	4	2100	1500	-600	0.19	0.71	3	2	-1
0008	2F	05	26	15	3	1500	1040	-460	0.20	0.69	2	1	-1
0008	2F	06	12	1536	485	153600	145680	-7920	0.32	0.95	271	257	-14
0008	2F	06	13	713	188	71300	49400	-21900	0.26	0.69	126	87	-39
0008	2F	06	14	324	88	32400	35080	2680	0.27	1.08	57	62	5
0008	2F	06	15	105	28	10500	10480	-20	0.27	1.00	18	18	0
0008	2F	06	16	69	14	6900	6330	-570	0.20	0.92	12	11	-1
0008	2F	06	23	23	3	2300	1450	-850	0.13	0.63	4	2	-2
0008	2F	06	24	12	4	1200	1760	560	0.33	1.47	2	3	1
0008	2F	06	25	17	0	1700	0	-1700	0.00	0.00	3	0	-3
0008	2F	06	26	23	3	2300	1270	-1030	0.13	0.55	4	2	-2
0008	2F	07	12	1542	456	154200	126370	-27830	0.30	0.82	272	223	-49
0008	2F	07	13	736	255	73600	64740	-8860	0.35	0.88	130	114	-16
0008	2F	07	14	379	112	37900	30620	-7280	0.30	0.81	67	54	-13
0008	2F	07	15	118	20	11800	6840	-4960	0.17	0.58	20	12	-8
0008	2F	07	16	73	13	7300	5490	-1810	0.18	0.75	12	9	-3
0008	2F	07	23	18	2	1800	960	-840	0.11	0.53	3	1	-2
0008	2F	07	24	9	0	900	0	-900	0.00	0.00	1	0	-1
0008	2F	07	25	16	1	1600	550	-1050	0.06	0.34	2	0	-2
0008	2F	07	26	11	2	1100	670	-430	0.18	0.61	1	1	0
0008	2F	08	12	1542	503	154200	133580	-20620	0.33	0.87	272	236	-36
0008	2F	08	13	654	196	65400	50000	-15400	0.30	0.76	115	88	-27
0008	2F	08	14	338	88	33800	22720	-11080	0.26	0.67	59	40	-19
0008	2F	08	15	109	23	10900	9400	-1500	0.21	0.86	19	16	-3
0008	2F	08	16	120	30	12000	12680	680	0.25	1.06	21	22	1
0008	2F	08	23	15	2	1500	670	-830	0.13	0.45	2	1	-1
0008	2F	08	24	8	1	800	260	-540	0.13	0.33	1	0	-1
0008	2F	08	25	10	4	1000	1890	890	0.40	1.89	1	3	2
0008	2F	08	26	17	2	1700	1060	-640	0.12	0.62	3	1	-2
0008	2F	09	12	1829	632	182900	152580	-30320	0.35	0.83	323	270	-53
0008	2F	09	13	651	203	65100	54150	-10950	0.31	0.83	115	95	-20
0008	2F	09	14	254	58	25400	15610	-9790	0.23	0.61	44	27	-17
0008	2F	09	15	61	10	6100	5280	-820	0.16	0.87	10	9	-1
0008	2F	09	16	71	10	7100	5530	-1570	0.14	0.78	12	9	-3
0008	2F	09	23	25	5	2500	1580	-920	0.20	0.63	4	2	-2
0008	2F	09	24	8	1	800	450	-350	0.13	0.56	1	0	-1
0008	2F	09	25	8	1	800	410	-390	0.13	0.51	1	0	-1
0008	2F	09	26	25	5	2500	2430	-70	0.20	0.97	4	4	0
0008	2F	10	12	1523	570	152300	129030	-23270	0.37	0.85	269	228	-41
0008	2F	10	13	690	224	69000	51400	-17600	0.32	0.74	122	90	-32
0008	2F	10	14	298	93	29800	29890	90	0.31	1.00	52	52	0
0008	2F	10	15	64	11	6400	4790	-1610	0.17	0.75	11	8	-3
0008	2F	10	16	59	10	5900	6810	910	0.17	1.15	10	12	2
0008	2F	10	23	16	7	1600	1980	380	0.44	1.24	2	3	1
0008	2F	10	24	18	5	1800	1610	-190	0.28	0.89	3	2	-1
0008	2F	10	25	17	2	1700	640	-1060	0.12	0.38	3	1	-2
0008	2F	10	26	21	10	2100	4180	2080	0.48	1.99	3	7	4
0008	2F	11	12	1608	553	160800	153830	-6970	0.34	0.96	284	272	-12
0008	2F	11	13	498	157	49800	44830	-4970	0.32	0.90	88	79	-9
0008	2F	11	14	169	44	16900	12860	-4040	0.26	0.76	29	22	-7
0008	2F	11	15	36	6	3600	3020	-580	0.17	0.84	6	5	-1
0008	2F	11	16	16	2	1600	1800	200	0.13	1.13	2	3	1
0008	2F	11	23	102	19	10200	9220	-980	0.19	0.90	18	16	-2
0008	2F	11	24	17	1	1700	320	-1380	0.06	0.19	3	0	-3
0008	2F	11	25	6	0	600	0	-600	0.00	0.00	1	0	-1
0008	2F	12	12	1657	524	165700	134560	-31140	0.32	0.81	293	238	-55
0008	2F	12	13	420	120	42000	29980	-12020	0.29	0.71	74	53	-21
0008	2F	12	14	257	58	25700	17570	-8130	0.23	0.68	45	31	-14
0008	2F	12	15	124	25	12400	10140	-2260	0.20	0.82	21	17	-4
0008	2F	12	16	69	17	6900	5100	-1800	0.25	0.74	12	9	-3
0008	2F	12	23	25	11	2500	2820	320	0.44	1.13	4	4	0
0008	2F	12	24	14	2	1400	290	-1110	0.14	0.21	2	0	-2
0008	2F	12	25	9	2	900	1790	890	0.22	1.99	1	3	2
0008	2F	12	26	1	0	100	0	-100	0.00	0.00	0	0	0
0008	2F	13	12	1340	449	134000	113500	-20500	0.34	0.85	237	200	-37
0008	2F	13	13	613	200	61300	49800	-11500	0.33	0.81	108	88	-20
0008	2F	13	14	354	118	35400	31470	-3930	0.33	0.89	62	55	-7
0008	2F	13	15	104	26	10400	8940	-1460	0.25	0.86	18	15	-3
0008	2F	13	16	49	14	4900	4630	-270	0.29	0.94	8	8	0
0008	2F	13	23	23	4	2300	1320	-980	0.17	0.57	4	2	-2
0008	2F	13	24	6	0	600	0	-600	0.00	0.00	1	0	-1
0008	2F	13	25	15	0	1500	0	-1500	0.00	0.00	2	0	-2
0008	2F	13	26	8	1	800	300	-500	0.13	0.38	1	0	-1
0008	2F	14	12	1353	401	135300	108120	-27180	0.30	0.80	239	191	-48
0008	2F	14	13	528	127	52800	34760	-18040	0.24	0.66	93	61	-32
0008	2F	14	14	315	81	31500	21220	-10280	0.26	0.67	55	37	-18
0008	2F	14	15	94	16	9400	7400	-2000	0.17	0.79	16	13	-3
0008	2F	14	16	55	10	5500	3560	-1940	0.18	0.65	9	6	-3
0008	2F	14	23	24	10	2400	3820	1420	0.42	1.59	4	6	2
0008	2F	14	24	17	4	1700	1180	-520	0.24	0.69	3	2	-1
0008	2F	14	25	11	0	1100	0	-1100	0.00	0.00	1	0	-1
0008	2F	14	26	13	2	1300	780	-520	0.15	0.60	2	1	-1
0008	2F	15	12	1693	513	169300	129370	-39930	0.30	0.76	299	228	-71
0008	2F	15	13	686	207	68600	53860	-14740	0.30	0.79	121	95	-26
0008	2F	15	14	307	96	30700	30300	-400	0.31	0.99	54	53	-1
0008	2F	15	15	97	17	9700	7360	-2340	0.18	0.76	17	13	-4
0008	2F	15	16	67	23	6700	10240	3540	0.34	1.53	11	18	7
0008	2F	15	23	21	3	2100	2180	80	0.14	1.04	3	3	0
0008	2F	15	24	9	1	900	710	-190	0.11	0.79	1	1	0
0008	2F	15	25	8	2	800	490	-310	0.25	0.61	1	0	-1
0008	2F	15	26	11	0	1100	0	-1100	0.00	0.00	1	0	-1
0008	2F	16	12	1690	566	169000	145420	-23580	0.33	0.86	299	257	-42
0008	2F	16	13	593	153	59300	38980	-20320	0.26	0.66	104	68	-36
0008	2F	16	14	448	156	44800	38280	-6520	0.35	0.85	79	67	-12
0008	2F	16	15	99	22	9900	10530	630	0.22	1.06	17	18	1
0008	2F	16	16	64	12	6400	7700	1300	0.19	1.20	11	13	2
0008	2F	16	23	16	3	1600	2400	800	0.19	1.50	2	4	2
0008	2F	16	24	10	4	1000	2400	1400	0.40	2.40	1	4	3
0008	2F	16	25	6	1	600	260	-340	0.17	0.43	1	0	-1
0008	2F	16	26	15	0	1500	0	-1500	0.00	0.00	2	0	-2
0008	2F	17	12	1669	516	166900	124130	-42770	0.31	0.74	295	219	-76
0008	2F	17	13	687	246	68700	58270	-10430	0.36	0.85	121	103	-18
0008	2F	17	14	338	82	33800	24100	-9700	0.24	0.71	59	42	-17
0008	2F	17	15	77	14	7700	5160	-2540	0.18	0.67	13	9	-4
0008	2F	17	16	37	3	3700	1610	-2090	0.08	0.44	6	2	-4
0008	2F	17	23	21	1	2100	330	-1770	0.05	0.16	3	0	-3
0008	2F	17	24	19	5	1900	1060	-840	0.26	0.56	3	1	-2
0008	2F	17	25	14	4	1400	1390	-10	0.29	0.99	2	2	0
0008	2F	17	26	10	2	1000	1020	20	0.20	1.02	1	1	0
0008	2F	18	12	1806	712	180600	159740	-20860	0.39	0.88	319	282	-37
0008	2F	18	13	637	194	63700	50640	-13060	0.30	0.79	112	89	-23
0008	2F	18	14	382	106	38200	30200	-8000	0.28	0.79	67	53	-14
0008	2F	18	15	120	31	12000	11480	-520	0.26	0.96	21	20	-1
0008	2F	18	16	80	17	8000	8270	270	0.21	1.03	14	14	0
0008	2F	18	23	18	2	1800	920	-880	0.11	0.51	3	1	-2
0008	2F	18	24	10	1	1000	340	-660	0.10	0.34	1	0	-1
0008	2F	18	25	13	1	1300	1060	-240	0.08	0.82	2	1	-1
0008	2F	18	26	18	5	1800	3030	1230	0.28	1.68	3	5	2
0008	2F	19	12	1380	444	138000	115860	-22140	0.32	0.84	244	205	-39
0008	2F	19	13	659	235	65900	51590	-14310	0.36	0.78	116	91	-25
0008	2F	19	14	428	139	42800	35760	-7040	0.32	0.84	75	63	-12
0008	2F	19	15	41	6	4100	2070	-2030	0.15	0.50	7	3	-4
0008	2F	19	16	57	9	5700	4590	-1110	0.16	0.81	10	8	-2
0008	2F	19	23	16	5	1600	2550	950	0.31	1.59	2	4	2
0008	2F	19	24	11	1	1100	280	-820	0.09	0.25	1	0	-1
0008	2F	19	25	2	0	200	0	-200	0.00	0.00	0	0	0
0008	2F	19	26	16	4	1600	1110	-490	0.25	0.69	2	1	-1
0008	2F	20	12	1645	558	164500	135340	-29160	0.34	0.82	291	239	-52
0008	2F	20	13	677	239	67700	59560	-8140	0.35	0.88	119	105	-14
0008	2F	20	14	361	96	36100	25120	-10980	0.27	0.70	63	44	-19
0008	2F	20	15	113	30	11300	10340	-960	0.27	0.92	20	18	-2
0008	2F	20	16	94	21	9400	7730	-1670	0.22	0.82	16	13	-3
0008	2F	20	23	5	0	500	0	-500	0.00	0.00	0	0	0
0008	2F	20	24	2	1	200	230	30	0.50	1.15	0	0	0
0008	2F	20	25	3	0	300	0	-300	0.00	0.00	0	0	0
0008	2F	20	26	5	1	500	240	-260	0.20	0.48	0	0	0
0008	2F	21	12	1737	593	173700	141370	-32330	0.34	0.81	307	250	-57
0008	2F	21	13	798	314	79800	70240	-9560	0.39	0.88	141	124	-17
0008	2F	21	14	433	160	43300	35040	-8260	0.37	0.81	76	62	-14
0008	2F	21	15	57	9	5700	2510	-3190	0.16	0.44	10	4	-6
0008	2F	21	16	26	4	2600	2040	-560	0.15	0.78	4	3	-1
0008	2F	21	23	7	3	700	560	-140	0.43	0.80	1	0	-1
0008	2F	21	24	3	0	300	0	-300	0.00	0.00	0	0	0
0008	2F	21	25	2	0	200	0	-200	0.00	0.00	0	0	0
0008	2F	21	26	4	1	400	430	30	0.25	1.08	0	0	0
0008	2F	22	12	1472	508	147200	136590	-10610	0.35	0.93	260	241	-19
0008	2F	22	13	462	132	46200	35060	-11140	0.29	0.76	81	62	-19
0008	2F	22	14	260	61	26000	15570	-10430	0.23	0.60	46	27	-19
0008	2F	22	15	33	9	3300	3550	250	0.27	1.08	5	6	1
0008	2F	22	16	28	6	2800	4540	1740	0.21	1.62	4	8	4
0008	2F	22	23	26	6	2600	1710	-890	0.23	0.66	4	3	-1
0008	2F	22	24	8	1	800	680	-120	0.13	0.85	1	1	0
0008	2F	22	25	8	1	800	680	-120	0.13	0.85	1	1	0
0008	2F	22	26	4	1	400	320	-80	0.25	0.80	0	0	0
0008	2F	23	12	1620	534	162000	131820	-30180	0.33	0.81	286	233	-53
0008	2F	23	13	585	200	58500	44510	-13990	0.34	0.76	103	78	-25
0008	2F	23	14	275	80	27500	20610	-6890	0.29	0.75	48	36	-12
0008	2F	23	15	77	22	7700	10460	2760	0.29	1.36	13	18	5
0008	2F	23	16	13	2	1300	340	-960	0.15	0.26	2	0	-2
0008	2F	23	23	19	3	1900	1070	-830	0.16	0.56	3	1	-2
0008	2F	23	24	9	3	900	1730	830	0.33	1.92	1	3	2
0008	2F	23	25	11	3	1100	1120	20	0.27	1.02	1	1	0
0008	2F	23	26	3	0	300	0	-300	0.00	0.00	0	0	0
0008	2F	24	12	1673	581	167300	133830	-33470	0.35	0.80	296	236	-60
0008	2F	24	13	727	246	72700	54890	-17810	0.34	0.76	128	97	-31
0008	2F	24	14	293	97	29300	23000	-6300	0.33	0.78	51	40	-11
0008	2F	24	15	85	27	8500	8950	450	0.32	1.05	15	15	0
0008	2F	24	16	55	20	5500	4710	-790	0.36	0.86	9	8	-1
0008	2F	24	23	20	5	2000	1920	-80	0.25	0.96	3	3	0
0008	2F	24	24	7	3	700	1060	360	0.43	1.51	1	1	0
0008	2F	24	26	4	0	400	0	-400	0.00	0.00	0	0	0
0008	2T	01	12	1681	394	168100	136540	-31560	0.23	0.81	297	241	-56
0008	2T	01	13	332	73	33200	26180	-7020	0.22	0.79	58	46	-12
0008	2T	01	14	198	40	19800	15700	-4100	0.20	0.79	35	27	-8
0008	2T	01	15	238	52	23800	18480	-5320	0.22	0.78	42	32	-10
0008	2T	01	16	23	4	2300	2020	-280	0.17	0.88	4	3	-1
0008	2T	01	21	5	2	500	1790	1290	0.40	3.58	0	3	3
0008	2T	01	23	18	3	1800	1630	-170	0.17	0.91	3	2	-1
0008	2T	01	24	10	0	1000	0	-1000	0.00	0.00	1	0	-1
0008	2T	01	25	2	0	200	0	-200	0.00	0.00	0	0	0
0008	2T	01	26	4	1	400	710	310	0.25	1.78	0	1	1
0008	2T	02	12	1562	321	156200	145110	-11090	0.21	0.93	276	256	-20
0008	2T	02	13	538	94	53800	42130	-11670	0.17	0.78	95	74	-21
0008	2T	02	14	258	37	25800	18170	-7630	0.14	0.70	45	32	-13
0008	2T	02	15	64	4	6400	4070	-2330	0.06	0.64	11	7	-4
0008	2T	02	16	33	3	3300	1660	-1640	0.09	0.50	5	2	-3
0008	2T	02	21	1	0	100	0	-100	0.00	0.00	0	0	0
0008	2T	02	23	41	6	4100	4010	-90	0.15	0.98	7	7	0
0008	2T	02	24	11	0	1100	0	-1100	0.00	0.00	1	0	-1
0008	2T	02	25	15	1	1500	670	-830	0.07	0.45	2	1	-1
0008	2T	02	26	3	0	300	0	-300	0.00	0.00	0	0	0
0008	2T	03	12	1016	218	101600	86560	-15040	0.21	0.85	179	153	-26
0008	2T	03	13	437	84	43700	36920	-6780	0.19	0.84	77	65	-12
0008	2T	03	14	214	44	21400	20980	-420	0.21	0.98	37	37	0
0008	2T	03	15	112	20	11200	13920	2720	0.18	1.24	19	24	5
0008	2T	03	16	49	6	4900	6520	1620	0.12	1.33	8	11	3
0008	2T	03	21	1	0	100	0	-100	0.00	0.00	0	0	0
0008	2T	03	23	28	5	2800	2730	-70	0.18	0.98	4	4	0
0008	2T	03	24	14	1	1400	1650	250	0.07	1.18	2	2	0
0008	2T	03	25	14	3	1400	1760	360	0.21	1.26	2	3	1
0008	2T	03	26	7	1	700	610	-90	0.14	0.87	1	1	0
0008	2T	04	12	1194	241	119400	106490	-12910	0.20	0.89	211	188	-23
0008	2T	04	13	581	114	58100	48010	-10090	0.20	0.83	102	84	-18
0008	2T	04	14	226	32	22600	15380	-7220	0.14	0.68	40	27	-13
0008	2T	04	15	110	14	11000	7560	-3440	0.13	0.69	19	13	-6
0008	2T	04	16	83	13	8300	7960	-340	0.16	0.96	14	14	0
0008	2T	04	21	3	0	300	0	-300	0.00	0.00	0	0	0
0008	2T	04	23	27	6	2700	3120	420	0.22	1.16	4	5	1
0008	2T	04	24	17	4	1700	1560	-140	0.24	0.92	3	2	-1
0008	2T	04	25	17	0	1700	0	-1700	0.00	0.00	3	0	-3
0008	2T	04	26	11	0	1100	0	-1100	0.00	0.00	1	0	-1
0008	2T	05	12	1463	332	146300	136060	-10240	0.23	0.93	258	240	-18
0008	2T	05	13	557	109	55700	41690	-14010	0.20	0.75	98	73	-25
0008	2T	05	14	365	72	36500	28200	-8300	0.20	0.77	64	49	-15
0008	2T	05	15	91	12	9100	7460	-1640	0.13	0.82	16	13	-3
0008	2T	05	16	50	8	5000	9090	4090	0.16	1.82	8	16	8
0008	2T	05	21	2	1	200	700	500	0.50	3.50	0	1	1
0008	2T	05	23	34	5	3400	2620	-780	0.15	0.77	6	4	-2
0008	2T	05	24	14	1	1400	390	-1010	0.07	0.28	2	0	-2
0008	2T	05	25	21	3	2100	1760	-340	0.14	0.84	3	3	0
0008	2T	05	26	15	3	1500	1440	-60	0.20	0.96	2	2	0
0008	2T	06	12	1533	349	153300	139180	-14120	0.23	0.91	271	246	-25
0008	2T	06	13	713	132	71300	49550	-21750	0.19	0.69	126	87	-39
0008	2T	06	14	324	62	32400	33840	1440	0.19	1.04	57	59	2
0008	2T	06	15	105	18	10500	9930	-570	0.17	0.95	18	17	-1
0008	2T	06	16	69	12	6900	7990	1090	0.17	1.16	12	14	2
0008	2T	06	21	3	1	300	660	360	0.33	2.20	0	1	1
0008	2T	06	23	23	2	2300	910	-1390	0.09	0.40	4	1	-3
0008	2T	06	24	12	3	1200	1820	620	0.25	1.52	2	3	1
0008	2T	06	25	17	0	1700	0	-1700	0.00	0.00	3	0	-3
0008	2T	06	26	23	1	2300	810	-1490	0.04	0.35	4	1	-3
0008	2T	07	12	1540	349	154000	126510	-27490	0.23	0.82	272	223	-49
0008	2T	07	13	736	185	73600	67320	-6280	0.25	0.91	130	119	-11
0008	2T	07	14	379	87	37900	32620	-5280	0.23	0.86	67	57	-10
0008	2T	07	15	118	13	11800	5990	-5810	0.11	0.51	20	10	-10
0008	2T	07	16	73	10	7300	7670	370	0.14	1.05	12	13	1
0008	2T	07	21	2	0	200	0	-200	0.00	0.00	0	0	0
0008	2T	07	23	18	1	1800	370	-1430	0.06	0.21	3	0	-3
0008	2T	07	24	9	0	900	0	-900	0.00	0.00	1	0	-1
0008	2T	07	25	16	1	1600	480	-1120	0.06	0.30	2	0	-2
0008	2T	07	26	11	1	1100	240	-860	0.09	0.22	1	0	-1
0008	2T	08	12	1538	395	153800	130580	-23220	0.26	0.85	272	231	-41
0008	2T	08	13	654	145	65400	51910	-13490	0.22	0.79	115	91	-24
0008	2T	08	14	338	60	33800	23160	-10640	0.18	0.69	59	40	-19
0008	2T	08	15	109	15	10900	9300	-1600	0.14	0.85	19	16	-3
0008	2T	08	16	120	25	12000	13810	1810	0.21	1.15	21	24	3
0008	2T	08	21	4	0	400	0	-400	0.00	0.00	0	0	0
0008	2T	08	23	15	1	1500	290	-1210	0.07	0.19	2	0	-2
0008	2T	08	24	8	0	800	0	-800	0.00	0.00	1	0	-1
0008	2T	08	25	10	4	1000	3270	2270	0.40	3.27	1	5	4
0008	2T	08	26	17	1	1700	920	-780	0.06	0.54	3	1	-2
0008	2T	09	12	1827	469	182700	138810	-43890	0.26	0.76	323	245	-78
0008	2T	09	13	651	143	65100	53460	-11640	0.22	0.82	115	94	-21
0008	2T	09	14	254	42	25400	15440	-9960	0.17	0.61	44	27	-17
0008	2T	09	15	61	7	6100	6850	750	0.11	1.12	10	12	2
0008	2T	09	16	71	7	7100	5990	-1110	0.10	0.84	12	10	-2
0008	2T	09	21	2	0	200	0	-200	0.00	0.00	0	0	0
0008	2T	09	23	25	3	2500	1960	-540	0.12	0.78	4	3	-1
0008	2T	09	24	8	1	800	790	-10	0.13	0.99	1	1	0
0008	2T	09	25	8	1	800	720	-80	0.13	0.90	1	1	0
0008	2T	09	26	25	2	2500	1800	-700	0.08	0.72	4	3	-1
0008	2T	10	12	1519	408	151900	118710	-33190	0.27	0.78	268	210	-58
0008	2T	10	13	690	155	69000	47570	-21430	0.22	0.69	122	84	-38
0008	2T	10	14	298	70	29800	28460	-1340	0.23	0.96	52	50	-2
0008	2T	10	15	64	8	6400	5350	-1050	0.13	0.84	11	9	-2
0008	2T	10	16	59	4	5900	2810	-3090	0.07	0.48	10	4	-6
0008	2T	10	21	4	0	400	0	-400	0.00	0.00	0	0	0
0008	2T	10	23	16	6	1600	2920	1320	0.38	1.83	2	5	3
0008	2T	10	24	18	2	1800	710	-1090	0.11	0.39	3	1	-2
0008	2T	10	25	17	0	1700	0	-1700	0.00	0.00	3	0	-3
0008	2T	10	26	21	5	2100	2990	890	0.24	1.42	3	5	2
0008	2T	11	12	1596	383	159600	136430	-23170	0.24	0.85	282	241	-41
0008	2T	11	13	498	102	49800	39610	-10190	0.20	0.80	88	70	-18
0008	2T	11	14	169	25	16900	9690	-7210	0.15	0.57	29	17	-12
0008	2T	11	15	36	3	3600	1380	-2220	0.08	0.38	6	2	-4
0008	2T	11	16	16	2	1600	2690	1090	0.13	1.68	2	4	2
0008	2T	11	21	12	1	1200	1120	-80	0.08	0.93	2	1	-1
0008	2T	11	23	102	11	10200	7360	-2840	0.11	0.72	18	13	-5
0008	2T	11	24	17	0	1700	0	-1700	0.00	0.00	3	0	-3
0008	2T	11	25	6	0	600	0	-600	0.00	0.00	1	0	-1
0008	2T	12	12	1656	408	165600	133760	-31840	0.25	0.81	293	236	-57
0008	2T	12	13	420	90	42000	29040	-12960	0.21	0.69	74	51	-23
0008	2T	12	14	257	42	25700	17600	-8100	0.16	0.68	45	31	-14
0008	2T	12	15	124	21	12400	12860	460	0.17	1.04	21	22	1
0008	2T	12	16	69	15	6900	5850	-1050	0.22	0.85	12	10	-2
0008	2T	12	21	1	0	100	0	-100	0.00	0.00	0	0	0
0008	2T	12	23	25	6	2500	2680	180	0.24	1.07	4	4	0
0008	2T	12	24	14	2	1400	470	-930	0.14	0.34	2	0	-2
0008	2T	12	25	9	0	900	0	-900	0.00	0.00	1	0	-1
0008	2T	12	26	1	0	100	0	-100	0.00	0.00	0	0	0
0008	2T	13	12	1340	350	134000	111700	-22300	0.26	0.83	237	197	-40
0008	2T	13	13	613	138	61300	44470	-16830	0.23	0.73	108	78	-30
0008	2T	13	14	354	97	35400	33710	-1690	0.27	0.95	62	59	-3
0008	2T	13	15	104	19	10400	10620	220	0.18	1.02	18	18	0
0008	2T	13	16	49	10	4900	5170	270	0.20	1.06	8	9	1
0008	2T	13	23	23	2	2300	860	-1440	0.09	0.37	4	1	-3
0008	2T	13	24	6	0	600	0	-600	0.00	0.00	1	0	-1
0008	2T	13	25	15	0	1500	0	-1500	0.00	0.00	2	0	-2
0008	2T	13	26	8	0	800	0	-800	0.00	0.00	1	0	-1
0008	2T	14	12	1353	272	135300	89330	-45970	0.20	0.66	239	158	-81
0008	2T	14	13	528	91	52800	32620	-20180	0.17	0.62	93	57	-36
0008	2T	14	14	315	62	31500	21280	-10220	0.20	0.68	55	37	-18
0008	2T	14	15	94	13	9400	8270	-1130	0.14	0.88	16	14	-2
0008	2T	14	16	55	5	5500	3010	-2490	0.09	0.55	9	5	-4
0008	2T	14	23	24	6	2400	2970	570	0.25	1.24	4	5	1
0008	2T	14	24	17	1	1700	550	-1150	0.06	0.32	3	0	-3
0008	2T	14	25	11	0	1100	0	-1100	0.00	0.00	1	0	-1
0008	2T	14	26	13	2	1300	1280	-20	0.15	0.98	2	2	0
0008	2T	15	12	1691	377	169100	120220	-48880	0.22	0.71	299	212	-87
0008	2T	15	13	686	146	68600	51490	-17110	0.21	0.75	121	91	-30
0008	2T	15	14	307	62	30700	27570	-3130	0.20	0.90	54	48	-6
0008	2T	15	15	97	12	9700	10200	500	0.12	1.05	17	18	1
0008	2T	15	16	67	21	6700	11960	5260	0.31	1.79	11	21	10
0008	2T	15	21	2	0	200	0	-200	0.00	0.00	0	0	0
0008	2T	15	23	21	2	2100	4110	2010	0.10	1.96	3	7	4
0008	2T	15	24	9	0	900	0	-900	0.00	0.00	1	0	-1
0008	2T	15	25	8	2	800	1040	240	0.25	1.30	1	1	0
0008	2T	15	26	11	0	1100	0	-1100	0.00	0.00	1	0	-1
0008	2T	16	12	1688	443	168800	141580	-27220	0.26	0.84	298	250	-48
0008	2T	16	13	593	111	59300	37750	-21550	0.19	0.64	104	66	-38
0008	2T	16	14	448	114	44800	40810	-3990	0.25	0.91	79	72	-7
0008	2T	16	15	99	16	9900	8730	-1170	0.16	0.88	17	15	-2
0008	2T	16	16	64	10	6400	6780	380	0.16	1.06	11	12	1
0008	2T	16	21	2	0	200	0	-200	0.00	0.00	0	0	0
0008	2T	16	23	16	2	1600	3210	1610	0.13	2.01	2	5	3
0008	2T	16	24	10	2	1000	1400	400	0.20	1.40	1	2	1
0008	2T	16	25	6	0	600	0	-600	0.00	0.00	1	0	-1
0008	2T	16	26	15	0	1500	0	-1500	0.00	0.00	2	0	-2
0008	2T	17	12	1669	399	166900	121480	-45420	0.24	0.73	295	215	-80
0008	2T	17	13	687	193	68700	60230	-8470	0.28	0.88	121	106	-15
0008	2T	17	14	338	55	33800	21070	-12730	0.16	0.62	59	37	-22
0008	2T	17	15	77	9	7700	4740	-2960	0.12	0.62	13	8	-5
0008	2T	17	16	37	1	3700	960	-2740	0.03	0.26	6	1	-5
0008	2T	17	23	21	1	2100	470	-1630	0.05	0.22	3	0	-3
0008	2T	17	24	19	4	1900	1950	50	0.21	1.03	3	3	0
0008	2T	17	25	14	3	1400	1770	370	0.21	1.26	2	3	1
0008	2T	17	26	10	2	1000	2370	1370	0.20	2.37	1	4	3
0008	2T	18	12	1805	582	180500	160450	-20050	0.32	0.89	319	283	-36
0008	2T	18	13	637	148	63700	49000	-14700	0.23	0.77	112	86	-26
0008	2T	18	14	382	88	38200	32200	-6000	0.23	0.84	67	56	-11
0008	2T	18	15	120	27	12000	11490	-510	0.23	0.96	21	20	-1
0008	2T	18	16	80	13	8000	9000	1000	0.16	1.13	14	15	1
0008	2T	18	21	1	1	100	420	320	1.00	4.20	0	0	0
0008	2T	18	23	18	0	1800	0	-1800	0.00	0.00	3	0	-3
0008	2T	18	24	10	1	1000	430	-570	0.10	0.43	1	0	-1
0008	2T	18	25	13	0	1300	0	-1300	0.00	0.00	2	0	-2
0008	2T	18	26	18	4	1800	2710	910	0.22	1.51	3	4	1
0008	2T	19	12	1378	334	137800	105960	-31840	0.24	0.77	243	187	-56
0008	2T	19	13	659	165	65900	50370	-15530	0.25	0.76	116	89	-27
0008	2T	19	14	428	105	42800	36400	-6400	0.25	0.85	75	64	-11
0008	2T	19	15	41	2	4100	1510	-2590	0.05	0.37	7	2	-5
0008	2T	19	16	57	6	5700	2950	-2750	0.11	0.52	10	5	-5
0008	2T	19	21	2	1	200	2000	1800	0.50	10.00	0	3	3
0008	2T	19	23	16	3	1600	3650	2050	0.19	2.28	2	6	4
0008	2T	19	24	11	0	1100	0	-1100	0.00	0.00	1	0	-1
0008	2T	19	25	2	0	200	0	-200	0.00	0.00	0	0	0
0008	2T	19	26	16	3	1600	1220	-380	0.19	0.76	2	2	0
0008	2T	20	12	1643	409	164300	128840	-35460	0.25	0.78	290	228	-62
0008	2T	20	13	677	168	67700	52430	-15270	0.25	0.77	119	92	-27
0008	2T	20	14	361	68	36100	25310	-10790	0.19	0.70	63	44	-19
0008	2T	20	15	113	25	11300	12810	1510	0.22	1.13	20	22	2
0008	2T	20	16	94	12	9400	6290	-3110	0.13	0.67	16	11	-5
0008	2T	20	21	2	0	200	0	-200	0.00	0.00	0	0	0
0008	2T	20	23	5	0	500	0	-500	0.00	0.00	0	0	0
0008	2T	20	24	2	0	200	0	-200	0.00	0.00	0	0	0
0008	2T	20	25	3	0	300	0	-300	0.00	0.00	0	0	0
0008	2T	20	26	5	1	500	650	150	0.20	1.30	0	1	1
0008	2T	21	12	1736	462	173600	138850	-34750	0.27	0.80	307	245	-62
0008	2T	21	13	798	248	79800	70580	-9220	0.31	0.88	141	124	-17
0008	2T	21	14	433	107	43300	30160	-13140	0.25	0.70	76	53	-23
0008	2T	21	15	57	5	5700	2130	-3570	0.09	0.37	10	3	-7
0008	2T	21	16	26	4	2600	3170	570	0.15	1.22	4	5	1
0008	2T	21	21	1	0	100	0	-100	0.00	0.00	0	0	0
0008	2T	21	23	7	2	700	610	-90	0.29	0.87	1	1	0
0008	2T	21	24	3	0	300	0	-300	0.00	0.00	0	0	0
0008	2T	21	25	2	0	200	0	-200	0.00	0.00	0	0	0
0008	2T	21	26	4	0	400	0	-400	0.00	0.00	0	0	0
0008	2T	22	12	1464	366	146400	128940	-17460	0.25	0.88	259	228	-31
0008	2T	22	13	462	103	46200	36880	-9320	0.22	0.80	81	65	-16
0008	2T	22	14	260	42	26000	14080	-11920	0.16	0.54	46	24	-22
0008	2T	22	15	33	7	3300	3980	680	0.21	1.21	5	7	2
0008	2T	22	16	28	3	2800	3410	610	0.11	1.22	4	6	2
0008	2T	22	21	8	0	800	0	-800	0.00	0.00	1	0	-1
0008	2T	22	23	26	3	2600	1990	-610	0.12	0.77	4	3	-1
0008	2T	22	24	8	1	800	1380	580	0.13	1.73	1	2	1
0008	2T	22	25	8	1	800	1550	750	0.13	1.94	1	2	1
0008	2T	22	26	4	0	400	0	-400	0.00	0.00	0	0	0
0008	2T	23	12	1619	377	161900	121350	-40550	0.23	0.75	286	214	-72
0008	2T	23	13	585	135	58500	40740	-17760	0.23	0.70	103	72	-31
0008	2T	23	14	275	52	27500	18540	-8960	0.19	0.67	48	32	-16
0008	2T	23	15	77	18	7700	13250	5550	0.23	1.72	13	23	10
0008	2T	23	16	13	0	1300	0	-1300	0.00	0.00	2	0	-2
0008	2T	23	21	1	0	100	0	-100	0.00	0.00	0	0	0
0008	2T	23	23	19	1	1900	1230	-670	0.05	0.65	3	2	-1
0008	2T	23	24	9	1	900	1190	290	0.11	1.32	1	2	1
0008	2T	23	25	11	2	1100	950	-150	0.18	0.86	1	1	0
0008	2T	23	26	3	0	300	0	-300	0.00	0.00	0	0	0
0008	2T	24	12	1671	482	167100	131780	-35320	0.29	0.79	295	233	-62
0008	2T	24	13	727	184	72700	52640	-20060	0.25	0.72	128	93	-35
0008	2T	24	14	293	75	29300	21910	-7390	0.26	0.75	51	38	-13
0008	2T	24	15	85	24	8500	9500	1000	0.28	1.12	15	16	1
0008	2T	24	16	55	16	5500	5730	230	0.29	1.04	9	10	1
0008	2T	24	21	2	0	200	0	-200	0.00	0.00	0	0	0
0008	2T	24	23	20	4	2000	2960	960	0.20	1.48	3	5	2
0008	2T	24	24	7	1	700	560	-140	0.14	0.80	1	0	-1
0008	2T	24	26	4	0	400	0	-400	0.00	0.00	0	0	0
0008	3F	01	123	229	60	22900	17100	-5800	0.26	0.75	40	30	-10
0008	3F	01	124	1000	152	100000	69430	-30570	0.15	0.69	176	122	-54
0008	3F	01	125	193	52	19300	21450	2150	0.27	1.11	34	37	3
0008	3F	01	126	250	31	25000	13960	-11040	0.12	0.56	44	24	-20
0008	3F	01	134	121	23	12100	9640	-2460	0.19	0.80	21	17	-4
0008	3F	01	135	79	13	7900	5110	-2790	0.16	0.65	13	9	-4
0008	3F	01	136	91	16	9100	8590	-510	0.18	0.94	16	15	-1
0008	3F	01	145	56	10	5600	5260	-340	0.18	0.94	9	9	0
0008	3F	01	146	39	6	3900	2230	-1670	0.15	0.57	6	3	-3
0008	3F	01	156	22	4	2200	2240	40	0.18	1.02	3	3	0
0008	3F	01	234	8	6	800	1770	970	0.75	2.21	1	3	2
0008	3F	01	235	4	0	400	0	-400	0.00	0.00	0	0	0
0008	3F	01	236	4	1	400	2040	1640	0.25	5.10	0	3	3
0008	3F	01	245	3	1	300	360	60	0.33	1.20	0	0	0
0008	3F	01	246	1	0	100	0	-100	0.00	0.00	0	0	0
0008	3F	02	123	308	74	30800	24980	-5820	0.24	0.81	54	44	-10
0008	3F	02	124	727	105	72700	53050	-19650	0.14	0.73	128	93	-35
0008	3F	02	125	212	33	21200	16320	-4880	0.16	0.77	37	28	-9
0008	3F	02	126	277	42	27700	27140	-560	0.15	0.98	49	48	-1
0008	3F	02	134	194	34	19400	15160	-4240	0.18	0.78	34	26	-8
0008	3F	02	135	115	27	11500	14550	3050	0.23	1.27	20	25	5
0008	3F	02	136	168	36	16800	22690	5890	0.21	1.35	29	40	11
0008	3F	02	145	57	9	5700	3900	-1800	0.16	0.68	10	6	-4
0008	3F	02	146	60	11	6000	9640	3640	0.18	1.61	10	17	7
0008	3F	02	156	11	3	1100	2090	990	0.27	1.90	1	3	2
0008	3F	02	234	20	2	2000	750	-1250	0.10	0.38	3	1	-2
0008	3F	02	235	5	1	500	1630	1130	0.20	3.26	0	2	2
0008	3F	02	236	7	0	700	0	-700	0.00	0.00	1	0	-1
0008	3F	02	245	7	0	700	0	-700	0.00	0.00	1	0	-1
0008	3F	02	246	3	0	300	0	-300	0.00	0.00	0	0	0
0008	3F	02	256	3	0	300	0	-300	0.00	0.00	0	0	0
0008	3F	03	123	263	80	26300	25890	-410	0.30	0.98	46	45	-1
0008	3F	03	124	331	54	33100	21760	-11340	0.16	0.66	58	38	-20
0008	3F	03	125	207	29	20700	18720	-1980	0.14	0.90	36	33	-3
0008	3F	03	126	173	29	17300	16780	-520	0.17	0.97	30	29	-1
0008	3F	03	134	108	24	10800	9010	-1790	0.22	0.83	19	15	-4
0008	3F	03	135	125	24	12500	12000	-500	0.19	0.96	22	21	-1
0008	3F	03	136	99	13	9900	8020	-1880	0.13	0.81	17	14	-3
0008	3F	03	145	53	12	5300	5390	90	0.23	1.02	9	9	0
0008	3F	03	146	32	6	3200	3210	10	0.19	1.00	5	5	0
0008	3F	03	156	14	2	1400	940	-460	0.14	0.67	2	1	-1
0008	3F	03	234	7	0	700	0	-700	0.00	0.00	1	0	-1
0008	3F	03	235	4	0	400	0	-400	0.00	0.00	0	0	0
0008	3F	03	236	3	1	300	410	110	0.33	1.37	0	0	0
0008	3F	03	245	1	0	100	0	-100	0.00	0.00	0	0	0
0008	3F	03	246	2	0	200	0	-200	0.00	0.00	0	0	0
0008	3F	03	256	2	0	200	0	-200	0.00	0.00	0	0	0
0008	3F	04	123	218	52	21800	20210	-1590	0.24	0.93	38	35	-3
0008	3F	04	124	497	101	49700	44510	-5190	0.20	0.90	87	78	-9
0008	3F	04	125	187	32	18700	13060	-5640	0.17	0.70	33	23	-10
0008	3F	04	126	275	42	27500	28860	1360	0.15	1.05	48	51	3
0008	3F	04	134	154	30	15400	11740	-3660	0.19	0.76	27	20	-7
0008	3F	04	135	152	22	15200	9990	-5210	0.14	0.66	26	17	-9
0008	3F	04	136	156	25	15600	12060	-3540	0.16	0.77	27	21	-6
0008	3F	04	145	51	6	5100	2270	-2830	0.12	0.45	9	4	-5
0008	3F	04	146	58	7	5800	2580	-3220	0.12	0.44	10	4	-6
0008	3F	04	156	17	3	1700	1060	-640	0.18	0.62	3	1	-2
0008	3F	04	234	5	0	500	0	-500	0.00	0.00	0	0	0
0008	3F	04	235	8	1	800	180	-620	0.13	0.23	1	0	-1
0008	3F	04	236	5	1	500	230	-270	0.20	0.46	0	0	0
0008	3F	04	245	3	0	300	0	-300	0.00	0.00	0	0	0
0008	3F	04	246	4	1	400	650	250	0.25	1.63	0	1	1
0008	3F	04	256	3	0	300	0	-300	0.00	0.00	0	0	0
0008	3F	05	123	218	53	21800	18600	-3200	0.24	0.85	38	32	-6
0008	3F	05	124	530	114	53000	46370	-6630	0.22	0.87	93	82	-11
0008	3F	05	125	286	37	28600	15090	-13510	0.13	0.53	50	26	-24
0008	3F	05	126	372	47	37200	31700	-5500	0.13	0.85	65	56	-9
0008	3F	05	134	177	37	17700	16740	-960	0.21	0.95	31	29	-2
0008	3F	05	135	168	29	16800	10510	-6290	0.17	0.63	29	18	-11
0008	3F	05	136	133	19	13300	10270	-3030	0.14	0.77	23	18	-5
0008	3F	05	145	63	6	6300	3300	-3000	0.10	0.52	11	5	-6
0008	3F	05	146	42	6	4200	2330	-1870	0.14	0.55	7	4	-3
0008	3F	05	156	11	2	1100	910	-190	0.18	0.83	1	1	0
0008	3F	05	234	6	1	600	220	-380	0.17	0.37	1	0	-1
0008	3F	05	235	12	1	1200	570	-630	0.08	0.48	2	1	-1
0008	3F	05	236	4	2	400	700	300	0.50	1.75	0	1	1
0008	3F	05	245	2	0	200	0	-200	0.00	0.00	0	0	0
0008	3F	05	256	1	0	100	0	-100	0.00	0.00	0	0	0
0008	3F	06	123	299	95	29900	32430	2530	0.32	1.08	52	57	5
0008	3F	06	124	552	117	55200	36800	-18400	0.21	0.67	97	65	-32
0008	3F	06	125	322	64	32200	28590	-3610	0.20	0.89	56	50	-6
0008	3F	06	126	311	46	31100	26120	-4980	0.15	0.84	55	46	-9
0008	3F	06	134	201	40	20100	12860	-7240	0.20	0.64	35	22	-13
0008	3F	06	135	222	44	22200	15020	-7180	0.20	0.68	39	26	-13
0008	3F	06	136	171	24	17100	10660	-6440	0.14	0.62	30	18	-12
0008	3F	06	145	73	18	7300	6500	-800	0.25	0.89	12	11	-1
0008	3F	06	146	60	7	6000	3110	-2890	0.12	0.52	10	5	-5
0008	3F	06	156	14	6	1400	3430	2030	0.43	2.45	2	6	4
0008	3F	06	234	3	0	300	0	-300	0.00	0.00	0	0	0
0008	3F	06	235	4	2	400	590	190	0.50	1.48	0	1	1
0008	3F	06	236	7	0	700	0	-700	0.00	0.00	1	0	-1
0008	3F	06	246	4	1	400	160	-240	0.25	0.40	0	0	0
0008	3F	06	256	2	0	200	0	-200	0.00	0.00	0	0	0
0008	3F	07	123	223	56	22300	18360	-3940	0.25	0.82	39	32	-7
0008	3F	07	124	631	123	63100	44710	-18390	0.19	0.71	111	79	-32
0008	3F	07	125	320	57	32000	27850	-4150	0.18	0.87	56	49	-7
0008	3F	07	126	316	51	31600	33490	1890	0.16	1.06	55	59	4
0008	3F	07	134	278	65	27800	18820	-8980	0.23	0.68	49	33	-16
0008	3F	07	135	193	26	19300	12630	-6670	0.13	0.65	34	22	-12
0008	3F	07	136	140	26	14000	9860	-4140	0.19	0.70	24	17	-7
0008	3F	07	145	110	30	11000	11240	240	0.27	1.02	19	19	0
0008	3F	07	146	42	4	4200	1560	-2640	0.10	0.37	7	2	-5
0008	3F	07	156	13	6	1300	2580	1280	0.46	1.98	2	4	2
0008	3F	07	234	4	2	400	950	550	0.50	2.38	0	1	1
0008	3F	07	235	7	1	700	280	-420	0.14	0.40	1	0	-1
0008	3F	07	236	1	1	100	930	830	1.00	9.30	0	1	1
0008	3F	07	245	5	0	500	0	-500	0.00	0.00	0	0	0
0008	3F	07	246	2	0	200	0	-200	0.00	0.00	0	0	0
0008	3F	07	256	2	0	200	0	-200	0.00	0.00	0	0	0
0008	3F	08	123	223	66	22300	17570	-4730	0.30	0.79	39	31	-8
0008	3F	08	124	685	147	68500	56730	-11770	0.21	0.83	121	100	-21
0008	3F	08	125	288	47	28800	22380	-6420	0.16	0.78	50	39	-11
0008	3F	08	126	310	54	31000	27600	-3400	0.17	0.89	54	48	-6
0008	3F	08	134	190	46	19000	16780	-2220	0.24	0.88	33	29	-4
0008	3F	08	135	154	23	15400	8810	-6590	0.15	0.57	27	15	-12
0008	3F	08	136	179	33	17900	11760	-6140	0.18	0.66	31	20	-11
0008	3F	08	145	81	15	8100	4390	-3710	0.19	0.54	14	7	-7
0008	3F	08	146	57	10	5700	4250	-1450	0.18	0.75	10	7	-3
0008	3F	08	156	23	3	2300	1140	-1160	0.13	0.50	4	2	-2
0008	3F	08	234	4	2	400	560	160	0.50	1.40	0	0	0
0008	3F	08	235	6	1	600	220	-380	0.17	0.37	1	0	-1
0008	3F	08	236	1	0	100	0	-100	0.00	0.00	0	0	0
0008	3F	08	245	1	0	100	0	-100	0.00	0.00	0	0	0
0008	3F	08	246	3	1	300	480	180	0.33	1.60	0	0	0
0008	3F	09	123	393	91	39300	22860	-16440	0.23	0.58	69	40	-29
0008	3F	09	124	767	160	76700	62540	-14160	0.21	0.82	135	110	-25
0008	3F	09	125	279	57	27900	23120	-4780	0.20	0.83	49	40	-9
0008	3F	09	126	288	43	28800	27360	-1440	0.15	0.95	50	48	-2
0008	3F	09	134	227	46	22700	14230	-8470	0.20	0.63	40	25	-15
0008	3F	09	135	154	29	15400	10830	-4570	0.19	0.70	27	19	-8
0008	3F	09	136	121	17	12100	11220	-880	0.14	0.93	21	19	-2
0008	3F	09	145	60	7	6000	5180	-820	0.12	0.86	10	9	-1
0008	3F	09	146	40	10	4000	5060	1060	0.25	1.27	7	8	1
0008	3F	09	156	12	3	1200	2560	1360	0.25	2.13	2	4	2
0008	3F	09	234	8	2	800	620	-180	0.25	0.78	1	1	0
0008	3F	09	235	3	0	300	0	-300	0.00	0.00	0	0	0
0008	3F	09	236	12	1	1200	510	-690	0.08	0.43	2	0	-2
0008	3F	09	245	2	0	200	0	-200	0.00	0.00	0	0	0
0008	3F	09	246	2	0	200	0	-200	0.00	0.00	0	0	0
0008	3F	09	256	2	1	200	330	130	0.50	1.65	0	0	0
0008	3F	10	123	485	156	48500	37970	-10530	0.32	0.78	85	67	-18
0008	3F	10	124	572	135	57200	48570	-8630	0.24	0.85	101	85	-16
0008	3F	10	125	215	40	21500	15770	-5730	0.19	0.73	38	27	-11
0008	3F	10	126	177	25	17700	14910	-2790	0.14	0.84	31	26	-5
0008	3F	10	134	181	30	18100	9100	-9000	0.17	0.50	32	16	-16
0008	3F	10	135	134	19	13400	9520	-3880	0.14	0.71	23	16	-7
0008	3F	10	136	91	9	9100	4720	-4380	0.10	0.52	16	8	-8
0008	3F	10	145	68	12	6800	6420	-380	0.18	0.94	12	11	-1
0008	3F	10	146	41	6	4100	2570	-1530	0.15	0.63	7	4	-3
0008	3F	10	156	12	2	1200	1510	310	0.17	1.26	2	2	0
0008	3F	10	234	3	0	300	0	-300	0.00	0.00	0	0	0
0008	3F	10	235	5	2	500	630	130	0.40	1.26	0	1	1
0008	3F	10	236	6	1	600	890	290	0.17	1.48	1	1	0
0008	3F	10	245	5	0	500	0	-500	0.00	0.00	0	0	0
0008	3F	10	246	5	0	500	0	-500	0.00	0.00	0	0	0
0008	3F	10	256	4	0	400	0	-400	0.00	0.00	0	0	0
0008	3F	11	123	452	107	45200	37110	-8090	0.24	0.82	80	65	-15
0008	3F	11	124	871	141	87100	69170	-17930	0.16	0.79	154	122	-32
0008	3F	11	126	285	37	28500	30500	2000	0.13	1.07	50	53	3
0008	3F	11	134	326	87	32600	34050	1450	0.27	1.04	57	60	3
0008	3F	11	135	11	1	1100	200	-900	0.09	0.18	1	0	-1
0008	3F	11	136	96	9	9600	6190	-3410	0.09	0.64	16	10	-6
0008	3F	11	145	14	0	1400	0	-1400	0.00	0.00	2	0	-2
0008	3F	11	146	39	11	3900	7070	3170	0.28	1.81	6	12	6
0008	3F	11	156	11	3	1100	1370	270	0.27	1.25	1	2	1
0008	3F	11	234	75	12	7500	8050	550	0.16	1.07	13	14	1
0008	3F	11	235	3	0	300	0	-300	0.00	0.00	0	0	0
0008	3F	11	236	23	4	2300	1930	-370	0.17	0.84	4	3	-1
0008	3F	11	245	1	0	100	0	-100	0.00	0.00	0	0	0
0008	3F	11	246	2	0	200	0	-200	0.00	0.00	0	0	0
0008	3F	11	256	2	0	200	0	-200	0.00	0.00	0	0	0
0008	3F	12	123	242	62	24200	18950	-5250	0.26	0.78	42	33	-9
0008	3F	12	124	1057	184	105700	78120	-27580	0.17	0.74	187	138	-49
0008	3F	12	125	101	14	10100	5550	-4550	0.14	0.55	17	9	-8
0008	3F	12	126	252	38	25200	21940	-3260	0.15	0.87	44	38	-6
0008	3F	12	134	137	26	13700	10060	-3640	0.19	0.73	24	17	-7
0008	3F	12	135	97	23	9700	9650	-50	0.24	0.99	17	17	0
0008	3F	12	136	135	27	13500	13880	380	0.20	1.03	23	24	1
0008	3F	12	145	62	11	6200	5040	-1160	0.18	0.81	10	8	-2
0008	3F	12	146	47	1	4700	720	-3980	0.02	0.15	8	1	-7
0008	3F	12	156	28	8	2800	3070	270	0.29	1.10	4	5	1
0008	3F	12	234	8	2	800	510	-290	0.25	0.64	1	0	-1
0008	3F	12	235	2	0	200	0	-200	0.00	0.00	0	0	0
0008	3F	12	236	4	1	400	420	20	0.25	1.05	0	0	0
0008	3F	12	246	1	1	100	260	160	1.00	2.60	0	0	0
0008	3F	12	256	2	1	200	410	210	0.50	2.05	0	0	0
0008	3F	13	123	185	45	18500	13280	-5220	0.24	0.72	32	23	-9
0008	3F	13	124	767	159	76700	62280	-14420	0.21	0.81	135	110	-25
0008	3F	13	125	187	41	18700	17400	-1300	0.22	0.93	33	30	-3
0008	3F	13	126	190	33	19000	19820	820	0.17	1.04	33	35	2
0008	3F	13	134	228	55	22800	19970	-2830	0.24	0.88	40	35	-5
0008	3F	13	135	129	27	12900	10080	-2820	0.21	0.78	22	17	-5
0008	3F	13	136	154	31	15400	12470	-2930	0.20	0.81	27	22	-5
0008	3F	13	145	62	7	6200	3470	-2730	0.11	0.56	10	6	-4
0008	3F	13	146	68	10	6800	4000	-2800	0.15	0.59	12	7	-5
0008	3F	13	156	18	4	1800	1980	180	0.22	1.10	3	3	0
0008	3F	13	234	9	1	900	200	-700	0.11	0.22	1	0	-1
0008	3F	13	235	5	1	500	160	-340	0.20	0.32	0	0	0
0008	3F	13	236	7	2	700	970	270	0.29	1.39	1	1	0
0008	3F	13	245	1	0	100	0	-100	0.00	0.00	0	0	0
0008	3F	13	246	1	0	100	0	-100	0.00	0.00	0	0	0
0008	3F	14	123	312	84	31200	28410	-2790	0.27	0.91	55	50	-5
0008	3F	14	124	556	111	55600	41730	-13870	0.20	0.75	98	73	-25
0008	3F	14	125	215	41	21500	17730	-3770	0.19	0.82	38	31	-7
0008	3F	14	126	213	26	21300	15820	-5480	0.12	0.74	37	28	-9
0008	3F	14	134	163	29	16300	10860	-5440	0.18	0.67	28	19	-9
0008	3F	14	135	142	30	14200	11090	-3110	0.21	0.78	25	19	-6
0008	3F	14	136	128	11	12800	4560	-8240	0.09	0.36	22	8	-14
0008	3F	14	145	69	8	6900	3230	-3670	0.12	0.47	12	5	-7
0008	3F	14	146	40	7	4000	3360	-640	0.18	0.84	7	5	-2
0008	3F	14	156	19	5	1900	2370	470	0.26	1.25	3	4	1
0008	3F	14	234	8	1	800	340	-460	0.13	0.43	1	0	-1
0008	3F	14	235	4	1	400	280	-120	0.25	0.70	0	0	0
0008	3F	14	236	9	2	900	1650	750	0.22	1.83	1	2	1
0008	3F	14	245	3	0	300	0	-300	0.00	0.00	0	0	0
0008	3F	14	246	2	0	200	0	-200	0.00	0.00	0	0	0
0008	3F	14	256	2	0	200	0	-200	0.00	0.00	0	0	0
0008	3F	15	123	253	52	25300	16430	-8870	0.21	0.65	44	29	-15
0008	3F	15	124	779	181	77900	50960	-26940	0.23	0.65	137	90	-47
0008	3F	15	125	297	56	29700	28840	-860	0.19	0.97	52	51	-1
0008	3F	15	126	301	39	30100	25410	-4690	0.13	0.84	53	44	-9
0008	3F	15	134	244	68	24400	22140	-2260	0.28	0.91	43	39	-4
0008	3F	15	135	141	24	14100	8540	-5560	0.17	0.61	24	15	-9
0008	3F	15	136	152	25	15200	12300	-2900	0.16	0.81	26	21	-5
0008	3F	15	145	49	5	4900	2190	-2710	0.10	0.45	8	3	-5
0008	3F	15	146	41	7	4100	3500	-600	0.17	0.85	7	6	-1
0008	3F	15	156	31	1	3100	150	-2950	0.03	0.05	5	0	-5
0008	3F	15	234	6	1	600	240	-360	0.17	0.40	1	0	-1
0008	3F	15	235	4	1	400	240	-160	0.25	0.60	0	0	0
0008	3F	15	236	8	1	800	360	-440	0.13	0.45	1	0	-1
0008	3F	15	245	4	0	400	0	-400	0.00	0.00	0	0	0
0008	3F	15	256	3	0	300	0	-300	0.00	0.00	0	0	0
0008	3F	16	123	379	119	37900	26040	-11860	0.31	0.69	67	46	-21
0008	3F	16	124	650	126	65000	45850	-19150	0.19	0.71	115	81	-34
0008	3F	16	125	268	39	26800	17360	-9440	0.15	0.65	47	30	-17
0008	3F	16	126	324	56	32400	32590	190	0.17	1.01	57	57	0
0008	3F	16	134	173	35	17300	11870	-5430	0.20	0.69	30	21	-9
0008	3F	16	135	128	27	12800	12130	-670	0.21	0.95	22	21	-1
0008	3F	16	136	132	20	13200	11340	-1860	0.15	0.86	23	20	-3
0008	3F	16	145	85	14	8500	5180	-3320	0.16	0.61	15	9	-6
0008	3F	16	146	49	7	4900	4390	-510	0.14	0.90	8	7	-1
0008	3F	16	156	10	2	1000	910	-90	0.20	0.91	1	1	0
0008	3F	16	234	1	0	100	0	-100	0.00	0.00	0	0	0
0008	3F	16	235	7	1	700	240	-460	0.14	0.34	1	0	-1
0008	3F	16	236	6	2	600	660	60	0.33	1.10	1	1	0
0008	3F	16	245	2	1	200	230	30	0.50	1.15	0	0	0
0008	3F	16	246	2	0	200	0	-200	0.00	0.00	0	0	0
0008	3F	16	256	3	0	300	0	-300	0.00	0.00	0	0	0
0008	3F	17	123	407	135	40700	37310	-3390	0.33	0.92	72	66	-6
0008	3F	17	124	673	148	67300	57610	-9690	0.22	0.86	119	101	-18
0008	3F	17	125	290	63	29000	31670	2670	0.22	1.09	51	56	5
0008	3F	17	126	248	34	24800	27920	3120	0.14	1.13	43	49	6
0008	3F	17	134	190	48	19000	14580	-4420	0.25	0.77	33	25	-8
0008	3F	17	135	170	31	17000	14590	-2410	0.18	0.86	30	25	-5
0008	3F	17	136	84	15	8400	6070	-2330	0.18	0.72	14	10	-4
0008	3F	17	145	71	10	7100	4580	-2520	0.14	0.65	12	8	-4
0008	3F	17	146	33	6	3300	3050	-250	0.18	0.92	5	5	0
0008	3F	17	156	5	2	500	1110	610	0.40	2.22	0	1	1
0008	3F	17	234	7	0	700	0	-700	0.00	0.00	1	0	-1
0008	3F	17	235	6	2	600	500	-100	0.33	0.83	1	0	-1
0008	3F	17	236	6	1	600	570	-30	0.17	0.95	1	1	0
0008	3F	17	245	4	0	400	0	-400	0.00	0.00	0	0	0
0008	3F	17	246	1	0	100	0	-100	0.00	0.00	0	0	0
0008	3F	17	256	3	0	300	0	-300	0.00	0.00	0	0	0
0008	3F	18	123	281	62	28100	21360	-6740	0.22	0.76	49	37	-12
0008	3F	18	124	784	178	78400	62510	-15890	0.23	0.80	138	110	-28
0008	3F	18	125	374	83	37400	32710	-4690	0.22	0.87	66	57	-9
0008	3F	18	126	233	41	23300	19010	-4290	0.18	0.82	41	33	-8
0008	3F	18	134	202	41	20200	13210	-6990	0.20	0.65	35	23	-12
0008	3F	18	135	203	43	20300	14880	-5420	0.21	0.73	35	26	-9
0008	3F	18	136	134	24	13400	10950	-2450	0.18	0.82	23	19	-4
0008	3F	18	145	110	22	11000	11370	370	0.20	1.03	19	20	1
0008	3F	18	146	53	5	5300	1630	-3670	0.09	0.31	9	2	-7
0008	3F	18	156	6	0	600	0	-600	0.00	0.00	1	0	-1
0008	3F	18	234	3	0	300	0	-300	0.00	0.00	0	0	0
0008	3F	18	235	9	2	900	470	-430	0.22	0.52	1	0	-1
0008	3F	18	236	3	0	300	0	-300	0.00	0.00	0	0	0
0008	3F	18	245	5	1	500	360	-140	0.20	0.72	0	0	0
0008	3F	18	246	2	1	200	470	270	0.50	2.35	0	0	0
0008	3F	18	256	2	0	200	0	-200	0.00	0.00	0	0	0
0008	3F	19	123	209	60	20900	17990	-2910	0.29	0.86	36	31	-5
0008	3F	19	124	695	169	69500	55050	-14450	0.24	0.79	123	97	-26
0008	3F	19	125	198	33	19800	17320	-2480	0.17	0.87	35	30	-5
0008	3F	19	126	223	36	22300	24500	2200	0.16	1.10	39	43	4
0008	3F	19	134	174	53	17400	15450	-1950	0.30	0.89	30	27	-3
0008	3F	19	135	151	28	15100	9680	-5420	0.19	0.64	26	17	-9
0008	3F	19	136	155	34	15500	11840	-3660	0.22	0.76	27	20	-7
0008	3F	19	145	69	15	6900	5780	-1120	0.22	0.84	12	10	-2
0008	3F	19	146	29	6	2900	3160	260	0.21	1.09	5	5	0
0008	3F	19	156	3	0	300	0	-300	0.00	0.00	0	0	0
0008	3F	19	234	2	1	200	220	20	0.50	1.10	0	0	0
0008	3F	19	235	6	2	600	610	10	0.33	1.02	1	1	0
0008	3F	19	236	2	0	200	0	-200	0.00	0.00	0	0	0
0008	3F	19	245	3	0	300	0	-300	0.00	0.00	0	0	0
0008	3F	19	246	5	0	500	0	-500	0.00	0.00	0	0	0
0008	3F	20	123	358	115	35800	29720	-6080	0.32	0.83	63	52	-11
0008	3F	20	124	800	180	80000	49550	-30450	0.23	0.62	141	87	-54
0008	3F	20	125	250	51	25000	22550	-2450	0.20	0.90	44	39	-5
0008	3F	20	126	197	26	19700	18660	-1040	0.13	0.95	34	33	-1
0008	3F	20	134	215	43	21500	13210	-8290	0.20	0.61	38	23	-15
0008	3F	20	135	150	37	15000	14680	-320	0.25	0.98	26	25	-1
0008	3F	20	136	148	23	14800	7890	-6910	0.16	0.53	26	13	-13
0008	3F	20	145	67	7	6700	3130	-3570	0.10	0.47	11	5	-6
0008	3F	20	146	68	14	6800	5110	-1690	0.21	0.75	12	9	-3
0008	3F	20	156	22	4	2200	1870	-330	0.18	0.85	3	3	0
0008	3F	20	235	3	0	300	0	-300	0.00	0.00	0	0	0
0008	3F	20	236	2	0	200	0	-200	0.00	0.00	0	0	0
0008	3F	20	245	1	1	100	210	110	1.00	2.10	0	0	0
0008	3F	21	123	351	102	35100	28940	-6160	0.29	0.82	62	51	-11
0008	3F	21	124	776	155	77600	53100	-24500	0.20	0.68	137	93	-44
0008	3F	21	125	334	67	33400	23370	-10030	0.20	0.70	59	41	-18
0008	3F	21	126	220	34	22000	17920	-4080	0.15	0.81	38	31	-7
0008	3F	21	134	248	69	24800	22230	-2570	0.28	0.90	43	39	-4
0008	3F	21	135	272	76	27200	20580	-6620	0.28	0.76	48	36	-12
0008	3F	21	136	87	7	8700	3610	-5090	0.08	0.41	15	6	-9
0008	3F	21	145	55	10	5500	4680	-820	0.18	0.85	9	8	-1
0008	3F	21	146	23	3	2300	930	-1370	0.13	0.40	4	1	-3
0008	3F	21	156	3	1	300	670	370	0.33	2.23	0	1	1
0008	3F	21	234	1	0	100	0	-100	0.00	0.00	0	0	0
0008	3F	21	235	1	0	100	0	-100	0.00	0.00	0	0	0
0008	3F	21	236	1	0	100	0	-100	0.00	0.00	0	0	0
0008	3F	21	256	1	0	100	0	-100	0.00	0.00	0	0	0
0008	3F	22	123	168	52	16800	14330	-2470	0.31	0.85	29	25	-4
0008	3F	22	124	1018	189	101800	76170	-25630	0.19	0.75	180	134	-46
0008	3F	22	125	101	19	10100	8140	-1960	0.19	0.81	17	14	-3
0008	3F	22	126	183	22	18300	16900	-1400	0.12	0.92	32	29	-3
0008	3F	22	134	305	53	30500	21560	-8940	0.17	0.71	53	38	-15
0008	3F	22	135	45	10	4500	3140	-1360	0.22	0.70	7	5	-2
0008	3F	22	136	73	10	7300	4770	-2530	0.14	0.65	12	8	-4
0008	3F	22	145	15	3	1500	3060	1560	0.20	2.04	2	5	3
0008	3F	22	146	12	0	1200	0	-1200	0.00	0.00	2	0	-2
0008	3F	22	156	6	2	600	1770	1170	0.33	2.95	1	3	2
0008	3F	22	234	10	2	1000	910	-90	0.20	0.91	1	1	0
0008	3F	22	235	6	0	600	0	-600	0.00	0.00	1	0	-1
0008	3F	22	236	3	1	300	460	160	0.33	1.53	0	0	0
0008	3F	22	245	1	0	100	0	-100	0.00	0.00	0	0	0
0008	3F	22	246	2	0	200	0	-200	0.00	0.00	0	0	0
0008	3F	22	256	1	0	100	0	-100	0.00	0.00	0	0	0
0008	3F	23	123	277	89	27700	23710	-3990	0.32	0.86	49	41	-8
0008	3F	23	124	1030	155	103000	65500	-37500	0.15	0.64	182	115	-67
0008	3F	23	125	142	21	14200	9590	-4610	0.15	0.68	25	16	-9
0008	3F	23	126	138	12	13800	11860	-1940	0.09	0.86	24	20	-4
0008	3F	23	134	202	35	20200	19020	-1180	0.17	0.94	35	33	-2
0008	3F	23	135	118	17	11800	5950	-5850	0.14	0.50	20	10	-10
0008	3F	23	136	95	17	9500	11210	1710	0.18	1.18	16	19	3
0008	3F	23	145	91	18	9100	5890	-3210	0.20	0.65	16	10	-6
0008	3F	23	146	68	7	6800	3300	-3500	0.10	0.49	12	5	-7
0008	3F	23	156	16	1	1600	270	-1330	0.06	0.17	2	0	-2
0008	3F	23	234	15	2	1500	720	-780	0.13	0.48	2	1	-1
0008	3F	23	235	4	1	400	210	-190	0.25	0.53	0	0	0
0008	3F	23	236	1	1	100	1040	940	1.00	10.40	0	1	1
0008	3F	23	245	3	0	300	0	-300	0.00	0.00	0	0	0
0008	3F	23	246	2	1	200	1740	1540	0.50	8.70	0	3	3
0008	3F	23	256	2	1	200	240	40	0.50	1.20	0	0	0
0008	3F	24	123	433	145	43300	40550	-2750	0.33	0.94	76	71	-5
0008	3F	24	124	692	125	69200	43390	-25810	0.18	0.63	122	76	-46
0008	3F	24	125	226	36	22600	17230	-5370	0.16	0.76	40	30	-10
0008	3F	24	126	248	43	24800	21650	-3150	0.17	0.87	43	38	-5
0008	3F	24	134	244	58	24400	18700	-5700	0.24	0.77	43	33	-10
0008	3F	24	135	148	30	14800	9790	-5010	0.20	0.66	26	17	-9
0008	3F	24	136	139	14	13900	5360	-8540	0.10	0.39	24	9	-15
0008	3F	24	145	55	11	5500	2930	-2570	0.20	0.53	9	5	-4
0008	3F	24	146	23	3	2300	870	-1430	0.13	0.38	4	1	-3
0008	3F	24	156	6	1	600	990	390	0.17	1.65	1	1	0
0008	3F	24	234	10	1	1000	230	-770	0.10	0.23	1	0	-1
0008	3F	24	235	3	0	300	0	-300	0.00	0.00	0	0	0
0008	3F	24	236	7	1	700	460	-240	0.14	0.66	1	0	-1
0008	3F	24	245	1	0	100	0	-100	0.00	0.00	0	0	0
0008	3T	01	123	219	21	21900	12770	-9130	0.10	0.58	38	22	-16
0008	3T	01	124	989	59	98900	58980	-39920	0.06	0.60	175	104	-71
0008	3T	01	125	188	19	18800	23510	4710	0.10	1.25	33	41	8
0008	3T	01	126	247	15	24700	22790	-1910	0.06	0.92	43	40	-3
0008	3T	01	132	9	3	900	2260	1360	0.33	2.51	1	4	3
0008	3T	01	134	113	8	11300	9060	-2240	0.07	0.80	20	16	-4
0008	3T	01	135	77	6	7700	6920	-780	0.08	0.90	13	12	-1
0008	3T	01	136	91	7	9100	6870	-2230	0.08	0.75	16	12	-4
0008	3T	01	142	11	1	1100	610	-490	0.09	0.55	1	1	0
0008	3T	01	143	8	0	800	0	-800	0.00	0.00	1	0	-1
0008	3T	01	145	41	2	4100	3070	-1030	0.05	0.75	7	5	-2
0008	3T	01	146	35	1	3500	760	-2740	0.03	0.22	6	1	-5
0008	3T	01	152	5	1	500	2020	1520	0.20	4.04	0	3	3
0008	3T	01	153	2	0	200	0	-200	0.00	0.00	0	0	0
0008	3T	01	154	15	0	1500	0	-1500	0.00	0.00	2	0	-2
0008	3T	01	156	22	2	2200	1790	-410	0.09	0.81	3	3	0
0008	3T	01	164	4	0	400	0	-400	0.00	0.00	0	0	0
0008	3T	01	213	1	0	100	0	-100	0.00	0.00	0	0	0
0008	3T	01	216	3	1	300	1570	1270	0.33	5.23	0	2	2
0008	3T	01	234	8	1	800	800	0	0.13	1.00	1	1	0
0008	3T	01	235	4	0	400	0	-400	0.00	0.00	0	0	0
0008	3T	01	236	4	1	400	4400	4000	0.25	11.00	0	7	7
0008	3T	01	245	3	0	300	0	-300	0.00	0.00	0	0	0
0008	3T	01	246	1	0	100	0	-100	0.00	0.00	0	0	0
0008	3T	02	123	300	29	30000	25040	-4960	0.10	0.83	53	44	-9
0008	3T	02	124	715	41	71500	55220	-16280	0.06	0.77	126	97	-29
0008	3T	02	125	207	14	20700	21230	530	0.07	1.03	36	37	1
0008	3T	02	126	275	18	27500	31690	4190	0.07	1.15	48	56	8
0008	3T	02	132	8	0	800	0	-800	0.00	0.00	1	0	-1
0008	3T	02	134	188	13	18800	15590	-3210	0.07	0.83	33	27	-6
0008	3T	02	135	112	10	11200	13110	1910	0.09	1.17	19	23	4
0008	3T	02	136	166	13	16600	23090	6490	0.08	1.39	29	40	11
0008	3T	02	142	12	0	1200	0	-1200	0.00	0.00	2	0	-2
0008	3T	02	143	6	1	600	1030	430	0.17	1.72	1	1	0
0008	3T	02	145	56	4	5600	8750	3150	0.07	1.56	9	15	6
0008	3T	02	146	59	2	5900	5840	-60	0.03	0.99	10	10	0
0008	3T	02	152	5	0	500	0	-500	0.00	0.00	0	0	0
0008	3T	02	153	3	0	300	0	-300	0.00	0.00	0	0	0
0008	3T	02	154	1	0	100	0	-100	0.00	0.00	0	0	0
0008	3T	02	156	11	1	1100	2750	1650	0.09	2.50	1	4	3
0008	3T	02	162	1	0	100	0	-100	0.00	0.00	0	0	0
0008	3T	02	163	2	0	200	0	-200	0.00	0.00	0	0	0
0008	3T	02	164	1	0	100	0	-100	0.00	0.00	0	0	0
0008	3T	02	216	1	0	100	0	-100	0.00	0.00	0	0	0
0008	3T	02	234	20	1	2000	740	-1260	0.05	0.37	3	1	-2
0008	3T	02	235	5	0	500	0	-500	0.00	0.00	0	0	0
0008	3T	02	236	7	0	700	0	-700	0.00	0.00	1	0	-1
0008	3T	02	245	4	0	400	0	-400	0.00	0.00	0	0	0
0008	3T	02	246	3	0	300	0	-300	0.00	0.00	0	0	0
0008	3T	02	254	3	0	300	0	-300	0.00	0.00	0	0	0
0008	3T	02	256	3	0	300	0	-300	0.00	0.00	0	0	0
0008	3T	03	123	261	31	26100	28400	2300	0.12	1.09	46	50	4
0008	3T	03	124	329	18	32900	22020	-10880	0.05	0.67	58	38	-20
0008	3T	03	125	205	10	20500	11450	-9050	0.05	0.56	36	20	-16
0008	3T	03	126	172	9	17200	17790	590	0.05	1.03	30	31	1
0008	3T	03	132	2	0	200	0	-200	0.00	0.00	0	0	0
0008	3T	03	134	98	10	9800	11550	1750	0.10	1.18	17	20	3
0008	3T	03	135	121	11	12100	13390	1290	0.09	1.11	21	23	2
0008	3T	03	136	98	4	9800	4010	-5790	0.04	0.41	17	7	-10
0008	3T	03	142	2	0	200	0	-200	0.00	0.00	0	0	0
0008	3T	03	143	10	1	1000	1100	100	0.10	1.10	1	1	0
0008	3T	03	145	53	4	5300	6070	770	0.08	1.15	9	10	1
0008	3T	03	146	32	4	3200	6320	3120	0.13	1.98	5	11	6
0008	3T	03	152	2	0	200	0	-200	0.00	0.00	0	0	0
0008	3T	03	153	4	1	400	770	370	0.25	1.93	0	1	1
0008	3T	03	156	14	0	1400	0	-1400	0.00	0.00	2	0	-2
0008	3T	03	163	1	0	100	0	-100	0.00	0.00	0	0	0
0008	3T	03	216	1	0	100	0	-100	0.00	0.00	0	0	0
0008	3T	03	234	6	0	600	0	-600	0.00	0.00	1	0	-1
0008	3T	03	235	4	0	400	0	-400	0.00	0.00	0	0	0
0008	3T	03	236	3	0	300	0	-300	0.00	0.00	0	0	0
0008	3T	03	243	1	0	100	0	-100	0.00	0.00	0	0	0
0008	3T	03	245	1	0	100	0	-100	0.00	0.00	0	0	0
0008	3T	03	246	2	0	200	0	-200	0.00	0.00	0	0	0
0008	3T	03	256	2	0	200	0	-200	0.00	0.00	0	0	0
0008	3T	04	123	214	22	21400	21760	360	0.10	1.02	37	38	1
0008	3T	04	124	492	39	49200	44410	-4790	0.08	0.90	87	78	-9
0008	3T	04	125	184	9	18400	13240	-5160	0.05	0.72	32	23	-9
0008	3T	04	126	275	19	27500	31060	3560	0.07	1.13	48	54	6
0008	3T	04	132	3	0	300	0	-300	0.00	0.00	0	0	0
0008	3T	04	134	148	13	14800	13520	-1280	0.09	0.91	26	23	-3
0008	3T	04	135	150	10	15000	10630	-4370	0.07	0.71	26	18	-8
0008	3T	04	136	156	10	15600	11840	-3760	0.06	0.76	27	20	-7
0008	3T	04	142	4	1	400	1030	630	0.25	2.58	0	1	1
0008	3T	04	143	6	0	600	0	-600	0.00	0.00	1	0	-1
0008	3T	04	145	48	1	4800	1190	-3610	0.02	0.25	8	2	-6
0008	3T	04	146	57	1	5700	840	-4860	0.02	0.15	10	1	-9
0008	3T	04	152	2	0	200	0	-200	0.00	0.00	0	0	0
0008	3T	04	153	2	0	200	0	-200	0.00	0.00	0	0	0
0008	3T	04	154	3	0	300	0	-300	0.00	0.00	0	0	0
0008	3T	04	156	17	0	1700	0	-1700	0.00	0.00	3	0	-3
0008	3T	04	164	1	0	100	0	-100	0.00	0.00	0	0	0
0008	3T	04	213	1	0	100	0	-100	0.00	0.00	0	0	0
0008	3T	04	214	1	0	100	0	-100	0.00	0.00	0	0	0
0008	3T	04	215	1	0	100	0	-100	0.00	0.00	0	0	0
0008	3T	04	234	5	0	500	0	-500	0.00	0.00	0	0	0
0008	3T	04	235	8	1	800	400	-400	0.13	0.50	1	0	-1
0008	3T	04	236	5	0	500	0	-500	0.00	0.00	0	0	0
0008	3T	04	245	2	0	200	0	-200	0.00	0.00	0	0	0
0008	3T	04	246	4	0	400	0	-400	0.00	0.00	0	0	0
0008	3T	04	254	1	0	100	0	-100	0.00	0.00	0	0	0
0008	3T	04	256	3	0	300	0	-300	0.00	0.00	0	0	0
0008	3T	05	123	217	15	21700	15550	-6150	0.07	0.72	38	27	-11
0008	3T	05	124	520	47	52000	44490	-7510	0.09	0.86	92	78	-14
0008	3T	05	125	286	13	28600	11080	-17520	0.05	0.39	50	19	-31
0008	3T	05	126	371	21	37100	28460	-8640	0.06	0.77	65	50	-15
0008	3T	05	132	1	0	100	0	-100	0.00	0.00	0	0	0
0008	3T	05	134	165	12	16500	12570	-3930	0.07	0.76	29	22	-7
0008	3T	05	135	168	9	16800	7540	-9260	0.05	0.45	29	13	-16
0008	3T	05	136	132	10	13200	14420	1220	0.08	1.09	23	25	2
0008	3T	05	142	9	1	900	700	-200	0.11	0.78	1	1	0
0008	3T	05	143	12	2	1200	2680	1480	0.17	2.23	2	4	2
0008	3T	05	145	62	3	6200	3490	-2710	0.05	0.56	10	6	-4
0008	3T	05	146	42	3	4200	2520	-1680	0.07	0.60	7	4	-3
0008	3T	05	154	1	0	100	0	-100	0.00	0.00	0	0	0
0008	3T	05	156	11	0	1100	0	-1100	0.00	0.00	1	0	-1
0008	3T	05	163	1	0	100	0	-100	0.00	0.00	0	0	0
0008	3T	05	214	1	0	100	0	-100	0.00	0.00	0	0	0
0008	3T	05	216	1	1	100	3320	3220	1.00	33.20	0	5	5
0008	3T	05	234	6	1	600	1580	980	0.17	2.63	1	2	1
0008	3T	05	235	12	0	1200	0	-1200	0.00	0.00	2	0	-2
0008	3T	05	236	4	1	400	740	340	0.25	1.85	0	1	1
0008	3T	05	245	2	0	200	0	-200	0.00	0.00	0	0	0
0008	3T	05	256	1	0	100	0	-100	0.00	0.00	0	0	0
0008	3T	06	123	296	51	29600	40900	11300	0.17	1.38	52	72	20
0008	3T	06	124	547	43	54700	32720	-21980	0.08	0.60	96	57	-39
0008	3T	06	125	320	21	32000	25560	-6440	0.07	0.80	56	45	-11
0008	3T	06	126	311	16	31100	38040	6940	0.05	1.22	55	67	12
0008	3T	06	132	2	0	200	0	-200	0.00	0.00	0	0	0
0008	3T	06	134	193	16	19300	11880	-7420	0.08	0.62	34	21	-13
0008	3T	06	135	220	14	22000	14320	-7680	0.06	0.65	38	25	-13
0008	3T	06	136	170	11	17000	13060	-3940	0.06	0.77	30	23	-7
0008	3T	06	142	5	0	500	0	-500	0.00	0.00	0	0	0
0008	3T	06	143	8	0	800	0	-800	0.00	0.00	1	0	-1
0008	3T	06	145	70	6	7000	7870	870	0.09	1.12	12	13	1
0008	3T	06	146	60	3	6000	5510	-490	0.05	0.92	10	9	-1
0008	3T	06	152	1	0	100	0	-100	0.00	0.00	0	0	0
0008	3T	06	153	2	0	200	0	-200	0.00	0.00	0	0	0
0008	3T	06	154	3	0	300	0	-300	0.00	0.00	0	0	0
0008	3T	06	156	14	2	1400	4430	3030	0.14	3.16	2	7	5
0008	3T	06	163	1	0	100	0	-100	0.00	0.00	0	0	0
0008	3T	06	213	1	0	100	0	-100	0.00	0.00	0	0	0
0008	3T	06	215	1	0	100	0	-100	0.00	0.00	0	0	0
0008	3T	06	234	3	0	300	0	-300	0.00	0.00	0	0	0
0008	3T	06	235	4	0	400	0	-400	0.00	0.00	0	0	0
0008	3T	06	236	7	0	700	0	-700	0.00	0.00	1	0	-1
0008	3T	06	246	4	0	400	0	-400	0.00	0.00	0	0	0
0008	3T	06	256	1	0	100	0	-100	0.00	0.00	0	0	0
0008	3T	06	265	1	0	100	0	-100	0.00	0.00	0	0	0
0008	3T	07	123	219	19	21900	15200	-6700	0.09	0.69	38	26	-12
0008	3T	07	124	629	50	62900	44410	-18490	0.08	0.71	111	78	-33
0008	3T	07	125	317	22	31700	29270	-2430	0.07	0.92	56	51	-5
0008	3T	07	126	316	14	31600	17650	-13950	0.04	0.56	55	31	-24
0008	3T	07	132	4	1	400	620	220	0.25	1.55	0	1	1
0008	3T	07	134	271	30	27100	22110	-4990	0.11	0.82	47	39	-8
0008	3T	07	135	190	10	19000	16630	-2370	0.05	0.88	33	29	-4
0008	3T	07	136	139	11	13900	15190	1290	0.08	1.09	24	26	2
0008	3T	07	142	2	0	200	0	-200	0.00	0.00	0	0	0
0008	3T	07	143	7	0	700	0	-700	0.00	0.00	1	0	-1
0008	3T	07	145	110	8	11000	10210	-790	0.07	0.93	19	18	-1
0008	3T	07	146	42	2	4200	1340	-2860	0.05	0.32	7	2	-5
0008	3T	07	152	3	1	300	790	490	0.33	2.63	0	1	1
0008	3T	07	153	3	0	300	0	-300	0.00	0.00	0	0	0
0008	3T	07	156	12	2	1200	2700	1500	0.17	2.25	2	4	2
0008	3T	07	163	1	0	100	0	-100	0.00	0.00	0	0	0
0008	3T	07	165	1	0	100	0	-100	0.00	0.00	0	0	0
0008	3T	07	234	3	1	300	870	570	0.33	2.90	0	1	1
0008	3T	07	235	6	0	600	0	-600	0.00	0.00	1	0	-1
0008	3T	07	236	1	0	100	0	-100	0.00	0.00	0	0	0
0008	3T	07	243	1	0	100	0	-100	0.00	0.00	0	0	0
0008	3T	07	245	4	0	400	0	-400	0.00	0.00	0	0	0
0008	3T	07	246	2	0	200	0	-200	0.00	0.00	0	0	0
0008	3T	07	253	1	0	100	0	-100	0.00	0.00	0	0	0
0008	3T	07	254	1	0	100	0	-100	0.00	0.00	0	0	0
0008	3T	07	256	2	0	200	0	-200	0.00	0.00	0	0	0
0008	3T	08	123	221	24	22100	15950	-6150	0.11	0.72	39	28	-11
0008	3T	08	124	684	64	68400	54610	-13790	0.09	0.80	121	96	-25
0008	3T	08	125	288	21	28800	23870	-4930	0.07	0.83	50	42	-8
0008	3T	08	126	309	23	30900	28590	-2310	0.07	0.93	54	50	-4
0008	3T	08	132	2	0	200	0	-200	0.00	0.00	0	0	0
0008	3T	08	134	188	19	18800	19260	460	0.10	1.02	33	34	1
0008	3T	08	135	152	10	15200	8110	-7090	0.07	0.53	26	14	-12
0008	3T	08	136	178	19	17800	16780	-1020	0.11	0.94	31	29	-2
0008	3T	08	142	1	0	100	0	-100	0.00	0.00	0	0	0
0008	3T	08	143	2	0	200	0	-200	0.00	0.00	0	0	0
0008	3T	08	145	81	6	8100	4670	-3430	0.07	0.58	14	8	-6
0008	3T	08	146	57	4	5700	3620	-2080	0.07	0.64	10	6	-4
0008	3T	08	153	2	0	200	0	-200	0.00	0.00	0	0	0
0008	3T	08	156	23	1	2300	1350	-950	0.04	0.59	4	2	-2
0008	3T	08	163	1	0	100	0	-100	0.00	0.00	0	0	0
0008	3T	08	216	1	0	100	0	-100	0.00	0.00	0	0	0
0008	3T	08	234	4	1	400	470	70	0.25	1.18	0	0	0
0008	3T	08	235	5	0	500	0	-500	0.00	0.00	0	0	0
0008	3T	08	236	1	0	100	0	-100	0.00	0.00	0	0	0
0008	3T	08	245	1	0	100	0	-100	0.00	0.00	0	0	0
0008	3T	08	246	3	0	300	0	-300	0.00	0.00	0	0	0
0008	3T	08	253	1	0	100	0	-100	0.00	0.00	0	0	0
0008	3T	09	123	388	43	38800	23380	-15420	0.11	0.60	68	41	-27
0008	3T	09	124	764	78	76400	60720	-15680	0.10	0.79	135	107	-28
0008	3T	09	125	279	22	27900	24680	-3220	0.08	0.88	49	43	-6
0008	3T	09	126	286	12	28600	12390	-16210	0.04	0.43	50	21	-29
0008	3T	09	132	5	0	500	0	-500	0.00	0.00	0	0	0
0008	3T	09	134	223	20	22300	18140	-4160	0.09	0.81	39	32	-7
0008	3T	09	135	153	19	15300	17410	2110	0.12	1.14	27	30	3
0008	3T	09	136	121	6	12100	8330	-3770	0.05	0.69	21	14	-7
0008	3T	09	142	3	0	300	0	-300	0.00	0.00	0	0	0
0008	3T	09	143	4	0	400	0	-400	0.00	0.00	0	0	0
0008	3T	09	145	60	3	6000	5670	-330	0.05	0.95	10	10	0
0008	3T	09	146	39	3	3900	2870	-1030	0.08	0.74	6	5	-1
0008	3T	09	153	1	0	100	0	-100	0.00	0.00	0	0	0
0008	3T	09	156	12	1	1200	5440	4240	0.08	4.53	2	9	7
0008	3T	09	164	1	0	100	0	-100	0.00	0.00	0	0	0
0008	3T	09	216	2	0	200	0	-200	0.00	0.00	0	0	0
0008	3T	09	234	8	0	800	0	-800	0.00	0.00	1	0	-1
0008	3T	09	235	3	0	300	0	-300	0.00	0.00	0	0	0
0008	3T	09	236	12	0	1200	0	-1200	0.00	0.00	2	0	-2
0008	3T	09	245	2	0	200	0	-200	0.00	0.00	0	0	0
0008	3T	09	246	2	0	200	0	-200	0.00	0.00	0	0	0
0008	3T	09	256	2	0	200	0	-200	0.00	0.00	0	0	0
0008	3T	10	123	484	67	48400	35900	-12500	0.14	0.74	85	63	-22
0008	3T	10	124	572	62	57200	56420	-780	0.11	0.99	101	99	-2
0008	3T	10	125	215	16	21500	15820	-5680	0.07	0.74	38	28	-10
0008	3T	10	126	173	11	17300	18440	1140	0.06	1.07	30	32	2
0008	3T	10	132	1	0	100	0	-100	0.00	0.00	0	0	0
0008	3T	10	134	179	10	17900	9250	-8650	0.06	0.52	31	16	-15
0008	3T	10	135	133	8	13300	7690	-5610	0.06	0.58	23	13	-10
0008	3T	10	136	91	6	9100	9130	30	0.07	1.00	16	16	0
0008	3T	10	143	2	0	200	0	-200	0.00	0.00	0	0	0
0008	3T	10	145	67	6	6700	11670	4970	0.09	1.74	11	20	9
0008	3T	10	146	40	3	4000	3260	-740	0.08	0.82	7	5	-2
0008	3T	10	153	1	1	100	770	670	1.00	7.70	0	1	1
0008	3T	10	154	1	0	100	0	-100	0.00	0.00	0	0	0
0008	3T	10	156	12	0	1200	0	-1200	0.00	0.00	2	0	-2
0008	3T	10	164	1	0	100	0	-100	0.00	0.00	0	0	0
0008	3T	10	216	4	0	400	0	-400	0.00	0.00	0	0	0
0008	3T	10	234	3	0	300	0	-300	0.00	0.00	0	0	0
0008	3T	10	235	5	1	500	340	-160	0.20	0.68	0	0	0
0008	3T	10	236	6	1	600	2180	1580	0.17	3.63	1	3	2
0008	3T	10	245	5	0	500	0	-500	0.00	0.00	0	0	0
0008	3T	10	246	5	0	500	0	-500	0.00	0.00	0	0	0
0008	3T	10	256	4	0	400	0	-400	0.00	0.00	0	0	0
0008	3T	11	123	449	47	44900	33960	-10940	0.10	0.76	79	60	-19
0008	3T	11	124	866	64	86600	86220	-380	0.07	1.00	153	152	-1
0008	3T	11	126	281	15	28100	22340	-5760	0.05	0.80	49	39	-10
0008	3T	11	134	295	35	29500	38140	8640	0.12	1.29	52	67	15
0008	3T	11	136	95	3	9500	6480	-3020	0.03	0.68	16	11	-5
0008	3T	11	143	31	1	3100	420	-2680	0.03	0.14	5	0	-5
0008	3T	11	146	36	4	3600	7020	3420	0.11	1.95	6	12	6
0008	3T	11	153	11	0	1100	0	-1100	0.00	0.00	1	0	-1
0008	3T	11	154	14	0	1400	0	-1400	0.00	0.00	2	0	-2
0008	3T	11	156	11	1	1100	1450	350	0.09	1.32	1	2	1
0008	3T	11	163	1	0	100	0	-100	0.00	0.00	0	0	0
0008	3T	11	164	3	0	300	0	-300	0.00	0.00	0	0	0
0008	3T	11	213	3	0	300	0	-300	0.00	0.00	0	0	0
0008	3T	11	214	5	0	500	0	-500	0.00	0.00	0	0	0
0008	3T	11	216	4	0	400	0	-400	0.00	0.00	0	0	0
0008	3T	11	234	75	2	7500	5920	-1580	0.03	0.79	13	10	-3
0008	3T	11	236	23	1	2300	1860	-440	0.04	0.81	4	3	-1
0008	3T	11	246	2	0	200	0	-200	0.00	0.00	0	0	0
0008	3T	11	253	3	0	300	0	-300	0.00	0.00	0	0	0
0008	3T	11	254	1	0	100	0	-100	0.00	0.00	0	0	0
0008	3T	11	256	2	0	200	0	-200	0.00	0.00	0	0	0
0008	3T	12	123	236	21	23600	17320	-6280	0.09	0.73	41	30	-11
0008	3T	12	124	1043	83	104300	74050	-30250	0.08	0.71	184	131	-53
0008	3T	12	125	97	5	9700	4880	-4820	0.05	0.50	17	8	-9
0008	3T	12	126	252	16	25200	17470	-7730	0.06	0.69	44	30	-14
0008	3T	12	132	6	0	600	0	-600	0.00	0.00	1	0	-1
0008	3T	12	134	127	12	12700	9690	-3010	0.09	0.76	22	17	-5
0008	3T	12	135	96	6	9600	6070	-3530	0.06	0.63	16	10	-6
0008	3T	12	136	135	14	13500	14870	1370	0.10	1.10	23	26	3
0008	3T	12	142	14	1	1400	1580	180	0.07	1.13	2	2	0
0008	3T	12	143	10	0	1000	0	-1000	0.00	0.00	1	0	-1
0008	3T	12	145	54	6	5400	7100	1700	0.11	1.31	9	12	3
0008	3T	12	146	42	1	4200	1190	-3010	0.02	0.28	7	2	-5
0008	3T	12	152	4	0	400	0	-400	0.00	0.00	0	0	0
0008	3T	12	153	1	0	100	0	-100	0.00	0.00	0	0	0
0008	3T	12	154	8	1	800	1330	530	0.13	1.66	1	2	1
0008	3T	12	156	27	4	2700	5690	2990	0.15	2.11	4	10	6
0008	3T	12	164	5	0	500	0	-500	0.00	0.00	0	0	0
0008	3T	12	165	1	0	100	0	-100	0.00	0.00	0	0	0
0008	3T	12	234	8	1	800	760	-40	0.13	0.95	1	1	0
0008	3T	12	236	4	1	400	1380	980	0.25	3.45	0	2	2
0008	3T	12	246	1	0	100	0	-100	0.00	0.00	0	0	0
0008	3T	12	253	2	0	200	0	-200	0.00	0.00	0	0	0
0008	3T	12	256	2	0	200	0	-200	0.00	0.00	0	0	0
0008	3T	13	123	173	16	17300	10680	-6620	0.09	0.62	30	18	-12
0008	3T	13	124	763	75	76300	70500	-5800	0.10	0.92	135	124	-11
0008	3T	13	125	182	17	18200	24350	6150	0.09	1.34	32	43	11
0008	3T	13	126	190	7	19000	9380	-9620	0.04	0.49	33	16	-17
0008	3T	13	132	12	2	1200	1020	-180	0.17	0.85	2	1	-1
0008	3T	13	134	218	25	21800	17570	-4230	0.11	0.81	38	31	-7
0008	3T	13	135	127	6	12700	5840	-6860	0.05	0.46	22	10	-12
0008	3T	13	136	153	7	15300	5450	-9850	0.05	0.36	27	9	-18
0008	3T	13	142	4	0	400	0	-400	0.00	0.00	0	0	0
0008	3T	13	143	10	1	1000	570	-430	0.10	0.57	1	1	0
0008	3T	13	145	61	4	6100	4580	-1520	0.07	0.75	10	8	-2
0008	3T	13	146	65	5	6500	4610	-1890	0.08	0.71	11	8	-3
0008	3T	13	152	5	1	500	540	40	0.20	1.08	0	0	0
0008	3T	13	153	2	0	200	0	-200	0.00	0.00	0	0	0
0008	3T	13	154	1	0	100	0	-100	0.00	0.00	0	0	0
0008	3T	13	156	16	0	1600	0	-1600	0.00	0.00	2	0	-2
0008	3T	13	163	1	0	100	0	-100	0.00	0.00	0	0	0
0008	3T	13	164	3	0	300	0	-300	0.00	0.00	0	0	0
0008	3T	13	165	2	0	200	0	-200	0.00	0.00	0	0	0
0008	3T	13	234	9	0	900	0	-900	0.00	0.00	1	0	-1
0008	3T	13	235	5	0	500	0	-500	0.00	0.00	0	0	0
0008	3T	13	236	7	1	700	1230	530	0.14	1.76	1	2	1
0008	3T	13	245	1	0	100	0	-100	0.00	0.00	0	0	0
0008	3T	13	246	1	0	100	0	-100	0.00	0.00	0	0	0
0008	3T	14	123	309	31	30900	23860	-7040	0.10	0.77	54	42	-12
0008	3T	14	124	555	42	55500	37590	-17910	0.08	0.68	98	66	-32
0008	3T	14	125	215	19	21500	20650	-850	0.09	0.96	38	36	-2
0008	3T	14	126	213	9	21300	20050	-1250	0.04	0.94	37	35	-2
0008	3T	14	132	3	0	300	0	-300	0.00	0.00	0	0	0
0008	3T	14	134	136	8	13600	7420	-6180	0.06	0.55	24	13	-11
0008	3T	14	135	139	11	13900	12040	-1860	0.08	0.87	24	21	-3
0008	3T	14	136	128	4	12800	3630	-9170	0.03	0.28	22	6	-16
0008	3T	14	142	1	0	100	0	-100	0.00	0.00	0	0	0
0008	3T	14	143	27	2	2700	1550	-1150	0.07	0.57	4	2	-2
0008	3T	14	145	62	3	6200	3510	-2690	0.05	0.57	10	6	-4
0008	3T	14	146	36	1	3600	810	-2790	0.03	0.23	6	1	-5
0008	3T	14	153	3	0	300	0	-300	0.00	0.00	0	0	0
0008	3T	14	154	7	0	700	0	-700	0.00	0.00	1	0	-1
0008	3T	14	156	19	2	1900	4630	2730	0.11	2.44	3	8	5
0008	3T	14	164	4	0	400	0	-400	0.00	0.00	0	0	0
0008	3T	14	234	8	0	800	0	-800	0.00	0.00	1	0	-1
0008	3T	14	235	3	1	300	780	480	0.33	2.60	0	1	1
0008	3T	14	236	9	1	900	1660	760	0.11	1.84	1	2	1
0008	3T	14	245	3	0	300	0	-300	0.00	0.00	0	0	0
0008	3T	14	246	2	0	200	0	-200	0.00	0.00	0	0	0
0008	3T	14	253	1	0	100	0	-100	0.00	0.00	0	0	0
0008	3T	14	256	1	0	100	0	-100	0.00	0.00	0	0	0
0008	3T	14	265	1	0	100	0	-100	0.00	0.00	0	0	0
0008	3T	15	123	249	24	24900	17390	-7510	0.10	0.70	44	30	-14
0008	3T	15	124	774	80	77400	50860	-26540	0.10	0.66	136	90	-46
0008	3T	15	125	297	20	29700	26980	-2720	0.07	0.91	52	47	-5
0008	3T	15	126	300	16	30000	28400	-1600	0.05	0.95	53	50	-3
0008	3T	15	132	3	0	300	0	-300	0.00	0.00	0	0	0
0008	3T	15	134	238	28	23800	22010	-1790	0.12	0.92	42	38	-4
0008	3T	15	135	139	9	13900	8780	-5120	0.06	0.63	24	15	-9
0008	3T	15	136	151	12	15100	13060	-2040	0.08	0.86	26	23	-3
0008	3T	15	142	5	0	500	0	-500	0.00	0.00	0	0	0
0008	3T	15	143	6	0	600	0	-600	0.00	0.00	1	0	-1
0008	3T	15	145	47	2	4700	2280	-2420	0.04	0.49	8	4	-4
0008	3T	15	146	39	2	3900	2740	-1160	0.05	0.70	6	4	-2
0008	3T	15	153	2	0	200	0	-200	0.00	0.00	0	0	0
0008	3T	15	154	2	0	200	0	-200	0.00	0.00	0	0	0
0008	3T	15	156	31	0	3100	0	-3100	0.00	0.00	5	0	-5
0008	3T	15	163	1	0	100	0	-100	0.00	0.00	0	0	0
0008	3T	15	164	2	0	200	0	-200	0.00	0.00	0	0	0
0008	3T	15	213	1	0	100	0	-100	0.00	0.00	0	0	0
0008	3T	15	216	1	0	100	0	-100	0.00	0.00	0	0	0
0008	3T	15	234	6	1	600	740	140	0.17	1.23	1	1	0
0008	3T	15	235	3	0	300	0	-300	0.00	0.00	0	0	0
0008	3T	15	236	7	0	700	0	-700	0.00	0.00	1	0	-1
0008	3T	15	245	4	0	400	0	-400	0.00	0.00	0	0	0
0008	3T	15	253	1	0	100	0	-100	0.00	0.00	0	0	0
0008	3T	15	256	2	0	200	0	-200	0.00	0.00	0	0	0
0008	3T	15	263	1	0	100	0	-100	0.00	0.00	0	0	0
0008	3T	15	265	1	0	100	0	-100	0.00	0.00	0	0	0
0008	3T	16	123	377	58	37700	30400	-7300	0.15	0.81	66	53	-13
0008	3T	16	124	648	49	64800	41800	-23000	0.08	0.65	114	73	-41
0008	3T	16	125	267	14	26700	17340	-9360	0.05	0.65	47	30	-17
0008	3T	16	126	323	23	32300	37160	4860	0.07	1.15	57	65	8
0008	3T	16	132	2	0	200	0	-200	0.00	0.00	0	0	0
0008	3T	16	134	167	11	16700	7580	-9120	0.07	0.45	29	13	-16
0008	3T	16	135	127	7	12700	8200	-4500	0.06	0.65	22	14	-8
0008	3T	16	136	130	8	13000	10460	-2540	0.06	0.80	23	18	-5
0008	3T	16	142	2	0	200	0	-200	0.00	0.00	0	0	0
0008	3T	16	143	6	1	600	970	370	0.17	1.62	1	1	0
0008	3T	16	145	85	6	8500	5720	-2780	0.07	0.67	15	10	-5
0008	3T	16	146	48	4	4800	8380	3580	0.08	1.75	8	14	6
0008	3T	16	152	1	0	100	0	-100	0.00	0.00	0	0	0
0008	3T	16	153	1	0	100	0	-100	0.00	0.00	0	0	0
0008	3T	16	156	10	2	1000	2340	1340	0.20	2.34	1	4	3
0008	3T	16	163	2	0	200	0	-200	0.00	0.00	0	0	0
0008	3T	16	164	1	0	100	0	-100	0.00	0.00	0	0	0
0008	3T	16	216	1	0	100	0	-100	0.00	0.00	0	0	0
0008	3T	16	234	1	0	100	0	-100	0.00	0.00	0	0	0
0008	3T	16	235	7	0	700	0	-700	0.00	0.00	1	0	-1
0008	3T	16	236	5	0	500	0	-500	0.00	0.00	0	0	0
0008	3T	16	245	2	1	200	1420	1220	0.50	7.10	0	2	2
0008	3T	16	246	2	0	200	0	-200	0.00	0.00	0	0	0
0008	3T	16	256	3	0	300	0	-300	0.00	0.00	0	0	0
0008	3T	16	263	1	0	100	0	-100	0.00	0.00	0	0	0
0008	3T	17	123	393	63	39300	34610	-4690	0.16	0.88	69	61	-8
0008	3T	17	124	667	58	66700	54560	-12140	0.09	0.82	118	96	-22
0008	3T	17	125	288	26	28800	28230	-570	0.09	0.98	50	49	-1
0008	3T	17	126	247	17	24700	28220	3520	0.07	1.14	43	49	6
0008	3T	17	132	14	0	1400	0	-1400	0.00	0.00	2	0	-2
0008	3T	17	134	180	23	18000	14180	-3820	0.13	0.79	31	25	-6
0008	3T	17	135	168	13	16800	17710	910	0.08	1.05	29	31	2
0008	3T	17	136	84	7	8400	5170	-3230	0.08	0.62	14	9	-5
0008	3T	17	142	6	0	600	0	-600	0.00	0.00	1	0	-1
0008	3T	17	143	10	0	1000	0	-1000	0.00	0.00	1	0	-1
0008	3T	17	145	71	2	7100	1540	-5560	0.03	0.22	12	2	-10
0008	3T	17	146	32	2	3200	3300	100	0.06	1.03	5	5	0
0008	3T	17	152	2	0	200	0	-200	0.00	0.00	0	0	0
0008	3T	17	153	2	0	200	0	-200	0.00	0.00	0	0	0
0008	3T	17	156	5	0	500	0	-500	0.00	0.00	0	0	0
0008	3T	17	162	1	0	100	0	-100	0.00	0.00	0	0	0
0008	3T	17	164	1	0	100	0	-100	0.00	0.00	0	0	0
0008	3T	17	234	7	0	700	0	-700	0.00	0.00	1	0	-1
0008	3T	17	235	5	1	500	870	370	0.20	1.74	0	1	1
0008	3T	17	236	5	0	500	0	-500	0.00	0.00	0	0	0
0008	3T	17	245	3	0	300	0	-300	0.00	0.00	0	0	0
0008	3T	17	246	1	0	100	0	-100	0.00	0.00	0	0	0
0008	3T	17	253	1	0	100	0	-100	0.00	0.00	0	0	0
0008	3T	17	254	1	0	100	0	-100	0.00	0.00	0	0	0
0008	3T	17	256	3	0	300	0	-300	0.00	0.00	0	0	0
0008	3T	17	263	1	0	100	0	-100	0.00	0.00	0	0	0
0008	3T	18	123	280	32	28000	21720	-6280	0.11	0.78	49	38	-11
0008	3T	18	124	781	82	78100	63700	-14400	0.10	0.82	138	112	-26
0008	3T	18	125	374	42	37400	39590	2190	0.11	1.06	66	70	4
0008	3T	18	126	233	17	23300	20150	-3150	0.07	0.86	41	35	-6
0008	3T	18	132	1	0	100	0	-100	0.00	0.00	0	0	0
0008	3T	18	134	195	14	19500	8790	-10710	0.07	0.45	34	15	-19
0008	3T	18	135	202	18	20200	15380	-4820	0.09	0.76	35	27	-8
0008	3T	18	136	134	11	13400	10470	-2930	0.08	0.78	23	18	-5
0008	3T	18	142	2	0	200	0	-200	0.00	0.00	0	0	0
0008	3T	18	143	7	0	700	0	-700	0.00	0.00	1	0	-1
0008	3T	18	145	109	10	10900	8380	-2520	0.09	0.77	19	14	-5
0008	3T	18	146	52	2	5200	1040	-4160	0.04	0.20	9	1	-8
0008	3T	18	153	1	0	100	0	-100	0.00	0.00	0	0	0
0008	3T	18	154	1	0	100	0	-100	0.00	0.00	0	0	0
0008	3T	18	156	6	0	600	0	-600	0.00	0.00	1	0	-1
0008	3T	18	164	1	0	100	0	-100	0.00	0.00	0	0	0
0008	3T	18	214	1	1	100	890	790	1.00	8.90	0	1	1
0008	3T	18	234	3	0	300	0	-300	0.00	0.00	0	0	0
0008	3T	18	235	9	0	900	0	-900	0.00	0.00	1	0	-1
0008	3T	18	236	3	0	300	0	-300	0.00	0.00	0	0	0
0008	3T	18	245	4	0	400	0	-400	0.00	0.00	0	0	0
0008	3T	18	246	2	0	200	0	-200	0.00	0.00	0	0	0
0008	3T	18	254	1	0	100	0	-100	0.00	0.00	0	0	0
0008	3T	18	256	2	0	200	0	-200	0.00	0.00	0	0	0
0008	3T	19	123	205	28	20500	17190	-3310	0.14	0.84	36	30	-6
0008	3T	19	124	691	75	69100	63530	-5570	0.11	0.92	122	112	-10
0008	3T	19	125	198	9	19800	11560	-8240	0.05	0.58	35	20	-15
0008	3T	19	126	221	8	22100	13890	-8210	0.04	0.63	39	24	-15
0008	3T	19	132	4	0	400	0	-400	0.00	0.00	0	0	0
0008	3T	19	134	171	19	17100	13880	-3220	0.11	0.81	30	24	-6
0008	3T	19	135	151	16	15100	10150	-4950	0.11	0.67	26	17	-9
0008	3T	19	136	155	17	15500	16250	750	0.11	1.05	27	28	1
0008	3T	19	142	4	0	400	0	-400	0.00	0.00	0	0	0
0008	3T	19	143	3	0	300	0	-300	0.00	0.00	0	0	0
0008	3T	19	145	68	6	6800	6710	-90	0.09	0.99	12	11	-1
0008	3T	19	146	29	1	2900	880	-2020	0.03	0.30	5	1	-4
0008	3T	19	154	1	0	100	0	-100	0.00	0.00	0	0	0
0008	3T	19	156	2	0	200	0	-200	0.00	0.00	0	0	0
0008	3T	19	165	1	0	100	0	-100	0.00	0.00	0	0	0
0008	3T	19	216	2	1	200	8510	8310	0.50	42.55	0	15	15
0008	3T	19	234	2	0	200	0	-200	0.00	0.00	0	0	0
0008	3T	19	235	6	1	600	880	280	0.17	1.47	1	1	0
0008	3T	19	236	2	0	200	0	-200	0.00	0.00	0	0	0
0008	3T	19	245	3	0	300	0	-300	0.00	0.00	0	0	0
0008	3T	19	246	5	0	500	0	-500	0.00	0.00	0	0	0
0008	3T	20	123	355	54	35500	35840	340	0.15	1.01	62	63	1
0008	3T	20	124	798	69	79800	51780	-28020	0.09	0.65	141	91	-50
0008	3T	20	125	250	17	25000	18640	-6360	0.07	0.75	44	32	-12
0008	3T	20	126	197	12	19700	18530	-1170	0.06	0.94	34	32	-2
0008	3T	20	132	2	0	200	0	-200	0.00	0.00	0	0	0
0008	3T	20	134	214	21	21400	15320	-6080	0.10	0.72	37	27	-10
0008	3T	20	135	147	17	14700	17380	2680	0.12	1.18	26	30	4
0008	3T	20	136	148	10	14800	9080	-5720	0.07	0.61	26	16	-10
0008	3T	20	142	2	0	200	0	-200	0.00	0.00	0	0	0
0008	3T	20	143	1	0	100	0	-100	0.00	0.00	0	0	0
0008	3T	20	145	67	0	6700	0	-6700	0.00	0.00	11	0	-11
0008	3T	20	146	67	6	6700	4930	-1770	0.09	0.74	11	8	-3
0008	3T	20	153	3	1	300	1340	1040	0.33	4.47	0	2	2
0008	3T	20	156	22	0	2200	0	-2200	0.00	0.00	3	0	-3
0008	3T	20	164	1	0	100	0	-100	0.00	0.00	0	0	0
0008	3T	20	213	1	0	100	0	-100	0.00	0.00	0	0	0
0008	3T	20	235	2	0	200	0	-200	0.00	0.00	0	0	0
0008	3T	20	236	2	0	200	0	-200	0.00	0.00	0	0	0
0008	3T	20	245	1	0	100	0	-100	0.00	0.00	0	0	0
0008	3T	20	253	1	0	100	0	-100	0.00	0.00	0	0	0
0008	3T	21	123	349	43	34900	26280	-8620	0.12	0.75	61	46	-15
0008	3T	21	124	774	69	77400	53520	-23880	0.09	0.69	136	94	-42
0008	3T	21	125	332	31	33200	31390	-1810	0.09	0.95	58	55	-3
0008	3T	21	126	220	17	22000	21290	-710	0.08	0.97	38	37	-1
0008	3T	21	132	2	0	200	0	-200	0.00	0.00	0	0	0
0008	3T	21	134	242	35	24200	30120	5920	0.14	1.24	42	53	11
0008	3T	21	135	269	38	26900	22670	-4230	0.14	0.84	47	40	-7
0008	3T	21	136	87	4	8700	4680	-4020	0.05	0.54	15	8	-7
0008	3T	21	142	2	0	200	0	-200	0.00	0.00	0	0	0
0008	3T	21	143	6	1	600	750	150	0.17	1.25	1	1	0
0008	3T	21	145	53	4	5300	3470	-1830	0.08	0.65	9	6	-3
0008	3T	21	146	23	1	2300	480	-1820	0.04	0.21	4	0	-4
0008	3T	21	152	1	0	100	0	-100	0.00	0.00	0	0	0
0008	3T	21	153	3	0	300	0	-300	0.00	0.00	0	0	0
0008	3T	21	154	2	0	200	0	-200	0.00	0.00	0	0	0
0008	3T	21	156	3	1	300	2480	2180	0.33	8.27	0	4	4
0008	3T	21	215	1	0	100	0	-100	0.00	0.00	0	0	0
0008	3T	21	234	1	0	100	0	-100	0.00	0.00	0	0	0
0008	3T	21	235	1	0	100	0	-100	0.00	0.00	0	0	0
0008	3T	21	236	1	0	100	0	-100	0.00	0.00	0	0	0
0008	3T	21	256	1	0	100	0	-100	0.00	0.00	0	0	0
0008	3T	22	123	168	24	16800	16980	180	0.14	1.01	29	30	1
0008	3T	22	124	1013	80	101300	73170	-28130	0.08	0.72	179	129	-50
0008	3T	22	125	99	5	9900	11040	1140	0.05	1.12	17	19	2
0008	3T	22	126	182	12	18200	20950	2750	0.07	1.15	32	37	5
0008	3T	22	134	296	28	29600	22540	-7060	0.09	0.76	52	39	-13
0008	3T	22	135	43	5	4300	3510	-790	0.12	0.82	7	6	-1
0008	3T	22	136	69	7	6900	10230	3330	0.10	1.48	12	18	6
0008	3T	22	143	9	0	900	0	-900	0.00	0.00	1	0	-1
0008	3T	22	145	9	1	900	3000	2100	0.11	3.33	1	5	4
0008	3T	22	146	9	0	900	0	-900	0.00	0.00	1	0	-1
0008	3T	22	153	2	0	200	0	-200	0.00	0.00	0	0	0
0008	3T	22	154	6	0	600	0	-600	0.00	0.00	1	0	-1
0008	3T	22	156	5	0	500	0	-500	0.00	0.00	0	0	0
0008	3T	22	163	4	1	400	1420	1020	0.25	3.55	0	2	2
0008	3T	22	164	3	0	300	0	-300	0.00	0.00	0	0	0
0008	3T	22	165	1	0	100	0	-100	0.00	0.00	0	0	0
0008	3T	22	214	5	0	500	0	-500	0.00	0.00	0	0	0
0008	3T	22	215	2	0	200	0	-200	0.00	0.00	0	0	0
0008	3T	22	216	1	0	100	0	-100	0.00	0.00	0	0	0
0008	3T	22	234	9	1	900	1660	760	0.11	1.84	1	2	1
0008	3T	22	235	6	0	600	0	-600	0.00	0.00	1	0	-1
0008	3T	22	236	3	0	300	0	-300	0.00	0.00	0	0	0
0008	3T	22	243	1	0	100	0	-100	0.00	0.00	0	0	0
0008	3T	22	245	1	0	100	0	-100	0.00	0.00	0	0	0
0008	3T	22	246	2	0	200	0	-200	0.00	0.00	0	0	0
0008	3T	22	256	1	0	100	0	-100	0.00	0.00	0	0	0
0008	3T	23	123	228	27	22800	17270	-5530	0.12	0.76	40	30	-10
0008	3T	23	124	1016	64	101600	74760	-26840	0.06	0.74	179	132	-47
0008	3T	23	125	138	4	13800	3240	-10560	0.03	0.23	24	5	-19
0008	3T	23	126	138	6	13800	8020	-5780	0.04	0.58	24	14	-10
0008	3T	23	132	49	6	4900	3720	-1180	0.12	0.76	8	6	-2
0008	3T	23	134	201	11	20100	12050	-8050	0.05	0.60	35	21	-14
0008	3T	23	135	115	9	11500	6250	-5250	0.08	0.54	20	11	-9
0008	3T	23	136	95	7	9500	14180	4680	0.07	1.49	16	25	9
0008	3T	23	142	13	0	1300	0	-1300	0.00	0.00	2	0	-2
0008	3T	23	143	1	0	100	0	-100	0.00	0.00	0	0	0
0008	3T	23	145	87	6	8700	4710	-3990	0.07	0.54	15	8	-7
0008	3T	23	146	67	2	6700	1750	-4950	0.03	0.26	11	3	-8
0008	3T	23	152	4	0	400	0	-400	0.00	0.00	0	0	0
0008	3T	23	153	3	0	300	0	-300	0.00	0.00	0	0	0
0008	3T	23	154	4	0	400	0	-400	0.00	0.00	0	0	0
0008	3T	23	156	16	1	1600	910	-690	0.06	0.57	2	1	-1
0008	3T	23	164	1	0	100	0	-100	0.00	0.00	0	0	0
0008	3T	23	214	1	0	100	0	-100	0.00	0.00	0	0	0
0008	3T	23	234	15	0	1500	0	-1500	0.00	0.00	2	0	-2
0008	3T	23	235	3	0	300	0	-300	0.00	0.00	0	0	0
0008	3T	23	236	1	0	100	0	-100	0.00	0.00	0	0	0
0008	3T	23	245	2	0	200	0	-200	0.00	0.00	0	0	0
0008	3T	23	246	1	0	100	0	-100	0.00	0.00	0	0	0
0008	3T	23	253	1	0	100	0	-100	0.00	0.00	0	0	0
0008	3T	23	254	1	0	100	0	-100	0.00	0.00	0	0	0
0008	3T	23	256	2	1	200	730	530	0.50	3.65	0	1	1
0008	3T	23	264	1	0	100	0	-100	0.00	0.00	0	0	0
0008	3T	24	123	430	74	43000	40490	-2510	0.17	0.94	76	71	-5
0008	3T	24	124	690	54	69000	36610	-32390	0.08	0.53	122	64	-58
0008	3T	24	125	223	22	22300	18230	-4070	0.10	0.82	39	32	-7
0008	3T	24	126	247	18	24700	19460	-5240	0.07	0.79	43	34	-9
0008	3T	24	132	3	0	300	0	-300	0.00	0.00	0	0	0
0008	3T	24	134	216	26	21600	18700	-2900	0.12	0.87	38	33	-5
0008	3T	24	135	142	14	14200	10730	-3470	0.10	0.76	25	18	-7
0008	3T	24	136	137	7	13700	7460	-6240	0.05	0.54	24	13	-11
0008	3T	24	142	2	0	200	0	-200	0.00	0.00	0	0	0
0008	3T	24	143	28	1	2800	780	-2020	0.04	0.28	4	1	-3
0008	3T	24	145	54	2	5400	1670	-3730	0.04	0.31	9	2	-7
0008	3T	24	146	23	1	2300	610	-1690	0.04	0.27	4	1	-3
0008	3T	24	152	3	0	300	0	-300	0.00	0.00	0	0	0
0008	3T	24	153	6	0	600	0	-600	0.00	0.00	1	0	-1
0008	3T	24	154	1	0	100	0	-100	0.00	0.00	0	0	0
0008	3T	24	156	6	1	600	1910	1310	0.17	3.18	1	3	2
0008	3T	24	163	2	0	200	0	-200	0.00	0.00	0	0	0
0008	3T	24	216	1	0	100	0	-100	0.00	0.00	0	0	0
0008	3T	24	234	9	0	900	0	-900	0.00	0.00	1	0	-1
0008	3T	24	235	3	0	300	0	-300	0.00	0.00	0	0	0
0008	3T	24	236	7	1	700	1820	1120	0.14	2.60	1	3	2
0008	3T	24	243	1	0	100	0	-100	0.00	0.00	0	0	0
0008	3T	24	245	1	0	100	0	-100	0.00	0.00	0	0	0
0010	2F	2_0	14	47	13	4700	4750	50	0.28	1.01	8	8	0
0010	2F	2_0	15	19	1	1900	390	-1510	0.05	0.21	3	0	-3
0010	2F	2_0	16	13	2	1300	780	-520	0.15	0.60	2	1	-1
0010	2F	2_0	23	8	1	800	240	-560	0.13	0.30	1	0	-1
0010	2F	2_0	24	4	0	400	0	-400	0.00	0.00	0	0	0
0010	2F	2_0	25	2	1	200	610	410	0.50	3.05	0	1	1
0010	2F	2_0	26	3	0	300	0	-300	0.00	0.00	0	0	0
0010	2F	2_1	12	770	271	77000	69940	-7060	0.35	0.91	136	123	-13
0010	2F	2_1	13	301	96	30100	24120	-5980	0.32	0.80	53	42	-11
0010	2F	2_1	14	181	59	18100	15340	-2760	0.33	0.85	32	27	-5
0010	2F	2_1	15	66	19	6600	6860	260	0.29	1.04	11	12	1
0013	1T	1_	1	17	10	1700	1840	140	0.59	1.08	3	3	0
0013	1T	1_	2	3	1	300	100	-200	0.33	0.33	0	0	0
0013	1T	1_A1	1	3941	2743	394100	346610	-47490	0.70	0.88	697	613	-84
0013	1T	1_A1	2	35	4	3500	1790	-1710	0.11	0.51	6	3	-3
0013	1T	1_A2	1	3584	2053	358400	322630	-35770	0.57	0.90	634	571	-63
0013	1T	1_A2	2	99	29	9900	9160	-740	0.29	0.93	17	16	-1
0013	1T	1_B1	1	3524	1472	352400	364710	12310	0.42	1.03	623	645	22
0013	1T	1_B1	2	1130	456	113000	111790	-1210	0.40	0.99	200	197	-3
0013	1T	1_B2	1	76	38	7600	8870	1270	0.50	1.17	13	15	2
0013	1T	1_B2	2	42	13	4200	2730	-1470	0.31	0.65	7	4	-3
0013	1T	2_	1	16	10	1600	1440	-160	0.63	0.90	2	2	0
0013	1T	2_	2	2	2	200	420	220	1.00	2.10	0	0	0
0013	1T	2_A1	1	3739	2581	373900	330310	-43590	0.69	0.88	661	584	-77
0013	1T	2_A1	2	34	5	3400	1690	-1710	0.15	0.50	6	2	-4
0013	1T	2_A2	1	3537	1923	353700	318840	-34860	0.54	0.90	626	564	-62
0013	1T	2_A2	2	140	50	14000	13120	-880	0.36	0.94	24	23	-1
0013	1T	2_B1	1	3564	1354	356400	347800	-8600	0.38	0.98	630	615	-15
0013	1T	2_B1	2	1116	374	111600	102210	-9390	0.34	0.92	197	180	-17
0013	1T	2_B2	1	121	46	12100	8130	-3970	0.38	0.67	21	14	-7
0013	1T	2_B2	2	85	34	8500	8730	230	0.40	1.03	15	15	0
0013	1T	3_	1	48	29	4800	5050	250	0.60	1.05	8	8	0
0013	1T	3_	2	5	1	500	150	-350	0.20	0.30	0	0	0
0013	1T	3_A1	1	3624	2560	362400	325380	-37020	0.71	0.90	641	575	-66
0013	1T	3_A1	2	49	8	4900	2390	-2510	0.16	0.49	8	4	-4
0013	1T	3_A2	1	3638	2111	363800	349670	-14130	0.58	0.96	643	618	-25
0013	1T	3_A2	2	172	47	17200	13040	-4160	0.27	0.76	30	23	-7
0013	1T	3_B1	1	3367	1385	336700	340970	4270	0.41	1.01	595	603	8
0013	1T	3_B1	2	1122	400	112200	118350	6150	0.36	1.05	198	209	11
0013	1T	3_B2	1	114	60	11400	15880	4480	0.53	1.39	20	28	8
0013	1T	3_B2	2	95	38	9500	11160	1660	0.40	1.17	16	19	3
0013	1T	4_	1	18	8	1800	1210	-590	0.44	0.67	3	2	-1
0013	1T	4_	2	2	0	200	0	-200	0.00	0.00	0	0	0
0013	1T	4_A1	1	4027	2942	402700	369470	-33230	0.73	0.92	712	653	-59
0013	1T	4_A1	2	34	7	3400	6620	3220	0.21	1.95	6	11	5
0013	1T	4_A2	1	2291	1364	229100	214440	-14660	0.60	0.94	405	379	-26
0013	1T	4_A2	2	102	33	10200	9840	-360	0.32	0.96	18	17	-1
0013	1T	4_B1	1	2792	1017	279200	265010	-14190	0.36	0.95	494	469	-25
0013	1T	4_B1	2	790	257	79000	77550	-1450	0.33	0.98	139	137	-2
0013	1T	4_B2	1	75	23	7500	6090	-1410	0.31	0.81	13	10	-3
0013	1T	4_B2	2	188	50	18800	15530	-3270	0.27	0.83	33	27	-6
0013	1T	5_	1	20	9	2000	1140	-860	0.45	0.57	3	2	-1
0013	1T	5_	2	4	0	400	0	-400	0.00	0.00	0	0	0
0013	1T	5_A1	1	3076	2278	307600	277920	-29680	0.74	0.90	544	491	-53
0013	1T	5_A1	2	56	10	5600	6530	930	0.18	1.17	9	11	2
0013	1T	5_A2	1	2599	1576	259900	236650	-23250	0.61	0.91	460	418	-42
0013	1T	5_A2	2	146	20	14600	13610	-990	0.14	0.93	25	24	-1
0013	1T	5_B1	1	1517	701	151700	151950	250	0.46	1.00	268	268	0
0013	1T	5_B1	2	333	90	33300	29880	-3420	0.27	0.90	58	52	-6
0013	1T	5_B2	1	102	54	10200	10130	-70	0.53	0.99	18	17	-1
0013	1T	5_B2	2	48	16	4800	7520	2720	0.33	1.57	8	13	5
0013	1T	6_A1	1	244	176	24400	20990	-3410	0.72	0.86	43	37	-6
0013	1T	6_A1	2	3	1	300	340	40	0.33	1.13	0	0	0
0013	1T	6_A2	1	208	117	20800	17730	-3070	0.56	0.85	36	31	-5
0013	1T	6_A2	2	4	2	400	520	120	0.50	1.30	0	0	0
0013	1T	6_B1	1	147	69	14700	14970	270	0.47	1.02	26	26	0
0013	1T	6_B1	2	30	11	3000	3530	530	0.37	1.18	5	6	1
0013	1T	6_B2	1	4	3	400	1320	920	0.75	3.30	0	2	2
0013	1T	6_B2	2	10	6	1000	2240	1240	0.60	2.24	1	3	2
0013	1T	7_	1	21	12	2100	2150	50	0.57	1.02	3	3	0
0013	1T	7_	2	1	1	100	280	180	1.00	2.80	0	0	0
0013	1T	7_A1	1	4121	2967	412100	362440	-49660	0.72	0.88	729	641	-88
0013	1T	7_A1	2	52	5	5200	2650	-2550	0.10	0.51	9	4	-5
0013	1T	7_A2	1	4511	2914	451100	423020	-28080	0.65	0.94	798	748	-50
0013	1T	7_A2	2	144	21	14400	10080	-4320	0.15	0.70	25	17	-8
0013	1T	7_B1	1	2940	1417	294000	277380	-16620	0.48	0.94	520	490	-30
0013	1T	7_B1	2	787	229	78700	73360	-5340	0.29	0.93	139	129	-10
0013	1T	7_B2	1	115	53	11500	11960	460	0.46	1.04	20	21	1
0013	1T	7_B2	2	89	33	8900	10810	1910	0.37	1.21	15	19	4
0013	2F	1_	12	10	4	1000	1610	610	0.40	1.61	1	2	1
0013	2F	1_	13	2	1	200	420	220	0.50	2.10	0	0	0
0013	2F	1_	14	2	2	200	550	350	1.00	2.75	0	0	0
0013	2F	1_	15	1	0	100	0	-100	0.00	0.00	0	0	0
0013	2F	1_	23	3	0	300	0	-300	0.00	0.00	0	0	0
0013	2F	1_A1	12	1866	559	186600	144940	-41660	0.30	0.78	330	256	-74
0013	2F	1_A1	13	969	259	96900	76900	-20000	0.27	0.79	171	136	-35
0013	2F	1_A1	14	548	121	54800	42150	-12650	0.22	0.77	96	74	-22
0013	2F	1_A1	15	163	21	16300	10790	-5510	0.13	0.66	28	19	-9
0013	2F	1_A1	16	42	2	4200	1430	-2770	0.05	0.34	7	2	-5
0013	2F	1_A1	23	10	0	1000	0	-1000	0.00	0.00	1	0	-1
0013	2F	1_A1	25	1	0	100	0	-100	0.00	0.00	0	0	0
0013	2F	1_A1	26	1	0	100	0	-100	0.00	0.00	0	0	0
0013	2F	1_A2	12	1371	441	137100	123040	-14060	0.32	0.90	242	217	-25
0013	2F	1_A2	13	844	259	84400	75660	-8740	0.31	0.90	149	133	-16
0013	2F	1_A2	14	544	131	54400	43120	-11280	0.24	0.79	96	76	-20
0013	2F	1_A2	15	167	27	16700	20750	4050	0.16	1.24	29	36	7
0013	2F	1_A2	16	109	21	10900	19830	8930	0.19	1.82	19	35	16
0013	2F	1_A2	23	21	1	2100	600	-1500	0.05	0.29	3	1	-2
0013	2F	1_A2	24	10	0	1000	0	-1000	0.00	0.00	1	0	-1
0013	2F	1_A2	25	6	0	600	0	-600	0.00	0.00	1	0	-1
0013	2F	1_A2	26	5	0	500	0	-500	0.00	0.00	0	0	0
0013	2F	1_B1	12	1482	412	148200	137080	-11120	0.28	0.92	262	242	-20
0013	2F	1_B1	13	775	171	77500	67260	-10240	0.22	0.87	137	119	-18
0013	2F	1_B1	14	527	112	52700	51990	-710	0.21	0.99	93	92	-1
0013	2F	1_B1	15	249	39	24900	20310	-4590	0.16	0.82	44	35	-9
0013	2F	1_B1	16	189	23	18900	13900	-5000	0.12	0.74	33	24	-9
0013	2F	1_B1	23	165	37	16500	19620	3120	0.22	1.19	29	34	5
0013	2F	1_B1	24	114	15	11400	4930	-6470	0.13	0.43	20	8	-12
0013	2F	1_B1	25	81	9	8100	4600	-3500	0.11	0.57	14	8	-6
0013	2F	1_B1	26	92	14	9200	8470	-730	0.15	0.92	16	14	-2
0013	2F	1_B2	12	32	6	3200	2270	-930	0.19	0.71	5	4	-1
0013	2F	1_B2	13	21	3	2100	590	-1510	0.14	0.28	3	1	-2
0013	2F	1_B2	14	5	2	500	900	400	0.40	1.80	0	1	1
0013	2F	1_B2	15	9	2	900	2660	1760	0.22	2.96	1	4	3
0013	2F	1_B2	16	5	0	500	0	-500	0.00	0.00	0	0	0
0013	2F	1_B2	23	15	1	1500	220	-1280	0.07	0.15	2	0	-2
0013	2F	1_B2	24	1	1	100	1040	940	1.00	10.40	0	1	1
0013	2F	1_B2	25	5	2	500	620	120	0.40	1.24	0	1	1
0013	2F	1_B2	26	2	0	200	0	-200	0.00	0.00	0	0	0
0013	2F	2_	12	6	2	600	550	-50	0.33	0.92	1	0	-1
0013	2F	2_	13	4	2	400	330	-70	0.50	0.83	0	0	0
0013	2F	2_	14	4	1	400	210	-190	0.25	0.53	0	0	0
0013	2F	2_	15	2	2	200	1460	1260	1.00	7.30	0	2	2
0013	2F	2_	16	1	0	100	0	-100	0.00	0.00	0	0	0
0013	2F	2_	23	1	1	100	1290	1190	1.00	12.90	0	2	2
0013	2F	2_A1	12	1769	565	176900	146390	-30510	0.32	0.83	313	259	-54
0013	2F	2_A1	13	876	252	87600	72850	-14750	0.29	0.83	155	128	-27
0013	2F	2_A1	14	558	142	55800	46800	-9000	0.25	0.84	98	82	-16
0013	2F	2_A1	15	172	30	17200	14310	-2890	0.17	0.83	30	25	-5
0013	2F	2_A1	16	87	13	8700	3920	-4780	0.15	0.45	15	6	-9
0013	2F	2_A1	23	9	0	900	0	-900	0.00	0.00	1	0	-1
0013	2F	2_A1	24	5	0	500	0	-500	0.00	0.00	0	0	0
0013	2F	2_A2	12	1282	426	128200	111710	-16490	0.33	0.87	226	197	-29
0013	2F	2_A2	13	812	265	81200	76600	-4600	0.33	0.94	143	135	-8
0013	2F	2_A2	14	567	156	56700	42810	-13890	0.28	0.76	100	75	-25
0013	2F	2_A2	15	197	52	19700	18710	-990	0.26	0.95	34	33	-1
0013	2F	2_A2	16	164	37	16400	19760	3360	0.23	1.20	29	34	5
0013	2F	2_A2	23	18	0	1800	0	-1800	0.00	0.00	3	0	-3
0013	2F	2_A2	24	12	3	1200	11600	10400	0.25	9.67	2	20	18
0013	2F	2_A2	25	10	1	1000	440	-560	0.10	0.44	1	0	-1
0013	2F	2_A2	26	9	4	900	1730	830	0.44	1.92	1	3	2
0013	2F	2_B1	12	1560	378	156000	132690	-23310	0.24	0.85	276	234	-42
0013	2F	2_B1	13	809	155	80900	74270	-6630	0.19	0.92	143	131	-12
0013	2F	2_B1	14	499	72	49900	34980	-14920	0.14	0.70	88	61	-27
0013	2F	2_B1	15	266	32	26600	21870	-4730	0.12	0.82	47	38	-9
0013	2F	2_B1	16	199	29	19900	32700	12800	0.15	1.64	35	57	22
0013	2F	2_B1	23	234	38	23400	22000	-1400	0.16	0.94	41	38	-3
0013	2F	2_B1	24	146	20	14600	12180	-2420	0.14	0.83	25	21	-4
0013	2F	2_B1	25	88	15	8800	6600	-2200	0.17	0.75	15	11	-4
0013	2F	2_B1	26	80	8	8000	4820	-3180	0.10	0.60	14	8	-6
0013	2F	2_B2	12	62	13	6200	4400	-1800	0.21	0.71	10	7	-3
0013	2F	2_B2	13	33	8	3300	2760	-540	0.24	0.84	5	4	-1
0013	2F	2_B2	14	18	4	1800	3520	1720	0.22	1.96	3	6	3
0013	2F	2_B2	15	5	1	500	960	460	0.20	1.92	0	1	1
0013	2F	2_B2	16	2	0	200	0	-200	0.00	0.00	0	0	0
0013	2F	2_B2	23	18	3	1800	1060	-740	0.17	0.59	3	1	-2
0013	2F	2_B2	24	11	2	1100	2410	1310	0.18	2.19	1	4	3
0013	2F	2_B2	25	14	5	1400	2070	670	0.36	1.48	2	3	1
0013	2F	2_B2	26	6	0	600	0	-600	0.00	0.00	1	0	-1
0013	2F	3_	12	27	5	2700	1210	-1490	0.19	0.45	4	2	-2
0013	2F	3_	13	8	1	800	210	-590	0.13	0.26	1	0	-1
0013	2F	3_	14	6	2	600	610	10	0.33	1.02	1	1	0
0013	2F	3_	15	2	0	200	0	-200	0.00	0.00	0	0	0
0013	2F	3_	16	1	0	100	0	-100	0.00	0.00	0	0	0
0013	2F	3_	23	1	0	100	0	-100	0.00	0.00	0	0	0
0013	2F	3_	24	1	0	100	0	-100	0.00	0.00	0	0	0
0013	2F	3_	25	1	0	100	0	-100	0.00	0.00	0	0	0
0013	2F	3_A1	12	1807	582	180700	147910	-32790	0.32	0.82	319	261	-58
0013	2F	3_A1	13	832	210	83200	67640	-15560	0.25	0.81	147	119	-28
0013	2F	3_A1	14	483	98	48300	43110	-5190	0.20	0.89	85	76	-9
0013	2F	3_A1	15	151	33	15100	16010	910	0.22	1.06	26	28	2
0013	2F	3_A1	16	68	16	6800	6840	40	0.24	1.01	12	12	0
0013	2F	3_A1	23	4	1	400	760	360	0.25	1.90	0	1	1
0013	2F	3_A1	24	7	0	700	0	-700	0.00	0.00	1	0	-1
0013	2F	3_A1	25	5	0	500	0	-500	0.00	0.00	0	0	0
0013	2F	3_A1	26	1	0	100	0	-100	0.00	0.00	0	0	0
0013	2F	3_A2	12	1456	462	145600	128230	-17370	0.32	0.88	257	226	-31
0013	2F	3_A2	13	837	231	83700	78210	-5490	0.28	0.93	148	138	-10
0013	2F	3_A2	14	554	134	55400	51800	-3600	0.24	0.94	98	91	-7
0013	2F	3_A2	15	207	33	20700	13710	-6990	0.16	0.66	36	24	-12
0013	2F	3_A2	16	127	18	12700	17180	4480	0.14	1.35	22	30	8
0013	2F	3_A2	23	25	1	2500	1170	-1330	0.04	0.47	4	2	-2
0013	2F	3_A2	24	15	2	1500	1050	-450	0.13	0.70	2	1	-1
0013	2F	3_A2	25	9	2	900	1320	420	0.22	1.47	1	2	1
0013	2F	3_A2	26	10	0	1000	0	-1000	0.00	0.00	1	0	-1
0013	2F	3_B1	12	1458	395	145800	140390	-5410	0.27	0.96	258	248	-10
0013	2F	3_B1	13	779	179	77900	72620	-5280	0.23	0.93	137	128	-9
0013	2F	3_B1	14	464	72	46400	39860	-6540	0.16	0.86	82	70	-12
0013	2F	3_B1	15	294	29	29400	22410	-6990	0.10	0.76	52	39	-13
0013	2F	3_B1	16	205	26	20500	19000	-1500	0.13	0.93	36	33	-3
0013	2F	3_B1	23	211	35	21100	22570	1470	0.17	1.07	37	39	2
0013	2F	3_B1	24	94	20	9400	12680	3280	0.21	1.35	16	22	6
0013	2F	3_B1	25	105	14	10500	7830	-2670	0.13	0.75	18	13	-5
0013	2F	3_B1	26	88	15	8800	8630	-170	0.17	0.98	15	15	0
0013	2F	3_B2	12	66	15	6600	6680	80	0.23	1.01	11	11	0
0013	2F	3_B2	13	30	6	3000	3300	300	0.20	1.10	5	5	0
0013	2F	3_B2	14	9	1	900	230	-670	0.11	0.26	1	0	-1
0013	2F	3_B2	15	10	0	1000	0	-1000	0.00	0.00	1	0	-1
0013	2F	3_B2	16	4	1	400	570	170	0.25	1.43	0	1	1
0013	2F	3_B2	23	26	6	2600	2340	-260	0.23	0.90	4	4	0
0013	2F	3_B2	24	9	4	900	1740	840	0.44	1.93	1	3	2
0013	2F	3_B2	25	9	1	900	550	-350	0.11	0.61	1	0	-1
0013	2F	3_B2	26	5	1	500	270	-230	0.20	0.54	0	0	0
0013	2F	4_	12	9	4	900	900	0	0.44	1.00	1	1	0
0013	2F	4_	13	4	0	400	0	-400	0.00	0.00	0	0	0
0013	2F	4_	14	2	0	200	0	-200	0.00	0.00	0	0	0
0013	2F	4_	15	1	0	100	0	-100	0.00	0.00	0	0	0
0013	2F	4_	23	1	0	100	0	-100	0.00	0.00	0	0	0
0013	2F	4_A1	12	1970	695	197000	170770	-26230	0.35	0.87	348	302	-46
0013	2F	4_A1	13	969	312	96900	84940	-11960	0.32	0.88	171	150	-21
0013	2F	4_A1	14	568	142	56800	51890	-4910	0.25	0.91	100	91	-9
0013	2F	4_A1	15	162	24	16200	10200	-6000	0.15	0.63	28	18	-10
0013	2F	4_A1	16	74	10	7400	8920	1520	0.14	1.21	13	15	2
0013	2F	4_A1	23	6	0	600	0	-600	0.00	0.00	1	0	-1
0013	2F	4_A1	24	2	1	200	910	710	0.50	4.55	0	1	1
0013	2F	4_A1	25	1	0	100	0	-100	0.00	0.00	0	0	0
0013	2F	4_A1	26	3	0	300	0	-300	0.00	0.00	0	0	0
0013	2F	4_A2	12	864	281	86400	73370	-13030	0.33	0.85	152	129	-23
0013	2F	4_A2	13	532	157	53200	48510	-4690	0.30	0.91	94	85	-9
0013	2F	4_A2	14	376	116	37600	35700	-1900	0.31	0.95	66	63	-3
0013	2F	4_A2	15	143	27	14300	10570	-3730	0.19	0.74	25	18	-7
0013	2F	4_A2	16	71	12	7100	5840	-1260	0.17	0.82	12	10	-2
0013	2F	4_A2	23	14	0	1400	0	-1400	0.00	0.00	2	0	-2
0013	2F	4_A2	24	11	2	1100	3460	2360	0.18	3.15	1	6	5
0013	2F	4_A2	25	4	0	400	0	-400	0.00	0.00	0	0	0
0013	2F	4_A2	26	7	0	700	0	-700	0.00	0.00	1	0	-1
0013	2F	4_B1	12	1212	257	121200	101210	-19990	0.21	0.84	214	179	-35
0013	2F	4_B1	13	707	107	70700	49030	-21670	0.15	0.69	125	86	-39
0013	2F	4_B1	14	473	62	47300	40410	-6890	0.13	0.85	83	71	-12
0013	2F	4_B1	15	170	18	17000	17680	680	0.11	1.04	30	31	1
0013	2F	4_B1	16	65	4	6500	4510	-1990	0.06	0.69	11	7	-4
0013	2F	4_B1	23	196	33	19600	22710	3110	0.17	1.16	34	40	6
0013	2F	4_B1	24	112	17	11200	11930	730	0.15	1.07	19	21	2
0013	2F	4_B1	25	66	8	6600	14720	8120	0.12	2.23	11	26	15
0013	2F	4_B1	26	22	2	2200	2180	-20	0.09	0.99	3	3	0
0013	2F	4_B2	12	45	7	4500	2200	-2300	0.16	0.49	7	3	-4
0013	2F	4_B2	13	15	1	1500	390	-1110	0.07	0.26	2	0	-2
0013	2F	4_B2	14	11	0	1100	0	-1100	0.00	0.00	1	0	-1
0013	2F	4_B2	15	5	0	500	0	-500	0.00	0.00	0	0	0
0013	2F	4_B2	16	8	0	800	0	-800	0.00	0.00	1	0	-1
0013	2F	4_B2	23	69	16	6900	9820	2920	0.23	1.42	12	17	5
0013	2F	4_B2	24	35	4	3500	1320	-2180	0.11	0.38	6	2	-4
0013	2F	4_B2	25	22	2	2200	880	-1320	0.09	0.40	3	1	-2
0013	2F	4_B2	26	5	0	500	0	-500	0.00	0.00	0	0	0
0013	2F	5_	12	10	2	1000	720	-280	0.20	0.72	1	1	0
0013	2F	5_	13	6	1	600	170	-430	0.17	0.28	1	0	-1
0013	2F	5_	14	3	2	300	620	320	0.67	2.07	0	1	1
0013	2F	5_	16	1	0	100	0	-100	0.00	0.00	0	0	0
0013	2F	5_	24	1	0	100	0	-100	0.00	0.00	0	0	0
0013	2F	5_	26	2	0	200	0	-200	0.00	0.00	0	0	0
0013	2F	5_A1	12	1541	575	154100	133010	-21090	0.37	0.86	272	235	-37
0013	2F	5_A1	13	718	178	71800	53790	-18010	0.25	0.75	127	95	-32
0013	2F	5_A1	14	447	92	44700	37320	-7380	0.21	0.83	79	66	-13
0013	2F	5_A1	15	87	16	8700	12900	4200	0.18	1.48	15	22	7
0013	2F	5_A1	16	31	5	3100	7130	4030	0.16	2.30	5	12	7
0013	2F	5_A1	23	11	0	1100	0	-1100	0.00	0.00	1	0	-1
0013	2F	5_A1	24	6	0	600	0	-600	0.00	0.00	1	0	-1
0013	2F	5_A1	25	1	0	100	0	-100	0.00	0.00	0	0	0
0013	2F	5_A1	26	3	0	300	0	-300	0.00	0.00	0	0	0
0013	2F	5_A2	12	962	277	96200	84510	-11690	0.29	0.88	170	149	-21
0013	2F	5_A2	13	622	132	62200	42400	-19800	0.21	0.68	110	75	-35
0013	2F	5_A2	14	418	94	41800	37520	-4280	0.22	0.90	73	66	-7
0013	2F	5_A2	15	142	16	14200	10340	-3860	0.11	0.73	25	18	-7
0013	2F	5_A2	16	40	1	4000	200	-3800	0.03	0.05	7	0	-7
0013	2F	5_A2	23	33	1	3300	1810	-1490	0.03	0.55	5	3	-2
0013	2F	5_A2	24	20	3	2000	6560	4560	0.15	3.28	3	11	8
0013	2F	5_A2	25	14	0	1400	0	-1400	0.00	0.00	2	0	-2
0013	2F	5_A2	26	3	0	300	0	-300	0.00	0.00	0	0	0
0013	2F	5_B1	12	615	166	61500	59820	-1680	0.27	0.97	108	105	-3
0013	2F	5_B1	13	348	65	34800	24350	-10450	0.19	0.70	61	43	-18
0013	2F	5_B1	14	233	44	23300	20300	-3000	0.19	0.87	41	35	-6
0013	2F	5_B1	15	124	12	12400	7300	-5100	0.10	0.59	21	12	-9
0013	2F	5_B1	16	72	9	7200	5440	-1760	0.13	0.76	12	9	-3
0013	2F	5_B1	23	69	6	6900	6270	-630	0.09	0.91	12	11	-1
0013	2F	5_B1	24	43	7	4300	2770	-1530	0.16	0.64	7	4	-3
0013	2F	5_B1	25	32	5	3200	7530	4330	0.16	2.35	5	13	8
0013	2F	5_B1	26	21	0	2100	0	-2100	0.00	0.00	3	0	-3
0013	2F	5_B2	12	50	11	5000	2460	-2540	0.22	0.49	8	4	-4
0013	2F	5_B2	13	21	3	2100	1120	-980	0.14	0.53	3	1	-2
0013	2F	5_B2	14	18	2	1800	470	-1330	0.11	0.26	3	0	-3
0013	2F	5_B2	15	7	0	700	0	-700	0.00	0.00	1	0	-1
0013	2F	5_B2	16	4	0	400	0	-400	0.00	0.00	0	0	0
0013	2F	5_B2	23	12	3	1200	1350	150	0.25	1.13	2	2	0
0013	2F	5_B2	24	11	4	1100	1960	860	0.36	1.78	1	3	2
0013	2F	5_B2	25	7	2	700	2920	2220	0.29	4.17	1	5	4
0013	2F	5_B2	26	4	0	400	0	-400	0.00	0.00	0	0	0
0013	2F	6_A1	12	135	52	13500	11150	-2350	0.39	0.83	23	19	-4
0013	2F	6_A1	13	59	16	5900	4660	-1240	0.27	0.79	10	8	-2
0013	2F	6_A1	14	22	6	2200	3780	1580	0.27	1.72	3	6	3
0013	2F	6_A1	15	13	3	1300	2060	760	0.23	1.58	2	3	1
0013	2F	6_A1	16	3	0	300	0	-300	0.00	0.00	0	0	0
0013	2F	6_A1	23	1	0	100	0	-100	0.00	0.00	0	0	0
0013	2F	6_A2	12	76	23	7600	5580	-2020	0.30	0.73	13	9	-4
0013	2F	6_A2	13	47	13	4700	2890	-1810	0.28	0.61	8	5	-3
0013	2F	6_A2	14	33	4	3300	1500	-1800	0.12	0.45	5	2	-3
0013	2F	6_A2	15	9	1	900	470	-430	0.11	0.52	1	0	-1
0013	2F	6_A2	16	8	2	800	750	-50	0.25	0.94	1	1	0
0013	2F	6_A2	24	1	0	100	0	-100	0.00	0.00	0	0	0
0013	2F	6_B1	12	93	29	9300	11280	1980	0.31	1.21	16	19	3
0013	2F	6_B1	13	24	4	2400	3170	770	0.17	1.32	4	5	1
0013	2F	6_B1	14	16	4	1600	1650	50	0.25	1.03	2	2	0
0013	2F	6_B1	15	6	1	600	260	-340	0.17	0.43	1	0	-1
0013	2F	6_B1	16	4	1	400	510	110	0.25	1.28	0	0	0
0013	2F	6_B1	23	10	2	1000	1390	390	0.20	1.39	1	2	1
0013	2F	6_B1	24	6	1	600	750	150	0.17	1.25	1	1	0
0013	2F	6_B2	12	3	2	300	330	30	0.67	1.10	0	0	0
0013	2F	6_B2	16	1	0	100	0	-100	0.00	0.00	0	0	0
0013	2F	6_B2	26	1	0	100	0	-100	0.00	0.00	0	0	0
0013	2F	7_	12	8	3	800	660	-140	0.38	0.83	1	1	0
0013	2F	7_	13	5	2	500	730	230	0.40	1.46	0	1	1
0013	2F	7_	14	2	0	200	0	-200	0.00	0.00	0	0	0
0013	2F	7_	15	2	0	200	0	-200	0.00	0.00	0	0	0
0013	2F	7_	16	1	0	100	0	-100	0.00	0.00	0	0	0
0013	2F	7_A1	12	1965	666	196500	166440	-30060	0.34	0.85	347	294	-53
0013	2F	7_A1	13	973	216	97300	74180	-23120	0.22	0.76	172	131	-41
0013	2F	7_A1	14	599	115	59900	47290	-12610	0.19	0.79	106	83	-23
0013	2F	7_A1	15	156	25	15600	17320	1720	0.16	1.11	27	30	3
0013	2F	7_A1	16	41	2	4100	3070	-1030	0.05	0.75	7	5	-2
0013	2F	7_A1	23	13	0	1300	0	-1300	0.00	0.00	2	0	-2
0013	2F	7_A1	24	6	0	600	0	-600	0.00	0.00	1	0	-1
0013	2F	7_A1	25	1	0	100	0	-100	0.00	0.00	0	0	0
0013	2F	7_A1	26	2	0	200	0	-200	0.00	0.00	0	0	0
0013	2F	7_A2	12	1831	585	183100	163640	-19460	0.32	0.89	324	289	-35
0013	2F	7_A2	13	1076	240	107600	80120	-27480	0.22	0.74	190	141	-49
0013	2F	7_A2	14	682	142	68200	51390	-16810	0.21	0.75	120	90	-30
0013	2F	7_A2	15	220	30	22000	16290	-5710	0.14	0.74	38	28	-10
0013	2F	7_A2	16	115	17	11500	10120	-1380	0.15	0.88	20	17	-3
0013	2F	7_A2	23	17	1	1700	1110	-590	0.06	0.65	3	1	-2
0013	2F	7_A2	24	18	0	1800	0	-1800	0.00	0.00	3	0	-3
0013	2F	7_A2	25	10	0	1000	0	-1000	0.00	0.00	1	0	-1
0013	2F	7_A2	26	6	0	600	0	-600	0.00	0.00	1	0	-1
0013	2F	7_B1	12	1241	361	124100	110700	-13400	0.29	0.89	219	195	-24
0013	2F	7_B1	13	632	151	63200	54170	-9030	0.24	0.86	111	95	-16
0013	2F	7_B1	14	452	89	45200	39680	-5520	0.20	0.88	80	70	-10
0013	2F	7_B1	15	212	25	21200	12460	-8740	0.12	0.59	37	22	-15
0013	2F	7_B1	16	152	10	15200	4070	-11130	0.07	0.27	26	7	-19
0013	2F	7_B1	23	164	13	16400	8150	-8250	0.08	0.50	29	14	-15
0013	2F	7_B1	24	80	9	8000	5400	-2600	0.11	0.68	14	9	-5
0013	2F	7_B1	25	77	5	7700	5110	-2590	0.06	0.66	13	9	-4
0013	2F	7_B1	26	50	1	5000	440	-4560	0.02	0.09	8	0	-8
0013	2F	7_B2	12	57	15	5700	5480	-220	0.26	0.96	10	9	-1
0013	2F	7_B2	13	32	8	3200	4220	1020	0.25	1.32	5	7	2
0013	2F	7_B2	14	14	1	1400	460	-940	0.07	0.33	2	0	-2
0013	2F	7_B2	15	9	2	900	1370	470	0.22	1.52	1	2	1
0013	2F	7_B2	16	4	0	400	0	-400	0.00	0.00	0	0	0
0013	2F	7_B2	23	25	6	2500	4600	2100	0.24	1.84	4	8	4
0013	2F	7_B2	24	10	4	1000	1650	650	0.40	1.65	1	2	1
0013	2F	7_B2	25	5	1	500	320	-180	0.20	0.64	0	0	0
0013	2F	7_B2	26	8	1	800	2820	2020	0.13	3.53	1	4	3
0013	2T	1_	12	10	3	1000	890	-110	0.30	0.89	1	1	0
0013	2T	1_	13	2	1	200	360	160	0.50	1.80	0	0	0
0013	2T	1_	14	2	2	200	720	520	1.00	3.60	0	1	1
0013	2T	1_	15	1	0	100	0	-100	0.00	0.00	0	0	0
0013	2T	1_	23	3	0	300	0	-300	0.00	0.00	0	0	0
0013	2T	1_A1	12	1849	466	184900	142800	-42100	0.25	0.77	327	252	-75
0013	2T	1_A1	13	969	194	96900	67120	-29780	0.20	0.69	171	118	-53
0013	2T	1_A1	14	548	102	54800	41250	-13550	0.19	0.75	96	73	-23
0013	2T	1_A1	15	163	17	16300	10780	-5520	0.10	0.66	28	19	-9
0013	2T	1_A1	16	42	1	4200	730	-3470	0.02	0.17	7	1	-6
0013	2T	1_A1	21	17	1	1700	620	-1080	0.06	0.36	3	1	-2
0013	2T	1_A1	23	10	0	1000	0	-1000	0.00	0.00	1	0	-1
0013	2T	1_A1	25	1	0	100	0	-100	0.00	0.00	0	0	0
0013	2T	1_A1	26	1	0	100	0	-100	0.00	0.00	0	0	0
0013	2T	1_A2	12	1339	304	133900	115690	-18210	0.23	0.86	236	204	-32
0013	2T	1_A2	13	844	190	84400	74540	-9860	0.23	0.88	149	131	-18
0013	2T	1_A2	14	544	104	54400	42250	-12150	0.19	0.78	96	74	-22
0013	2T	1_A2	15	167	23	16700	29920	13220	0.14	1.79	29	52	23
0013	2T	1_A2	16	109	14	10900	23140	12240	0.13	2.12	19	40	21
0013	2T	1_A2	21	32	4	3200	1160	-2040	0.13	0.36	5	2	-3
0013	2T	1_A2	23	21	1	2100	880	-1220	0.05	0.42	3	1	-2
0013	2T	1_A2	24	10	0	1000	0	-1000	0.00	0.00	1	0	-1
0013	2T	1_A2	25	6	0	600	0	-600	0.00	0.00	1	0	-1
0013	2T	1_A2	26	5	0	500	0	-500	0.00	0.00	0	0	0
0013	2T	1_B1	12	1162	200	116200	98610	-17590	0.17	0.85	205	174	-31
0013	2T	1_B1	13	775	113	77500	62380	-15120	0.15	0.80	137	110	-27
0013	2T	1_B1	14	527	79	52700	54100	1400	0.15	1.03	93	95	2
0013	2T	1_B1	15	249	34	24900	24580	-320	0.14	0.99	44	43	-1
0013	2T	1_B1	16	189	17	18900	15990	-2910	0.09	0.85	33	28	-5
0013	2T	1_B1	21	320	38	32000	25910	-6090	0.12	0.81	56	45	-11
0013	2T	1_B1	23	165	26	16500	20980	4480	0.16	1.27	29	37	8
0013	2T	1_B1	24	114	10	11400	5570	-5830	0.09	0.49	20	9	-11
0013	2T	1_B1	25	81	5	8100	4130	-3970	0.06	0.51	14	7	-7
0013	2T	1_B1	26	92	10	9200	9260	60	0.11	1.01	16	16	0
0013	2T	1_B2	12	27	3	2700	1190	-1510	0.11	0.44	4	2	-2
0013	2T	1_B2	13	21	3	2100	780	-1320	0.14	0.37	3	1	-2
0013	2T	1_B2	14	5	1	500	1000	500	0.20	2.00	0	1	1
0013	2T	1_B2	15	9	1	900	4620	3720	0.11	5.13	1	8	7
0013	2T	1_B2	16	5	0	500	0	-500	0.00	0.00	0	0	0
0013	2T	1_B2	21	5	0	500	0	-500	0.00	0.00	0	0	0
0013	2T	1_B2	23	15	1	1500	320	-1180	0.07	0.21	2	0	-2
0013	2T	1_B2	24	1	0	100	0	-100	0.00	0.00	0	0	0
0013	2T	1_B2	25	5	1	500	440	-60	0.20	0.88	0	0	0
0013	2T	1_B2	26	2	0	200	0	-200	0.00	0.00	0	0	0
0013	2T	2_	12	5	1	500	390	-110	0.20	0.78	0	0	0
0013	2T	2_	13	4	1	400	280	-120	0.25	0.70	0	0	0
0013	2T	2_	14	4	1	400	410	10	0.25	1.03	0	0	0
0013	2T	2_	15	2	1	200	1720	1520	0.50	8.60	0	3	3
0013	2T	2_	16	1	0	100	0	-100	0.00	0.00	0	0	0
0013	2T	2_	21	1	1	100	360	260	1.00	3.60	0	0	0
0013	2T	2_	23	1	1	100	2190	2090	1.00	21.90	0	3	3
0013	2T	2_A1	12	1761	461	176100	141180	-34920	0.26	0.80	311	249	-62
0013	2T	2_A1	13	876	201	87600	68600	-19000	0.23	0.78	155	121	-34
0013	2T	2_A1	14	558	119	55800	47350	-8450	0.21	0.85	98	83	-15
0013	2T	2_A1	15	172	20	17200	11190	-6010	0.12	0.65	30	19	-11
0013	2T	2_A1	16	87	6	8700	2400	-6300	0.07	0.28	15	4	-11
0013	2T	2_A1	21	8	1	800	860	60	0.13	1.08	1	1	0
0013	2T	2_A1	23	9	0	900	0	-900	0.00	0.00	1	0	-1
0013	2T	2_A1	24	5	0	500	0	-500	0.00	0.00	0	0	0
0013	2T	2_A2	12	1223	298	122300	107350	-14950	0.24	0.88	216	190	-26
0013	2T	2_A2	13	812	201	81200	77440	-3760	0.25	0.95	143	137	-6
0013	2T	2_A2	14	567	109	56700	43570	-13130	0.19	0.77	100	77	-23
0013	2T	2_A2	15	197	40	19700	20220	520	0.20	1.03	34	35	1
0013	2T	2_A2	16	164	24	16400	17370	970	0.15	1.06	29	30	1
0013	2T	2_A2	21	59	9	5900	3350	-2550	0.15	0.57	10	5	-5
0013	2T	2_A2	23	18	0	1800	0	-1800	0.00	0.00	3	0	-3
0013	2T	2_A2	24	12	1	1200	610	-590	0.08	0.51	2	1	-1
0013	2T	2_A2	25	10	1	1000	1180	180	0.10	1.18	1	2	1
0013	2T	2_A2	26	9	3	900	2220	1320	0.33	2.47	1	3	2
0013	2T	2_B1	12	1230	173	123000	94990	-28010	0.14	0.77	217	168	-49
0013	2T	2_B1	13	809	103	80900	73490	-7410	0.13	0.91	143	130	-13
0013	2T	2_B1	14	499	50	49900	42810	-7090	0.10	0.86	88	75	-13
0013	2T	2_B1	15	266	18	26600	14170	-12430	0.07	0.53	47	25	-22
0013	2T	2_B1	16	199	20	19900	28270	8370	0.10	1.42	35	50	15
0013	2T	2_B1	21	330	45	33000	31600	-1400	0.14	0.96	58	55	-3
0013	2T	2_B1	23	234	15	23400	11240	-12160	0.06	0.48	41	19	-22
0013	2T	2_B1	24	146	14	14600	13820	-780	0.10	0.95	25	24	-1
0013	2T	2_B1	25	88	8	8800	8160	-640	0.09	0.93	15	14	-1
0013	2T	2_B1	26	80	2	8000	3510	-4490	0.03	0.44	14	6	-8
0013	2T	2_B2	12	46	5	4600	1870	-2730	0.11	0.41	8	3	-5
0013	2T	2_B2	13	33	5	3300	2510	-790	0.15	0.76	5	4	-1
0013	2T	2_B2	14	18	3	1800	3420	1620	0.17	1.90	3	6	3
0013	2T	2_B2	15	5	1	500	1160	660	0.20	2.32	0	2	2
0013	2T	2_B2	16	2	0	200	0	-200	0.00	0.00	0	0	0
0013	2T	2_B2	21	16	3	1600	3570	1970	0.19	2.23	2	6	4
0013	2T	2_B2	23	18	2	1800	1320	-480	0.11	0.73	3	2	-1
0013	2T	2_B2	24	11	2	1100	4520	3420	0.18	4.11	1	8	7
0013	2T	2_B2	25	14	3	1400	2300	900	0.21	1.64	2	4	2
0013	2T	2_B2	26	6	0	600	0	-600	0.00	0.00	1	0	-1
0013	2T	3_	12	25	3	2500	930	-1570	0.12	0.37	4	1	-3
0013	2T	3_	13	8	1	800	320	-480	0.13	0.40	1	0	-1
0013	2T	3_	14	6	2	600	880	280	0.33	1.47	1	1	0
0013	2T	3_	15	2	0	200	0	-200	0.00	0.00	0	0	0
0013	2T	3_	16	1	0	100	0	-100	0.00	0.00	0	0	0
0013	2T	3_	21	2	1	200	380	180	0.50	1.90	0	0	0
0013	2T	3_	23	1	0	100	0	-100	0.00	0.00	0	0	0
0013	2T	3_	24	1	0	100	0	-100	0.00	0.00	0	0	0
0013	2T	3_	25	1	0	100	0	-100	0.00	0.00	0	0	0
0013	2T	3_A1	12	1786	470	178600	141880	-36720	0.26	0.79	316	251	-65
0013	2T	3_A1	13	832	179	83200	64410	-18790	0.22	0.77	147	114	-33
0013	2T	3_A1	14	483	79	48300	39790	-8510	0.16	0.82	85	70	-15
0013	2T	3_A1	15	151	27	15100	15760	660	0.18	1.04	26	27	1
0013	2T	3_A1	16	68	12	6800	6170	-630	0.18	0.91	12	10	-2
0013	2T	3_A1	21	21	4	2100	2120	20	0.19	1.01	3	3	0
0013	2T	3_A1	23	4	0	400	0	-400	0.00	0.00	0	0	0
0013	2T	3_A1	24	7	0	700	0	-700	0.00	0.00	1	0	-1
0013	2T	3_A1	25	5	0	500	0	-500	0.00	0.00	0	0	0
0013	2T	3_A1	26	1	0	100	0	-100	0.00	0.00	0	0	0
0013	2T	3_A2	12	1383	326	138300	127760	-10540	0.24	0.92	244	226	-18
0013	2T	3_A2	13	837	171	83700	77910	-5790	0.20	0.93	148	137	-11
0013	2T	3_A2	14	554	93	55400	44330	-11070	0.17	0.80	98	78	-20
0013	2T	3_A2	15	207	26	20700	14110	-6590	0.13	0.68	36	24	-12
0013	2T	3_A2	16	127	16	12700	23880	11180	0.13	1.88	22	42	20
0013	2T	3_A2	21	73	10	7300	7080	-220	0.14	0.97	12	12	0
0013	2T	3_A2	23	25	1	2500	1000	-1500	0.04	0.40	4	1	-3
0013	2T	3_A2	24	15	2	1500	2110	610	0.13	1.41	2	3	1
0013	2T	3_A2	25	9	2	900	2120	1220	0.22	2.36	1	3	2
0013	2T	3_A2	26	10	0	1000	0	-1000	0.00	0.00	1	0	-1
0013	2T	3_B1	12	1137	197	113700	114600	900	0.17	1.01	201	202	1
0013	2T	3_B1	13	779	118	77900	72590	-5310	0.15	0.93	137	128	-9
0013	2T	3_B1	14	464	43	46400	35330	-11070	0.09	0.76	82	62	-20
0013	2T	3_B1	15	294	22	29400	25470	-3930	0.07	0.87	52	45	-7
0013	2T	3_B1	16	205	17	20500	21500	1000	0.08	1.05	36	38	2
0013	2T	3_B1	21	321	53	32100	36670	4570	0.17	1.14	56	64	8
0013	2T	3_B1	23	211	25	21100	27860	6760	0.12	1.32	37	49	12
0013	2T	3_B1	24	94	12	9400	13120	3720	0.13	1.40	16	23	7
0013	2T	3_B1	25	105	8	10500	5710	-4790	0.08	0.54	18	10	-8
0013	2T	3_B1	26	88	10	8800	10650	1850	0.11	1.21	15	18	3
0013	2T	3_B2	12	43	9	4300	3610	-690	0.21	0.84	7	6	-1
0013	2T	3_B2	13	30	6	3000	3840	840	0.20	1.28	5	6	1
0013	2T	3_B2	14	9	1	900	440	-460	0.11	0.49	1	0	-1
0013	2T	3_B2	15	10	0	1000	0	-1000	0.00	0.00	1	0	-1
0013	2T	3_B2	16	4	1	400	590	190	0.25	1.48	0	1	1
0013	2T	3_B2	21	23	1	2300	1550	-750	0.04	0.67	4	2	-2
0013	2T	3_B2	23	26	3	2600	3130	530	0.12	1.20	4	5	1
0013	2T	3_B2	24	9	4	900	3250	2350	0.44	3.61	1	5	4
0013	2T	3_B2	25	9	1	900	480	-420	0.11	0.53	1	0	-1
0013	2T	3_B2	26	5	1	500	580	80	0.20	1.16	0	1	1
0013	2T	4_	12	8	4	800	950	150	0.50	1.19	1	1	0
0013	2T	4_	13	4	0	400	0	-400	0.00	0.00	0	0	0
0013	2T	4_	14	2	0	200	0	-200	0.00	0.00	0	0	0
0013	2T	4_	15	1	0	100	0	-100	0.00	0.00	0	0	0
0013	2T	4_	21	1	0	100	0	-100	0.00	0.00	0	0	0
0013	2T	4_	23	1	0	100	0	-100	0.00	0.00	0	0	0
0013	2T	4_A1	12	1958	562	195800	160450	-35350	0.29	0.82	346	283	-63
0013	2T	4_A1	13	969	273	96900	87630	-9270	0.28	0.90	171	155	-16
0013	2T	4_A1	14	568	112	56800	48030	-8770	0.20	0.85	100	85	-15
0013	2T	4_A1	15	162	19	16200	9650	-6550	0.12	0.60	28	17	-11
0013	2T	4_A1	16	74	9	7400	9800	2400	0.12	1.32	13	17	4
0013	2T	4_A1	21	12	1	1200	1210	10	0.08	1.01	2	2	0
0013	2T	4_A1	23	6	0	600	0	-600	0.00	0.00	1	0	-1
0013	2T	4_A1	24	2	1	200	1440	1240	0.50	7.20	0	2	2
0013	2T	4_A1	25	1	0	100	0	-100	0.00	0.00	0	0	0
0013	2T	4_A1	26	3	0	300	0	-300	0.00	0.00	0	0	0
0013	2T	4_A2	12	818	188	81800	68220	-13580	0.23	0.83	144	120	-24
0013	2T	4_A2	13	532	121	53200	48730	-4470	0.23	0.92	94	86	-8
0013	2T	4_A2	14	376	89	37600	39360	1760	0.24	1.05	66	69	3
0013	2T	4_A2	15	143	19	14300	9440	-4860	0.13	0.66	25	16	-9
0013	2T	4_A2	16	71	9	7100	7000	-100	0.13	0.99	12	12	0
0013	2T	4_A2	21	46	7	4600	3010	-1590	0.15	0.65	8	5	-3
0013	2T	4_A2	23	14	0	1400	0	-1400	0.00	0.00	2	0	-2
0013	2T	4_A2	24	11	1	1100	540	-560	0.09	0.49	1	0	-1
0013	2T	4_A2	25	4	0	400	0	-400	0.00	0.00	0	0	0
0013	2T	4_A2	26	7	0	700	0	-700	0.00	0.00	1	0	-1
0013	2T	4_B1	12	998	116	99800	79020	-20780	0.12	0.79	176	139	-37
0013	2T	4_B1	13	707	69	70700	56310	-14390	0.10	0.80	125	99	-26
0013	2T	4_B1	14	473	49	47300	44420	-2880	0.10	0.94	83	78	-5
0013	2T	4_B1	15	170	13	17000	16970	-30	0.08	1.00	30	30	0
0013	2T	4_B1	16	65	2	6500	3220	-3280	0.03	0.50	11	5	-6
0013	2T	4_B1	21	214	22	21400	13070	-8330	0.10	0.61	37	23	-14
0013	2T	4_B1	23	196	19	19600	20790	1190	0.10	1.06	34	36	2
0013	2T	4_B1	24	112	12	11200	11050	-150	0.11	0.99	19	19	0
0013	2T	4_B1	25	66	7	6600	27690	21090	0.11	4.20	11	49	38
0013	2T	4_B1	26	22	2	2200	3710	1510	0.09	1.69	3	6	3
0013	2T	4_B2	12	36	3	3600	1630	-1970	0.08	0.45	6	2	-4
0013	2T	4_B2	13	15	1	1500	530	-970	0.07	0.35	2	0	-2
0013	2T	4_B2	14	11	0	1100	0	-1100	0.00	0.00	1	0	-1
0013	2T	4_B2	15	5	0	500	0	-500	0.00	0.00	0	0	0
0013	2T	4_B2	16	8	0	800	0	-800	0.00	0.00	1	0	-1
0013	2T	4_B2	21	9	0	900	0	-900	0.00	0.00	1	0	-1
0013	2T	4_B2	23	69	7	6900	7780	880	0.10	1.13	12	13	1
0013	2T	4_B2	24	35	3	3500	1380	-2120	0.09	0.39	6	2	-4
0013	2T	4_B2	25	22	1	2200	820	-1380	0.05	0.37	3	1	-2
0013	2T	4_B2	26	5	0	500	0	-500	0.00	0.00	0	0	0
0013	2T	5_	12	10	2	1000	540	-460	0.20	0.54	1	0	-1
0013	2T	5_	13	6	0	600	0	-600	0.00	0.00	1	0	-1
0013	2T	5_	14	3	2	300	880	580	0.67	2.93	0	1	1
0013	2T	5_	16	1	0	100	0	-100	0.00	0.00	0	0	0
0013	2T	5_	24	1	0	100	0	-100	0.00	0.00	0	0	0
0013	2T	5_	26	2	0	200	0	-200	0.00	0.00	0	0	0
0013	2T	5_A1	12	1520	477	152000	131090	-20910	0.31	0.86	269	232	-37
0013	2T	5_A1	13	718	152	71800	51630	-20170	0.21	0.72	127	91	-36
0013	2T	5_A1	14	447	79	44700	38630	-6070	0.18	0.86	79	68	-11
0013	2T	5_A1	15	87	10	8700	9900	1200	0.11	1.14	15	17	2
0013	2T	5_A1	16	31	4	3100	5790	2690	0.13	1.87	5	10	5
0013	2T	5_A1	21	21	2	2100	3150	1050	0.10	1.50	3	5	2
0013	2T	5_A1	23	11	0	1100	0	-1100	0.00	0.00	1	0	-1
0013	2T	5_A1	24	6	0	600	0	-600	0.00	0.00	1	0	-1
0013	2T	5_A1	25	1	0	100	0	-100	0.00	0.00	0	0	0
0013	2T	5_A1	26	3	0	300	0	-300	0.00	0.00	0	0	0
0013	2T	5_A2	12	905	187	90500	71870	-18630	0.21	0.79	160	127	-33
0013	2T	5_A2	13	622	104	62200	39740	-22460	0.17	0.64	110	70	-40
0013	2T	5_A2	14	418	73	41800	41360	-440	0.17	0.99	73	73	0
0013	2T	5_A2	15	142	13	14200	12660	-1540	0.09	0.89	25	22	-3
0013	2T	5_A2	16	40	0	4000	0	-4000	0.00	0.00	7	0	-7
0013	2T	5_A2	21	57	6	5700	12730	7030	0.11	2.23	10	22	12
0013	2T	5_A2	23	33	1	3300	4400	1100	0.03	1.33	5	7	2
0013	2T	5_A2	24	20	1	2000	4420	2420	0.05	2.21	3	7	4
0013	2T	5_A2	25	14	0	1400	0	-1400	0.00	0.00	2	0	-2
0013	2T	5_A2	26	3	0	300	0	-300	0.00	0.00	0	0	0
0013	2T	5_B1	12	521	98	52100	49000	-3100	0.19	0.94	92	86	-6
0013	2T	5_B1	13	348	43	34800	28740	-6060	0.12	0.83	61	50	-11
0013	2T	5_B1	14	233	33	23300	26140	2840	0.14	1.12	41	46	5
0013	2T	5_B1	15	124	8	12400	8440	-3960	0.06	0.68	21	14	-7
0013	2T	5_B1	16	72	6	7200	6350	-850	0.08	0.88	12	11	-1
0013	2T	5_B1	21	94	15	9400	17230	7830	0.16	1.83	16	30	14
0013	2T	5_B1	23	69	3	6900	5800	-1100	0.04	0.84	12	10	-2
0013	2T	5_B1	24	43	5	4300	3640	-660	0.12	0.85	7	6	-1
0013	2T	5_B1	25	32	2	3200	5000	1800	0.06	1.56	5	8	3
0013	2T	5_B1	26	21	0	2100	0	-2100	0.00	0.00	3	0	-3
0013	2T	5_B2	12	46	9	4600	2330	-2270	0.20	0.51	8	4	-4
0013	2T	5_B2	13	21	2	2100	810	-1290	0.10	0.39	3	1	-2
0013	2T	5_B2	14	18	1	1800	340	-1460	0.06	0.19	3	0	-3
0013	2T	5_B2	15	7	0	700	0	-700	0.00	0.00	1	0	-1
0013	2T	5_B2	16	4	0	400	0	-400	0.00	0.00	0	0	0
0013	2T	5_B2	21	4	0	400	0	-400	0.00	0.00	0	0	0
0013	2T	5_B2	23	12	2	1200	1690	490	0.17	1.41	2	2	0
0013	2T	5_B2	24	11	0	1100	0	-1100	0.00	0.00	1	0	-1
0013	2T	5_B2	25	7	1	700	1230	530	0.14	1.76	1	2	1
0013	2T	5_B2	26	4	0	400	0	-400	0.00	0.00	0	0	0
0013	2T	6_A1	12	133	39	13300	9890	-3410	0.29	0.74	23	17	-6
0013	2T	6_A1	13	59	12	5900	4000	-1900	0.20	0.68	10	7	-3
0013	2T	6_A1	14	22	5	2200	2720	520	0.23	1.24	3	4	1
0013	2T	6_A1	15	13	2	1300	1360	60	0.15	1.05	2	2	0
0013	2T	6_A1	16	3	0	300	0	-300	0.00	0.00	0	0	0
0013	2T	6_A1	21	2	1	200	270	70	0.50	1.35	0	0	0
0013	2T	6_A1	23	1	0	100	0	-100	0.00	0.00	0	0	0
0013	2T	6_A2	12	75	16	7500	4460	-3040	0.21	0.59	13	7	-6
0013	2T	6_A2	13	47	7	4700	2130	-2570	0.15	0.45	8	3	-5
0013	2T	6_A2	14	33	3	3300	1680	-1620	0.09	0.51	5	2	-3
0013	2T	6_A2	15	9	0	900	0	-900	0.00	0.00	1	0	-1
0013	2T	6_A2	16	8	0	800	0	-800	0.00	0.00	1	0	-1
0013	2T	6_A2	21	1	1	100	390	290	1.00	3.90	0	0	0
0013	2T	6_A2	24	1	0	100	0	-100	0.00	0.00	0	0	0
0013	2T	6_B1	12	84	16	8400	9670	1270	0.19	1.15	14	17	3
0013	2T	6_B1	13	24	2	2400	3440	1040	0.08	1.43	4	6	2
0013	2T	6_B1	14	16	3	1600	1620	20	0.19	1.01	2	2	0
0013	2T	6_B1	15	6	0	600	0	-600	0.00	0.00	1	0	-1
0013	2T	6_B1	16	4	1	400	580	180	0.25	1.45	0	1	1
0013	2T	6_B1	21	9	2	900	1650	750	0.22	1.83	1	2	1
0013	2T	6_B1	23	10	2	1000	2570	1570	0.20	2.57	1	4	3
0013	2T	6_B1	24	6	1	600	1420	820	0.17	2.37	1	2	1
0013	2T	6_B2	12	3	2	300	460	160	0.67	1.53	0	0	0
0013	2T	6_B2	16	1	0	100	0	-100	0.00	0.00	0	0	0
0013	2T	6_B2	26	1	0	100	0	-100	0.00	0.00	0	0	0
0013	2T	7_	12	8	2	800	760	-40	0.25	0.95	1	1	0
0013	2T	7_	13	5	0	500	0	-500	0.00	0.00	0	0	0
0013	2T	7_	14	2	0	200	0	-200	0.00	0.00	0	0	0
0013	2T	7_	15	2	0	200	0	-200	0.00	0.00	0	0	0
0013	2T	7_	16	1	0	100	0	-100	0.00	0.00	0	0	0
0013	2T	7_A1	12	1943	547	194300	160050	-34250	0.28	0.82	343	283	-60
0013	2T	7_A1	13	973	181	97300	71500	-25800	0.19	0.73	172	126	-46
0013	2T	7_A1	14	599	88	59900	41770	-18130	0.15	0.70	106	73	-33
0013	2T	7_A1	15	156	21	15600	17950	2350	0.13	1.15	27	31	4
0013	2T	7_A1	16	41	2	4100	3580	-520	0.05	0.87	7	6	-1
0013	2T	7_A1	21	22	2	2200	1270	-930	0.09	0.58	3	2	-1
0013	2T	7_A1	23	13	0	1300	0	-1300	0.00	0.00	2	0	-2
0013	2T	7_A1	24	6	0	600	0	-600	0.00	0.00	1	0	-1
0013	2T	7_A1	25	1	0	100	0	-100	0.00	0.00	0	0	0
0013	2T	7_A1	26	2	0	200	0	-200	0.00	0.00	0	0	0
0013	2T	7_A2	12	1776	450	177600	158060	-19540	0.25	0.89	314	279	-35
0013	2T	7_A2	13	1076	195	107600	80750	-26850	0.18	0.75	190	142	-48
0013	2T	7_A2	14	682	116	68200	52410	-15790	0.17	0.77	120	92	-28
0013	2T	7_A2	15	220	19	22000	13550	-8450	0.09	0.62	38	23	-15
0013	2T	7_A2	16	115	15	11500	11150	-350	0.13	0.97	20	19	-1
0013	2T	7_A2	21	55	3	5500	4390	-1110	0.05	0.80	9	7	-2
0013	2T	7_A2	23	17	0	1700	0	-1700	0.00	0.00	3	0	-3
0013	2T	7_A2	24	18	0	1800	0	-1800	0.00	0.00	3	0	-3
0013	2T	7_A2	25	10	0	1000	0	-1000	0.00	0.00	1	0	-1
0013	2T	7_A2	26	6	0	600	0	-600	0.00	0.00	1	0	-1
0013	2T	7_B1	12	1035	204	103500	86130	-17370	0.20	0.83	183	152	-31
0013	2T	7_B1	13	632	108	63200	52530	-10670	0.17	0.83	111	92	-19
0013	2T	7_B1	14	452	65	45200	39390	-5810	0.14	0.87	80	69	-11
0013	2T	7_B1	15	212	20	21200	14070	-7130	0.09	0.66	37	24	-13
0013	2T	7_B1	16	152	6	15200	5150	-10050	0.04	0.34	26	9	-17
0013	2T	7_B1	21	206	32	20600	26850	6250	0.16	1.30	36	47	11
0013	2T	7_B1	23	164	6	16400	6770	-9630	0.04	0.41	29	11	-18
0013	2T	7_B1	24	80	6	8000	6050	-1950	0.08	0.76	14	10	-4
0013	2T	7_B1	25	77	4	7700	8710	1010	0.05	1.13	13	15	2
0013	2T	7_B1	26	50	1	5000	890	-4110	0.02	0.18	8	1	-7
0013	2T	7_B2	12	46	10	4600	4340	-260	0.22	0.94	8	7	-1
0013	2T	7_B2	13	32	5	3200	2230	-970	0.16	0.70	5	3	-2
0013	2T	7_B2	14	14	0	1400	0	-1400	0.00	0.00	2	0	-2
0013	2T	7_B2	15	9	1	900	290	-610	0.11	0.32	1	0	-1
0013	2T	7_B2	16	4	0	400	0	-400	0.00	0.00	0	0	0
0013	2T	7_B2	21	11	1	1100	1350	250	0.09	1.23	1	2	1
0013	2T	7_B2	23	25	4	2500	5450	2950	0.16	2.18	4	9	5
0013	2T	7_B2	24	10	3	1000	1680	680	0.30	1.68	1	2	1
0013	2T	7_B2	25	5	1	500	520	20	0.20	1.04	0	0	0
0013	2T	7_B2	26	8	1	800	2490	1690	0.13	3.11	1	4	3
0013	3F	1_	123	4	0	400	0	-400	0.00	0.00	0	0	0
0013	3F	1_	124	3	1	300	200	-100	0.33	0.67	0	0	0
0013	3F	1_	125	2	1	200	210	10	0.50	1.05	0	0	0
0013	3F	1_	126	2	0	200	0	-200	0.00	0.00	0	0	0
0013	3F	1_	135	2	1	200	390	190	0.50	1.95	0	0	0
0013	3F	1_	136	1	0	100	0	-100	0.00	0.00	0	0	0
0013	3F	1_	145	1	1	100	430	330	1.00	4.30	0	0	0
0013	3F	1_	235	3	0	300	0	-300	0.00	0.00	0	0	0
0013	3F	1_A1	123	795	161	79500	61080	-18420	0.20	0.77	140	108	-32
0013	3F	1_A1	124	663	123	66300	49840	-16460	0.19	0.75	117	88	-29
0013	3F	1_A1	125	328	35	32800	27130	-5670	0.11	0.83	58	48	-10
0013	3F	1_A1	126	222	24	22200	27880	5680	0.11	1.26	39	49	10
0013	3F	1_A1	134	391	72	39100	40820	1720	0.18	1.04	69	72	3
0013	3F	1_A1	135	178	16	17800	9590	-8210	0.09	0.54	31	16	-15
0013	3F	1_A1	136	149	12	14900	8650	-6250	0.08	0.58	26	15	-11
0013	3F	1_A1	145	115	11	11500	7610	-3890	0.10	0.66	20	13	-7
0013	3F	1_A1	146	75	3	7500	2950	-4550	0.04	0.39	13	5	-8
0013	3F	1_A1	156	36	2	3600	3930	330	0.06	1.09	6	6	0
0013	3F	1_A1	234	2	0	200	0	-200	0.00	0.00	0	0	0
0013	3F	1_A1	235	2	0	200	0	-200	0.00	0.00	0	0	0
0013	3F	1_A1	236	2	0	200	0	-200	0.00	0.00	0	0	0
0013	3F	1_A1	245	1	0	100	0	-100	0.00	0.00	0	0	0
0013	3F	1_A2	123	622	121	62200	49830	-12370	0.19	0.80	110	88	-22
0013	3F	1_A2	124	512	106	51200	48970	-2230	0.21	0.96	90	86	-4
0013	3F	1_A2	125	230	31	23000	15850	-7150	0.13	0.69	40	28	-12
0013	3F	1_A2	126	206	24	20600	17750	-2850	0.12	0.86	36	31	-5
0013	3F	1_A2	134	363	66	36300	28170	-8130	0.18	0.78	64	49	-15
0013	3F	1_A2	135	169	25	16900	22480	5580	0.15	1.33	29	39	10
0013	3F	1_A2	136	139	23	13900	13530	-370	0.17	0.97	24	23	-1
0013	3F	1_A2	145	96	13	9600	6070	-3530	0.14	0.63	16	10	-6
0013	3F	1_A2	146	83	10	8300	7790	-510	0.12	0.94	14	13	-1
0013	3F	1_A2	156	35	5	3500	13940	10440	0.14	3.98	6	24	18
0013	3F	1_A2	234	7	0	700	0	-700	0.00	0.00	1	0	-1
0013	3F	1_A2	235	4	0	400	0	-400	0.00	0.00	0	0	0
0013	3F	1_A2	236	2	0	200	0	-200	0.00	0.00	0	0	0
0013	3F	1_A2	245	1	0	100	0	-100	0.00	0.00	0	0	0
0013	3F	1_A2	246	4	0	400	0	-400	0.00	0.00	0	0	0
0013	3F	1_A2	256	1	0	100	0	-100	0.00	0.00	0	0	0
0013	3F	1_B1	123	560	105	56000	46910	-9090	0.19	0.84	99	83	-16
0013	3F	1_B1	124	457	77	45700	36010	-9690	0.17	0.79	80	63	-17
0013	3F	1_B1	125	323	49	32300	30820	-1480	0.15	0.95	57	54	-3
0013	3F	1_B1	126	332	39	33200	29370	-3830	0.12	0.88	58	51	-7
0013	3F	1_B1	134	277	44	27700	23150	-4550	0.16	0.84	49	40	-9
0013	3F	1_B1	135	186	26	18600	19180	580	0.14	1.03	32	33	1
0013	3F	1_B1	136	152	25	15200	23740	8540	0.16	1.56	26	42	16
0013	3F	1_B1	145	126	13	12600	11340	-1260	0.10	0.90	22	20	-2
0013	3F	1_B1	146	114	8	11400	6070	-5330	0.07	0.53	20	10	-10
0013	3F	1_B1	156	67	10	6700	12910	6210	0.15	1.93	11	22	11
0013	3F	1_B1	234	53	8	5300	5300	0	0.15	1.00	9	9	0
0013	3F	1_B1	235	52	5	5200	2420	-2780	0.10	0.47	9	4	-5
0013	3F	1_B1	236	40	3	4000	2710	-1290	0.08	0.68	7	4	-3
0013	3F	1_B1	245	29	3	2900	1020	-1880	0.10	0.35	5	1	-4
0013	3F	1_B1	246	24	1	2400	410	-1990	0.04	0.17	4	0	-4
0013	3F	1_B1	256	25	2	2500	1280	-1220	0.08	0.51	4	2	-2
0013	3F	1_B2	123	13	1	1300	300	-1000	0.08	0.23	2	0	-2
0013	3F	1_B2	124	9	2	900	4420	3520	0.22	4.91	1	7	6
0013	3F	1_B2	125	5	0	500	0	-500	0.00	0.00	0	0	0
0013	3F	1_B2	126	4	1	400	910	510	0.25	2.28	0	1	1
0013	3F	1_B2	134	7	0	700	0	-700	0.00	0.00	1	0	-1
0013	3F	1_B2	135	4	1	400	680	280	0.25	1.70	0	1	1
0013	3F	1_B2	136	7	2	700	1250	550	0.29	1.79	1	2	1
0013	3F	1_B2	145	4	0	400	0	-400	0.00	0.00	0	0	0
0013	3F	1_B2	146	3	0	300	0	-300	0.00	0.00	0	0	0
0013	3F	1_B2	156	1	0	100	0	-100	0.00	0.00	0	0	0
0013	3F	1_B2	234	5	2	500	970	470	0.40	1.94	0	1	1
0013	3F	1_B2	235	8	1	800	320	-480	0.13	0.40	1	0	-1
0013	3F	1_B2	236	2	0	200	0	-200	0.00	0.00	0	0	0
0013	3F	1_B2	245	1	0	100	0	-100	0.00	0.00	0	0	0
0013	3F	1_B2	246	1	0	100	0	-100	0.00	0.00	0	0	0
0013	3F	2_	123	4	1	400	620	220	0.25	1.55	0	1	1
0013	3F	2_	124	3	2	300	390	90	0.67	1.30	0	0	0
0013	3F	2_	125	1	0	100	0	-100	0.00	0.00	0	0	0
0013	3F	2_	126	1	0	100	0	-100	0.00	0.00	0	0	0
0013	3F	2_	135	1	1	100	820	720	1.00	8.20	0	1	1
0013	3F	2_	136	1	0	100	0	-100	0.00	0.00	0	0	0
0013	3F	2_	145	1	0	100	0	-100	0.00	0.00	0	0	0
0013	3F	2_A1	123	715	154	71500	56400	-15100	0.22	0.79	126	99	-27
0013	3F	2_A1	124	633	127	63300	56030	-7270	0.20	0.89	112	99	-13
0013	3F	2_A1	125	297	34	29700	21300	-8400	0.11	0.72	52	37	-15
0013	3F	2_A1	126	252	21	25200	18780	-6420	0.08	0.75	44	33	-11
0013	3F	2_A1	134	392	52	39200	26370	-12830	0.13	0.67	69	46	-23
0013	3F	2_A1	135	170	20	17000	12310	-4690	0.12	0.72	30	21	-9
0013	3F	2_A1	136	150	17	15000	10360	-4640	0.11	0.69	26	18	-8
0013	3F	2_A1	145	110	12	11000	6370	-4630	0.11	0.58	19	11	-8
0013	3F	2_A1	146	86	11	8600	6080	-2520	0.13	0.71	15	10	-5
0013	3F	2_A1	156	30	2	3000	1300	-1700	0.07	0.43	5	2	-3
0013	3F	2_A1	234	4	0	400	0	-400	0.00	0.00	0	0	0
0013	3F	2_A1	245	1	0	100	0	-100	0.00	0.00	0	0	0
0013	3F	2_A2	123	564	122	56400	44390	-12010	0.22	0.79	99	78	-21
0013	3F	2_A2	124	467	100	46700	36720	-9980	0.21	0.79	82	64	-18
0013	3F	2_A2	125	230	46	23000	17570	-5430	0.20	0.76	40	31	-9
0013	3F	2_A2	126	206	32	20600	15470	-5130	0.16	0.75	36	27	-9
0013	3F	2_A2	134	303	54	30300	29380	-920	0.18	0.97	53	52	-1
0013	3F	2_A2	135	175	29	17500	13020	-4480	0.17	0.74	30	23	-7
0013	3F	2_A2	136	173	30	17300	15560	-1740	0.17	0.90	30	27	-3
0013	3F	2_A2	145	130	21	13000	7690	-5310	0.16	0.59	23	13	-10
0013	3F	2_A2	146	94	14	9400	14970	5570	0.15	1.59	16	26	10
0013	3F	2_A2	156	41	4	4100	2900	-1200	0.10	0.71	7	5	-2
0013	3F	2_A2	234	5	1	500	400	-100	0.20	0.80	0	0	0
0013	3F	2_A2	235	8	0	800	0	-800	0.00	0.00	1	0	-1
0013	3F	2_A2	236	6	0	600	0	-600	0.00	0.00	1	0	-1
0013	3F	2_A2	245	5	0	500	0	-500	0.00	0.00	0	0	0
0013	3F	2_A2	246	2	0	200	0	-200	0.00	0.00	0	0	0
0013	3F	2_A2	256	2	0	200	0	-200	0.00	0.00	0	0	0
0013	3F	2_B1	123	657	118	65700	55190	-10510	0.18	0.84	116	97	-19
0013	3F	2_B1	124	501	84	50100	44990	-5110	0.17	0.90	88	79	-9
0013	3F	2_B1	125	371	49	37100	29340	-7760	0.13	0.79	65	51	-14
0013	3F	2_B1	126	329	37	32900	24510	-8390	0.11	0.74	58	43	-15
0013	3F	2_B1	134	282	30	28200	17190	-11010	0.11	0.61	49	30	-19
0013	3F	2_B1	135	192	25	19200	24420	5220	0.13	1.27	33	43	10
0013	3F	2_B1	136	155	15	15500	9100	-6400	0.10	0.59	27	16	-11
0013	3F	2_B1	145	118	13	11800	18610	6810	0.11	1.58	20	32	12
0013	3F	2_B1	146	112	7	11200	15870	4670	0.06	1.42	19	28	9
0013	3F	2_B1	156	62	3	6200	2110	-4090	0.05	0.34	10	3	-7
0013	3F	2_B1	234	81	7	8100	4650	-3450	0.09	0.57	14	8	-6
0013	3F	2_B1	235	48	6	4800	1830	-2970	0.13	0.38	8	3	-5
0013	3F	2_B1	236	69	8	6900	3940	-2960	0.12	0.57	12	6	-6
0013	3F	2_B1	245	32	2	3200	3240	40	0.06	1.01	5	5	0
0013	3F	2_B1	246	43	5	4300	7720	3420	0.12	1.80	7	13	6
0013	3F	2_B1	256	25	3	2500	1010	-1490	0.12	0.40	4	1	-3
0013	3F	2_B2	123	29	5	2900	2560	-340	0.17	0.88	5	4	-1
0013	3F	2_B2	124	19	1	1900	590	-1310	0.05	0.31	3	1	-2
0013	3F	2_B2	125	12	0	1200	0	-1200	0.00	0.00	2	0	-2
0013	3F	2_B2	126	15	1	1500	1300	-200	0.07	0.87	2	2	0
0013	3F	2_B2	134	9	2	900	890	-10	0.22	0.99	1	1	0
0013	3F	2_B2	135	8	0	800	0	-800	0.00	0.00	1	0	-1
0013	3F	2_B2	136	6	0	600	0	-600	0.00	0.00	1	0	-1
0013	3F	2_B2	145	4	1	400	1250	850	0.25	3.13	0	2	2
0013	3F	2_B2	146	5	1	500	820	320	0.20	1.64	0	1	1
0013	3F	2_B2	234	8	0	800	0	-800	0.00	0.00	1	0	-1
0013	3F	2_B2	235	11	0	1100	0	-1100	0.00	0.00	1	0	-1
0013	3F	2_B2	236	2	0	200	0	-200	0.00	0.00	0	0	0
0013	3F	2_B2	245	3	0	300	0	-300	0.00	0.00	0	0	0
0013	3F	2_B2	246	2	0	200	0	-200	0.00	0.00	0	0	0
0013	3F	2_B2	256	1	0	100	0	-100	0.00	0.00	0	0	0
0013	3F	3_	123	8	1	800	1190	390	0.13	1.49	1	2	1
0013	3F	3_	124	11	4	1100	1560	460	0.36	1.42	1	2	1
0013	3F	3_	125	6	0	600	0	-600	0.00	0.00	1	0	-1
0013	3F	3_	126	1	0	100	0	-100	0.00	0.00	0	0	0
0013	3F	3_	134	5	0	500	0	-500	0.00	0.00	0	0	0
0013	3F	3_	135	1	0	100	0	-100	0.00	0.00	0	0	0
0013	3F	3_	136	2	0	200	0	-200	0.00	0.00	0	0	0
0013	3F	3_	145	2	1	200	450	250	0.50	2.25	0	0	0
0013	3F	3_	156	1	0	100	0	-100	0.00	0.00	0	0	0
0013	3F	3_	235	1	0	100	0	-100	0.00	0.00	0	0	0
0013	3F	3_	245	1	0	100	0	-100	0.00	0.00	0	0	0
0013	3F	3_A1	123	757	168	75700	62470	-13230	0.22	0.83	133	110	-23
0013	3F	3_A1	124	577	107	57700	46680	-11020	0.19	0.81	102	82	-20
0013	3F	3_A1	125	357	41	35700	26000	-9700	0.11	0.73	63	46	-17
0013	3F	3_A1	126	221	18	22100	20240	-1860	0.08	0.92	39	35	-4
0013	3F	3_A1	134	336	55	33600	32230	-1370	0.16	0.96	59	57	-2
0013	3F	3_A1	135	193	26	19300	13520	-5780	0.13	0.70	34	23	-11
0013	3F	3_A1	136	127	14	12700	10310	-2390	0.11	0.81	22	18	-4
0013	3F	3_A1	145	91	11	9100	7280	-1820	0.12	0.80	16	12	-4
0013	3F	3_A1	146	59	7	5900	6470	570	0.12	1.10	10	11	1
0013	3F	3_A1	156	37	3	3700	3960	260	0.08	1.07	6	7	1
0013	3F	3_A1	234	2	0	200	0	-200	0.00	0.00	0	0	0
0013	3F	3_A1	235	4	0	400	0	-400	0.00	0.00	0	0	0
0013	3F	3_A1	236	1	0	100	0	-100	0.00	0.00	0	0	0
0013	3F	3_A1	245	4	0	400	0	-400	0.00	0.00	0	0	0
0013	3F	3_A1	246	1	0	100	0	-100	0.00	0.00	0	0	0
0013	3F	3_A2	123	671	142	67100	55130	-11970	0.21	0.82	118	97	-21
0013	3F	3_A2	124	495	92	49500	39870	-9630	0.19	0.81	87	70	-17
0013	3F	3_A2	125	264	36	26400	15870	-10530	0.14	0.60	46	28	-18
0013	3F	3_A2	126	201	28	20100	16170	-3930	0.14	0.80	35	28	-7
0013	3F	3_A2	134	335	47	33500	22800	-10700	0.14	0.68	59	40	-19
0013	3F	3_A2	135	213	27	21300	17500	-3800	0.13	0.82	37	30	-7
0013	3F	3_A2	136	144	7	14400	7880	-6520	0.05	0.55	25	13	-12
0013	3F	3_A2	145	127	14	12700	13880	1180	0.11	1.09	22	24	2
0013	3F	3_A2	146	89	7	8900	6980	-1920	0.08	0.78	15	12	-3
0013	3F	3_A2	156	53	5	5300	4750	-550	0.09	0.90	9	8	-1
0013	3F	3_A2	234	8	1	800	690	-110	0.13	0.86	1	1	0
0013	3F	3_A2	235	6	1	600	1580	980	0.17	2.63	1	2	1
0013	3F	3_A2	236	2	0	200	0	-200	0.00	0.00	0	0	0
0013	3F	3_A2	245	5	0	500	0	-500	0.00	0.00	0	0	0
0013	3F	3_A2	246	5	1	500	760	260	0.20	1.52	0	1	1
0013	3F	3_A2	256	3	0	300	0	-300	0.00	0.00	0	0	0
0013	3F	3_B1	123	528	108	52800	51680	-1120	0.20	0.98	93	91	-2
0013	3F	3_B1	124	478	90	47800	43940	-3860	0.19	0.92	84	77	-7
0013	3F	3_B1	125	370	37	37000	23080	-13920	0.10	0.62	65	40	-25
0013	3F	3_B1	126	266	28	26600	22180	-4420	0.11	0.83	47	39	-8
0013	3F	3_B1	134	280	44	28000	24030	-3970	0.16	0.86	49	42	-7
0013	3F	3_B1	135	197	24	19700	17980	-1720	0.12	0.91	34	31	-3
0013	3F	3_B1	136	187	17	18700	14190	-4510	0.09	0.76	33	25	-8
0013	3F	3_B1	145	111	15	11100	13520	2420	0.14	1.22	19	23	4
0013	3F	3_B1	146	88	5	8800	5550	-3250	0.06	0.63	15	9	-6
0013	3F	3_B1	156	82	6	8200	9740	1540	0.07	1.19	14	17	3
0013	3F	3_B1	234	64	9	6400	5250	-1150	0.14	0.82	11	9	-2
0013	3F	3_B1	235	55	3	5500	3480	-2020	0.05	0.63	9	6	-3
0013	3F	3_B1	236	59	5	5900	13970	8070	0.08	2.37	10	24	14
0013	3F	3_B1	245	39	5	3900	3170	-730	0.13	0.81	6	5	-1
0013	3F	3_B1	246	33	5	3300	3830	530	0.15	1.16	5	6	1
0013	3F	3_B1	256	26	1	2600	420	-2180	0.04	0.16	4	0	-4
0013	3F	3_B2	123	20	6	2000	4300	2300	0.30	2.15	3	7	4
0013	3F	3_B2	124	19	5	1900	4620	2720	0.26	2.43	3	8	5
0013	3F	3_B2	125	12	2	1200	610	-590	0.17	0.51	2	1	-1
0013	3F	3_B2	126	16	1	1600	340	-1260	0.06	0.21	2	0	-2
0013	3F	3_B2	134	9	0	900	0	-900	0.00	0.00	1	0	-1
0013	3F	3_B2	135	6	0	600	0	-600	0.00	0.00	1	0	-1
0013	3F	3_B2	136	5	0	500	0	-500	0.00	0.00	0	0	0
0013	3F	3_B2	145	4	0	400	0	-400	0.00	0.00	0	0	0
0013	3F	3_B2	146	2	0	200	0	-200	0.00	0.00	0	0	0
0013	3F	3_B2	156	2	0	200	0	-200	0.00	0.00	0	0	0
0013	3F	3_B2	234	12	3	1200	2310	1110	0.25	1.93	2	4	2
0013	3F	3_B2	235	11	3	1100	910	-190	0.27	0.83	1	1	0
0013	3F	3_B2	236	6	0	600	0	-600	0.00	0.00	1	0	-1
0013	3F	3_B2	245	1	0	100	0	-100	0.00	0.00	0	0	0
0013	3F	3_B2	246	1	0	100	0	-100	0.00	0.00	0	0	0
0013	3F	3_B2	256	3	0	300	0	-300	0.00	0.00	0	0	0
0013	3F	4_	123	3	0	300	0	-300	0.00	0.00	0	0	0
0013	3F	4_	124	1	0	100	0	-100	0.00	0.00	0	0	0
0013	3F	4_	125	3	1	300	270	-30	0.33	0.90	0	0	0
0013	3F	4_	126	1	0	100	0	-100	0.00	0.00	0	0	0
0013	3F	4_	134	2	0	200	0	-200	0.00	0.00	0	0	0
0013	3F	4_	145	2	0	200	0	-200	0.00	0.00	0	0	0
0013	3F	4_	146	1	0	100	0	-100	0.00	0.00	0	0	0
0013	3F	4_	234	1	1	100	180	80	1.00	1.80	0	0	0
0013	3F	4_A1	123	904	209	90400	69490	-20910	0.23	0.77	160	122	-38
0013	3F	4_A1	124	654	135	65400	57320	-8080	0.21	0.88	115	101	-14
0013	3F	4_A1	125	326	39	32600	21320	-11280	0.12	0.65	57	37	-20
0013	3F	4_A1	126	228	19	22800	19220	-3580	0.08	0.84	40	34	-6
0013	3F	4_A1	134	406	86	40600	38270	-2330	0.21	0.94	71	67	-4
0013	3F	4_A1	135	197	22	19700	12690	-7010	0.11	0.64	34	22	-12
0013	3F	4_A1	136	115	19	11500	17080	5580	0.17	1.49	20	30	10
0013	3F	4_A1	145	117	9	11700	3600	-8100	0.08	0.31	20	6	-14
0013	3F	4_A1	146	74	5	7400	8210	810	0.07	1.11	13	14	1
0013	3F	4_A1	156	30	0	3000	0	-3000	0.00	0.00	5	0	-5
0013	3F	4_A1	234	1	0	100	0	-100	0.00	0.00	0	0	0
0013	3F	4_A1	235	2	0	200	0	-200	0.00	0.00	0	0	0
0013	3F	4_A1	236	1	0	100	0	-100	0.00	0.00	0	0	0
0013	3F	4_A1	256	1	0	100	0	-100	0.00	0.00	0	0	0
0013	3F	4_A2	123	392	98	39200	37290	-1910	0.25	0.95	69	66	-3
0013	3F	4_A2	124	319	64	31900	21100	-10800	0.20	0.66	56	37	-19
0013	3F	4_A2	125	200	35	20000	18450	-1550	0.18	0.92	35	32	-3
0013	3F	4_A2	126	105	12	10500	4150	-6350	0.11	0.40	18	7	-11
0013	3F	4_A2	134	208	40	20800	23950	3150	0.19	1.15	36	42	6
0013	3F	4_A2	135	120	19	12000	8530	-3470	0.16	0.71	21	15	-6
0013	3F	4_A2	136	81	12	8100	9340	1240	0.15	1.15	14	16	2
0013	3F	4_A2	145	84	11	8400	8330	-70	0.13	0.99	14	14	0
0013	3F	4_A2	146	50	9	5000	9920	4920	0.18	1.98	8	17	9
0013	3F	4_A2	156	18	2	1800	820	-980	0.11	0.46	3	1	-2
0013	3F	4_A2	234	7	0	700	0	-700	0.00	0.00	1	0	-1
0013	3F	4_A2	235	3	0	300	0	-300	0.00	0.00	0	0	0
0013	3F	4_A2	236	3	0	300	0	-300	0.00	0.00	0	0	0
0013	3F	4_A2	245	3	0	300	0	-300	0.00	0.00	0	0	0
0013	3F	4_A2	246	1	0	100	0	-100	0.00	0.00	0	0	0
0013	3F	4_A2	256	1	0	100	0	-100	0.00	0.00	0	0	0
0013	3F	4_B1	123	514	75	51400	37280	-14120	0.15	0.73	90	65	-25
0013	3F	4_B1	124	432	41	43200	24560	-18640	0.09	0.57	76	43	-33
0013	3F	4_B1	125	270	19	27000	10800	-16200	0.07	0.40	47	19	-28
0013	3F	4_B1	126	171	14	17100	12420	-4680	0.08	0.73	30	21	-9
0013	3F	4_B1	134	309	36	30900	27230	-3670	0.12	0.88	54	48	-6
0013	3F	4_B1	135	182	12	18200	6620	-11580	0.07	0.36	32	11	-21
0013	3F	4_B1	136	108	5	10800	6390	-4410	0.05	0.59	19	11	-8
0013	3F	4_B1	145	95	9	9500	14280	4780	0.09	1.50	16	25	9
0013	3F	4_B1	146	72	3	7200	3630	-3570	0.04	0.50	12	6	-6
0013	3F	4_B1	156	34	3	3400	4380	980	0.09	1.29	6	7	1
0013	3F	4_B1	234	82	8	8200	4820	-3380	0.10	0.59	14	8	-6
0013	3F	4_B1	235	64	3	6400	2610	-3790	0.05	0.41	11	4	-7
0013	3F	4_B1	236	23	2	2300	850	-1450	0.09	0.37	4	1	-3
0013	3F	4_B1	245	39	4	3900	5410	1510	0.10	1.39	6	9	3
0013	3F	4_B1	246	24	1	2400	890	-1510	0.04	0.37	4	1	-3
0013	3F	4_B1	256	6	0	600	0	-600	0.00	0.00	1	0	-1
0013	3F	4_B2	123	16	4	1600	3780	2180	0.25	2.36	2	6	4
0013	3F	4_B2	124	15	1	1500	510	-990	0.07	0.34	2	0	-2
0013	3F	4_B2	125	11	2	1100	800	-300	0.18	0.73	1	1	0
0013	3F	4_B2	126	10	1	1000	1210	210	0.10	1.21	1	2	1
0013	3F	4_B2	134	12	1	1200	980	-220	0.08	0.82	2	1	-1
0013	3F	4_B2	135	5	0	500	0	-500	0.00	0.00	0	0	0
0013	3F	4_B2	136	2	0	200	0	-200	0.00	0.00	0	0	0
0013	3F	4_B2	145	3	0	300	0	-300	0.00	0.00	0	0	0
0013	3F	4_B2	146	2	0	200	0	-200	0.00	0.00	0	0	0
0013	3F	4_B2	156	1	0	100	0	-100	0.00	0.00	0	0	0
0013	3F	4_B2	234	31	5	3100	1670	-1430	0.16	0.54	5	2	-3
0013	3F	4_B2	235	22	3	2200	2140	-60	0.14	0.97	3	3	0
0013	3F	4_B2	236	12	0	1200	0	-1200	0.00	0.00	2	0	-2
0013	3F	4_B2	245	17	1	1700	230	-1470	0.06	0.14	3	0	-3
0013	3F	4_B2	246	8	0	800	0	-800	0.00	0.00	1	0	-1
0013	3F	4_B2	256	4	1	400	840	440	0.25	2.10	0	1	1
0013	3F	5_	123	7	1	700	330	-370	0.14	0.47	1	0	-1
0013	3F	5_	124	3	0	300	0	-300	0.00	0.00	0	0	0
0013	3F	5_	125	1	0	100	0	-100	0.00	0.00	0	0	0
0013	3F	5_	126	2	0	200	0	-200	0.00	0.00	0	0	0
0013	3F	5_	136	1	0	100	0	-100	0.00	0.00	0	0	0
0013	3F	5_	246	1	0	100	0	-100	0.00	0.00	0	0	0
0013	3F	5_A1	123	686	166	68600	50240	-18360	0.24	0.73	121	88	-33
0013	3F	5_A1	124	534	98	53400	39640	-13760	0.18	0.74	94	70	-24
0013	3F	5_A1	125	256	21	25600	12830	-12770	0.08	0.50	45	22	-23
0013	3F	5_A1	126	147	7	14700	5240	-9460	0.05	0.36	26	9	-17
0013	3F	5_A1	134	336	38	33600	23220	-10380	0.11	0.69	59	41	-18
0013	3F	5_A1	135	126	16	12600	14160	1560	0.13	1.12	22	25	3
0013	3F	5_A1	136	70	4	7000	1590	-5410	0.06	0.23	12	2	-10
0013	3F	5_A1	145	109	8	10900	6140	-4760	0.07	0.56	19	10	-9
0013	3F	5_A1	146	53	5	5300	5430	130	0.09	1.02	9	9	0
0013	3F	5_A1	156	12	2	1200	2240	1040	0.17	1.87	2	3	1
0013	3F	5_A1	234	5	1	500	2400	1900	0.20	4.80	0	4	4
0013	3F	5_A1	235	1	0	100	0	-100	0.00	0.00	0	0	0
0013	3F	5_A1	245	2	0	200	0	-200	0.00	0.00	0	0	0
0013	3F	5_A1	246	1	0	100	0	-100	0.00	0.00	0	0	0
0013	3F	5_A1	256	1	0	100	0	-100	0.00	0.00	0	0	0
0013	3F	5_A2	123	461	100	46100	42190	-3910	0.22	0.92	81	74	-7
0013	3F	5_A2	124	351	54	35100	27530	-7570	0.15	0.78	62	48	-14
0013	3F	5_A2	125	185	17	18500	13070	-5430	0.09	0.71	32	23	-9
0013	3F	5_A2	126	107	12	10700	12690	1990	0.11	1.19	18	22	4
0013	3F	5_A2	134	319	45	31900	21060	-10840	0.14	0.66	56	37	-19
0013	3F	5_A2	135	125	12	12500	8540	-3960	0.10	0.68	22	15	-7
0013	3F	5_A2	136	61	5	6100	6720	620	0.08	1.10	10	11	1
0013	3F	5_A2	145	113	10	11300	10340	-960	0.09	0.92	20	18	-2
0013	3F	5_A2	146	54	2	5400	6090	690	0.04	1.13	9	10	1
0013	3F	5_A2	156	18	2	1800	860	-940	0.11	0.48	3	1	-2
0013	3F	5_A2	234	20	1	2000	1500	-500	0.05	0.75	3	2	-1
0013	3F	5_A2	235	7	0	700	0	-700	0.00	0.00	1	0	-1
0013	3F	5_A2	236	4	0	400	0	-400	0.00	0.00	0	0	0
0013	3F	5_A2	245	8	0	800	0	-800	0.00	0.00	1	0	-1
0013	3F	5_A2	246	1	0	100	0	-100	0.00	0.00	0	0	0
0013	3F	5_A2	256	2	0	200	0	-200	0.00	0.00	0	0	0
0013	3F	5_B1	123	251	46	25100	22000	-3100	0.18	0.88	44	38	-6
0013	3F	5_B1	124	204	40	20400	21270	870	0.20	1.04	36	37	1
0013	3F	5_B1	125	122	12	12200	11310	-890	0.10	0.93	21	20	-1
0013	3F	5_B1	126	106	12	10600	13480	2880	0.11	1.27	18	23	5
0013	3F	5_B1	134	136	23	13600	13640	40	0.17	1.00	24	24	0
0013	3F	5_B1	135	86	6	8600	5700	-2900	0.07	0.66	15	10	-5
0013	3F	5_B1	136	57	7	5700	7500	1800	0.12	1.32	10	13	3
0013	3F	5_B1	145	63	4	6300	2350	-3950	0.06	0.37	11	4	-7
0013	3F	5_B1	146	51	5	5100	2590	-2510	0.10	0.51	9	4	-5
0013	3F	5_B1	156	25	1	2500	610	-1890	0.04	0.24	4	1	-3
0013	3F	5_B1	234	24	3	2400	1870	-530	0.13	0.78	4	3	-1
0013	3F	5_B1	235	17	1	1700	1390	-310	0.06	0.82	3	2	-1
0013	3F	5_B1	236	14	0	1400	0	-1400	0.00	0.00	2	0	-2
0013	3F	5_B1	245	11	0	1100	0	-1100	0.00	0.00	1	0	-1
0013	3F	5_B1	246	10	0	1000	0	-1000	0.00	0.00	1	0	-1
0013	3F	5_B1	256	10	1	1000	1530	530	0.10	1.53	1	2	1
0013	3F	5_B2	123	21	3	2100	940	-1160	0.14	0.45	3	1	-2
0013	3F	5_B2	124	20	2	2000	890	-1110	0.10	0.45	3	1	-2
0013	3F	5_B2	125	12	2	1200	1960	760	0.17	1.63	2	3	1
0013	3F	5_B2	126	5	0	500	0	-500	0.00	0.00	0	0	0
0013	3F	5_B2	134	12	1	1200	340	-860	0.08	0.28	2	0	-2
0013	3F	5_B2	135	7	0	700	0	-700	0.00	0.00	1	0	-1
0013	3F	5_B2	145	5	1	500	720	220	0.20	1.44	0	1	1
0013	3F	5_B2	146	2	0	200	0	-200	0.00	0.00	0	0	0
0013	3F	5_B2	156	2	0	200	0	-200	0.00	0.00	0	0	0
0013	3F	5_B2	234	3	0	300	0	-300	0.00	0.00	0	0	0
0013	3F	5_B2	235	5	2	500	1120	620	0.40	2.24	0	1	1
0013	3F	5_B2	236	2	0	200	0	-200	0.00	0.00	0	0	0
0013	3F	5_B2	245	3	1	300	360	60	0.33	1.20	0	0	0
0013	3F	5_B2	246	1	0	100	0	-100	0.00	0.00	0	0	0
0013	3F	5_B2	256	2	0	200	0	-200	0.00	0.00	0	0	0
0013	3F	6_A1	123	57	11	5700	3480	-2220	0.19	0.61	10	6	-4
0013	3F	6_A1	124	56	5	5600	1440	-4160	0.09	0.26	9	2	-7
0013	3F	6_A1	125	20	3	2000	2560	560	0.15	1.28	3	4	1
0013	3F	6_A1	126	14	3	1400	2410	1010	0.21	1.72	2	4	2
0013	3F	6_A1	134	20	3	2000	1600	-400	0.15	0.80	3	2	-1
0013	3F	6_A1	135	14	0	1400	0	-1400	0.00	0.00	2	0	-2
0013	3F	6_A1	136	8	1	800	1890	1090	0.13	2.36	1	3	2
0013	3F	6_A1	145	10	0	1000	0	-1000	0.00	0.00	1	0	-1
0013	3F	6_A1	146	3	0	300	0	-300	0.00	0.00	0	0	0
0013	3F	6_A1	156	1	0	100	0	-100	0.00	0.00	0	0	0
0013	3F	6_A2	123	34	4	3400	1880	-1520	0.12	0.55	6	3	-3
0013	3F	6_A2	124	28	6	2800	1890	-910	0.21	0.68	4	3	-1
0013	3F	6_A2	125	17	3	1700	1740	40	0.18	1.02	3	3	0
0013	3F	6_A2	126	7	2	700	870	170	0.29	1.24	1	1	0
0013	3F	6_A2	134	24	4	2400	1100	-1300	0.17	0.46	4	1	-3
0013	3F	6_A2	135	6	2	600	1260	660	0.33	2.10	1	2	1
0013	3F	6_A2	136	5	0	500	0	-500	0.00	0.00	0	0	0
0013	3F	6_A2	145	7	2	700	580	-120	0.29	0.83	1	1	0
0013	3F	6_A2	146	5	0	500	0	-500	0.00	0.00	0	0	0
0013	3F	6_B1	123	22	3	2200	890	-1310	0.14	0.40	3	1	-2
0013	3F	6_B1	124	67	11	6700	4530	-2170	0.16	0.68	11	8	-3
0013	3F	6_B1	125	15	3	1500	1150	-350	0.20	0.77	2	2	0
0013	3F	6_B1	126	3	1	300	410	110	0.33	1.37	0	0	0
0013	3F	6_B1	134	11	0	1100	0	-1100	0.00	0.00	1	0	-1
0013	3F	6_B1	135	9	0	900	0	-900	0.00	0.00	1	0	-1
0013	3F	6_B1	136	4	0	400	0	-400	0.00	0.00	0	0	0
0013	3F	6_B1	145	5	0	500	0	-500	0.00	0.00	0	0	0
0013	3F	6_B1	146	3	0	300	0	-300	0.00	0.00	0	0	0
0013	3F	6_B1	156	1	0	100	0	-100	0.00	0.00	0	0	0
0013	3F	6_B1	234	8	1	800	450	-350	0.13	0.56	1	0	-1
0013	3F	6_B1	235	2	1	200	840	640	0.50	4.20	0	1	1
0013	3F	6_B2	124	2	1	200	330	130	0.50	1.65	0	0	0
0013	3F	6_B2	125	1	0	100	0	-100	0.00	0.00	0	0	0
0013	3F	6_B2	156	1	0	100	0	-100	0.00	0.00	0	0	0
0013	3F	6_B2	246	1	0	100	0	-100	0.00	0.00	0	0	0
0013	3F	7_	123	6	2	600	1210	610	0.33	2.02	1	2	1
0013	3F	7_	124	1	0	100	0	-100	0.00	0.00	0	0	0
0013	3F	7_	125	1	0	100	0	-100	0.00	0.00	0	0	0
0013	3F	7_	126	1	0	100	0	-100	0.00	0.00	0	0	0
0013	3F	7_	134	1	0	100	0	-100	0.00	0.00	0	0	0
0013	3F	7_	135	2	0	200	0	-200	0.00	0.00	0	0	0
0013	3F	7_	136	2	0	200	0	-200	0.00	0.00	0	0	0
0013	3F	7_	146	1	0	100	0	-100	0.00	0.00	0	0	0
0013	3F	7_	156	1	0	100	0	-100	0.00	0.00	0	0	0
0013	3F	7_A1	123	897	192	89700	74800	-14900	0.21	0.83	158	132	-26
0013	3F	7_A1	124	755	130	75500	53600	-21900	0.17	0.71	133	94	-39
0013	3F	7_A1	125	309	41	30900	31420	520	0.13	1.02	54	55	1
0013	3F	7_A1	126	187	14	18700	12210	-6490	0.07	0.65	33	21	-12
0013	3F	7_A1	134	488	76	48800	45260	-3540	0.16	0.93	86	80	-6
0013	3F	7_A1	135	187	18	18700	11490	-7210	0.10	0.61	33	20	-13
0013	3F	7_A1	136	98	7	9800	6280	-3520	0.07	0.64	17	11	-6
0013	3F	7_A1	145	110	11	11000	11800	800	0.10	1.07	19	20	1
0013	3F	7_A1	146	72	6	7200	6030	-1170	0.08	0.84	12	10	-2
0013	3F	7_A1	156	14	0	1400	0	-1400	0.00	0.00	2	0	-2
0013	3F	7_A1	234	4	0	400	0	-400	0.00	0.00	0	0	0
0013	3F	7_A1	235	1	0	100	0	-100	0.00	0.00	0	0	0
0013	3F	7_A1	236	2	0	200	0	-200	0.00	0.00	0	0	0
0013	3F	7_A1	245	1	0	100	0	-100	0.00	0.00	0	0	0
0013	3F	7_A1	246	1	0	100	0	-100	0.00	0.00	0	0	0
0013	3F	7_A2	123	841	180	84100	71990	-12110	0.21	0.86	148	127	-21
0013	3F	7_A2	124	674	96	67400	47220	-20180	0.14	0.70	119	83	-36
0013	3F	7_A2	125	371	48	37100	24140	-12960	0.13	0.65	65	42	-23
0013	3F	7_A2	126	208	29	20800	18450	-2350	0.14	0.89	36	32	-4
0013	3F	7_A2	134	433	52	43300	29910	-13390	0.12	0.69	76	52	-24
0013	3F	7_A2	135	236	26	23600	18500	-5100	0.11	0.78	41	32	-9
0013	3F	7_A2	136	144	15	14400	10350	-4050	0.10	0.72	25	18	-7
0013	3F	7_A2	145	151	17	15100	14280	-820	0.11	0.95	26	25	-1
0013	3F	7_A2	146	97	7	9700	3600	-6100	0.07	0.37	17	6	-11
0013	3F	7_A2	156	40	0	4000	0	-4000	0.00	0.00	7	0	-7
0013	3F	7_A2	234	7	1	700	1570	870	0.14	2.24	1	2	1
0013	3F	7_A2	235	7	0	700	0	-700	0.00	0.00	1	0	-1
0013	3F	7_A2	236	1	0	100	0	-100	0.00	0.00	0	0	0
0013	3F	7_A2	245	2	0	200	0	-200	0.00	0.00	0	0	0
0013	3F	7_A2	246	3	0	300	0	-300	0.00	0.00	0	0	0
0013	3F	7_A2	256	2	0	200	0	-200	0.00	0.00	0	0	0
0013	3F	7_B1	123	470	82	47000	35080	-11920	0.17	0.75	83	62	-21
0013	3F	7_B1	124	372	78	37200	39500	2300	0.21	1.06	65	69	4
0013	3F	7_B1	125	255	30	25500	21130	-4370	0.12	0.83	45	37	-8
0013	3F	7_B1	126	234	31	23400	26550	3150	0.13	1.13	41	46	5
0013	3F	7_B1	134	233	41	23300	26960	3660	0.18	1.16	41	47	6
0013	3F	7_B1	135	166	26	16600	20670	4070	0.16	1.25	29	36	7
0013	3F	7_B1	136	127	15	12700	9850	-2850	0.12	0.78	22	17	-5
0013	3F	7_B1	145	92	11	9200	17920	8720	0.12	1.95	16	31	15
0013	3F	7_B1	146	92	4	9200	3050	-6150	0.04	0.33	16	5	-11
0013	3F	7_B1	156	47	4	4700	4040	-660	0.09	0.86	8	7	-1
0013	3F	7_B1	234	44	3	4400	1000	-3400	0.07	0.23	7	1	-6
0013	3F	7_B1	235	45	8	4500	6670	2170	0.18	1.48	7	11	4
0013	3F	7_B1	236	36	0	3600	0	-3600	0.00	0.00	6	0	-6
0013	3F	7_B1	245	22	2	2200	1330	-870	0.09	0.60	3	2	-1
0013	3F	7_B1	246	15	0	1500	0	-1500	0.00	0.00	2	0	-2
0013	3F	7_B1	256	19	0	1900	0	-1900	0.00	0.00	3	0	-3
0013	3F	7_B2	123	33	6	3300	2520	-780	0.18	0.76	5	4	-1
0013	3F	7_B2	124	17	2	1700	1120	-580	0.12	0.66	3	1	-2
0013	3F	7_B2	125	12	2	1200	780	-420	0.17	0.65	2	1	-1
0013	3F	7_B2	126	9	0	900	0	-900	0.00	0.00	1	0	-1
0013	3F	7_B2	134	8	3	800	2450	1650	0.38	3.06	1	4	3
0013	3F	7_B2	135	8	1	800	990	190	0.13	1.24	1	1	0
0013	3F	7_B2	136	8	1	800	1470	670	0.13	1.84	1	2	1
0013	3F	7_B2	145	4	1	400	290	-110	0.25	0.73	0	0	0
0013	3F	7_B2	146	3	0	300	0	-300	0.00	0.00	0	0	0
0013	3F	7_B2	156	3	1	300	3440	3140	0.33	11.47	0	6	6
0013	3F	7_B2	234	8	1	800	340	-460	0.13	0.43	1	0	-1
0013	3F	7_B2	235	6	1	600	1100	500	0.17	1.83	1	1	0
0013	3F	7_B2	236	2	0	200	0	-200	0.00	0.00	0	0	0
0013	3F	7_B2	246	1	0	100	0	-100	0.00	0.00	0	0	0
0025	3T	07	136	130	12	13000	15990	2990	0.09	1.23	23	28	5
0025	3T	07	142	1	0	100	0	-100	0.00	0.00	0	0	0
0025	3T	07	143	5	0	500	0	-500	0.00	0.00	0	0	0
0025	3T	07	145	130	13	13000	15710	2710	0.10	1.21	23	27	4
0025	3T	07	146	28	3	2800	2800	0	0.11	1.00	4	4	0
0025	3T	07	152	2	0	200	0	-200	0.00	0.00	0	0	0
0025	3T	07	153	5	0	500	0	-500	0.00	0.00	0	0	0
0025	3T	07	156	12	1	1200	1540	340	0.08	1.28	2	2	0
0025	3T	07	163	1	0	100	0	-100	0.00	0.00	0	0	0
0025	3T	07	213	1	0	100	0	-100	0.00	0.00	0	0	0
0025	3T	07	234	5	0	500	0	-500	0.00	0.00	0	0	0
0025	3T	07	235	6	0	600	0	-600	0.00	0.00	1	0	-1
0025	3T	07	236	3	0	300	0	-300	0.00	0.00	0	0	0
0025	3T	07	243	1	0	100	0	-100	0.00	0.00	0	0	0
0025	3T	07	245	3	0	300	0	-300	0.00	0.00	0	0	0
0025	3T	07	246	2	0	200	0	-200	0.00	0.00	0	0	0
0025	3T	07	253	1	0	100	0	-100	0.00	0.00	0	0	0
0025	3T	07	256	2	0	200	0	-200	0.00	0.00	0	0	0
0025	3T	08	123	231	35	23100	23220	120	0.15	1.01	40	41	1
0025	3T	08	124	667	67	66700	57050	-9650	0.10	0.86	118	100	-18
0025	3T	08	125	294	19	29400	21140	-8260	0.06	0.72	52	37	-15
0025	3T	08	126	312	21	31200	26570	-4630	0.07	0.85	55	47	-8
0025	3T	08	134	175	20	17500	17750	250	0.11	1.01	30	31	1
0025	3T	08	135	156	9	15600	7880	-7720	0.06	0.51	27	13	-14
0025	3T	08	136	166	17	16600	16580	-20	0.10	1.00	29	29	0
0025	3T	08	142	1	0	100	0	-100	0.00	0.00	0	0	0
0025	3T	08	143	3	0	300	0	-300	0.00	0.00	0	0	0
0025	3T	08	145	91	5	9100	4290	-4810	0.05	0.47	16	7	-9
0025	3T	08	146	61	4	6100	4240	-1860	0.07	0.70	10	7	-3
0025	3T	08	152	2	0	200	0	-200	0.00	0.00	0	0	0
0025	3T	08	153	4	0	400	0	-400	0.00	0.00	0	0	0
0025	3T	08	156	19	1	1900	1350	-550	0.05	0.71	3	2	-1
0025	3T	08	163	1	0	100	0	-100	0.00	0.00	0	0	0
0025	3T	08	216	1	0	100	0	-100	0.00	0.00	0	0	0
0025	3T	08	234	5	0	500	0	-500	0.00	0.00	0	0	0
0025	3T	08	235	6	0	600	0	-600	0.00	0.00	1	0	-1
0025	3T	08	245	2	0	200	0	-200	0.00	0.00	0	0	0
0025	3T	08	246	1	0	100	0	-100	0.00	0.00	0	0	0
0025	3T	08	256	1	0	100	0	-100	0.00	0.00	0	0	0
0025	3T	09	123	399	50	39900	27690	-12210	0.13	0.69	70	49	-21
0025	3T	09	124	760	83	76000	66930	-9070	0.11	0.88	134	118	-16
0025	3T	09	125	286	24	28600	26230	-2370	0.08	0.92	50	46	-4
0025	3T	09	126	265	8	26500	10630	-15870	0.03	0.40	46	18	-28
0025	3T	09	132	4	0	400	0	-400	0.00	0.00	0	0	0
0025	3T	09	134	218	16	21800	12160	-9640	0.07	0.56	38	21	-17
0025	3T	09	135	159	16	15900	15510	-390	0.10	0.98	28	27	-1
0025	3T	09	136	121	6	12100	8330	-3770	0.05	0.69	21	14	-7
0025	3T	09	143	2	0	200	0	-200	0.00	0.00	0	0	0
0025	3T	09	145	55	2	5500	3470	-2030	0.04	0.63	9	6	-3
0025	3T	09	146	36	2	3600	1540	-2060	0.06	0.43	6	2	-4
0025	3T	09	153	2	0	200	0	-200	0.00	0.00	0	0	0
0025	3T	09	156	15	0	1500	0	-1500	0.00	0.00	2	0	-2
0025	3T	09	165	1	0	100	0	-100	0.00	0.00	0	0	0
0025	3T	09	214	1	0	100	0	-100	0.00	0.00	0	0	0
0025	3T	09	216	2	0	200	0	-200	0.00	0.00	0	0	0
0025	3T	09	234	9	0	900	0	-900	0.00	0.00	1	0	-1
0025	3T	09	235	4	0	400	0	-400	0.00	0.00	0	0	0
0025	3T	09	236	9	0	900	0	-900	0.00	0.00	1	0	-1
0025	3T	09	245	2	1	200	2160	1960	0.50	10.80	0	3	3
0025	3T	09	246	1	0	100	0	-100	0.00	0.00	0	0	0
0025	3T	09	256	3	0	300	0	-300	0.00	0.00	0	0	0
0025	3T	10	123	472	64	47200	34290	-12910	0.14	0.73	83	60	-23
0025	3T	10	124	609	68	60900	57670	-3230	0.11	0.95	107	102	-5
0025	3T	10	125	209	16	20900	18140	-2760	0.08	0.87	36	32	-4
0025	3T	10	126	159	10	15900	14120	-1780	0.06	0.89	28	24	-4
0025	3T	10	134	183	13	18300	14130	-4170	0.07	0.77	32	25	-7
0025	3T	10	135	145	8	14500	8020	-6480	0.06	0.55	25	14	-11
0025	3T	10	136	90	6	9000	8660	-340	0.07	0.96	15	15	0
0025	3T	10	142	1	0	100	0	-100	0.00	0.00	0	0	0
0025	3T	10	143	5	0	500	0	-500	0.00	0.00	0	0	0
0025	3T	10	145	75	8	7500	12640	5140	0.11	1.69	13	22	9
0025	3T	10	146	43	4	4300	4970	670	0.09	1.16	7	8	1
0025	3T	10	154	2	0	200	0	-200	0.00	0.00	0	0	0
0025	3T	10	156	11	0	1100	0	-1100	0.00	0.00	1	0	-1
0025	3T	10	216	6	0	600	0	-600	0.00	0.00	1	0	-1
0025	3T	10	234	1	0	100	0	-100	0.00	0.00	0	0	0
0013	3T	1_	123	4	0	400	0	-400	0.00	0.00	0	0	0
0013	3T	1_	124	2	0	200	0	-200	0.00	0.00	0	0	0
0013	3T	1_	125	2	1	200	980	780	0.50	4.90	0	1	1
0013	3T	1_	126	2	0	200	0	-200	0.00	0.00	0	0	0
0013	3T	1_	135	1	1	100	1040	940	1.00	10.40	0	1	1
0013	3T	1_	136	1	0	100	0	-100	0.00	0.00	0	0	0
0013	3T	1_	142	1	1	100	610	510	1.00	6.10	0	1	1
0013	3T	1_	145	1	1	100	800	700	1.00	8.00	0	1	1
0013	3T	1_	153	1	0	100	0	-100	0.00	0.00	0	0	0
0013	3T	1_	235	3	0	300	0	-300	0.00	0.00	0	0	0
0013	3T	1_A1	123	537	50	53700	39950	-13750	0.09	0.74	95	70	-25
0013	3T	1_A1	124	522	51	52200	42470	-9730	0.10	0.81	92	75	-17
0013	3T	1_A1	125	286	21	28600	31420	2820	0.07	1.10	50	55	5
0013	3T	1_A1	126	207	10	20700	20540	-160	0.05	0.99	36	36	0
0013	3T	1_A1	132	254	14	25400	16730	-8670	0.06	0.66	44	29	-15
0013	3T	1_A1	134	244	20	24400	21220	-3180	0.08	0.87	43	37	-6
0013	3T	1_A1	135	140	2	14000	2850	-11150	0.01	0.20	24	5	-19
0013	3T	1_A1	136	141	5	14100	6740	-7360	0.04	0.48	24	11	-13
0013	3T	1_A1	142	136	8	13600	6520	-7080	0.06	0.48	24	11	-13
0013	3T	1_A1	143	147	6	14700	11420	-3280	0.04	0.78	26	20	-6
0013	3T	1_A1	145	82	5	8200	5140	-3060	0.06	0.63	14	9	-5
0013	3T	1_A1	146	67	1	6700	2120	-4580	0.01	0.32	11	3	-8
0013	3T	1_A1	152	39	4	3900	9150	5250	0.10	2.35	6	16	10
0013	3T	1_A1	153	38	1	3800	1040	-2760	0.03	0.27	6	1	-5
0013	3T	1_A1	154	33	0	3300	0	-3300	0.00	0.00	5	0	-5
0013	3T	1_A1	156	28	1	2800	4670	1870	0.04	1.67	4	8	4
0013	3T	1_A1	162	13	0	1300	0	-1300	0.00	0.00	2	0	-2
0013	3T	1_A1	163	8	0	800	0	-800	0.00	0.00	1	0	-1
0013	3T	1_A1	164	8	0	800	0	-800	0.00	0.00	1	0	-1
0013	3T	1_A1	165	8	1	800	3100	2300	0.13	3.88	1	5	4
0013	3T	1_A1	213	4	0	400	0	-400	0.00	0.00	0	0	0
0013	3T	1_A1	214	5	0	500	0	-500	0.00	0.00	0	0	0
0013	3T	1_A1	215	3	0	300	0	-300	0.00	0.00	0	0	0
0013	3T	1_A1	216	2	0	200	0	-200	0.00	0.00	0	0	0
0013	3T	1_A1	234	2	0	200	0	-200	0.00	0.00	0	0	0
0013	3T	1_A1	235	2	0	200	0	-200	0.00	0.00	0	0	0
0013	3T	1_A1	236	2	0	200	0	-200	0.00	0.00	0	0	0
0013	3T	1_A1	254	1	0	100	0	-100	0.00	0.00	0	0	0
0013	3T	1_A2	123	408	33	40800	29520	-11280	0.08	0.72	72	52	-20
0013	3T	1_A2	124	359	31	35900	37770	1870	0.09	1.05	63	66	3
0013	3T	1_A2	125	183	9	18300	11770	-6530	0.05	0.64	32	20	-12
0013	3T	1_A2	126	181	11	18100	22860	4760	0.06	1.26	32	40	8
0013	3T	1_A2	132	199	17	19900	24490	4590	0.09	1.23	35	43	8
0013	3T	1_A2	134	231	16	23100	18440	-4660	0.07	0.80	40	32	-8
0013	3T	1_A2	135	136	10	13600	20240	6640	0.07	1.49	24	35	11
0013	3T	1_A2	136	112	9	11200	16160	4960	0.08	1.44	19	28	9
0013	3T	1_A2	142	146	12	14600	12860	-1740	0.08	0.88	25	22	-3
0013	3T	1_A2	143	132	9	13200	12680	-520	0.07	0.96	23	22	-1
0013	3T	1_A2	145	68	4	6800	4470	-2330	0.06	0.66	12	7	-5
0013	3T	1_A2	146	68	4	6800	9310	2510	0.06	1.37	12	16	4
0013	3T	1_A2	152	40	2	4000	5170	1170	0.05	1.29	7	9	2
0013	3T	1_A2	153	33	1	3300	11150	7850	0.03	3.38	5	19	14
0013	3T	1_A2	154	28	0	2800	0	-2800	0.00	0.00	4	0	-4
0013	3T	1_A2	156	22	3	2200	15870	13670	0.14	7.21	3	28	25
0013	3T	1_A2	162	19	1	1900	770	-1130	0.05	0.41	3	1	-2
0013	3T	1_A2	163	27	1	2700	1500	-1200	0.04	0.56	4	2	-2
0013	3T	1_A2	164	15	1	1500	690	-810	0.07	0.46	2	1	-1
0013	3T	1_A2	165	13	1	1300	26680	25380	0.08	20.52	2	47	45
0013	3T	1_A2	213	8	0	800	0	-800	0.00	0.00	1	0	-1
0013	3T	1_A2	214	7	0	700	0	-700	0.00	0.00	1	0	-1
0013	3T	1_A2	215	5	0	500	0	-500	0.00	0.00	0	0	0
0013	3T	1_A2	216	5	0	500	0	-500	0.00	0.00	0	0	0
0013	3T	1_A2	231	7	0	700	0	-700	0.00	0.00	1	0	-1
0013	3T	1_A2	234	4	0	400	0	-400	0.00	0.00	0	0	0
0013	3T	1_A2	235	2	0	200	0	-200	0.00	0.00	0	0	0
0013	3T	1_A2	243	3	0	300	0	-300	0.00	0.00	0	0	0
0013	3T	1_A2	245	1	0	100	0	-100	0.00	0.00	0	0	0
0013	3T	1_A2	246	3	0	300	0	-300	0.00	0.00	0	0	0
0013	3T	1_A2	251	2	0	200	0	-200	0.00	0.00	0	0	0
0013	3T	1_A2	253	2	0	200	0	-200	0.00	0.00	0	0	0
0013	3T	1_A2	256	1	0	100	0	-100	0.00	0.00	0	0	0
0013	3T	1_A2	261	1	0	100	0	-100	0.00	0.00	0	0	0
0013	3T	1_A2	263	2	0	200	0	-200	0.00	0.00	0	0	0
0013	3T	1_A2	264	1	0	100	0	-100	0.00	0.00	0	0	0
0013	3T	1_B1	123	309	23	30900	29780	-1120	0.07	0.96	54	52	-2
0013	3T	1_B1	124	258	15	25800	23250	-2550	0.06	0.90	45	41	-4
0013	3T	1_B1	125	200	8	20000	11580	-8420	0.04	0.58	35	20	-15
0013	3T	1_B1	126	208	6	20800	10170	-10630	0.03	0.49	36	18	-18
0013	3T	1_B1	132	174	9	17400	14640	-2760	0.05	0.84	30	25	-5
0013	3T	1_B1	134	175	7	17500	16190	-1310	0.04	0.93	30	28	-2
0013	3T	1_B1	135	136	6	13600	10730	-2870	0.04	0.79	24	18	-6
0013	3T	1_B1	136	123	7	12300	22060	9760	0.06	1.79	21	39	18
0013	3T	1_B1	142	117	4	11700	4360	-7340	0.03	0.37	20	7	-13
0013	3T	1_B1	143	102	6	10200	9240	-960	0.06	0.91	18	16	-2
0013	3T	1_B1	145	95	4	9500	11050	1550	0.04	1.16	16	19	3
0013	3T	1_B1	146	77	2	7700	4110	-3590	0.03	0.53	13	7	-6
0013	3T	1_B1	152	55	5	5500	8300	2800	0.09	1.51	9	14	5
0013	3T	1_B1	153	50	2	5000	4420	-580	0.04	0.88	8	7	-1
0013	3T	1_B1	154	31	0	3100	0	-3100	0.00	0.00	5	0	-5
0013	3T	1_B1	156	46	4	4600	13150	8550	0.09	2.86	8	23	15
0013	3T	1_B1	162	36	1	3600	7290	3690	0.03	2.03	6	12	6
0013	3T	1_B1	163	29	1	2900	3610	710	0.03	1.24	5	6	1
0013	3T	1_B1	164	37	1	3700	3420	-280	0.03	0.92	6	6	0
0013	3T	1_B1	165	21	0	2100	0	-2100	0.00	0.00	3	0	-3
0013	3T	1_B1	213	62	3	6200	6490	290	0.05	1.05	10	11	1
0013	3T	1_B1	214	68	2	6800	3710	-3090	0.03	0.55	12	6	-6
0013	3T	1_B1	215	57	2	5700	3090	-2610	0.04	0.54	10	5	-5
0013	3T	1_B1	216	68	1	6800	3480	-3320	0.01	0.51	12	6	-6
0013	3T	1_B1	231	15	1	1500	1160	-340	0.07	0.77	2	2	0
0013	3T	1_B1	234	26	2	2600	2570	-30	0.08	0.99	4	4	0
0013	3T	1_B1	235	39	1	3900	630	-3270	0.03	0.16	6	1	-5
0013	3T	1_B1	236	23	0	2300	0	-2300	0.00	0.00	4	0	-4
0013	3T	1_B1	241	14	0	1400	0	-1400	0.00	0.00	2	0	-2
0013	3T	1_B1	243	27	1	2700	2780	80	0.04	1.03	4	4	0
0013	3T	1_B1	245	19	0	1900	0	-1900	0.00	0.00	3	0	-3
0013	3T	1_B1	246	15	0	1500	0	-1500	0.00	0.00	2	0	-2
0013	3T	1_B1	251	11	0	1100	0	-1100	0.00	0.00	1	0	-1
0013	3T	1_B1	253	13	0	1300	0	-1300	0.00	0.00	2	0	-2
0013	3T	1_B1	254	10	0	1000	0	-1000	0.00	0.00	1	0	-1
0013	3T	1_B1	256	14	0	1400	0	-1400	0.00	0.00	2	0	-2
0013	3T	1_B1	261	20	0	2000	0	-2000	0.00	0.00	3	0	-3
0013	3T	1_B1	263	17	1	1700	2150	450	0.06	1.26	3	3	0
0013	3T	1_B1	264	9	0	900	0	-900	0.00	0.00	1	0	-1
0013	3T	1_B1	265	11	1	1100	1820	720	0.09	1.65	1	3	2
0013	3T	1_B2	123	9	0	900	0	-900	0.00	0.00	1	0	-1
0013	3T	1_B2	124	7	1	700	3950	3250	0.14	5.64	1	6	5
0013	3T	1_B2	125	2	0	200	0	-200	0.00	0.00	0	0	0
0013	3T	1_B2	126	4	0	400	0	-400	0.00	0.00	0	0	0
0013	3T	1_B2	132	2	0	200	0	-200	0.00	0.00	0	0	0
0013	3T	1_B2	134	7	0	700	0	-700	0.00	0.00	1	0	-1
0013	3T	1_B2	135	2	0	200	0	-200	0.00	0.00	0	0	0
0013	3T	1_B2	136	6	1	600	890	290	0.17	1.48	1	1	0
0013	3T	1_B2	142	1	0	100	0	-100	0.00	0.00	0	0	0
0013	3T	1_B2	145	1	0	100	0	-100	0.00	0.00	0	0	0
0013	3T	1_B2	146	1	0	100	0	-100	0.00	0.00	0	0	0
0013	3T	1_B2	152	2	0	200	0	-200	0.00	0.00	0	0	0
0013	3T	1_B2	153	2	0	200	0	-200	0.00	0.00	0	0	0
0013	3T	1_B2	154	3	0	300	0	-300	0.00	0.00	0	0	0
0013	3T	1_B2	163	1	0	100	0	-100	0.00	0.00	0	0	0
0013	3T	1_B2	164	2	0	200	0	-200	0.00	0.00	0	0	0
0013	3T	1_B2	165	1	0	100	0	-100	0.00	0.00	0	0	0
0013	3T	1_B2	214	1	0	100	0	-100	0.00	0.00	0	0	0
0013	3T	1_B2	215	1	0	100	0	-100	0.00	0.00	0	0	0
0013	3T	1_B2	231	2	0	200	0	-200	0.00	0.00	0	0	0
0013	3T	1_B2	234	4	1	400	900	500	0.25	2.25	0	1	1
0013	3T	1_B2	235	4	0	400	0	-400	0.00	0.00	0	0	0
0013	3T	1_B2	236	2	0	200	0	-200	0.00	0.00	0	0	0
0013	3T	1_B2	243	1	0	100	0	-100	0.00	0.00	0	0	0
0013	3T	1_B2	253	4	0	400	0	-400	0.00	0.00	0	0	0
0013	3T	1_B2	254	1	0	100	0	-100	0.00	0.00	0	0	0
0013	3T	1_B2	264	1	0	100	0	-100	0.00	0.00	0	0	0
0013	3T	2_	123	1	0	100	0	-100	0.00	0.00	0	0	0
0013	3T	2_	124	1	0	100	0	-100	0.00	0.00	0	0	0
0013	3T	2_	125	1	0	100	0	-100	0.00	0.00	0	0	0
0013	3T	2_	126	1	0	100	0	-100	0.00	0.00	0	0	0
0013	3T	2_	132	3	1	300	1520	1220	0.33	5.07	0	2	2
0013	3T	2_	136	1	0	100	0	-100	0.00	0.00	0	0	0
0013	3T	2_	142	2	0	200	0	-200	0.00	0.00	0	0	0
0013	3T	2_	153	1	1	100	4300	4200	1.00	43.00	0	7	7
0013	3T	2_	154	1	0	100	0	-100	0.00	0.00	0	0	0
0013	3T	2_A1	123	503	59	50300	46400	-3900	0.12	0.92	89	82	-7
0013	3T	2_A1	124	476	48	47600	52940	5340	0.10	1.11	84	93	9
0013	3T	2_A1	125	251	16	25100	23460	-1640	0.06	0.93	44	41	-3
0013	3T	2_A1	126	230	12	23000	19810	-3190	0.05	0.86	40	35	-5
0013	3T	2_A1	132	207	20	20700	23030	2330	0.10	1.11	36	40	4
0013	3T	2_A1	134	250	11	25000	10680	-14320	0.04	0.43	44	18	-26
0013	3T	2_A1	135	131	6	13100	5410	-7690	0.05	0.41	23	9	-14
0013	3T	2_A1	136	121	7	12100	11010	-1090	0.06	0.91	21	19	-2
0013	3T	2_A1	142	153	15	15300	14400	-900	0.10	0.94	27	25	-2
0013	3T	2_A1	143	142	7	14200	14500	300	0.05	1.02	25	25	0
0013	3T	2_A1	145	76	6	7600	6490	-1110	0.08	0.85	13	11	-2
0013	3T	2_A1	146	75	7	7500	8110	610	0.09	1.08	13	14	1
0013	3T	2_A1	152	46	1	4600	2080	-2520	0.02	0.45	8	3	-5
0013	3T	2_A1	153	39	2	3900	9870	5970	0.05	2.53	6	17	11
0013	3T	2_A1	154	34	0	3400	0	-3400	0.00	0.00	6	0	-6
0013	3T	2_A1	156	21	1	2100	1500	-600	0.05	0.71	3	2	-1
0013	3T	2_A1	162	22	0	2200	0	-2200	0.00	0.00	3	0	-3
0013	3T	2_A1	163	29	2	2900	1480	-1420	0.07	0.51	5	2	-3
0013	3T	2_A1	164	11	1	1100	700	-400	0.09	0.64	1	1	0
0013	3T	2_A1	165	9	0	900	0	-900	0.00	0.00	1	0	-1
0013	3T	2_A1	213	4	0	400	0	-400	0.00	0.00	0	0	0
0013	3T	2_A1	214	2	0	200	0	-200	0.00	0.00	0	0	0
0013	3T	2_A1	231	1	0	100	0	-100	0.00	0.00	0	0	0
0013	3T	2_A1	234	3	0	300	0	-300	0.00	0.00	0	0	0
0013	3T	2_A1	241	2	0	200	0	-200	0.00	0.00	0	0	0
0013	3T	2_A1	243	1	0	100	0	-100	0.00	0.00	0	0	0
0013	3T	2_A1	245	1	0	100	0	-100	0.00	0.00	0	0	0
0013	3T	2_A2	123	343	36	34300	27210	-7090	0.10	0.79	60	48	-12
0013	3T	2_A2	124	314	27	31400	28350	-3050	0.09	0.90	55	50	-5
0013	3T	2_A2	125	189	15	18900	13460	-5440	0.08	0.71	33	23	-10
0013	3T	2_A2	126	169	16	16900	19510	2610	0.09	1.15	29	34	5
0013	3T	2_A2	132	201	15	20100	17730	-2370	0.07	0.88	35	31	-4
0013	3T	2_A2	134	172	22	17200	25050	7850	0.13	1.46	30	44	14
0013	3T	2_A2	135	124	8	12400	6190	-6210	0.06	0.50	21	10	-11
0013	3T	2_A2	136	134	7	13400	9540	-3860	0.05	0.71	23	16	-7
0013	3T	2_A2	142	141	14	14100	16420	2320	0.10	1.16	24	29	5
0013	3T	2_A2	143	131	6	13100	10010	-3090	0.05	0.76	23	17	-6
0013	3T	2_A2	145	95	5	9500	4970	-4530	0.05	0.52	16	8	-8
0013	3T	2_A2	146	64	5	6400	24590	18190	0.08	3.84	11	43	32
0013	3T	2_A2	152	34	4	3400	8950	5550	0.12	2.63	6	15	9
0013	3T	2_A2	153	51	5	5100	5350	250	0.10	1.05	9	9	0
0013	3T	2_A2	154	35	3	3500	3180	-320	0.09	0.91	6	5	-1
0013	3T	2_A2	156	28	2	2800	3580	780	0.07	1.28	4	6	2
0013	3T	2_A2	162	26	2	2600	6250	3650	0.08	2.40	4	11	7
0013	3T	2_A2	163	39	5	3900	10360	6460	0.13	2.66	6	18	12
0013	3T	2_A2	164	30	1	3000	1300	-1700	0.03	0.43	5	2	-3
0013	3T	2_A2	165	13	0	1300	0	-1300	0.00	0.00	2	0	-2
0013	3T	2_A2	213	18	1	1800	730	-1070	0.06	0.41	3	1	-2
0013	3T	2_A2	214	9	1	900	1410	510	0.11	1.57	1	2	1
0013	3T	2_A2	215	7	0	700	0	-700	0.00	0.00	1	0	-1
0013	3T	2_A2	216	10	0	1000	0	-1000	0.00	0.00	1	0	-1
0013	3T	2_A2	231	2	0	200	0	-200	0.00	0.00	0	0	0
0013	3T	2_A2	234	3	0	300	0	-300	0.00	0.00	0	0	0
0013	3T	2_A2	235	5	0	500	0	-500	0.00	0.00	0	0	0
0013	3T	2_A2	236	2	0	200	0	-200	0.00	0.00	0	0	0
0013	3T	2_A2	241	3	0	300	0	-300	0.00	0.00	0	0	0
0013	3T	2_A2	243	2	1	200	1480	1280	0.50	7.40	0	2	2
0013	3T	2_A2	245	3	0	300	0	-300	0.00	0.00	0	0	0
0013	3T	2_A2	246	1	0	100	0	-100	0.00	0.00	0	0	0
0013	3T	2_A2	253	3	0	300	0	-300	0.00	0.00	0	0	0
0013	3T	2_A2	254	2	0	200	0	-200	0.00	0.00	0	0	0
0013	3T	2_A2	256	1	0	100	0	-100	0.00	0.00	0	0	0
0013	3T	2_A2	261	1	0	100	0	-100	0.00	0.00	0	0	0
0013	3T	2_A2	263	4	0	400	0	-400	0.00	0.00	0	0	0
0013	3T	2_A2	264	1	0	100	0	-100	0.00	0.00	0	0	0
0013	3T	2_A2	265	1	0	100	0	-100	0.00	0.00	0	0	0
0013	3T	2_B1	123	337	23	33700	32330	-1370	0.07	0.96	59	57	-2
0013	3T	2_B1	124	290	23	29000	36350	7350	0.08	1.25	51	64	13
0013	3T	2_B1	125	219	8	21900	15520	-6380	0.04	0.71	38	27	-11
0013	3T	2_B1	126	188	8	18800	16330	-2470	0.04	0.87	33	28	-5
0013	3T	2_B1	132	213	8	21300	16810	-4490	0.04	0.79	37	29	-8
0013	3T	2_B1	134	172	7	17200	18710	1510	0.04	1.09	30	33	3
0013	3T	2_B1	135	145	6	14500	8930	-5570	0.04	0.62	25	15	-10
0013	3T	2_B1	136	118	2	11800	5760	-6040	0.02	0.49	20	10	-10
0013	3T	2_B1	142	125	4	12500	5300	-7200	0.03	0.42	22	9	-13
0013	3T	2_B1	143	110	2	11000	6900	-4100	0.02	0.63	19	12	-7
0013	3T	2_B1	145	71	1	7100	940	-6160	0.01	0.13	12	1	-11
0013	3T	2_B1	146	83	3	8300	8780	480	0.04	1.06	14	15	1
0013	3T	2_B1	152	67	1	6700	1650	-5050	0.01	0.25	11	2	-9
0013	3T	2_B1	153	47	1	4700	2820	-1880	0.02	0.60	8	4	-4
0013	3T	2_B1	154	47	2	4700	3710	-990	0.04	0.79	8	6	-2
0013	3T	2_B1	156	48	0	4800	0	-4800	0.00	0.00	8	0	-8
0013	3T	2_B1	162	55	2	5500	3650	-1850	0.04	0.66	9	6	-3
0013	3T	2_B1	163	37	0	3700	0	-3700	0.00	0.00	6	0	-6
0013	3T	2_B1	164	29	2	2900	41150	38250	0.07	14.19	5	72	67
0013	3T	2_B1	165	14	0	1400	0	-1400	0.00	0.00	2	0	-2
0013	3T	2_B1	213	74	3	7400	3470	-3930	0.04	0.47	13	6	-7
0013	3T	2_B1	214	66	2	6600	7930	1330	0.03	1.20	11	14	3
0013	3T	2_B1	215	62	5	6200	18600	12400	0.08	3.00	10	32	22
0013	3T	2_B1	216	71	4	7100	9980	2880	0.06	1.41	12	17	5
0013	3T	2_B1	231	33	0	3300	0	-3300	0.00	0.00	5	0	-5
0013	3T	2_B1	234	47	1	4700	2000	-2700	0.02	0.43	8	3	-5
0013	3T	2_B1	235	30	0	3000	0	-3000	0.00	0.00	5	0	-5
0013	3T	2_B1	236	55	2	5500	2840	-2660	0.04	0.52	9	5	-4
0013	3T	2_B1	241	20	0	2000	0	-2000	0.00	0.00	3	0	-3
0013	3T	2_B1	243	34	0	3400	0	-3400	0.00	0.00	6	0	-6
0013	3T	2_B1	245	24	0	2400	0	-2400	0.00	0.00	4	0	-4
0013	3T	2_B1	246	25	1	2500	6140	3640	0.04	2.46	4	10	6
0013	3T	2_B1	251	23	1	2300	2380	80	0.04	1.03	4	4	0
0013	3T	2_B1	253	18	0	1800	0	-1800	0.00	0.00	3	0	-3
0013	3T	2_B1	254	8	0	800	0	-800	0.00	0.00	1	0	-1
0013	3T	2_B1	256	14	1	1400	990	-410	0.07	0.71	2	1	-1
0013	3T	2_B1	261	15	0	1500	0	-1500	0.00	0.00	2	0	-2
0013	3T	2_B1	263	14	0	1400	0	-1400	0.00	0.00	2	0	-2
0013	3T	2_B1	264	18	1	1800	7970	6170	0.06	4.43	3	14	11
0013	3T	2_B1	265	11	0	1100	0	-1100	0.00	0.00	1	0	-1
0013	3T	2_B2	123	15	1	1500	590	-910	0.07	0.39	2	1	-1
0013	3T	2_B2	124	12	0	1200	0	-1200	0.00	0.00	2	0	-2
0013	3T	2_B2	125	8	0	800	0	-800	0.00	0.00	1	0	-1
0013	3T	2_B2	126	6	0	600	0	-600	0.00	0.00	1	0	-1
0013	3T	2_B2	132	10	1	1000	2770	1770	0.10	2.77	1	4	3
0013	3T	2_B2	134	5	1	500	670	170	0.20	1.34	0	1	1
0013	3T	2_B2	135	7	0	700	0	-700	0.00	0.00	1	0	-1
0013	3T	2_B2	136	4	0	400	0	-400	0.00	0.00	0	0	0
0013	3T	2_B2	142	2	0	200	0	-200	0.00	0.00	0	0	0
0013	3T	2_B2	143	4	1	400	4290	3890	0.25	10.73	0	7	7
0013	3T	2_B2	145	2	0	200	0	-200	0.00	0.00	0	0	0
0013	3T	2_B2	146	5	0	500	0	-500	0.00	0.00	0	0	0
0013	3T	2_B2	152	1	0	100	0	-100	0.00	0.00	0	0	0
0013	3T	2_B2	153	1	0	100	0	-100	0.00	0.00	0	0	0
0013	3T	2_B2	154	2	1	200	3930	3730	0.50	19.65	0	6	6
0013	3T	2_B2	163	2	0	200	0	-200	0.00	0.00	0	0	0
0013	3T	2_B2	213	2	0	200	0	-200	0.00	0.00	0	0	0
0013	3T	2_B2	214	3	1	300	4240	3940	0.33	14.13	0	7	7
0013	3T	2_B2	215	2	0	200	0	-200	0.00	0.00	0	0	0
0013	3T	2_B2	216	7	0	700	0	-700	0.00	0.00	1	0	-1
0013	3T	2_B2	231	2	0	200	0	-200	0.00	0.00	0	0	0
0013	3T	2_B2	234	4	0	400	0	-400	0.00	0.00	0	0	0
0013	3T	2_B2	235	5	0	500	0	-500	0.00	0.00	0	0	0
0013	3T	2_B2	236	1	0	100	0	-100	0.00	0.00	0	0	0
0013	3T	2_B2	241	2	0	200	0	-200	0.00	0.00	0	0	0
0013	3T	2_B2	243	4	0	400	0	-400	0.00	0.00	0	0	0
0013	3T	2_B2	245	2	0	200	0	-200	0.00	0.00	0	0	0
0013	3T	2_B2	246	1	0	100	0	-100	0.00	0.00	0	0	0
0013	3T	2_B2	251	1	0	100	0	-100	0.00	0.00	0	0	0
0013	3T	2_B2	253	6	0	600	0	-600	0.00	0.00	1	0	-1
0013	3T	2_B2	254	1	0	100	0	-100	0.00	0.00	0	0	0
0013	3T	2_B2	256	1	0	100	0	-100	0.00	0.00	0	0	0
0013	3T	2_B2	261	2	0	200	0	-200	0.00	0.00	0	0	0
0013	3T	2_B2	263	1	0	100	0	-100	0.00	0.00	0	0	0
0013	3T	2_B2	264	1	0	100	0	-100	0.00	0.00	0	0	0
0013	3T	3_	123	8	0	800	0	-800	0.00	0.00	1	0	-1
0013	3T	3_	124	8	2	800	1130	330	0.25	1.41	1	2	1
0013	3T	3_	125	6	0	600	0	-600	0.00	0.00	1	0	-1
0013	3T	3_	134	4	0	400	0	-400	0.00	0.00	0	0	0
0013	3T	3_	135	1	0	100	0	-100	0.00	0.00	0	0	0
0013	3T	3_	136	1	0	100	0	-100	0.00	0.00	0	0	0
0013	3T	3_	142	3	1	300	2880	2580	0.33	9.60	0	5	5
0013	3T	3_	143	1	0	100	0	-100	0.00	0.00	0	0	0
0013	3T	3_	145	2	1	200	1100	900	0.50	5.50	0	1	1
0013	3T	3_	156	1	0	100	0	-100	0.00	0.00	0	0	0
0013	3T	3_	163	1	0	100	0	-100	0.00	0.00	0	0	0
0013	3T	3_	216	1	0	100	0	-100	0.00	0.00	0	0	0
0013	3T	3_	235	1	0	100	0	-100	0.00	0.00	0	0	0
0013	3T	3_	254	1	0	100	0	-100	0.00	0.00	0	0	0
0013	3T	3_A1	123	551	61	55100	49300	-5800	0.11	0.89	97	87	-10
0013	3T	3_A1	124	434	41	43400	34740	-8660	0.09	0.80	76	61	-15
0013	3T	3_A1	125	323	20	32300	24770	-7530	0.06	0.77	57	43	-14
0013	3T	3_A1	126	208	9	20800	8800	-12000	0.04	0.42	36	15	-21
0013	3T	3_A1	132	200	15	20000	14690	-5310	0.08	0.73	35	26	-9
0013	3T	3_A1	134	200	16	20000	13880	-6120	0.08	0.69	35	24	-11
0013	3T	3_A1	135	153	8	15300	10510	-4790	0.05	0.69	27	18	-9
0013	3T	3_A1	136	102	6	10200	10190	-10	0.06	1.00	18	18	0
0013	3T	3_A1	142	135	7	13500	6220	-7280	0.05	0.46	23	11	-12
0013	3T	3_A1	143	136	11	13600	19820	6220	0.08	1.46	24	35	11
0013	3T	3_A1	145	65	3	6500	3590	-2910	0.05	0.55	11	6	-5
0013	3T	3_A1	146	49	5	4900	9850	4950	0.10	2.01	8	17	9
0013	3T	3_A1	152	30	0	3000	0	-3000	0.00	0.00	5	0	-5
0013	3T	3_A1	153	40	2	4000	4710	710	0.05	1.18	7	8	1
0013	3T	3_A1	154	26	2	2600	5710	3110	0.08	2.20	4	10	6
0013	3T	3_A1	156	26	2	2600	3690	1090	0.08	1.42	4	6	2
0013	3T	3_A1	162	11	0	1100	0	-1100	0.00	0.00	1	0	-1
0013	3T	3_A1	163	25	1	2500	1020	-1480	0.04	0.41	4	1	-3
0013	3T	3_A1	164	10	0	1000	0	-1000	0.00	0.00	1	0	-1
0013	3T	3_A1	165	11	0	1100	0	-1100	0.00	0.00	1	0	-1
0013	3T	3_A1	213	6	1	600	700	100	0.17	1.17	1	1	0
0013	3T	3_A1	214	7	0	700	0	-700	0.00	0.00	1	0	-1
0013	3T	3_A1	215	4	0	400	0	-400	0.00	0.00	0	0	0
0013	3T	3_A1	216	2	0	200	0	-200	0.00	0.00	0	0	0
0013	3T	3_A1	235	2	0	200	0	-200	0.00	0.00	0	0	0
0013	3T	3_A1	236	1	0	100	0	-100	0.00	0.00	0	0	0
0013	3T	3_A1	241	1	0	100	0	-100	0.00	0.00	0	0	0
0013	3T	3_A1	243	2	0	200	0	-200	0.00	0.00	0	0	0
0013	3T	3_A1	245	2	0	200	0	-200	0.00	0.00	0	0	0
0013	3T	3_A1	246	1	0	100	0	-100	0.00	0.00	0	0	0
0013	3T	3_A1	253	2	0	200	0	-200	0.00	0.00	0	0	0
0013	3T	3_A1	254	2	0	200	0	-200	0.00	0.00	0	0	0
0013	3T	3_A2	123	433	39	43300	48610	5310	0.09	1.12	76	86	10
0013	3T	3_A2	124	335	22	33500	21720	-11780	0.07	0.65	59	38	-21
0013	3T	3_A2	125	215	15	21500	19510	-1990	0.07	0.91	38	34	-4
0013	3T	3_A2	126	169	14	16900	20140	3240	0.08	1.19	29	35	6
0013	3T	3_A2	132	214	17	21400	21510	110	0.08	1.01	37	38	1
0013	3T	3_A2	134	205	11	20500	12680	-7820	0.05	0.62	36	22	-14
0013	3T	3_A2	135	158	10	15800	17170	1370	0.06	1.09	27	30	3
0013	3T	3_A2	136	106	3	10600	3480	-7120	0.03	0.33	18	6	-12
0013	3T	3_A2	142	136	9	13600	17480	3880	0.07	1.29	24	30	6
0013	3T	3_A2	143	130	6	13000	12130	-870	0.05	0.93	23	21	-2
0013	3T	3_A2	145	95	4	9500	8260	-1240	0.04	0.87	16	14	-2
0013	3T	3_A2	146	68	2	6800	1780	-5020	0.03	0.26	12	3	-9
0013	3T	3_A2	152	36	0	3600	0	-3600	0.00	0.00	6	0	-6
0013	3T	3_A2	153	55	2	5500	2180	-3320	0.04	0.40	9	3	-6
0013	3T	3_A2	154	32	0	3200	0	-3200	0.00	0.00	5	0	-5
0013	3T	3_A2	156	33	2	3300	5860	2560	0.06	1.78	5	10	5
0013	3T	3_A2	162	18	0	1800	0	-1800	0.00	0.00	3	0	-3
0013	3T	3_A2	163	38	0	3800	0	-3800	0.00	0.00	6	0	-6
0013	3T	3_A2	164	21	0	2100	0	-2100	0.00	0.00	3	0	-3
0013	3T	3_A2	165	20	0	2000	0	-2000	0.00	0.00	3	0	-3
0013	3T	3_A2	213	22	1	2200	1510	-690	0.05	0.69	3	2	-1
0013	3T	3_A2	214	23	0	2300	0	-2300	0.00	0.00	4	0	-4
0013	3T	3_A2	215	12	0	1200	0	-1200	0.00	0.00	2	0	-2
0013	3T	3_A2	216	8	0	800	0	-800	0.00	0.00	1	0	-1
0013	3T	3_A2	231	2	0	200	0	-200	0.00	0.00	0	0	0
0013	3T	3_A2	234	4	0	400	0	-400	0.00	0.00	0	0	0
0013	3T	3_A2	235	4	0	400	0	-400	0.00	0.00	0	0	0
0013	3T	3_A2	236	2	0	200	0	-200	0.00	0.00	0	0	0
0013	3T	3_A2	241	1	0	100	0	-100	0.00	0.00	0	0	0
0013	3T	3_A2	243	4	0	400	0	-400	0.00	0.00	0	0	0
0013	3T	3_A2	245	3	0	300	0	-300	0.00	0.00	0	0	0
0013	3T	3_A2	246	3	1	300	1950	1650	0.33	6.50	0	3	3
0013	3T	3_A2	251	1	0	100	0	-100	0.00	0.00	0	0	0
0013	3T	3_A2	253	2	0	200	0	-200	0.00	0.00	0	0	0
0013	3T	3_A2	254	2	0	200	0	-200	0.00	0.00	0	0	0
0013	3T	3_A2	256	2	0	200	0	-200	0.00	0.00	0	0	0
0013	3T	3_A2	261	6	0	600	0	-600	0.00	0.00	1	0	-1
0013	3T	3_A2	264	2	0	200	0	-200	0.00	0.00	0	0	0
0013	3T	3_A2	265	1	0	100	0	-100	0.00	0.00	0	0	0
0013	3T	3_B1	123	280	28	28000	34630	6630	0.10	1.24	49	61	12
0013	3T	3_B1	124	282	15	28200	19130	-9070	0.05	0.68	49	33	-16
0013	3T	3_B1	125	211	8	21100	12350	-8750	0.04	0.59	37	21	-16
0013	3T	3_B1	126	163	4	16300	10740	-5560	0.02	0.66	28	19	-9
0013	3T	3_B1	132	152	14	15200	24190	8990	0.09	1.59	26	42	16
0013	3T	3_B1	134	186	10	18600	18230	-370	0.05	0.98	32	32	0
0013	3T	3_B1	135	144	3	14400	3430	-10970	0.02	0.24	25	6	-19
0013	3T	3_B1	136	136	6	13600	9390	-4210	0.04	0.69	24	16	-8
0013	3T	3_B1	142	118	5	11800	7310	-4490	0.04	0.62	20	12	-8
0013	3T	3_B1	143	94	5	9400	9870	470	0.05	1.05	16	17	1
0013	3T	3_B1	145	72	4	7200	7410	210	0.06	1.03	12	13	1
0013	3T	3_B1	146	62	0	6200	0	-6200	0.00	0.00	10	0	-10
0013	3T	3_B1	152	78	0	7800	0	-7800	0.00	0.00	13	0	-13
0013	3T	3_B1	153	53	0	5300	0	-5300	0.00	0.00	9	0	-9
0013	3T	3_B1	154	39	0	3900	0	-3900	0.00	0.00	6	0	-6
0013	3T	3_B1	156	52	3	5200	23570	18370	0.06	4.53	9	41	32
0013	3T	3_B1	162	35	1	3500	1280	-2220	0.03	0.37	6	2	-4
0013	3T	3_B1	163	51	2	5100	4070	-1030	0.04	0.80	9	7	-2
0013	3T	3_B1	164	26	0	2600	0	-2600	0.00	0.00	4	0	-4
0013	3T	3_B1	165	30	1	3000	2070	-930	0.03	0.69	5	3	-2
0013	3T	3_B1	213	80	9	8000	16600	8600	0.11	2.08	14	29	15
0013	3T	3_B1	214	69	3	6900	6670	-230	0.04	0.97	12	11	-1
0013	3T	3_B1	215	62	3	6200	3910	-2290	0.05	0.63	10	6	-4
0013	3T	3_B1	216	53	5	5300	8890	3590	0.09	1.68	9	15	6
0013	3T	3_B1	231	16	1	1600	3460	1860	0.06	2.16	2	6	4
0013	3T	3_B1	234	46	5	4600	8640	4040	0.11	1.88	8	15	7
0013	3T	3_B1	235	38	2	3800	3770	-30	0.05	0.99	6	6	0
0013	3T	3_B1	236	42	1	4200	3730	-470	0.02	0.89	7	6	-1
0013	3T	3_B1	241	9	1	900	3630	2730	0.11	4.03	1	6	5
0013	3T	3_B1	243	18	0	1800	0	-1800	0.00	0.00	3	0	-3
0013	3T	3_B1	245	16	2	1600	4570	2970	0.13	2.86	2	8	6
0013	3T	3_B1	246	16	0	1600	0	-1600	0.00	0.00	2	0	-2
0013	3T	3_B1	251	19	0	1900	0	-1900	0.00	0.00	3	0	-3
0013	3T	3_B1	253	17	0	1700	0	-1700	0.00	0.00	3	0	-3
0013	3T	3_B1	254	23	1	2300	3200	900	0.04	1.39	4	5	1
0013	3T	3_B1	256	20	1	2000	1170	-830	0.05	0.59	3	2	-1
0013	3T	3_B1	261	15	0	1500	0	-1500	0.00	0.00	2	0	-2
0013	3T	3_B1	263	17	0	1700	0	-1700	0.00	0.00	3	0	-3
0013	3T	3_B1	264	17	0	1700	0	-1700	0.00	0.00	3	0	-3
0013	3T	3_B1	265	6	0	600	0	-600	0.00	0.00	1	0	-1
0013	3T	3_B2	123	7	2	700	3090	2390	0.29	4.41	1	5	4
0013	3T	3_B2	124	11	2	1100	4990	3890	0.18	4.54	1	8	7
0013	3T	3_B2	125	5	1	500	910	410	0.20	1.82	0	1	1
0013	3T	3_B2	126	9	0	900	0	-900	0.00	0.00	1	0	-1
0013	3T	3_B2	132	7	0	700	0	-700	0.00	0.00	1	0	-1
0013	3T	3_B2	134	8	0	800	0	-800	0.00	0.00	1	0	-1
0013	3T	3_B2	135	5	0	500	0	-500	0.00	0.00	0	0	0
0013	3T	3_B2	136	4	0	400	0	-400	0.00	0.00	0	0	0
0013	3T	3_B2	142	4	0	400	0	-400	0.00	0.00	0	0	0
0013	3T	3_B2	143	1	0	100	0	-100	0.00	0.00	0	0	0
0013	3T	3_B2	146	2	0	200	0	-200	0.00	0.00	0	0	0
0013	3T	3_B2	153	1	0	100	0	-100	0.00	0.00	0	0	0
0013	3T	3_B2	154	4	0	400	0	-400	0.00	0.00	0	0	0
0013	3T	3_B2	156	1	0	100	0	-100	0.00	0.00	0	0	0
0013	3T	3_B2	162	1	0	100	0	-100	0.00	0.00	0	0	0
0013	3T	3_B2	163	1	0	100	0	-100	0.00	0.00	0	0	0
0013	3T	3_B2	165	1	0	100	0	-100	0.00	0.00	0	0	0
0013	3T	3_B2	213	5	0	500	0	-500	0.00	0.00	0	0	0
0013	3T	3_B2	214	4	0	400	0	-400	0.00	0.00	0	0	0
0013	3T	3_B2	215	6	0	600	0	-600	0.00	0.00	1	0	-1
0013	3T	3_B2	216	5	0	500	0	-500	0.00	0.00	0	0	0
0013	3T	3_B2	231	1	0	100	0	-100	0.00	0.00	0	0	0
0013	3T	3_B2	234	8	0	800	0	-800	0.00	0.00	1	0	-1
0013	3T	3_B2	235	7	1	700	1610	910	0.14	2.30	1	2	1
0013	3T	3_B2	236	5	0	500	0	-500	0.00	0.00	0	0	0
0013	3T	3_B2	243	4	0	400	0	-400	0.00	0.00	0	0	0
0013	3T	3_B2	245	1	0	100	0	-100	0.00	0.00	0	0	0
0013	3T	3_B2	246	1	0	100	0	-100	0.00	0.00	0	0	0
0013	3T	3_B2	251	1	0	100	0	-100	0.00	0.00	0	0	0
0013	3T	3_B2	253	4	0	400	0	-400	0.00	0.00	0	0	0
0013	3T	3_B2	256	1	0	100	0	-100	0.00	0.00	0	0	0
0013	3T	3_B2	261	1	0	100	0	-100	0.00	0.00	0	0	0
0013	3T	3_B2	263	1	0	100	0	-100	0.00	0.00	0	0	0
0013	3T	3_B2	265	2	0	200	0	-200	0.00	0.00	0	0	0
0013	3T	4_	123	2	0	200	0	-200	0.00	0.00	0	0	0
0013	3T	4_	124	1	0	100	0	-100	0.00	0.00	0	0	0
0013	3T	4_	125	2	0	200	0	-200	0.00	0.00	0	0	0
0013	3T	4_	126	1	0	100	0	-100	0.00	0.00	0	0	0
0013	3T	4_	132	1	0	100	0	-100	0.00	0.00	0	0	0
0013	3T	4_	134	2	0	200	0	-200	0.00	0.00	0	0	0
0013	3T	4_	145	1	0	100	0	-100	0.00	0.00	0	0	0
0013	3T	4_	146	1	0	100	0	-100	0.00	0.00	0	0	0
0013	3T	4_	154	1	0	100	0	-100	0.00	0.00	0	0	0
0013	3T	4_	215	1	0	100	0	-100	0.00	0.00	0	0	0
0013	3T	4_	234	1	0	100	0	-100	0.00	0.00	0	0	0
0013	3T	4_A1	123	652	83	65200	57700	-7500	0.13	0.88	115	102	-13
0013	3T	4_A1	124	511	48	51100	40190	-10910	0.09	0.79	90	71	-19
0013	3T	4_A1	125	285	22	28500	20350	-8150	0.08	0.71	50	36	-14
0013	3T	4_A1	126	204	9	20400	17360	-3040	0.04	0.85	36	30	-6
0013	3T	4_A1	132	250	25	25000	23730	-1270	0.10	0.95	44	42	-2
0013	3T	4_A1	134	245	34	24500	31910	7410	0.14	1.30	43	56	13
0013	3T	4_A1	135	156	9	15600	9330	-6270	0.06	0.60	27	16	-11
0013	3T	4_A1	136	95	7	9500	8370	-1130	0.07	0.88	16	14	-2
0013	3T	4_A1	142	141	13	14100	15310	1210	0.09	1.09	24	27	3
0013	3T	4_A1	143	161	8	16100	12000	-4100	0.05	0.75	28	21	-7
0013	3T	4_A1	145	85	1	8500	790	-7710	0.01	0.09	15	1	-14
0013	3T	4_A1	146	56	2	5600	4800	-800	0.04	0.86	9	8	-1
0013	3T	4_A1	152	39	0	3900	0	-3900	0.00	0.00	6	0	-6
0013	3T	4_A1	153	41	3	4100	4490	390	0.07	1.10	7	7	0
0013	3T	4_A1	154	32	1	3200	610	-2590	0.03	0.19	5	1	-4
0013	3T	4_A1	156	25	0	2500	0	-2500	0.00	0.00	4	0	-4
0013	3T	4_A1	162	23	1	2300	4120	1820	0.04	1.79	4	7	3
0013	3T	4_A1	163	20	1	2000	690	-1310	0.05	0.35	3	1	-2
0013	3T	4_A1	164	18	1	1800	2480	680	0.06	1.38	3	4	1
0013	3T	4_A1	165	5	0	500	0	-500	0.00	0.00	0	0	0
0013	3T	4_A1	213	2	0	200	0	-200	0.00	0.00	0	0	0
0013	3T	4_A1	214	2	0	200	0	-200	0.00	0.00	0	0	0
0013	3T	4_A1	215	2	0	200	0	-200	0.00	0.00	0	0	0
0013	3T	4_A1	216	1	0	100	0	-100	0.00	0.00	0	0	0
0013	3T	4_A1	235	2	0	200	0	-200	0.00	0.00	0	0	0
0013	3T	4_A1	236	1	0	100	0	-100	0.00	0.00	0	0	0
0013	3T	4_A1	243	1	0	100	0	-100	0.00	0.00	0	0	0
0013	3T	4_A1	256	1	0	100	0	-100	0.00	0.00	0	0	0
0013	3T	4_A2	123	240	26	24000	21120	-2880	0.11	0.88	42	37	-5
0013	3T	4_A2	124	210	13	21000	12720	-8280	0.06	0.61	37	22	-15
0013	3T	4_A2	125	159	14	15900	21300	5400	0.09	1.34	28	37	9
0013	3T	4_A2	126	80	1	8000	1500	-6500	0.01	0.19	14	2	-12
0013	3T	4_A2	132	137	16	13700	28570	14870	0.12	2.09	24	50	26
0013	3T	4_A2	134	132	9	13200	7480	-5720	0.07	0.57	23	13	-10
0013	3T	4_A2	135	84	3	8400	4090	-4310	0.04	0.49	14	7	-7
0013	3T	4_A2	136	61	5	6100	6820	720	0.08	1.12	10	12	2
0013	3T	4_A2	142	92	10	9200	8590	-610	0.11	0.93	16	15	-1
0013	3T	4_A2	143	76	5	7600	5540	-2060	0.07	0.73	13	9	-4
0013	3T	4_A2	145	58	4	5800	3450	-2350	0.07	0.59	10	6	-4
0013	3T	4_A2	146	38	2	3800	7690	3890	0.05	2.02	6	13	7
0013	3T	4_A2	152	33	0	3300	0	-3300	0.00	0.00	5	0	-5
0013	3T	4_A2	153	36	1	3600	1050	-2550	0.03	0.29	6	1	-5
0013	3T	4_A2	154	26	0	2600	0	-2600	0.00	0.00	4	0	-4
0013	3T	4_A2	156	14	0	1400	0	-1400	0.00	0.00	2	0	-2
0013	3T	4_A2	162	21	1	2100	1950	-150	0.05	0.93	3	3	0
0013	3T	4_A2	163	20	2	2000	2280	280	0.10	1.14	3	4	1
0013	3T	4_A2	164	12	0	1200	0	-1200	0.00	0.00	2	0	-2
0013	3T	4_A2	165	4	0	400	0	-400	0.00	0.00	0	0	0
0013	3T	4_A2	213	13	0	1300	0	-1300	0.00	0.00	2	0	-2
0013	3T	4_A2	214	16	1	1600	2760	1160	0.06	1.73	2	4	2
0013	3T	4_A2	215	8	1	800	550	-250	0.13	0.69	1	0	-1
0013	3T	4_A2	216	2	0	200	0	-200	0.00	0.00	0	0	0
0013	3T	4_A2	231	2	0	200	0	-200	0.00	0.00	0	0	0
0013	3T	4_A2	234	4	0	400	0	-400	0.00	0.00	0	0	0
0013	3T	4_A2	235	2	0	200	0	-200	0.00	0.00	0	0	0
0013	3T	4_A2	236	1	0	100	0	-100	0.00	0.00	0	0	0
0013	3T	4_A2	241	1	0	100	0	-100	0.00	0.00	0	0	0
0013	3T	4_A2	243	3	0	300	0	-300	0.00	0.00	0	0	0
0013	3T	4_A2	245	2	0	200	0	-200	0.00	0.00	0	0	0
0013	3T	4_A2	246	1	0	100	0	-100	0.00	0.00	0	0	0
0013	3T	4_A2	253	1	0	100	0	-100	0.00	0.00	0	0	0
0013	3T	4_A2	254	1	0	100	0	-100	0.00	0.00	0	0	0
0013	3T	4_A2	261	2	0	200	0	-200	0.00	0.00	0	0	0
0013	3T	4_A2	263	2	0	200	0	-200	0.00	0.00	0	0	0
0013	3T	4_A2	265	1	0	100	0	-100	0.00	0.00	0	0	0
0013	3T	4_B1	123	285	11	28500	16440	-12060	0.04	0.58	50	29	-21
0013	3T	4_B1	124	266	7	26600	26670	70	0.03	1.00	47	47	0
0013	3T	4_B1	125	181	2	18100	4080	-14020	0.01	0.23	32	7	-25
0013	3T	4_B1	126	117	3	11700	14120	2420	0.03	1.21	20	24	4
0013	3T	4_B1	132	155	9	15500	29080	13580	0.06	1.88	27	51	24
0013	3T	4_B1	134	178	6	17800	16310	-1490	0.03	0.92	31	28	-3
0013	3T	4_B1	135	141	3	14100	4480	-9620	0.02	0.32	24	7	-17
0013	3T	4_B1	136	90	1	9000	1380	-7620	0.01	0.15	15	2	-13
0013	3T	4_B1	142	112	3	11200	2900	-8300	0.03	0.26	19	5	-14
0013	3T	4_B1	143	131	3	13100	7110	-5990	0.02	0.54	23	12	-11
0013	3T	4_B1	145	70	2	7000	14230	7230	0.03	2.03	12	25	13
0013	3T	4_B1	146	57	2	5700	5480	-220	0.04	0.96	10	9	-1
0013	3T	4_B1	152	42	0	4200	0	-4200	0.00	0.00	7	0	-7
0013	3T	4_B1	153	41	1	4100	5210	1110	0.02	1.27	7	9	2
0013	3T	4_B1	154	25	2	2500	35010	32510	0.08	14.00	4	61	57
0013	3T	4_B1	156	24	1	2400	4920	2520	0.04	2.05	4	8	4
0013	3T	4_B1	162	10	0	1000	0	-1000	0.00	0.00	1	0	-1
0013	3T	4_B1	163	18	1	1800	8500	6700	0.06	4.72	3	15	12
0013	3T	4_B1	164	15	0	1500	0	-1500	0.00	0.00	2	0	-2
0013	3T	4_B1	165	10	0	1000	0	-1000	0.00	0.00	1	0	-1
0013	3T	4_B1	213	54	2	5400	2680	-2720	0.04	0.50	9	4	-5
0013	3T	4_B1	214	43	2	4300	1930	-2370	0.05	0.45	7	3	-4
0013	3T	4_B1	215	39	2	3900	2220	-1680	0.05	0.57	6	3	-3
0013	3T	4_B1	216	40	1	4000	1660	-2340	0.03	0.42	7	2	-5
0013	3T	4_B1	231	20	1	2000	1520	-480	0.05	0.76	3	2	-1
0013	3T	4_B1	234	53	1	5300	5850	550	0.02	1.10	9	10	1
0013	3T	4_B1	235	44	1	4400	640	-3760	0.02	0.15	7	1	-6
0013	3T	4_B1	236	18	0	1800	0	-1800	0.00	0.00	3	0	-3
0013	3T	4_B1	241	11	0	1100	0	-1100	0.00	0.00	1	0	-1
0013	3T	4_B1	243	29	0	2900	0	-2900	0.00	0.00	5	0	-5
0013	3T	4_B1	245	22	0	2200	0	-2200	0.00	0.00	3	0	-3
0013	3T	4_B1	246	14	0	1400	0	-1400	0.00	0.00	2	0	-2
0013	3T	4_B1	251	8	1	800	5600	4800	0.13	7.00	1	9	8
0013	3T	4_B1	253	20	0	2000	0	-2000	0.00	0.00	3	0	-3
0013	3T	4_B1	254	17	0	1700	0	-1700	0.00	0.00	3	0	-3
0013	3T	4_B1	256	5	0	500	0	-500	0.00	0.00	0	0	0
0013	3T	4_B1	261	4	0	400	0	-400	0.00	0.00	0	0	0
0013	3T	4_B1	263	5	0	500	0	-500	0.00	0.00	0	0	0
0013	3T	4_B1	264	10	0	1000	0	-1000	0.00	0.00	1	0	-1
0013	3T	4_B1	265	1	0	100	0	-100	0.00	0.00	0	0	0
0013	3T	4_B2	123	5	2	500	3770	3270	0.40	7.54	0	6	6
0013	3T	4_B2	124	10	0	1000	0	-1000	0.00	0.00	1	0	-1
0013	3T	4_B2	125	8	1	800	1090	290	0.13	1.36	1	1	0
0013	3T	4_B2	126	6	0	600	0	-600	0.00	0.00	1	0	-1
0013	3T	4_B2	132	3	0	300	0	-300	0.00	0.00	0	0	0
0013	3T	4_B2	134	7	0	700	0	-700	0.00	0.00	1	0	-1
0013	3T	4_B2	135	2	0	200	0	-200	0.00	0.00	0	0	0
0013	3T	4_B2	142	1	0	100	0	-100	0.00	0.00	0	0	0
0013	3T	4_B2	143	5	0	500	0	-500	0.00	0.00	0	0	0
0013	3T	4_B2	145	2	0	200	0	-200	0.00	0.00	0	0	0
0013	3T	4_B2	146	1	0	100	0	-100	0.00	0.00	0	0	0
0013	3T	4_B2	152	1	0	100	0	-100	0.00	0.00	0	0	0
0013	3T	4_B2	153	3	0	300	0	-300	0.00	0.00	0	0	0
0013	3T	4_B2	154	1	0	100	0	-100	0.00	0.00	0	0	0
0013	3T	4_B2	162	3	0	300	0	-300	0.00	0.00	0	0	0
0013	3T	4_B2	163	2	0	200	0	-200	0.00	0.00	0	0	0
0013	3T	4_B2	164	1	0	100	0	-100	0.00	0.00	0	0	0
0013	3T	4_B2	165	1	0	100	0	-100	0.00	0.00	0	0	0
0013	3T	4_B2	213	2	0	200	0	-200	0.00	0.00	0	0	0
0013	3T	4_B2	214	3	0	300	0	-300	0.00	0.00	0	0	0
0013	3T	4_B2	215	2	0	200	0	-200	0.00	0.00	0	0	0
0013	3T	4_B2	231	6	0	600	0	-600	0.00	0.00	1	0	-1
0013	3T	4_B2	234	24	2	2400	1690	-710	0.08	0.70	4	2	-2
0013	3T	4_B2	235	13	1	1300	4880	3580	0.08	3.75	2	8	6
0013	3T	4_B2	236	12	0	1200	0	-1200	0.00	0.00	2	0	-2
0013	3T	4_B2	241	1	0	100	0	-100	0.00	0.00	0	0	0
0013	3T	4_B2	243	7	0	700	0	-700	0.00	0.00	1	0	-1
0013	3T	4_B2	245	9	0	900	0	-900	0.00	0.00	1	0	-1
0013	3T	4_B2	246	5	0	500	0	-500	0.00	0.00	0	0	0
0013	3T	4_B2	253	9	0	900	0	-900	0.00	0.00	1	0	-1
0013	3T	4_B2	254	8	0	800	0	-800	0.00	0.00	1	0	-1
0013	3T	4_B2	256	3	1	300	2590	2290	0.33	8.63	0	4	4
0013	3T	4_B2	261	1	0	100	0	-100	0.00	0.00	0	0	0
0013	3T	4_B2	264	3	0	300	0	-300	0.00	0.00	0	0	0
0013	3T	4_B2	265	1	0	100	0	-100	0.00	0.00	0	0	0
0013	3T	5_	123	3	0	300	0	-300	0.00	0.00	0	0	0
0013	3T	5_	124	1	0	100	0	-100	0.00	0.00	0	0	0
0013	3T	5_	125	1	0	100	0	-100	0.00	0.00	0	0	0
0013	3T	5_	126	2	0	200	0	-200	0.00	0.00	0	0	0
0013	3T	5_	132	4	0	400	0	-400	0.00	0.00	0	0	0
0013	3T	5_	142	1	0	100	0	-100	0.00	0.00	0	0	0
0013	3T	5_	163	1	0	100	0	-100	0.00	0.00	0	0	0
0013	3T	5_	241	1	0	100	0	-100	0.00	0.00	0	0	0
0013	3T	5_	264	1	0	100	0	-100	0.00	0.00	0	0	0
0013	3T	5_A1	123	500	63	50000	40690	-9310	0.13	0.81	88	72	-16
0013	3T	5_A1	124	441	47	44100	35000	-9100	0.11	0.79	78	61	-17
0013	3T	5_A1	125	231	8	23100	7340	-15760	0.03	0.32	40	12	-28
0013	3T	5_A1	126	136	3	13600	5850	-7750	0.02	0.43	24	10	-14
0013	3T	5_A1	132	180	10	18000	7870	-10130	0.06	0.44	31	13	-18
0013	3T	5_A1	134	212	14	21200	14640	-6560	0.07	0.69	37	25	-12
0013	3T	5_A1	135	100	9	10000	12290	2290	0.09	1.23	17	21	4
0013	3T	5_A1	136	61	2	6100	1750	-4350	0.03	0.29	10	3	-7
0013	3T	5_A1	142	85	6	8500	9190	690	0.07	1.08	15	16	1
0013	3T	5_A1	143	124	10	12400	23270	10870	0.08	1.88	21	41	20
0013	3T	5_A1	145	88	3	8800	3980	-4820	0.03	0.45	15	7	-8
0013	3T	5_A1	146	47	2	4700	6390	1690	0.04	1.36	8	11	3
0013	3T	5_A1	152	22	0	2200	0	-2200	0.00	0.00	3	0	-3
0013	3T	5_A1	153	26	0	2600	0	-2600	0.00	0.00	4	0	-4
0013	3T	5_A1	154	21	1	2100	3490	1390	0.05	1.66	3	6	3
0013	3T	5_A1	156	10	1	1000	3500	2500	0.10	3.50	1	6	5
0013	3T	5_A1	162	7	0	700	0	-700	0.00	0.00	1	0	-1
0013	3T	5_A1	163	9	0	900	0	-900	0.00	0.00	1	0	-1
0013	3T	5_A1	164	6	0	600	0	-600	0.00	0.00	1	0	-1
0013	3T	5_A1	165	2	0	200	0	-200	0.00	0.00	0	0	0
0013	3T	5_A1	213	3	0	300	0	-300	0.00	0.00	0	0	0
0013	3T	5_A1	214	6	1	600	5760	5160	0.17	9.60	1	10	9
0013	3T	5_A1	215	3	0	300	0	-300	0.00	0.00	0	0	0
0013	3T	5_A1	216	3	0	300	0	-300	0.00	0.00	0	0	0
0013	3T	5_A1	231	3	0	300	0	-300	0.00	0.00	0	0	0
0013	3T	5_A1	234	3	0	300	0	-300	0.00	0.00	0	0	0
0013	3T	5_A1	235	1	0	100	0	-100	0.00	0.00	0	0	0
0013	3T	5_A1	241	2	0	200	0	-200	0.00	0.00	0	0	0
0013	3T	5_A1	243	2	0	200	0	-200	0.00	0.00	0	0	0
0013	3T	5_A1	245	2	0	200	0	-200	0.00	0.00	0	0	0
0013	3T	5_A1	261	1	0	100	0	-100	0.00	0.00	0	0	0
0013	3T	5_A1	264	1	0	100	0	-100	0.00	0.00	0	0	0
0013	3T	5_A1	265	1	0	100	0	-100	0.00	0.00	0	0	0
0013	3T	5_A2	123	282	24	28200	23190	-5010	0.09	0.82	49	41	-8
0013	3T	5_A2	124	239	17	23900	20950	-2950	0.07	0.88	42	37	-5
0013	3T	5_A2	125	134	7	13400	13240	-160	0.05	0.99	23	23	0
0013	3T	5_A2	126	86	6	8600	11690	3090	0.07	1.36	15	20	5
0013	3T	5_A2	132	163	6	16300	6090	-10210	0.04	0.37	28	10	-18
0013	3T	5_A2	134	195	12	19500	13240	-6260	0.06	0.68	34	23	-11
0013	3T	5_A2	135	87	2	8700	1610	-7090	0.02	0.19	15	2	-13
0013	3T	5_A2	136	51	2	5100	1780	-3320	0.04	0.35	9	3	-6
0013	3T	5_A2	142	94	1	9400	790	-8610	0.01	0.08	16	1	-15
0013	3T	5_A2	143	124	8	12400	16640	4240	0.06	1.34	21	29	8
0013	3T	5_A2	145	77	0	7700	0	-7700	0.00	0.00	13	0	-13
0013	3T	5_A2	146	44	1	4400	11790	7390	0.02	2.68	7	20	13
0013	3T	5_A2	152	37	0	3700	0	-3700	0.00	0.00	6	0	-6
0013	3T	5_A2	153	38	2	3800	1650	-2150	0.05	0.43	6	2	-4
0013	3T	5_A2	154	36	2	3600	19580	15980	0.06	5.44	6	34	28
0013	3T	5_A2	156	13	2	1300	1950	650	0.15	1.50	2	3	1
0013	3T	5_A2	162	10	0	1000	0	-1000	0.00	0.00	1	0	-1
0013	3T	5_A2	163	10	0	1000	0	-1000	0.00	0.00	1	0	-1
0013	3T	5_A2	164	10	0	1000	0	-1000	0.00	0.00	1	0	-1
0013	3T	5_A2	165	5	0	500	0	-500	0.00	0.00	0	0	0
0013	3T	5_A2	213	11	0	1100	0	-1100	0.00	0.00	1	0	-1
0013	3T	5_A2	214	17	0	1700	0	-1700	0.00	0.00	3	0	-3
0013	3T	5_A2	215	12	0	1200	0	-1200	0.00	0.00	2	0	-2
0013	3T	5_A2	216	11	1	1100	23800	22700	0.09	21.64	1	42	41
0013	3T	5_A2	231	5	0	500	0	-500	0.00	0.00	0	0	0
0013	3T	5_A2	234	12	0	1200	0	-1200	0.00	0.00	2	0	-2
0013	3T	5_A2	235	3	0	300	0	-300	0.00	0.00	0	0	0
0013	3T	5_A2	236	3	0	300	0	-300	0.00	0.00	0	0	0
0013	3T	5_A2	241	1	0	100	0	-100	0.00	0.00	0	0	0
0013	3T	5_A2	243	8	0	800	0	-800	0.00	0.00	1	0	-1
0013	3T	5_A2	245	4	0	400	0	-400	0.00	0.00	0	0	0
0013	3T	5_A2	246	1	0	100	0	-100	0.00	0.00	0	0	0
0013	3T	5_A2	251	2	0	200	0	-200	0.00	0.00	0	0	0
0013	3T	5_A2	253	4	0	400	0	-400	0.00	0.00	0	0	0
0013	3T	5_A2	254	4	0	400	0	-400	0.00	0.00	0	0	0
0013	3T	5_A2	256	1	0	100	0	-100	0.00	0.00	0	0	0
0013	3T	5_A2	263	1	0	100	0	-100	0.00	0.00	0	0	0
0013	3T	5_A2	265	1	0	100	0	-100	0.00	0.00	0	0	0
0013	3T	5_B1	123	142	14	14200	14870	670	0.10	1.05	25	26	1
0013	3T	5_B1	124	133	10	13300	24280	10980	0.08	1.83	23	42	19
0013	3T	5_B1	125	71	3	7100	5290	-1810	0.04	0.75	12	9	-3
0013	3T	5_B1	126	74	1	7400	1140	-6260	0.01	0.15	13	2	-11
0013	3T	5_B1	132	79	2	7900	2580	-5320	0.03	0.33	13	4	-9
0013	3T	5_B1	134	83	4	8300	10660	2360	0.05	1.28	14	18	4
0013	3T	5_B1	135	61	1	6100	6140	40	0.02	1.01	10	10	0
0013	3T	5_B1	136	44	3	4400	4400	0	0.07	1.00	7	7	0
0013	3T	5_B1	142	49	3	4900	5780	880	0.06	1.18	8	10	2
0013	3T	5_B1	143	53	3	5300	3100	-2200	0.06	0.58	9	5	-4
0013	3T	5_B1	145	40	1	4000	1380	-2620	0.03	0.35	7	2	-5
0013	3T	5_B1	146	33	1	3300	2680	-620	0.03	0.81	5	4	-1
0013	3T	5_B1	152	24	0	2400	0	-2400	0.00	0.00	4	0	-4
0013	3T	5_B1	153	25	2	2500	5260	2760	0.08	2.10	4	9	5
0013	3T	5_B1	154	23	0	2300	0	-2300	0.00	0.00	4	0	-4
0013	3T	5_B1	156	22	1	2200	2530	330	0.05	1.15	3	4	1
0013	3T	5_B1	162	13	2	1300	5750	4450	0.15	4.42	2	10	8
0013	3T	5_B1	163	13	0	1300	0	-1300	0.00	0.00	2	0	-2
0013	3T	5_B1	164	18	0	1800	0	-1800	0.00	0.00	3	0	-3
0013	3T	5_B1	165	3	0	300	0	-300	0.00	0.00	0	0	0
0013	3T	5_B1	213	16	0	1600	0	-1600	0.00	0.00	2	0	-2
0013	3T	5_B1	214	19	1	1900	1650	-250	0.05	0.87	3	2	-1
0025	3T	10	235	6	1	600	340	-260	0.17	0.57	1	0	-1
0025	3T	10	236	9	0	900	0	-900	0.00	0.00	1	0	-1
0025	3T	10	245	3	0	300	0	-300	0.00	0.00	0	0	0
0025	3T	10	246	7	0	700	0	-700	0.00	0.00	1	0	-1
0025	3T	10	253	1	0	100	0	-100	0.00	0.00	0	0	0
0025	3T	10	256	3	0	300	0	-300	0.00	0.00	0	0	0
0025	3T	11	123	346	43	34600	31210	-3390	0.12	0.90	61	55	-6
0025	3T	11	124	834	72	83400	87340	3940	0.09	1.05	147	154	7
0025	3T	11	126	460	22	46000	45510	-490	0.05	0.99	81	80	-1
0025	3T	11	134	217	20	21700	17190	-4510	0.09	0.79	38	30	-8
0025	3T	11	136	184	2	18400	2450	-15950	0.01	0.13	32	4	-28
0025	3T	11	143	31	2	3100	2960	-140	0.06	0.95	5	5	0
0025	3T	11	146	34	2	3400	2780	-620	0.06	0.82	6	4	-2
0025	3T	11	153	10	1	1000	4910	3910	0.10	4.91	1	8	7
0025	3T	11	154	8	0	800	0	-800	0.00	0.00	1	0	-1
0025	3T	11	156	14	0	1400	0	-1400	0.00	0.00	2	0	-2
0025	3T	11	163	2	0	200	0	-200	0.00	0.00	0	0	0
0025	3T	11	164	6	0	600	0	-600	0.00	0.00	1	0	-1
0025	3T	11	213	2	0	200	0	-200	0.00	0.00	0	0	0
0025	3T	11	216	6	0	600	0	-600	0.00	0.00	1	0	-1
0025	3T	11	234	55	3	5500	7850	2350	0.05	1.43	9	13	4
0025	3T	11	236	43	1	4300	1860	-2440	0.02	0.43	7	3	-4
0025	3T	11	246	6	0	600	0	-600	0.00	0.00	1	0	-1
0025	3T	11	253	4	0	400	0	-400	0.00	0.00	0	0	0
0025	3T	11	254	3	0	300	0	-300	0.00	0.00	0	0	0
0025	3T	11	256	4	0	400	0	-400	0.00	0.00	0	0	0
0025	3T	12	123	265	30	26500	23930	-2570	0.11	0.90	46	42	-4
0025	3T	12	124	928	80	92800	68020	-24780	0.09	0.73	164	120	-44
0025	3T	12	125	121	8	12100	10510	-1590	0.07	0.87	21	18	-3
0025	3T	12	126	321	24	32100	33650	1550	0.07	1.05	56	59	3
0025	3T	12	132	10	1	1000	1360	360	0.10	1.36	1	2	1
0025	3T	12	134	98	9	9800	6750	-3050	0.09	0.69	17	11	-6
0025	3T	12	135	117	8	11700	8340	-3360	0.07	0.71	20	14	-6
0025	3T	12	136	156	15	15600	15140	-460	0.10	0.97	27	26	-1
0025	3T	12	142	11	0	1100	0	-1100	0.00	0.00	1	0	-1
0025	3T	12	143	6	0	600	0	-600	0.00	0.00	1	0	-1
0025	3T	12	145	59	7	5900	7120	1220	0.12	1.21	10	12	2
0025	3T	12	146	43	2	4300	2150	-2150	0.05	0.50	7	3	-4
0025	3T	12	152	6	1	600	2010	1410	0.17	3.35	1	3	2
0025	3T	12	153	1	0	100	0	-100	0.00	0.00	0	0	0
0025	3T	12	154	6	0	600	0	-600	0.00	0.00	1	0	-1
0025	3T	12	156	28	4	2800	6460	3660	0.14	2.31	4	11	7
0025	3T	12	214	2	0	200	0	-200	0.00	0.00	0	0	0
0025	3T	12	234	7	1	700	760	60	0.14	1.09	1	1	0
0025	3T	12	235	1	0	100	0	-100	0.00	0.00	0	0	0
0025	3T	12	236	6	0	600	0	-600	0.00	0.00	1	0	-1
0025	3T	12	243	1	0	100	0	-100	0.00	0.00	0	0	0
0025	3T	12	245	1	0	100	0	-100	0.00	0.00	0	0	0
0025	3T	12	256	1	0	100	0	-100	0.00	0.00	0	0	0
0025	3T	13	123	168	18	16800	12780	-4020	0.11	0.76	29	22	-7
0025	3T	13	124	795	77	79500	71180	-8320	0.10	0.90	140	125	-15
0025	3T	13	125	198	13	19800	15320	-4480	0.07	0.77	35	27	-8
0025	3T	13	126	205	9	20500	12220	-8280	0.04	0.60	36	21	-15
0025	3T	13	132	14	2	1400	1280	-120	0.14	0.91	2	2	0
0025	3T	13	134	198	25	19800	17980	-1820	0.13	0.91	35	31	-4
0025	3T	13	135	118	5	11800	5550	-6250	0.04	0.47	20	9	-11
0007	1T	1_0	1	592	318	59200	55260	-3940	0.54	0.93	104	97	-7
0007	1T	1_0	2	66	13	6600	6390	-210	0.20	0.97	11	11	0
0007	1T	1_1	1	1461	905	146100	130070	-16030	0.62	0.89	258	230	-28
0007	1T	1_1	2	91	18	9100	6830	-2270	0.20	0.75	16	12	-4
0007	1T	1_2	1	1870	958	187000	168270	-18730	0.51	0.90	330	297	-33
0007	1T	1_2	2	346	93	34600	23880	-10720	0.27	0.69	61	42	-19
0007	1T	1_3	1	3256	1563	325600	310620	-14980	0.48	0.95	576	549	-27
0007	1T	1_3	2	703	234	70300	85870	15570	0.33	1.22	124	151	27
0007	1T	1_4	1	1959	1116	195900	171640	-24260	0.57	0.88	346	303	-43
0007	1T	1_4	2	246	72	24600	24960	360	0.29	1.01	43	44	1
0007	1T	1_5	1	381	243	38100	33240	-4860	0.64	0.87	67	58	-9
0007	1T	1_5	2	25	4	2500	1490	-1010	0.16	0.60	4	2	-2
0007	1T	1_6	1	1222	844	122200	113570	-8630	0.69	0.93	216	201	-15
0007	1T	1_6	2	30	5	3000	3720	720	0.17	1.24	5	6	1
0007	1T	2_0	1	466	237	46600	39470	-7130	0.51	0.85	82	69	-13
0007	1T	2_0	2	83	16	8300	6170	-2130	0.19	0.74	14	10	-4
0007	1T	2_1	1	1318	852	131800	122430	-9370	0.65	0.93	233	216	-17
0007	1T	2_1	2	107	36	10700	10410	-290	0.34	0.97	18	18	0
0007	1T	2_2	1	1888	966	188800	183360	-5440	0.51	0.97	334	324	-10
0007	1T	2_2	2	366	148	36600	40680	4080	0.40	1.11	64	72	8
0007	1T	2_3	1	3519	1679	351900	328610	-23290	0.48	0.93	622	581	-41
0007	1T	2_3	2	595	225	59500	59340	-160	0.38	1.00	105	105	0
0007	1T	2_4	1	2583	1407	258300	232100	-26200	0.54	0.90	457	410	-47
0007	1T	2_4	2	165	67	16500	15440	-1060	0.41	0.94	29	27	-2
0007	1T	2_5	1	694	450	69400	63190	-6210	0.65	0.91	122	111	-11
0007	1T	2_5	2	10	3	1000	910	-90	0.30	0.91	1	1	0
0007	1T	2_6	1	494	341	49400	44790	-4610	0.69	0.91	87	79	-8
0007	1T	2_6	2	3	0	300	0	-300	0.00	0.00	0	0	0
0007	1T	3_0	1	512	268	51200	49780	-1420	0.52	0.97	90	88	-2
0007	1T	3_0	2	59	14	5900	4830	-1070	0.24	0.82	10	8	-2
0007	1T	3_1	1	1337	850	133700	119190	-14510	0.64	0.89	236	210	-26
0007	1T	3_1	2	132	36	13200	15410	2210	0.27	1.17	23	27	4
0007	1T	3_2	1	1801	936	180100	171880	-8220	0.52	0.95	318	304	-14
0007	1T	3_2	2	378	122	37800	34520	-3280	0.32	0.91	66	61	-5
0007	1T	3_3	1	3093	1612	309300	316560	7260	0.52	1.02	547	560	13
0007	1T	3_3	2	805	270	80500	72330	-8170	0.34	0.90	142	128	-14
0025	3T	13	136	165	7	16500	6010	-10490	0.04	0.36	29	10	-19
0025	3T	13	142	14	3	1400	1780	380	0.21	1.27	2	3	1
0025	3T	13	143	4	0	400	0	-400	0.00	0.00	0	0	0
0025	3T	13	145	57	3	5700	4230	-1470	0.05	0.74	10	7	-3
0010	2F	2_1	16	53	12	5300	3800	-1500	0.23	0.72	9	6	-3
0010	2F	2_1	23	4	1	400	200	-200	0.25	0.50	0	0	0
0010	2F	2_1	24	2	0	200	0	-200	0.00	0.00	0	0	0
0010	2F	2_1	25	4	1	400	500	100	0.25	1.25	0	0	0
0010	2F	2_1	26	5	0	500	0	-500	0.00	0.00	0	0	0
0010	2F	2_2	12	948	326	94800	77850	-16950	0.34	0.82	167	137	-30
0010	2F	2_2	13	487	153	48700	35010	-13690	0.31	0.72	86	61	-25
0010	2F	2_2	14	387	135	38700	29330	-9370	0.35	0.76	68	51	-17
0010	2F	2_2	15	113	38	11300	11070	-230	0.34	0.98	20	19	-1
0010	2F	2_2	16	103	22	10300	14310	4010	0.21	1.39	18	25	7
0010	2F	2_2	23	18	5	1800	7280	5480	0.28	4.04	3	12	9
0010	2F	2_2	24	15	3	1500	1170	-330	0.20	0.78	2	2	0
0010	2F	2_2	25	11	0	1100	0	-1100	0.00	0.00	1	0	-1
0010	2F	2_2	26	18	3	1800	630	-1170	0.17	0.35	3	1	-2
0010	2F	2_3	12	1858	569	185800	157510	-28290	0.31	0.85	328	278	-50
0010	2F	2_3	13	1021	310	102100	82400	-19700	0.30	0.81	180	145	-35
0010	2F	2_3	14	463	139	46300	39160	-7140	0.30	0.85	81	69	-12
0010	2F	2_3	15	130	29	13000	10620	-2380	0.22	0.82	23	18	-5
0010	2F	2_3	16	134	34	13400	15690	2290	0.25	1.17	23	27	4
0010	2F	2_3	23	53	6	5300	2010	-3290	0.11	0.38	9	3	-6
0010	2F	2_3	24	27	4	2700	1740	-960	0.15	0.64	4	3	-1
0010	2F	2_3	25	27	7	2700	2740	40	0.26	1.01	4	4	0
0010	2F	2_3	26	45	7	4500	3210	-1290	0.16	0.71	7	5	-2
0010	2F	2_4	12	1655	494	165500	140660	-24840	0.30	0.85	292	248	-44
0010	2F	2_4	13	697	211	69700	53470	-16230	0.30	0.77	123	94	-29
0010	2F	2_4	14	246	82	24600	21960	-2640	0.33	0.89	43	38	-5
0010	2F	2_4	15	39	11	3900	3440	-460	0.28	0.88	6	6	0
0010	2F	2_4	16	27	4	2700	1300	-1400	0.15	0.48	4	2	-2
0010	2F	2_4	23	8	3	800	710	-90	0.38	0.89	1	1	0
0010	2F	2_4	24	4	0	400	0	-400	0.00	0.00	0	0	0
0010	2F	2_4	25	5	1	500	350	-150	0.20	0.70	0	0	0
0010	2F	2_4	26	9	1	900	270	-630	0.11	0.30	1	0	-1
0010	2F	2_5	12	551	166	55100	42950	-12150	0.30	0.78	97	76	-21
0010	2F	2_5	13	127	34	12700	8030	-4670	0.27	0.63	22	14	-8
0010	2F	2_5	14	23	8	2300	2440	140	0.35	1.06	4	4	0
0010	2F	2_5	15	1	0	100	0	-100	0.00	0.00	0	0	0
0010	2F	2_6	12	405	103	40500	28450	-12050	0.25	0.70	71	50	-21
0010	2F	2_6	13	59	21	5900	6360	460	0.36	1.08	10	11	1
0010	2F	2_6	14	9	2	900	800	-100	0.22	0.89	1	1	0
0010	2F	2_6	15	2	1	200	800	600	0.50	4.00	0	1	1
0010	2F	3_-1	12	19	4	1900	1020	-880	0.21	0.54	3	1	-2
0010	2F	3_-1	13	17	8	1700	1860	160	0.47	1.09	3	3	0
0010	2F	3_-1	14	6	2	600	720	120	0.33	1.20	1	1	0
0010	2F	3_-1	15	2	1	200	310	110	0.50	1.55	0	0	0
0010	2F	3_-1	16	1	0	100	0	-100	0.00	0.00	0	0	0
0010	2F	3_-1	23	1	1	100	370	270	1.00	3.70	0	0	0
0010	2F	3_-1	26	1	0	100	0	-100	0.00	0.00	0	0	0
0010	2F	3_0	12	316	90	31600	28240	-3360	0.28	0.89	55	49	-6
0010	2F	3_0	13	144	26	14400	8020	-6380	0.18	0.56	25	14	-11
0010	2F	3_0	14	55	12	5500	5700	200	0.22	1.04	9	10	1
0010	2F	3_0	15	30	3	3000	1720	-1280	0.10	0.57	5	3	-2
0010	2F	3_0	16	18	3	1800	980	-820	0.17	0.54	3	1	-2
0010	2F	3_0	23	6	0	600	0	-600	0.00	0.00	1	0	-1
0010	2F	3_0	24	1	0	100	0	-100	0.00	0.00	0	0	0
0010	2F	3_0	26	1	0	100	0	-100	0.00	0.00	0	0	0
0010	2F	3_1	12	758	256	75800	65460	-10340	0.34	0.86	134	115	-19
0010	2F	3_1	13	293	93	29300	22970	-6330	0.32	0.78	51	40	-11
0010	2F	3_1	14	149	39	14900	10960	-3940	0.26	0.74	26	19	-7
0010	2F	3_1	15	99	23	9900	9950	50	0.23	1.01	17	17	0
0010	2F	3_1	16	45	12	4500	3870	-630	0.27	0.86	7	6	-1
0010	2F	3_1	23	3	1	300	210	-90	0.33	0.70	0	0	0
0010	2F	3_1	24	2	1	200	280	80	0.50	1.40	0	0	0
0010	2F	3_1	25	4	1	400	470	70	0.25	1.18	0	0	0
0010	2F	3_1	26	6	1	600	530	-70	0.17	0.88	1	0	-1
0010	2F	3_2	12	693	270	69300	67190	-2110	0.39	0.97	122	118	-4
0010	2F	3_2	13	379	133	37900	30940	-6960	0.35	0.82	67	54	-13
0010	2F	3_2	14	379	112	37900	25230	-12670	0.30	0.67	67	44	-23
0010	2F	3_2	15	159	39	15900	12480	-3420	0.25	0.78	28	22	-6
0010	2F	3_2	16	74	15	7400	7790	390	0.20	1.05	13	13	0
0010	2F	3_2	23	54	13	5400	4360	-1040	0.24	0.81	9	7	-2
0010	2F	3_2	24	31	7	3100	2030	-1070	0.23	0.65	5	3	-2
0010	2F	3_2	25	20	6	2000	1990	-10	0.30	1.00	3	3	0
0010	2F	3_2	26	24	5	2400	1380	-1020	0.21	0.58	4	2	-2
0010	2F	3_3	12	1214	437	121400	108400	-13000	0.36	0.89	214	191	-23
0010	2F	3_3	13	812	286	81200	71520	-9680	0.35	0.88	143	126	-17
0010	2F	3_3	14	522	135	52200	37370	-14830	0.26	0.72	92	66	-26
0010	2F	3_3	15	235	46	23500	16010	-7490	0.20	0.68	41	28	-13
0010	2F	3_3	16	156	32	15600	15080	-520	0.21	0.97	27	26	-1
0010	2F	3_3	23	134	28	13400	11070	-2330	0.21	0.83	23	19	-4
0010	2F	3_3	24	75	14	7500	5260	-2240	0.19	0.70	13	9	-4
0010	2F	3_3	25	66	12	6600	5290	-1310	0.18	0.80	11	9	-2
0010	2F	3_3	26	103	24	10300	16170	5870	0.23	1.57	18	28	10
0010	2F	3_4	12	1485	498	148500	135110	-13390	0.34	0.91	262	239	-23
0010	2F	3_4	13	815	229	81500	63670	-17830	0.28	0.78	144	112	-32
0010	2F	3_4	14	328	78	32800	23910	-8890	0.24	0.73	58	42	-16
0010	2F	3_4	15	36	4	3600	1250	-2350	0.11	0.35	6	2	-4
0010	2F	3_4	16	28	4	2800	2490	-310	0.14	0.89	4	4	0
0010	2F	3_4	23	33	5	3300	2650	-650	0.15	0.80	5	4	-1
0010	2F	3_4	24	23	1	2300	220	-2080	0.04	0.10	4	0	-4
0010	2F	3_4	25	1	0	100	0	-100	0.00	0.00	0	0	0
0010	2F	3_4	26	5	1	500	350	-150	0.20	0.70	0	0	0
0010	2F	3_5	12	510	167	51000	42590	-8410	0.33	0.84	90	75	-15
0010	2F	3_5	13	199	55	19900	15030	-4870	0.28	0.76	35	26	-9
0010	2F	3_5	14	57	14	5700	3730	-1970	0.25	0.65	10	6	-4
0010	2F	3_5	15	1	0	100	0	-100	0.00	0.00	0	0	0
0010	2F	3_5	24	1	0	100	0	-100	0.00	0.00	0	0	0
0010	2F	3_6	12	200	65	20000	19260	-740	0.33	0.96	35	34	-1
0010	2F	3_6	13	68	17	6800	4340	-2460	0.25	0.64	12	7	-5
0010	2F	3_6	14	5	2	500	960	460	0.40	1.92	0	1	1
0010	2F	4_0	12	171	47	17100	14660	-2440	0.27	0.86	30	25	-5
0010	2F	4_0	13	104	27	10400	9890	-510	0.26	0.95	18	17	-1
0010	2F	4_0	14	44	6	4400	2200	-2200	0.14	0.50	7	3	-4
0010	2F	4_0	15	18	0	1800	0	-1800	0.00	0.00	3	0	-3
0010	2F	4_0	16	7	1	700	230	-470	0.14	0.33	1	0	-1
0010	2F	4_0	23	8	1	800	500	-300	0.13	0.63	1	0	-1
0010	2F	4_0	24	1	1	100	870	770	1.00	8.70	0	1	1
0010	2F	4_0	25	3	2	300	1450	1150	0.67	4.83	0	2	2
0010	2F	4_0	26	1	0	100	0	-100	0.00	0.00	0	0	0
0010	2F	4_1	12	652	221	65200	55870	-9330	0.34	0.86	115	98	-17
0010	2F	4_1	13	282	85	28200	20240	-7960	0.30	0.72	49	35	-14
0010	2F	4_1	14	135	47	13500	14760	1260	0.35	1.09	23	26	3
0010	2F	4_1	15	56	14	5600	4880	-720	0.25	0.87	9	8	-1
0010	2F	4_1	16	25	5	2500	1990	-510	0.20	0.80	4	3	-1
0010	2F	4_1	23	5	1	500	400	-100	0.20	0.80	0	0	0
0010	2F	4_1	24	4	1	400	600	200	0.25	1.50	0	1	1
0010	2F	4_1	25	2	0	200	0	-200	0.00	0.00	0	0	0
0010	2F	4_1	26	5	0	500	0	-500	0.00	0.00	0	0	0
0010	2F	4_2	12	755	283	75500	72370	-3130	0.37	0.96	133	128	-5
0010	2F	4_2	13	428	143	42800	31290	-11510	0.33	0.73	75	55	-20
0010	2F	4_2	14	330	121	33000	25830	-7170	0.37	0.78	58	45	-13
0010	2F	4_2	15	117	36	11700	12110	410	0.31	1.04	20	21	1
0010	2F	4_2	16	42	10	4200	3190	-1010	0.24	0.76	7	5	-2
0010	2F	4_2	23	22	9	2200	2730	530	0.41	1.24	3	4	1
0010	2F	4_2	24	21	7	2100	1780	-320	0.33	0.85	3	3	0
0010	2F	4_2	25	16	3	1600	1310	-290	0.19	0.82	2	2	0
0010	2F	4_2	26	11	6	1100	3430	2330	0.55	3.12	1	6	5
0010	2F	4_3	12	1353	457	135300	114080	-21220	0.34	0.84	239	201	-38
0010	2F	4_3	13	819	291	81900	70030	-11870	0.36	0.86	144	123	-21
0010	2F	4_3	14	426	127	42600	39550	-3050	0.30	0.93	75	70	-5
0010	2F	4_3	15	119	33	11900	11330	-570	0.28	0.95	21	20	-1
0007	1T	3_4	1	2656	1530	265600	244620	-20980	0.58	0.92	470	432	-38
0007	1T	3_4	2	236	67	23600	17990	-5610	0.28	0.76	41	31	-10
0007	1T	3_5	1	789	562	78900	75650	-3250	0.71	0.96	139	133	-6
0007	1T	3_5	2	17	7	1700	3060	1360	0.41	1.80	3	5	2
0007	1T	3_6	1	283	190	28300	24220	-4080	0.67	0.86	50	42	-8
0007	1T	3_6	2	6	1	600	300	-300	0.17	0.50	1	0	-1
0007	1T	4_0	1	341	178	34100	30440	-3660	0.52	0.89	60	53	-7
0007	1T	4_0	2	73	17	7300	6310	-990	0.23	0.86	12	11	-1
0007	1T	4_1	1	1108	754	110800	104020	-6780	0.68	0.94	196	184	-12
0007	1T	4_1	2	128	39	12800	13190	390	0.30	1.03	22	23	1
0007	1T	4_2	1	1586	913	158600	155970	-2630	0.58	0.98	280	276	-4
0007	1T	4_2	2	312	126	31200	28890	-2310	0.40	0.93	55	51	-4
0007	1T	4_3	1	2728	1454	272800	256870	-15930	0.53	0.94	482	454	-28
0007	1T	4_3	2	510	189	51000	45420	-5580	0.37	0.89	90	80	-10
0007	1T	4_4	1	2028	1258	202800	185640	-17160	0.62	0.92	358	328	-30
0007	1T	4_4	2	126	39	12600	10870	-1730	0.31	0.86	22	19	-3
0007	1T	4_5	1	795	553	79500	72630	-6870	0.70	0.91	140	128	-12
0007	1T	4_5	2	12	6	1200	2690	1490	0.50	2.24	2	4	2
0007	1T	4_6	1	304	222	30400	28740	-1660	0.73	0.95	53	50	-3
0007	1T	4_6	2	1	0	100	0	-100	0.00	0.00	0	0	0
0007	1T	5_0	1	400	231	40000	39460	-540	0.58	0.99	70	69	-1
0007	1T	5_0	2	61	14	6100	7330	1230	0.23	1.20	10	12	2
0007	1T	5_1	1	925	615	92500	84430	-8070	0.66	0.91	163	149	-14
0007	1T	5_1	2	75	19	7500	6450	-1050	0.25	0.86	13	11	-2
0007	1T	5_2	1	1301	812	130100	124890	-5210	0.62	0.96	230	221	-9
0007	1T	5_2	2	145	49	14500	13610	-890	0.34	0.94	25	24	-1
0007	1T	5_3	1	2197	1308	219700	202920	-16780	0.60	0.92	388	359	-29
0007	1T	5_3	2	166	40	16600	12090	-4510	0.24	0.73	29	21	-8
0007	1T	5_4	1	1439	936	143900	132800	-11100	0.65	0.92	254	235	-19
0007	1T	5_4	2	75	16	7500	6230	-1270	0.21	0.83	13	11	-2
0007	1T	5_5	1	860	605	86000	75850	-10150	0.70	0.88	152	134	-18
0007	1T	5_5	2	28	4	2800	1910	-890	0.14	0.68	4	3	-1
0007	1T	5_6	1	287	206	28700	26700	-2000	0.72	0.93	50	47	-3
0007	1T	5_6	2	7	1	700	470	-230	0.14	0.67	1	0	-1
0007	1T	6_0	1	35	23	3500	4560	1060	0.66	1.30	6	8	2
0007	1T	6_0	2	9	5	900	2160	1260	0.56	2.40	1	3	2
0007	1T	6_1	1	66	40	6600	5210	-1390	0.61	0.79	11	9	-2
0007	1T	6_1	2	4	1	400	280	-120	0.25	0.70	0	0	0
0007	1T	6_2	1	84	45	8400	8570	170	0.54	1.02	14	15	1
0007	1T	6_2	2	5	2	500	740	240	0.40	1.48	0	1	1
0007	1T	6_3	1	176	96	17600	15460	-2140	0.55	0.88	31	27	-4
0007	1T	6_3	2	13	5	1300	2460	1160	0.38	1.89	2	4	2
0007	1T	6_4	1	141	90	14100	12240	-1860	0.64	0.87	24	21	-3
0007	1T	6_4	2	2	0	200	0	-200	0.00	0.00	0	0	0
0007	1T	6_5	1	71	53	7100	6430	-670	0.75	0.91	12	11	-1
0007	1T	6_5	2	1	0	100	0	-100	0.00	0.00	0	0	0
0010	2F	4_3	16	54	11	5400	6390	990	0.20	1.18	9	11	2
0010	2F	4_3	23	72	19	7200	5060	-2140	0.26	0.70	12	8	-4
0007	1T	6_6	1	29	22	2900	2840	-60	0.76	0.98	5	5	0
0007	1T	6_6	2	1	0	100	0	-100	0.00	0.00	0	0	0
0007	1T	7_0	1	742	395	74200	70340	-3860	0.53	0.95	131	124	-7
0007	1T	7_0	2	139	27	13900	10600	-3300	0.19	0.76	24	18	-6
0007	1T	7_1	1	2065	1355	206500	187080	-19420	0.66	0.91	365	331	-34
0007	1T	7_1	2	192	50	19200	17640	-1560	0.26	0.92	33	31	-2
0007	1T	7_2	1	2926	1750	292600	266660	-25940	0.60	0.91	517	471	-46
0007	1T	7_2	2	312	83	31200	22940	-8260	0.27	0.74	55	40	-15
0007	1T	7_3	1	3077	1910	307700	288320	-19380	0.62	0.94	544	510	-34
0007	1T	7_3	2	206	65	20600	23920	3320	0.32	1.16	36	42	6
0007	1T	7_4	1	1462	915	146200	137000	-9200	0.63	0.94	258	242	-16
0007	1T	7_4	2	68	17	6800	5110	-1690	0.25	0.75	12	9	-3
0007	1T	7_5	1	1006	685	100600	91540	-9060	0.68	0.91	178	162	-16
0007	1T	7_5	2	22	3	2200	780	-1420	0.14	0.35	3	1	-2
0007	1T	7_6	1	710	487	71000	63400	-7600	0.69	0.89	125	112	-13
0007	1T	7_6	2	9	0	900	0	-900	0.00	0.00	1	0	-1
0007	2F	1_0	12	243	57	24300	17520	-6780	0.23	0.72	43	31	-12
0007	2F	1_0	13	158	18	15800	6070	-9730	0.11	0.38	27	10	-17
0007	2F	1_0	14	91	16	9100	7490	-1610	0.18	0.82	16	13	-3
0007	2F	1_0	15	39	5	3900	3190	-710	0.13	0.82	6	5	-1
0007	2F	1_0	16	4	1	400	360	-40	0.25	0.90	0	0	0
0007	2F	1_0	23	11	0	1100	0	-1100	0.00	0.00	1	0	-1
0007	2F	1_0	24	16	2	1600	3630	2030	0.13	2.27	2	6	4
0007	2F	1_0	25	3	0	300	0	-300	0.00	0.00	0	0	0
0007	2F	1_1	12	538	125	53800	39890	-13910	0.23	0.74	95	70	-25
0007	2F	1_1	13	409	98	40900	34660	-6240	0.24	0.85	72	61	-11
0007	2F	1_1	14	232	37	23200	16730	-6470	0.16	0.72	41	29	-12
0007	2F	1_1	15	86	14	8600	9280	680	0.16	1.08	15	16	1
0007	2F	1_1	16	19	1	1900	250	-1650	0.05	0.13	3	0	-3
0007	2F	1_1	23	19	0	1900	0	-1900	0.00	0.00	3	0	-3
0007	2F	1_1	24	21	0	2100	0	-2100	0.00	0.00	3	0	-3
0007	2F	1_1	25	8	0	800	0	-800	0.00	0.00	1	0	-1
0007	2F	1_1	26	2	0	200	0	-200	0.00	0.00	0	0	0
0007	2F	1_2	12	730	183	73000	63900	-9100	0.25	0.88	129	113	-16
0007	2F	1_2	13	477	99	47700	33470	-14230	0.21	0.70	84	59	-25
0007	2F	1_2	14	337	70	33700	27400	-6300	0.21	0.81	59	48	-11
0007	2F	1_2	15	106	10	10600	8040	-2560	0.09	0.76	18	14	-4
0007	2F	1_2	16	58	7	5800	7910	2110	0.12	1.36	10	14	4
0007	2F	1_2	23	72	6	7200	4540	-2660	0.08	0.63	12	8	-4
0007	2F	1_2	24	46	4	4600	2890	-1710	0.09	0.63	8	5	-3
0007	2F	1_2	25	25	1	2500	1970	-530	0.04	0.79	4	3	-1
0007	2F	1_2	26	13	0	1300	0	-1300	0.00	0.00	2	0	-2
0007	2F	1_3	12	1275	333	127500	113710	-13790	0.26	0.89	225	201	-24
0007	2F	1_3	13	813	185	81300	60490	-20810	0.23	0.74	143	107	-36
0007	2F	1_3	14	540	102	54000	40930	-13070	0.19	0.76	95	72	-23
0007	2F	1_3	15	210	20	21000	13240	-7760	0.10	0.63	37	23	-14
0007	2F	1_3	16	130	17	13000	14610	1610	0.13	1.12	23	25	2
0007	2F	1_3	23	123	24	12300	12900	600	0.20	1.05	21	22	1
0007	2F	1_3	24	115	11	11500	8760	-2740	0.10	0.76	20	15	-5
0007	2F	1_3	25	38	0	3800	0	-3800	0.00	0.00	6	0	-6
0007	2F	1_3	26	35	4	3500	3840	340	0.11	1.10	6	6	0
0007	2F	1_4	12	750	215	75000	68070	-6930	0.29	0.91	132	120	-12
0007	2F	1_4	13	492	114	49200	39160	-10040	0.23	0.80	87	69	-18
0007	2F	1_4	14	327	57	32700	26290	-6410	0.17	0.80	57	46	-11
0007	2F	1_4	15	103	10	10300	6850	-3450	0.10	0.67	18	12	-6
0007	2F	1_4	16	71	4	7100	4280	-2820	0.06	0.60	12	7	-5
0007	2F	1_4	23	46	7	4600	3710	-890	0.15	0.81	8	6	-2
0007	2F	1_4	24	36	4	3600	6220	2620	0.11	1.73	6	11	5
0007	2F	1_4	25	20	1	2000	1070	-930	0.05	0.54	3	1	-2
0007	2F	1_4	26	3	0	300	0	-300	0.00	0.00	0	0	0
0007	2F	1_5	12	138	36	13800	9840	-3960	0.26	0.71	24	17	-7
0007	2F	1_5	13	90	18	9000	8400	-600	0.20	0.93	15	14	-1
0007	2F	1_5	14	65	7	6500	1990	-4510	0.11	0.31	11	3	-8
0007	2F	1_5	15	23	1	2300	930	-1370	0.04	0.40	4	1	-3
0007	2F	1_5	16	8	0	800	0	-800	0.00	0.00	1	0	-1
0007	2F	1_5	23	7	0	700	0	-700	0.00	0.00	1	0	-1
0007	2F	1_5	24	4	0	400	0	-400	0.00	0.00	0	0	0
0007	2F	1_5	25	2	0	200	0	-200	0.00	0.00	0	0	0
0007	2F	1_5	26	2	0	200	0	-200	0.00	0.00	0	0	0
0007	2F	1_6	12	447	131	44700	34740	-9960	0.29	0.78	79	61	-18
0007	2F	1_6	13	318	76	31800	26050	-5750	0.24	0.82	56	46	-10
0007	2F	1_6	14	199	47	19900	21060	1160	0.24	1.06	35	37	2
0007	2F	1_6	15	83	12	8300	9820	1520	0.14	1.18	14	17	3
0007	2F	1_6	16	19	1	1900	670	-1230	0.05	0.35	3	1	-2
0007	2F	1_6	23	6	1	600	1470	870	0.17	2.45	1	2	1
0007	2F	1_6	24	3	0	300	0	-300	0.00	0.00	0	0	0
0007	2F	1_6	25	3	1	300	2540	2240	0.33	8.47	0	4	4
0007	2F	1_6	26	1	0	100	0	-100	0.00	0.00	0	0	0
0007	2F	2_0	12	174	56	17400	17350	-50	0.32	1.00	30	30	0
0007	2F	2_0	13	122	26	12200	9640	-2560	0.21	0.79	21	17	-4
0007	2F	2_0	14	45	7	4500	2960	-1540	0.16	0.66	7	5	-2
0007	2F	2_0	15	41	5	4100	2010	-2090	0.12	0.49	7	3	-4
0007	2F	2_0	16	29	3	2900	2410	-490	0.10	0.83	5	4	-1
0007	2F	2_0	23	19	2	1900	2280	380	0.11	1.20	3	4	1
0007	2F	2_0	24	11	0	1100	0	-1100	0.00	0.00	1	0	-1
0007	2F	2_0	25	5	1	500	1250	750	0.20	2.50	0	2	2
0007	2F	2_0	26	6	0	600	0	-600	0.00	0.00	1	0	-1
0007	2F	2_1	12	501	175	50100	50280	180	0.35	1.00	88	88	0
0007	2F	2_1	13	304	85	30400	25360	-5040	0.28	0.83	53	44	-9
0007	2F	2_1	14	211	50	21100	16280	-4820	0.24	0.77	37	28	-9
0007	2F	2_1	15	95	15	9500	6210	-3290	0.16	0.65	16	10	-6
0007	2F	2_1	16	64	10	6400	4690	-1710	0.16	0.73	11	8	-3
0007	2F	2_1	23	13	2	1300	1790	490	0.15	1.38	2	3	1
0007	2F	2_1	24	15	4	1500	14570	13070	0.27	9.71	2	25	23
0007	2F	2_1	25	7	0	700	0	-700	0.00	0.00	1	0	-1
0007	2F	2_1	26	7	1	700	1040	340	0.14	1.49	1	1	0
0007	2F	2_2	12	798	242	79800	66690	-13110	0.30	0.84	141	118	-23
0007	2F	2_2	13	409	125	40900	41700	800	0.31	1.02	72	73	1
0007	2F	2_2	14	317	76	31700	19480	-12220	0.24	0.61	56	34	-22
0007	2F	2_2	15	111	25	11100	15760	4660	0.23	1.42	19	27	8
0007	2F	2_2	16	101	20	10100	8660	-1440	0.20	0.86	17	15	-2
0007	2F	2_2	23	71	9	7100	4020	-3080	0.13	0.57	12	7	-5
0007	2F	2_2	24	42	9	4200	7500	3300	0.21	1.79	7	13	6
0007	2F	2_2	25	23	3	2300	1350	-950	0.13	0.59	4	2	-2
0007	2F	2_2	26	32	2	3200	1390	-1810	0.06	0.43	5	2	-3
0007	2F	2_3	12	1418	415	141800	125110	-16690	0.29	0.88	250	221	-29
0007	2F	2_3	13	809	211	80900	68880	-12020	0.26	0.85	143	121	-22
0007	2F	2_3	14	473	89	47300	34210	-13090	0.19	0.72	83	60	-23
0007	2F	2_3	15	240	49	24000	24160	160	0.20	1.01	42	42	0
0007	2F	2_3	16	223	38	22300	19330	-2970	0.17	0.87	39	34	-5
0007	2F	2_3	23	103	9	10300	4130	-6170	0.09	0.40	18	7	-11
0007	2F	2_3	24	66	9	6600	3140	-3460	0.14	0.48	11	5	-6
0007	2F	2_3	25	43	9	4300	4670	370	0.21	1.09	7	8	1
0007	2F	2_3	26	48	8	4800	3750	-1050	0.17	0.78	8	6	-2
0007	2F	2_4	12	1075	322	107500	95260	-12240	0.30	0.89	190	168	-22
0007	2F	2_4	13	631	166	63100	54400	-8700	0.26	0.86	111	96	-15
0007	2F	2_4	14	383	87	38300	30510	-7790	0.23	0.80	67	54	-13
0007	2F	2_4	15	146	20	14600	7820	-6780	0.14	0.54	25	13	-12
0007	2F	2_4	16	86	13	8600	7890	-710	0.15	0.92	15	13	-2
0007	2F	2_4	23	22	4	2200	2310	110	0.18	1.05	3	4	1
0007	2F	2_4	24	16	3	1600	2440	840	0.19	1.53	2	4	2
0007	2F	2_4	25	14	3	1400	1450	50	0.21	1.04	2	2	0
0007	2F	2_4	26	15	2	1500	2640	1140	0.13	1.76	2	4	2
0007	2F	2_5	12	345	108	34500	28490	-6010	0.31	0.83	61	50	-11
0007	2F	2_5	13	153	34	15300	9630	-5670	0.22	0.63	27	17	-10
0007	2F	2_5	14	111	26	11100	9330	-1770	0.23	0.84	19	16	-3
0007	2F	2_5	15	27	8	2700	5360	2660	0.30	1.99	4	9	5
0007	2F	2_5	16	6	0	600	0	-600	0.00	0.00	1	0	-1
0007	2F	2_5	23	1	0	100	0	-100	0.00	0.00	0	0	0
0007	2F	2_6	12	253	62	25300	16670	-8630	0.25	0.66	44	29	-15
0007	2F	2_6	13	95	28	9500	8660	-840	0.29	0.91	16	15	-1
0007	2F	2_6	14	86	13	8600	4910	-3690	0.15	0.57	15	8	-7
0007	2F	2_6	15	18	2	1800	1120	-680	0.11	0.62	3	1	-2
0007	2F	2_6	16	6	0	600	0	-600	0.00	0.00	1	0	-1
0007	2F	2_6	24	2	0	200	0	-200	0.00	0.00	0	0	0
0007	2F	3_0	12	189	51	18900	16730	-2170	0.27	0.89	33	29	-4
0007	2F	3_0	13	136	24	13600	9200	-4400	0.18	0.68	24	16	-8
0007	2F	3_0	14	91	10	9100	4890	-4210	0.11	0.54	16	8	-8
0007	2F	3_0	15	31	2	3100	1570	-1530	0.06	0.51	5	2	-3
0007	2F	3_0	16	14	0	1400	0	-1400	0.00	0.00	2	0	-2
0007	2F	3_0	23	12	1	1200	460	-740	0.08	0.38	2	0	-2
0007	2F	3_0	24	10	1	1000	1830	830	0.10	1.83	1	3	2
0007	2F	3_0	25	7	0	700	0	-700	0.00	0.00	1	0	-1
0007	2F	3_0	26	2	0	200	0	-200	0.00	0.00	0	0	0
0007	2F	3_1	12	522	155	52200	45200	-7000	0.30	0.87	92	80	-12
0007	2F	3_1	13	363	72	36300	22320	-13980	0.20	0.61	64	39	-25
0007	2F	3_1	14	199	31	19900	10460	-9440	0.16	0.53	35	18	-17
0007	2F	3_1	15	84	15	8400	7280	-1120	0.18	0.87	14	12	-2
0007	2F	3_1	16	46	9	4600	5970	1370	0.20	1.30	8	10	2
0007	2F	3_1	23	30	3	3000	2500	-500	0.10	0.83	5	4	-1
0007	2F	3_1	24	21	2	2100	1670	-430	0.10	0.80	3	2	-1
0007	2F	3_1	25	10	0	1000	0	-1000	0.00	0.00	1	0	-1
0007	2F	3_1	26	6	1	600	970	370	0.17	1.62	1	1	0
0007	2F	3_2	12	784	238	78400	78640	240	0.30	1.00	138	139	1
0007	2F	3_2	13	431	105	43100	39070	-4030	0.24	0.91	76	69	-7
0007	2F	3_2	14	245	51	24500	18030	-6470	0.21	0.74	43	31	-12
0007	2F	3_2	15	134	20	13400	8450	-4950	0.15	0.63	23	14	-9
0007	2F	3_2	16	71	7	7100	7160	60	0.10	1.01	12	12	0
0007	2F	3_2	23	81	4	8100	1410	-6690	0.05	0.17	14	2	-12
0007	2F	3_2	24	37	5	3700	3880	180	0.14	1.05	6	6	0
0007	2F	3_2	25	29	0	2900	0	-2900	0.00	0.00	5	0	-5
0007	2F	3_2	26	24	2	2400	1080	-1320	0.08	0.45	4	1	-3
0007	2F	3_3	12	1277	352	127700	108080	-19620	0.28	0.85	226	191	-35
0007	2F	3_3	13	809	213	80900	72090	-8810	0.26	0.89	143	127	-16
0007	2F	3_3	14	422	76	42200	28420	-13780	0.18	0.67	74	50	-24
0007	2F	3_3	15	254	36	25400	22540	-2860	0.14	0.89	44	39	-5
0007	2F	3_3	16	127	14	12700	8860	-3840	0.11	0.70	22	15	-7
0007	2F	3_3	23	157	22	15700	11940	-3760	0.14	0.76	27	21	-6
0007	2F	3_3	24	84	12	8400	4970	-3430	0.14	0.59	14	8	-6
0007	2F	3_3	25	83	11	8300	7470	-830	0.13	0.90	14	13	-1
0007	2F	3_3	26	58	4	5800	2080	-3720	0.07	0.36	10	3	-7
0007	2F	3_4	12	994	295	99400	84560	-14840	0.30	0.85	175	149	-26
0007	2F	3_4	13	669	151	66900	52870	-14030	0.23	0.79	118	93	-25
0007	2F	3_4	14	369	62	36900	31410	-5490	0.17	0.85	65	55	-10
0007	2F	3_4	15	200	34	20000	24700	4700	0.17	1.24	35	43	8
0007	2F	3_4	16	101	7	10100	7640	-2460	0.07	0.76	17	13	-4
0007	2F	3_4	23	46	2	4600	1070	-3530	0.04	0.23	8	1	-7
0007	2F	3_4	24	28	5	2800	2870	70	0.18	1.03	4	5	1
0007	2F	3_4	25	22	2	2200	2430	230	0.09	1.10	3	4	1
0007	2F	3_4	26	13	1	1300	1080	-220	0.08	0.83	2	1	-1
0007	2F	3_5	12	332	99	33200	25360	-7840	0.30	0.76	58	44	-14
0007	2F	3_5	13	176	46	17600	13380	-4220	0.26	0.76	31	23	-8
0007	2F	3_5	14	132	33	13200	14660	1460	0.25	1.11	23	25	2
0007	2F	3_5	15	53	5	5300	4240	-1060	0.09	0.80	9	7	-2
0007	2F	3_5	16	18	1	1800	770	-1030	0.06	0.43	3	1	-2
0007	2F	3_5	23	1	0	100	0	-100	0.00	0.00	0	0	0
0007	2F	3_5	24	3	0	300	0	-300	0.00	0.00	0	0	0
0007	2F	3_5	26	2	0	200	0	-200	0.00	0.00	0	0	0
0007	2F	3_6	12	110	32	11000	8420	-2580	0.29	0.77	19	14	-5
0007	2F	3_6	13	68	22	6800	6670	-130	0.32	0.98	12	11	-1
0007	2F	3_6	14	52	12	5200	5140	-60	0.23	0.99	9	9	0
0007	2F	3_6	15	17	2	1700	880	-820	0.12	0.52	3	1	-2
0007	2F	3_6	16	9	0	900	0	-900	0.00	0.00	1	0	-1
0007	2F	3_6	24	1	0	100	0	-100	0.00	0.00	0	0	0
0007	2F	4_0	12	126	28	12600	10020	-2580	0.22	0.80	22	17	-5
0007	2F	4_0	13	81	21	8100	7420	-680	0.26	0.92	14	13	-1
0007	2F	4_0	14	39	12	3900	5530	1630	0.31	1.42	6	9	3
0007	2F	4_0	15	39	3	3900	1650	-2250	0.08	0.42	6	2	-4
0007	2F	4_0	16	19	2	1900	1490	-410	0.11	0.78	3	2	-1
0007	2F	4_0	23	19	1	1900	1560	-340	0.05	0.82	3	2	-1
0007	2F	4_0	24	8	1	800	400	-400	0.13	0.50	1	0	-1
0007	2F	4_0	25	4	0	400	0	-400	0.00	0.00	0	0	0
0007	2F	4_0	26	5	0	500	0	-500	0.00	0.00	0	0	0
0007	2F	4_1	12	468	156	46800	41070	-5730	0.33	0.88	82	72	-10
0007	2F	4_1	13	276	73	27600	22160	-5440	0.26	0.80	48	39	-9
0007	2F	4_1	14	162	36	16200	12110	-4090	0.22	0.75	28	21	-7
0007	2F	4_1	15	61	12	6100	5390	-710	0.20	0.88	10	9	-1
0007	2F	4_1	16	44	7	4400	7470	3070	0.16	1.70	7	13	6
0007	2F	4_1	23	24	4	2400	1650	-750	0.17	0.69	4	2	-2
0007	2F	4_1	24	14	0	1400	0	-1400	0.00	0.00	2	0	-2
0007	2F	4_1	25	12	0	1200	0	-1200	0.00	0.00	2	0	-2
0007	2F	4_1	26	6	0	600	0	-600	0.00	0.00	1	0	-1
0007	2F	4_2	12	687	215	68700	59000	-9700	0.31	0.86	121	104	-17
0007	2F	4_2	13	388	94	38800	28120	-10680	0.24	0.72	68	49	-19
0007	2F	4_2	14	259	72	25900	19260	-6640	0.28	0.74	45	34	-11
0007	2F	4_2	15	85	18	8500	7660	-840	0.21	0.90	15	13	-2
0007	2F	4_2	16	56	10	5600	8980	3380	0.18	1.60	9	15	6
0007	2F	4_2	23	54	11	5400	6070	670	0.20	1.12	9	10	1
0007	2F	4_2	24	34	3	3400	970	-2430	0.09	0.29	6	1	-5
0007	2F	4_2	25	24	6	2400	3100	700	0.25	1.29	4	5	1
0007	2F	4_2	26	20	5	2000	1320	-680	0.25	0.66	3	2	-1
0007	2F	4_3	12	1120	336	112000	92430	-19570	0.30	0.83	198	163	-35
0007	2F	4_3	13	734	205	73400	60690	-12710	0.28	0.83	129	107	-22
0007	2F	4_3	14	382	94	38200	33770	-4430	0.25	0.88	67	59	-8
0007	2F	4_3	15	204	25	20400	11860	-8540	0.12	0.58	36	20	-16
0007	2F	4_3	16	104	13	10400	9600	-800	0.13	0.92	18	16	-2
0007	2F	4_3	23	118	29	11800	14840	3040	0.25	1.26	20	26	6
0007	2F	4_3	24	45	9	4500	3490	-1010	0.20	0.78	7	6	-1
0007	2F	4_3	25	46	4	4600	5090	490	0.09	1.11	8	9	1
0007	2F	4_3	26	30	2	3000	700	-2300	0.07	0.23	5	1	-4
0007	2F	4_4	12	944	307	94400	79240	-15160	0.33	0.84	167	140	-27
0007	2F	4_4	13	479	140	47900	43700	-4200	0.29	0.91	84	77	-7
0007	2F	4_4	14	300	66	30000	22600	-7400	0.22	0.75	53	40	-13
0007	2F	4_4	15	103	15	10300	6390	-3910	0.15	0.62	18	11	-7
0007	2F	4_4	16	50	2	5000	690	-4310	0.04	0.14	8	1	-7
0007	2F	4_4	23	23	4	2300	2060	-240	0.17	0.90	4	3	-1
0007	2F	4_4	24	20	2	2000	1000	-1000	0.10	0.50	3	1	-2
0007	2F	4_4	25	12	0	1200	0	-1200	0.00	0.00	2	0	-2
0007	2F	4_4	26	9	1	900	750	-150	0.11	0.83	1	1	0
0007	2F	4_5	12	413	136	41300	32750	-8550	0.33	0.79	73	57	-16
0007	2F	4_5	13	209	76	20900	25780	4880	0.36	1.23	36	45	9
0007	2F	4_5	14	87	14	8700	5110	-3590	0.16	0.59	15	9	-6
0007	2F	4_5	15	21	2	2100	950	-1150	0.10	0.45	3	1	-2
0007	2F	4_5	16	8	0	800	0	-800	0.00	0.00	1	0	-1
0007	2F	4_5	23	1	0	100	0	-100	0.00	0.00	0	0	0
0007	2F	4_5	24	2	1	200	2980	2780	0.50	14.90	0	5	5
0007	2F	4_5	25	1	0	100	0	-100	0.00	0.00	0	0	0
0007	2F	4_6	12	167	59	16700	14860	-1840	0.35	0.89	29	26	-3
0007	2F	4_6	13	72	16	7200	6230	-970	0.22	0.87	12	11	-1
0007	2F	4_6	14	31	7	3100	4200	1100	0.23	1.35	5	7	2
0007	2F	4_6	15	13	0	1300	0	-1300	0.00	0.00	2	0	-2
0007	2F	4_6	16	2	0	200	0	-200	0.00	0.00	0	0	0
0007	2F	5_0	12	165	49	16500	15720	-780	0.30	0.95	29	27	-2
0007	2F	5_0	13	103	17	10300	6630	-3670	0.17	0.64	18	11	-7
0007	2F	5_0	14	56	7	5600	5300	-300	0.13	0.95	9	9	0
0007	2F	5_0	15	33	3	3300	1060	-2240	0.09	0.32	5	1	-4
0007	2F	5_0	16	11	2	1100	2410	1310	0.18	2.19	1	4	3
0007	2F	5_0	23	14	2	1400	1700	300	0.14	1.21	2	3	1
0007	2F	5_0	24	4	0	400	0	-400	0.00	0.00	0	0	0
0007	2F	5_0	25	7	0	700	0	-700	0.00	0.00	1	0	-1
0007	2F	5_0	26	1	0	100	0	-100	0.00	0.00	0	0	0
0007	2F	5_1	12	365	115	36500	31460	-5040	0.32	0.86	64	55	-9
0007	2F	5_1	13	231	53	23100	19780	-3320	0.23	0.86	40	35	-5
0007	2F	5_1	14	145	27	14500	8140	-6360	0.19	0.56	25	14	-11
0007	2F	5_1	15	63	11	6300	7410	1110	0.17	1.18	11	13	2
0007	2F	5_1	16	21	2	2100	1870	-230	0.10	0.89	3	3	0
0007	2F	5_1	23	18	1	1800	310	-1490	0.06	0.17	3	0	-3
0007	2F	5_1	24	9	2	900	1150	250	0.22	1.28	1	2	1
0007	2F	5_1	25	7	1	700	1150	450	0.14	1.64	1	2	1
0007	2F	5_1	26	2	0	200	0	-200	0.00	0.00	0	0	0
0007	2F	5_2	12	520	156	52000	43290	-8710	0.30	0.83	92	76	-16
0007	2F	5_2	13	315	79	31500	27030	-4470	0.25	0.86	55	47	-8
0007	2F	5_2	14	194	54	19400	17150	-2250	0.28	0.88	34	30	-4
0007	2F	5_2	15	76	10	7600	7250	-350	0.13	0.95	13	12	-1
0007	2F	5_2	16	47	9	4700	6230	1530	0.19	1.33	8	11	3
0007	2F	5_2	23	34	3	3400	1520	-1880	0.09	0.45	6	2	-4
0007	2F	5_2	24	14	2	1400	700	-700	0.14	0.50	2	1	-1
0007	2F	5_2	25	17	2	1700	1010	-690	0.12	0.59	3	1	-2
0007	2F	5_2	26	5	0	500	0	-500	0.00	0.00	0	0	0
0007	2F	5_3	12	852	269	85200	86330	1130	0.32	1.01	150	152	2
0007	2F	5_3	13	538	149	53800	43930	-9870	0.28	0.82	95	77	-18
0007	2F	5_3	14	337	81	33700	26510	-7190	0.24	0.79	59	46	-13
0007	2F	5_3	15	136	30	13600	14800	1200	0.22	1.09	24	26	2
0007	2F	5_3	16	76	13	7600	9960	2360	0.17	1.31	13	17	4
0007	2F	5_3	23	37	4	3700	1400	-2300	0.11	0.38	6	2	-4
0007	2F	5_3	24	23	2	2300	670	-1630	0.09	0.29	4	1	-3
0007	2F	5_3	25	8	0	800	0	-800	0.00	0.00	1	0	-1
0007	2F	5_3	26	5	0	500	0	-500	0.00	0.00	0	0	0
0007	2F	5_4	12	565	207	56500	51170	-5330	0.37	0.91	100	90	-10
0007	2F	5_4	13	353	81	35300	25540	-9760	0.23	0.72	62	45	-17
0007	2F	5_4	14	243	47	24300	16470	-7830	0.19	0.68	43	29	-14
0007	2F	5_4	15	73	10	7300	4200	-3100	0.14	0.58	12	7	-5
0007	2F	5_4	16	39	5	3900	2500	-1400	0.13	0.64	6	4	-2
0007	2F	5_4	23	21	1	2100	260	-1840	0.05	0.12	3	0	-3
0007	2F	5_4	24	2	1	200	290	90	0.50	1.45	0	0	0
0007	2F	5_4	25	3	0	300	0	-300	0.00	0.00	0	0	0
0007	2F	5_4	26	4	0	400	0	-400	0.00	0.00	0	0	0
0007	2F	5_5	12	438	161	43800	33480	-10320	0.37	0.76	77	59	-18
0007	2F	5_5	13	207	57	20700	18960	-1740	0.28	0.92	36	33	-3
0007	2F	5_5	14	105	26	10500	13170	2670	0.25	1.25	18	23	5
0007	2F	5_5	15	44	2	4400	2480	-1920	0.05	0.56	7	4	-3
0007	2F	5_5	16	4	0	400	0	-400	0.00	0.00	0	0	0
0007	2F	5_5	23	5	1	500	810	310	0.20	1.62	0	1	1
0007	2F	5_5	25	3	1	300	2660	2360	0.33	8.87	0	4	4
0007	2F	5_6	12	145	55	14500	11560	-2940	0.38	0.80	25	20	-5
0007	2F	5_6	13	68	18	6800	5740	-1060	0.26	0.84	12	10	-2
0007	2F	5_6	14	23	6	2300	2960	660	0.26	1.29	4	5	1
0007	2F	5_6	15	19	2	1900	2090	190	0.11	1.10	3	3	0
0007	2F	5_6	16	7	0	700	0	-700	0.00	0.00	1	0	-1
0007	2F	5_6	24	1	0	100	0	-100	0.00	0.00	0	0	0
0007	2F	5_6	25	1	0	100	0	-100	0.00	0.00	0	0	0
0007	2F	5_6	26	1	0	100	0	-100	0.00	0.00	0	0	0
0007	2F	6_0	12	11	3	1100	1350	250	0.27	1.23	1	2	1
0007	2F	6_0	13	12	3	1200	850	-350	0.25	0.71	2	1	-1
0007	2F	6_0	14	3	0	300	0	-300	0.00	0.00	0	0	0
0007	2F	6_0	15	5	0	500	0	-500	0.00	0.00	0	0	0
0007	2F	6_0	16	1	0	100	0	-100	0.00	0.00	0	0	0
0007	2F	6_0	23	2	0	200	0	-200	0.00	0.00	0	0	0
0007	2F	6_0	25	3	0	300	0	-300	0.00	0.00	0	0	0
0007	2F	6_1	12	25	10	2500	2540	40	0.40	1.02	4	4	0
0007	2F	6_1	13	16	4	1600	1020	-580	0.25	0.64	2	1	-1
0007	2F	6_1	14	12	2	1200	980	-220	0.17	0.82	2	1	-1
0007	2F	6_1	15	5	0	500	0	-500	0.00	0.00	0	0	0
0007	2F	6_1	16	1	0	100	0	-100	0.00	0.00	0	0	0
0007	2F	6_1	24	1	0	100	0	-100	0.00	0.00	0	0	0
0007	2F	6_2	12	29	7	2900	1880	-1020	0.24	0.65	5	3	-2
0007	2F	6_2	13	23	7	2300	1780	-520	0.30	0.77	4	3	-1
0007	2F	6_2	14	17	4	1700	1030	-670	0.24	0.61	3	1	-2
0007	2F	6_2	15	7	1	700	230	-470	0.14	0.33	1	0	-1
0007	2F	6_2	26	1	0	100	0	-100	0.00	0.00	0	0	0
0007	2F	6_3	12	64	18	6400	5160	-1240	0.28	0.81	11	9	-2
0007	2F	6_3	13	45	16	4500	3920	-580	0.36	0.87	7	6	-1
0007	2F	6_3	14	20	3	2000	990	-1010	0.15	0.50	3	1	-2
0007	2F	6_3	15	14	3	1400	1020	-380	0.21	0.73	2	1	-1
0007	2F	6_3	16	15	5	1500	3700	2200	0.33	2.47	2	6	4
0007	2F	6_3	23	3	1	300	1970	1670	0.33	6.57	0	3	3
0007	2F	6_3	24	1	0	100	0	-100	0.00	0.00	0	0	0
0007	2F	6_3	25	1	0	100	0	-100	0.00	0.00	0	0	0
0007	2F	6_3	26	2	0	200	0	-200	0.00	0.00	0	0	0
0007	2F	6_4	12	57	14	5700	3130	-2570	0.25	0.55	10	5	-5
0007	2F	6_4	13	32	10	3200	2880	-320	0.31	0.90	5	5	0
0007	2F	6_4	14	19	4	1900	2140	240	0.21	1.13	3	3	0
0007	2F	6_4	15	11	1	1100	160	-940	0.09	0.15	1	0	-1
0007	2F	6_4	16	7	0	700	0	-700	0.00	0.00	1	0	-1
0007	2F	6_5	12	31	15	3100	2800	-300	0.48	0.90	5	4	-1
0007	2F	6_5	13	17	2	1700	590	-1110	0.12	0.35	3	1	-2
0007	2F	6_5	14	7	1	700	1040	340	0.14	1.49	1	1	0
0007	2F	6_5	15	2	0	200	0	-200	0.00	0.00	0	0	0
0007	2F	6_5	16	2	0	200	0	-200	0.00	0.00	0	0	0
0007	2F	6_6	12	18	7	1800	1480	-320	0.39	0.82	3	2	-1
0007	2F	6_6	13	5	0	500	0	-500	0.00	0.00	0	0	0
0007	2F	6_6	14	5	1	500	370	-130	0.20	0.74	0	0	0
0007	2F	7_0	12	316	89	31600	26420	-5180	0.28	0.84	55	46	-9
0007	2F	7_0	13	189	33	18900	12150	-6750	0.17	0.64	33	21	-12
0007	2F	7_0	14	84	17	8400	7410	-990	0.20	0.88	14	13	-1
0007	2F	7_0	15	53	5	5300	2640	-2660	0.09	0.50	9	4	-5
0007	2F	7_0	16	19	1	1900	1520	-380	0.05	0.80	3	2	-1
0007	2F	7_0	23	40	7	4000	4530	530	0.18	1.13	7	8	1
0007	2F	7_0	24	24	3	2400	2400	0	0.13	1.00	4	4	0
0007	2F	7_0	25	6	0	600	0	-600	0.00	0.00	1	0	-1
0007	2F	7_0	26	8	0	800	0	-800	0.00	0.00	1	0	-1
0007	2F	7_1	12	852	290	85200	81110	-4090	0.34	0.95	150	143	-7
0007	2F	7_1	13	526	131	52600	41980	-10620	0.25	0.80	93	74	-19
0007	2F	7_1	14	278	59	27800	24570	-3230	0.21	0.88	49	43	-6
0007	2F	7_1	15	143	18	14300	9760	-4540	0.13	0.68	25	17	-8
0007	2F	7_1	16	43	6	4300	2900	-1400	0.14	0.67	7	5	-2
0007	2F	7_1	23	48	6	4800	5200	400	0.13	1.08	8	9	1
0007	2F	7_1	24	19	2	1900	710	-1190	0.11	0.37	3	1	-2
0007	2F	7_1	25	14	0	1400	0	-1400	0.00	0.00	2	0	-2
0007	2F	7_1	26	7	1	700	2040	1340	0.14	2.91	1	3	2
0007	2F	7_2	12	1192	375	119200	105790	-13410	0.31	0.89	210	187	-23
0007	2F	7_2	13	691	178	69100	58570	-10530	0.26	0.85	122	103	-19
0007	2F	7_2	14	460	113	46000	39300	-6700	0.25	0.85	81	69	-12
0007	2F	7_2	15	168	24	16800	10270	-6530	0.14	0.61	29	18	-11
0007	2F	7_2	16	97	16	9700	5820	-3880	0.16	0.60	17	10	-7
0007	2F	7_2	23	69	11	6900	8690	1790	0.16	1.26	12	15	3
0007	2F	7_2	24	36	5	3600	1600	-2000	0.14	0.44	6	2	-4
0007	2F	7_2	25	35	1	3500	480	-3020	0.03	0.14	6	0	-6
0007	2F	7_2	26	14	0	1400	0	-1400	0.00	0.00	2	0	-2
0007	2F	7_3	12	1281	410	128100	112420	-15680	0.32	0.88	226	198	-28
0007	2F	7_3	13	741	195	74100	59940	-14160	0.26	0.81	131	106	-25
0007	2F	7_3	14	434	76	43400	32020	-11380	0.18	0.74	76	56	-20
0007	2F	7_3	15	171	23	17100	15470	-1630	0.13	0.90	30	27	-3
0007	2F	7_3	16	100	15	10000	8940	-1060	0.15	0.89	17	15	-2
0007	2F	7_3	23	35	2	3500	940	-2560	0.06	0.27	6	1	-5
0007	2F	7_3	24	31	3	3100	1800	-1300	0.10	0.58	5	3	-2
0007	2F	7_3	25	17	3	1700	3370	1670	0.18	1.98	3	5	2
0007	2F	7_3	26	14	2	1400	1180	-220	0.14	0.84	2	2	0
0007	2F	7_4	12	644	233	64400	57790	-6610	0.36	0.90	113	102	-11
0007	2F	7_4	13	358	79	35800	27690	-8110	0.22	0.77	63	49	-14
0007	2F	7_4	14	203	38	20300	17050	-3250	0.19	0.84	35	30	-5
0007	2F	7_4	15	67	6	6700	2670	-4030	0.09	0.40	11	4	-7
0007	2F	7_4	16	27	1	2700	540	-2160	0.04	0.20	4	0	-4
0007	2F	7_4	23	11	0	1100	0	-1100	0.00	0.00	1	0	-1
0007	2F	7_4	24	11	1	1100	1270	170	0.09	1.15	1	2	1
0007	2F	7_4	25	9	1	900	1240	340	0.11	1.38	1	2	1
0007	2F	7_4	26	1	0	100	0	-100	0.00	0.00	0	0	0
0007	2F	7_5	12	499	165	49900	38310	-11590	0.33	0.77	88	67	-21
0007	2F	7_5	13	214	56	21400	20720	-680	0.26	0.97	37	36	-1
0007	2F	7_5	14	120	21	12000	10560	-1440	0.18	0.88	21	18	-3
0007	2F	7_5	15	51	7	5100	5330	230	0.14	1.05	9	9	0
0007	2F	7_5	16	14	0	1400	0	-1400	0.00	0.00	2	0	-2
0007	2F	7_5	23	5	0	500	0	-500	0.00	0.00	0	0	0
0007	2F	7_5	24	1	0	100	0	-100	0.00	0.00	0	0	0
0007	2F	7_5	25	1	1	100	2040	1940	1.00	20.40	0	3	3
0007	2F	7_6	12	336	107	33600	24930	-8670	0.32	0.74	59	44	-15
0007	2F	7_6	13	145	24	14500	8320	-6180	0.17	0.57	25	14	-11
0007	2F	7_6	14	99	22	9900	11590	1690	0.22	1.17	17	20	3
0007	2F	7_6	15	27	2	2700	1320	-1380	0.07	0.49	4	2	-2
0007	2F	7_6	16	11	1	1100	1020	-80	0.09	0.93	1	1	0
0007	2F	7_6	23	3	0	300	0	-300	0.00	0.00	0	0	0
0007	2F	7_6	24	1	0	100	0	-100	0.00	0.00	0	0	0
0007	2T	1_0	12	212	39	21200	14320	-6880	0.18	0.68	37	25	-12
0007	2T	1_0	13	158	16	15800	6940	-8860	0.10	0.44	27	12	-15
0007	2T	1_0	14	91	13	9100	8480	-620	0.14	0.93	16	15	-1
0007	2T	1_0	15	39	3	3900	2710	-1190	0.08	0.69	6	4	-2
0007	2T	1_0	16	4	1	400	520	120	0.25	1.30	0	0	0
0007	2T	1_0	21	31	4	3100	4500	1400	0.13	1.45	5	7	2
0007	2T	1_0	23	11	0	1100	0	-1100	0.00	0.00	1	0	-1
0007	2T	1_0	24	16	2	1600	5050	3450	0.13	3.16	2	8	6
0007	2T	1_0	25	3	0	300	0	-300	0.00	0.00	0	0	0
0007	2T	1_1	12	512	95	51200	32910	-18290	0.19	0.64	90	58	-32
0007	2T	1_1	13	409	80	40900	32640	-8260	0.20	0.80	72	57	-15
0007	2T	1_1	14	232	27	23200	13110	-10090	0.12	0.57	41	23	-18
0007	2T	1_1	15	86	10	8600	7520	-1080	0.12	0.87	15	13	-2
0007	2T	1_1	16	19	1	1900	350	-1550	0.05	0.18	3	0	-3
0007	2T	1_1	21	26	2	2600	4080	1480	0.08	1.57	4	7	3
0007	2T	1_1	23	19	0	1900	0	-1900	0.00	0.00	3	0	-3
0007	2T	1_1	24	21	0	2100	0	-2100	0.00	0.00	3	0	-3
0007	2T	1_1	25	8	0	800	0	-800	0.00	0.00	1	0	-1
0007	2T	1_1	26	2	0	200	0	-200	0.00	0.00	0	0	0
0007	2T	1_2	12	603	111	60300	52890	-7410	0.18	0.88	106	93	-13
0007	2T	1_2	13	477	65	47700	29530	-18170	0.14	0.62	84	52	-32
0007	2T	1_2	14	337	55	33700	30560	-3140	0.16	0.91	59	54	-5
0007	2T	1_2	15	106	7	10600	7080	-3520	0.07	0.67	18	12	-6
0007	2T	1_2	16	58	5	5800	8880	3080	0.09	1.53	10	15	5
0007	2T	1_2	21	127	14	12700	11480	-1220	0.11	0.90	22	20	-2
0007	2T	1_2	23	72	4	7200	5550	-1650	0.06	0.77	12	9	-3
0007	2T	1_2	24	46	4	4600	6290	1690	0.09	1.37	8	11	3
0007	2T	1_2	25	25	0	2500	0	-2500	0.00	0.00	4	0	-4
0007	2T	1_2	26	13	0	1300	0	-1300	0.00	0.00	2	0	-2
0007	2T	1_3	12	1013	185	101300	82020	-19280	0.18	0.81	179	145	-34
0007	2T	1_3	13	813	128	81300	54370	-26930	0.16	0.67	143	96	-47
0007	2T	1_3	14	540	86	54000	46550	-7450	0.16	0.86	95	82	-13
0007	2T	1_3	15	210	18	21000	13490	-7510	0.09	0.64	37	23	-14
0007	2T	1_3	16	130	13	13000	21420	8420	0.10	1.65	23	37	14
0007	2T	1_3	21	262	32	26200	21980	-4220	0.12	0.84	46	38	-8
0007	2T	1_3	23	123	14	12300	13330	1030	0.11	1.08	21	23	2
0007	2T	1_3	24	115	5	11500	6170	-5330	0.04	0.54	20	10	-10
0007	2T	1_3	25	38	0	3800	0	-3800	0.00	0.00	6	0	-6
0007	2T	1_3	26	35	2	3500	4930	1430	0.06	1.41	6	8	2
0007	2T	1_4	12	655	150	65500	60160	-5340	0.23	0.92	115	106	-9
0007	2T	1_4	13	492	86	49200	37460	-11740	0.17	0.76	87	66	-21
0007	2T	1_4	14	327	45	32700	24130	-8570	0.14	0.74	57	42	-15
0007	2T	1_4	15	103	9	10300	8160	-2140	0.09	0.79	18	14	-4
0007	2T	1_4	16	71	3	7100	4380	-2720	0.04	0.62	12	7	-5
0007	2T	1_4	21	95	10	9500	7300	-2200	0.11	0.77	16	12	-4
0007	2T	1_4	23	46	4	4600	3340	-1260	0.09	0.73	8	5	-3
0007	2T	1_4	24	36	2	3600	1370	-2230	0.06	0.38	6	2	-4
0007	2T	1_4	25	20	1	2000	1120	-880	0.05	0.56	3	1	-2
0007	2T	1_4	26	3	0	300	0	-300	0.00	0.00	0	0	0
0007	2T	1_5	12	131	27	13100	8470	-4630	0.21	0.65	23	14	-9
0007	2T	1_5	13	90	14	9000	8450	-550	0.16	0.94	15	14	-1
0007	2T	1_5	14	65	5	6500	1560	-4940	0.08	0.24	11	2	-9
0007	2T	1_5	15	23	1	2300	1020	-1280	0.04	0.44	4	1	-3
0007	2T	1_5	16	8	0	800	0	-800	0.00	0.00	1	0	-1
0007	2T	1_5	21	7	0	700	0	-700	0.00	0.00	1	0	-1
0007	2T	1_5	23	7	0	700	0	-700	0.00	0.00	1	0	-1
0007	2T	1_5	24	4	0	400	0	-400	0.00	0.00	0	0	0
0007	2T	1_5	25	2	0	200	0	-200	0.00	0.00	0	0	0
0007	2T	1_5	26	2	0	200	0	-200	0.00	0.00	0	0	0
0007	2T	1_6	12	434	105	43400	33760	-9640	0.24	0.78	76	59	-17
0007	2T	1_6	13	318	63	31800	24740	-7060	0.20	0.78	56	43	-13
0007	2T	1_6	14	199	39	19900	21820	1920	0.20	1.10	35	38	3
0007	2T	1_6	15	83	10	8300	8670	370	0.12	1.04	14	15	1
0007	2T	1_6	16	19	1	1900	850	-1050	0.05	0.45	3	1	-2
0007	2T	1_6	21	13	2	1300	2910	1610	0.15	2.24	2	5	3
0007	2T	1_6	23	6	0	600	0	-600	0.00	0.00	1	0	-1
0007	2T	1_6	24	3	0	300	0	-300	0.00	0.00	0	0	0
0007	2T	1_6	25	3	1	300	2630	2330	0.33	8.77	0	4	4
0007	2T	1_6	26	1	0	100	0	-100	0.00	0.00	0	0	0
0007	2T	2_0	12	148	42	14800	16360	1560	0.28	1.11	26	28	2
0007	2T	2_0	13	122	17	12200	9270	-2930	0.14	0.76	21	16	-5
0007	2T	2_0	14	45	6	4500	3820	-680	0.13	0.85	7	6	-1
0007	2T	2_0	15	41	3	4100	2010	-2090	0.07	0.49	7	3	-4
0007	2T	2_0	16	29	1	2900	630	-2270	0.03	0.22	5	1	-4
0007	2T	2_0	21	26	0	2600	0	-2600	0.00	0.00	4	0	-4
0007	2T	2_0	23	19	1	1900	2950	1050	0.05	1.55	3	5	2
0007	2T	2_0	24	11	0	1100	0	-1100	0.00	0.00	1	0	-1
0007	2T	2_0	25	5	1	500	1310	810	0.20	2.62	0	2	2
0007	2T	2_0	26	6	0	600	0	-600	0.00	0.00	1	0	-1
0007	2T	2_1	12	467	134	46700	46560	-140	0.29	1.00	82	82	0
0007	2T	2_1	13	304	61	30400	21800	-8600	0.20	0.72	53	38	-15
0007	2T	2_1	14	211	41	21100	16820	-4280	0.19	0.80	37	29	-8
0007	2T	2_1	15	95	11	9500	4440	-5060	0.12	0.47	16	7	-9
0007	2T	2_1	16	64	6	6400	5530	-870	0.09	0.86	11	9	-2
0007	2T	2_1	21	34	4	3400	1520	-1880	0.12	0.45	6	2	-4
0007	2T	2_1	23	13	2	1300	2210	910	0.15	1.70	2	3	1
0007	2T	2_1	24	15	1	1500	8630	7130	0.07	5.75	2	15	13
0007	2T	2_1	25	7	0	700	0	-700	0.00	0.00	1	0	-1
0007	2T	2_1	26	7	1	700	1570	870	0.14	2.24	1	2	1
0007	2T	2_2	12	693	144	69300	56050	-13250	0.21	0.81	122	99	-23
0007	2T	2_2	13	409	99	40900	46290	5390	0.24	1.13	72	81	9
0007	2T	2_2	14	317	51	31700	19890	-11810	0.16	0.63	56	35	-21
0007	2T	2_2	15	111	22	11100	17890	6790	0.20	1.61	19	31	12
0007	2T	2_2	16	101	14	10100	11470	1370	0.14	1.14	17	20	3
0007	2T	2_2	21	105	17	10500	15180	4680	0.16	1.45	18	26	8
0007	2T	2_2	23	71	5	7100	4110	-2990	0.07	0.58	12	7	-5
0007	2T	2_2	24	42	5	4200	13420	9220	0.12	3.20	7	23	16
0007	2T	2_2	25	23	3	2300	3180	880	0.13	1.38	4	5	1
0007	2T	2_2	26	32	1	3200	1110	-2090	0.03	0.35	5	1	-4
0007	2T	2_3	12	1239	240	123900	96060	-27840	0.19	0.78	219	170	-49
0007	2T	2_3	13	809	153	80900	68420	-12480	0.19	0.85	143	121	-22
0007	2T	2_3	14	473	67	47300	39870	-7430	0.14	0.84	83	70	-13
0007	2T	2_3	15	240	34	24000	24390	390	0.14	1.02	42	43	1
0007	2T	2_3	16	223	27	22300	23170	870	0.12	1.04	39	41	2
0007	2T	2_3	21	179	34	17900	22110	4210	0.19	1.24	31	39	8
0007	2T	2_3	23	103	4	10300	2670	-7630	0.04	0.26	18	4	-14
0007	2T	2_3	24	66	6	6600	3640	-2960	0.09	0.55	11	6	-5
0007	2T	2_3	25	43	4	4300	3380	-920	0.09	0.79	7	5	-2
0007	2T	2_3	26	48	5	4800	9440	4640	0.10	1.97	8	16	8
0007	2T	2_4	12	1019	230	101900	91060	-10840	0.23	0.89	180	161	-19
0007	2T	2_4	13	631	115	63100	47480	-15620	0.18	0.75	111	84	-27
0007	2T	2_4	14	383	63	38300	26190	-12110	0.16	0.68	67	46	-21
0007	2T	2_4	15	146	16	14600	7680	-6920	0.11	0.53	25	13	-12
0007	2T	2_4	16	86	8	8600	7160	-1440	0.09	0.83	15	12	-3
0007	2T	2_4	21	56	10	5600	6640	1040	0.18	1.19	9	11	2
0007	2T	2_4	23	22	3	2200	1800	-400	0.14	0.82	3	3	0
0007	2T	2_4	24	16	1	1600	1680	80	0.06	1.05	2	2	0
0007	2T	2_4	25	14	3	1400	2370	970	0.21	1.69	2	4	2
0007	2T	2_4	26	15	2	1500	2220	720	0.13	1.48	2	3	1
0007	2T	2_5	12	341	89	34100	28950	-5150	0.26	0.85	60	51	-9
0007	2T	2_5	13	153	28	15300	9880	-5420	0.18	0.65	27	17	-10
0007	2T	2_5	14	111	20	11100	7190	-3910	0.18	0.65	19	12	-7
0007	2T	2_5	15	27	6	2700	5330	2630	0.22	1.97	4	9	5
0007	2T	2_5	16	6	0	600	0	-600	0.00	0.00	1	0	-1
0007	2T	2_5	21	4	2	400	1200	800	0.50	3.00	0	2	2
0007	2T	2_5	23	1	0	100	0	-100	0.00	0.00	0	0	0
0007	2T	2_6	12	252	50	25200	16020	-9180	0.20	0.64	44	28	-16
0007	2T	2_6	13	95	23	9500	8320	-1180	0.24	0.88	16	14	-2
0007	2T	2_6	14	86	12	8600	5300	-3300	0.14	0.62	15	9	-6
0007	2T	2_6	15	18	1	1800	540	-1260	0.06	0.30	3	0	-3
0007	2T	2_6	16	6	0	600	0	-600	0.00	0.00	1	0	-1
0007	2T	2_6	21	1	0	100	0	-100	0.00	0.00	0	0	0
0007	2T	2_6	24	2	0	200	0	-200	0.00	0.00	0	0	0
0007	2T	3_0	12	172	39	17200	17940	740	0.23	1.04	30	31	1
0007	2T	3_0	13	136	21	13600	10970	-2630	0.15	0.81	24	19	-5
0007	2T	3_0	14	91	8	9100	5150	-3950	0.09	0.57	16	9	-7
0007	2T	3_0	15	31	2	3100	2530	-570	0.06	0.82	5	4	-1
0007	2T	3_0	16	14	0	1400	0	-1400	0.00	0.00	2	0	-2
0007	2T	3_0	21	17	0	1700	0	-1700	0.00	0.00	3	0	-3
0007	2T	3_0	23	12	1	1200	550	-650	0.08	0.46	2	0	-2
0007	2T	3_0	24	10	0	1000	0	-1000	0.00	0.00	1	0	-1
0007	2T	3_0	25	7	0	700	0	-700	0.00	0.00	1	0	-1
0007	2T	3_0	26	2	0	200	0	-200	0.00	0.00	0	0	0
0007	2T	3_1	12	479	124	47900	42840	-5060	0.26	0.89	84	75	-9
0007	2T	3_1	13	363	62	36300	21830	-14470	0.17	0.60	64	38	-26
0007	2T	3_1	14	199	22	19900	8640	-11260	0.11	0.43	35	15	-20
0007	2T	3_1	15	84	14	8400	9370	970	0.17	1.12	14	16	2
0007	2T	3_1	16	46	6	4600	8290	3690	0.13	1.80	8	14	6
0007	2T	3_1	21	43	3	4300	2050	-2250	0.07	0.48	7	3	-4
0007	2T	3_1	23	30	2	3000	3240	240	0.07	1.08	5	5	0
0007	2T	3_1	24	21	1	2100	500	-1600	0.05	0.24	3	0	-3
0007	2T	3_1	25	10	0	1000	0	-1000	0.00	0.00	1	0	-1
0007	2T	3_1	26	6	1	600	1420	820	0.17	2.37	1	2	1
0007	2T	3_2	12	662	147	66200	65590	-610	0.22	0.99	117	116	-1
0007	2T	3_2	13	431	72	43100	38000	-5100	0.17	0.88	76	67	-9
0007	2T	3_2	14	245	39	24500	17430	-7070	0.16	0.71	43	30	-13
0007	2T	3_2	15	134	13	13400	7440	-5960	0.10	0.56	23	13	-10
0007	2T	3_2	16	71	4	7100	8830	1730	0.06	1.24	12	15	3
0007	2T	3_2	21	122	12	12200	10810	-1390	0.10	0.89	21	19	-2
0007	2T	3_2	23	81	2	8100	1530	-6570	0.02	0.19	14	2	-12
0007	2T	3_2	24	37	3	3700	4270	570	0.08	1.15	6	7	1
0007	2T	3_2	25	29	0	2900	0	-2900	0.00	0.00	5	0	-5
0007	2T	3_2	26	24	1	2400	2620	220	0.04	1.09	4	4	0
0007	2T	3_3	12	1031	205	103100	90200	-12900	0.20	0.87	182	159	-23
0007	2T	3_3	13	809	157	80900	81480	580	0.19	1.01	143	144	1
0007	2T	3_3	14	422	48	42200	23390	-18810	0.11	0.55	74	41	-33
0007	2T	3_3	15	254	28	25400	26740	1340	0.11	1.05	44	47	3
0007	2T	3_3	16	127	9	12700	9640	-3060	0.07	0.76	22	17	-5
0007	2T	3_3	21	246	29	24600	17010	-7590	0.12	0.69	43	30	-13
0007	2T	3_3	23	157	9	15700	6470	-9230	0.06	0.41	27	11	-16
0007	2T	3_3	24	84	10	8400	7210	-1190	0.12	0.86	14	12	-2
0007	2T	3_3	25	83	5	8300	4740	-3560	0.06	0.57	14	8	-6
0007	2T	3_3	26	58	3	5800	2940	-2860	0.05	0.51	10	5	-5
0007	2T	3_4	12	913	206	91300	78600	-12700	0.23	0.86	161	139	-22
0007	2T	3_4	13	669	116	66900	51500	-15400	0.17	0.77	118	91	-27
0007	2T	3_4	14	369	50	36900	33420	-3480	0.14	0.91	65	59	-6
0007	2T	3_4	15	200	27	20000	21770	1770	0.14	1.09	35	38	3
0007	2T	3_4	16	101	7	10100	9080	-1020	0.07	0.90	17	16	-1
0007	2T	3_4	21	81	9	8100	5540	-2560	0.11	0.68	14	9	-5
0007	2T	3_4	23	46	2	4600	1530	-3070	0.04	0.33	8	2	-6
0007	2T	3_4	24	28	4	2800	3800	1000	0.14	1.36	4	6	2
0007	2T	3_4	25	22	1	2200	4820	2620	0.05	2.19	3	8	5
0007	2T	3_4	26	13	1	1300	1570	270	0.08	1.21	2	2	0
0007	2T	3_5	12	324	80	32400	24720	-7680	0.25	0.76	57	43	-14
0007	2T	3_5	13	176	42	17600	13980	-3620	0.24	0.79	31	24	-7
0007	2T	3_5	14	132	29	13200	14400	1200	0.22	1.09	23	25	2
0007	2T	3_5	15	53	4	5300	3020	-2280	0.08	0.57	9	5	-4
0007	2T	3_5	16	18	1	1800	890	-910	0.06	0.49	3	1	-2
0007	2T	3_5	21	8	3	800	3720	2920	0.38	4.65	1	6	5
0007	2T	3_5	23	1	0	100	0	-100	0.00	0.00	0	0	0
0007	2T	3_5	24	3	0	300	0	-300	0.00	0.00	0	0	0
0007	2T	3_5	26	2	0	200	0	-200	0.00	0.00	0	0	0
0007	2T	3_6	12	106	27	10600	8300	-2300	0.25	0.78	18	14	-4
0007	2T	3_6	13	68	18	6800	6600	-200	0.26	0.97	12	11	-1
0007	2T	3_6	14	52	8	5200	3210	-1990	0.15	0.62	9	5	-4
0007	2T	3_6	15	17	2	1700	1070	-630	0.12	0.63	3	1	-2
0007	2T	3_6	16	9	0	900	0	-900	0.00	0.00	1	0	-1
0007	2T	3_6	21	4	0	400	0	-400	0.00	0.00	0	0	0
0007	2T	3_6	24	1	0	100	0	-100	0.00	0.00	0	0	0
0007	2T	4_0	12	105	19	10500	8560	-1940	0.18	0.82	18	15	-3
0007	2T	4_0	13	81	14	8100	6700	-1400	0.17	0.83	14	11	-3
0007	2T	4_0	14	39	7	3900	4330	430	0.18	1.11	6	7	1
0007	2T	4_0	15	39	2	3900	1400	-2500	0.05	0.36	6	2	-4
0007	2T	4_0	16	19	2	1900	2030	130	0.11	1.07	3	3	0
0007	2T	4_0	21	21	1	2100	610	-1490	0.05	0.29	3	1	-2
0007	2T	4_0	23	19	1	1900	3180	1280	0.05	1.67	3	5	2
0007	2T	4_0	24	8	1	800	460	-340	0.13	0.58	1	0	-1
0007	2T	4_0	25	4	0	400	0	-400	0.00	0.00	0	0	0
0007	2T	4_0	26	5	0	500	0	-500	0.00	0.00	0	0	0
0007	2T	4_1	12	435	123	43500	38160	-5340	0.28	0.88	76	67	-9
0007	2T	4_1	13	276	61	27600	20700	-6900	0.22	0.75	48	36	-12
0007	2T	4_1	14	162	25	16200	11930	-4270	0.15	0.74	28	21	-7
0007	2T	4_1	15	61	11	6100	5550	-550	0.18	0.91	10	9	-1
0007	2T	4_1	16	44	5	4400	7270	2870	0.11	1.65	7	12	5
0007	2T	4_1	21	33	7	3300	4740	1440	0.21	1.44	5	8	3
0007	2T	4_1	23	24	1	2400	990	-1410	0.04	0.41	4	1	-3
0007	2T	4_1	24	14	0	1400	0	-1400	0.00	0.00	2	0	-2
0010	2F	4_3	24	46	12	4600	3380	-1220	0.26	0.73	8	5	-3
0010	2F	4_3	25	29	6	2900	2130	-770	0.21	0.73	5	3	-2
0010	2F	4_3	26	26	3	2600	1320	-1280	0.12	0.51	4	2	-2
0010	2F	4_4	12	1351	450	135100	110560	-24540	0.33	0.82	239	195	-44
0010	2F	4_4	13	466	162	46600	41620	-4980	0.35	0.89	82	73	-9
0010	2F	4_4	14	217	56	21700	15940	-5760	0.26	0.73	38	28	-10
0010	2F	4_4	15	32	5	3200	2170	-1030	0.16	0.68	5	3	-2
0010	2F	4_4	16	13	1	1300	790	-510	0.08	0.61	2	1	-1
0010	2F	4_4	23	16	2	1600	440	-1160	0.13	0.28	2	0	-2
0010	2F	4_4	24	14	2	1400	860	-540	0.14	0.61	2	1	-1
0010	2F	4_4	25	4	1	400	390	-10	0.25	0.98	0	0	0
0010	2F	4_4	26	5	3	500	1680	1180	0.60	3.36	0	2	2
0010	2F	4_5	12	625	208	62500	51650	-10850	0.33	0.83	110	91	-19
0010	2F	4_5	13	145	41	14500	10790	-3710	0.28	0.74	25	19	-6
0010	2F	4_5	14	34	7	3400	2370	-1030	0.21	0.70	6	4	-2
0010	2F	4_5	15	2	0	200	0	-200	0.00	0.00	0	0	0
0010	2F	4_5	16	1	0	100	0	-100	0.00	0.00	0	0	0
0010	2F	4_5	23	1	0	100	0	-100	0.00	0.00	0	0	0
0010	2F	4_6	12	266	91	26600	22240	-4360	0.34	0.84	47	39	-8
0010	2F	4_6	13	32	6	3200	1950	-1250	0.19	0.61	5	3	-2
0010	2F	4_6	14	5	1	500	740	240	0.20	1.48	0	1	1
0010	2F	5_-1	12	12	4	1200	1010	-190	0.33	0.84	2	1	-1
0010	2F	5_-1	13	6	4	600	770	170	0.67	1.28	1	1	0
0010	2F	5_-1	14	3	0	300	0	-300	0.00	0.00	0	0	0
0010	2F	5_0	12	257	81	25700	21880	-3820	0.32	0.85	45	38	-7
0010	2F	5_0	13	127	36	12700	11680	-1020	0.28	0.92	22	20	-2
0010	2F	5_0	14	36	7	3600	1800	-1800	0.19	0.50	6	3	-3
0010	2F	5_0	15	30	5	3000	2220	-780	0.17	0.74	5	3	-2
0010	2F	5_0	16	5	0	500	0	-500	0.00	0.00	0	0	0
0010	2F	5_0	23	1	0	100	0	-100	0.00	0.00	0	0	0
0010	2F	5_1	12	578	191	57800	48220	-9580	0.33	0.83	102	85	-17
0010	2F	5_1	13	203	52	20300	13140	-7160	0.26	0.65	35	23	-12
0010	2F	5_1	14	142	36	14200	9910	-4290	0.25	0.70	25	17	-8
0010	2F	5_1	15	42	7	4200	3360	-840	0.17	0.80	7	5	-2
0010	2F	5_1	16	29	4	2900	1500	-1400	0.14	0.52	5	2	-3
0010	2F	5_1	23	2	0	200	0	-200	0.00	0.00	0	0	0
0010	2F	5_1	25	1	0	100	0	-100	0.00	0.00	0	0	0
0010	2F	5_1	26	1	0	100	0	-100	0.00	0.00	0	0	0
0010	2F	5_2	12	601	217	60100	54100	-6000	0.36	0.90	106	95	-11
0010	2F	5_2	13	356	112	35600	27360	-8240	0.31	0.77	63	48	-15
0010	2F	5_2	14	330	107	33000	26970	-6030	0.32	0.82	58	47	-11
0010	2F	5_2	15	60	20	6000	9780	3780	0.33	1.63	10	17	7
0010	2F	5_2	16	35	10	3500	2740	-760	0.29	0.78	6	4	-2
0010	2F	5_2	23	12	2	1200	820	-380	0.17	0.68	2	1	-1
0010	2F	5_2	24	10	2	1000	600	-400	0.20	0.60	1	1	0
0010	2F	5_2	25	4	0	400	0	-400	0.00	0.00	0	0	0
0010	2F	5_2	26	2	0	200	0	-200	0.00	0.00	0	0	0
0010	2F	5_3	12	1058	375	105800	98260	-7540	0.35	0.93	187	173	-14
0010	2F	5_3	13	658	212	65800	51540	-14260	0.32	0.78	116	91	-25
0010	2F	5_3	14	420	121	42000	30250	-11750	0.29	0.72	74	53	-21
0010	2F	5_3	15	75	21	7500	7570	70	0.28	1.01	13	13	0
0010	2F	5_3	16	52	9	5200	5430	230	0.17	1.04	9	9	0
0010	2F	5_3	23	26	5	2600	1510	-1090	0.19	0.58	4	2	-2
0010	2F	5_3	24	14	2	1400	600	-800	0.14	0.43	2	1	-1
0010	2F	5_3	25	3	0	300	0	-300	0.00	0.00	0	0	0
0010	2F	5_3	26	10	2	1000	1120	120	0.20	1.12	1	1	0
0010	2F	5_4	12	955	341	95500	74340	-21160	0.36	0.78	169	131	-38
0010	2F	5_4	13	356	98	35600	27690	-7910	0.28	0.78	63	49	-14
0010	2F	5_4	14	129	39	12900	13710	810	0.30	1.06	22	24	2
0010	2F	5_4	15	17	1	1700	280	-1420	0.06	0.16	3	0	-3
0010	2F	5_4	16	5	0	500	0	-500	0.00	0.00	0	0	0
0010	2F	5_4	23	8	1	800	490	-310	0.13	0.61	1	0	-1
0010	2F	5_4	24	3	1	300	240	-60	0.33	0.80	0	0	0
0010	2F	5_4	25	1	1	100	1230	1130	1.00	12.30	0	2	2
0010	2F	5_4	26	3	0	300	0	-300	0.00	0.00	0	0	0
0010	2F	5_5	12	751	285	75100	60860	-14240	0.38	0.81	132	107	-25
0010	2F	5_5	13	96	20	9600	5640	-3960	0.21	0.59	16	9	-7
0010	2F	5_5	14	17	6	1700	2100	400	0.35	1.24	3	3	0
0010	2F	5_5	23	1	0	100	0	-100	0.00	0.00	0	0	0
0010	2F	5_6	12	260	90	26000	19200	-6800	0.35	0.74	46	33	-13
0010	2F	5_6	13	23	6	2300	2050	-250	0.26	0.89	4	3	-1
0010	2F	5_6	14	1	0	100	0	-100	0.00	0.00	0	0	0
0010	2F	6_0	12	20	3	2000	790	-1210	0.15	0.40	3	1	-2
0010	2F	6_0	13	10	4	1000	1100	100	0.40	1.10	1	1	0
0010	2F	6_0	14	3	0	300	0	-300	0.00	0.00	0	0	0
0010	2F	6_0	15	4	1	400	1100	700	0.25	2.75	0	1	1
0010	2F	6_0	16	1	0	100	0	-100	0.00	0.00	0	0	0
0010	2F	6_0	23	1	0	100	0	-100	0.00	0.00	0	0	0
0010	2F	6_1	12	32	13	3200	2980	-220	0.41	0.93	5	5	0
0010	2F	6_1	13	22	8	2200	2080	-120	0.36	0.95	3	3	0
0010	2F	6_1	14	13	1	1300	190	-1110	0.08	0.15	2	0	-2
0010	2F	6_1	15	2	1	200	230	30	0.50	1.15	0	0	0
0010	2F	6_1	16	2	1	200	400	200	0.50	2.00	0	0	0
0010	2F	6_2	12	27	11	2700	1890	-810	0.41	0.70	4	3	-1
0010	2F	6_2	13	22	8	2200	1680	-520	0.36	0.76	3	2	-1
0010	2F	6_2	14	24	5	2400	1130	-1270	0.21	0.47	4	2	-2
0010	2F	6_2	15	10	2	1000	510	-490	0.20	0.51	1	0	-1
0010	2F	6_2	16	2	0	200	0	-200	0.00	0.00	0	0	0
0010	2F	6_2	23	1	1	100	850	750	1.00	8.50	0	1	1
0010	2F	6_2	24	1	0	100	0	-100	0.00	0.00	0	0	0
0010	2F	6_3	12	93	28	9300	9500	200	0.30	1.02	16	16	0
0010	2F	6_3	13	45	15	4500	3250	-1250	0.33	0.72	7	5	-2
0010	2F	6_3	14	29	9	2900	2660	-240	0.31	0.92	5	4	-1
0010	2F	6_3	15	6	1	600	310	-290	0.17	0.52	1	0	-1
0010	2F	6_3	16	15	6	1500	2500	1000	0.40	1.67	2	4	2
0010	2F	6_3	23	1	0	100	0	-100	0.00	0.00	0	0	0
0010	2F	6_4	12	84	26	8400	6800	-1600	0.31	0.81	14	12	-2
0010	2F	6_4	13	37	15	3700	3930	230	0.41	1.06	6	6	0
0010	2F	6_4	14	16	3	1600	810	-790	0.19	0.51	2	1	-1
0010	2F	6_4	15	3	0	300	0	-300	0.00	0.00	0	0	0
0010	2F	6_4	16	5	1	500	600	100	0.20	1.20	0	1	1
0010	2F	6_5	12	63	28	6300	5590	-710	0.44	0.89	11	9	-2
0010	2F	6_5	13	8	0	800	0	-800	0.00	0.00	1	0	-1
0010	2F	6_5	16	1	0	100	0	-100	0.00	0.00	0	0	0
0010	2F	6_6	12	28	13	2800	2650	-150	0.46	0.95	4	4	0
0010	2F	6_6	13	1	0	100	0	-100	0.00	0.00	0	0	0
0010	2F	7_-1	12	15	6	1500	1210	-290	0.40	0.81	2	2	0
0010	2F	7_-1	13	4	2	400	730	330	0.50	1.83	0	1	1
0010	2F	7_-1	14	3	1	300	180	-120	0.33	0.60	0	0	0
0010	2F	7_-1	23	1	1	100	940	840	1.00	9.40	0	1	1
0010	2F	7_0	12	568	161	56800	46320	-10480	0.28	0.82	100	81	-19
0010	2F	7_0	13	231	54	23100	17470	-5630	0.23	0.76	40	30	-10
0010	2F	7_0	14	79	21	7900	7560	-340	0.27	0.96	13	13	0
0010	2F	7_0	15	35	7	3500	3150	-350	0.20	0.90	6	5	-1
0010	2F	7_0	16	13	2	1300	1840	540	0.15	1.42	2	3	1
0010	2F	7_0	23	11	2	1100	970	-130	0.18	0.88	1	1	0
0010	2F	7_0	25	2	0	200	0	-200	0.00	0.00	0	0	0
0010	2F	7_1	12	1292	451	129200	114840	-14360	0.35	0.89	228	203	-25
0010	2F	7_1	13	484	147	48400	40050	-8350	0.30	0.83	85	70	-15
0010	2F	7_1	14	289	72	28900	23580	-5320	0.25	0.82	51	41	-10
0010	2F	7_1	15	61	10	6100	4050	-2050	0.16	0.66	10	7	-3
0010	2F	7_1	16	41	8	4100	4780	680	0.20	1.17	7	8	1
0010	2F	7_1	23	16	2	1600	590	-1010	0.13	0.37	2	1	-1
0010	2F	7_1	24	8	1	800	890	90	0.13	1.11	1	1	0
0010	2F	7_1	25	3	2	300	690	390	0.67	2.30	0	1	1
0010	2F	7_1	26	1	0	100	0	-100	0.00	0.00	0	0	0
0010	2F	7_2	12	1519	553	151900	137960	-13940	0.36	0.91	268	244	-24
0010	2F	7_2	13	750	235	75000	59550	-15450	0.31	0.79	132	105	-27
0010	2F	7_2	14	518	165	51800	40080	-11720	0.32	0.77	91	70	-21
0010	2F	7_2	15	148	28	14800	11010	-3790	0.19	0.74	26	19	-7
0010	2F	7_2	16	115	25	11500	10500	-1000	0.22	0.91	20	18	-2
0010	2F	7_2	23	30	9	3000	3350	350	0.30	1.12	5	5	0
0010	2F	7_2	24	12	4	1200	1100	-100	0.33	0.92	2	1	-1
0010	2F	7_2	25	7	0	700	0	-700	0.00	0.00	1	0	-1
0010	2F	7_2	26	13	2	1300	960	-340	0.15	0.74	2	1	-1
0010	2F	7_3	12	1697	559	169700	137880	-31820	0.33	0.81	300	244	-56
0010	2F	7_3	13	874	261	87400	63380	-24020	0.30	0.73	154	112	-42
0010	2F	7_3	14	423	111	42300	31320	-10980	0.26	0.74	74	55	-19
0010	2F	7_3	15	90	18	9000	6620	-2380	0.20	0.74	15	11	-4
0010	2F	7_3	16	92	17	9200	8950	-250	0.18	0.97	16	15	-1
0010	2F	7_3	23	19	7	1900	3180	1280	0.37	1.67	3	5	2
0010	2F	7_3	24	19	1	1900	240	-1660	0.05	0.13	3	0	-3
0010	2F	7_3	25	8	0	800	0	-800	0.00	0.00	1	0	-1
0010	2F	7_3	26	8	2	800	1850	1050	0.25	2.31	1	3	2
0010	2F	7_4	12	1049	366	104900	90400	-14500	0.35	0.86	185	160	-25
0010	2F	7_4	13	324	87	32400	24140	-8260	0.27	0.75	57	42	-15
0010	2F	7_4	14	105	19	10500	5620	-4880	0.18	0.54	18	9	-9
0010	2F	7_4	15	10	3	1000	1040	40	0.30	1.04	1	1	0
0010	2F	7_4	16	13	0	1300	0	-1300	0.00	0.00	2	0	-2
0010	2F	7_4	23	6	2	600	870	270	0.33	1.45	1	1	0
0010	2F	7_4	24	4	1	400	280	-120	0.25	0.70	0	0	0
0010	2F	7_4	25	3	0	300	0	-300	0.00	0.00	0	0	0
0010	2F	7_5	12	896	283	89600	66970	-22630	0.32	0.75	158	118	-40
0010	2F	7_5	13	111	33	11100	10770	-330	0.30	0.97	19	19	0
0010	2F	7_5	14	14	4	1400	1090	-310	0.29	0.78	2	1	-1
0010	2F	7_5	15	1	0	100	0	-100	0.00	0.00	0	0	0
0010	2F	7_5	16	2	0	200	0	-200	0.00	0.00	0	0	0
0010	2F	7_6	12	682	211	68200	51050	-17150	0.31	0.75	120	90	-30
0010	2F	7_6	13	26	4	2600	1980	-620	0.15	0.76	4	3	-1
0010	2F	7_6	14	3	0	300	0	-300	0.00	0.00	0	0	0
0010	2F	7_6	16	1	0	100	0	-100	0.00	0.00	0	0	0
0010	2T	1_-1	12	11	3	1100	800	-300	0.27	0.73	1	1	0
0010	2T	1_-1	13	3	1	300	360	60	0.33	1.20	0	0	0
0010	2T	1_-1	14	1	0	100	0	-100	0.00	0.00	0	0	0
0010	2T	1_-1	23	2	0	200	0	-200	0.00	0.00	0	0	0
0010	2T	1_0	12	685	128	68500	56900	-11600	0.19	0.83	121	100	-21
0010	2T	1_0	13	16	3	1600	1250	-350	0.19	0.78	2	2	0
0010	2T	1_1	12	719	169	71900	47630	-24270	0.24	0.66	127	84	-43
0010	2T	1_1	13	308	64	30800	21240	-9560	0.21	0.69	54	37	-17
0010	2T	1_1	14	129	20	12900	7430	-5470	0.16	0.58	22	13	-9
0010	2T	1_1	15	99	18	9900	10300	400	0.18	1.04	17	18	1
0010	2T	1_1	16	25	2	2500	1830	-670	0.08	0.73	4	3	-1
0010	2T	1_1	21	7	1	700	740	40	0.14	1.06	1	1	0
0010	2T	1_1	23	23	4	2300	3100	800	0.17	1.35	4	5	1
0010	2T	1_2	12	610	143	61000	41150	-19850	0.23	0.67	107	72	-35
0010	2T	1_2	13	294	67	29400	26330	-3070	0.23	0.90	52	46	-6
0010	2T	1_2	14	420	93	42000	39510	-2490	0.22	0.94	74	69	-5
0010	2T	1_2	15	62	6	6200	2170	-4030	0.10	0.35	10	3	-7
0010	2T	1_2	16	88	10	8800	5560	-3240	0.11	0.63	15	9	-6
0010	2T	1_2	21	98	16	9800	9060	-740	0.16	0.92	17	16	-1
0010	2T	1_2	23	56	6	5600	6890	1290	0.11	1.23	9	12	3
0010	2T	1_2	24	92	11	9200	6410	-2790	0.12	0.70	16	11	-5
0010	2T	1_2	25	17	2	1700	1170	-530	0.12	0.69	3	2	-1
0010	2T	1_2	26	60	6	6000	7510	1510	0.10	1.25	10	13	3
0010	2T	1_3	12	778	202	77800	67580	-10220	0.26	0.87	137	119	-18
0010	2T	1_3	13	888	205	88800	67270	-21530	0.23	0.76	157	119	-38
0010	2T	1_3	14	494	96	49400	36310	-13090	0.19	0.74	87	64	-23
0010	2T	1_3	15	222	34	22200	19180	-3020	0.15	0.86	39	33	-6
0010	2T	1_3	16	280	34	28000	23380	-4620	0.12	0.84	49	41	-8
0010	2T	1_3	21	426	54	42600	44700	2100	0.13	1.05	75	79	4
0010	2T	1_3	23	76	10	7600	8070	470	0.13	1.06	13	14	1
0010	2T	1_3	24	90	6	9000	3890	-5110	0.07	0.43	15	6	-9
0010	2T	1_3	25	64	4	6400	2400	-4000	0.06	0.38	11	4	-7
0010	2T	1_3	26	95	7	9500	4330	-5170	0.07	0.46	16	7	-9
0010	2T	1_4	12	815	197	81500	66390	-15110	0.24	0.81	144	117	-27
0010	2T	1_4	13	497	119	49700	37150	-12550	0.24	0.75	87	65	-22
0010	2T	1_4	14	322	56	32200	23810	-8390	0.17	0.74	56	42	-14
0010	2T	1_4	15	73	8	7300	6470	-830	0.11	0.89	12	11	-1
0010	2T	1_4	16	41	5	4100	4130	30	0.12	1.01	7	7	0
0010	2T	1_4	21	170	17	17000	13920	-3080	0.10	0.82	30	24	-6
0010	2T	1_4	23	10	1	1000	360	-640	0.10	0.36	1	0	-1
0010	2T	1_4	24	13	1	1300	340	-960	0.08	0.26	2	0	-2
0010	2T	1_4	25	10	0	1000	0	-1000	0.00	0.00	1	0	-1
0010	2T	1_4	26	10	0	1000	0	-1000	0.00	0.00	1	0	-1
0010	2T	1_5	12	172	40	17200	12120	-5080	0.23	0.70	30	21	-9
0010	2T	1_5	13	99	13	9900	4860	-5040	0.13	0.49	17	8	-9
0010	2T	1_5	14	55	13	5500	5410	-90	0.24	0.98	9	9	0
0010	2T	1_5	15	4	0	400	0	-400	0.00	0.00	0	0	0
0010	2T	1_5	21	10	0	1000	0	-1000	0.00	0.00	1	0	-1
0010	2T	1_5	26	1	0	100	0	-100	0.00	0.00	0	0	0
0010	2T	1_6	12	947	226	94700	75080	-19620	0.24	0.79	167	132	-35
0010	2T	1_6	13	131	20	13100	7070	-6030	0.15	0.54	23	12	-11
0010	2T	1_6	14	19	6	1900	2530	630	0.32	1.33	3	4	1
0010	2T	1_6	21	2	0	200	0	-200	0.00	0.00	0	0	0
0010	2T	2_-1	12	10	0	1000	0	-1000	0.00	0.00	1	0	-1
0010	2T	2_-1	13	3	0	300	0	-300	0.00	0.00	0	0	0
0010	2T	2_-1	14	7	3	700	1140	440	0.43	1.63	1	2	1
0010	2T	2_-1	16	1	0	100	0	-100	0.00	0.00	0	0	0
0010	2T	2_0	12	231	58	23100	21900	-1200	0.25	0.95	40	38	-2
0010	2T	2_0	13	158	25	15800	11180	-4620	0.16	0.71	27	19	-8
0010	2T	2_0	14	47	7	4700	2920	-1780	0.15	0.62	8	5	-3
0010	2T	2_0	15	19	1	1900	560	-1340	0.05	0.29	3	0	-3
0010	2T	2_0	16	13	2	1300	1080	-220	0.15	0.83	2	1	-1
0010	2T	2_0	23	8	1	800	430	-370	0.13	0.54	1	0	-1
0010	2T	2_0	24	4	0	400	0	-400	0.00	0.00	0	0	0
0010	2T	2_0	25	2	0	200	0	-200	0.00	0.00	0	0	0
0010	2T	2_0	26	3	0	300	0	-300	0.00	0.00	0	0	0
0010	2T	2_1	12	770	215	77000	63190	-13810	0.28	0.82	136	111	-25
0010	2T	2_1	13	301	73	30100	20140	-9960	0.24	0.67	53	35	-18
0010	2T	2_1	14	181	40	18100	14990	-3110	0.22	0.83	32	26	-6
0010	2T	2_1	15	66	10	6600	6430	-170	0.15	0.97	11	11	0
0010	2T	2_1	16	53	9	5300	4490	-810	0.17	0.85	9	7	-2
0010	2T	2_1	23	4	0	400	0	-400	0.00	0.00	0	0	0
0010	2T	2_1	24	2	0	200	0	-200	0.00	0.00	0	0	0
0010	2T	2_1	25	4	1	400	2070	1670	0.25	5.18	0	3	3
0010	2T	2_1	26	5	0	500	0	-500	0.00	0.00	0	0	0
0010	2T	2_2	12	948	203	94800	67970	-26830	0.21	0.72	167	120	-47
0010	2T	2_2	13	487	116	48700	39360	-9340	0.24	0.81	86	69	-17
0010	2T	2_2	14	387	96	38700	31330	-7370	0.25	0.81	68	55	-13
0010	2T	2_2	15	113	28	11300	11900	600	0.25	1.05	20	21	1
0010	2T	2_2	16	103	14	10300	15250	4950	0.14	1.48	18	26	8
0010	2T	2_2	23	18	3	1800	4750	2950	0.17	2.64	3	8	5
0010	2T	2_2	24	15	2	1500	2320	820	0.13	1.55	2	4	2
0010	2T	2_2	25	11	0	1100	0	-1100	0.00	0.00	1	0	-1
0010	2T	2_2	26	18	2	1800	580	-1220	0.11	0.32	3	1	-2
0010	2T	2_3	12	1847	366	184700	144440	-40260	0.20	0.78	326	255	-71
0010	2T	2_3	13	1021	223	102100	87260	-14840	0.22	0.85	180	154	-26
0010	2T	2_3	14	463	100	46300	39880	-6420	0.22	0.86	81	70	-11
0010	2T	2_3	15	130	16	13000	8360	-4640	0.12	0.64	23	14	-9
0010	2T	2_3	16	134	24	13400	14640	1240	0.18	1.09	23	25	2
0010	2T	2_3	21	11	2	1100	1250	150	0.18	1.14	1	2	1
0010	2T	2_3	23	53	3	5300	1600	-3700	0.06	0.30	9	2	-7
0010	2T	2_3	24	27	4	2700	2710	10	0.15	1.00	4	4	0
0010	2T	2_3	25	27	4	2700	2890	190	0.15	1.07	4	5	1
0010	2T	2_3	26	45	5	4500	3990	-510	0.11	0.89	7	7	0
0010	2T	2_4	12	1638	362	163800	138980	-24820	0.22	0.85	289	245	-44
0010	2T	2_4	13	697	146	69700	48910	-20790	0.21	0.70	123	86	-37
0010	2T	2_4	14	246	60	24600	21750	-2850	0.24	0.88	43	38	-5
0010	2T	2_4	15	39	8	3900	4010	110	0.21	1.03	6	7	1
0010	2T	2_4	16	27	2	2700	830	-1870	0.07	0.31	4	1	-3
0010	2T	2_4	21	17	5	1700	3560	1860	0.29	2.09	3	6	3
0010	2T	2_4	23	8	1	800	420	-380	0.13	0.53	1	0	-1
0010	2T	2_4	24	4	0	400	0	-400	0.00	0.00	0	0	0
0010	2T	2_4	25	5	1	500	640	140	0.20	1.28	0	1	1
0010	2T	2_4	26	9	1	900	520	-380	0.11	0.58	1	0	-1
0010	2T	2_5	12	551	132	55100	41850	-13250	0.24	0.76	97	74	-23
0010	2T	2_5	13	127	29	12700	9010	-3690	0.23	0.71	22	15	-7
0010	2T	2_5	14	23	6	2300	2120	-180	0.26	0.92	4	3	-1
0010	2T	2_5	15	1	0	100	0	-100	0.00	0.00	0	0	0
0010	2T	2_6	12	405	86	40500	27580	-12920	0.21	0.68	71	48	-23
0010	2T	2_6	13	59	16	5900	6100	200	0.27	1.03	10	10	0
0010	2T	2_6	14	9	2	900	850	-50	0.22	0.94	1	1	0
0010	2T	2_6	15	2	1	200	860	660	0.50	4.30	0	1	1
0010	2T	3_-1	12	19	2	1900	560	-1340	0.11	0.29	3	0	-3
0010	2T	3_-1	13	17	6	1700	1930	230	0.35	1.14	3	3	0
0010	2T	3_-1	14	6	2	600	1130	530	0.33	1.88	1	2	1
0010	2T	3_-1	15	2	0	200	0	-200	0.00	0.00	0	0	0
0010	2T	3_-1	16	1	0	100	0	-100	0.00	0.00	0	0	0
0010	2T	3_-1	23	1	1	100	560	460	1.00	5.60	0	0	0
0010	2T	3_-1	26	1	0	100	0	-100	0.00	0.00	0	0	0
0010	2T	3_0	12	316	63	31600	26850	-4750	0.20	0.85	55	47	-8
0010	2T	3_0	13	144	19	14400	8590	-5810	0.13	0.60	25	15	-10
0010	2T	3_0	14	55	8	5500	5080	-420	0.15	0.92	9	8	-1
0010	2T	3_0	15	30	2	3000	1580	-1420	0.07	0.53	5	2	-3
0010	2T	3_0	16	18	3	1800	1630	-170	0.17	0.91	3	2	-1
0010	2T	3_0	23	6	0	600	0	-600	0.00	0.00	1	0	-1
0010	2T	3_0	24	1	0	100	0	-100	0.00	0.00	0	0	0
0010	2T	3_0	26	1	0	100	0	-100	0.00	0.00	0	0	0
0010	2T	3_1	12	753	212	75300	61390	-13910	0.28	0.82	133	108	-25
0010	2T	3_1	13	293	75	29300	24790	-4510	0.26	0.85	51	43	-8
0010	2T	3_1	14	149	29	14900	12450	-2450	0.19	0.84	26	22	-4
0010	2T	3_1	15	99	16	9900	10050	150	0.16	1.02	17	17	0
0010	2T	3_1	16	45	5	4500	2620	-1880	0.11	0.58	7	4	-3
0010	2T	3_1	21	5	1	500	680	180	0.20	1.36	0	1	1
0010	2T	3_1	23	3	1	300	320	20	0.33	1.07	0	0	0
0010	2T	3_1	24	2	0	200	0	-200	0.00	0.00	0	0	0
0010	2T	3_1	25	4	1	400	700	300	0.25	1.75	0	1	1
0010	2T	3_1	26	6	1	600	840	240	0.17	1.40	1	1	0
0010	2T	3_2	12	669	195	66900	65350	-1550	0.29	0.98	118	115	-3
0010	2T	3_2	13	379	93	37900	31930	-5970	0.25	0.84	67	56	-11
0010	2T	3_2	14	379	73	37900	22790	-15110	0.19	0.60	67	40	-27
0010	2T	3_2	15	159	30	15900	16010	110	0.19	1.01	28	28	0
0010	2T	3_2	16	74	8	7400	6210	-1190	0.11	0.84	13	10	-3
0010	2T	3_2	21	24	2	2400	2690	290	0.08	1.12	4	4	0
0010	2T	3_2	23	54	7	5400	5240	-160	0.13	0.97	9	9	0
0010	2T	3_2	24	31	4	3100	2100	-1000	0.13	0.68	5	3	-2
0010	2T	3_2	25	20	2	2000	1000	-1000	0.10	0.50	3	1	-2
0010	2T	3_2	26	24	2	2400	890	-1510	0.08	0.37	4	1	-3
0010	2T	3_3	12	1085	286	108500	99530	-8970	0.26	0.92	192	176	-16
0010	2T	3_3	13	812	197	81200	69160	-12040	0.24	0.85	143	122	-21
0010	2T	3_3	14	522	93	52200	39080	-13120	0.18	0.75	92	69	-23
0010	2T	3_3	15	235	36	23500	18400	-5100	0.15	0.78	41	32	-9
0010	2T	3_3	16	156	23	15600	16070	470	0.15	1.03	27	28	1
0010	2T	3_3	21	129	17	12900	14580	1680	0.13	1.13	22	25	3
0010	2T	3_3	23	134	16	13400	10410	-2990	0.12	0.78	23	18	-5
0010	2T	3_3	24	75	9	7500	5180	-2320	0.12	0.69	13	9	-4
0010	2T	3_3	25	66	7	6600	5450	-1150	0.11	0.83	11	9	-2
0010	2T	3_3	26	103	15	10300	16430	6130	0.15	1.60	18	29	11
0010	2T	3_4	12	1430	364	143000	128200	-14800	0.25	0.90	253	226	-27
0010	2T	3_4	13	815	175	81500	60350	-21150	0.21	0.74	144	106	-38
0010	2T	3_4	14	328	60	32800	24680	-8120	0.18	0.75	58	43	-15
0010	2T	3_4	15	36	4	3600	1840	-1760	0.11	0.51	6	3	-3
0010	2T	3_4	16	28	3	2800	2690	-110	0.11	0.96	4	4	0
0010	2T	3_4	21	55	9	5500	6920	1420	0.16	1.26	9	12	3
0010	2T	3_4	23	33	2	3300	1430	-1870	0.06	0.43	5	2	-3
0010	2T	3_4	24	23	1	2300	290	-2010	0.04	0.13	4	0	-4
0010	2T	3_4	25	1	0	100	0	-100	0.00	0.00	0	0	0
0010	2T	3_4	26	5	0	500	0	-500	0.00	0.00	0	0	0
0010	2T	3_5	12	504	134	50400	40110	-10290	0.27	0.80	89	70	-19
0010	2T	3_5	13	199	45	19900	14800	-5100	0.23	0.74	35	26	-9
0010	2T	3_5	14	57	12	5700	4400	-1300	0.21	0.77	10	7	-3
0010	2T	3_5	15	1	0	100	0	-100	0.00	0.00	0	0	0
0010	2T	3_5	21	6	1	600	600	0	0.17	1.00	1	1	0
0010	2T	3_5	24	1	0	100	0	-100	0.00	0.00	0	0	0
0010	2T	3_6	12	199	56	19900	19070	-830	0.28	0.96	35	33	-2
0010	2T	3_6	13	68	16	6800	5350	-1450	0.24	0.79	12	9	-3
0010	2T	3_6	14	5	1	500	360	-140	0.20	0.72	0	0	0
0010	2T	3_6	21	1	0	100	0	-100	0.00	0.00	0	0	0
0010	2T	4_0	12	171	35	17100	14920	-2180	0.20	0.87	30	26	-4
0010	2T	4_0	13	104	20	10400	10640	240	0.19	1.02	18	18	0
0010	2T	4_0	14	44	5	4400	2820	-1580	0.11	0.64	7	4	-3
0010	2T	4_0	15	18	0	1800	0	-1800	0.00	0.00	3	0	-3
0010	2T	4_0	16	7	0	700	0	-700	0.00	0.00	1	0	-1
0010	2T	4_0	23	8	1	800	980	180	0.13	1.23	1	1	0
0010	2T	4_0	24	1	0	100	0	-100	0.00	0.00	0	0	0
0010	2T	4_0	25	3	1	300	1210	910	0.33	4.03	0	2	2
0010	2T	4_0	26	1	0	100	0	-100	0.00	0.00	0	0	0
0010	2T	4_1	12	652	185	65200	56340	-8860	0.28	0.86	115	99	-16
0010	2T	4_1	13	282	70	28200	22130	-6070	0.25	0.78	49	39	-10
0010	2T	4_1	14	135	33	13500	14320	820	0.24	1.06	23	25	2
0010	2T	4_1	15	56	10	5600	6130	530	0.18	1.09	9	10	1
0010	2T	4_1	16	25	2	2500	1220	-1280	0.08	0.49	4	2	-2
0010	2T	4_1	23	5	1	500	1000	500	0.20	2.00	0	1	1
0010	2T	4_1	24	4	0	400	0	-400	0.00	0.00	0	0	0
0010	2T	4_1	25	2	0	200	0	-200	0.00	0.00	0	0	0
0010	2T	4_1	26	5	0	500	0	-500	0.00	0.00	0	0	0
0010	2T	4_2	12	754	204	75400	68680	-6720	0.27	0.91	133	121	-12
0010	2T	4_2	13	428	96	42800	30900	-11900	0.22	0.72	75	54	-21
0010	2T	4_2	14	330	91	33000	30250	-2750	0.28	0.92	58	53	-5
0010	2T	4_2	15	117	26	11700	15470	3770	0.22	1.32	20	27	7
0010	2T	4_2	16	42	8	4200	3130	-1070	0.19	0.75	7	5	-2
0010	2T	4_2	21	1	0	100	0	-100	0.00	0.00	0	0	0
0010	2T	4_2	23	22	3	2200	1250	-950	0.14	0.57	3	2	-1
0010	2T	4_2	24	21	5	2100	2300	200	0.24	1.10	3	4	1
0010	2T	4_2	25	16	1	1600	560	-1040	0.06	0.35	2	0	-2
0010	2T	4_2	26	11	6	1100	4370	3270	0.55	3.97	1	7	6
0010	2T	4_3	12	1336	308	133600	102250	-31350	0.23	0.77	236	180	-56
0010	2T	4_3	13	819	207	81900	67140	-14760	0.25	0.82	144	118	-26
0010	2T	4_3	14	426	91	42600	36580	-6020	0.21	0.86	75	64	-11
0010	2T	4_3	15	119	25	11900	11160	-740	0.21	0.94	21	19	-2
0010	2T	4_3	16	54	7	5400	8750	3350	0.13	1.62	9	15	6
0010	2T	4_3	21	17	1	1700	780	-920	0.06	0.46	3	1	-2
0010	2T	4_3	23	72	15	7200	6230	-970	0.21	0.87	12	11	-1
0010	2T	4_3	24	46	6	4600	2560	-2040	0.13	0.56	8	4	-4
0010	2T	4_3	25	29	4	2900	2490	-410	0.14	0.86	5	4	-1
0010	2T	4_3	26	26	0	2600	0	-2600	0.00	0.00	4	0	-4
0010	2T	4_4	12	1343	341	134300	106310	-27990	0.25	0.79	237	188	-49
0010	2T	4_4	13	466	131	46600	44410	-2190	0.28	0.95	82	78	-4
0010	2T	4_4	14	217	44	21700	16470	-5230	0.20	0.76	38	29	-9
0010	2T	4_4	15	32	4	3200	2440	-760	0.13	0.76	5	4	-1
0010	2T	4_4	16	13	1	1300	1240	-60	0.08	0.95	2	2	0
0010	2T	4_4	21	8	0	800	0	-800	0.00	0.00	1	0	-1
0010	2T	4_4	23	16	1	1600	300	-1300	0.06	0.19	2	0	-2
0010	2T	4_4	24	14	2	1400	1090	-310	0.14	0.78	2	1	-1
0010	2T	4_4	25	4	0	400	0	-400	0.00	0.00	0	0	0
0010	2T	4_4	26	5	1	500	1260	760	0.20	2.52	0	2	2
0010	2T	4_5	12	625	164	62500	46070	-16430	0.26	0.74	110	81	-29
0010	2T	4_5	13	145	33	14500	9570	-4930	0.23	0.66	25	16	-9
0010	2T	4_5	14	34	7	3400	2680	-720	0.21	0.79	6	4	-2
0010	2T	4_5	15	2	0	200	0	-200	0.00	0.00	0	0	0
0010	2T	4_5	16	1	0	100	0	-100	0.00	0.00	0	0	0
0010	2T	4_5	23	1	0	100	0	-100	0.00	0.00	0	0	0
0010	2T	4_6	12	266	76	26600	21200	-5400	0.29	0.80	47	37	-10
0010	2T	4_6	13	32	5	3200	1900	-1300	0.16	0.59	5	3	-2
0010	2T	4_6	14	5	1	500	500	0	0.20	1.00	0	0	0
0010	2T	5_-1	12	12	4	1200	990	-210	0.33	0.83	2	1	-1
0010	2T	5_-1	13	6	1	600	230	-370	0.17	0.38	1	0	-1
0010	2T	5_-1	14	3	0	300	0	-300	0.00	0.00	0	0	0
0010	2T	5_0	12	257	64	25700	22450	-3250	0.25	0.87	45	39	-6
0010	2T	5_0	13	127	27	12700	11680	-1020	0.21	0.92	22	20	-2
0010	2T	5_0	14	36	6	3600	2270	-1330	0.17	0.63	6	4	-2
0010	2T	5_0	15	30	5	3000	3240	240	0.17	1.08	5	5	0
0010	2T	5_0	16	5	0	500	0	-500	0.00	0.00	0	0	0
0010	2T	5_0	23	1	0	100	0	-100	0.00	0.00	0	0	0
0010	2T	5_1	12	577	156	57700	44240	-13460	0.27	0.77	102	78	-24
0010	2T	5_1	13	203	42	20300	12920	-7380	0.21	0.64	35	22	-13
0010	2T	5_1	14	142	27	14200	10330	-3870	0.19	0.73	25	18	-7
0010	2T	5_1	15	42	3	4200	1820	-2380	0.07	0.43	7	3	-4
0010	2T	5_1	16	29	4	2900	1960	-940	0.14	0.68	5	3	-2
0010	2T	5_1	21	1	0	100	0	-100	0.00	0.00	0	0	0
0010	2T	5_1	23	2	0	200	0	-200	0.00	0.00	0	0	0
0010	2T	5_1	25	1	0	100	0	-100	0.00	0.00	0	0	0
0010	2T	5_1	26	1	0	100	0	-100	0.00	0.00	0	0	0
0010	2T	5_2	12	597	156	59700	52590	-7110	0.26	0.88	105	93	-12
0010	2T	5_2	13	356	82	35600	29030	-6570	0.23	0.82	63	51	-12
0010	2T	5_2	14	330	81	33000	28770	-4230	0.25	0.87	58	50	-8
0010	2T	5_2	15	60	16	6000	10610	4610	0.27	1.77	10	18	8
0010	2T	5_2	16	35	5	3500	1970	-1530	0.14	0.56	6	3	-3
0010	2T	5_2	21	4	1	400	250	-150	0.25	0.63	0	0	0
0010	2T	5_2	23	12	2	1200	1460	260	0.17	1.22	2	2	0
0010	2T	5_2	24	10	0	1000	0	-1000	0.00	0.00	1	0	-1
0010	2T	5_2	25	4	0	400	0	-400	0.00	0.00	0	0	0
0010	2T	5_2	26	2	0	200	0	-200	0.00	0.00	0	0	0
0010	2T	5_3	12	1042	282	104200	91950	-12250	0.27	0.88	184	162	-22
0010	2T	5_3	13	658	142	65800	47930	-17870	0.22	0.73	116	84	-32
0010	2T	5_3	14	420	91	42000	31520	-10480	0.22	0.75	74	55	-19
0010	2T	5_3	15	75	15	7500	8490	990	0.20	1.13	13	15	2
0010	2T	5_3	16	52	8	5200	6910	1710	0.15	1.33	9	12	3
0010	2T	5_3	21	16	2	1600	5360	3760	0.13	3.35	2	9	7
0010	2T	5_3	23	26	1	2600	410	-2190	0.04	0.16	4	0	-4
0010	2T	5_3	24	14	1	1400	960	-440	0.07	0.69	2	1	-1
0010	2T	5_3	25	3	0	300	0	-300	0.00	0.00	0	0	0
0010	2T	5_3	26	10	2	1000	1850	850	0.20	1.85	1	3	2
0010	2T	5_4	12	935	263	93500	70450	-23050	0.28	0.75	165	124	-41
0010	2T	5_4	13	356	77	35600	26160	-9440	0.22	0.73	63	46	-17
0010	2T	5_4	14	129	32	12900	14530	1630	0.25	1.13	22	25	3
0010	2T	5_4	15	17	1	1700	390	-1310	0.06	0.23	3	0	-3
0010	2T	5_4	16	5	0	500	0	-500	0.00	0.00	0	0	0
0010	2T	5_4	21	20	1	2000	450	-1550	0.05	0.23	3	0	-3
0010	2T	5_4	23	8	0	800	0	-800	0.00	0.00	1	0	-1
0010	2T	5_4	24	3	0	300	0	-300	0.00	0.00	0	0	0
0010	2T	5_4	25	1	0	100	0	-100	0.00	0.00	0	0	0
0010	2T	5_4	26	3	0	300	0	-300	0.00	0.00	0	0	0
0010	2T	5_5	12	749	233	74900	59310	-15590	0.31	0.79	132	104	-28
0010	2T	5_5	13	96	18	9600	6030	-3570	0.19	0.63	16	10	-6
0010	2T	5_5	14	17	4	1700	2160	460	0.24	1.27	3	3	0
0010	2T	5_5	21	2	0	200	0	-200	0.00	0.00	0	0	0
0010	2T	5_5	23	1	0	100	0	-100	0.00	0.00	0	0	0
0010	2T	5_6	12	258	73	25800	19390	-6410	0.28	0.75	45	34	-11
0010	2T	5_6	13	23	6	2300	2530	230	0.26	1.10	4	4	0
0010	2T	5_6	14	1	0	100	0	-100	0.00	0.00	0	0	0
0010	2T	5_6	21	2	0	200	0	-200	0.00	0.00	0	0	0
0010	2T	6_0	12	20	1	2000	320	-1680	0.05	0.16	3	0	-3
0010	2T	6_0	13	10	3	1000	1320	320	0.30	1.32	1	2	1
0010	2T	6_0	14	3	0	300	0	-300	0.00	0.00	0	0	0
0010	2T	6_0	15	4	1	400	1220	820	0.25	3.05	0	2	2
0010	2T	6_0	16	1	0	100	0	-100	0.00	0.00	0	0	0
0010	2T	6_0	23	1	0	100	0	-100	0.00	0.00	0	0	0
0010	2T	6_1	12	32	12	3200	2950	-250	0.38	0.92	5	5	0
0010	2T	6_1	13	22	7	2200	2000	-200	0.32	0.91	3	3	0
0010	2T	6_1	14	13	1	1300	320	-980	0.08	0.25	2	0	-2
0010	2T	6_1	15	2	0	200	0	-200	0.00	0.00	0	0	0
0010	2T	6_1	16	2	1	200	600	400	0.50	3.00	0	1	1
0010	2T	6_2	12	27	6	2700	1150	-1550	0.22	0.43	4	2	-2
0010	2T	6_2	13	22	4	2200	1050	-1150	0.18	0.48	3	1	-2
0010	2T	6_2	14	24	3	2400	770	-1630	0.13	0.32	4	1	-3
0010	2T	6_2	15	10	1	1000	310	-690	0.10	0.31	1	0	-1
0010	2T	6_2	16	2	0	200	0	-200	0.00	0.00	0	0	0
0010	2T	6_2	23	1	1	100	1820	1720	1.00	18.20	0	3	3
0010	2T	6_2	24	1	0	100	0	-100	0.00	0.00	0	0	0
0010	2T	6_3	12	93	18	9300	9240	-60	0.19	0.99	16	16	0
0010	2T	6_3	13	45	11	4500	2960	-1540	0.24	0.66	7	5	-2
0010	2T	6_3	14	29	4	2900	1680	-1220	0.14	0.58	5	2	-3
0010	2T	6_3	15	6	0	600	0	-600	0.00	0.00	1	0	-1
0010	2T	6_3	16	15	5	1500	3170	1670	0.33	2.11	2	5	3
0010	2T	6_3	23	1	0	100	0	-100	0.00	0.00	0	0	0
0010	2T	6_4	12	83	22	8300	6220	-2080	0.27	0.75	14	11	-3
0010	2T	6_4	13	37	11	3700	3570	-130	0.30	0.96	6	6	0
0010	2T	6_4	14	16	3	1600	1210	-390	0.19	0.76	2	2	0
0010	2T	6_4	15	3	0	300	0	-300	0.00	0.00	0	0	0
0010	2T	6_4	16	5	1	500	940	440	0.20	1.88	0	1	1
0010	2T	6_4	21	1	1	100	2000	1900	1.00	20.00	0	3	3
0010	2T	6_5	12	63	23	6300	5580	-720	0.37	0.89	11	9	-2
0010	2T	6_5	13	8	0	800	0	-800	0.00	0.00	1	0	-1
0010	2T	6_5	16	1	0	100	0	-100	0.00	0.00	0	0	0
0010	2T	6_6	12	28	11	2800	3060	260	0.39	1.09	4	5	1
0010	2T	6_6	13	1	0	100	0	-100	0.00	0.00	0	0	0
0010	2T	7_-1	12	15	4	1500	1170	-330	0.27	0.78	2	2	0
0010	2T	7_-1	13	4	0	400	0	-400	0.00	0.00	0	0	0
0010	2T	7_-1	14	3	1	300	340	40	0.33	1.13	0	0	0
0010	2T	7_-1	23	1	1	100	1450	1350	1.00	14.50	0	2	2
0010	2T	7_0	12	568	122	56800	44830	-11970	0.21	0.79	100	79	-21
0010	2T	7_0	13	231	42	23100	16860	-6240	0.18	0.73	40	29	-11
0010	2T	7_0	14	79	18	7900	9370	1470	0.23	1.19	13	16	3
0010	2T	7_0	15	35	5	3500	3500	0	0.14	1.00	6	6	0
0010	2T	7_0	16	13	1	1300	1330	30	0.08	1.02	2	2	0
0010	2T	7_0	23	11	2	1100	1600	500	0.18	1.45	1	2	1
0010	2T	7_0	25	2	0	200	0	-200	0.00	0.00	0	0	0
0010	2T	7_1	12	1290	380	129000	114540	-14460	0.29	0.89	228	202	-26
0010	2T	7_1	13	484	116	48400	35880	-12520	0.24	0.74	85	63	-22
0010	2T	7_1	14	289	54	28900	24630	-4270	0.19	0.85	51	43	-8
0010	2T	7_1	15	61	8	6100	4730	-1370	0.13	0.78	10	8	-2
0010	2T	7_1	16	41	7	4100	5020	920	0.17	1.22	7	8	1
0010	2T	7_1	21	2	0	200	0	-200	0.00	0.00	0	0	0
0010	2T	7_1	23	16	0	1600	0	-1600	0.00	0.00	2	0	-2
0010	2T	7_1	24	8	1	800	1250	450	0.13	1.56	1	2	1
0010	2T	7_1	25	3	2	300	990	690	0.67	3.30	0	1	1
0010	2T	7_1	26	1	0	100	0	-100	0.00	0.00	0	0	0
0010	2T	7_2	12	1515	413	151500	126810	-24690	0.27	0.84	268	224	-44
0010	2T	7_2	13	750	174	75000	58110	-16890	0.23	0.77	132	102	-30
0010	2T	7_2	14	518	122	51800	40760	-11040	0.24	0.79	91	72	-19
0010	2T	7_2	15	148	21	14800	11040	-3760	0.14	0.75	26	19	-7
0010	2T	7_2	16	115	21	11500	12710	1210	0.18	1.11	20	22	2
0010	2T	7_2	21	4	1	400	1210	810	0.25	3.03	0	2	2
0010	2T	7_2	23	30	3	3000	1920	-1080	0.10	0.64	5	3	-2
0010	2T	7_2	24	12	2	1200	850	-350	0.17	0.71	2	1	-1
0010	2T	7_2	25	7	0	700	0	-700	0.00	0.00	1	0	-1
0010	2T	7_2	26	13	1	1300	610	-690	0.08	0.47	2	1	-1
0010	2T	7_3	12	1691	441	169100	139540	-29560	0.26	0.83	299	246	-53
0010	2T	7_3	13	874	198	87400	63460	-23940	0.23	0.73	154	112	-42
0010	2T	7_3	14	423	84	42300	31520	-10780	0.20	0.75	74	55	-19
0010	2T	7_3	15	90	15	9000	6560	-2440	0.17	0.73	15	11	-4
0010	2T	7_3	16	92	15	9200	9790	590	0.16	1.06	16	17	1
0010	2T	7_3	21	6	1	600	460	-140	0.17	0.77	1	0	-1
0010	2T	7_3	23	19	5	1900	2460	560	0.26	1.29	3	4	1
0010	2T	7_3	24	19	1	1900	480	-1420	0.05	0.25	3	0	-3
0010	2T	7_3	25	8	0	800	0	-800	0.00	0.00	1	0	-1
0010	2T	7_3	26	8	2	800	2660	1860	0.25	3.33	1	4	3
0010	2T	7_4	12	1041	270	104100	83290	-20810	0.26	0.80	184	147	-37
0010	2T	7_4	13	324	65	32400	22600	-9800	0.20	0.70	57	40	-17
0010	2T	7_4	14	105	13	10500	4630	-5870	0.12	0.44	18	8	-10
0010	2T	7_4	15	10	2	1000	650	-350	0.20	0.65	1	1	0
0010	2T	7_4	16	13	0	1300	0	-1300	0.00	0.00	2	0	-2
0010	2T	7_4	21	8	0	800	0	-800	0.00	0.00	1	0	-1
0010	2T	7_4	23	6	1	600	700	100	0.17	1.17	1	1	0
0010	2T	7_4	24	4	1	400	550	150	0.25	1.38	0	0	0
0010	2T	7_4	25	3	0	300	0	-300	0.00	0.00	0	0	0
0010	2T	7_5	12	893	233	89300	68650	-20650	0.26	0.77	158	121	-37
0010	2T	7_5	13	111	30	11100	11460	360	0.27	1.03	19	20	1
0010	2T	7_5	14	14	3	1400	950	-450	0.21	0.68	2	1	-1
0010	2T	7_5	15	1	0	100	0	-100	0.00	0.00	0	0	0
0010	2T	7_5	16	2	0	200	0	-200	0.00	0.00	0	0	0
0010	2T	7_5	21	3	0	300	0	-300	0.00	0.00	0	0	0
0010	2T	7_6	12	681	174	68100	52350	-15750	0.26	0.77	120	92	-28
0010	2T	7_6	13	26	3	2600	1530	-1070	0.12	0.59	4	2	-2
0010	2T	7_6	14	3	0	300	0	-300	0.00	0.00	0	0	0
0010	2T	7_6	16	1	0	100	0	-100	0.00	0.00	0	0	0
0010	2T	7_6	21	1	0	100	0	-100	0.00	0.00	0	0	0
0010	3F	1_-1	123	3	2	300	960	660	0.67	3.20	0	1	1
0010	3F	1_-1	124	5	2	500	460	-40	0.40	0.92	0	0	0
0010	3F	1_-1	125	2	1	200	320	120	0.50	1.60	0	0	0
0010	3F	1_-1	126	1	0	100	0	-100	0.00	0.00	0	0	0
0010	3F	1_-1	135	1	1	100	390	290	1.00	3.90	0	0	0
0010	3F	1_-1	136	2	0	200	0	-200	0.00	0.00	0	0	0
0010	3F	1_-1	145	1	0	100	0	-100	0.00	0.00	0	0	0
0010	3F	1_-1	235	1	0	100	0	-100	0.00	0.00	0	0	0
0010	3F	1_0	124	220	36	22000	17560	-4440	0.16	0.80	38	31	-7
0010	3F	1_0	125	213	24	21300	22710	1410	0.11	1.07	37	40	3
0010	3F	1_0	126	47	4	4700	4870	170	0.09	1.04	8	8	0
0010	3F	1_0	134	5	1	500	540	40	0.20	1.08	0	0	0
0010	3F	1_0	135	11	2	1100	1620	520	0.18	1.47	1	2	1
0010	3F	1_1	123	108	25	10800	8900	-1900	0.23	0.82	19	15	-4
0010	3F	1_1	124	199	37	19900	15520	-4380	0.19	0.78	35	27	-8
0010	3F	1_1	125	121	12	12100	6900	-5200	0.10	0.57	21	12	-9
0010	3F	1_1	126	184	28	18400	27640	9240	0.15	1.50	32	48	16
0010	3F	1_1	134	44	8	4400	2800	-1600	0.18	0.64	7	4	-3
0010	3F	1_1	135	92	10	9200	6170	-3030	0.11	0.67	16	10	-6
0010	3F	1_1	136	86	9	8600	6360	-2240	0.10	0.74	15	11	-4
0010	3F	1_1	145	65	7	6500	5430	-1070	0.11	0.84	11	9	-2
0010	3F	1_1	146	16	0	1600	0	-1600	0.00	0.00	2	0	-2
0010	3F	1_1	156	26	2	2600	1160	-1440	0.08	0.45	4	2	-2
0010	3F	1_1	234	3	1	300	410	110	0.33	1.37	0	0	0
0010	3F	1_1	235	15	0	1500	0	-1500	0.00	0.00	2	0	-2
0010	3F	1_1	236	5	1	500	990	490	0.20	1.98	0	1	1
0010	3F	1_2	123	62	18	6200	5510	-690	0.29	0.89	10	9	-1
0010	3F	1_2	124	204	58	20400	18990	-1410	0.28	0.93	36	33	-3
0010	3F	1_2	125	186	30	18600	11060	-7540	0.16	0.59	32	19	-13
0010	3F	1_2	126	229	33	22900	16440	-6460	0.14	0.72	40	29	-11
0010	3F	1_2	134	40	14	4000	4380	380	0.35	1.10	7	7	0
0010	3F	1_2	135	77	10	7700	3120	-4580	0.13	0.41	13	5	-8
0010	3F	1_2	136	122	18	12200	7010	-5190	0.15	0.57	21	12	-9
0010	3F	1_2	145	128	26	12800	16510	3710	0.20	1.29	22	29	7
0010	3F	1_2	146	62	10	6200	15770	9570	0.16	2.54	10	27	17
0010	3F	1_2	156	12	0	1200	0	-1200	0.00	0.00	2	0	-2
0010	3F	1_2	234	23	2	2300	1760	-540	0.09	0.77	4	3	-1
0010	3F	1_2	235	17	1	1700	1080	-620	0.06	0.64	3	1	-2
0010	3F	1_2	236	12	1	1200	1000	-200	0.08	0.83	2	1	-1
0010	3F	1_2	245	16	1	1600	410	-1190	0.06	0.26	2	0	-2
0010	3F	1_2	246	24	1	2400	500	-1900	0.04	0.21	4	0	-4
0010	3F	1_2	256	4	1	400	790	390	0.25	1.98	0	1	1
0010	3F	1_3	123	47	17	4700	3450	-1250	0.36	0.73	8	6	-2
0010	3F	1_3	124	327	92	32700	28470	-4230	0.28	0.87	57	50	-7
0010	3F	1_3	125	273	45	27300	21620	-5680	0.16	0.79	48	38	-10
0010	3F	1_3	126	560	62	56000	38680	-17320	0.11	0.69	99	68	-31
0010	3F	1_3	134	259	72	25900	19810	-6090	0.28	0.76	45	35	-10
0010	3F	1_3	135	221	47	22100	15190	-6910	0.21	0.69	39	26	-13
0010	3F	1_3	136	366	50	36600	26050	-10550	0.14	0.71	64	46	-18
0010	3F	1_3	145	101	23	10100	8550	-1550	0.23	0.85	17	15	-2
0010	3F	1_3	146	194	24	19400	20020	620	0.12	1.03	34	35	1
0010	3F	1_3	156	89	16	8900	17410	8510	0.18	1.96	15	30	15
0010	3F	1_3	234	15	3	1500	1180	-320	0.20	0.79	2	2	0
0010	3F	1_3	235	23	7	2300	4220	1920	0.30	1.83	4	7	3
0010	3F	1_3	236	30	3	3000	1070	-1930	0.10	0.36	5	1	-4
0010	3F	1_3	245	26	3	2600	1270	-1330	0.12	0.49	4	2	-2
0010	3F	1_3	246	29	1	2900	1500	-1400	0.03	0.52	5	2	-3
0010	3F	1_3	256	24	1	2400	530	-1870	0.04	0.22	4	0	-4
0010	3F	1_4	123	10	3	1000	630	-370	0.30	0.63	1	1	0
0010	3F	1_4	124	251	49	25100	16570	-8530	0.20	0.66	44	29	-15
0010	3F	1_4	125	330	55	33000	32910	-90	0.17	1.00	58	58	0
0010	3F	1_4	126	396	37	39600	32260	-7340	0.09	0.81	70	57	-13
0010	3F	1_4	134	139	38	13900	12690	-1210	0.27	0.91	24	22	-2
0010	3F	1_4	135	152	26	15200	12150	-3050	0.17	0.80	26	21	-5
0010	3F	1_4	136	192	15	19200	11090	-8110	0.08	0.58	33	19	-14
0010	3F	1_4	145	82	9	8200	4880	-3320	0.11	0.60	14	8	-6
0010	3F	1_4	146	106	11	10600	15370	4770	0.10	1.45	18	27	9
0010	3F	1_4	156	24	3	2400	2240	-160	0.13	0.93	4	3	-1
0010	3F	1_4	235	3	0	300	0	-300	0.00	0.00	0	0	0
0010	3F	1_4	236	7	0	700	0	-700	0.00	0.00	1	0	-1
0010	3F	1_4	245	2	0	200	0	-200	0.00	0.00	0	0	0
0010	3F	1_4	246	7	1	700	560	-140	0.14	0.80	1	0	-1
0010	3F	1_4	256	6	1	600	1100	500	0.17	1.83	1	1	0
0010	3F	1_5	124	48	6	4800	1820	-2980	0.13	0.38	8	3	-5
0010	3F	1_5	125	66	8	6600	4320	-2280	0.12	0.65	11	7	-4
0010	3F	1_5	126	68	4	6800	2970	-3830	0.06	0.44	12	5	-7
0010	3F	1_5	134	26	4	2600	2450	-150	0.15	0.94	4	4	0
0010	3F	1_5	135	30	4	3000	1820	-1180	0.13	0.61	5	3	-2
0010	3F	1_5	136	42	4	4200	3270	-930	0.10	0.78	7	5	-2
0010	3F	1_5	145	23	3	2300	1880	-420	0.13	0.82	4	3	-1
0010	3F	1_5	146	24	1	2400	1250	-1150	0.04	0.52	4	2	-2
0010	3F	1_5	156	2	0	200	0	-200	0.00	0.00	0	0	0
0010	3F	1_6	123	16	6	1600	2270	670	0.38	1.42	2	4	2
0010	3F	1_6	124	109	17	10900	7000	-3900	0.16	0.64	19	12	-7
0010	3F	1_6	125	9	1	900	420	-480	0.11	0.47	1	0	-1
0010	3F	1_6	126	815	57	81500	77700	-3800	0.07	0.95	144	137	-7
0010	3F	1_6	134	7	1	700	580	-120	0.14	0.83	1	1	0
0010	3F	1_6	135	2	0	200	0	-200	0.00	0.00	0	0	0
0010	3F	1_6	136	121	7	12100	7950	-4150	0.06	0.66	21	14	-7
0010	3F	1_6	145	1	0	100	0	-100	0.00	0.00	0	0	0
0010	3F	1_6	146	12	0	1200	0	-1200	0.00	0.00	2	0	-2
0010	3F	2_-1	123	2	2	200	460	260	1.00	2.30	0	0	0
0010	3F	2_-1	124	3	2	300	510	210	0.67	1.70	0	0	0
0010	3F	2_-1	125	1	0	100	0	-100	0.00	0.00	0	0	0
0010	3F	2_-1	126	3	0	300	0	-300	0.00	0.00	0	0	0
0010	3F	2_-1	135	1	0	100	0	-100	0.00	0.00	0	0	0
0010	3F	2_-1	136	1	0	100	0	-100	0.00	0.00	0	0	0
0010	3F	2_-1	146	1	0	100	0	-100	0.00	0.00	0	0	0
0010	3F	2_0	123	87	26	8700	8760	60	0.30	1.01	15	15	0
0010	3F	2_0	124	43	10	4300	4100	-200	0.23	0.95	7	7	0
0010	3F	2_0	125	38	9	3800	4000	200	0.24	1.05	6	7	1
0010	3F	2_0	126	22	1	2200	470	-1730	0.05	0.21	3	0	-3
0010	3F	2_0	134	24	6	2400	2030	-370	0.25	0.85	4	3	-1
0010	3F	2_0	135	27	5	2700	3330	630	0.19	1.23	4	5	1
0010	3F	2_0	136	13	2	1300	460	-840	0.15	0.35	2	0	-2
0010	3F	2_0	145	4	0	400	0	-400	0.00	0.00	0	0	0
0010	3F	2_0	146	1	1	100	970	870	1.00	9.70	0	1	1
0010	3F	2_0	156	1	1	100	720	620	1.00	7.20	0	1	1
0010	3F	2_0	235	1	0	100	0	-100	0.00	0.00	0	0	0
0010	3F	2_0	245	1	0	100	0	-100	0.00	0.00	0	0	0
0010	3F	2_1	123	310	80	31000	26530	-4470	0.26	0.86	54	46	-8
0010	3F	2_1	124	125	34	12500	10960	-1540	0.27	0.88	22	19	-3
0010	3F	2_1	125	107	19	10700	11760	1060	0.18	1.10	18	20	2
0010	3F	2_1	126	60	7	6000	2790	-3210	0.12	0.47	10	4	-6
0010	3F	2_1	134	51	10	5100	2680	-2420	0.20	0.53	9	4	-5
0010	3F	2_1	135	40	10	4000	4070	70	0.25	1.02	7	7	0
0010	3F	2_1	136	37	8	3700	4000	300	0.22	1.08	6	7	1
0010	3F	2_1	145	20	6	2000	2880	880	0.30	1.44	3	5	2
0010	3F	2_1	146	11	1	1100	420	-680	0.09	0.38	1	0	-1
0010	3F	2_1	156	4	1	400	590	190	0.25	1.48	0	1	1
0010	3F	2_1	234	2	0	200	0	-200	0.00	0.00	0	0	0
0010	3F	2_1	246	1	0	100	0	-100	0.00	0.00	0	0	0
0010	3F	2_2	123	248	80	24800	21820	-2980	0.32	0.88	43	38	-5
0010	3F	2_2	124	283	80	28300	21910	-6390	0.28	0.77	50	38	-12
0010	3F	2_2	125	182	41	18200	13070	-5130	0.23	0.72	32	23	-9
0010	3F	2_2	126	190	41	19000	18800	-200	0.22	0.99	33	33	0
0010	3F	2_2	134	109	23	10900	6220	-4680	0.21	0.57	19	11	-8
0010	3F	2_2	135	102	14	10200	4670	-5530	0.14	0.46	18	8	-10
0010	3F	2_2	136	109	23	10900	8390	-2510	0.21	0.77	19	14	-5
0010	3F	2_2	145	59	8	5900	2340	-3560	0.14	0.40	10	4	-6
0010	3F	2_2	146	42	11	4200	3870	-330	0.26	0.92	7	6	-1
0010	3F	2_2	156	19	5	1900	1650	-250	0.26	0.87	3	2	-1
0010	3F	2_2	234	6	0	600	0	-600	0.00	0.00	1	0	-1
0010	3F	2_2	235	4	1	400	3020	2620	0.25	7.55	0	5	5
0010	3F	2_2	236	2	0	200	0	-200	0.00	0.00	0	0	0
0010	3F	2_2	246	2	0	200	0	-200	0.00	0.00	0	0	0
0010	3F	2_3	123	277	91	27700	22750	-4950	0.33	0.82	49	40	-9
0010	3F	2_3	124	606	141	60600	43120	-17480	0.23	0.71	107	76	-31
0010	3F	2_3	125	422	89	42200	37890	-4310	0.21	0.90	74	67	-7
0010	3F	2_3	126	547	101	54700	54860	160	0.18	1.00	96	97	1
0010	3F	2_3	134	255	60	25500	15970	-9530	0.24	0.63	45	28	-17
0010	3F	2_3	135	264	69	26400	23130	-3270	0.26	0.88	46	40	-6
0010	3F	2_3	136	354	70	35400	26620	-8780	0.20	0.75	62	47	-15
0010	3F	2_3	145	117	25	11700	11780	80	0.21	1.01	20	20	0
0010	3F	2_3	146	86	13	8600	7230	-1370	0.15	0.84	15	12	-3
0010	3F	2_3	156	38	8	3800	3660	-140	0.21	0.96	6	6	0
0010	3F	2_3	234	12	3	1200	730	-470	0.25	0.61	2	1	-1
0010	3F	2_3	235	13	2	1300	450	-850	0.15	0.35	2	0	-2
0010	3F	2_3	236	22	6	2200	2360	160	0.27	1.07	3	4	1
0010	3F	2_3	245	9	1	900	370	-530	0.11	0.41	1	0	-1
0010	3F	2_3	246	7	1	700	160	-540	0.14	0.23	1	0	-1
0010	3F	2_3	256	7	0	700	0	-700	0.00	0.00	1	0	-1
0010	3F	2_4	123	208	58	20800	16950	-3850	0.28	0.81	36	30	-6
0010	3F	2_4	124	617	147	61700	51040	-10660	0.24	0.83	109	90	-19
0010	3F	2_4	125	336	49	33600	21420	-12180	0.15	0.64	59	37	-22
0010	3F	2_4	126	492	65	49200	38290	-10910	0.13	0.78	87	67	-20
0010	3F	2_4	134	218	50	21800	17130	-4670	0.23	0.79	38	30	-8
0010	3F	2_4	135	176	42	17600	17090	-510	0.24	0.97	31	30	-1
0010	3F	2_4	136	262	34	26200	14750	-11450	0.13	0.56	46	26	-20
0010	3F	2_4	145	56	10	5600	4180	-1420	0.18	0.75	9	7	-2
0010	3F	2_4	146	72	7	7200	3210	-3990	0.10	0.45	12	5	-7
0010	3F	2_4	156	15	3	1500	1310	-190	0.20	0.87	2	2	0
0010	3F	2_4	234	2	0	200	0	-200	0.00	0.00	0	0	0
0010	3F	2_4	235	2	0	200	0	-200	0.00	0.00	0	0	0
0010	3F	2_4	236	3	0	300	0	-300	0.00	0.00	0	0	0
0010	3F	2_4	245	1	0	100	0	-100	0.00	0.00	0	0	0
0010	3F	2_4	246	3	0	300	0	-300	0.00	0.00	0	0	0
0010	3F	2_4	256	1	0	100	0	-100	0.00	0.00	0	0	0
0010	3F	2_5	123	55	15	5500	4490	-1010	0.27	0.82	9	7	-2
0010	3F	2_5	124	315	53	31500	21040	-10460	0.17	0.67	55	37	-18
0010	3F	2_5	125	68	12	6800	6940	140	0.18	1.02	12	12	0
0010	3F	2_5	126	113	8	11300	10330	-970	0.07	0.91	20	18	-2
0010	3F	2_5	134	60	7	6000	2680	-3320	0.12	0.45	10	4	-6
0010	3F	2_5	135	27	6	2700	3290	590	0.22	1.22	4	5	1
0010	3F	2_5	136	35	2	3500	1720	-1780	0.06	0.49	6	3	-3
0010	3F	2_5	145	4	1	400	520	120	0.25	1.30	0	0	0
0010	3F	2_5	146	4	0	400	0	-400	0.00	0.00	0	0	0
0010	3F	2_6	123	26	7	2600	2350	-250	0.27	0.90	4	4	0
0010	3F	2_6	124	267	48	26700	22120	-4580	0.18	0.83	47	39	-8
0010	3F	2_6	125	16	3	1600	1770	170	0.19	1.11	2	3	1
0010	3F	2_6	126	96	3	9600	3990	-5610	0.03	0.42	16	7	-9
0010	3F	2_6	134	36	9	3600	3550	-50	0.25	0.99	6	6	0
0010	3F	2_6	135	6	1	600	420	-180	0.17	0.70	1	0	-1
0010	3F	2_6	136	17	2	1700	1050	-650	0.12	0.62	3	1	-2
0010	3F	2_6	146	1	0	100	0	-100	0.00	0.00	0	0	0
0010	3F	2_6	156	1	0	100	0	-100	0.00	0.00	0	0	0
0010	3F	3_-1	123	1	0	100	0	-100	0.00	0.00	0	0	0
0010	3F	3_-1	124	3	1	300	320	20	0.33	1.07	0	0	0
0010	3F	3_-1	125	6	0	600	0	-600	0.00	0.00	1	0	-1
0010	3F	3_-1	126	8	4	800	1820	1020	0.50	2.28	1	3	2
0010	3F	3_-1	134	4	2	400	520	120	0.50	1.30	0	0	0
0010	3F	3_-1	135	3	1	300	530	230	0.33	1.77	0	0	0
0010	3F	3_-1	136	6	1	600	300	-300	0.17	0.50	1	0	-1
0010	3F	3_-1	145	2	0	200	0	-200	0.00	0.00	0	0	0
0010	3F	3_-1	146	3	0	300	0	-300	0.00	0.00	0	0	0
0010	3F	3_-1	156	1	0	100	0	-100	0.00	0.00	0	0	0
0010	3F	3_-1	234	1	1	100	620	520	1.00	6.20	0	1	1
0010	3F	3_0	123	68	21	6800	6510	-290	0.31	0.96	12	11	-1
0010	3F	3_0	124	120	18	12000	9840	-2160	0.15	0.82	21	17	-4
0010	3F	3_0	125	40	8	4000	3450	-550	0.20	0.86	7	6	-1
0010	3F	3_0	126	75	7	7500	5790	-1710	0.09	0.77	13	10	-3
0010	3F	3_0	134	63	13	6300	6880	580	0.21	1.09	11	12	1
0010	3F	3_0	135	17	2	1700	1010	-690	0.12	0.59	3	1	-2
0010	3F	3_0	136	31	1	3100	500	-2600	0.03	0.16	5	0	-5
0010	3F	3_0	145	14	6	1400	3280	1880	0.43	2.34	2	5	3
0010	3F	3_0	146	12	0	1200	0	-1200	0.00	0.00	2	0	-2
0010	3F	3_0	156	9	1	900	680	-220	0.11	0.76	1	1	0
0010	3F	3_0	234	3	0	300	0	-300	0.00	0.00	0	0	0
0010	3F	3_0	235	1	0	100	0	-100	0.00	0.00	0	0	0
0010	3F	3_0	236	1	0	100	0	-100	0.00	0.00	0	0	0
0010	3F	3_1	123	258	74	25800	24480	-1320	0.29	0.95	45	43	-2
0010	3F	3_1	124	135	30	13500	9980	-3520	0.22	0.74	23	17	-6
0010	3F	3_1	125	108	21	10800	9640	-1160	0.19	0.89	19	17	-2
0010	3F	3_1	126	173	24	17300	17520	220	0.14	1.01	30	31	1
0010	3F	3_1	134	59	15	5900	5370	-530	0.25	0.91	10	9	-1
0010	3F	3_1	135	42	10	4200	4420	220	0.24	1.05	7	7	0
0010	3F	3_1	136	65	12	6500	7040	540	0.18	1.08	11	12	1
0010	3F	3_1	145	26	3	2600	1280	-1320	0.12	0.49	4	2	-2
0010	3F	3_1	146	35	6	3500	2430	-1070	0.17	0.69	6	4	-2
0010	3F	3_1	156	26	2	2600	1250	-1350	0.08	0.48	4	2	-2
0010	3F	3_1	236	2	0	200	0	-200	0.00	0.00	0	0	0
0010	3F	3_2	123	111	36	11100	9540	-1560	0.32	0.86	19	16	-3
0010	3F	3_2	124	201	49	20100	15290	-4810	0.24	0.76	35	27	-8
0010	3F	3_2	125	153	34	15300	11820	-3480	0.22	0.77	27	20	-7
0010	3F	3_2	126	211	36	21100	16000	-5100	0.17	0.76	37	28	-9
0010	3F	3_2	134	108	39	10800	13180	2380	0.36	1.22	19	23	4
0010	3F	3_2	135	74	16	7400	4940	-2460	0.22	0.67	13	8	-5
0010	3F	3_2	136	107	10	10700	4040	-6660	0.09	0.38	18	7	-11
0010	3F	3_2	145	48	6	4800	1830	-2970	0.13	0.38	8	3	-5
0010	3F	3_2	146	65	5	6500	2860	-3640	0.08	0.44	11	5	-6
0010	3F	3_2	156	24	2	2400	1620	-780	0.08	0.68	4	2	-2
0010	3F	3_2	234	10	3	1000	1300	300	0.30	1.30	1	2	1
0010	3F	3_2	235	13	1	1300	260	-1040	0.08	0.20	2	0	-2
0010	3F	3_2	236	13	1	1300	650	-650	0.08	0.50	2	1	-1
0010	3F	3_2	245	4	1	400	350	-50	0.25	0.88	0	0	0
0010	3F	3_2	246	11	1	1100	440	-660	0.09	0.40	1	0	-1
0010	3F	3_2	256	4	0	400	0	-400	0.00	0.00	0	0	0
0010	3F	3_3	123	116	50	11600	11000	-600	0.43	0.95	20	19	-1
0010	3F	3_3	124	367	107	36700	32740	-3960	0.29	0.89	64	57	-7
0010	3F	3_3	125	352	72	35200	25310	-9890	0.20	0.72	62	44	-18
0010	3F	3_3	126	375	63	37500	27460	-10040	0.17	0.73	66	48	-18
0010	3F	3_3	134	225	56	22500	17690	-4810	0.25	0.79	39	31	-8
0010	3F	3_3	135	254	53	25400	18880	-6520	0.21	0.74	44	33	-11
0010	3F	3_3	136	223	36	22300	15570	-6730	0.16	0.70	39	27	-12
0010	3F	3_3	145	143	35	14300	14360	60	0.24	1.00	25	25	0
0010	3F	3_3	146	102	21	10200	9000	-1200	0.21	0.88	18	15	-3
0010	3F	3_3	156	40	8	4000	4850	850	0.20	1.21	7	8	1
0010	3F	3_3	234	42	11	4200	4360	160	0.26	1.04	7	7	0
0010	3F	3_3	235	27	5	2700	1700	-1000	0.19	0.63	4	3	-1
0010	3F	3_3	236	51	3	5100	1820	-3280	0.06	0.36	9	3	-6
0010	3F	3_3	245	19	2	1900	900	-1000	0.11	0.47	3	1	-2
0010	3F	3_3	246	16	0	1600	0	-1600	0.00	0.00	2	0	-2
0010	3F	3_3	256	14	0	1400	0	-1400	0.00	0.00	2	0	-2
0010	3F	3_4	123	71	23	7100	5840	-1260	0.32	0.82	12	10	-2
0010	3F	3_4	124	384	84	38400	30300	-8100	0.22	0.79	67	53	-14
0010	3F	3_4	125	434	60	43400	25410	-17990	0.14	0.59	76	44	-32
0010	3F	3_4	126	594	63	59400	52460	-6940	0.11	0.88	105	92	-13
0010	3F	3_4	134	193	43	19300	15620	-3680	0.22	0.81	34	27	-7
0010	3F	3_4	135	248	51	24800	25180	380	0.21	1.02	43	44	1
0010	3F	3_4	136	340	46	34000	29670	-4330	0.14	0.87	60	52	-8
0010	3F	3_4	145	91	10	9100	3900	-5200	0.11	0.43	16	6	-10
0010	3F	3_4	146	100	6	10000	3570	-6430	0.06	0.36	17	6	-11
0010	3F	3_4	156	26	5	2600	4170	1570	0.19	1.60	4	7	3
0010	3F	3_4	234	3	1	300	480	180	0.33	1.60	0	0	0
0010	3F	3_4	235	13	0	1300	0	-1300	0.00	0.00	2	0	-2
0010	3F	3_4	236	17	1	1700	1120	-580	0.06	0.66	3	1	-2
0010	3F	3_4	245	12	0	1200	0	-1200	0.00	0.00	2	0	-2
0010	3F	3_4	246	6	1	600	670	70	0.17	1.12	1	1	0
0010	3F	3_4	256	1	0	100	0	-100	0.00	0.00	0	0	0
0010	3F	3_5	123	7	4	700	1090	390	0.57	1.56	1	1	0
0010	3F	3_5	124	180	35	18000	13900	-4100	0.19	0.77	31	24	-7
0010	3F	3_5	125	148	17	14800	8800	-6000	0.11	0.59	26	15	-11
0010	3F	3_5	126	175	19	17500	24480	6980	0.11	1.40	30	43	13
0010	3F	3_5	134	51	8	5100	3540	-1560	0.16	0.69	9	6	-3
0010	3F	3_5	135	61	9	6100	6080	-20	0.15	1.00	10	10	0
0010	3F	3_5	136	82	7	8200	3630	-4570	0.09	0.44	14	6	-8
0010	3F	3_5	145	25	3	2500	2820	320	0.12	1.13	4	4	0
0010	3F	3_5	146	14	0	1400	0	-1400	0.00	0.00	2	0	-2
0010	3F	3_5	156	1	0	100	0	-100	0.00	0.00	0	0	0
0010	3F	3_5	245	1	0	100	0	-100	0.00	0.00	0	0	0
0010	3F	3_6	123	2	0	200	0	-200	0.00	0.00	0	0	0
0010	3F	3_6	124	51	6	5100	2790	-2310	0.12	0.55	9	4	-5
0010	3F	3_6	125	41	5	4100	3690	-410	0.12	0.90	7	6	-1
0010	3F	3_6	126	106	12	10600	20000	9400	0.11	1.89	18	35	17
0010	3F	3_6	134	8	2	800	1040	240	0.25	1.30	1	1	0
0010	3F	3_6	135	25	3	2500	1060	-1440	0.12	0.42	4	1	-3
0010	3F	3_6	136	35	6	3500	7970	4470	0.17	2.28	6	14	8
0010	3F	3_6	145	1	0	100	0	-100	0.00	0.00	0	0	0
0010	3F	3_6	146	2	0	200	0	-200	0.00	0.00	0	0	0
0010	3F	4_0	123	70	19	7000	7070	70	0.27	1.01	12	12	0
0010	3F	4_0	124	34	6	3400	2210	-1190	0.18	0.65	6	3	-3
0010	3F	4_0	125	35	7	3500	3300	-200	0.20	0.94	6	5	-1
0010	3F	4_0	126	17	1	1700	1580	-120	0.06	0.93	3	2	-1
0010	3F	4_0	134	17	4	1700	1610	-90	0.24	0.95	3	2	-1
0010	3F	4_0	135	15	1	1500	1300	-200	0.07	0.87	2	2	0
0010	3F	4_0	136	8	2	800	1410	610	0.25	1.76	1	2	1
0010	3F	4_0	145	5	0	500	0	-500	0.00	0.00	0	0	0
0010	3F	4_0	146	3	1	300	330	30	0.33	1.10	0	0	0
0010	3F	4_0	234	3	1	300	590	290	0.33	1.97	0	1	1
0010	3F	4_0	235	2	0	200	0	-200	0.00	0.00	0	0	0
0010	3F	4_0	236	1	0	100	0	-100	0.00	0.00	0	0	0
0010	3F	4_1	123	244	74	24400	23710	-690	0.30	0.97	43	41	-2
0010	3F	4_1	124	148	29	14800	10320	-4480	0.20	0.70	26	18	-8
0010	3F	4_1	125	103	14	10300	5430	-4870	0.14	0.53	18	9	-9
0010	3F	4_1	126	53	9	5300	5290	-10	0.17	1.00	9	9	0
0010	3F	4_1	134	61	12	6100	3560	-2540	0.20	0.58	10	6	-4
0010	3F	4_1	135	36	4	3600	1400	-2200	0.11	0.39	6	2	-4
0010	3F	4_1	136	19	3	1900	1860	-40	0.16	0.98	3	3	0
0010	3F	4_1	145	12	1	1200	350	-850	0.08	0.29	2	0	-2
0010	3F	4_1	146	3	0	300	0	-300	0.00	0.00	0	0	0
0010	3F	4_1	156	2	0	200	0	-200	0.00	0.00	0	0	0
0010	3F	4_1	234	1	0	100	0	-100	0.00	0.00	0	0	0
0010	3F	4_1	235	1	0	100	0	-100	0.00	0.00	0	0	0
0010	3F	4_1	245	1	0	100	0	-100	0.00	0.00	0	0	0
0010	3F	4_2	123	200	66	20000	15610	-4390	0.33	0.78	35	27	-8
0010	3F	4_2	124	225	54	22500	16060	-6440	0.24	0.71	39	28	-11
0010	3F	4_2	125	189	52	18900	21350	2450	0.28	1.13	33	37	4
0010	3F	4_2	126	104	15	10400	7310	-3090	0.14	0.70	18	12	-6
0010	3F	4_2	134	108	19	10800	5410	-5390	0.18	0.50	19	9	-10
0010	3F	4_2	135	85	13	8500	4340	-4160	0.15	0.51	15	7	-8
0010	3F	4_2	136	64	18	6400	7690	1290	0.28	1.20	11	13	2
0010	3F	4_2	145	44	11	4400	4500	100	0.25	1.02	7	7	0
0010	3F	4_2	146	19	3	1900	1120	-780	0.16	0.59	3	1	-2
0010	3F	4_2	156	15	3	1500	950	-550	0.20	0.63	2	1	-1
0010	3F	4_2	234	7	1	700	550	-150	0.14	0.79	1	0	-1
0010	3F	4_2	235	3	0	300	0	-300	0.00	0.00	0	0	0
0010	3F	4_2	236	3	1	300	390	90	0.33	1.30	0	0	0
0010	3F	4_2	245	5	0	500	0	-500	0.00	0.00	0	0	0
0010	3F	4_2	246	5	0	500	0	-500	0.00	0.00	0	0	0
0010	3F	4_2	256	2	0	200	0	-200	0.00	0.00	0	0	0
0010	3F	4_3	123	227	83	22700	18180	-4520	0.37	0.80	40	32	-8
0010	3F	4_3	124	506	123	50600	39690	-10910	0.24	0.78	89	70	-19
0010	3F	4_3	125	366	68	36600	26910	-9690	0.19	0.74	64	47	-17
0010	3F	4_3	126	247	38	24700	18300	-6400	0.15	0.74	43	32	-11
0010	3F	4_3	134	262	86	26200	22680	-3520	0.33	0.87	46	40	-6
0010	3F	4_3	135	285	62	28500	19530	-8970	0.22	0.69	50	34	-16
0010	3F	4_3	136	165	27	16500	11640	-4860	0.16	0.71	29	20	-9
0010	3F	4_3	145	119	22	11900	13070	1170	0.18	1.10	21	23	2
0010	3F	4_3	146	77	13	7700	10730	3030	0.17	1.39	13	18	5
0010	3F	4_3	156	25	6	2500	4560	2060	0.24	1.82	4	8	4
0010	3F	4_3	234	14	2	1400	580	-820	0.14	0.41	2	1	-1
0010	3F	4_3	235	29	4	2900	1070	-1830	0.14	0.37	5	1	-4
0010	3F	4_3	236	17	3	1700	1880	180	0.18	1.11	3	3	0
0010	3F	4_3	245	20	2	2000	590	-1410	0.10	0.30	3	1	-2
0010	3F	4_3	246	6	1	600	150	-450	0.17	0.25	1	0	-1
0010	3F	4_3	256	3	0	300	0	-300	0.00	0.00	0	0	0
0010	3F	4_4	123	199	59	19900	14710	-5190	0.30	0.74	35	26	-9
0010	3F	4_4	124	620	124	62000	43950	-18050	0.20	0.71	109	77	-32
0010	3F	4_4	125	331	56	33100	32920	-180	0.17	0.99	58	58	0
0010	3F	4_4	126	199	25	19900	21730	1830	0.13	1.09	35	38	3
0010	3F	4_4	134	188	48	18800	16610	-2190	0.26	0.88	33	29	-4
0010	3F	4_4	135	143	40	14300	16530	2230	0.28	1.16	25	29	4
0010	3F	4_4	136	102	12	10200	6370	-3830	0.12	0.62	18	11	-7
0010	3F	4_4	145	52	8	5200	3880	-1320	0.15	0.75	9	6	-3
0010	3F	4_4	146	43	3	4300	1450	-2850	0.07	0.34	7	2	-5
0010	3F	4_4	156	6	0	600	0	-600	0.00	0.00	1	0	-1
0010	3F	4_4	234	7	1	700	220	-480	0.14	0.31	1	0	-1
0010	3F	4_4	235	7	3	700	1520	820	0.43	2.17	1	2	1
0010	3F	4_4	236	1	0	100	0	-100	0.00	0.00	0	0	0
0010	3F	4_4	245	5	0	500	0	-500	0.00	0.00	0	0	0
0010	3F	4_4	246	5	2	500	1730	1230	0.40	3.46	0	3	3
0010	3F	4_4	256	1	0	100	0	-100	0.00	0.00	0	0	0
0010	3F	4_5	123	89	24	8900	6970	-1930	0.27	0.78	15	12	-3
0010	3F	4_5	124	383	71	38300	27060	-11240	0.19	0.71	67	47	-20
0010	3F	4_5	125	91	10	9100	5790	-3310	0.11	0.64	16	10	-6
0010	3F	4_5	126	62	4	6200	3740	-2460	0.06	0.60	10	6	-4
0010	3F	4_5	134	79	18	7900	6960	-940	0.23	0.88	13	12	-1
0010	3F	4_5	135	30	3	3000	1490	-1510	0.10	0.50	5	2	-3
0010	3F	4_5	136	27	3	2700	2300	-400	0.11	0.85	4	4	0
0010	3F	4_5	145	8	2	800	1050	250	0.25	1.31	1	1	0
0010	3F	4_5	146	7	0	700	0	-700	0.00	0.00	1	0	-1
0010	3F	4_5	236	1	0	100	0	-100	0.00	0.00	0	0	0
0010	3F	4_6	123	34	6	3400	1740	-1660	0.18	0.51	6	3	-3
0010	3F	4_6	124	160	29	16000	12680	-3320	0.18	0.79	28	22	-6
0010	3F	4_6	125	15	1	1500	620	-880	0.07	0.41	2	1	-1
0010	3F	4_6	126	57	4	5700	4070	-1630	0.07	0.71	10	7	-3
0010	3F	4_6	134	17	6	1700	2940	1240	0.35	1.73	3	5	2
0010	3F	4_6	135	3	0	300	0	-300	0.00	0.00	0	0	0
0010	3F	4_6	136	12	2	1200	2950	1750	0.17	2.46	2	5	3
0010	3F	4_6	145	1	0	100	0	-100	0.00	0.00	0	0	0
0010	3F	5_-1	123	1	0	100	0	-100	0.00	0.00	0	0	0
0010	3F	5_-1	124	6	0	600	0	-600	0.00	0.00	1	0	-1
0010	3F	5_-1	125	3	0	300	0	-300	0.00	0.00	0	0	0
0010	3F	5_-1	126	1	0	100	0	-100	0.00	0.00	0	0	0
0010	3F	5_-1	134	1	0	100	0	-100	0.00	0.00	0	0	0
0010	3F	5_-1	135	1	0	100	0	-100	0.00	0.00	0	0	0
0010	3F	5_-1	145	1	0	100	0	-100	0.00	0.00	0	0	0
0010	3F	5_-1	146	1	0	100	0	-100	0.00	0.00	0	0	0
0010	3F	5_0	123	108	24	10800	9840	-960	0.22	0.91	19	17	-2
0010	3F	5_0	124	46	6	4600	2330	-2270	0.13	0.51	8	4	-4
0010	3F	5_0	125	51	4	5100	1780	-3320	0.08	0.35	9	3	-6
0010	3F	5_0	126	34	3	3400	2740	-660	0.09	0.81	6	4	-2
0010	3F	5_0	134	29	9	2900	3400	500	0.31	1.17	5	6	1
0010	3F	5_0	135	25	5	2500	2430	-70	0.20	0.97	4	4	0
0010	3F	5_0	136	9	2	900	1150	250	0.22	1.28	1	2	1
0010	3F	5_0	145	8	1	800	410	-390	0.13	0.51	1	0	-1
0010	3F	5_0	146	1	0	100	0	-100	0.00	0.00	0	0	0
0010	3F	5_0	156	1	0	100	0	-100	0.00	0.00	0	0	0
0010	3F	5_0	235	1	0	100	0	-100	0.00	0.00	0	0	0
0010	3F	5_1	123	197	48	19700	13420	-6280	0.24	0.68	34	23	-11
0010	3F	5_1	124	185	45	18500	14470	-4030	0.24	0.78	32	25	-7
0010	3F	5_1	125	73	12	7300	5540	-1760	0.16	0.76	12	9	-3
0010	3F	5_1	126	62	10	6200	4620	-1580	0.16	0.75	10	8	-2
0010	3F	5_1	134	60	10	6000	3780	-2220	0.17	0.63	10	6	-4
0010	3F	5_1	135	18	1	1800	610	-1190	0.06	0.34	3	1	-2
0010	3F	5_1	136	28	6	2800	3500	700	0.21	1.25	4	6	2
0010	3F	5_1	145	17	2	1700	720	-980	0.12	0.42	3	1	-2
0010	3F	5_1	146	7	2	700	1020	320	0.29	1.46	1	1	0
0010	3F	5_1	156	3	2	300	860	560	0.67	2.87	0	1	1
0010	3F	5_1	234	1	0	100	0	-100	0.00	0.00	0	0	0
0010	3F	5_1	236	1	0	100	0	-100	0.00	0.00	0	0	0
0010	3F	5_2	123	155	36	15500	9090	-6410	0.23	0.59	27	16	-11
0010	3F	5_2	124	197	60	19700	15380	-4320	0.30	0.78	34	27	-7
0010	3F	5_2	125	124	29	12400	10520	-1880	0.23	0.85	21	18	-3
0010	3F	5_2	126	115	29	11500	10550	-950	0.25	0.92	20	18	-2
0010	3F	5_2	134	109	35	10900	9500	-1400	0.32	0.87	19	16	-3
0010	3F	5_2	135	77	13	7700	5820	-1880	0.17	0.76	13	10	-3
0010	3F	5_2	136	67	13	6700	4720	-1980	0.19	0.70	11	8	-3
0010	3F	5_2	145	46	6	4600	3100	-1500	0.13	0.67	8	5	-3
0010	3F	5_2	146	43	11	4300	4670	370	0.26	1.09	7	8	1
0010	3F	5_2	156	15	2	1500	1000	-500	0.13	0.67	2	1	-1
0010	3F	5_2	234	4	1	400	610	210	0.25	1.53	0	1	1
0010	3F	5_2	235	2	1	200	390	190	0.50	1.95	0	0	0
0010	3F	5_2	236	3	0	300	0	-300	0.00	0.00	0	0	0
0010	3F	5_2	245	2	0	200	0	-200	0.00	0.00	0	0	0
0010	3F	5_2	256	3	0	300	0	-300	0.00	0.00	0	0	0
0010	3F	5_3	123	180	74	18000	16360	-1640	0.41	0.91	31	28	-3
0010	3F	5_3	124	356	80	35600	22420	-13180	0.22	0.63	63	39	-24
0010	3F	5_3	125	293	61	29300	26130	-3170	0.21	0.89	51	46	-5
0010	3F	5_3	126	230	39	23000	26800	3800	0.17	1.17	40	47	7
0010	3F	5_3	134	209	60	20900	17010	-3890	0.29	0.81	36	30	-6
0010	3F	5_3	135	179	44	17900	16590	-1310	0.25	0.93	31	29	-2
0010	3F	5_3	136	182	33	18200	16490	-1710	0.18	0.91	32	29	-3
0010	3F	5_3	145	146	34	14600	11880	-2720	0.23	0.81	25	21	-4
0010	3F	5_3	146	58	11	5800	8060	2260	0.19	1.39	10	14	4
0010	3F	5_3	156	32	6	3200	3940	740	0.19	1.23	5	6	1
0010	3F	5_3	234	4	1	400	420	20	0.25	1.05	0	0	0
0010	3F	5_3	235	6	1	600	440	-160	0.17	0.73	1	0	-1
0010	3F	5_3	236	11	1	1100	290	-810	0.09	0.26	1	0	-1
0010	3F	5_3	245	2	2	200	720	520	1.00	3.60	0	1	1
0010	3F	5_3	246	5	0	500	0	-500	0.00	0.00	0	0	0
0010	3F	5_3	256	1	0	100	0	-100	0.00	0.00	0	0	0
0010	3F	5_4	123	92	29	9200	7140	-2060	0.32	0.78	16	12	-4
0010	3F	5_4	124	389	81	38900	29520	-9380	0.21	0.76	68	52	-16
0010	3F	5_4	125	256	36	25600	19000	-6600	0.14	0.74	45	33	-12
0010	3F	5_4	126	216	34	21600	25740	4140	0.16	1.19	38	45	7
0010	3F	5_4	134	124	28	12400	8830	-3570	0.23	0.71	21	15	-6
0010	3F	5_4	135	111	9	11100	5100	-6000	0.08	0.46	19	9	-10
0010	3F	5_4	136	102	5	10200	3210	-6990	0.05	0.31	18	5	-13
0010	3F	5_4	145	49	10	4900	4090	-810	0.20	0.83	8	7	-1
0010	3F	5_4	146	29	5	2900	2880	-20	0.17	0.99	5	5	0
0010	3F	5_4	156	6	1	600	530	-70	0.17	0.88	1	0	-1
0010	3F	5_4	234	2	0	200	0	-200	0.00	0.00	0	0	0
0010	3F	5_4	235	4	0	400	0	-400	0.00	0.00	0	0	0
0010	3F	5_4	236	2	1	200	1040	840	0.50	5.20	0	1	1
0010	3F	5_4	246	3	1	300	430	130	0.33	1.43	0	0	0
0010	3F	5_5	123	66	17	6600	4310	-2290	0.26	0.65	11	7	-4
0010	3F	5_5	124	359	63	35900	23060	-12840	0.18	0.64	63	40	-23
0010	3F	5_5	125	184	27	18400	17180	-1220	0.15	0.93	32	30	-2
0010	3F	5_5	126	142	15	14200	15540	1340	0.11	1.09	25	27	2
0010	3F	5_5	134	28	5	2800	3020	220	0.18	1.08	4	5	1
0010	3F	5_5	135	35	1	3500	510	-2990	0.03	0.15	6	0	-6
0010	3F	5_5	136	30	6	3000	7110	4110	0.20	2.37	5	12	7
0010	3F	5_5	145	7	1	700	730	30	0.14	1.04	1	1	0
0010	3F	5_5	235	1	0	100	0	-100	0.00	0.00	0	0	0
0010	3F	5_6	123	32	9	3200	3040	-160	0.28	0.95	5	5	0
0010	3F	5_6	124	139	17	13900	7610	-6290	0.12	0.55	24	13	-11
0010	3F	5_6	125	31	4	3100	2550	-550	0.13	0.82	5	4	-1
0010	3F	5_6	126	58	4	5800	5150	-650	0.07	0.89	10	9	-1
0010	3F	5_6	134	10	1	1000	560	-440	0.10	0.56	1	0	-1
0010	3F	5_6	135	4	1	400	1180	780	0.25	2.95	0	2	2
0010	3F	5_6	136	9	0	900	0	-900	0.00	0.00	1	0	-1
0010	3F	6_0	123	5	0	500	0	-500	0.00	0.00	0	0	0
0010	3F	6_0	124	5	1	500	500	0	0.20	1.00	0	0	0
0010	3F	6_0	125	7	1	700	420	-280	0.14	0.60	1	0	-1
0010	3F	6_0	135	2	0	200	0	-200	0.00	0.00	0	0	0
0010	3F	6_0	136	1	0	100	0	-100	0.00	0.00	0	0	0
0010	3F	6_1	123	5	1	500	190	-310	0.20	0.38	0	0	0
0010	3F	6_1	124	9	0	900	0	-900	0.00	0.00	1	0	-1
0010	3F	6_1	125	8	1	800	410	-390	0.13	0.51	1	0	-1
0010	3F	6_1	126	4	1	400	490	90	0.25	1.23	0	0	0
0010	3F	6_1	134	1	0	100	0	-100	0.00	0.00	0	0	0
0010	3F	6_1	135	3	0	300	0	-300	0.00	0.00	0	0	0
0010	3F	6_1	136	3	2	300	1020	720	0.67	3.40	0	1	1
0010	3F	6_1	145	2	0	200	0	-200	0.00	0.00	0	0	0
0010	3F	6_2	123	5	1	500	230	-270	0.20	0.46	0	0	0
0010	3F	6_2	124	14	4	1400	790	-610	0.29	0.56	2	1	-1
0010	3F	6_2	125	3	1	300	170	-130	0.33	0.57	0	0	0
0010	3F	6_2	126	4	0	400	0	-400	0.00	0.00	0	0	0
0010	3F	6_2	134	4	0	400	0	-400	0.00	0.00	0	0	0
0010	3F	6_2	135	4	0	400	0	-400	0.00	0.00	0	0	0
0010	3F	6_2	136	3	1	300	300	0	0.33	1.00	0	0	0
0010	3F	6_2	145	1	0	100	0	-100	0.00	0.00	0	0	0
0010	3F	6_2	146	2	0	200	0	-200	0.00	0.00	0	0	0
0010	3F	6_2	156	2	0	200	0	-200	0.00	0.00	0	0	0
0010	3F	6_2	235	1	1	100	840	740	1.00	8.40	0	1	1
0010	3F	6_2	246	1	0	100	0	-100	0.00	0.00	0	0	0
0010	3F	6_3	123	24	3	2400	890	-1510	0.13	0.37	4	1	-3
0010	3F	6_3	124	33	4	3300	870	-2430	0.12	0.26	5	1	-4
0010	3F	6_3	125	15	4	1500	2410	910	0.27	1.61	2	4	2
0010	3F	6_3	126	21	6	2100	2600	500	0.29	1.24	3	4	1
0010	3F	6_3	134	12	5	1200	1350	150	0.42	1.13	2	2	0
0010	3F	6_3	135	12	4	1200	820	-380	0.33	0.68	2	1	-1
0010	3F	6_3	136	13	1	1300	270	-1030	0.08	0.21	2	0	-2
0010	3F	6_3	145	9	3	900	730	-170	0.33	0.81	1	1	0
0010	3F	6_3	146	5	1	500	250	-250	0.20	0.50	0	0	0
0010	3F	6_3	156	1	0	100	0	-100	0.00	0.00	0	0	0
0010	3F	6_3	235	1	0	100	0	-100	0.00	0.00	0	0	0
0010	3F	6_4	123	10	5	1000	1240	240	0.50	1.24	1	2	1
0010	3F	6_4	124	44	8	4400	1870	-2530	0.18	0.43	7	3	-4
0010	3F	6_4	125	20	6	2000	2860	860	0.30	1.43	3	5	2
0010	3F	6_4	126	10	2	1000	3160	2160	0.20	3.16	1	5	4
0010	3F	6_4	134	12	1	1200	220	-980	0.08	0.18	2	0	-2
0010	3F	6_4	135	12	2	1200	490	-710	0.17	0.41	2	0	-2
0010	3F	6_4	136	8	0	800	0	-800	0.00	0.00	1	0	-1
0010	3F	6_4	145	5	1	500	370	-130	0.20	0.74	0	0	0
0010	3F	6_4	146	2	0	200	0	-200	0.00	0.00	0	0	0
0010	3F	6_4	156	3	0	300	0	-300	0.00	0.00	0	0	0
0010	3F	6_5	123	9	5	900	1610	710	0.56	1.79	1	2	1
0010	3F	6_5	124	44	11	4400	3820	-580	0.25	0.87	7	6	-1
0010	3F	6_5	125	2	1	200	870	670	0.50	4.35	0	1	1
0010	3F	6_5	126	8	1	800	710	-90	0.13	0.89	1	1	0
0010	3F	6_5	134	5	0	500	0	-500	0.00	0.00	0	0	0
0010	3F	6_5	135	1	0	100	0	-100	0.00	0.00	0	0	0
0010	3F	6_5	136	1	0	100	0	-100	0.00	0.00	0	0	0
0010	3F	6_6	123	7	3	700	1030	330	0.43	1.47	1	1	0
0010	3F	6_6	124	12	3	1200	1590	390	0.25	1.33	2	2	0
0010	3F	6_6	125	3	1	300	1050	750	0.33	3.50	0	1	1
0010	3F	6_6	126	6	0	600	0	-600	0.00	0.00	1	0	-1
0010	3F	6_6	134	1	0	100	0	-100	0.00	0.00	0	0	0
0010	3F	7_-1	123	7	3	700	590	-110	0.43	0.84	1	1	0
0010	3F	7_-1	124	4	0	400	0	-400	0.00	0.00	0	0	0
0010	3F	7_-1	126	2	0	200	0	-200	0.00	0.00	0	0	0
0010	3F	7_-1	134	1	0	100	0	-100	0.00	0.00	0	0	0
0010	3F	7_-1	136	2	0	200	0	-200	0.00	0.00	0	0	0
0010	3F	7_-1	145	1	1	100	340	240	1.00	3.40	0	0	0
0010	3F	7_-1	146	2	0	200	0	-200	0.00	0.00	0	0	0
0010	3F	7_-1	236	1	0	100	0	-100	0.00	0.00	0	0	0
0010	3F	7_0	123	266	62	26600	22490	-4110	0.23	0.85	47	39	-8
0010	3F	7_0	124	95	20	9500	7260	-2240	0.21	0.76	16	12	-4
0010	3F	7_0	125	75	11	7500	5360	-2140	0.15	0.71	13	9	-4
0010	3F	7_0	126	53	6	5300	2970	-2330	0.11	0.56	9	5	-4
0010	3F	7_0	134	49	9	4900	4540	-360	0.18	0.93	8	8	0
0010	3F	7_0	135	30	5	3000	3730	730	0.17	1.24	5	6	1
0010	3F	7_0	136	17	2	1700	1450	-250	0.12	0.85	3	2	-1
0010	3F	7_0	145	8	1	800	860	60	0.13	1.08	1	1	0
0010	3F	7_0	146	4	0	400	0	-400	0.00	0.00	0	0	0
0010	3F	7_0	156	4	0	400	0	-400	0.00	0.00	0	0	0
0010	3F	7_0	234	1	0	100	0	-100	0.00	0.00	0	0	0
0010	3F	7_0	235	2	1	200	490	290	0.50	2.45	0	0	0
0010	3F	7_0	236	1	0	100	0	-100	0.00	0.00	0	0	0
0010	3F	7_1	123	588	153	58800	48690	-10110	0.26	0.83	104	86	-18
0010	3F	7_1	124	266	56	26600	22410	-4190	0.21	0.84	47	39	-8
0010	3F	7_1	125	157	25	15700	9000	-6700	0.16	0.57	27	15	-12
0010	3F	7_1	126	97	17	9700	9450	-250	0.18	0.97	17	16	-1
0010	3F	7_1	134	111	21	11100	8310	-2790	0.19	0.75	19	14	-5
0010	3F	7_1	135	74	15	7400	6510	-890	0.20	0.88	13	11	-2
0010	3F	7_1	136	51	6	5100	3470	-1630	0.12	0.68	9	6	-3
0010	3F	7_1	145	38	5	3800	3360	-440	0.13	0.88	6	5	-1
0010	3F	7_1	146	19	1	1900	540	-1360	0.05	0.28	3	0	-3
0010	3F	7_1	156	3	0	300	0	-300	0.00	0.00	0	0	0
0010	3F	7_1	234	4	0	400	0	-400	0.00	0.00	0	0	0
0010	3F	7_1	235	3	0	300	0	-300	0.00	0.00	0	0	0
0010	3F	7_1	236	2	1	200	410	210	0.50	2.05	0	0	0
0010	3F	7_1	245	1	0	100	0	-100	0.00	0.00	0	0	0
0010	3F	7_1	246	1	0	100	0	-100	0.00	0.00	0	0	0
0010	3F	7_2	123	410	103	41000	31050	-9950	0.25	0.76	72	54	-18
0010	3F	7_2	124	469	110	46900	32800	-14100	0.23	0.70	83	58	-25
0010	3F	7_2	125	317	66	31700	26550	-5150	0.21	0.84	56	46	-10
0010	3F	7_2	126	277	44	27700	28030	330	0.16	1.01	49	49	0
0010	3F	7_2	134	185	48	18500	17460	-1040	0.26	0.94	32	30	-2
0010	3F	7_2	135	169	30	16900	11370	-5530	0.18	0.67	29	20	-9
0010	3F	7_2	136	142	16	14200	8590	-5610	0.11	0.60	25	15	-10
0010	3F	7_2	145	76	12	7600	5240	-2360	0.16	0.69	13	9	-4
0010	3F	7_2	146	47	5	4700	2650	-2050	0.11	0.56	8	4	-4
0010	3F	7_2	156	16	3	1600	2910	1310	0.19	1.82	2	5	3
0010	3F	7_2	234	3	0	300	0	-300	0.00	0.00	0	0	0
0010	3F	7_2	235	5	0	500	0	-500	0.00	0.00	0	0	0
0010	3F	7_2	236	5	0	500	0	-500	0.00	0.00	0	0	0
0010	3F	7_2	245	1	0	100	0	-100	0.00	0.00	0	0	0
0010	3F	7_2	246	1	0	100	0	-100	0.00	0.00	0	0	0
0010	3F	7_2	256	2	1	200	1080	880	0.50	5.40	0	1	1
0010	3F	7_3	123	280	85	28000	21580	-6420	0.30	0.77	49	38	-11
0010	3F	7_3	124	607	132	60700	39100	-21600	0.22	0.64	107	69	-38
0010	3F	7_3	125	424	80	42400	37260	-5140	0.19	0.88	75	65	-10
0010	3F	7_3	126	378	56	37800	30950	-6850	0.15	0.82	66	54	-12
0010	3F	7_3	134	246	64	24600	19220	-5380	0.26	0.78	43	34	-9
0010	3F	7_3	135	234	33	23400	10660	-12740	0.14	0.46	41	18	-23
0010	3F	7_3	136	216	39	21600	21810	210	0.18	1.01	38	38	0
0010	3F	7_3	145	116	17	11600	8150	-3450	0.15	0.70	20	14	-6
0010	3F	7_3	146	79	10	7900	4250	-3650	0.13	0.54	13	7	-6
0010	3F	7_3	156	33	4	3300	1760	-1540	0.12	0.53	5	3	-2
0010	3F	7_3	234	5	0	500	0	-500	0.00	0.00	0	0	0
0010	3F	7_3	235	9	0	900	0	-900	0.00	0.00	1	0	-1
0010	3F	7_3	236	2	0	200	0	-200	0.00	0.00	0	0	0
0010	3F	7_3	245	6	0	600	0	-600	0.00	0.00	1	0	-1
0010	3F	7_3	246	5	2	500	960	460	0.40	1.92	0	1	1
0010	3F	7_3	256	4	0	400	0	-400	0.00	0.00	0	0	0
0010	3F	7_4	123	134	45	13400	12900	-500	0.34	0.96	23	22	-1
0010	3F	7_4	124	455	99	45500	37810	-7690	0.22	0.83	80	66	-14
0010	3F	7_4	125	259	40	25900	25320	-580	0.15	0.98	45	44	-1
0010	3F	7_4	126	200	19	20000	14870	-5130	0.10	0.74	35	26	-9
0010	3F	7_4	134	112	14	11200	5690	-5510	0.13	0.51	19	10	-9
0010	3F	7_4	135	97	13	9700	9430	-270	0.13	0.97	17	16	-1
0010	3F	7_4	136	97	9	9700	5500	-4200	0.09	0.57	17	9	-8
0010	3F	7_4	145	33	3	3300	1110	-2190	0.09	0.34	5	1	-4
0010	3F	7_4	146	28	4	2800	4850	2050	0.14	1.73	4	8	4
0010	3F	7_4	156	6	1	600	850	250	0.17	1.42	1	1	0
0010	3F	7_4	234	2	1	200	280	80	0.50	1.40	0	0	0
0010	3F	7_4	235	2	0	200	0	-200	0.00	0.00	0	0	0
0010	3F	7_4	236	1	0	100	0	-100	0.00	0.00	0	0	0
0010	3F	7_4	245	2	0	200	0	-200	0.00	0.00	0	0	0
0010	3F	7_5	123	190	46	19000	17000	-2000	0.24	0.89	33	30	-3
0010	3F	7_5	124	456	74	45600	31200	-14400	0.16	0.68	80	55	-25
0010	3F	7_5	125	97	9	9700	6100	-3600	0.09	0.63	17	10	-7
0010	3F	7_5	126	153	13	15300	13920	-1380	0.08	0.91	27	24	-3
0010	3F	7_5	134	50	11	5000	4370	-630	0.22	0.87	8	7	-1
0010	3F	7_5	135	19	2	1900	1100	-800	0.11	0.58	3	1	-2
0010	3F	7_5	136	38	2	3800	2010	-1790	0.05	0.53	6	3	-3
0010	3F	7_5	145	3	0	300	0	-300	0.00	0.00	0	0	0
0010	3F	7_5	146	3	0	300	0	-300	0.00	0.00	0	0	0
0010	3F	7_6	123	158	37	15800	12510	-3290	0.23	0.79	27	22	-5
0010	3F	7_6	124	408	64	40800	28270	-12530	0.16	0.69	72	50	-22
0010	3F	7_6	125	13	0	1300	0	-1300	0.00	0.00	2	0	-2
0010	3F	7_6	126	103	4	10300	6010	-4290	0.04	0.58	18	10	-8
0010	3F	7_6	134	12	3	1200	1670	470	0.25	1.39	2	2	0
0010	3F	7_6	135	4	1	400	940	540	0.25	2.35	0	1	1
0010	3F	7_6	136	7	0	700	0	-700	0.00	0.00	1	0	-1
0010	3F	7_6	146	3	0	300	0	-300	0.00	0.00	0	0	0
0010	3T	1_-1	123	3	1	300	730	430	0.33	2.43	0	1	1
0010	3T	1_-1	124	5	1	500	860	360	0.20	1.72	0	1	1
0010	3T	1_-1	125	2	1	200	690	490	0.50	3.45	0	1	1
0010	3T	1_-1	126	1	0	100	0	-100	0.00	0.00	0	0	0
0010	3T	1_-1	135	1	1	100	1040	940	1.00	10.40	0	1	1
0010	3T	1_-1	136	2	0	200	0	-200	0.00	0.00	0	0	0
0010	3T	1_-1	145	1	0	100	0	-100	0.00	0.00	0	0	0
0010	3T	1_-1	235	1	0	100	0	-100	0.00	0.00	0	0	0
0010	3T	1_0	124	220	14	22000	15770	-6230	0.06	0.72	38	27	-11
0010	3T	1_0	125	213	7	21300	14500	-6800	0.03	0.68	37	25	-12
0010	3T	1_0	126	47	2	4700	3240	-1460	0.04	0.69	8	5	-3
0010	3T	1_0	134	5	0	500	0	-500	0.00	0.00	0	0	0
0010	3T	1_0	135	11	1	1100	1560	460	0.09	1.42	1	2	1
0010	3T	1_1	123	25	3	2500	1410	-1090	0.12	0.56	4	2	-2
0010	3T	1_1	124	163	12	16300	10030	-6270	0.07	0.62	28	17	-11
0010	3T	1_1	125	97	4	9700	3880	-5820	0.04	0.40	17	6	-11
0010	3T	1_1	126	178	9	17800	21630	3830	0.05	1.22	31	38	7
0010	3T	1_1	132	83	3	8300	2650	-5650	0.04	0.32	14	4	-10
0010	3T	1_1	134	42	4	4200	3160	-1040	0.10	0.75	7	5	-2
0010	3T	1_1	135	87	2	8700	2410	-6290	0.02	0.28	15	4	-11
0010	3T	1_1	136	86	5	8600	3870	-4730	0.06	0.45	15	6	-9
0010	3T	1_1	142	36	5	3600	5310	1710	0.14	1.48	6	9	3
0010	3T	1_1	143	2	0	200	0	-200	0.00	0.00	0	0	0
0010	3T	1_1	145	47	1	4700	2000	-2700	0.02	0.43	8	3	-5
0010	3T	1_1	146	16	0	1600	0	-1600	0.00	0.00	2	0	-2
0010	3T	1_1	152	20	1	2000	1780	-220	0.05	0.89	3	3	0
0010	3T	1_1	153	5	0	500	0	-500	0.00	0.00	0	0	0
0010	3T	1_1	154	18	0	1800	0	-1800	0.00	0.00	3	0	-3
0010	3T	1_1	156	21	1	2100	1080	-1020	0.05	0.51	3	1	-2
0010	3T	1_1	162	3	0	300	0	-300	0.00	0.00	0	0	0
0010	3T	1_1	165	5	0	500	0	-500	0.00	0.00	0	0	0
0010	3T	1_1	215	4	0	400	0	-400	0.00	0.00	0	0	0
0010	3T	1_1	216	3	0	300	0	-300	0.00	0.00	0	0	0
0010	3T	1_1	234	3	1	300	880	580	0.33	2.93	0	1	1
0010	3T	1_1	235	15	0	1500	0	-1500	0.00	0.00	2	0	-2
0010	3T	1_1	236	5	0	500	0	-500	0.00	0.00	0	0	0
0010	3T	1_2	123	14	0	1400	0	-1400	0.00	0.00	2	0	-2
0010	3T	1_2	124	153	16	15300	11370	-3930	0.10	0.74	27	20	-7
0010	3T	1_2	125	162	11	16200	9500	-6700	0.07	0.59	28	16	-12
0010	3T	1_2	126	185	12	18500	16700	-1800	0.06	0.90	32	29	-3
0010	3T	1_2	132	48	4	4800	3790	-1010	0.08	0.79	8	6	-2
0010	3T	1_2	134	40	8	4000	6630	2630	0.20	1.66	7	11	4
0010	3T	1_2	135	77	3	7700	2840	-4860	0.04	0.37	13	5	-8
0010	3T	1_2	136	122	8	12200	6850	-5350	0.07	0.56	21	12	-9
0010	3T	1_2	142	28	2	2800	12670	9870	0.07	4.53	4	22	18
0010	3T	1_2	145	128	6	12800	6900	-5900	0.05	0.54	22	12	-10
0010	3T	1_2	146	59	3	5900	13710	7810	0.05	2.32	10	24	14
0010	3T	1_2	156	10	0	1000	0	-1000	0.00	0.00	1	0	-1
0010	3T	1_2	164	3	0	300	0	-300	0.00	0.00	0	0	0
0010	3T	1_2	165	2	0	200	0	-200	0.00	0.00	0	0	0
0010	3T	1_2	214	7	0	700	0	-700	0.00	0.00	1	0	-1
0010	3T	1_2	215	24	2	2400	3260	860	0.08	1.36	4	5	1
0010	3T	1_2	216	44	2	4400	2810	-1590	0.05	0.64	7	4	-3
0010	3T	1_2	234	20	2	2000	4590	2590	0.10	2.30	3	8	5
0010	3T	1_2	235	17	0	1700	0	-1700	0.00	0.00	3	0	-3
0010	3T	1_2	236	12	0	1200	0	-1200	0.00	0.00	2	0	-2
0010	3T	1_2	241	16	1	1600	2620	1020	0.06	1.64	2	4	2
0010	3T	1_2	243	3	0	300	0	-300	0.00	0.00	0	0	0
0010	3T	1_2	245	16	1	1600	1980	380	0.06	1.24	2	3	1
0010	3T	1_2	246	24	1	2400	1040	-1360	0.04	0.43	4	1	-3
0010	3T	1_2	256	4	1	400	2930	2530	0.25	7.33	0	5	5
0010	3T	1_3	123	33	5	3300	3500	200	0.15	1.06	5	6	1
0010	3T	1_3	124	281	35	28100	24400	-3700	0.12	0.87	49	43	-6
0010	3T	1_3	125	156	17	15600	18760	3160	0.11	1.20	27	33	6
0010	3T	1_3	126	299	16	29900	25980	-3920	0.05	0.87	52	45	-7
0010	3T	1_3	132	11	2	1100	850	-250	0.18	0.77	1	1	0
0010	3T	1_3	134	259	28	25900	17960	-7940	0.11	0.69	45	31	-14
0010	3T	1_3	135	220	23	22000	18960	-3040	0.10	0.86	38	33	-5
0010	3T	1_3	136	366	19	36600	27530	-9070	0.05	0.75	64	48	-16
0010	3T	1_3	142	1	0	100	0	-100	0.00	0.00	0	0	0
0010	3T	1_3	145	101	7	10100	7170	-2930	0.07	0.71	17	12	-5
0010	3T	1_3	146	175	7	17500	10680	-6820	0.04	0.61	30	18	-12
0010	3T	1_3	153	1	0	100	0	-100	0.00	0.00	0	0	0
0010	3T	1_3	156	77	3	7700	9550	1850	0.04	1.24	13	16	3
0010	3T	1_3	164	19	1	1900	1260	-640	0.05	0.66	3	2	-1
0010	3T	1_3	165	12	1	1200	1750	550	0.08	1.46	2	3	1
0010	3T	1_3	213	3	0	300	0	-300	0.00	0.00	0	0	0
0010	3T	1_3	214	45	1	4500	1660	-2840	0.02	0.37	7	2	-5
0010	3T	1_3	215	117	5	11700	8310	-3390	0.04	0.71	20	14	-6
0010	3T	1_3	216	261	8	26100	19300	-6800	0.03	0.74	46	34	-12
0010	3T	1_3	234	15	1	1500	1520	20	0.07	1.01	2	2	0
0010	3T	1_3	235	23	2	2300	8210	5910	0.09	3.57	4	14	10
0010	3T	1_3	236	30	2	3000	2560	-440	0.07	0.85	5	4	-1
0010	3T	1_3	245	26	0	2600	0	-2600	0.00	0.00	4	0	-4
0010	3T	1_3	246	29	1	2900	6600	3700	0.03	2.28	5	11	6
0010	3T	1_3	256	21	1	2100	1210	-890	0.05	0.58	3	2	-1
0010	3T	1_3	265	3	0	300	0	-300	0.00	0.00	0	0	0
0010	3T	1_4	123	6	0	600	0	-600	0.00	0.00	1	0	-1
0010	3T	1_4	124	234	19	23400	14760	-8640	0.08	0.63	41	26	-15
0010	3T	1_4	125	290	24	29000	34910	5910	0.08	1.20	51	61	10
0010	3T	1_4	126	283	9	28300	13980	-14320	0.03	0.49	50	24	-26
0010	3T	1_4	132	4	1	400	510	110	0.25	1.28	0	0	0
0010	3T	1_4	134	139	14	13900	10470	-3430	0.10	0.75	24	18	-6
0010	3T	1_4	135	152	9	15200	12510	-2690	0.06	0.82	26	22	-4
0010	3T	1_4	136	192	7	19200	12710	-6490	0.04	0.66	33	22	-11
0010	3T	1_4	145	82	3	8200	6110	-2090	0.04	0.75	14	10	-4
0010	3T	1_4	146	104	4	10400	10240	-160	0.04	0.98	18	18	0
0010	3T	1_4	156	19	3	1900	6360	4460	0.16	3.35	3	11	8
0010	3T	1_4	164	2	0	200	0	-200	0.00	0.00	0	0	0
0010	3T	1_4	165	5	0	500	0	-500	0.00	0.00	0	0	0
0010	3T	1_4	214	17	1	1700	1740	40	0.06	1.02	3	3	0
0010	3T	1_4	215	40	1	4000	5240	1240	0.03	1.31	7	9	2
0010	3T	1_4	216	113	2	11300	9090	-2210	0.02	0.80	20	16	-4
0010	3T	1_4	235	3	0	300	0	-300	0.00	0.00	0	0	0
0010	3T	1_4	236	7	0	700	0	-700	0.00	0.00	1	0	-1
0010	3T	1_4	245	2	0	200	0	-200	0.00	0.00	0	0	0
0010	3T	1_4	246	7	1	700	970	270	0.14	1.39	1	1	0
0010	3T	1_4	256	5	0	500	0	-500	0.00	0.00	0	0	0
0010	3T	1_4	265	1	0	100	0	-100	0.00	0.00	0	0	0
0010	3T	1_5	124	46	1	4600	270	-4330	0.02	0.06	8	0	-8
0010	3T	1_5	125	64	1	6400	1410	-4990	0.02	0.22	11	2	-9
0010	3T	1_5	126	62	2	6200	2570	-3630	0.03	0.41	10	4	-6
0010	3T	1_5	134	26	2	2600	3910	1310	0.08	1.50	4	6	2
0010	3T	1_5	135	30	1	3000	570	-2430	0.03	0.19	5	1	-4
0010	3T	1_5	136	42	2	4200	3250	-950	0.05	0.77	7	5	-2
0010	3T	1_5	145	23	1	2300	1180	-1120	0.04	0.51	4	2	-2
0010	3T	1_5	146	24	1	2400	1890	-510	0.04	0.79	4	3	-1
0010	3T	1_5	156	2	0	200	0	-200	0.00	0.00	0	0	0
0010	3T	1_5	214	2	0	200	0	-200	0.00	0.00	0	0	0
0010	3T	1_5	215	2	0	200	0	-200	0.00	0.00	0	0	0
0010	3T	1_5	216	6	0	600	0	-600	0.00	0.00	1	0	-1
0010	3T	1_6	123	16	4	1600	4470	2870	0.25	2.79	2	7	5
0010	3T	1_6	124	109	7	10900	5070	-5830	0.06	0.47	19	8	-11
0010	3T	1_6	125	8	1	800	780	-20	0.13	0.98	1	1	0
0010	3T	1_6	126	814	31	81400	73240	-8160	0.04	0.90	144	129	-15
0010	3T	1_6	134	7	0	700	0	-700	0.00	0.00	1	0	-1
0010	3T	1_6	135	2	0	200	0	-200	0.00	0.00	0	0	0
0010	3T	1_6	136	121	1	12100	2190	-9910	0.01	0.18	21	3	-18
0010	3T	1_6	145	1	0	100	0	-100	0.00	0.00	0	0	0
0010	3T	1_6	146	12	0	1200	0	-1200	0.00	0.00	2	0	-2
0010	3T	1_6	215	1	0	100	0	-100	0.00	0.00	0	0	0
0010	3T	1_6	216	1	0	100	0	-100	0.00	0.00	0	0	0
0010	3T	2_-1	123	2	0	200	0	-200	0.00	0.00	0	0	0
0010	3T	2_-1	124	2	0	200	0	-200	0.00	0.00	0	0	0
0010	3T	2_-1	125	1	0	100	0	-100	0.00	0.00	0	0	0
0010	3T	2_-1	126	3	0	300	0	-300	0.00	0.00	0	0	0
0010	3T	2_-1	135	1	0	100	0	-100	0.00	0.00	0	0	0
0010	3T	2_-1	136	1	0	100	0	-100	0.00	0.00	0	0	0
0010	3T	2_-1	142	1	1	100	1170	1070	1.00	11.70	0	2	2
0010	3T	2_-1	146	1	0	100	0	-100	0.00	0.00	0	0	0
0010	3T	2_0	123	87	9	8700	7270	-1430	0.10	0.84	15	12	-3
0010	3T	2_0	124	42	5	4200	5580	1380	0.12	1.33	7	9	2
0010	3T	2_0	125	38	2	3800	2320	-1480	0.05	0.61	6	4	-2
0010	3T	2_0	126	22	0	2200	0	-2200	0.00	0.00	3	0	-3
0010	3T	2_0	134	20	1	2000	860	-1140	0.05	0.43	3	1	-2
0010	3T	2_0	135	24	4	2400	6560	4160	0.17	2.73	4	11	7
0010	3T	2_0	136	13	1	1300	550	-750	0.08	0.42	2	0	-2
0010	3T	2_0	142	1	0	100	0	-100	0.00	0.00	0	0	0
0010	3T	2_0	143	4	0	400	0	-400	0.00	0.00	0	0	0
0010	3T	2_0	145	4	0	400	0	-400	0.00	0.00	0	0	0
0010	3T	2_0	146	1	0	100	0	-100	0.00	0.00	0	0	0
0010	3T	2_0	153	3	0	300	0	-300	0.00	0.00	0	0	0
0010	3T	2_0	156	1	0	100	0	-100	0.00	0.00	0	0	0
0010	3T	2_0	235	1	0	100	0	-100	0.00	0.00	0	0	0
0010	3T	2_0	245	1	0	100	0	-100	0.00	0.00	0	0	0
0010	3T	2_1	123	306	41	30600	29860	-740	0.13	0.98	54	52	-2
0010	3T	2_1	124	121	12	12100	6710	-5390	0.10	0.55	21	11	-10
0010	3T	2_1	125	107	10	10700	8180	-2520	0.09	0.76	18	14	-4
0010	3T	2_1	126	60	3	6000	2400	-3600	0.05	0.40	10	4	-6
0010	3T	2_1	132	4	0	400	0	-400	0.00	0.00	0	0	0
0010	3T	2_1	134	46	6	4600	3300	-1300	0.13	0.72	8	5	-3
0010	3T	2_1	135	40	5	4000	3300	-700	0.13	0.83	7	5	-2
0010	3T	2_1	136	37	2	3700	2270	-1430	0.05	0.61	6	4	-2
0010	3T	2_1	142	4	1	400	520	120	0.25	1.30	0	0	0
0010	3T	2_1	143	5	0	500	0	-500	0.00	0.00	0	0	0
0010	3T	2_1	145	20	4	2000	5180	3180	0.20	2.59	3	9	6
0010	3T	2_1	146	11	0	1100	0	-1100	0.00	0.00	1	0	-1
0010	3T	2_1	156	4	0	400	0	-400	0.00	0.00	0	0	0
0010	3T	2_1	234	1	0	100	0	-100	0.00	0.00	0	0	0
0010	3T	2_1	243	1	0	100	0	-100	0.00	0.00	0	0	0
0010	3T	2_1	246	1	0	100	0	-100	0.00	0.00	0	0	0
0010	3T	2_2	123	244	26	24400	19810	-4590	0.11	0.81	43	35	-8
0010	3T	2_2	124	280	25	28000	19960	-8040	0.09	0.71	49	35	-14
0010	3T	2_2	125	182	8	18200	8350	-9850	0.04	0.46	32	14	-18
0010	3T	2_2	126	190	11	19000	13410	-5590	0.06	0.71	33	23	-10
0010	3T	2_2	132	4	0	400	0	-400	0.00	0.00	0	0	0
0010	3T	2_2	134	107	9	10700	6990	-3710	0.08	0.65	18	12	-6
0010	3T	2_2	135	100	5	10000	4600	-5400	0.05	0.46	17	8	-9
0010	3T	2_2	136	109	9	10900	11090	190	0.08	1.02	19	19	0
0010	3T	2_2	142	3	0	300	0	-300	0.00	0.00	0	0	0
0010	3T	2_2	143	2	0	200	0	-200	0.00	0.00	0	0	0
0010	3T	2_2	145	57	3	5700	2230	-3470	0.05	0.39	10	3	-7
0010	3T	2_2	146	39	5	3900	4270	370	0.13	1.09	6	7	1
0010	3T	2_2	153	2	0	200	0	-200	0.00	0.00	0	0	0
0010	3T	2_2	154	2	1	200	980	780	0.50	4.90	0	1	1
0010	3T	2_2	156	19	2	1900	2040	140	0.11	1.07	3	3	0
0010	3T	2_2	164	3	1	300	1250	950	0.33	4.17	0	2	2
0010	3T	2_2	234	6	0	600	0	-600	0.00	0.00	1	0	-1
0010	3T	2_2	235	4	0	400	0	-400	0.00	0.00	0	0	0
0010	3T	2_2	236	2	0	200	0	-200	0.00	0.00	0	0	0
0010	3T	2_2	246	2	0	200	0	-200	0.00	0.00	0	0	0
0010	3T	2_3	123	277	37	27700	22830	-4870	0.13	0.82	49	40	-9
0010	3T	2_3	124	605	51	60500	46960	-13540	0.08	0.78	107	83	-24
0010	3T	2_3	125	421	27	42100	41590	-510	0.06	0.99	74	73	-1
0010	3T	2_3	126	537	34	53700	50980	-2720	0.06	0.95	95	90	-5
0010	3T	2_3	134	255	23	25500	17640	-7860	0.09	0.69	45	31	-14
0010	3T	2_3	135	264	31	26400	32040	5640	0.12	1.21	46	56	10
0010	3T	2_3	136	354	32	35400	39270	3870	0.09	1.11	62	69	7
0010	3T	2_3	142	1	0	100	0	-100	0.00	0.00	0	0	0
0010	3T	2_3	145	113	4	11300	7160	-4140	0.04	0.63	20	12	-8
0010	3T	2_3	146	84	7	8400	10580	2180	0.08	1.26	14	18	4
0010	3T	2_3	154	4	0	400	0	-400	0.00	0.00	0	0	0
0010	3T	2_3	156	38	2	3800	2510	-1290	0.05	0.66	6	4	-2
0010	3T	2_3	164	2	1	200	1080	880	0.50	5.40	0	1	1
0010	3T	2_3	215	1	0	100	0	-100	0.00	0.00	0	0	0
0010	3T	2_3	216	10	0	1000	0	-1000	0.00	0.00	1	0	-1
0010	3T	2_3	234	12	0	1200	0	-1200	0.00	0.00	2	0	-2
0010	3T	2_3	235	13	1	1300	400	-900	0.08	0.31	2	0	-2
0010	3T	2_3	236	22	0	2200	0	-2200	0.00	0.00	3	0	-3
0010	3T	2_3	245	9	1	900	1350	450	0.11	1.50	1	2	1
0010	3T	2_3	246	7	0	700	0	-700	0.00	0.00	1	0	-1
0010	3T	2_3	256	7	0	700	0	-700	0.00	0.00	1	0	-1
0010	3T	2_4	123	208	21	20800	15930	-4870	0.10	0.77	36	28	-8
0010	3T	2_4	124	617	68	61700	66200	4500	0.11	1.07	109	117	8
0010	3T	2_4	125	329	23	32900	24080	-8820	0.07	0.73	58	42	-16
0010	3T	2_4	126	482	32	48200	36700	-11500	0.07	0.76	85	64	-21
0010	3T	2_4	134	218	25	21800	22910	1110	0.11	1.05	38	40	2
0010	3T	2_4	135	176	18	17600	16110	-1490	0.10	0.92	31	28	-3
0010	3T	2_4	136	262	10	26200	10910	-15290	0.04	0.42	46	19	-27
0010	3T	2_4	145	55	5	5500	5110	-390	0.09	0.93	9	9	0
0010	3T	2_4	146	70	6	7000	6600	-400	0.09	0.94	12	11	-1
0010	3T	2_4	154	1	0	100	0	-100	0.00	0.00	0	0	0
0010	3T	2_4	156	15	2	1500	3240	1740	0.13	2.16	2	5	3
0010	3T	2_4	164	2	1	200	710	510	0.50	3.55	0	1	1
0010	3T	2_4	215	7	0	700	0	-700	0.00	0.00	1	0	-1
0010	3T	2_4	216	10	3	1000	10490	9490	0.30	10.49	1	18	17
0010	3T	2_4	234	2	0	200	0	-200	0.00	0.00	0	0	0
0010	3T	2_4	235	2	0	200	0	-200	0.00	0.00	0	0	0
0010	3T	2_4	236	3	0	300	0	-300	0.00	0.00	0	0	0
0010	3T	2_4	245	1	0	100	0	-100	0.00	0.00	0	0	0
0010	3T	2_4	246	3	0	300	0	-300	0.00	0.00	0	0	0
0010	3T	2_4	256	1	0	100	0	-100	0.00	0.00	0	0	0
0010	3T	2_5	123	55	6	5500	4570	-930	0.11	0.83	9	8	-1
0010	3T	2_5	124	315	22	31500	17240	-14260	0.07	0.55	55	30	-25
0010	3T	2_5	125	68	3	6800	3230	-3570	0.04	0.48	12	5	-7
0010	3T	2_5	126	113	3	11300	9240	-2060	0.03	0.82	20	16	-4
0010	3T	2_5	134	60	2	6000	1890	-4110	0.03	0.32	10	3	-7
0010	3T	2_5	135	27	3	2700	4700	2000	0.11	1.74	4	8	4
0010	3T	2_5	136	35	2	3500	2820	-680	0.06	0.81	6	4	-2
0010	3T	2_5	145	4	1	400	1160	760	0.25	2.90	0	2	2
0010	3T	2_5	146	4	0	400	0	-400	0.00	0.00	0	0	0
0010	3T	2_6	123	26	5	2600	3490	890	0.19	1.34	4	6	2
0010	3T	2_6	124	267	20	26700	19580	-7120	0.07	0.73	47	34	-13
0010	3T	2_6	125	16	2	1600	3500	1900	0.13	2.19	2	6	4
0010	3T	2_6	126	96	2	9600	6430	-3170	0.02	0.67	16	11	-5
0010	3T	2_6	134	36	2	3600	1680	-1920	0.06	0.47	6	2	-4
0010	3T	2_6	135	6	0	600	0	-600	0.00	0.00	1	0	-1
0010	3T	2_6	136	17	1	1700	700	-1000	0.06	0.41	3	1	-2
0010	3T	2_6	146	1	0	100	0	-100	0.00	0.00	0	0	0
0010	3T	2_6	156	1	0	100	0	-100	0.00	0.00	0	0	0
0010	3T	3_-1	123	1	0	100	0	-100	0.00	0.00	0	0	0
0010	3T	3_-1	124	3	0	300	0	-300	0.00	0.00	0	0	0
0010	3T	3_-1	125	6	0	600	0	-600	0.00	0.00	1	0	-1
0010	3T	3_-1	126	8	1	800	1030	230	0.13	1.29	1	1	0
0010	3T	3_-1	134	4	1	400	770	370	0.25	1.93	0	1	1
0010	3T	3_-1	135	3	1	300	890	590	0.33	2.97	0	1	1
0010	3T	3_-1	136	6	0	600	0	-600	0.00	0.00	1	0	-1
0010	3T	3_-1	145	2	0	200	0	-200	0.00	0.00	0	0	0
0010	3T	3_-1	146	3	0	300	0	-300	0.00	0.00	0	0	0
0010	3T	3_-1	156	1	0	100	0	-100	0.00	0.00	0	0	0
0010	3T	3_-1	234	1	1	100	1160	1060	1.00	11.60	0	2	2
0010	3T	3_0	123	61	6	6100	7100	1000	0.10	1.16	10	12	2
0010	3T	3_0	124	117	5	11700	9380	-2320	0.04	0.80	20	16	-4
0010	3T	3_0	125	40	2	4000	1610	-2390	0.05	0.40	7	2	-5
0010	3T	3_0	126	75	4	7500	9600	2100	0.05	1.28	13	16	3
0010	3T	3_0	132	7	0	700	0	-700	0.00	0.00	1	0	-1
0010	3T	3_0	134	59	3	5900	3450	-2450	0.05	0.58	10	6	-4
0010	3T	3_0	135	17	0	1700	0	-1700	0.00	0.00	3	0	-3
0010	3T	3_0	136	31	0	3100	0	-3100	0.00	0.00	5	0	-5
0010	3T	3_0	142	3	0	300	0	-300	0.00	0.00	0	0	0
0010	3T	3_0	143	4	0	400	0	-400	0.00	0.00	0	0	0
0010	3T	3_0	145	13	2	1300	2870	1570	0.15	2.21	2	5	3
0010	3T	3_0	146	11	0	1100	0	-1100	0.00	0.00	1	0	-1
0010	3T	3_0	154	1	0	100	0	-100	0.00	0.00	0	0	0
0010	3T	3_0	156	9	0	900	0	-900	0.00	0.00	1	0	-1
0010	3T	3_0	164	1	0	100	0	-100	0.00	0.00	0	0	0
0010	3T	3_0	234	2	0	200	0	-200	0.00	0.00	0	0	0
0010	3T	3_0	235	1	0	100	0	-100	0.00	0.00	0	0	0
0010	3T	3_0	236	1	0	100	0	-100	0.00	0.00	0	0	0
0010	3T	3_0	243	1	0	100	0	-100	0.00	0.00	0	0	0
0010	3T	3_1	123	241	29	24100	19260	-4840	0.12	0.80	42	34	-8
0010	3T	3_1	124	133	14	13300	10900	-2400	0.11	0.82	23	19	-4
0010	3T	3_1	125	106	11	10600	10610	10	0.10	1.00	18	18	0
0010	3T	3_1	126	169	13	16900	16510	-390	0.08	0.98	29	29	0
0010	3T	3_1	132	16	1	1600	790	-810	0.06	0.49	2	1	-1
0010	3T	3_1	134	51	7	5100	6610	1510	0.14	1.30	9	11	2
0010	3T	3_1	135	35	3	3500	1680	-1820	0.09	0.48	6	2	-4
0010	3T	3_1	136	65	6	6500	8020	1520	0.09	1.23	11	14	3
0010	3T	3_1	142	2	0	200	0	-200	0.00	0.00	0	0	0
0010	3T	3_1	143	8	0	800	0	-800	0.00	0.00	1	0	-1
0010	3T	3_1	145	23	1	2300	700	-1600	0.04	0.30	4	1	-3
0010	3T	3_1	146	35	1	3500	830	-2670	0.03	0.24	6	1	-5
0010	3T	3_1	152	1	0	100	0	-100	0.00	0.00	0	0	0
0010	3T	3_1	153	7	1	700	4880	4180	0.14	6.97	1	8	7
0010	3T	3_1	154	3	1	300	940	640	0.33	3.13	0	1	1
0010	3T	3_1	156	26	2	2600	2040	-560	0.08	0.78	4	3	-1
0010	3T	3_1	162	1	0	100	0	-100	0.00	0.00	0	0	0
0010	3T	3_1	213	1	0	100	0	-100	0.00	0.00	0	0	0
0010	3T	3_1	215	1	0	100	0	-100	0.00	0.00	0	0	0
0010	3T	3_1	216	3	0	300	0	-300	0.00	0.00	0	0	0
0010	3T	3_1	236	2	0	200	0	-200	0.00	0.00	0	0	0
0010	3T	3_2	123	107	19	10700	12080	1380	0.18	1.13	18	21	3
0010	3T	3_2	124	197	22	19700	19610	-90	0.11	1.00	34	34	0
0010	3T	3_2	125	143	16	14300	19290	4990	0.11	1.35	25	34	9
0010	3T	3_2	126	201	16	20100	17410	-2690	0.08	0.87	35	30	-5
0010	3T	3_2	132	4	1	400	810	410	0.25	2.03	0	1	1
0010	3T	3_2	134	106	18	10600	16480	5880	0.17	1.55	18	29	11
0010	3T	3_2	135	73	3	7300	1740	-5560	0.04	0.24	12	3	-9
0010	3T	3_2	136	107	3	10700	3150	-7550	0.03	0.29	18	5	-13
0010	3T	3_2	143	2	1	200	1650	1450	0.50	8.25	0	2	2
0010	3T	3_2	145	47	1	4700	870	-3830	0.02	0.19	8	1	-7
0010	3T	3_2	146	62	1	6200	1520	-4680	0.02	0.25	10	2	-8
0010	3T	3_2	153	1	0	100	0	-100	0.00	0.00	0	0	0
0010	3T	3_2	154	1	0	100	0	-100	0.00	0.00	0	0	0
0010	3T	3_2	156	19	0	1900	0	-1900	0.00	0.00	3	0	-3
0010	3T	3_2	164	3	0	300	0	-300	0.00	0.00	0	0	0
0010	3T	3_2	165	5	0	500	0	-500	0.00	0.00	0	0	0
0010	3T	3_2	214	4	1	400	800	400	0.25	2.00	0	1	1
0010	3T	3_2	215	10	0	1000	0	-1000	0.00	0.00	1	0	-1
0010	3T	3_2	216	10	0	1000	0	-1000	0.00	0.00	1	0	-1
0010	3T	3_2	234	10	2	1000	2570	1570	0.20	2.57	1	4	3
0010	3T	3_2	235	13	1	1300	680	-620	0.08	0.52	2	1	-1
0010	3T	3_2	236	13	0	1300	0	-1300	0.00	0.00	2	0	-2
0010	3T	3_2	245	4	0	400	0	-400	0.00	0.00	0	0	0
0010	3T	3_2	246	11	0	1100	0	-1100	0.00	0.00	1	0	-1
0010	3T	3_2	256	2	0	200	0	-200	0.00	0.00	0	0	0
0010	3T	3_2	265	2	0	200	0	-200	0.00	0.00	0	0	0
0010	3T	3_3	123	113	26	11300	16580	5280	0.23	1.47	20	29	9
0010	3T	3_3	124	346	47	34600	35290	690	0.14	1.02	61	62	1
0010	3T	3_3	125	303	26	30300	20920	-9380	0.09	0.69	53	37	-16
0010	3T	3_3	126	315	22	31500	26960	-4540	0.07	0.86	55	47	-8
0010	3T	3_3	132	3	0	300	0	-300	0.00	0.00	0	0	0
0010	3T	3_3	134	225	31	22500	25540	3040	0.14	1.14	39	45	6
0010	3T	3_3	135	254	18	25400	16460	-8940	0.07	0.65	44	29	-15
0010	3T	3_3	136	223	13	22300	16130	-6170	0.06	0.72	39	28	-11
0010	3T	3_3	145	142	13	14200	11760	-2440	0.09	0.83	25	20	-5
0010	3T	3_3	146	99	4	9900	3440	-6460	0.04	0.35	17	6	-11
0010	3T	3_3	152	1	0	100	0	-100	0.00	0.00	0	0	0
0010	3T	3_3	154	1	0	100	0	-100	0.00	0.00	0	0	0
0010	3T	3_3	156	36	2	3600	2860	-740	0.06	0.79	6	5	-1
0010	3T	3_3	164	3	0	300	0	-300	0.00	0.00	0	0	0
0010	3T	3_3	165	4	0	400	0	-400	0.00	0.00	0	0	0
0010	3T	3_3	214	21	0	2100	0	-2100	0.00	0.00	3	0	-3
0010	3T	3_3	215	48	2	4800	4910	110	0.04	1.02	8	8	0
0010	3T	3_3	216	60	0	6000	0	-6000	0.00	0.00	10	0	-10
0010	3T	3_3	234	42	4	4200	3790	-410	0.10	0.90	7	6	-1
0010	3T	3_3	235	27	1	2700	2360	-340	0.04	0.87	4	4	0
0010	3T	3_3	236	51	0	5100	0	-5100	0.00	0.00	9	0	-9
0010	3T	3_3	245	19	2	1900	2920	1020	0.11	1.54	3	5	2
0010	3T	3_3	246	16	0	1600	0	-1600	0.00	0.00	2	0	-2
0010	3T	3_3	256	13	0	1300	0	-1300	0.00	0.00	2	0	-2
0010	3T	3_3	265	1	0	100	0	-100	0.00	0.00	0	0	0
0010	3T	3_4	123	71	8	7100	4490	-2610	0.11	0.63	12	7	-5
0010	3T	3_4	124	380	32	38000	29070	-8930	0.08	0.77	67	51	-16
0010	3T	3_4	125	414	29	41400	26230	-15170	0.07	0.63	73	46	-27
0010	3T	3_4	126	563	38	56300	65480	9180	0.07	1.16	99	115	16
0010	3T	3_4	134	193	21	19300	18050	-1250	0.11	0.94	34	31	-3
0010	3T	3_4	135	248	22	24800	29060	4260	0.09	1.17	43	51	8
0010	3T	3_4	136	339	17	33900	19550	-14350	0.05	0.58	60	34	-26
0010	3T	3_4	145	91	3	9100	2250	-6850	0.03	0.25	16	3	-13
0010	3T	3_4	146	100	2	10000	2910	-7090	0.02	0.29	17	5	-12
0010	3T	3_4	156	23	2	2300	2930	630	0.09	1.27	4	5	1
0010	3T	3_4	163	1	0	100	0	-100	0.00	0.00	0	0	0
0010	3T	3_4	165	3	0	300	0	-300	0.00	0.00	0	0	0
0010	3T	3_4	214	4	0	400	0	-400	0.00	0.00	0	0	0
0010	3T	3_4	215	20	0	2000	0	-2000	0.00	0.00	3	0	-3
0010	3T	3_4	216	31	1	3100	3010	-90	0.03	0.97	5	5	0
0010	3T	3_4	234	3	0	300	0	-300	0.00	0.00	0	0	0
0010	3T	3_4	235	13	0	1300	0	-1300	0.00	0.00	2	0	-2
0010	3T	3_4	236	17	1	1700	4650	2950	0.06	2.74	3	8	5
0010	3T	3_4	245	12	0	1200	0	-1200	0.00	0.00	2	0	-2
0010	3T	3_4	246	6	1	600	1350	750	0.17	2.25	1	2	1
0010	3T	3_4	256	1	0	100	0	-100	0.00	0.00	0	0	0
0010	3T	3_5	123	7	0	700	0	-700	0.00	0.00	1	0	-1
0010	3T	3_5	124	179	20	17900	14670	-3230	0.11	0.82	31	25	-6
0010	3T	3_5	125	147	8	14700	7870	-6830	0.05	0.54	26	13	-13
0010	3T	3_5	126	171	9	17100	20150	3050	0.05	1.18	30	35	5
0010	3T	3_5	134	51	1	5100	910	-4190	0.02	0.18	9	1	-8
0010	3T	3_5	135	61	7	6100	10670	4570	0.11	1.75	10	18	8
0010	3T	3_5	136	82	5	8200	4920	-3280	0.06	0.60	14	8	-6
0010	3T	3_5	145	25	3	2500	4750	2250	0.12	1.90	4	8	4
0010	3T	3_5	146	14	0	1400	0	-1400	0.00	0.00	2	0	-2
0010	3T	3_5	156	1	0	100	0	-100	0.00	0.00	0	0	0
0010	3T	3_5	214	1	0	100	0	-100	0.00	0.00	0	0	0
0010	3T	3_5	215	1	0	100	0	-100	0.00	0.00	0	0	0
0010	3T	3_5	216	4	0	400	0	-400	0.00	0.00	0	0	0
0010	3T	3_5	245	1	0	100	0	-100	0.00	0.00	0	0	0
0010	3T	3_6	123	2	0	200	0	-200	0.00	0.00	0	0	0
0010	3T	3_6	124	51	3	5100	2180	-2920	0.06	0.43	9	3	-6
0010	3T	3_6	125	41	4	4100	5010	910	0.10	1.22	7	8	1
0010	3T	3_6	126	105	7	10500	17200	6700	0.07	1.64	18	30	12
0010	3T	3_6	134	8	2	800	2170	1370	0.25	2.71	1	3	2
0010	3T	3_6	135	25	0	2500	0	-2500	0.00	0.00	4	0	-4
0010	3T	3_6	136	35	5	3500	11280	7780	0.14	3.22	6	19	13
0010	3T	3_6	145	1	0	100	0	-100	0.00	0.00	0	0	0
0010	3T	3_6	146	2	0	200	0	-200	0.00	0.00	0	0	0
0010	3T	3_6	216	1	0	100	0	-100	0.00	0.00	0	0	0
0010	3T	4_0	123	70	6	7000	5830	-1170	0.09	0.83	12	10	-2
0010	3T	4_0	124	33	2	3300	2550	-750	0.06	0.77	5	4	-1
0010	3T	4_0	125	35	1	3500	2140	-1360	0.03	0.61	6	3	-3
0010	3T	4_0	126	17	1	1700	4370	2670	0.06	2.57	3	7	4
0010	3T	4_0	134	13	3	1300	3570	2270	0.23	2.75	2	6	4
0010	3T	4_0	135	14	0	1400	0	-1400	0.00	0.00	2	0	-2
0010	3T	4_0	136	7	2	700	3140	2440	0.29	4.49	1	5	4
0010	3T	4_0	142	1	0	100	0	-100	0.00	0.00	0	0	0
0010	3T	4_0	143	4	0	400	0	-400	0.00	0.00	0	0	0
0010	3T	4_0	145	5	0	500	0	-500	0.00	0.00	0	0	0
0010	3T	4_0	146	3	0	300	0	-300	0.00	0.00	0	0	0
0010	3T	4_0	153	1	0	100	0	-100	0.00	0.00	0	0	0
0010	3T	4_0	163	1	0	100	0	-100	0.00	0.00	0	0	0
0010	3T	4_0	234	2	1	200	2110	1910	0.50	10.55	0	3	3
0010	3T	4_0	235	1	0	100	0	-100	0.00	0.00	0	0	0
0010	3T	4_0	236	1	0	100	0	-100	0.00	0.00	0	0	0
0010	3T	4_0	243	1	0	100	0	-100	0.00	0.00	0	0	0
0010	3T	4_0	253	1	0	100	0	-100	0.00	0.00	0	0	0
0010	3T	4_1	123	238	35	23800	25130	1330	0.15	1.06	42	44	2
0010	3T	4_1	124	148	18	14800	14740	-60	0.12	1.00	26	26	0
0010	3T	4_1	125	103	9	10300	7130	-3170	0.09	0.69	18	12	-6
0010	3T	4_1	126	53	5	5300	7580	2280	0.09	1.43	9	13	4
0010	3T	4_1	132	6	1	600	860	260	0.17	1.43	1	1	0
0010	3T	4_1	134	55	3	5500	1270	-4230	0.05	0.23	9	2	-7
0010	3T	4_1	135	36	1	3600	680	-2920	0.03	0.19	6	1	-5
0010	3T	4_1	136	19	1	1900	650	-1250	0.05	0.34	3	1	-2
0010	3T	4_1	143	6	0	600	0	-600	0.00	0.00	1	0	-1
0010	3T	4_1	145	12	0	1200	0	-1200	0.00	0.00	2	0	-2
0010	3T	4_1	146	3	0	300	0	-300	0.00	0.00	0	0	0
0010	3T	4_1	156	2	0	200	0	-200	0.00	0.00	0	0	0
0010	3T	4_1	234	1	0	100	0	-100	0.00	0.00	0	0	0
0010	3T	4_1	235	1	0	100	0	-100	0.00	0.00	0	0	0
0010	3T	4_1	245	1	0	100	0	-100	0.00	0.00	0	0	0
0010	3T	4_2	123	196	25	19600	11030	-8570	0.13	0.56	34	19	-15
0010	3T	4_2	124	223	26	22300	24610	2310	0.12	1.10	39	43	4
0010	3T	4_2	125	189	16	18900	16950	-1950	0.08	0.90	33	30	-3
0010	3T	4_2	126	104	8	10400	10400	0	0.08	1.00	18	18	0
0010	3T	4_2	132	3	0	300	0	-300	0.00	0.00	0	0	0
0010	3T	4_2	134	107	5	10700	3300	-7400	0.05	0.31	18	5	-13
0010	3T	4_2	135	85	4	8500	4030	-4470	0.05	0.47	15	7	-8
0010	3T	4_2	136	64	7	6400	7530	1130	0.11	1.18	11	13	2
0010	3T	4_2	142	2	0	200	0	-200	0.00	0.00	0	0	0
0010	3T	4_2	143	1	1	100	860	760	1.00	8.60	0	1	1
0010	3T	4_2	145	44	5	4400	6740	2340	0.11	1.53	7	11	4
0010	3T	4_2	146	19	2	1900	1950	50	0.11	1.03	3	3	0
0010	3T	4_2	156	15	1	1500	740	-760	0.07	0.49	2	1	-1
0010	3T	4_2	213	1	0	100	0	-100	0.00	0.00	0	0	0
0010	3T	4_2	234	7	0	700	0	-700	0.00	0.00	1	0	-1
0010	3T	4_2	235	3	0	300	0	-300	0.00	0.00	0	0	0
0010	3T	4_2	236	3	0	300	0	-300	0.00	0.00	0	0	0
0010	3T	4_2	245	5	0	500	0	-500	0.00	0.00	0	0	0
0010	3T	4_2	246	5	0	500	0	-500	0.00	0.00	0	0	0
0010	3T	4_2	256	2	0	200	0	-200	0.00	0.00	0	0	0
0010	3T	4_3	123	227	34	22700	18330	-4370	0.15	0.81	40	32	-8
0010	3T	4_3	124	501	45	50100	42840	-7260	0.09	0.86	88	75	-13
0010	3T	4_3	125	361	21	36100	17200	-18900	0.06	0.48	63	30	-33
0010	3T	4_3	126	240	10	24000	10430	-13570	0.04	0.43	42	18	-24
0010	3T	4_3	134	262	43	26200	27830	1630	0.16	1.06	46	49	3
0010	3T	4_3	135	285	31	28500	23390	-5110	0.11	0.82	50	41	-9
0010	3T	4_3	136	165	15	16500	12910	-3590	0.09	0.78	29	22	-7
0010	3T	4_3	145	118	10	11800	19710	7910	0.08	1.67	20	34	14
0010	3T	4_3	146	77	4	7700	6990	-710	0.05	0.91	13	12	-1
0010	3T	4_3	154	1	0	100	0	-100	0.00	0.00	0	0	0
0010	3T	4_3	156	25	3	2500	5110	2610	0.12	2.04	4	9	5
0010	3T	4_3	214	5	0	500	0	-500	0.00	0.00	0	0	0
0010	3T	4_3	215	5	0	500	0	-500	0.00	0.00	0	0	0
0010	3T	4_3	216	7	0	700	0	-700	0.00	0.00	1	0	-1
0010	3T	4_3	234	14	1	1400	740	-660	0.07	0.53	2	1	-1
0010	3T	4_3	235	29	3	2900	3190	290	0.10	1.10	5	5	0
0010	3T	4_3	236	17	2	1700	2250	550	0.12	1.32	3	3	0
0010	3T	4_3	245	20	0	2000	0	-2000	0.00	0.00	3	0	-3
0010	3T	4_3	246	6	1	600	390	-210	0.17	0.65	1	0	-1
0010	3T	4_3	256	3	0	300	0	-300	0.00	0.00	0	0	0
0010	3T	4_4	123	199	30	19900	17920	-1980	0.15	0.90	35	31	-4
0010	3T	4_4	124	618	59	61800	52590	-9210	0.10	0.85	109	93	-16
0010	3T	4_4	125	329	20	32900	25830	-7070	0.06	0.79	58	45	-13
0010	3T	4_4	126	195	9	19500	14170	-5330	0.05	0.73	34	25	-9
0010	3T	4_4	134	188	24	18800	18460	-340	0.13	0.98	33	32	-1
0010	3T	4_4	135	143	17	14300	16530	2230	0.12	1.16	25	29	4
0010	3T	4_4	136	102	8	10200	9030	-1170	0.08	0.89	18	15	-3
0010	3T	4_4	145	52	2	5200	1320	-3880	0.04	0.25	9	2	-7
0010	3T	4_4	146	43	2	4300	1820	-2480	0.05	0.42	7	3	-4
0010	3T	4_4	156	6	0	600	0	-600	0.00	0.00	1	0	-1
0010	3T	4_4	214	2	0	200	0	-200	0.00	0.00	0	0	0
0010	3T	4_4	215	2	0	200	0	-200	0.00	0.00	0	0	0
0010	3T	4_4	216	4	0	400	0	-400	0.00	0.00	0	0	0
0010	3T	4_4	234	7	0	700	0	-700	0.00	0.00	1	0	-1
0010	3T	4_4	235	7	0	700	0	-700	0.00	0.00	1	0	-1
0010	3T	4_4	236	1	0	100	0	-100	0.00	0.00	0	0	0
0010	3T	4_4	245	5	0	500	0	-500	0.00	0.00	0	0	0
0010	3T	4_4	246	5	1	500	2890	2390	0.20	5.78	0	5	5
0010	3T	4_4	256	1	0	100	0	-100	0.00	0.00	0	0	0
0010	3T	4_5	123	89	11	8900	7250	-1650	0.12	0.81	15	12	-3
0010	3T	4_5	124	383	29	38300	21740	-16560	0.08	0.57	67	38	-29
0010	3T	4_5	125	91	6	9100	6410	-2690	0.07	0.70	16	11	-5
0010	3T	4_5	126	62	2	6200	2820	-3380	0.03	0.45	10	4	-6
0010	3T	4_5	134	79	8	7900	6980	-920	0.10	0.88	13	12	-1
0010	3T	4_5	135	30	2	3000	1980	-1020	0.07	0.66	5	3	-2
0010	3T	4_5	136	27	1	2700	470	-2230	0.04	0.17	4	0	-4
0010	3T	4_5	145	7	1	700	1020	320	0.14	1.46	1	1	0
0010	3T	4_5	146	7	0	700	0	-700	0.00	0.00	1	0	-1
0010	3T	4_5	154	1	0	100	0	-100	0.00	0.00	0	0	0
0010	3T	4_5	236	1	0	100	0	-100	0.00	0.00	0	0	0
0010	3T	4_6	123	34	2	3400	1060	-2340	0.06	0.31	6	1	-5
0010	3T	4_6	124	160	15	16000	12960	-3040	0.09	0.81	28	22	-6
0010	3T	4_6	125	15	1	1500	1050	-450	0.07	0.70	2	1	-1
0010	3T	4_6	126	57	3	5700	5570	-130	0.05	0.98	10	9	-1
0010	3T	4_6	134	17	1	1700	1140	-560	0.06	0.67	3	2	-1
0010	3T	4_6	135	3	0	300	0	-300	0.00	0.00	0	0	0
0010	3T	4_6	136	12	1	1200	2100	900	0.08	1.75	2	3	1
0010	3T	4_6	145	1	0	100	0	-100	0.00	0.00	0	0	0
0010	3T	5_-1	123	1	0	100	0	-100	0.00	0.00	0	0	0
0010	3T	5_-1	124	6	0	600	0	-600	0.00	0.00	1	0	-1
0010	3T	5_-1	125	3	0	300	0	-300	0.00	0.00	0	0	0
0010	3T	5_-1	126	1	0	100	0	-100	0.00	0.00	0	0	0
0010	3T	5_-1	134	1	0	100	0	-100	0.00	0.00	0	0	0
0010	3T	5_-1	135	1	0	100	0	-100	0.00	0.00	0	0	0
0010	3T	5_-1	145	1	0	100	0	-100	0.00	0.00	0	0	0
0010	3T	5_-1	146	1	0	100	0	-100	0.00	0.00	0	0	0
0010	3T	5_0	123	105	15	10500	13630	3130	0.14	1.30	18	24	6
0010	3T	5_0	124	45	2	4500	2150	-2350	0.04	0.48	7	3	-4
0010	3T	5_0	125	49	3	4900	3190	-1710	0.06	0.65	8	5	-3
0010	3T	5_0	126	34	2	3400	2230	-1170	0.06	0.66	6	3	-3
0010	3T	5_0	132	3	0	300	0	-300	0.00	0.00	0	0	0
0010	3T	5_0	134	28	3	2800	2500	-300	0.11	0.89	4	4	0
0010	3T	5_0	135	20	3	2000	2870	870	0.15	1.44	3	5	2
0010	3T	5_0	136	9	0	900	0	-900	0.00	0.00	1	0	-1
0010	3T	5_0	142	1	0	100	0	-100	0.00	0.00	0	0	0
0010	3T	5_0	143	1	0	100	0	-100	0.00	0.00	0	0	0
0010	3T	5_0	145	6	0	600	0	-600	0.00	0.00	1	0	-1
0010	3T	5_0	146	1	0	100	0	-100	0.00	0.00	0	0	0
0010	3T	5_0	152	2	0	200	0	-200	0.00	0.00	0	0	0
0010	3T	5_0	153	5	0	500	0	-500	0.00	0.00	0	0	0
0010	3T	5_0	154	2	0	200	0	-200	0.00	0.00	0	0	0
0010	3T	5_0	165	1	0	100	0	-100	0.00	0.00	0	0	0
0010	3T	5_0	235	1	0	100	0	-100	0.00	0.00	0	0	0
0010	3T	5_1	123	189	22	18900	13180	-5720	0.12	0.70	33	23	-10
0010	3T	5_1	124	183	17	18300	12180	-6120	0.09	0.67	32	21	-11
0010	3T	5_1	125	71	6	7100	4660	-2440	0.08	0.66	12	8	-4
0010	3T	5_1	126	62	4	6200	3600	-2600	0.06	0.58	10	6	-4
0010	3T	5_1	132	8	1	800	670	-130	0.13	0.84	1	1	0
0010	3T	5_1	134	54	6	5400	5420	20	0.11	1.00	9	9	0
0010	3T	5_1	135	16	0	1600	0	-1600	0.00	0.00	2	0	-2
0010	3T	5_1	136	27	1	2700	1720	-980	0.04	0.64	4	3	-1
0010	3T	5_1	142	2	0	200	0	-200	0.00	0.00	0	0	0
0010	3T	5_1	143	6	1	600	650	50	0.17	1.08	1	1	0
0010	3T	5_1	145	16	0	1600	0	-1600	0.00	0.00	2	0	-2
0010	3T	5_1	146	7	1	700	2420	1720	0.14	3.46	1	4	3
0010	3T	5_1	152	1	0	100	0	-100	0.00	0.00	0	0	0
0010	3T	5_1	153	2	0	200	0	-200	0.00	0.00	0	0	0
0010	3T	5_1	154	1	0	100	0	-100	0.00	0.00	0	0	0
0010	3T	5_1	156	3	1	300	1120	820	0.33	3.73	0	1	1
0010	3T	5_1	163	1	0	100	0	-100	0.00	0.00	0	0	0
0010	3T	5_1	215	1	0	100	0	-100	0.00	0.00	0	0	0
0010	3T	5_1	234	1	0	100	0	-100	0.00	0.00	0	0	0
0010	3T	5_1	236	1	0	100	0	-100	0.00	0.00	0	0	0
0010	3T	5_2	123	146	13	14600	6200	-8400	0.09	0.42	25	10	-15
0010	3T	5_2	124	194	24	19400	13390	-6010	0.12	0.69	34	23	-11
0010	3T	5_2	125	123	11	12300	9650	-2650	0.09	0.78	21	17	-4
0010	3T	5_2	126	113	14	11300	19570	8270	0.12	1.73	20	34	14
0010	3T	5_2	132	9	2	900	1130	230	0.22	1.26	1	2	1
0010	3T	5_2	134	108	13	10800	9150	-1650	0.12	0.85	19	16	-3
0010	3T	5_2	135	77	4	7700	4010	-3690	0.05	0.52	13	7	-6
0010	3T	5_2	136	67	7	6700	8010	1310	0.10	1.20	11	14	3
0010	3T	5_2	142	2	0	200	0	-200	0.00	0.00	0	0	0
0010	3T	5_2	143	1	0	100	0	-100	0.00	0.00	0	0	0
0010	3T	5_2	145	46	5	4600	6090	1490	0.11	1.32	8	10	2
0010	3T	5_2	146	42	6	4200	7170	2970	0.14	1.71	7	12	5
0010	3T	5_2	156	12	0	1200	0	-1200	0.00	0.00	2	0	-2
0010	3T	5_2	164	1	0	100	0	-100	0.00	0.00	0	0	0
0010	3T	5_2	165	3	0	300	0	-300	0.00	0.00	0	0	0
0010	3T	5_2	214	1	0	100	0	-100	0.00	0.00	0	0	0
0010	3T	5_2	215	1	0	100	0	-100	0.00	0.00	0	0	0
0010	3T	5_2	216	2	0	200	0	-200	0.00	0.00	0	0	0
0010	3T	5_2	234	4	0	400	0	-400	0.00	0.00	0	0	0
0010	3T	5_2	235	2	1	200	1180	980	0.50	5.90	0	2	2
0010	3T	5_2	236	3	0	300	0	-300	0.00	0.00	0	0	0
0010	3T	5_2	245	2	0	200	0	-200	0.00	0.00	0	0	0
0010	3T	5_2	256	3	0	300	0	-300	0.00	0.00	0	0	0
0010	3T	5_3	123	176	28	17600	13040	-4560	0.16	0.74	31	23	-8
0010	3T	5_3	124	349	31	34900	22380	-12520	0.09	0.64	61	39	-22
0010	3T	5_3	125	289	34	28900	37580	8680	0.12	1.30	51	66	15
0010	3T	5_3	126	223	15	22300	33760	11460	0.07	1.51	39	59	20
0010	3T	5_3	132	4	1	400	650	250	0.25	1.63	0	1	1
0010	3T	5_3	134	208	18	20800	16490	-4310	0.09	0.79	36	29	-7
0010	3T	5_3	135	179	18	17900	18930	1030	0.10	1.06	31	33	2
0010	3T	5_3	136	182	16	18200	17590	-610	0.09	0.97	32	31	-1
0010	3T	5_3	142	2	0	200	0	-200	0.00	0.00	0	0	0
0010	3T	5_3	143	1	0	100	0	-100	0.00	0.00	0	0	0
0010	3T	5_3	145	146	7	14600	7150	-7450	0.05	0.49	25	12	-13
0010	3T	5_3	146	56	6	5600	12380	6780	0.11	2.21	9	21	12
0010	3T	5_3	156	31	3	3100	4400	1300	0.10	1.42	5	7	2
0010	3T	5_3	164	2	0	200	0	-200	0.00	0.00	0	0	0
0010	3T	5_3	165	1	0	100	0	-100	0.00	0.00	0	0	0
0010	3T	5_3	214	5	0	500	0	-500	0.00	0.00	0	0	0
0010	3T	5_3	215	4	0	400	0	-400	0.00	0.00	0	0	0
0010	3T	5_3	216	7	0	700	0	-700	0.00	0.00	1	0	-1
0010	3T	5_3	234	4	0	400	0	-400	0.00	0.00	0	0	0
0010	3T	5_3	235	6	1	600	860	260	0.17	1.43	1	1	0
0010	3T	5_3	236	11	0	1100	0	-1100	0.00	0.00	1	0	-1
0010	3T	5_3	245	2	0	200	0	-200	0.00	0.00	0	0	0
0010	3T	5_3	246	5	0	500	0	-500	0.00	0.00	0	0	0
0010	3T	5_3	256	1	0	100	0	-100	0.00	0.00	0	0	0
0010	3T	5_4	123	92	17	9200	9460	260	0.18	1.03	16	16	0
0010	3T	5_4	124	385	43	38500	33630	-4870	0.11	0.87	68	59	-9
0010	3T	5_4	125	250	18	25000	20390	-4610	0.07	0.82	44	36	-8
0010	3T	5_4	126	206	12	20600	16560	-4040	0.06	0.80	36	29	-7
0010	3T	5_4	134	124	10	12400	7110	-5290	0.08	0.57	21	12	-9
0010	3T	5_4	135	111	7	11100	8280	-2820	0.06	0.75	19	14	-5
0010	3T	5_4	136	102	3	10200	3040	-7160	0.03	0.30	18	5	-13
0010	3T	5_4	145	48	4	4800	4070	-730	0.08	0.85	8	7	-1
0010	3T	5_4	146	29	1	2900	930	-1970	0.03	0.32	5	1	-4
0010	3T	5_4	154	1	0	100	0	-100	0.00	0.00	0	0	0
0010	3T	5_4	156	6	1	600	990	390	0.17	1.65	1	1	0
0010	3T	5_4	214	4	0	400	0	-400	0.00	0.00	0	0	0
0010	3T	5_4	215	6	0	600	0	-600	0.00	0.00	1	0	-1
0010	3T	5_4	216	10	0	1000	0	-1000	0.00	0.00	1	0	-1
0010	3T	5_4	234	2	0	200	0	-200	0.00	0.00	0	0	0
0010	3T	5_4	235	4	0	400	0	-400	0.00	0.00	0	0	0
0010	3T	5_4	236	2	0	200	0	-200	0.00	0.00	0	0	0
0010	3T	5_4	246	3	0	300	0	-300	0.00	0.00	0	0	0
0010	3T	5_5	123	66	10	6600	5100	-1500	0.15	0.77	11	9	-2
0010	3T	5_5	124	359	31	35900	24190	-11710	0.09	0.67	63	42	-21
0010	3T	5_5	125	184	16	18400	18360	-40	0.09	1.00	32	32	0
0010	3T	5_5	126	140	10	14000	17220	3220	0.07	1.23	24	30	6
0010	3T	5_5	134	28	2	2800	2010	-790	0.07	0.72	4	3	-1
0010	3T	5_5	135	35	1	3500	810	-2690	0.03	0.23	6	1	-5
0010	3T	5_5	136	30	3	3000	7520	4520	0.10	2.51	5	13	8
0010	3T	5_5	145	7	0	700	0	-700	0.00	0.00	1	0	-1
0010	3T	5_5	216	2	0	200	0	-200	0.00	0.00	0	0	0
0010	3T	5_5	235	1	0	100	0	-100	0.00	0.00	0	0	0
0010	3T	5_6	123	32	5	3200	2870	-330	0.16	0.90	5	5	0
0010	3T	5_6	124	139	8	13900	7080	-6820	0.06	0.51	24	12	-12
0010	3T	5_6	125	29	2	2900	2060	-840	0.07	0.71	5	3	-2
0010	3T	5_6	126	58	2	5800	4190	-1610	0.03	0.72	10	7	-3
0010	3T	5_6	134	10	1	1000	1110	110	0.10	1.11	1	1	0
0010	3T	5_6	135	4	1	400	1690	1290	0.25	4.23	0	2	2
0010	3T	5_6	136	9	0	900	0	-900	0.00	0.00	1	0	-1
0010	3T	5_6	215	2	0	200	0	-200	0.00	0.00	0	0	0
0010	3T	6_0	123	5	0	500	0	-500	0.00	0.00	0	0	0
0010	3T	6_0	124	5	0	500	0	-500	0.00	0.00	0	0	0
0010	3T	6_0	125	7	0	700	0	-700	0.00	0.00	1	0	-1
0010	3T	6_0	135	2	0	200	0	-200	0.00	0.00	0	0	0
0010	3T	6_0	136	1	0	100	0	-100	0.00	0.00	0	0	0
0010	3T	6_1	123	5	0	500	0	-500	0.00	0.00	0	0	0
0010	3T	6_1	124	9	0	900	0	-900	0.00	0.00	1	0	-1
0010	3T	6_1	125	8	1	800	710	-90	0.13	0.89	1	1	0
0010	3T	6_1	126	4	1	400	980	580	0.25	2.45	0	1	1
0010	3T	6_1	134	1	0	100	0	-100	0.00	0.00	0	0	0
0010	3T	6_1	135	3	0	300	0	-300	0.00	0.00	0	0	0
0010	3T	6_1	136	3	1	300	870	570	0.33	2.90	0	1	1
0010	3T	6_1	145	2	0	200	0	-200	0.00	0.00	0	0	0
0010	3T	6_2	123	5	0	500	0	-500	0.00	0.00	0	0	0
0010	3T	6_2	124	14	0	1400	0	-1400	0.00	0.00	2	0	-2
0010	3T	6_2	125	3	0	300	0	-300	0.00	0.00	0	0	0
0010	3T	6_2	126	4	0	400	0	-400	0.00	0.00	0	0	0
0010	3T	6_2	134	4	0	400	0	-400	0.00	0.00	0	0	0
0010	3T	6_2	135	4	0	400	0	-400	0.00	0.00	0	0	0
0010	3T	6_2	136	3	1	300	690	390	0.33	2.30	0	1	1
0010	3T	6_2	145	1	0	100	0	-100	0.00	0.00	0	0	0
0010	3T	6_2	146	2	0	200	0	-200	0.00	0.00	0	0	0
0010	3T	6_2	156	2	0	200	0	-200	0.00	0.00	0	0	0
0010	3T	6_2	235	1	1	100	4620	4520	1.00	46.20	0	8	8
0010	3T	6_2	246	1	0	100	0	-100	0.00	0.00	0	0	0
0010	3T	6_3	123	24	1	2400	610	-1790	0.04	0.25	4	1	-3
0010	3T	6_3	124	33	1	3300	440	-2860	0.03	0.13	5	0	-5
0010	3T	6_3	125	15	2	1500	4970	3470	0.13	3.31	2	8	6
0010	3T	6_3	126	21	2	2100	10250	8150	0.10	4.88	3	18	15
0010	3T	6_3	134	12	2	1200	1300	100	0.17	1.08	2	2	0
0010	3T	6_3	135	12	1	1200	320	-880	0.08	0.27	2	0	-2
0010	3T	6_3	136	13	1	1300	730	-570	0.08	0.56	2	1	-1
0010	3T	6_3	145	9	0	900	0	-900	0.00	0.00	1	0	-1
0010	3T	6_3	146	5	0	500	0	-500	0.00	0.00	0	0	0
0010	3T	6_3	156	1	0	100	0	-100	0.00	0.00	0	0	0
0010	3T	6_3	235	1	0	100	0	-100	0.00	0.00	0	0	0
0010	3T	6_4	123	10	3	1000	1440	440	0.30	1.44	1	2	1
0010	3T	6_4	124	44	2	4400	850	-3550	0.05	0.19	7	1	-6
0010	3T	6_4	125	20	2	2000	2630	630	0.10	1.32	3	4	1
0010	3T	6_4	126	9	1	900	1560	660	0.11	1.73	1	2	1
0010	3T	6_4	134	12	1	1200	430	-770	0.08	0.36	2	0	-2
0010	3T	6_4	135	12	1	1200	660	-540	0.08	0.55	2	1	-1
0010	3T	6_4	136	8	0	800	0	-800	0.00	0.00	1	0	-1
0010	3T	6_4	145	5	1	500	820	320	0.20	1.64	0	1	1
0010	3T	6_4	146	2	0	200	0	-200	0.00	0.00	0	0	0
0010	3T	6_4	156	3	0	300	0	-300	0.00	0.00	0	0	0
0010	3T	6_4	216	1	1	100	8510	8410	1.00	85.10	0	15	15
0010	3T	6_5	123	9	3	900	2090	1190	0.33	2.32	1	3	2
0010	3T	6_5	124	44	6	4400	4150	-250	0.14	0.94	7	7	0
0010	3T	6_5	125	2	1	200	1530	1330	0.50	7.65	0	2	2
0010	3T	6_5	126	8	0	800	0	-800	0.00	0.00	1	0	-1
0010	3T	6_5	134	5	0	500	0	-500	0.00	0.00	0	0	0
0010	3T	6_5	135	1	0	100	0	-100	0.00	0.00	0	0	0
0010	3T	6_5	136	1	0	100	0	-100	0.00	0.00	0	0	0
0010	3T	6_6	123	7	2	700	950	250	0.29	1.36	1	1	0
0010	3T	6_6	124	12	1	1200	1510	310	0.08	1.26	2	2	0
0010	3T	6_6	125	3	0	300	0	-300	0.00	0.00	0	0	0
0010	3T	6_6	126	6	0	600	0	-600	0.00	0.00	1	0	-1
0010	3T	6_6	134	1	0	100	0	-100	0.00	0.00	0	0	0
0010	3T	7_-1	123	7	1	700	590	-110	0.14	0.84	1	1	0
0010	3T	7_-1	124	4	0	400	0	-400	0.00	0.00	0	0	0
0010	3T	7_-1	126	2	0	200	0	-200	0.00	0.00	0	0	0
0010	3T	7_-1	134	1	0	100	0	-100	0.00	0.00	0	0	0
0010	3T	7_-1	136	2	0	200	0	-200	0.00	0.00	0	0	0
0010	3T	7_-1	145	1	1	100	740	640	1.00	7.40	0	1	1
0010	3T	7_-1	146	2	0	200	0	-200	0.00	0.00	0	0	0
0010	3T	7_-1	236	1	0	100	0	-100	0.00	0.00	0	0	0
0010	3T	7_0	123	261	29	26100	21100	-5000	0.11	0.81	46	37	-9
0010	3T	7_0	124	91	5	9100	4550	-4550	0.05	0.50	16	8	-8
0010	3T	7_0	125	74	6	7400	8160	760	0.08	1.10	13	14	1
0010	3T	7_0	126	52	1	5200	1360	-3840	0.02	0.26	9	2	-7
0010	3T	7_0	132	5	0	500	0	-500	0.00	0.00	0	0	0
0010	3T	7_0	134	40	5	4000	6740	2740	0.13	1.69	7	11	4
0010	3T	7_0	135	28	3	2800	7950	5150	0.11	2.84	4	14	10
0010	3T	7_0	136	17	0	1700	0	-1700	0.00	0.00	3	0	-3
0010	3T	7_0	142	4	0	400	0	-400	0.00	0.00	0	0	0
0010	3T	7_0	143	9	1	900	1610	710	0.11	1.79	1	2	1
0010	3T	7_0	145	7	0	700	0	-700	0.00	0.00	1	0	-1
0010	3T	7_0	146	4	0	400	0	-400	0.00	0.00	0	0	0
0010	3T	7_0	152	1	0	100	0	-100	0.00	0.00	0	0	0
0010	3T	7_0	153	2	0	200	0	-200	0.00	0.00	0	0	0
0010	3T	7_0	154	1	0	100	0	-100	0.00	0.00	0	0	0
0010	3T	7_0	156	4	0	400	0	-400	0.00	0.00	0	0	0
0010	3T	7_0	162	1	0	100	0	-100	0.00	0.00	0	0	0
0010	3T	7_0	234	1	0	100	0	-100	0.00	0.00	0	0	0
0010	3T	7_0	235	2	0	200	0	-200	0.00	0.00	0	0	0
0010	3T	7_0	236	1	0	100	0	-100	0.00	0.00	0	0	0
0010	3T	7_1	123	577	71	57700	47720	-9980	0.12	0.83	102	84	-18
0010	3T	7_1	124	256	25	25600	24900	-700	0.10	0.97	45	44	-1
0010	3T	7_1	125	156	15	15600	14090	-1510	0.10	0.90	27	24	-3
0010	3T	7_1	126	97	9	9700	10430	730	0.09	1.08	17	18	1
0010	3T	7_1	132	11	0	1100	0	-1100	0.00	0.00	1	0	-1
0010	3T	7_1	134	95	7	9500	6430	-3070	0.07	0.68	16	11	-5
0010	3T	7_1	135	72	6	7200	5350	-1850	0.08	0.74	12	9	-3
0010	3T	7_1	136	51	4	5100	6150	1050	0.08	1.21	9	10	1
0010	3T	7_1	142	9	1	900	670	-230	0.11	0.74	1	1	0
0010	3T	7_1	143	16	1	1600	950	-650	0.06	0.59	2	1	-1
0010	3T	7_1	145	38	0	3800	0	-3800	0.00	0.00	6	0	-6
0010	3T	7_1	146	19	1	1900	980	-920	0.05	0.52	3	1	-2
0010	3T	7_1	153	2	0	200	0	-200	0.00	0.00	0	0	0
0010	3T	7_1	156	3	0	300	0	-300	0.00	0.00	0	0	0
0010	3T	7_1	214	1	0	100	0	-100	0.00	0.00	0	0	0
0010	3T	7_1	215	1	0	100	0	-100	0.00	0.00	0	0	0
0010	3T	7_1	234	3	0	300	0	-300	0.00	0.00	0	0	0
0010	3T	7_1	235	3	0	300	0	-300	0.00	0.00	0	0	0
0010	3T	7_1	236	2	0	200	0	-200	0.00	0.00	0	0	0
0010	3T	7_1	243	1	0	100	0	-100	0.00	0.00	0	0	0
0010	3T	7_1	245	1	0	100	0	-100	0.00	0.00	0	0	0
0010	3T	7_1	246	1	0	100	0	-100	0.00	0.00	0	0	0
0010	3T	7_2	123	410	52	41000	37270	-3730	0.13	0.91	72	65	-7
0010	3T	7_2	124	462	46	46200	32730	-13470	0.10	0.71	81	57	-24
0010	3T	7_2	125	313	24	31300	21280	-10020	0.08	0.68	55	37	-18
0010	3T	7_2	126	277	19	27700	32820	5120	0.07	1.18	49	58	9
0010	3T	7_2	134	176	17	17600	14690	-2910	0.10	0.83	31	26	-5
0010	3T	7_2	135	168	11	16800	9410	-7390	0.07	0.56	29	16	-13
0010	3T	7_2	136	142	10	14200	11540	-2660	0.07	0.81	25	20	-5
0010	3T	7_2	142	6	1	600	660	60	0.17	1.10	1	1	0
0010	3T	7_2	143	9	2	900	1620	720	0.22	1.80	1	2	1
0010	3T	7_2	145	75	4	7500	6540	-960	0.05	0.87	13	11	-2
0010	3T	7_2	146	47	3	4700	3140	-1560	0.06	0.67	8	5	-3
0010	3T	7_2	152	1	0	100	0	-100	0.00	0.00	0	0	0
0010	3T	7_2	153	1	1	100	850	750	1.00	8.50	0	1	1
0010	3T	7_2	154	1	0	100	0	-100	0.00	0.00	0	0	0
0010	3T	7_2	156	16	1	1600	900	-700	0.06	0.56	2	1	-1
0010	3T	7_2	214	1	0	100	0	-100	0.00	0.00	0	0	0
0010	3T	7_2	215	3	0	300	0	-300	0.00	0.00	0	0	0
0010	3T	7_2	234	3	0	300	0	-300	0.00	0.00	0	0	0
0010	3T	7_2	235	5	0	500	0	-500	0.00	0.00	0	0	0
0010	3T	7_2	236	5	0	500	0	-500	0.00	0.00	0	0	0
0010	3T	7_2	245	1	0	100	0	-100	0.00	0.00	0	0	0
0010	3T	7_2	246	1	0	100	0	-100	0.00	0.00	0	0	0
0010	3T	7_2	256	2	0	200	0	-200	0.00	0.00	0	0	0
0010	3T	7_3	123	279	33	27900	17700	-10200	0.12	0.63	49	31	-18
0010	3T	7_3	124	605	55	60500	42330	-18170	0.09	0.70	107	74	-33
0010	3T	7_3	125	422	35	42200	33520	-8680	0.08	0.79	74	59	-15
0010	3T	7_3	126	376	28	37600	37360	-240	0.07	0.99	66	66	0
0010	3T	7_3	132	1	0	100	0	-100	0.00	0.00	0	0	0
0010	3T	7_3	134	246	27	24600	17550	-7050	0.11	0.71	43	31	-12
0010	3T	7_3	135	234	16	23400	11180	-12220	0.07	0.48	41	19	-22
0010	3T	7_3	136	216	19	21600	22760	1160	0.09	1.05	38	40	2
0010	3T	7_3	145	115	10	11500	13870	2370	0.09	1.21	20	24	4
0010	3T	7_3	146	72	3	7200	2270	-4930	0.04	0.32	12	4	-8
0010	3T	7_3	154	1	0	100	0	-100	0.00	0.00	0	0	0
0010	3T	7_3	156	33	1	3300	530	-2770	0.03	0.16	5	0	-5
0010	3T	7_3	164	7	1	700	1370	670	0.14	1.96	1	2	1
0010	3T	7_3	214	2	0	200	0	-200	0.00	0.00	0	0	0
0010	3T	7_3	215	2	1	200	2210	2010	0.50	11.05	0	3	3
0010	3T	7_3	216	2	0	200	0	-200	0.00	0.00	0	0	0
0010	3T	7_3	234	5	0	500	0	-500	0.00	0.00	0	0	0
0010	3T	7_3	235	9	0	900	0	-900	0.00	0.00	1	0	-1
0010	3T	7_3	236	2	0	200	0	-200	0.00	0.00	0	0	0
0010	3T	7_3	245	6	0	600	0	-600	0.00	0.00	1	0	-1
0010	3T	7_3	246	5	1	500	1210	710	0.20	2.42	0	2	2
0010	3T	7_3	256	4	0	400	0	-400	0.00	0.00	0	0	0
0010	3T	7_4	123	134	21	13400	12180	-1220	0.16	0.91	23	21	-2
0010	3T	7_4	124	454	46	45400	35270	-10130	0.10	0.78	80	62	-18
0010	3T	7_4	125	256	16	25600	26020	420	0.06	1.02	45	46	1
0010	3T	7_4	126	196	8	19600	11630	-7970	0.04	0.59	34	20	-14
0010	3T	7_4	134	112	6	11200	5370	-5830	0.05	0.48	19	9	-10
0010	3T	7_4	135	97	8	9700	12180	2480	0.08	1.26	17	21	4
0010	3T	7_4	136	97	3	9700	3750	-5950	0.03	0.39	17	6	-11
0010	3T	7_4	145	32	1	3200	1120	-2080	0.03	0.35	5	1	-4
0010	3T	7_4	146	28	1	2800	2000	-800	0.04	0.71	4	3	-1
0010	3T	7_4	154	1	0	100	0	-100	0.00	0.00	0	0	0
0010	3T	7_4	156	6	0	600	0	-600	0.00	0.00	1	0	-1
0010	3T	7_4	214	1	0	100	0	-100	0.00	0.00	0	0	0
0010	3T	7_4	215	3	0	300	0	-300	0.00	0.00	0	0	0
0010	3T	7_4	216	4	0	400	0	-400	0.00	0.00	0	0	0
0010	3T	7_4	234	2	1	200	1140	940	0.50	5.70	0	2	2
0010	3T	7_4	235	2	0	200	0	-200	0.00	0.00	0	0	0
0010	3T	7_4	236	1	0	100	0	-100	0.00	0.00	0	0	0
0010	3T	7_4	245	2	0	200	0	-200	0.00	0.00	0	0	0
0010	3T	7_5	123	190	25	19000	17080	-1920	0.13	0.90	33	30	-3
0010	3T	7_5	124	456	34	45600	29220	-16380	0.07	0.64	80	51	-29
0010	3T	7_5	125	97	5	9700	6890	-2810	0.05	0.71	17	12	-5
0010	3T	7_5	126	150	8	15000	15400	400	0.05	1.03	26	27	1
0010	3T	7_5	134	50	5	5000	3680	-1320	0.10	0.74	8	6	-2
0010	3T	7_5	135	19	2	1900	2410	510	0.11	1.27	3	4	1
0010	3T	7_5	136	38	2	3800	3820	20	0.05	1.01	6	6	0
0010	3T	7_5	145	3	0	300	0	-300	0.00	0.00	0	0	0
0010	3T	7_5	146	3	0	300	0	-300	0.00	0.00	0	0	0
0010	3T	7_5	216	3	0	300	0	-300	0.00	0.00	0	0	0
0010	3T	7_6	123	158	17	15800	11340	-4460	0.11	0.72	27	20	-7
0010	3T	7_6	124	408	28	40800	25870	-14930	0.07	0.63	72	45	-27
0010	3T	7_6	125	13	0	1300	0	-1300	0.00	0.00	2	0	-2
0010	3T	7_6	126	102	3	10200	9650	-550	0.03	0.95	18	17	-1
0010	3T	7_6	134	12	1	1200	1870	670	0.08	1.56	2	3	1
0010	3T	7_6	135	4	0	400	0	-400	0.00	0.00	0	0	0
0010	3T	7_6	136	7	0	700	0	-700	0.00	0.00	1	0	-1
0010	3T	7_6	146	3	0	300	0	-300	0.00	0.00	0	0	0
0010	3T	7_6	216	1	0	100	0	-100	0.00	0.00	0	0	0
0007	2T	4_1	25	12	0	1200	0	-1200	0.00	0.00	2	0	-2
0007	2T	4_1	26	6	0	600	0	-600	0.00	0.00	1	0	-1
0007	2T	4_2	12	612	147	61200	51370	-9830	0.24	0.84	108	90	-18
0007	2T	4_2	13	388	73	38800	33310	-5490	0.19	0.86	68	58	-10
0007	2T	4_2	14	259	49	25900	20100	-5800	0.19	0.78	45	35	-10
0007	2T	4_2	15	85	11	8500	7190	-1310	0.13	0.85	15	12	-3
0007	2T	4_2	16	56	7	5600	5680	80	0.13	1.01	9	10	1
0007	2T	4_2	21	75	12	7500	8100	600	0.16	1.08	13	14	1
0007	2T	4_2	23	54	4	5400	6390	990	0.07	1.18	9	11	2
0007	2T	4_2	24	34	3	3400	1310	-2090	0.09	0.39	6	2	-4
0007	2T	4_2	25	24	5	2400	3820	1420	0.21	1.59	4	6	2
0007	2T	4_2	26	20	3	2000	990	-1010	0.15	0.50	3	1	-2
0007	2T	4_3	12	987	204	98700	75390	-23310	0.21	0.76	174	133	-41
0007	2T	4_3	13	734	160	73400	67730	-5670	0.22	0.92	129	119	-10
0007	2T	4_3	14	382	76	38200	38820	620	0.20	1.02	67	68	1
0007	2T	4_3	15	204	18	20400	11710	-8690	0.09	0.57	36	20	-16
0007	2T	4_3	16	104	7	10400	7760	-2640	0.07	0.75	18	13	-5
0007	2T	4_3	21	133	18	13300	10380	-2920	0.14	0.78	23	18	-5
0007	2T	4_3	23	118	14	11800	10110	-1690	0.12	0.86	20	17	-3
0007	2T	4_3	24	45	7	4500	4770	270	0.16	1.06	7	8	1
0007	2T	4_3	25	46	2	4600	1350	-3250	0.04	0.29	8	2	-6
0007	2T	4_3	26	30	2	3000	1090	-1910	0.07	0.36	5	1	-4
0007	2T	4_4	12	912	235	91200	79980	-11220	0.26	0.88	161	141	-20
0007	2T	4_4	13	479	114	47900	42670	-5230	0.24	0.89	84	75	-9
0007	2T	4_4	14	300	50	30000	22750	-7250	0.17	0.76	53	40	-13
0007	2T	4_4	15	103	12	10300	6110	-4190	0.12	0.59	18	10	-8
0007	2T	4_4	16	50	2	5000	1030	-3970	0.04	0.21	8	1	-7
0007	2T	4_4	21	32	4	3200	2300	-900	0.13	0.72	5	4	-1
0007	2T	4_4	23	23	1	2300	1230	-1070	0.04	0.53	4	2	-2
0007	2T	4_4	24	20	2	2000	1200	-800	0.10	0.60	3	2	-1
0007	2T	4_4	25	12	0	1200	0	-1200	0.00	0.00	2	0	-2
0007	2T	4_4	26	9	1	900	1260	360	0.11	1.40	1	2	1
0007	2T	4_5	12	408	111	40800	29080	-11720	0.27	0.71	72	51	-21
0007	2T	4_5	13	209	71	20900	28100	7200	0.34	1.34	36	49	13
0007	2T	4_5	14	87	11	8700	5450	-3250	0.13	0.63	15	9	-6
0007	2T	4_5	15	21	1	2100	580	-1520	0.05	0.28	3	1	-2
0007	2T	4_5	16	8	0	800	0	-800	0.00	0.00	1	0	-1
0007	2T	4_5	21	5	1	500	1210	710	0.20	2.42	0	2	2
0007	2T	4_5	23	1	0	100	0	-100	0.00	0.00	0	0	0
0007	2T	4_5	24	2	0	200	0	-200	0.00	0.00	0	0	0
0007	2T	4_5	25	1	0	100	0	-100	0.00	0.00	0	0	0
0007	2T	4_6	12	166	50	16600	13780	-2820	0.30	0.83	29	24	-5
0007	2T	4_6	13	72	13	7200	5410	-1790	0.18	0.75	12	9	-3
0007	2T	4_6	14	31	7	3100	5230	2130	0.23	1.69	5	9	4
0007	2T	4_6	15	13	0	1300	0	-1300	0.00	0.00	2	0	-2
0007	2T	4_6	16	2	0	200	0	-200	0.00	0.00	0	0	0
0007	2T	4_6	21	1	0	100	0	-100	0.00	0.00	0	0	0
0007	2T	5_0	12	147	32	14700	12860	-1840	0.22	0.87	26	22	-4
0007	2T	5_0	13	103	15	10300	7260	-3040	0.15	0.70	18	12	-6
0007	2T	5_0	14	56	3	5600	1800	-3800	0.05	0.32	9	3	-6
0007	2T	5_0	15	33	2	3300	1270	-2030	0.06	0.38	5	2	-3
0007	2T	5_0	16	11	2	1100	2590	1490	0.18	2.35	1	4	3
0007	2T	5_0	21	18	2	1800	2080	280	0.11	1.16	3	3	0
0007	2T	5_0	23	14	1	1400	1670	270	0.07	1.19	2	2	0
0007	2T	5_0	24	4	0	400	0	-400	0.00	0.00	0	0	0
0007	2T	5_0	25	7	0	700	0	-700	0.00	0.00	1	0	-1
0007	2T	5_0	26	1	0	100	0	-100	0.00	0.00	0	0	0
0007	2T	5_1	12	345	95	34500	28720	-5780	0.28	0.83	61	50	-11
0007	2T	5_1	13	231	48	23100	23510	410	0.21	1.02	40	41	1
0007	2T	5_1	14	145	22	14500	9440	-5060	0.15	0.65	25	16	-9
0007	2T	5_1	15	63	7	6300	5740	-560	0.11	0.91	11	10	-1
0007	2T	5_1	16	21	2	2100	1400	-700	0.10	0.67	3	2	-1
0007	2T	5_1	21	20	1	2000	760	-1240	0.05	0.38	3	1	-2
0007	2T	5_1	23	18	0	1800	0	-1800	0.00	0.00	3	0	-3
0007	2T	5_1	24	9	1	900	760	-140	0.11	0.84	1	1	0
0007	2T	5_1	25	7	0	700	0	-700	0.00	0.00	1	0	-1
0007	2T	5_1	26	2	0	200	0	-200	0.00	0.00	0	0	0
0007	2T	5_2	12	481	103	48100	32540	-15560	0.21	0.68	85	57	-28
0007	2T	5_2	13	315	57	31500	25540	-5960	0.18	0.81	55	45	-10
0007	2T	5_2	14	194	44	19400	20270	870	0.23	1.04	34	35	1
0007	2T	5_2	15	76	7	7600	5430	-2170	0.09	0.71	13	9	-4
0007	2T	5_2	16	47	8	4700	5470	770	0.17	1.16	8	9	1
0007	2T	5_2	21	39	6	3900	6090	2190	0.15	1.56	6	10	4
0007	2T	5_2	23	34	2	3400	1740	-1660	0.06	0.51	6	3	-3
0007	2T	5_2	24	14	2	1400	920	-480	0.14	0.66	2	1	-1
0007	2T	5_2	25	17	1	1700	700	-1000	0.06	0.41	3	1	-2
0007	2T	5_2	26	5	0	500	0	-500	0.00	0.00	0	0	0
0007	2T	5_3	12	793	194	79300	77850	-1450	0.24	0.98	140	137	-3
0005	1T	01	1	2561	1387	256100	234780	-21320	0.54	0.92	453	415	-38
0005	1T	01	2	325	83	32500	33140	640	0.26	1.02	57	58	1
0005	1T	02	1	2500	1185	250000	222160	-27840	0.47	0.89	442	393	-49
0005	1T	02	2	327	89	32700	26530	-6170	0.27	0.81	57	46	-11
0005	1T	03	1	1806	898	180600	173750	-6850	0.50	0.96	319	307	-12
0005	1T	03	2	326	91	32600	29750	-2850	0.28	0.91	57	52	-5
0005	1T	04	1	2099	1047	209900	188240	-21660	0.50	0.90	371	333	-38
0005	1T	04	2	311	89	31100	31530	430	0.29	1.01	55	55	0
0005	1T	05	1	2414	1392	241400	238780	-2620	0.58	0.99	427	422	-5
0005	1T	05	2	360	101	36000	29620	-6380	0.28	0.82	63	52	-11
0005	1T	06	1	2652	1426	265200	238400	-26800	0.54	0.90	469	421	-48
0005	1T	06	2	329	103	32900	27080	-5820	0.31	0.82	58	47	-11
0005	1T	07	1	2671	1597	267100	256980	-10120	0.60	0.96	472	454	-18
0005	1T	07	2	321	97	32100	30270	-1830	0.30	0.94	56	53	-3
0005	1T	08	1	2620	1589	262000	248480	-13520	0.61	0.95	463	439	-24
0005	1T	08	2	242	74	24200	27560	3360	0.31	1.14	42	48	6
0005	1T	09	1	2740	1711	274000	266830	-7170	0.62	0.97	484	472	-12
0005	1T	09	2	314	125	31400	33030	1630	0.40	1.05	55	58	3
0005	1T	10	1	2551	1479	255100	231420	-23680	0.58	0.91	451	409	-42
0005	1T	10	2	306	120	30600	28580	-2020	0.39	0.93	54	50	-4
0005	1T	11	1	2252	1126	225200	199010	-26190	0.50	0.88	398	352	-46
0005	1T	11	2	386	85	38600	35090	-3510	0.22	0.91	68	62	-6
0005	1T	12	1	2469	1438	246900	222100	-24800	0.58	0.90	436	393	-43
0005	1T	12	2	293	82	29300	32960	3660	0.28	1.12	51	58	7
0005	1T	13	1	2482	1511	248200	238950	-9250	0.61	0.96	439	422	-17
0005	1T	13	2	274	84	27400	27100	-300	0.31	0.99	48	47	-1
0005	1T	14	1	2290	1202	229000	208560	-20440	0.52	0.91	405	369	-36
0005	1T	14	2	335	101	33500	30930	-2570	0.30	0.92	59	54	-5
0005	1T	15	1	2832	1590	283200	254520	-28680	0.56	0.90	501	450	-51
0005	1T	15	2	291	88	29100	28250	-850	0.30	0.97	51	50	-1
0005	1T	16	1	2892	1744	289200	275150	-14050	0.60	0.95	511	486	-25
0005	1T	16	2	289	91	28900	29750	850	0.31	1.03	51	52	1
0005	1T	17	1	2769	1667	276900	266300	-10600	0.60	0.96	490	471	-19
0005	1T	17	2	303	108	30300	31730	1430	0.36	1.05	53	56	3
0005	1T	18	1	2968	2029	296800	283260	-13540	0.68	0.95	525	501	-24
0005	1T	18	2	298	120	29800	28960	-840	0.40	0.97	52	51	-1
0005	1T	19	1	2536	1552	253600	237300	-16300	0.61	0.94	448	420	-28
0005	1T	19	2	267	85	26700	35590	8890	0.32	1.33	47	62	15
0005	1T	20	1	2698	1601	269800	249510	-20290	0.59	0.92	477	441	-36
0005	1T	20	2	207	71	20700	21700	1000	0.34	1.05	36	38	2
0005	1T	21	1	2936	1875	293600	266300	-27300	0.64	0.91	519	471	-48
0005	1T	21	2	156	60	15600	15930	330	0.38	1.02	27	28	1
0005	1T	22	1	2254	1222	225400	209130	-16270	0.54	0.93	398	370	-28
0005	1T	22	2	350	72	35000	22880	-12120	0.21	0.65	61	40	-21
0005	1T	23	1	2552	1460	255200	245540	-9660	0.57	0.96	451	434	-17
0005	1T	23	2	322	85	32200	26010	-6190	0.26	0.81	56	46	-10
0005	1T	24	1	2858	2013	285800	281100	-4700	0.70	0.98	505	497	-8
0005	1T	24	2	202	73	20200	21720	1520	0.36	1.08	35	38	3
0005	2F	01	12	1101	281	110100	87750	-22350	0.26	0.80	194	155	-39
0005	2F	01	13	524	103	52400	43450	-8950	0.20	0.83	92	76	-16
0005	2F	01	14	358	47	35800	19310	-16490	0.13	0.54	63	34	-29
0005	2F	01	15	183	28	18300	12760	-5540	0.15	0.70	32	22	-10
0005	2F	01	16	39	7	3900	5240	1340	0.18	1.34	6	9	3
0005	2F	01	23	64	10	6400	4860	-1540	0.16	0.76	11	8	-3
0005	2F	01	24	36	2	3600	2780	-820	0.06	0.77	6	4	-2
0005	2F	01	25	25	1	2500	1560	-940	0.04	0.62	4	2	-2
0005	2F	01	26	9	1	900	790	-110	0.11	0.88	1	1	0
0005	2F	02	12	1062	271	106200	94260	-11940	0.26	0.89	187	166	-21
0005	2F	02	13	569	114	56900	50740	-6160	0.20	0.89	100	89	-11
0007	2T	5_3	13	538	102	53800	40270	-13530	0.19	0.75	95	71	-24
0007	2T	5_3	14	337	63	33700	27800	-5900	0.19	0.82	59	49	-10
0007	2T	5_3	15	136	23	13600	18740	5140	0.17	1.38	24	33	9
0007	2T	5_3	16	76	10	7600	10830	3230	0.13	1.43	13	19	6
0007	2T	5_3	21	59	9	5900	7370	1470	0.15	1.25	10	13	3
0007	2T	5_3	23	37	1	3700	370	-3330	0.03	0.10	6	0	-6
0007	2T	5_3	24	23	0	2300	0	-2300	0.00	0.00	4	0	-4
0007	2T	5_3	25	8	0	800	0	-800	0.00	0.00	1	0	-1
0007	2T	5_3	26	5	0	500	0	-500	0.00	0.00	0	0	0
0007	2T	5_4	12	540	149	54000	44070	-9930	0.28	0.82	95	78	-17
0007	2T	5_4	13	353	73	35300	27180	-8120	0.21	0.77	62	48	-14
0007	2T	5_4	14	243	34	24300	16440	-7860	0.14	0.68	43	29	-14
0007	2T	5_4	15	73	8	7300	4170	-3130	0.11	0.57	12	7	-5
0007	2T	5_4	16	39	4	3900	2480	-1420	0.10	0.64	6	4	-2
0007	2T	5_4	21	25	2	2500	810	-1690	0.08	0.32	4	1	-3
0007	2T	5_4	23	21	0	2100	0	-2100	0.00	0.00	3	0	-3
0007	2T	5_4	24	2	0	200	0	-200	0.00	0.00	0	0	0
0007	2T	5_4	25	3	0	300	0	-300	0.00	0.00	0	0	0
0007	2T	5_4	26	4	0	400	0	-400	0.00	0.00	0	0	0
0007	2T	5_5	12	425	128	42500	30550	-11950	0.30	0.72	75	54	-21
0007	2T	5_5	13	207	48	20700	16770	-3930	0.23	0.81	36	29	-7
0007	2T	5_5	14	105	25	10500	15030	4530	0.24	1.43	18	26	8
0007	2T	5_5	15	44	2	4400	2780	-1620	0.05	0.63	7	4	-3
0007	2T	5_5	16	4	0	400	0	-400	0.00	0.00	0	0	0
0007	2T	5_5	21	13	0	1300	0	-1300	0.00	0.00	2	0	-2
0007	2T	5_5	23	5	1	500	2140	1640	0.20	4.28	0	3	3
0007	2T	5_5	25	3	1	300	2630	2330	0.33	8.77	0	4	4
0007	2T	5_6	12	141	45	14100	11810	-2290	0.32	0.84	24	20	-4
0007	2T	5_6	13	68	18	6800	6270	-530	0.26	0.92	12	11	-1
0007	2T	5_6	14	23	6	2300	2880	580	0.26	1.25	4	5	1
0007	2T	5_6	15	19	1	1900	2130	230	0.05	1.12	3	3	0
0007	2T	5_6	16	7	0	700	0	-700	0.00	0.00	1	0	-1
0007	2T	5_6	21	4	1	400	660	260	0.25	1.65	0	1	1
0007	2T	5_6	24	1	0	100	0	-100	0.00	0.00	0	0	0
0007	2T	5_6	25	1	0	100	0	-100	0.00	0.00	0	0	0
0007	2T	5_6	26	1	0	100	0	-100	0.00	0.00	0	0	0
0007	2T	6_0	12	9	1	900	820	-80	0.11	0.91	1	1	0
0007	2T	6_0	13	12	2	1200	500	-700	0.17	0.42	2	0	-2
0007	2T	6_0	14	3	0	300	0	-300	0.00	0.00	0	0	0
0007	2T	6_0	15	5	0	500	0	-500	0.00	0.00	0	0	0
0007	2T	6_0	16	1	0	100	0	-100	0.00	0.00	0	0	0
0007	2T	6_0	21	2	1	200	830	630	0.50	4.15	0	1	1
0007	2T	6_0	23	2	0	200	0	-200	0.00	0.00	0	0	0
0007	2T	6_0	25	3	0	300	0	-300	0.00	0.00	0	0	0
0007	2T	6_1	12	23	9	2300	2030	-270	0.39	0.88	4	3	-1
0007	2T	6_1	13	16	3	1600	790	-810	0.19	0.49	2	1	-1
0007	2T	6_1	14	12	2	1200	1320	120	0.17	1.10	2	2	0
0007	2T	6_1	15	5	0	500	0	-500	0.00	0.00	0	0	0
0007	2T	6_1	16	1	0	100	0	-100	0.00	0.00	0	0	0
0007	2T	6_1	21	2	0	200	0	-200	0.00	0.00	0	0	0
0007	2T	6_1	24	1	0	100	0	-100	0.00	0.00	0	0	0
0007	2T	6_2	12	27	4	2700	2170	-530	0.15	0.80	4	3	-1
0007	2T	6_2	13	23	3	2300	1020	-1280	0.13	0.44	4	1	-3
0007	2T	6_2	14	17	4	1700	1740	40	0.24	1.02	3	3	0
0007	2T	6_2	15	7	1	700	310	-390	0.14	0.44	1	0	-1
0007	2T	6_2	21	2	0	200	0	-200	0.00	0.00	0	0	0
0007	2T	6_2	26	1	0	100	0	-100	0.00	0.00	0	0	0
0007	2T	6_3	12	60	11	6000	3310	-2690	0.18	0.55	10	5	-5
0007	2T	6_3	13	45	11	4500	3270	-1230	0.24	0.73	7	5	-2
0007	2T	6_3	14	20	1	2000	330	-1670	0.05	0.17	3	0	-3
0007	2T	6_3	15	14	1	1400	340	-1060	0.07	0.24	2	0	-2
0007	2T	6_3	16	15	2	1500	3190	1690	0.13	2.13	2	5	3
0007	2T	6_3	21	4	1	400	390	-10	0.25	0.98	0	0	0
0007	2T	6_3	23	3	0	300	0	-300	0.00	0.00	0	0	0
0007	2T	6_3	24	1	0	100	0	-100	0.00	0.00	0	0	0
0007	2T	6_3	25	1	0	100	0	-100	0.00	0.00	0	0	0
0007	2T	6_3	26	2	0	200	0	-200	0.00	0.00	0	0	0
0007	2T	6_4	12	56	11	5600	2940	-2660	0.20	0.53	9	5	-4
0007	2T	6_4	13	32	5	3200	1300	-1900	0.16	0.41	5	2	-3
0007	2T	6_4	14	19	3	1900	1680	-220	0.16	0.88	3	2	-1
0007	2T	6_4	15	11	0	1100	0	-1100	0.00	0.00	1	0	-1
0007	2T	6_4	16	7	0	700	0	-700	0.00	0.00	1	0	-1
0007	2T	6_4	21	1	0	100	0	-100	0.00	0.00	0	0	0
0007	2T	6_5	12	31	12	3100	2770	-330	0.39	0.89	5	4	-1
0007	2T	6_5	13	17	2	1700	610	-1090	0.12	0.36	3	1	-2
0007	2T	6_5	14	7	0	700	0	-700	0.00	0.00	1	0	-1
0007	2T	6_5	15	2	0	200	0	-200	0.00	0.00	0	0	0
0007	2T	6_5	16	2	0	200	0	-200	0.00	0.00	0	0	0
0007	2T	6_6	12	17	4	1700	1280	-420	0.24	0.75	3	2	-1
0007	2T	6_6	13	5	0	500	0	-500	0.00	0.00	0	0	0
0007	2T	6_6	14	5	1	500	380	-120	0.20	0.76	0	0	0
0007	2T	6_6	21	1	0	100	0	-100	0.00	0.00	0	0	0
0007	2T	7_0	12	279	61	27900	24250	-3650	0.22	0.87	49	42	-7
0007	2T	7_0	13	189	28	18900	14710	-4190	0.15	0.78	33	26	-7
0007	2T	7_0	14	84	16	8400	9860	1460	0.19	1.17	14	17	3
0007	2T	7_0	15	53	3	5300	1930	-3370	0.06	0.36	9	3	-6
0007	2T	7_0	16	19	1	1900	3470	1570	0.05	1.83	3	6	3
0007	2T	7_0	21	37	3	3700	3160	-540	0.08	0.85	6	5	-1
0007	2T	7_0	23	40	5	4000	6970	2970	0.13	1.74	7	12	5
0007	2T	7_0	24	24	1	2400	3140	740	0.04	1.31	4	5	1
0007	2T	7_0	25	6	0	600	0	-600	0.00	0.00	1	0	-1
0007	2T	7_0	26	8	0	800	0	-800	0.00	0.00	1	0	-1
0007	2T	7_1	12	797	219	79700	69410	-10290	0.27	0.87	141	122	-19
0007	2T	7_1	13	526	105	52600	40770	-11830	0.20	0.78	93	72	-21
0007	2T	7_1	14	278	43	27800	21390	-6410	0.15	0.77	49	37	-12
0007	2T	7_1	15	143	17	14300	12150	-2150	0.12	0.85	25	21	-4
0007	2T	7_1	16	43	3	4300	2590	-1710	0.07	0.60	7	4	-3
0007	2T	7_1	21	55	7	5500	4060	-1440	0.13	0.74	9	7	-2
0007	2T	7_1	23	48	4	4800	7580	2780	0.08	1.58	8	13	5
0007	2T	7_1	24	19	0	1900	0	-1900	0.00	0.00	3	0	-3
0007	2T	7_1	25	14	0	1400	0	-1400	0.00	0.00	2	0	-2
0007	2T	7_1	26	7	0	700	0	-700	0.00	0.00	1	0	-1
0007	2T	7_2	12	1107	273	110700	95050	-15650	0.25	0.86	195	168	-27
0007	2T	7_2	13	691	145	69100	62060	-7040	0.21	0.90	122	109	-13
0007	2T	7_2	14	460	84	46000	37670	-8330	0.18	0.82	81	66	-15
0007	2T	7_2	15	168	17	16800	9800	-7000	0.10	0.58	29	17	-12
0007	2T	7_2	16	97	14	9700	6550	-3150	0.14	0.68	17	11	-6
0007	2T	7_2	21	85	9	8500	5320	-3180	0.11	0.63	15	9	-6
0007	2T	7_2	23	69	5	6900	4120	-2780	0.07	0.60	12	7	-5
0007	2T	7_2	24	36	4	3600	2740	-860	0.11	0.76	6	4	-2
0007	2T	7_2	25	35	1	3500	900	-2600	0.03	0.26	6	1	-5
0007	2T	7_2	26	14	0	1400	0	-1400	0.00	0.00	2	0	-2
0007	2T	7_3	12	1211	310	121100	105800	-15300	0.26	0.87	214	187	-27
0007	2T	7_3	13	741	155	74100	58230	-15870	0.21	0.79	131	103	-28
0007	2T	7_3	14	434	58	43400	29230	-14170	0.13	0.67	76	51	-25
0007	2T	7_3	15	171	16	17100	12970	-4130	0.09	0.76	30	22	-8
0007	2T	7_3	16	100	15	10000	14190	4190	0.15	1.42	17	25	8
0007	2T	7_3	21	70	15	7000	14170	7170	0.21	2.02	12	25	13
0007	2T	7_3	23	35	1	3500	600	-2900	0.03	0.17	6	1	-5
0007	2T	7_3	24	31	1	3100	390	-2710	0.03	0.13	5	0	-5
0007	2T	7_3	25	17	2	1700	2480	780	0.12	1.46	3	4	1
0007	2T	7_3	26	14	2	1400	2560	1160	0.14	1.83	2	4	2
0007	2T	7_4	12	626	175	62600	54980	-7620	0.28	0.88	110	97	-13
0007	2T	7_4	13	358	63	35800	26000	-9800	0.18	0.73	63	46	-17
0007	2T	7_4	14	203	33	20300	18000	-2300	0.16	0.89	35	31	-4
0007	2T	7_4	15	67	6	6700	3560	-3140	0.09	0.53	11	6	-5
0007	2T	7_4	16	27	1	2700	860	-1840	0.04	0.32	4	1	-3
0007	2T	7_4	21	18	2	1800	1270	-530	0.11	0.71	3	2	-1
0007	2T	7_4	23	11	0	1100	0	-1100	0.00	0.00	1	0	-1
0007	2T	7_4	24	11	1	1100	1730	630	0.09	1.57	1	3	2
0007	2T	7_4	25	9	1	900	2640	1740	0.11	2.93	1	4	3
0007	2T	7_4	26	1	0	100	0	-100	0.00	0.00	0	0	0
0007	2T	7_5	12	488	143	48800	42500	-6300	0.29	0.87	86	75	-11
0007	2T	7_5	13	214	49	21400	20740	-660	0.23	0.97	37	36	-1
0007	2T	7_5	14	120	18	12000	10540	-1460	0.15	0.88	21	18	-3
0007	2T	7_5	15	51	6	5100	5970	870	0.12	1.17	9	10	1
0007	2T	7_5	16	14	0	1400	0	-1400	0.00	0.00	2	0	-2
0007	2T	7_5	21	11	0	1100	0	-1100	0.00	0.00	1	0	-1
0007	2T	7_5	23	5	0	500	0	-500	0.00	0.00	0	0	0
0007	2T	7_5	24	1	0	100	0	-100	0.00	0.00	0	0	0
0007	2T	7_5	25	1	0	100	0	-100	0.00	0.00	0	0	0
0007	2T	7_6	12	333	88	33300	24830	-8470	0.26	0.75	58	43	-15
0007	2T	7_6	13	145	23	14500	8780	-5720	0.16	0.61	25	15	-10
0007	2T	7_6	14	99	18	9900	11150	1250	0.18	1.13	17	19	2
0007	2T	7_6	15	27	1	2700	540	-2160	0.04	0.20	4	0	-4
0007	2T	7_6	16	11	1	1100	990	-110	0.09	0.90	1	1	0
0007	2T	7_6	21	3	0	300	0	-300	0.00	0.00	0	0	0
0007	2T	7_6	23	3	0	300	0	-300	0.00	0.00	0	0	0
0007	2T	7_6	24	1	0	100	0	-100	0.00	0.00	0	0	0
0007	3F	1_0	123	105	16	10500	6490	-4010	0.15	0.62	18	11	-7
0007	3F	1_0	124	95	13	9500	9340	-160	0.14	0.98	16	16	0
0007	3F	1_0	125	58	6	5800	5970	170	0.10	1.03	10	10	0
0007	3F	1_0	126	25	3	2500	2460	-40	0.12	0.98	4	4	0
0007	3F	1_0	134	70	11	7000	6330	-670	0.16	0.90	12	11	-1
0007	3F	1_0	135	46	0	4600	0	-4600	0.00	0.00	8	0	-8
0007	3F	1_0	136	20	1	2000	350	-1650	0.05	0.18	3	0	-3
0007	3F	1_0	145	23	1	2300	550	-1750	0.04	0.24	4	0	-4
0007	3F	1_0	146	10	1	1000	830	-170	0.10	0.83	1	1	0
0007	3F	1_0	156	8	1	800	2580	1780	0.13	3.23	1	4	3
0007	3F	1_0	234	9	0	900	0	-900	0.00	0.00	1	0	-1
0007	3F	1_0	235	2	0	200	0	-200	0.00	0.00	0	0	0
0007	3F	1_0	245	2	0	200	0	-200	0.00	0.00	0	0	0
0007	3F	1_0	246	4	0	400	0	-400	0.00	0.00	0	0	0
0007	3F	1_1	123	257	55	25700	22070	-3630	0.21	0.86	45	39	-6
0007	3F	1_1	124	219	36	21900	17380	-4520	0.16	0.79	38	30	-8
0007	3F	1_1	125	122	14	12200	10320	-1880	0.11	0.85	21	18	-3
0007	3F	1_1	126	50	2	5000	2300	-2700	0.04	0.46	8	4	-4
0007	3F	1_1	134	167	26	16700	14290	-2410	0.16	0.86	29	25	-4
0007	3F	1_1	135	98	8	9800	5390	-4410	0.08	0.55	17	9	-8
0007	3F	1_1	136	39	3	3900	2900	-1000	0.08	0.74	6	5	-1
0007	3F	1_1	145	63	3	6300	1030	-5270	0.05	0.16	11	1	-10
0007	3F	1_1	146	23	0	2300	0	-2300	0.00	0.00	4	0	-4
0007	3F	1_1	156	15	0	1500	0	-1500	0.00	0.00	2	0	-2
0007	3F	1_1	234	12	1	1200	660	-540	0.08	0.55	2	1	-1
0007	3F	1_1	235	8	0	800	0	-800	0.00	0.00	1	0	-1
0007	3F	1_1	236	2	0	200	0	-200	0.00	0.00	0	0	0
0007	3F	1_1	245	10	0	1000	0	-1000	0.00	0.00	1	0	-1
0007	3F	1_2	123	338	62	33800	32280	-1520	0.18	0.96	59	57	-2
0007	3F	1_2	124	300	47	30000	20860	-9140	0.16	0.70	53	36	-17
0007	3F	1_2	125	160	17	16000	11060	-4940	0.11	0.69	28	19	-9
0007	3F	1_2	126	91	7	9100	6540	-2560	0.08	0.72	16	11	-5
0007	3F	1_2	134	199	29	19900	15010	-4890	0.15	0.75	35	26	-9
0007	3F	1_2	135	100	9	10000	9770	-230	0.09	0.98	17	17	0
0007	3F	1_2	136	63	4	6300	2730	-3570	0.06	0.43	11	4	-7
0007	3F	1_2	145	81	6	8100	2730	-5370	0.07	0.34	14	4	-10
0007	3F	1_2	146	37	4	3700	5610	1910	0.11	1.52	6	9	3
0007	3F	1_2	156	15	1	1500	440	-1060	0.07	0.29	2	0	-2
0007	3F	1_2	234	24	0	2400	0	-2400	0.00	0.00	4	0	-4
0007	3F	1_2	235	21	0	2100	0	-2100	0.00	0.00	3	0	-3
0007	3F	1_2	236	13	1	1300	1700	400	0.08	1.31	2	3	1
0007	3F	1_2	245	17	2	1700	1330	-370	0.12	0.78	3	2	-1
0007	3F	1_2	246	10	0	1000	0	-1000	0.00	0.00	1	0	-1
0007	3F	1_2	256	6	0	600	0	-600	0.00	0.00	1	0	-1
0007	3F	1_3	123	506	74	50600	32070	-18530	0.15	0.63	89	56	-33
0007	3F	1_3	124	432	82	43200	46350	3150	0.19	1.07	76	82	6
0007	3F	1_3	125	222	17	22200	10760	-11440	0.08	0.48	39	19	-20
0007	3F	1_3	126	265	31	26500	31060	4560	0.12	1.17	46	54	8
0007	3F	1_3	134	328	53	32800	27750	-5050	0.16	0.85	58	49	-9
0007	3F	1_3	135	181	18	18100	10330	-7770	0.10	0.57	32	18	-14
0007	3F	1_3	136	163	11	16300	8840	-7460	0.07	0.54	28	15	-13
0007	3F	1_3	145	135	7	13500	5980	-7520	0.05	0.44	23	10	-13
0007	3F	1_3	146	110	10	11000	10040	-960	0.09	0.91	19	17	-2
0007	3F	1_3	156	59	2	5900	1400	-4500	0.03	0.24	10	2	-8
0007	3F	1_3	234	64	4	6400	2990	-3410	0.06	0.47	11	5	-6
0007	3F	1_3	235	34	3	3400	2600	-800	0.09	0.76	6	4	-2
0007	3F	1_3	236	27	2	2700	1500	-1200	0.07	0.56	4	2	-2
0007	3F	1_3	245	26	2	2600	1750	-850	0.08	0.67	4	3	-1
0007	3F	1_3	246	25	3	2500	6570	4070	0.12	2.63	4	11	7
0007	3F	1_3	256	12	2	1200	4640	3440	0.17	3.87	2	8	6
0007	3F	1_4	123	283	58	28300	25020	-3280	0.20	0.88	50	44	-6
0007	3F	1_4	124	259	40	25900	21840	-4060	0.15	0.84	45	38	-7
0007	3F	1_4	125	154	21	15400	19180	3780	0.14	1.25	27	33	6
0007	3F	1_4	126	155	16	15500	15220	-280	0.10	0.98	27	26	-1
0007	3F	1_4	134	186	29	18600	19000	400	0.16	1.02	32	33	1
0007	3F	1_4	135	102	10	10200	8260	-1940	0.10	0.81	18	14	-4
0007	3F	1_4	136	113	6	11300	6520	-4780	0.05	0.58	20	11	-9
0007	3F	1_4	145	99	11	9900	16650	6750	0.11	1.68	17	29	12
0007	3F	1_4	146	72	5	7200	5450	-1750	0.07	0.76	12	9	-3
0007	3F	1_4	156	32	1	3200	350	-2850	0.03	0.11	5	0	-5
0007	3F	1_4	234	20	1	2000	1350	-650	0.05	0.68	3	2	-1
0007	3F	1_4	235	14	2	1400	650	-750	0.14	0.46	2	1	-1
0007	3F	1_4	236	11	0	1100	0	-1100	0.00	0.00	1	0	-1
0007	3F	1_4	245	13	1	1300	570	-730	0.08	0.44	2	1	-1
0007	3F	1_4	246	6	0	600	0	-600	0.00	0.00	1	0	-1
0007	3F	1_4	256	5	1	500	1100	600	0.20	2.20	0	1	1
0007	3F	1_5	123	46	12	4600	4090	-510	0.26	0.89	8	7	-1
0007	3F	1_5	124	52	6	5200	3670	-1530	0.12	0.71	9	6	-3
0007	3F	1_5	125	36	1	3600	990	-2610	0.03	0.28	6	1	-5
0007	3F	1_5	126	26	1	2600	4120	1520	0.04	1.58	4	7	3
0007	3F	1_5	134	39	8	3900	5370	1470	0.21	1.38	6	9	3
0007	3F	1_5	135	20	0	2000	0	-2000	0.00	0.00	3	0	-3
0007	3F	1_5	136	23	1	2300	1790	-510	0.04	0.78	4	3	-1
0007	3F	1_5	145	23	0	2300	0	-2300	0.00	0.00	4	0	-4
0007	3F	1_5	146	16	0	1600	0	-1600	0.00	0.00	2	0	-2
0007	3F	1_5	156	1	0	100	0	-100	0.00	0.00	0	0	0
0007	3F	1_5	234	4	1	400	3050	2650	0.25	7.63	0	5	5
0007	3F	1_5	235	2	1	200	980	780	0.50	4.90	0	1	1
0007	3F	1_5	236	1	0	100	0	-100	0.00	0.00	0	0	0
0007	3F	1_5	245	1	0	100	0	-100	0.00	0.00	0	0	0
0007	3F	1_5	246	2	0	200	0	-200	0.00	0.00	0	0	0
0007	3F	1_6	123	168	38	16800	14180	-2620	0.23	0.84	29	25	-4
0007	3F	1_6	124	132	20	13200	9100	-4100	0.15	0.69	23	16	-7
0007	3F	1_6	125	105	9	10500	8350	-2150	0.09	0.80	18	14	-4
0007	3F	1_6	126	103	8	10300	14040	3740	0.08	1.36	18	24	6
0007	3F	1_6	134	119	24	11900	17890	5990	0.20	1.50	21	31	10
0007	3F	1_6	135	84	5	8400	6060	-2340	0.06	0.72	14	10	-4
0007	3F	1_6	136	76	4	7600	6410	-1190	0.05	0.84	13	11	-2
0007	3F	1_6	145	62	6	6200	6790	590	0.10	1.10	10	12	2
0007	3F	1_6	146	36	0	3600	0	-3600	0.00	0.00	6	0	-6
0007	3F	1_6	156	26	3	2600	5800	3200	0.12	2.23	4	10	6
0007	3F	1_6	234	1	0	100	0	-100	0.00	0.00	0	0	0
0007	3F	1_6	235	1	0	100	0	-100	0.00	0.00	0	0	0
0007	3F	1_6	236	4	0	400	0	-400	0.00	0.00	0	0	0
0007	3F	1_6	245	1	0	100	0	-100	0.00	0.00	0	0	0
0007	3F	1_6	246	3	0	300	0	-300	0.00	0.00	0	0	0
0007	3F	1_6	256	1	0	100	0	-100	0.00	0.00	0	0	0
0007	3F	2_0	123	91	21	9100	8350	-750	0.23	0.92	16	14	-2
0007	3F	2_0	124	46	6	4600	2620	-1980	0.13	0.57	8	4	-4
0007	3F	2_0	125	36	5	3600	3570	-30	0.14	0.99	6	6	0
0007	3F	2_0	126	35	2	3500	1660	-1840	0.06	0.47	6	2	-4
0007	3F	2_0	134	43	6	4300	2900	-1400	0.14	0.67	7	5	-2
0007	3F	2_0	135	24	2	2400	720	-1680	0.08	0.30	4	1	-3
0007	3F	2_0	136	26	1	2600	600	-2000	0.04	0.23	4	1	-3
0007	3F	2_0	145	12	2	1200	1300	100	0.17	1.08	2	2	0
0007	3F	2_0	146	4	0	400	0	-400	0.00	0.00	0	0	0
0007	3F	2_0	156	8	0	800	0	-800	0.00	0.00	1	0	-1
0007	3F	2_0	234	7	1	700	1490	790	0.14	2.13	1	2	1
0007	3F	2_0	235	3	0	300	0	-300	0.00	0.00	0	0	0
0007	3F	2_0	236	4	0	400	0	-400	0.00	0.00	0	0	0
0007	3F	2_0	245	2	0	200	0	-200	0.00	0.00	0	0	0
0007	3F	2_0	246	2	0	200	0	-200	0.00	0.00	0	0	0
0007	3F	2_1	123	229	53	22900	18750	-4150	0.23	0.82	40	33	-7
0007	3F	2_1	124	159	37	15900	15580	-320	0.23	0.98	28	27	-1
0007	3F	2_1	125	96	21	9600	13060	3460	0.22	1.36	16	23	7
0007	3F	2_1	126	70	10	7000	7340	340	0.14	1.05	12	12	0
0007	3F	2_1	134	122	21	12200	8290	-3910	0.17	0.68	21	14	-7
0007	3F	2_1	135	75	11	7500	5830	-1670	0.15	0.78	13	10	-3
0007	3F	2_1	136	50	3	5000	2390	-2610	0.06	0.48	8	4	-4
0007	3F	2_1	145	52	3	5200	1570	-3630	0.06	0.30	9	2	-7
0007	3F	2_1	146	37	7	3700	5320	1620	0.19	1.44	6	9	3
0007	3F	2_1	156	11	2	1100	2270	1170	0.18	2.06	1	4	3
0007	3F	2_1	234	4	0	400	0	-400	0.00	0.00	0	0	0
0007	3F	2_1	235	2	0	200	0	-200	0.00	0.00	0	0	0
0007	3F	2_1	236	2	0	200	0	-200	0.00	0.00	0	0	0
0007	3F	2_1	245	8	2	800	11340	10540	0.25	14.18	1	20	19
0007	3F	2_1	246	2	0	200	0	-200	0.00	0.00	0	0	0
0007	3F	2_1	256	3	0	300	0	-300	0.00	0.00	0	0	0
0007	3F	2_2	123	317	64	31700	27540	-4160	0.20	0.87	56	48	-8
0007	3F	2_2	124	301	66	30100	23800	-6300	0.22	0.79	53	42	-11
0007	3F	2_2	125	137	31	13700	13570	-130	0.23	0.99	24	24	0
0007	3F	2_2	126	155	16	15500	9100	-6400	0.10	0.59	27	16	-11
0007	3F	2_2	134	158	21	15800	8580	-7220	0.13	0.54	27	15	-12
0007	3F	2_2	135	73	13	7300	6900	-400	0.18	0.95	12	12	0
0007	3F	2_2	136	77	10	7700	3990	-3710	0.13	0.52	13	7	-6
0007	3F	2_2	145	69	6	6900	1980	-4920	0.09	0.29	12	3	-9
0007	3F	2_2	146	48	2	4800	730	-4070	0.04	0.15	8	1	-7
0007	3F	2_2	156	11	1	1100	270	-830	0.09	0.25	1	0	-1
0007	3F	2_2	234	26	8	2600	4910	2310	0.31	1.89	4	8	4
0007	3F	2_2	235	15	1	1500	490	-1010	0.07	0.33	2	0	-2
0007	3F	2_2	236	28	2	2800	1370	-1430	0.07	0.49	4	2	-2
0007	3F	2_2	245	9	1	900	9900	9000	0.11	11.00	1	17	16
0007	3F	2_2	246	9	0	900	0	-900	0.00	0.00	1	0	-1
0007	3F	2_2	256	9	0	900	0	-900	0.00	0.00	1	0	-1
0007	3F	2_3	123	557	111	55700	44390	-11310	0.20	0.80	98	78	-20
0007	3F	2_3	124	463	86	46300	39490	-6810	0.19	0.85	81	69	-12
0007	3F	2_3	125	309	44	30900	22370	-8530	0.14	0.72	54	39	-15
0007	3F	2_3	126	307	59	30700	36090	5390	0.19	1.18	54	63	9
0007	3F	2_3	134	297	41	29700	24290	-5410	0.14	0.82	52	42	-10
0007	3F	2_3	135	177	25	17700	11890	-5810	0.14	0.67	31	21	-10
0007	3F	2_3	136	200	34	20000	19060	-940	0.17	0.95	35	33	-2
0007	3F	2_3	145	117	13	11700	10380	-1320	0.11	0.89	20	18	-2
0007	3F	2_3	146	99	10	9900	10650	750	0.10	1.08	17	18	1
0007	3F	2_3	156	76	3	7600	2550	-5050	0.04	0.34	13	4	-9
0007	3F	2_3	234	25	2	2500	1280	-1220	0.08	0.51	4	2	-2
0007	3F	2_3	235	17	1	1700	170	-1530	0.06	0.10	3	0	-3
0007	3F	2_3	236	38	7	3800	6940	3140	0.18	1.83	6	12	6
0007	3F	2_3	245	17	3	1700	2330	630	0.18	1.37	3	4	1
0007	3F	2_3	246	17	5	1700	3500	1800	0.29	2.06	3	6	3
0007	3F	2_3	256	17	4	1700	2520	820	0.24	1.48	3	4	1
0007	3F	2_4	123	440	86	44000	35730	-8270	0.20	0.81	77	63	-14
0007	3F	2_4	124	360	60	36000	29540	-6460	0.17	0.82	63	52	-11
0007	3F	2_4	125	196	23	19600	14040	-5560	0.12	0.72	34	24	-10
0007	3F	2_4	126	213	24	21300	14830	-6470	0.11	0.70	37	26	-11
0007	3F	2_4	134	258	26	25800	12590	-13210	0.10	0.49	45	22	-23
0007	3F	2_4	135	151	26	15100	14690	-410	0.17	0.97	26	26	0
0007	3F	2_4	136	136	11	13600	4550	-9050	0.08	0.33	24	8	-16
0007	3F	2_4	145	80	9	8000	7030	-970	0.11	0.88	14	12	-2
0007	3F	2_4	146	88	9	8800	8620	-180	0.10	0.98	15	15	0
0007	3F	2_4	156	43	3	4300	2890	-1410	0.07	0.67	7	5	-2
0007	3F	2_4	234	6	0	600	0	-600	0.00	0.00	1	0	-1
0007	3F	2_4	235	9	2	900	1810	910	0.22	2.01	1	3	2
0007	3F	2_4	236	14	4	1400	4220	2820	0.29	3.01	2	7	5
0007	3F	2_4	245	8	1	800	750	-50	0.13	0.94	1	1	0
0007	3F	2_4	246	5	0	500	0	-500	0.00	0.00	0	0	0
0007	3F	2_4	256	6	0	600	0	-600	0.00	0.00	1	0	-1
0007	3F	2_5	123	119	19	11900	7040	-4860	0.16	0.59	21	12	-9
0007	3F	2_5	124	128	16	12800	9490	-3310	0.13	0.74	22	16	-6
0007	3F	2_5	125	66	11	6600	6830	230	0.17	1.03	11	12	1
0007	3F	2_5	126	47	4	4700	5330	630	0.09	1.13	8	9	1
0007	3F	2_5	134	77	11	7700	7150	-550	0.14	0.93	13	12	-1
0007	3F	2_5	135	22	5	2200	3140	940	0.23	1.43	3	5	2
0007	3F	2_5	136	30	0	3000	0	-3000	0.00	0.00	5	0	-5
0007	3F	2_5	145	21	5	2100	8260	6160	0.24	3.93	3	14	11
0007	3F	2_5	146	24	3	2400	2020	-380	0.13	0.84	4	3	-1
0007	3F	2_5	156	10	0	1000	0	-1000	0.00	0.00	1	0	-1
0007	3F	2_6	123	91	15	9100	6280	-2820	0.16	0.69	16	11	-5
0007	3F	2_6	124	88	13	8800	5950	-2850	0.15	0.68	15	10	-5
0007	3F	2_6	125	51	2	5100	1670	-3430	0.04	0.33	9	2	-7
0007	3F	2_6	126	38	3	3800	5080	1280	0.08	1.34	6	8	2
0007	3F	2_6	134	45	6	4500	4500	0	0.13	1.00	7	7	0
0007	3F	2_6	135	15	3	1500	3700	2200	0.20	2.47	2	6	4
0007	3F	2_6	136	23	0	2300	0	-2300	0.00	0.00	4	0	-4
0007	3F	2_6	145	22	2	2200	3990	1790	0.09	1.81	3	7	4
0007	3F	2_6	146	17	0	1700	0	-1700	0.00	0.00	3	0	-3
0007	3F	2_6	156	1	0	100	0	-100	0.00	0.00	0	0	0
0007	3F	2_6	234	1	0	100	0	-100	0.00	0.00	0	0	0
0007	3F	2_6	246	1	0	100	0	-100	0.00	0.00	0	0	0
0007	3F	3_0	123	94	12	9400	4760	-4640	0.13	0.51	16	8	-8
0007	3F	3_0	124	76	10	7600	4670	-2930	0.13	0.61	13	8	-5
0007	3F	3_0	125	45	5	4500	2490	-2010	0.11	0.55	7	4	-3
0007	3F	3_0	126	29	4	2900	5170	2270	0.14	1.78	5	9	4
0007	3F	3_0	134	58	7	5800	4090	-1710	0.12	0.71	10	7	-3
0007	3F	3_0	135	23	3	2300	3250	950	0.13	1.41	4	5	1
0007	3F	3_0	136	12	1	1200	550	-650	0.08	0.46	2	0	-2
0007	3F	3_0	145	23	1	2300	770	-1530	0.04	0.33	4	1	-3
0007	3F	3_0	146	10	0	1000	0	-1000	0.00	0.00	1	0	-1
0007	3F	3_0	156	8	0	800	0	-800	0.00	0.00	1	0	-1
0007	3F	3_0	234	5	1	500	1740	1240	0.20	3.48	0	3	3
0007	3F	3_0	235	5	1	500	230	-270	0.20	0.46	0	0	0
0007	3F	3_0	236	2	0	200	0	-200	0.00	0.00	0	0	0
0007	3F	3_0	245	3	0	300	0	-300	0.00	0.00	0	0	0
0007	3F	3_0	246	1	0	100	0	-100	0.00	0.00	0	0	0
0007	3F	3_0	256	1	0	100	0	-100	0.00	0.00	0	0	0
0007	3F	3_1	123	253	52	25300	21960	-3340	0.21	0.87	44	38	-6
0007	3F	3_1	124	183	29	18300	15170	-3130	0.16	0.83	32	26	-6
0007	3F	3_1	125	100	10	10000	6880	-3120	0.10	0.69	17	12	-5
0007	3F	3_1	126	75	5	7500	2590	-4910	0.07	0.35	13	4	-9
0007	3F	3_1	134	141	19	14100	13750	-350	0.13	0.98	24	24	0
0007	3F	3_1	135	79	9	7900	6210	-1690	0.11	0.79	13	10	-3
0007	3F	3_1	136	55	5	5500	3530	-1970	0.09	0.64	9	6	-3
0007	3F	3_1	145	55	4	5500	3160	-2340	0.07	0.57	9	5	-4
0007	3F	3_1	146	29	1	2900	910	-1990	0.03	0.31	5	1	-4
0007	3F	3_1	156	20	2	2000	9410	7410	0.10	4.71	3	16	13
0007	3F	3_1	234	8	0	800	0	-800	0.00	0.00	1	0	-1
0007	3F	3_1	235	6	0	600	0	-600	0.00	0.00	1	0	-1
0007	3F	3_1	236	3	0	300	0	-300	0.00	0.00	0	0	0
0007	3F	3_1	245	7	0	700	0	-700	0.00	0.00	1	0	-1
0007	3F	3_1	246	1	0	100	0	-100	0.00	0.00	0	0	0
0007	3F	3_1	256	5	2	500	3800	3300	0.40	7.60	0	6	6
0007	3F	3_2	123	320	62	32000	24040	-7960	0.19	0.75	56	42	-14
0007	3F	3_2	124	245	46	24500	19920	-4580	0.19	0.81	43	35	-8
0007	3F	3_2	125	192	30	19200	15200	-4000	0.16	0.79	33	26	-7
0007	3F	3_2	126	131	11	13100	12180	-920	0.08	0.93	23	21	-2
0007	3F	3_2	134	150	29	15000	12060	-2940	0.19	0.80	26	21	-5
0007	3F	3_2	135	118	10	11800	9070	-2730	0.08	0.77	20	16	-4
0007	3F	3_2	136	70	6	7000	8140	1140	0.09	1.16	12	14	2
0007	3F	3_2	145	71	3	7100	1670	-5430	0.04	0.24	12	2	-10
0007	3F	3_2	146	37	4	3700	3890	190	0.11	1.05	6	6	0
0007	3F	3_2	156	32	1	3200	680	-2520	0.03	0.21	5	1	-4
0007	3F	3_2	234	26	0	2600	0	-2600	0.00	0.00	4	0	-4
0007	3F	3_2	235	23	3	2300	1700	-600	0.13	0.74	4	3	-1
0007	3F	3_2	236	20	0	2000	0	-2000	0.00	0.00	3	0	-3
0007	3F	3_2	245	10	1	1000	450	-550	0.10	0.45	1	0	-1
0007	3F	3_2	246	11	1	1100	790	-310	0.09	0.72	1	1	0
0007	3F	3_2	256	5	0	500	0	-500	0.00	0.00	0	0	0
0007	3F	3_3	123	554	126	55400	65720	10320	0.23	1.19	98	116	18
0007	3F	3_3	124	402	72	40200	27740	-12460	0.18	0.69	71	49	-22
0007	3F	3_3	125	315	43	31500	24110	-7390	0.14	0.77	55	42	-13
0007	3F	3_3	126	249	24	24900	24700	-200	0.10	0.99	44	43	-1
0007	3F	3_3	134	280	38	28000	25180	-2820	0.14	0.90	49	44	-5
0007	3F	3_3	135	201	22	20100	13210	-6890	0.11	0.66	35	23	-12
0007	3F	3_3	136	148	17	14800	11680	-3120	0.11	0.79	26	20	-6
0007	3F	3_3	145	118	12	11800	6700	-5100	0.10	0.57	20	11	-9
0007	3F	3_3	146	79	6	7900	6920	-980	0.08	0.88	13	12	-1
0007	3F	3_3	156	58	7	5800	7980	2180	0.12	1.38	10	14	4
0007	3F	3_3	234	68	7	6800	5050	-1750	0.10	0.74	12	8	-4
0007	3F	3_3	235	46	5	4600	6310	1710	0.11	1.37	8	11	3
0007	3F	3_3	236	39	4	3900	4620	720	0.10	1.18	6	8	2
0007	3F	3_3	245	23	0	2300	0	-2300	0.00	0.00	4	0	-4
0007	3F	3_3	246	40	3	4000	2140	-1860	0.08	0.54	7	3	-4
0007	3F	3_3	256	23	2	2300	3780	1480	0.09	1.64	4	6	2
0007	3F	3_4	123	360	69	36000	30740	-5260	0.19	0.85	63	54	-9
0007	3F	3_4	124	324	46	32400	28400	-4000	0.14	0.88	57	50	-7
0007	3F	3_4	125	231	21	23100	13100	-10000	0.09	0.57	40	23	-17
0007	3F	3_4	126	186	14	18600	11840	-6760	0.08	0.64	32	20	-12
0007	3F	3_4	134	266	36	26600	28720	2120	0.14	1.08	47	50	3
0007	3F	3_4	135	188	22	18800	19340	540	0.12	1.03	33	34	1
0007	3F	3_4	136	136	10	13600	7490	-6110	0.07	0.55	24	13	-11
0007	3F	3_4	145	104	10	10400	6500	-3900	0.10	0.63	18	11	-7
0007	3F	3_4	146	87	3	8700	2580	-6120	0.03	0.30	15	4	-11
0007	3F	3_4	156	58	4	5800	3960	-1840	0.07	0.68	10	7	-3
0007	3F	3_4	234	13	0	1300	0	-1300	0.00	0.00	2	0	-2
0007	3F	3_4	235	16	2	1600	620	-980	0.13	0.39	2	1	-1
0007	3F	3_4	236	14	0	1400	0	-1400	0.00	0.00	2	0	-2
0007	3F	3_4	245	12	1	1200	240	-960	0.08	0.20	2	0	-2
0007	3F	3_4	246	11	1	1100	750	-350	0.09	0.68	1	1	0
0007	3F	3_4	256	9	1	900	400	-500	0.11	0.44	1	0	-1
0007	3F	3_5	123	125	37	12500	14140	1640	0.30	1.13	22	25	3
0007	3F	3_5	124	112	22	11200	9050	-2150	0.20	0.81	19	16	-3
0007	3F	3_5	125	71	5	7100	4070	-3030	0.07	0.57	12	7	-5
0007	3F	3_5	126	61	5	6100	6480	380	0.08	1.06	10	11	1
0007	3F	3_5	134	71	8	7100	3030	-4070	0.11	0.43	12	5	-7
0007	3F	3_5	135	47	6	4700	3770	-930	0.13	0.80	8	6	-2
0007	3F	3_5	136	33	1	3300	580	-2720	0.03	0.18	5	1	-4
0007	3F	3_5	145	41	1	4100	440	-3660	0.02	0.11	7	0	-7
0007	3F	3_5	146	28	3	2800	1690	-1110	0.11	0.60	4	2	-2
0007	3F	3_5	156	13	1	1300	850	-450	0.08	0.65	2	1	-1
0007	3F	3_5	234	1	0	100	0	-100	0.00	0.00	0	0	0
0007	3F	3_5	245	1	0	100	0	-100	0.00	0.00	0	0	0
0007	3F	3_6	123	38	10	3800	4760	960	0.26	1.25	6	8	2
0007	3F	3_6	124	43	6	4300	2560	-1740	0.14	0.60	7	4	-3
0007	3F	3_6	125	18	2	1800	2060	260	0.11	1.14	3	3	0
0007	3F	3_6	126	25	3	2500	2690	190	0.12	1.08	4	4	0
0007	3F	3_6	134	28	5	2800	3340	540	0.18	1.19	4	5	1
0007	3F	3_6	135	14	2	1400	1200	-200	0.14	0.86	2	2	0
0007	3F	3_6	136	22	4	2200	8320	6120	0.18	3.78	3	14	11
0007	3F	3_6	145	14	0	1400	0	-1400	0.00	0.00	2	0	-2
0007	3F	3_6	146	15	0	1500	0	-1500	0.00	0.00	2	0	-2
0007	3F	3_6	156	7	0	700	0	-700	0.00	0.00	1	0	-1
0007	3F	3_6	246	1	0	100	0	-100	0.00	0.00	0	0	0
0007	3F	4_0	123	66	13	6600	5650	-950	0.20	0.86	11	10	-1
0007	3F	4_0	124	32	3	3200	2160	-1040	0.09	0.68	5	3	-2
0007	3F	4_0	125	34	7	3400	4120	720	0.21	1.21	6	7	1
0007	3F	4_0	126	21	1	2100	590	-1510	0.05	0.28	3	1	-2
0007	3F	4_0	134	28	5	2800	3000	200	0.18	1.07	4	5	1
0007	3F	4_0	135	20	0	2000	0	-2000	0.00	0.00	3	0	-3
0007	3F	4_0	136	11	2	1100	2160	1060	0.18	1.96	1	3	2
0007	3F	4_0	145	14	1	1400	570	-830	0.07	0.41	2	1	-1
0007	3F	4_0	146	12	0	1200	0	-1200	0.00	0.00	2	0	-2
0007	3F	4_0	156	8	1	800	4380	3580	0.13	5.48	1	7	6
0007	3F	4_0	234	5	2	500	1560	1060	0.40	3.12	0	2	2
0007	3F	4_0	235	2	0	200	0	-200	0.00	0.00	0	0	0
0007	3F	4_0	245	2	0	200	0	-200	0.00	0.00	0	0	0
0007	3F	4_1	123	252	68	25200	26740	1540	0.27	1.06	44	47	3
0007	3F	4_1	124	157	29	15700	10960	-4740	0.18	0.70	27	19	-8
0007	3F	4_1	125	76	6	7600	2560	-5040	0.08	0.34	13	4	-9
0007	3F	4_1	126	56	6	5600	3620	-1980	0.11	0.65	9	6	-3
0007	3F	4_1	134	97	19	9700	8150	-1550	0.20	0.84	17	14	-3
0007	3F	4_1	135	61	4	6100	2750	-3350	0.07	0.45	10	4	-6
0007	3F	4_1	136	44	8	4400	7330	2930	0.18	1.67	7	12	5
0007	3F	4_1	145	33	6	3300	9050	5750	0.18	2.74	5	16	11
0007	3F	4_1	146	21	2	2100	930	-1170	0.10	0.44	3	1	-2
0007	3F	4_1	156	10	2	1000	1260	260	0.20	1.26	1	2	1
0007	3F	4_1	234	8	0	800	0	-800	0.00	0.00	1	0	-1
0007	3F	4_1	235	8	1	800	510	-290	0.13	0.64	1	0	-1
0007	3F	4_1	236	4	0	400	0	-400	0.00	0.00	0	0	0
0007	3F	4_1	245	5	0	500	0	-500	0.00	0.00	0	0	0
0007	3F	4_1	246	1	0	100	0	-100	0.00	0.00	0	0	0
0007	3F	4_1	256	1	0	100	0	-100	0.00	0.00	0	0	0
0007	3F	4_2	123	334	83	33400	28080	-5320	0.25	0.84	59	49	-10
0007	3F	4_2	124	247	56	24700	17710	-6990	0.23	0.72	43	31	-12
0007	3F	4_2	125	126	26	12600	12000	-600	0.21	0.95	22	21	-1
0007	3F	4_2	126	85	9	8500	6530	-1970	0.11	0.77	15	11	-4
0007	3F	4_2	134	137	25	13700	10700	-3000	0.18	0.78	24	18	-6
0007	3F	4_2	135	73	9	7300	4410	-2890	0.12	0.60	12	7	-5
0007	3F	4_2	136	63	7	6300	4570	-1730	0.11	0.73	11	8	-3
0007	3F	4_2	145	51	5	5100	6220	1120	0.10	1.22	9	11	2
0007	3F	4_2	146	34	5	3400	3510	110	0.15	1.03	6	6	0
0007	3F	4_2	156	10	2	1000	850	-150	0.20	0.85	1	1	0
0007	3F	4_2	234	21	3	2100	680	-1420	0.14	0.32	3	1	-2
0007	3F	4_2	235	12	1	1200	280	-920	0.08	0.23	2	0	-2
0007	3F	4_2	236	8	2	800	690	-110	0.25	0.86	1	1	0
0007	3F	4_2	245	6	0	600	0	-600	0.00	0.00	1	0	-1
0007	3F	4_2	246	10	0	1000	0	-1000	0.00	0.00	1	0	-1
0007	3F	4_2	256	8	0	800	0	-800	0.00	0.00	1	0	-1
0007	3F	4_3	123	519	120	51900	50250	-1650	0.23	0.97	91	88	-3
0007	3F	4_3	124	382	75	38200	28340	-9860	0.20	0.74	67	50	-17
0007	3F	4_3	125	263	48	26300	32040	5740	0.18	1.22	46	56	10
0007	3F	4_3	126	171	24	17100	16840	-260	0.14	0.98	30	29	-1
0007	3F	4_3	134	259	51	25900	16460	-9440	0.20	0.64	45	29	-16
0007	3F	4_3	135	160	29	16000	16490	490	0.18	1.03	28	29	1
0007	3F	4_3	136	126	12	12600	9390	-3210	0.10	0.75	22	16	-6
0007	3F	4_3	145	83	8	8300	6500	-1800	0.10	0.78	14	11	-3
0007	3F	4_3	146	68	6	6800	5010	-1790	0.09	0.74	12	8	-4
0007	3F	4_3	156	38	4	3800	2720	-1080	0.11	0.72	6	4	-2
0007	3F	4_3	234	28	4	2800	2060	-740	0.14	0.74	4	3	-1
0007	3F	4_3	235	33	5	3300	2570	-730	0.15	0.78	5	4	-1
0007	3F	4_3	236	32	6	3200	8140	4940	0.19	2.54	5	14	9
0007	3F	4_3	245	14	1	1400	420	-980	0.07	0.30	2	0	-2
0007	3F	4_3	246	11	2	1100	1270	170	0.18	1.15	1	2	1
0007	3F	4_3	256	7	0	700	0	-700	0.00	0.00	1	0	-1
0007	3F	4_4	123	385	86	38500	31460	-7040	0.22	0.82	68	55	-13
0007	3F	4_4	124	315	49	31500	18670	-12830	0.16	0.59	55	33	-22
0007	3F	4_4	125	211	28	21100	16010	-5090	0.13	0.76	37	28	-9
0007	3F	4_4	126	127	13	12700	11860	-840	0.10	0.93	22	20	-2
0007	3F	4_4	134	192	35	19200	24460	5260	0.18	1.27	33	43	10
0007	3F	4_4	135	112	13	11200	6620	-4580	0.12	0.59	19	11	-8
0007	3F	4_4	136	84	8	8400	7430	-970	0.10	0.88	14	13	-1
0007	3F	4_4	145	84	10	8400	9550	1150	0.12	1.14	14	16	2
0007	3F	4_4	146	54	3	5400	4830	-570	0.06	0.89	9	8	-1
0007	3F	4_4	156	23	0	2300	0	-2300	0.00	0.00	4	0	-4
0007	3F	4_4	234	13	0	1300	0	-1300	0.00	0.00	2	0	-2
0007	3F	4_4	235	3	0	300	0	-300	0.00	0.00	0	0	0
0007	3F	4_4	236	5	1	500	1070	570	0.20	2.14	0	1	1
0007	3F	4_4	245	6	1	600	500	-100	0.17	0.83	1	0	-1
0007	3F	4_4	246	5	0	500	0	-500	0.00	0.00	0	0	0
0007	3F	4_4	256	2	0	200	0	-200	0.00	0.00	0	0	0
0007	3F	4_5	123	172	37	17200	13940	-3260	0.22	0.81	30	24	-6
0007	3F	4_5	124	148	26	14800	9680	-5120	0.18	0.65	26	17	-9
0007	3F	4_5	125	67	6	6700	2730	-3970	0.09	0.41	11	4	-7
0007	3F	4_5	126	42	2	4200	1690	-2510	0.05	0.40	7	2	-5
0007	3F	4_5	134	72	14	7200	6140	-1060	0.19	0.85	12	10	-2
0007	3F	4_5	135	43	5	4300	2970	-1330	0.12	0.69	7	5	-2
0007	3F	4_5	136	34	4	3400	6420	3020	0.12	1.89	6	11	5
0007	3F	4_5	145	21	2	2100	1690	-410	0.10	0.80	3	2	-1
0007	3F	4_5	146	15	0	1500	0	-1500	0.00	0.00	2	0	-2
0007	3F	4_5	156	5	0	500	0	-500	0.00	0.00	0	0	0
0007	3F	4_5	234	2	0	200	0	-200	0.00	0.00	0	0	0
0007	3F	4_6	123	74	16	7400	4950	-2450	0.22	0.67	13	8	-5
0007	3F	4_6	124	56	5	5600	2530	-3070	0.09	0.45	9	4	-5
0007	3F	4_6	125	33	4	3300	3980	680	0.12	1.21	5	7	2
0007	3F	4_6	126	23	0	2300	0	-2300	0.00	0.00	4	0	-4
0007	3F	4_6	134	29	5	2900	2280	-620	0.17	0.79	5	4	-1
0007	3F	4_6	135	12	2	1200	2170	970	0.17	1.81	2	3	1
0007	3F	4_6	136	5	1	500	1600	1100	0.20	3.20	0	2	2
0007	3F	4_6	145	7	0	700	0	-700	0.00	0.00	1	0	-1
0007	3F	4_6	146	2	0	200	0	-200	0.00	0.00	0	0	0
0007	3F	4_6	156	3	0	300	0	-300	0.00	0.00	0	0	0
0007	3F	5_0	123	77	11	7700	4220	-3480	0.14	0.55	13	7	-6
0007	3F	5_0	124	63	8	6300	3580	-2720	0.13	0.57	11	6	-5
0007	3F	5_0	125	33	5	3300	4220	920	0.15	1.28	5	7	2
0007	3F	5_0	126	21	1	2100	500	-1600	0.05	0.24	3	0	-3
0007	3F	5_0	134	42	5	4200	2490	-1710	0.12	0.59	7	4	-3
0007	3F	5_0	135	26	2	2600	1190	-1410	0.08	0.46	4	2	-2
0007	3F	5_0	136	19	1	1900	490	-1410	0.05	0.26	3	0	-3
0007	3F	5_0	145	12	0	1200	0	-1200	0.00	0.00	2	0	-2
0007	3F	5_0	146	8	0	800	0	-800	0.00	0.00	1	0	-1
0007	3F	5_0	156	6	0	600	0	-600	0.00	0.00	1	0	-1
0007	3F	5_0	234	2	0	200	0	-200	0.00	0.00	0	0	0
0007	3F	5_0	235	5	0	500	0	-500	0.00	0.00	0	0	0
0007	3F	5_0	245	2	0	200	0	-200	0.00	0.00	0	0	0
0007	3F	5_0	246	1	0	100	0	-100	0.00	0.00	0	0	0
0007	3F	5_1	123	175	34	17500	11950	-5550	0.19	0.68	30	21	-9
0007	3F	5_1	124	120	21	12000	7970	-4030	0.18	0.66	21	14	-7
0007	3F	5_1	125	86	8	8600	3530	-5070	0.09	0.41	15	6	-9
0007	3F	5_1	126	35	1	3500	680	-2820	0.03	0.19	6	1	-5
0007	3F	5_1	134	87	12	8700	8510	-190	0.14	0.98	15	15	0
0007	3F	5_1	135	50	4	5000	1900	-3100	0.08	0.38	8	3	-5
0007	3F	5_1	136	33	2	3300	4010	710	0.06	1.22	5	7	2
0007	3F	5_1	145	27	1	2700	370	-2330	0.04	0.14	4	0	-4
0007	3F	5_1	146	13	0	1300	0	-1300	0.00	0.00	2	0	-2
0007	3F	5_1	156	3	1	300	620	320	0.33	2.07	0	1	1
0007	3F	5_1	234	3	2	300	650	350	0.67	2.17	0	1	1
0007	3F	5_1	235	9	1	900	970	70	0.11	1.08	1	1	0
0007	3F	5_1	236	1	0	100	0	-100	0.00	0.00	0	0	0
0007	3F	5_1	245	2	0	200	0	-200	0.00	0.00	0	0	0
0007	3F	5_1	246	1	0	100	0	-100	0.00	0.00	0	0	0
0007	3F	5_1	256	2	0	200	0	-200	0.00	0.00	0	0	0
0007	3F	5_2	123	234	51	23400	17970	-5430	0.22	0.77	41	31	-10
0007	3F	5_2	124	189	40	18900	14980	-3920	0.21	0.79	33	26	-7
0007	3F	5_2	125	106	19	10600	8020	-2580	0.18	0.76	18	14	-4
0007	3F	5_2	126	72	6	7200	3140	-4060	0.08	0.44	12	5	-7
0007	3F	5_2	134	119	20	11900	11520	-380	0.17	0.97	21	20	-1
0007	3F	5_2	135	72	6	7200	4820	-2380	0.08	0.67	12	8	-4
0007	3F	5_2	136	46	3	4600	1260	-3340	0.07	0.27	8	2	-6
0007	3F	5_2	145	56	6	5600	2950	-2650	0.11	0.53	9	5	-4
0007	3F	5_2	146	24	5	2400	3000	600	0.21	1.25	4	5	1
0007	3F	5_2	156	11	0	1100	0	-1100	0.00	0.00	1	0	-1
0007	3F	5_2	234	13	0	1300	0	-1300	0.00	0.00	2	0	-2
0007	3F	5_2	235	4	1	400	240	-160	0.25	0.60	0	0	0
0007	3F	5_2	236	2	0	200	0	-200	0.00	0.00	0	0	0
0007	3F	5_2	245	7	0	700	0	-700	0.00	0.00	1	0	-1
0007	3F	5_2	246	2	0	200	0	-200	0.00	0.00	0	0	0
0007	3F	5_2	256	3	0	300	0	-300	0.00	0.00	0	0	0
0007	3F	5_3	123	360	87	36000	38250	2250	0.24	1.06	63	67	4
0007	3F	5_3	124	310	62	31000	25280	-5720	0.20	0.82	54	44	-10
0007	3F	5_3	125	166	22	16600	14580	-2020	0.13	0.88	29	25	-4
0007	3F	5_3	126	133	13	13300	17770	4470	0.10	1.34	23	31	8
0007	3F	5_3	134	215	34	21500	14700	-6800	0.16	0.68	38	26	-12
0007	3F	5_3	135	158	20	15800	10830	-4970	0.13	0.69	27	19	-8
0007	3F	5_3	136	70	6	7000	9610	2610	0.09	1.37	12	17	5
0007	3F	5_3	145	95	10	9500	5200	-4300	0.11	0.55	16	9	-7
0007	3F	5_3	146	49	4	4900	1830	-3070	0.08	0.37	8	3	-5
0007	3F	5_3	156	17	1	1700	1480	-220	0.06	0.87	3	2	-1
0007	3F	5_3	234	14	2	1400	1430	30	0.14	1.02	2	2	0
0007	3F	5_3	235	9	1	900	460	-440	0.11	0.51	1	0	-1
0007	3F	5_3	236	4	0	400	0	-400	0.00	0.00	0	0	0
0007	3F	5_3	245	8	1	800	360	-440	0.13	0.45	1	0	-1
0007	3F	5_3	246	5	0	500	0	-500	0.00	0.00	0	0	0
0007	3F	5_4	123	240	63	24000	22610	-1390	0.26	0.94	42	40	-2
0007	3F	5_4	124	211	41	21100	18300	-2800	0.19	0.87	37	32	-5
0007	3F	5_4	125	119	14	11900	6900	-5000	0.12	0.58	21	12	-9
0007	3F	5_4	126	92	4	9200	5540	-3660	0.04	0.60	16	9	-7
0007	3F	5_4	134	133	17	13300	7380	-5920	0.13	0.55	23	13	-10
0007	3F	5_4	135	96	5	9600	2520	-7080	0.05	0.26	16	4	-12
0007	3F	5_4	136	62	8	6200	6960	760	0.13	1.12	10	12	2
0007	3F	5_4	145	58	7	5800	4310	-1490	0.12	0.74	10	7	-3
0007	3F	5_4	146	39	3	3900	2220	-1680	0.08	0.57	6	3	-3
0007	3F	5_4	156	16	0	1600	0	-1600	0.00	0.00	2	0	-2
0007	3F	5_4	234	4	0	400	0	-400	0.00	0.00	0	0	0
0007	3F	5_4	235	6	0	600	0	-600	0.00	0.00	1	0	-1
0007	3F	5_4	236	4	0	400	0	-400	0.00	0.00	0	0	0
0007	3F	5_4	246	1	0	100	0	-100	0.00	0.00	0	0	0
0007	3F	5_4	256	1	0	100	0	-100	0.00	0.00	0	0	0
0007	3F	5_5	123	169	38	16900	11560	-5340	0.22	0.68	29	20	-9
0007	3F	5_5	124	150	21	15000	7660	-7340	0.14	0.51	26	13	-13
0007	3F	5_5	125	94	10	9400	7330	-2070	0.11	0.78	16	12	-4
0007	3F	5_5	126	57	6	5700	4940	-760	0.11	0.87	10	8	-2
0007	3F	5_5	134	70	11	7000	6520	-480	0.16	0.93	12	11	-1
0007	3F	5_5	135	57	5	5700	6410	710	0.09	1.12	10	11	1
0007	3F	5_5	136	22	0	2200	0	-2200	0.00	0.00	3	0	-3
0007	3F	5_5	145	39	1	3900	580	-3320	0.03	0.15	6	1	-5
0007	3F	5_5	146	16	1	1600	2760	1160	0.06	1.73	2	4	2
0007	3F	5_5	156	12	0	1200	0	-1200	0.00	0.00	2	0	-2
0007	3F	5_5	234	3	0	300	0	-300	0.00	0.00	0	0	0
0007	3F	5_5	235	1	0	100	0	-100	0.00	0.00	0	0	0
0007	3F	5_5	245	2	0	200	0	-200	0.00	0.00	0	0	0
0007	3F	5_6	123	55	16	5500	4810	-690	0.29	0.87	9	8	-1
0007	3F	5_6	124	43	11	4300	4180	-120	0.26	0.97	7	7	0
0007	3F	5_6	125	33	4	3300	3870	570	0.12	1.17	5	6	1
0007	3F	5_6	126	24	1	2400	1960	-440	0.04	0.82	4	3	-1
0007	3F	5_6	134	27	2	2700	1320	-1380	0.07	0.49	4	2	-2
0007	3F	5_6	135	18	1	1800	1480	-320	0.06	0.82	3	2	-1
0007	3F	5_6	136	11	1	1100	1420	320	0.09	1.29	1	2	1
0007	3F	5_6	145	8	1	800	680	-120	0.13	0.85	1	1	0
0007	3F	5_6	146	2	0	200	0	-200	0.00	0.00	0	0	0
0007	3F	5_6	156	4	0	400	0	-400	0.00	0.00	0	0	0
0007	3F	5_6	245	1	0	100	0	-100	0.00	0.00	0	0	0
0007	3F	5_6	246	1	0	100	0	-100	0.00	0.00	0	0	0
0007	3F	6_0	123	12	4	1200	1010	-190	0.33	0.84	2	1	-1
0007	3F	6_0	124	2	1	200	1900	1700	0.50	9.50	0	3	3
0007	3F	6_0	125	3	1	300	970	670	0.33	3.23	0	1	1
0007	3F	6_0	126	1	0	100	0	-100	0.00	0.00	0	0	0
0007	3F	6_0	134	6	0	600	0	-600	0.00	0.00	1	0	-1
0007	3F	6_0	135	1	0	100	0	-100	0.00	0.00	0	0	0
0007	3F	6_0	136	1	0	100	0	-100	0.00	0.00	0	0	0
0007	3F	6_0	145	1	0	100	0	-100	0.00	0.00	0	0	0
0007	3F	6_0	156	2	0	200	0	-200	0.00	0.00	0	0	0
0007	3F	6_0	235	1	0	100	0	-100	0.00	0.00	0	0	0
0007	3F	6_0	236	1	0	100	0	-100	0.00	0.00	0	0	0
0007	3F	6_1	123	15	5	1500	1600	100	0.33	1.07	2	2	0
0007	3F	6_1	124	8	1	800	240	-560	0.13	0.30	1	0	-1
0007	3F	6_1	125	4	0	400	0	-400	0.00	0.00	0	0	0
0007	3F	6_1	126	1	0	100	0	-100	0.00	0.00	0	0	0
0007	3F	6_1	134	7	2	700	630	-70	0.29	0.90	1	1	0
0007	3F	6_1	135	5	0	500	0	-500	0.00	0.00	0	0	0
0007	3F	6_1	136	3	0	300	0	-300	0.00	0.00	0	0	0
0007	3F	6_1	145	2	0	200	0	-200	0.00	0.00	0	0	0
0007	3F	6_1	146	3	0	300	0	-300	0.00	0.00	0	0	0
0007	3F	6_1	156	1	0	100	0	-100	0.00	0.00	0	0	0
0007	3F	6_2	123	16	0	1600	0	-1600	0.00	0.00	2	0	-2
0007	3F	6_2	124	13	4	1300	690	-610	0.31	0.53	2	1	-1
0007	3F	6_2	125	4	0	400	0	-400	0.00	0.00	0	0	0
0007	3F	6_2	126	2	0	200	0	-200	0.00	0.00	0	0	0
0007	3F	6_2	134	6	1	600	140	-460	0.17	0.23	1	0	-1
0007	3F	6_2	135	6	0	600	0	-600	0.00	0.00	1	0	-1
0007	3F	6_2	136	4	1	400	300	-100	0.25	0.75	0	0	0
0007	3F	6_2	145	6	0	600	0	-600	0.00	0.00	1	0	-1
0007	3F	6_2	146	1	0	100	0	-100	0.00	0.00	0	0	0
0007	3F	6_2	156	1	0	100	0	-100	0.00	0.00	0	0	0
0007	3F	6_2	256	1	0	100	0	-100	0.00	0.00	0	0	0
0007	3F	6_3	123	28	4	2800	1710	-1090	0.14	0.61	4	3	-1
0007	3F	6_3	124	19	2	1900	430	-1470	0.11	0.23	3	0	-3
0007	3F	6_3	125	12	1	1200	410	-790	0.08	0.34	2	0	-2
0007	3F	6_3	126	4	4	400	3310	2910	1.00	8.28	0	5	5
0007	3F	6_3	134	17	4	1700	1180	-520	0.24	0.69	3	2	-1
0007	3F	6_3	135	13	1	1300	260	-1040	0.08	0.20	2	0	-2
0007	3F	6_3	136	9	2	900	2460	1560	0.22	2.73	1	4	3
0007	3F	6_3	145	5	1	500	210	-290	0.20	0.42	0	0	0
0007	3F	6_3	146	3	0	300	0	-300	0.00	0.00	0	0	0
0007	3F	6_3	156	4	1	400	250	-150	0.25	0.63	0	0	0
0007	3F	6_3	234	1	1	100	1600	1500	1.00	16.00	0	2	2
0007	3F	6_3	235	2	0	200	0	-200	0.00	0.00	0	0	0
0007	3F	6_3	236	2	1	200	240	40	0.50	1.20	0	0	0
0007	3F	6_3	246	1	0	100	0	-100	0.00	0.00	0	0	0
0007	3F	6_4	123	22	3	2200	980	-1220	0.14	0.45	3	1	-2
0007	3F	6_4	124	27	5	2700	1920	-780	0.19	0.71	4	3	-1
0007	3F	6_4	125	11	4	1100	3460	2360	0.36	3.15	1	6	5
0007	3F	6_4	126	7	0	700	0	-700	0.00	0.00	1	0	-1
0007	3F	6_4	134	13	2	1300	830	-470	0.15	0.64	2	1	-1
0007	3F	6_4	135	6	0	600	0	-600	0.00	0.00	1	0	-1
0007	3F	6_4	136	7	1	700	830	130	0.14	1.19	1	1	0
0007	3F	6_4	145	10	2	1000	700	-300	0.20	0.70	1	1	0
0007	3F	6_4	146	3	0	300	0	-300	0.00	0.00	0	0	0
0007	3F	6_4	156	4	0	400	0	-400	0.00	0.00	0	0	0
0007	3F	6_5	123	15	3	1500	950	-550	0.20	0.63	2	1	-1
0007	3F	6_5	124	9	1	900	500	-400	0.11	0.56	1	0	-1
0007	3F	6_5	125	3	0	300	0	-300	0.00	0.00	0	0	0
0007	3F	6_5	126	5	1	500	710	210	0.20	1.42	0	1	1
0007	3F	6_5	134	8	0	800	0	-800	0.00	0.00	1	0	-1
0007	3F	6_5	135	3	0	300	0	-300	0.00	0.00	0	0	0
0007	3F	6_5	136	3	0	300	0	-300	0.00	0.00	0	0	0
0007	3F	6_5	145	2	0	200	0	-200	0.00	0.00	0	0	0
0007	3F	6_5	156	1	0	100	0	-100	0.00	0.00	0	0	0
0007	3F	6_6	123	6	1	600	240	-360	0.17	0.40	1	0	-1
0007	3F	6_6	124	7	1	700	450	-250	0.14	0.64	1	0	-1
0007	3F	6_6	125	3	1	300	1120	820	0.33	3.73	0	1	1
0007	3F	6_6	126	3	0	300	0	-300	0.00	0.00	0	0	0
0007	3F	6_6	134	4	0	400	0	-400	0.00	0.00	0	0	0
0007	3F	6_6	135	1	0	100	0	-100	0.00	0.00	0	0	0
0007	3F	6_6	136	1	0	100	0	-100	0.00	0.00	0	0	0
0007	3F	7_0	123	155	26	15500	11600	-3900	0.17	0.75	27	20	-7
0007	3F	7_0	124	101	20	10100	10220	120	0.20	1.01	17	18	1
0007	3F	7_0	125	59	7	5900	4070	-1830	0.12	0.69	10	7	-3
0007	3F	7_0	126	41	5	4100	4640	540	0.12	1.13	7	8	1
0007	3F	7_0	134	66	11	6600	7070	470	0.17	1.07	11	12	1
0007	3F	7_0	135	50	8	5000	6110	1110	0.16	1.22	8	10	2
0007	3F	7_0	136	27	1	2700	1120	-1580	0.04	0.41	4	1	-3
0007	3F	7_0	145	16	2	1600	1250	-350	0.13	0.78	2	2	0
0007	3F	7_0	146	8	0	800	0	-800	0.00	0.00	1	0	-1
0007	3F	7_0	156	6	0	600	0	-600	0.00	0.00	1	0	-1
0007	3F	7_0	234	20	1	2000	1980	-20	0.05	0.99	3	3	0
0007	3F	7_0	235	10	0	1000	0	-1000	0.00	0.00	1	0	-1
0007	3F	7_0	236	4	0	400	0	-400	0.00	0.00	0	0	0
0007	3F	7_0	245	4	0	400	0	-400	0.00	0.00	0	0	0
0007	3F	7_0	246	3	0	300	0	-300	0.00	0.00	0	0	0
0007	3F	7_0	256	1	0	100	0	-100	0.00	0.00	0	0	0
0007	3F	7_1	123	441	103	44100	35150	-8950	0.23	0.80	78	62	-16
0007	3F	7_1	124	288	49	28800	21750	-7050	0.17	0.76	50	38	-12
0007	3F	7_1	125	158	18	15800	9580	-6220	0.11	0.61	27	16	-11
0007	3F	7_1	126	74	15	7400	10990	3590	0.20	1.49	13	19	6
0007	3F	7_1	134	175	35	17500	14200	-3300	0.20	0.81	30	25	-5
0007	3F	7_1	135	117	11	11700	6390	-5310	0.09	0.55	20	11	-9
0007	3F	7_1	136	67	9	6700	7810	1110	0.13	1.17	11	13	2
0007	3F	7_1	145	68	4	6800	5280	-1520	0.06	0.78	12	9	-3
0007	3F	7_1	146	33	4	3300	2600	-700	0.12	0.79	5	4	-1
0007	3F	7_1	156	25	2	2500	2180	-320	0.08	0.87	4	3	-1
0007	3F	7_1	234	16	1	1600	460	-1140	0.06	0.29	2	0	-2
0007	3F	7_1	235	9	1	900	1760	860	0.11	1.96	1	3	2
0007	3F	7_1	236	7	2	700	6430	5730	0.29	9.19	1	11	10
0007	3F	7_1	245	4	0	400	0	-400	0.00	0.00	0	0	0
0007	3F	7_1	246	4	0	400	0	-400	0.00	0.00	0	0	0
0007	3F	7_1	256	4	0	400	0	-400	0.00	0.00	0	0	0
0007	3F	7_2	123	556	123	55600	53420	-2180	0.22	0.96	98	94	-4
0007	3F	7_2	124	446	90	44600	36450	-8150	0.20	0.82	78	64	-14
0007	3F	7_2	125	235	30	23500	15720	-7780	0.13	0.67	41	27	-14
0007	3F	7_2	126	137	20	13700	13530	-170	0.15	0.99	24	23	-1
0007	3F	7_2	134	295	51	29500	24740	-4760	0.17	0.84	52	43	-9
0007	3F	7_2	135	137	12	13700	6850	-6850	0.09	0.50	24	12	-12
0007	3F	7_2	136	97	16	9700	10410	710	0.16	1.07	17	18	1
0007	3F	7_2	145	110	13	11000	7540	-3460	0.12	0.69	19	13	-6
0007	3F	7_2	146	65	6	6500	2120	-4380	0.09	0.33	11	3	-8
0007	3F	7_2	156	34	5	3400	4500	1100	0.15	1.32	6	7	1
0007	3F	7_2	234	22	2	2200	1740	-460	0.09	0.79	3	3	0
0007	3F	7_2	235	17	1	1700	190	-1510	0.06	0.11	3	0	-3
0007	3F	7_2	236	10	0	1000	0	-1000	0.00	0.00	1	0	-1
0007	3F	7_2	245	10	0	1000	0	-1000	0.00	0.00	1	0	-1
0007	3F	7_2	246	9	0	900	0	-900	0.00	0.00	1	0	-1
0007	3F	7_2	256	7	0	700	0	-700	0.00	0.00	1	0	-1
0007	3F	7_3	123	517	117	51700	43420	-8280	0.23	0.84	91	76	-15
0007	3F	7_3	124	468	79	46800	31310	-15490	0.17	0.67	82	55	-27
0007	3F	7_3	125	238	35	23800	20190	-3610	0.15	0.85	42	35	-7
0007	3F	7_3	126	203	29	20300	24620	4320	0.14	1.21	35	43	8
0007	3F	7_3	134	277	53	27700	28590	890	0.19	1.03	49	50	1
0007	3F	7_3	135	174	22	17400	11470	-5930	0.13	0.66	30	20	-10
0007	3F	7_3	136	130	18	13000	11420	-1580	0.14	0.88	23	20	-3
0007	3F	7_3	145	102	13	10200	13310	3110	0.13	1.30	18	23	5
0007	3F	7_3	146	77	3	7700	3130	-4570	0.04	0.41	13	5	-8
0007	3F	7_3	156	31	5	3100	4900	1800	0.16	1.58	5	8	3
0007	3F	7_3	234	19	0	1900	0	-1900	0.00	0.00	3	0	-3
0007	3F	7_3	235	15	3	1500	950	-550	0.20	0.63	2	1	-1
0007	3F	7_3	236	8	2	800	1120	320	0.25	1.40	1	1	0
0007	3F	7_3	245	7	0	700	0	-700	0.00	0.00	1	0	-1
0007	3F	7_3	246	6	0	600	0	-600	0.00	0.00	1	0	-1
0007	3F	7_3	256	4	0	400	0	-400	0.00	0.00	0	0	0
0007	3F	7_4	123	266	65	26600	23760	-2840	0.24	0.89	47	42	-5
0007	3F	7_4	124	245	45	24500	20220	-4280	0.18	0.83	43	35	-8
0007	3F	7_4	125	105	17	10500	10460	-40	0.16	1.00	18	18	0
0007	3F	7_4	126	102	9	10200	7570	-2630	0.09	0.74	18	13	-5
0007	3F	7_4	134	127	17	12700	8250	-4450	0.13	0.65	22	14	-8
0007	3F	7_4	135	80	5	8000	3950	-4050	0.06	0.49	14	6	-8
0007	3F	7_4	136	65	7	6500	5340	-1160	0.11	0.82	11	9	-2
0007	3F	7_4	145	67	6	6700	3960	-2740	0.09	0.59	11	7	-4
0007	3F	7_4	146	31	2	3100	2500	-600	0.06	0.81	5	4	-1
0007	3F	7_4	156	16	3	1600	2770	1170	0.19	1.73	2	4	2
0007	3F	7_4	234	7	0	700	0	-700	0.00	0.00	1	0	-1
0007	3F	7_4	235	5	1	500	1010	510	0.20	2.02	0	1	1
0007	3F	7_4	236	4	0	400	0	-400	0.00	0.00	0	0	0
0007	3F	7_4	245	3	0	300	0	-300	0.00	0.00	0	0	0
0007	3F	7_4	246	1	0	100	0	-100	0.00	0.00	0	0	0
0007	3F	7_5	123	188	44	18800	15920	-2880	0.23	0.85	33	28	-5
0007	3F	7_5	124	168	19	16800	7830	-8970	0.11	0.47	29	13	-16
0007	3F	7_5	125	86	11	8600	6920	-1680	0.13	0.80	15	12	-3
0007	3F	7_5	126	79	5	7900	4920	-2980	0.06	0.62	13	8	-5
0007	3F	7_5	134	85	13	8500	10140	1640	0.15	1.19	15	17	2
0007	3F	7_5	135	49	7	4900	7500	2600	0.14	1.53	8	13	5
0007	3F	7_5	136	38	1	3800	1470	-2330	0.03	0.39	6	2	-4
0007	3F	7_5	145	51	6	5100	7180	2080	0.12	1.41	9	12	3
0007	3F	7_5	146	24	0	2400	0	-2400	0.00	0.00	4	0	-4
0007	3F	7_5	156	4	0	400	0	-400	0.00	0.00	0	0	0
0007	3F	7_5	234	2	0	200	0	-200	0.00	0.00	0	0	0
0007	3F	7_6	123	122	33	12200	13700	1500	0.27	1.12	21	24	3
0007	3F	7_6	124	113	23	11300	11010	-290	0.20	0.97	20	19	-1
0007	3F	7_6	125	69	5	6900	4250	-2650	0.07	0.62	12	7	-5
0007	3F	7_6	126	53	2	5300	3650	-1650	0.04	0.69	9	6	-3
0007	3F	7_6	134	50	5	5000	3700	-1300	0.10	0.74	8	6	-2
0007	3F	7_6	135	39	1	3900	830	-3070	0.03	0.21	6	1	-5
0007	3F	7_6	136	33	1	3300	2810	-490	0.03	0.85	5	4	-1
0007	3F	7_6	145	26	1	2600	700	-1900	0.04	0.27	4	1	-3
0007	3F	7_6	146	17	0	1700	0	-1700	0.00	0.00	3	0	-3
0007	3F	7_6	156	7	0	700	0	-700	0.00	0.00	1	0	-1
0007	3F	7_6	234	1	0	100	0	-100	0.00	0.00	0	0	0
0007	3F	7_6	235	1	0	100	0	-100	0.00	0.00	0	0	0
0007	3F	7_6	236	1	0	100	0	-100	0.00	0.00	0	0	0
0007	3T	1_0	123	57	1	5700	590	-5110	0.02	0.10	10	1	-9
0007	3T	1_0	124	52	4	5200	4880	-320	0.08	0.94	9	8	-1
0007	3T	1_0	125	45	1	4500	2570	-1930	0.02	0.57	7	4	-3
0007	3T	1_0	126	21	1	2100	2410	310	0.05	1.15	3	4	1
0007	3T	1_0	132	38	1	3800	720	-3080	0.03	0.19	6	1	-5
0007	3T	1_0	134	51	2	5100	1820	-3280	0.04	0.36	9	3	-6
0007	3T	1_0	135	38	0	3800	0	-3800	0.00	0.00	6	0	-6
0007	3T	1_0	136	19	1	1900	810	-1090	0.05	0.43	3	1	-2
0007	3T	1_0	142	30	3	3000	11460	8460	0.10	3.82	5	20	15
0007	3T	1_0	143	19	1	1900	1690	-210	0.05	0.89	3	2	-1
0007	3T	1_0	145	21	1	2100	1070	-1030	0.05	0.51	3	1	-2
0007	3T	1_0	146	9	0	900	0	-900	0.00	0.00	1	0	-1
0007	3T	1_0	152	8	1	800	1060	260	0.13	1.33	1	1	0
0007	3T	1_0	153	8	0	800	0	-800	0.00	0.00	1	0	-1
0007	3T	1_0	154	2	0	200	0	-200	0.00	0.00	0	0	0
0007	3T	1_0	156	8	0	800	0	-800	0.00	0.00	1	0	-1
0007	3T	1_0	162	2	0	200	0	-200	0.00	0.00	0	0	0
0007	3T	1_0	163	1	0	100	0	-100	0.00	0.00	0	0	0
0007	3T	1_0	164	1	0	100	0	-100	0.00	0.00	0	0	0
0007	3T	1_0	213	8	2	800	5690	4890	0.25	7.11	1	10	9
0007	3T	1_0	214	11	0	1100	0	-1100	0.00	0.00	1	0	-1
0007	3T	1_0	215	5	0	500	0	-500	0.00	0.00	0	0	0
0007	3T	1_0	216	2	0	200	0	-200	0.00	0.00	0	0	0
0007	3T	1_0	231	2	0	200	0	-200	0.00	0.00	0	0	0
0007	3T	1_0	234	4	0	400	0	-400	0.00	0.00	0	0	0
0007	3T	1_0	235	2	0	200	0	-200	0.00	0.00	0	0	0
0007	3T	1_0	241	2	0	200	0	-200	0.00	0.00	0	0	0
0007	3T	1_0	243	5	0	500	0	-500	0.00	0.00	0	0	0
0007	3T	1_0	245	1	0	100	0	-100	0.00	0.00	0	0	0
0007	3T	1_0	246	4	0	400	0	-400	0.00	0.00	0	0	0
0007	3T	1_0	254	1	0	100	0	-100	0.00	0.00	0	0	0
0007	3T	1_1	123	132	7	13200	6210	-6990	0.05	0.47	23	10	-13
0007	3T	1_1	124	142	9	14200	8960	-5240	0.06	0.63	25	15	-10
0007	3T	1_1	125	97	4	9700	5950	-3750	0.04	0.61	17	10	-7
0007	3T	1_1	126	41	0	4100	0	-4100	0.00	0.00	7	0	-7
0007	3T	1_1	132	119	9	11900	9480	-2420	0.08	0.80	21	16	-5
0007	3T	1_1	134	110	6	11000	9790	-1210	0.05	0.89	19	17	-2
0007	3T	1_1	135	77	2	7700	2960	-4740	0.03	0.38	13	5	-8
0007	3T	1_1	136	34	1	3400	790	-2610	0.03	0.23	6	1	-5
0007	3T	1_1	142	66	2	6600	2900	-3700	0.03	0.44	11	5	-6
0007	3T	1_1	143	57	4	5700	5750	50	0.07	1.01	10	10	0
0007	3T	1_1	145	43	0	4300	0	-4300	0.00	0.00	7	0	-7
0007	3T	1_1	146	20	0	2000	0	-2000	0.00	0.00	3	0	-3
0007	3T	1_1	152	21	1	2100	810	-1290	0.05	0.39	3	1	-2
0007	3T	1_1	153	21	0	2100	0	-2100	0.00	0.00	3	0	-3
0007	3T	1_1	154	20	0	2000	0	-2000	0.00	0.00	3	0	-3
0007	3T	1_1	156	10	0	1000	0	-1000	0.00	0.00	1	0	-1
0007	3T	1_1	162	4	0	400	0	-400	0.00	0.00	0	0	0
0007	3T	1_1	163	5	0	500	0	-500	0.00	0.00	0	0	0
0007	3T	1_1	164	3	0	300	0	-300	0.00	0.00	0	0	0
0007	3T	1_1	165	5	0	500	0	-500	0.00	0.00	0	0	0
0007	3T	1_1	213	3	0	300	0	-300	0.00	0.00	0	0	0
0007	3T	1_1	214	7	0	700	0	-700	0.00	0.00	1	0	-1
0007	3T	1_1	215	2	0	200	0	-200	0.00	0.00	0	0	0
0007	3T	1_1	216	4	0	400	0	-400	0.00	0.00	0	0	0
0007	3T	1_1	231	3	0	300	0	-300	0.00	0.00	0	0	0
0007	3T	1_1	234	7	0	700	0	-700	0.00	0.00	1	0	-1
0007	3T	1_1	235	6	0	600	0	-600	0.00	0.00	1	0	-1
0007	3T	1_1	236	1	0	100	0	-100	0.00	0.00	0	0	0
0007	3T	1_1	241	4	0	400	0	-400	0.00	0.00	0	0	0
0007	3T	1_1	243	5	0	500	0	-500	0.00	0.00	0	0	0
0007	3T	1_1	245	8	0	800	0	-800	0.00	0.00	1	0	-1
0007	3T	1_1	251	2	0	200	0	-200	0.00	0.00	0	0	0
0007	3T	1_1	253	2	0	200	0	-200	0.00	0.00	0	0	0
0007	3T	1_1	254	2	0	200	0	-200	0.00	0.00	0	0	0
0007	3T	1_1	261	1	0	100	0	-100	0.00	0.00	0	0	0
0007	3T	1_1	263	1	0	100	0	-100	0.00	0.00	0	0	0
0007	3T	1_2	123	160	10	16000	15870	-130	0.06	0.99	28	28	0
0007	3T	1_2	124	172	10	17200	13550	-3650	0.06	0.79	30	23	-7
0007	3T	1_2	125	98	7	9800	10560	760	0.07	1.08	17	18	1
0007	3T	1_2	126	55	3	5500	7260	1760	0.05	1.32	9	12	3
0007	3T	1_2	132	143	7	14300	10430	-3870	0.05	0.73	25	18	-7
0007	3T	1_2	134	117	5	11700	5410	-6290	0.04	0.46	20	9	-11
0007	3T	1_2	135	71	0	7100	0	-7100	0.00	0.00	12	0	-12
0007	3T	1_2	136	48	0	4800	0	-4800	0.00	0.00	8	0	-8
0007	3T	1_2	142	90	4	9000	6960	-2040	0.04	0.77	15	12	-3
0007	3T	1_2	143	82	4	8200	7400	-800	0.05	0.90	14	13	-1
0007	3T	1_2	145	61	1	6100	1250	-4850	0.02	0.20	10	2	-8
0007	3T	1_2	146	30	3	3000	12340	9340	0.10	4.11	5	21	16
0007	3T	1_2	152	28	1	2800	7410	4610	0.04	2.65	4	13	9
0007	3T	1_2	153	29	1	2900	9290	6390	0.03	3.20	5	16	11
0007	3T	1_2	154	20	0	2000	0	-2000	0.00	0.00	3	0	-3
0007	3T	1_2	156	8	0	800	0	-800	0.00	0.00	1	0	-1
0007	3T	1_2	162	18	0	1800	0	-1800	0.00	0.00	3	0	-3
0007	3T	1_2	163	15	1	1500	1020	-480	0.07	0.68	2	1	-1
0007	3T	1_2	164	7	0	700	0	-700	0.00	0.00	1	0	-1
0007	3T	1_2	165	7	0	700	0	-700	0.00	0.00	1	0	-1
0007	3T	1_2	213	23	0	2300	0	-2300	0.00	0.00	4	0	-4
0007	3T	1_2	214	31	1	3100	1790	-1310	0.03	0.58	5	3	-2
0007	3T	1_2	215	31	0	3100	0	-3100	0.00	0.00	5	0	-5
0007	3T	1_2	216	16	1	1600	1490	-110	0.06	0.93	2	2	0
0007	3T	1_2	231	12	0	1200	0	-1200	0.00	0.00	2	0	-2
0007	3T	1_2	234	16	0	1600	0	-1600	0.00	0.00	2	0	-2
0007	3T	1_2	235	14	0	1400	0	-1400	0.00	0.00	2	0	-2
0007	3T	1_2	236	11	0	1100	0	-1100	0.00	0.00	1	0	-1
0007	3T	1_2	241	7	0	700	0	-700	0.00	0.00	1	0	-1
0007	3T	1_2	243	8	0	800	0	-800	0.00	0.00	1	0	-1
0007	3T	1_2	245	11	0	1100	0	-1100	0.00	0.00	1	0	-1
0007	3T	1_2	246	7	0	700	0	-700	0.00	0.00	1	0	-1
0007	3T	1_2	251	3	0	300	0	-300	0.00	0.00	0	0	0
0007	3T	1_2	253	7	0	700	0	-700	0.00	0.00	1	0	-1
0007	3T	1_2	254	6	0	600	0	-600	0.00	0.00	1	0	-1
0007	3T	1_2	256	4	0	400	0	-400	0.00	0.00	0	0	0
0007	3T	1_2	261	2	0	200	0	-200	0.00	0.00	0	0	0
0007	3T	1_2	263	2	0	200	0	-200	0.00	0.00	0	0	0
0007	3T	1_2	264	3	0	300	0	-300	0.00	0.00	0	0	0
0007	3T	1_2	265	2	0	200	0	-200	0.00	0.00	0	0	0
0007	3T	1_3	123	256	18	25600	19640	-5960	0.07	0.77	45	34	-11
0007	3T	1_3	124	238	19	23800	29370	5570	0.08	1.23	42	51	9
0007	3T	1_3	125	144	6	14400	10910	-3490	0.04	0.76	25	19	-6
0007	3T	1_3	126	185	9	18500	22380	3880	0.05	1.21	32	39	7
0007	3T	1_3	132	170	4	17000	6700	-10300	0.02	0.39	30	11	-19
0007	3T	1_3	134	213	11	21300	9750	-11550	0.05	0.46	37	17	-20
0007	3T	1_3	135	130	8	13000	12210	-790	0.06	0.94	23	21	-2
0007	3T	1_3	136	124	0	12400	0	-12400	0.00	0.00	21	0	-21
0007	3T	1_3	142	126	8	12600	8520	-4080	0.06	0.68	22	15	-7
0007	3T	1_3	143	115	8	11500	15630	4130	0.07	1.36	20	27	7
0007	3T	1_3	145	88	2	8800	3750	-5050	0.02	0.43	15	6	-9
0007	3T	1_3	146	89	3	8900	6970	-1930	0.03	0.78	15	12	-3
0007	3T	1_3	152	34	1	3400	1050	-2350	0.03	0.31	6	1	-5
0007	3T	1_3	153	51	1	5100	2280	-2820	0.02	0.45	9	4	-5
0007	3T	1_3	154	47	1	4700	3520	-1180	0.02	0.75	8	6	-2
0007	3T	1_3	156	40	1	4000	2660	-1340	0.03	0.67	7	4	-3
0007	3T	1_3	162	23	2	2300	1810	-490	0.09	0.79	4	3	-1
0007	3T	1_3	163	39	1	3900	2490	-1410	0.03	0.64	6	4	-2
0007	3T	1_3	164	21	3	2100	20280	18180	0.14	9.66	3	35	32
0007	3T	1_3	165	19	0	1900	0	-1900	0.00	0.00	3	0	-3
0007	3T	1_3	213	66	2	6600	4180	-2420	0.03	0.63	11	7	-4
0007	3T	1_3	214	53	2	5300	6520	1220	0.04	1.23	9	11	2
0007	3T	1_3	215	38	2	3800	3130	-670	0.05	0.82	6	5	-1
0007	3T	1_3	216	53	1	5300	1850	-3450	0.02	0.35	9	3	-6
0007	3T	1_3	231	14	1	1400	5750	4350	0.07	4.11	2	10	8
0007	3T	1_3	234	34	2	3400	5070	1670	0.06	1.49	6	8	2
0007	3T	1_3	235	25	0	2500	0	-2500	0.00	0.00	4	0	-4
0007	3T	1_3	236	13	0	1300	0	-1300	0.00	0.00	2	0	-2
0007	3T	1_3	241	15	1	1500	1110	-390	0.07	0.74	2	1	-1
0007	3T	1_3	243	30	0	3000	0	-3000	0.00	0.00	5	0	-5
0007	3T	1_3	245	20	0	2000	0	-2000	0.00	0.00	3	0	-3
0007	3T	1_3	246	21	0	2100	0	-2100	0.00	0.00	3	0	-3
0007	3T	1_3	251	6	0	600	0	-600	0.00	0.00	1	0	-1
0007	3T	1_3	253	9	0	900	0	-900	0.00	0.00	1	0	-1
0007	3T	1_3	254	6	0	600	0	-600	0.00	0.00	1	0	-1
0007	3T	1_3	256	7	0	700	0	-700	0.00	0.00	1	0	-1
0007	3T	1_3	261	4	0	400	0	-400	0.00	0.00	0	0	0
0007	3T	1_3	263	14	0	1400	0	-1400	0.00	0.00	2	0	-2
0007	3T	1_3	264	4	0	400	0	-400	0.00	0.00	0	0	0
0007	3T	1_3	265	5	0	500	0	-500	0.00	0.00	0	0	0
0007	3T	1_4	123	153	13	15300	15900	600	0.08	1.04	27	28	1
0007	3T	1_4	124	166	11	16600	13040	-3560	0.07	0.79	29	23	-6
0007	3T	1_4	125	119	9	11900	22120	10220	0.08	1.86	21	39	18
0007	3T	1_4	126	116	6	11600	12380	780	0.05	1.07	20	21	1
0007	3T	1_4	132	112	10	11200	16750	5550	0.09	1.50	19	29	10
0007	3T	1_4	134	120	8	12000	8650	-3350	0.07	0.72	21	15	-6
0007	3T	1_4	135	83	4	8300	5550	-2750	0.05	0.67	14	9	-5
0007	3T	1_4	136	97	2	9700	11390	1690	0.02	1.17	17	20	3
0007	3T	1_4	142	70	5	7000	7770	770	0.07	1.11	12	13	1
0007	3T	1_4	143	66	1	6600	3540	-3060	0.02	0.54	11	6	-5
0007	3T	1_4	145	74	4	7400	9480	2080	0.05	1.28	13	16	3
0007	3T	1_4	146	59	2	5900	3800	-2100	0.03	0.64	10	6	-4
0007	3T	1_4	152	18	1	1800	3820	2020	0.06	2.12	3	6	3
0007	3T	1_4	153	19	0	1900	0	-1900	0.00	0.00	3	0	-3
0007	3T	1_4	154	25	0	2500	0	-2500	0.00	0.00	4	0	-4
0007	3T	1_4	156	23	1	2300	1050	-1250	0.04	0.46	4	1	-3
0007	3T	1_4	162	18	0	1800	0	-1800	0.00	0.00	3	0	-3
0007	3T	1_4	163	16	0	1600	0	-1600	0.00	0.00	2	0	-2
0007	3T	1_4	164	13	0	1300	0	-1300	0.00	0.00	2	0	-2
0007	3T	1_4	165	9	0	900	0	-900	0.00	0.00	1	0	-1
0007	3T	1_4	213	17	0	1700	0	-1700	0.00	0.00	3	0	-3
0007	3T	1_4	214	22	2	2200	5110	2910	0.09	2.32	3	9	6
0007	3T	1_4	215	14	0	1400	0	-1400	0.00	0.00	2	0	-2
0007	3T	1_4	216	21	0	2100	0	-2100	0.00	0.00	3	0	-3
0007	3T	1_4	231	1	0	100	0	-100	0.00	0.00	0	0	0
0007	3T	1_4	234	13	1	1300	3590	2290	0.08	2.76	2	6	4
0007	3T	1_4	235	10	1	1000	1140	140	0.10	1.14	1	2	1
0007	3T	1_4	236	10	0	1000	0	-1000	0.00	0.00	1	0	-1
0007	3T	1_4	241	1	0	100	0	-100	0.00	0.00	0	0	0
0007	3T	1_4	243	7	0	700	0	-700	0.00	0.00	1	0	-1
0007	3T	1_4	245	8	1	800	2130	1330	0.13	2.66	1	3	2
0007	3T	1_4	246	5	0	500	0	-500	0.00	0.00	0	0	0
0007	3T	1_4	251	3	0	300	0	-300	0.00	0.00	0	0	0
0007	3T	1_4	253	4	0	400	0	-400	0.00	0.00	0	0	0
0007	3T	1_4	254	5	0	500	0	-500	0.00	0.00	0	0	0
0007	3T	1_4	256	5	1	500	3240	2740	0.20	6.48	0	5	5
0007	3T	1_4	263	1	0	100	0	-100	0.00	0.00	0	0	0
0007	3T	1_4	264	1	0	100	0	-100	0.00	0.00	0	0	0
0007	3T	1_5	123	28	3	2800	2270	-530	0.11	0.81	4	4	0
0007	3T	1_5	124	37	2	3700	5480	1780	0.05	1.48	6	9	3
0007	3T	1_5	125	29	1	2900	1700	-1200	0.03	0.59	5	3	-2
0007	3T	1_5	126	23	0	2300	0	-2300	0.00	0.00	4	0	-4
0007	3T	1_5	132	16	0	1600	0	-1600	0.00	0.00	2	0	-2
0007	3T	1_5	134	26	3	2600	4690	2090	0.12	1.80	4	8	4
0007	3T	1_5	135	16	0	1600	0	-1600	0.00	0.00	2	0	-2
0007	3T	1_5	136	21	0	2100	0	-2100	0.00	0.00	3	0	-3
0007	3T	1_5	142	14	0	1400	0	-1400	0.00	0.00	2	0	-2
0007	3T	1_5	143	13	1	1300	800	-500	0.08	0.62	2	1	-1
0007	3T	1_5	145	13	0	1300	0	-1300	0.00	0.00	2	0	-2
0007	3T	1_5	146	15	0	1500	0	-1500	0.00	0.00	2	0	-2
0007	3T	1_5	152	5	0	500	0	-500	0.00	0.00	0	0	0
0007	3T	1_5	153	4	0	400	0	-400	0.00	0.00	0	0	0
0007	3T	1_5	154	10	0	1000	0	-1000	0.00	0.00	1	0	-1
0007	3T	1_5	156	1	0	100	0	-100	0.00	0.00	0	0	0
0007	3T	1_5	162	2	0	200	0	-200	0.00	0.00	0	0	0
0007	3T	1_5	163	2	0	200	0	-200	0.00	0.00	0	0	0
0007	3T	1_5	164	1	0	100	0	-100	0.00	0.00	0	0	0
0007	3T	1_5	213	2	0	200	0	-200	0.00	0.00	0	0	0
0007	3T	1_5	214	1	0	100	0	-100	0.00	0.00	0	0	0
0007	3T	1_5	215	2	0	200	0	-200	0.00	0.00	0	0	0
0007	3T	1_5	216	1	0	100	0	-100	0.00	0.00	0	0	0
0007	3T	1_5	234	2	0	200	0	-200	0.00	0.00	0	0	0
0007	3T	1_5	235	2	0	200	0	-200	0.00	0.00	0	0	0
0007	3T	1_5	236	1	0	100	0	-100	0.00	0.00	0	0	0
0007	3T	1_5	243	2	0	200	0	-200	0.00	0.00	0	0	0
0007	3T	1_5	245	1	0	100	0	-100	0.00	0.00	0	0	0
0007	3T	1_5	246	1	0	100	0	-100	0.00	0.00	0	0	0
0007	3T	1_5	264	1	0	100	0	-100	0.00	0.00	0	0	0
0007	3T	1_6	123	106	11	10600	8320	-2280	0.10	0.78	18	14	-4
0007	3T	1_6	124	95	7	9500	6280	-3220	0.07	0.66	16	11	-5
0007	3T	1_6	125	83	4	8300	7820	-480	0.05	0.94	14	13	-1
0007	3T	1_6	126	99	3	9900	6810	-3090	0.03	0.69	17	12	-5
0007	3T	1_6	132	59	3	5900	3090	-2810	0.05	0.52	10	5	-5
0007	3T	1_6	134	70	3	7000	3530	-3470	0.04	0.50	12	6	-6
0007	3T	1_6	135	68	1	6800	2170	-4630	0.01	0.32	12	3	-9
0007	3T	1_6	136	73	4	7300	11740	4440	0.05	1.61	12	20	8
0007	3T	1_6	142	32	1	3200	1540	-1660	0.03	0.48	5	2	-3
0007	3T	1_6	143	49	3	4900	3440	-1460	0.06	0.70	8	6	-2
0007	3T	1_6	145	40	2	4000	6140	2140	0.05	1.54	7	10	3
0007	3T	1_6	146	30	0	3000	0	-3000	0.00	0.00	5	0	-5
0007	3T	1_6	152	18	0	1800	0	-1800	0.00	0.00	3	0	-3
0007	3T	1_6	153	16	0	1600	0	-1600	0.00	0.00	2	0	-2
0007	3T	1_6	154	22	0	2200	0	-2200	0.00	0.00	3	0	-3
0007	3T	1_6	156	22	3	2200	11410	9210	0.14	5.19	3	20	17
0007	3T	1_6	162	2	0	200	0	-200	0.00	0.00	0	0	0
0007	3T	1_6	163	3	0	300	0	-300	0.00	0.00	0	0	0
0007	3T	1_6	164	6	0	600	0	-600	0.00	0.00	1	0	-1
0007	3T	1_6	165	4	0	400	0	-400	0.00	0.00	0	0	0
0007	3T	1_6	213	2	0	200	0	-200	0.00	0.00	0	0	0
0007	3T	1_6	214	5	0	500	0	-500	0.00	0.00	0	0	0
0007	3T	1_6	215	4	0	400	0	-400	0.00	0.00	0	0	0
0007	3T	1_6	216	2	0	200	0	-200	0.00	0.00	0	0	0
0007	3T	1_6	231	1	0	100	0	-100	0.00	0.00	0	0	0
0007	3T	1_6	234	1	0	100	0	-100	0.00	0.00	0	0	0
0007	3T	1_6	236	4	0	400	0	-400	0.00	0.00	0	0	0
0007	3T	1_6	246	2	0	200	0	-200	0.00	0.00	0	0	0
0007	3T	1_6	253	1	0	100	0	-100	0.00	0.00	0	0	0
0007	3T	1_6	254	1	0	100	0	-100	0.00	0.00	0	0	0
0007	3T	1_6	256	1	0	100	0	-100	0.00	0.00	0	0	0
0007	3T	1_6	264	1	0	100	0	-100	0.00	0.00	0	0	0
0007	3T	2_0	123	52	7	5200	8680	3480	0.13	1.67	9	15	6
0007	3T	2_0	124	27	4	2700	4990	2290	0.15	1.85	4	8	4
0007	3T	2_0	125	21	1	2100	2430	330	0.05	1.16	3	4	1
0007	3T	2_0	126	18	0	1800	0	-1800	0.00	0.00	3	0	-3
0007	3T	2_0	132	34	1	3400	790	-2610	0.03	0.23	6	1	-5
0007	3T	2_0	134	32	2	3200	4080	880	0.06	1.28	5	7	2
0007	3T	2_0	135	13	0	1300	0	-1300	0.00	0.00	2	0	-2
0007	3T	2_0	136	18	1	1800	2060	260	0.06	1.14	3	3	0
0007	3T	2_0	142	13	0	1300	0	-1300	0.00	0.00	2	0	-2
0007	3T	2_0	143	11	1	1100	750	-350	0.09	0.68	1	1	0
0007	3T	2_0	145	6	0	600	0	-600	0.00	0.00	1	0	-1
0007	3T	2_0	146	4	0	400	0	-400	0.00	0.00	0	0	0
0007	3T	2_0	152	8	0	800	0	-800	0.00	0.00	1	0	-1
0007	3T	2_0	153	11	1	1100	1360	260	0.09	1.24	1	2	1
0007	3T	2_0	154	6	1	600	1850	1250	0.17	3.08	1	3	2
0007	3T	2_0	156	5	0	500	0	-500	0.00	0.00	0	0	0
0007	3T	2_0	162	10	0	1000	0	-1000	0.00	0.00	1	0	-1
0007	3T	2_0	163	8	0	800	0	-800	0.00	0.00	1	0	-1
0007	3T	2_0	165	3	0	300	0	-300	0.00	0.00	0	0	0
0007	3T	2_0	213	4	0	400	0	-400	0.00	0.00	0	0	0
0007	3T	2_0	214	4	0	400	0	-400	0.00	0.00	0	0	0
0007	3T	2_0	215	4	0	400	0	-400	0.00	0.00	0	0	0
0007	3T	2_0	216	5	0	500	0	-500	0.00	0.00	0	0	0
0007	3T	2_0	231	1	0	100	0	-100	0.00	0.00	0	0	0
0007	3T	2_0	234	5	0	500	0	-500	0.00	0.00	0	0	0
0007	3T	2_0	235	3	0	300	0	-300	0.00	0.00	0	0	0
0007	3T	2_0	236	3	0	300	0	-300	0.00	0.00	0	0	0
0007	3T	2_0	241	2	0	200	0	-200	0.00	0.00	0	0	0
0007	3T	2_0	243	2	0	200	0	-200	0.00	0.00	0	0	0
0007	3T	2_0	245	1	0	100	0	-100	0.00	0.00	0	0	0
0007	3T	2_0	246	2	0	200	0	-200	0.00	0.00	0	0	0
0007	3T	2_0	251	3	0	300	0	-300	0.00	0.00	0	0	0
0007	3T	2_0	254	1	0	100	0	-100	0.00	0.00	0	0	0
0007	3T	2_0	261	2	0	200	0	-200	0.00	0.00	0	0	0
0007	3T	2_0	263	1	0	100	0	-100	0.00	0.00	0	0	0
0007	3T	2_1	123	139	18	13900	18410	4510	0.13	1.32	24	32	8
0007	3T	2_1	124	101	14	10100	12270	2170	0.14	1.21	17	21	4
0007	3T	2_1	125	71	8	7100	13660	6560	0.11	1.92	12	24	12
0007	3T	2_1	126	47	7	4700	10680	5980	0.15	2.27	8	18	10
0007	3T	2_1	132	81	5	8100	3920	-4180	0.06	0.48	14	6	-8
0007	3T	2_1	134	64	5	6400	4010	-2390	0.08	0.63	11	7	-4
0007	3T	2_1	135	49	2	4900	2270	-2630	0.04	0.46	8	4	-4
0007	3T	2_1	136	40	0	4000	0	-4000	0.00	0.00	7	0	-7
0007	3T	2_1	142	47	2	4700	1420	-3280	0.04	0.30	8	2	-6
0007	3T	2_1	143	58	4	5800	3980	-1820	0.07	0.69	10	7	-3
0007	3T	2_1	145	37	1	3700	600	-3100	0.03	0.16	6	1	-5
0007	3T	2_1	146	25	1	2500	3570	1070	0.04	1.43	4	6	2
0007	3T	2_1	152	19	3	1900	2790	890	0.16	1.47	3	4	1
0007	3T	2_1	153	26	2	2600	2120	-480	0.08	0.82	4	3	-1
0007	3T	2_1	154	15	0	1500	0	-1500	0.00	0.00	2	0	-2
0007	3T	2_1	156	8	0	800	0	-800	0.00	0.00	1	0	-1
0007	3T	2_1	162	18	0	1800	0	-1800	0.00	0.00	3	0	-3
0007	3T	2_1	163	10	0	1000	0	-1000	0.00	0.00	1	0	-1
0007	3T	2_1	164	12	0	1200	0	-1200	0.00	0.00	2	0	-2
0007	3T	2_1	165	3	0	300	0	-300	0.00	0.00	0	0	0
0007	3T	2_1	213	5	0	500	0	-500	0.00	0.00	0	0	0
0007	3T	2_1	214	8	1	800	1000	200	0.13	1.25	1	1	0
0007	3T	2_1	215	4	0	400	0	-400	0.00	0.00	0	0	0
0007	3T	2_1	216	5	0	500	0	-500	0.00	0.00	0	0	0
0007	3T	2_1	231	4	1	400	2050	1650	0.25	5.13	0	3	3
0007	3T	2_1	234	3	0	300	0	-300	0.00	0.00	0	0	0
0007	3T	2_1	235	2	0	200	0	-200	0.00	0.00	0	0	0
0007	3T	2_1	236	1	0	100	0	-100	0.00	0.00	0	0	0
0007	3T	2_1	241	3	0	300	0	-300	0.00	0.00	0	0	0
0007	3T	2_1	243	1	0	100	0	-100	0.00	0.00	0	0	0
0007	3T	2_1	245	6	0	600	0	-600	0.00	0.00	1	0	-1
0007	3T	2_1	246	1	0	100	0	-100	0.00	0.00	0	0	0
0007	3T	2_1	251	2	0	200	0	-200	0.00	0.00	0	0	0
0007	3T	2_1	254	2	0	200	0	-200	0.00	0.00	0	0	0
0007	3T	2_1	256	3	0	300	0	-300	0.00	0.00	0	0	0
0007	3T	2_1	263	1	0	100	0	-100	0.00	0.00	0	0	0
0007	3T	2_1	264	1	0	100	0	-100	0.00	0.00	0	0	0
0007	3T	2_2	123	175	15	17500	17030	-470	0.09	0.97	30	30	0
0007	3T	2_2	124	184	12	18400	7570	-10830	0.07	0.41	32	13	-19
0007	3T	2_2	125	106	7	10600	6750	-3850	0.07	0.64	18	11	-7
0007	3T	2_2	126	104	6	10400	6590	-3810	0.06	0.63	18	11	-7
0007	3T	2_2	132	106	7	10600	6000	-4600	0.07	0.57	18	10	-8
0007	3T	2_2	134	95	6	9500	4470	-5030	0.06	0.47	16	7	-9
0007	3T	2_2	135	53	6	5300	8230	2930	0.11	1.55	9	14	5
0007	3T	2_2	136	58	4	5800	2860	-2940	0.07	0.49	10	5	-5
0007	3T	2_2	142	96	6	9600	6960	-2640	0.06	0.73	16	12	-4
0007	3T	2_2	143	63	2	6300	3600	-2700	0.03	0.57	11	6	-5
0007	3T	2_2	145	45	1	4500	1240	-3260	0.02	0.28	7	2	-5
0007	3T	2_2	146	35	0	3500	0	-3500	0.00	0.00	6	0	-6
0007	3T	2_2	152	19	1	1900	1190	-710	0.05	0.63	3	2	-1
0007	3T	2_2	153	20	3	2000	2390	390	0.15	1.20	3	4	1
0007	3T	2_2	154	24	2	2400	2200	-200	0.08	0.92	4	3	-1
0007	3T	2_2	156	5	0	500	0	-500	0.00	0.00	0	0	0
0007	3T	2_2	162	18	0	1800	0	-1800	0.00	0.00	3	0	-3
0007	3T	2_2	163	19	0	1900	0	-1900	0.00	0.00	3	0	-3
0007	3T	2_2	164	13	0	1300	0	-1300	0.00	0.00	2	0	-2
0007	3T	2_2	165	6	0	600	0	-600	0.00	0.00	1	0	-1
0007	3T	2_2	213	31	3	3100	9930	6830	0.10	3.20	5	17	12
0007	3T	2_2	214	15	2	1500	4500	3000	0.13	3.00	2	7	5
0007	3T	2_2	215	10	0	1000	0	-1000	0.00	0.00	1	0	-1
0007	3T	2_2	216	25	0	2500	0	-2500	0.00	0.00	4	0	-4
0007	3T	2_2	231	5	0	500	0	-500	0.00	0.00	0	0	0
0007	3T	2_2	234	17	1	1700	1830	130	0.06	1.08	3	3	0
0007	3T	2_2	235	10	0	1000	0	-1000	0.00	0.00	1	0	-1
0007	3T	2_2	236	20	0	2000	0	-2000	0.00	0.00	3	0	-3
0007	3T	2_2	241	6	0	600	0	-600	0.00	0.00	1	0	-1
0007	3T	2_2	243	9	3	900	6550	5650	0.33	7.28	1	11	10
0007	3T	2_2	245	7	1	700	72950	72250	0.14	104.21	1	129	128
0007	3T	2_2	246	5	0	500	0	-500	0.00	0.00	0	0	0
0007	3T	2_2	251	2	0	200	0	-200	0.00	0.00	0	0	0
0007	3T	2_2	253	5	0	500	0	-500	0.00	0.00	0	0	0
0007	3T	2_2	254	2	0	200	0	-200	0.00	0.00	0	0	0
0007	3T	2_2	256	7	0	700	0	-700	0.00	0.00	1	0	-1
0007	3T	2_2	261	8	0	800	0	-800	0.00	0.00	1	0	-1
0007	3T	2_2	263	8	0	800	0	-800	0.00	0.00	1	0	-1
0007	3T	2_2	264	4	0	400	0	-400	0.00	0.00	0	0	0
0007	3T	2_2	265	2	0	200	0	-200	0.00	0.00	0	0	0
0007	3T	2_3	123	324	31	32400	28440	-3960	0.10	0.88	57	50	-7
0007	3T	2_3	124	308	24	30800	39980	9180	0.08	1.30	54	70	16
0007	3T	2_3	125	216	12	21600	18620	-2980	0.06	0.86	38	32	-6
0007	3T	2_3	126	201	14	20100	14360	-5740	0.07	0.71	35	25	-10
0007	3T	2_3	132	169	11	16900	13060	-3840	0.07	0.77	29	23	-6
0007	3T	2_3	134	201	11	20100	20560	460	0.05	1.02	35	36	1
0007	3T	2_3	135	124	4	12400	3910	-8490	0.03	0.32	21	6	-15
0007	3T	2_3	136	151	11	15100	16830	1730	0.07	1.11	26	29	3
0007	3T	2_3	142	112	4	11200	3790	-7410	0.04	0.34	19	6	-13
0007	3T	2_3	143	96	3	9600	30150	20550	0.03	3.14	16	53	37
0007	3T	2_3	145	89	3	8900	2360	-6540	0.03	0.27	15	4	-11
0007	3T	2_3	146	72	3	7200	9850	2650	0.04	1.37	12	17	5
0007	3T	2_3	152	58	2	5800	7550	1750	0.03	1.30	10	13	3
0007	3T	2_3	153	53	5	5300	7600	2300	0.09	1.43	9	13	4
0007	3T	2_3	154	28	0	2800	0	-2800	0.00	0.00	4	0	-4
0007	3T	2_3	156	48	0	4800	0	-4800	0.00	0.00	8	0	-8
0007	3T	2_3	162	48	5	4800	11530	6730	0.10	2.40	8	20	12
0007	3T	2_3	163	49	2	4900	6530	1630	0.04	1.33	8	11	3
0007	3T	2_3	164	27	0	2700	0	-2700	0.00	0.00	4	0	-4
0007	3T	2_3	165	28	0	2800	0	-2800	0.00	0.00	4	0	-4
0007	3T	2_3	213	46	4	4600	5440	840	0.09	1.18	8	9	1
0007	3T	2_3	214	34	1	3400	1570	-1830	0.03	0.46	6	2	-4
0007	3T	2_3	215	30	1	3000	1890	-1110	0.03	0.63	5	3	-2
0007	3T	2_3	216	48	5	4800	7670	2870	0.10	1.60	8	13	5
0007	3T	2_3	231	18	0	1800	0	-1800	0.00	0.00	3	0	-3
0007	3T	2_3	234	11	0	1100	0	-1100	0.00	0.00	1	0	-1
0007	3T	2_3	235	12	0	1200	0	-1200	0.00	0.00	2	0	-2
0007	3T	2_3	236	30	0	3000	0	-3000	0.00	0.00	5	0	-5
0007	3T	2_3	241	9	0	900	0	-900	0.00	0.00	1	0	-1
0007	3T	2_3	243	14	0	1400	0	-1400	0.00	0.00	2	0	-2
0007	3T	2_3	245	6	0	600	0	-600	0.00	0.00	1	0	-1
0007	3T	2_3	246	9	0	900	0	-900	0.00	0.00	1	0	-1
0007	3T	2_3	251	5	0	500	0	-500	0.00	0.00	0	0	0
0007	3T	2_3	253	5	0	500	0	-500	0.00	0.00	0	0	0
0007	3T	2_3	254	11	0	1100	0	-1100	0.00	0.00	1	0	-1
0007	3T	2_3	256	11	0	1100	0	-1100	0.00	0.00	1	0	-1
0007	3T	2_3	261	10	1	1000	5250	4250	0.10	5.25	1	9	8
0007	3T	2_3	263	8	0	800	0	-800	0.00	0.00	1	0	-1
0007	3T	2_3	264	8	1	800	2820	2020	0.13	3.53	1	4	3
0007	3T	2_3	265	6	0	600	0	-600	0.00	0.00	1	0	-1
0007	3T	2_4	123	283	24	28300	20970	-7330	0.08	0.74	50	37	-13
0007	3T	2_4	124	266	27	26600	37670	11070	0.10	1.42	47	66	19
0007	3T	2_4	125	169	9	16900	16040	-860	0.05	0.95	29	28	-1
0007	3T	2_4	126	172	12	17200	16920	-280	0.07	0.98	30	29	-1
0007	3T	2_4	132	139	9	13900	12970	-930	0.06	0.93	24	22	-2
0007	3T	2_4	134	159	7	15900	6890	-9010	0.04	0.43	28	12	-16
0007	3T	2_4	135	113	5	11300	3360	-7940	0.04	0.30	20	5	-15
0007	3T	2_4	136	119	2	11900	1690	-10210	0.02	0.14	21	2	-19
0007	3T	2_4	142	83	1	8300	800	-7500	0.01	0.10	14	1	-13
0007	3T	2_4	143	99	4	9900	8060	-1840	0.04	0.81	17	14	-3
0007	3T	2_4	145	60	3	6000	2930	-3070	0.05	0.49	10	5	-5
0007	3T	2_4	146	78	2	7800	2800	-5000	0.03	0.36	13	4	-9
0007	3T	2_4	152	23	2	2300	1410	-890	0.09	0.61	4	2	-2
0007	3T	2_4	153	38	2	3800	8090	4290	0.05	2.13	6	14	8
0007	3T	2_4	154	20	1	2000	2260	260	0.05	1.13	3	4	1
0007	3T	2_4	156	35	0	3500	0	-3500	0.00	0.00	6	0	-6
0007	3T	2_4	162	27	0	2700	0	-2700	0.00	0.00	4	0	-4
0007	3T	2_4	163	17	2	1700	1480	-220	0.12	0.87	3	2	-1
0007	3T	2_4	164	10	0	1000	0	-1000	0.00	0.00	1	0	-1
0007	3T	2_4	165	8	0	800	0	-800	0.00	0.00	1	0	-1
0007	3T	2_4	213	16	1	1600	1370	-230	0.06	0.86	2	2	0
0007	3T	2_4	214	11	1	1100	1120	20	0.09	1.02	1	1	0
0007	3T	2_4	215	4	0	400	0	-400	0.00	0.00	0	0	0
0007	3T	2_4	216	13	2	1300	4770	3470	0.15	3.67	2	8	6
0007	3T	2_4	231	2	0	200	0	-200	0.00	0.00	0	0	0
0007	3T	2_4	234	3	0	300	0	-300	0.00	0.00	0	0	0
0007	3T	2_4	235	6	0	600	0	-600	0.00	0.00	1	0	-1
0007	3T	2_4	236	7	0	700	0	-700	0.00	0.00	1	0	-1
0007	3T	2_4	243	3	0	300	0	-300	0.00	0.00	0	0	0
0007	3T	2_4	245	4	0	400	0	-400	0.00	0.00	0	0	0
0007	3T	2_4	246	5	0	500	0	-500	0.00	0.00	0	0	0
0007	3T	2_4	253	3	1	300	2730	2430	0.33	9.10	0	4	4
0007	3T	2_4	254	4	1	400	3180	2780	0.25	7.95	0	5	5
0007	3T	2_4	256	2	0	200	0	-200	0.00	0.00	0	0	0
0007	3T	2_4	261	1	0	100	0	-100	0.00	0.00	0	0	0
0007	3T	2_4	263	7	2	700	9350	8650	0.29	13.36	1	16	15
0007	3T	2_4	265	4	0	400	0	-400	0.00	0.00	0	0	0
0007	3T	2_5	123	86	10	8600	8270	-330	0.12	0.96	15	14	-1
0007	3T	2_5	124	104	6	10400	10690	290	0.06	1.03	18	18	0
0007	3T	2_5	125	58	4	5800	4040	-1760	0.07	0.70	10	7	-3
0007	3T	2_5	126	44	2	4400	4100	-300	0.05	0.93	7	7	0
0007	3T	2_5	132	32	1	3200	1170	-2030	0.03	0.37	5	2	-3
0007	3T	2_5	134	50	4	5000	3040	-1960	0.08	0.61	8	5	-3
0007	3T	2_5	135	16	0	1600	0	-1600	0.00	0.00	2	0	-2
0007	3T	2_5	136	30	0	3000	0	-3000	0.00	0.00	5	0	-5
0007	3T	2_5	142	24	3	2400	2330	-70	0.13	0.97	4	4	0
0007	3T	2_5	143	27	1	2700	780	-1920	0.04	0.29	4	1	-3
0007	3T	2_5	145	16	0	1600	0	-1600	0.00	0.00	2	0	-2
0007	3T	2_5	146	23	3	2300	4050	1750	0.13	1.76	4	7	3
0007	3T	2_5	152	7	1	700	2080	1380	0.14	2.97	1	3	2
0007	3T	2_5	153	6	2	600	5300	4700	0.33	8.83	1	9	8
0007	3T	2_5	154	5	1	500	10140	9640	0.20	20.28	0	17	17
0007	3T	2_5	156	7	0	700	0	-700	0.00	0.00	1	0	-1
0007	3T	2_5	162	1	0	100	0	-100	0.00	0.00	0	0	0
0007	3T	2_5	164	1	0	100	0	-100	0.00	0.00	0	0	0
0007	3T	2_5	165	3	0	300	0	-300	0.00	0.00	0	0	0
0007	3T	2_5	213	1	0	100	0	-100	0.00	0.00	0	0	0
0007	3T	2_5	215	1	1	100	1920	1820	1.00	19.20	0	3	3
0007	3T	2_5	216	2	0	200	0	-200	0.00	0.00	0	0	0
0007	3T	2_6	123	75	3	7500	1900	-5600	0.04	0.25	13	3	-10
0007	3T	2_6	124	61	4	6100	3440	-2660	0.07	0.56	10	6	-4
0007	3T	2_6	125	46	2	4600	3270	-1330	0.04	0.71	8	5	-3
0007	3T	2_6	126	36	3	3600	10140	6540	0.08	2.82	6	17	11
0007	3T	2_6	132	16	2	1600	2200	600	0.13	1.38	2	3	1
0007	3T	2_6	134	28	3	2800	3420	620	0.11	1.22	4	6	2
0007	3T	2_6	135	10	1	1000	1400	400	0.10	1.40	1	2	1
0007	3T	2_6	136	22	0	2200	0	-2200	0.00	0.00	3	0	-3
0007	3T	2_6	142	26	0	2600	0	-2600	0.00	0.00	4	0	-4
0007	3T	2_6	143	17	1	1700	5520	3820	0.06	3.25	3	9	6
0007	3T	2_6	145	16	0	1600	0	-1600	0.00	0.00	2	0	-2
0007	3T	2_6	146	14	0	1400	0	-1400	0.00	0.00	2	0	-2
0007	3T	2_6	152	5	0	500	0	-500	0.00	0.00	0	0	0
0007	3T	2_6	153	5	0	500	0	-500	0.00	0.00	0	0	0
0007	3T	2_6	154	6	0	600	0	-600	0.00	0.00	1	0	-1
0007	3T	2_6	156	1	0	100	0	-100	0.00	0.00	0	0	0
0007	3T	2_6	162	2	0	200	0	-200	0.00	0.00	0	0	0
0007	3T	2_6	163	1	0	100	0	-100	0.00	0.00	0	0	0
0007	3T	2_6	164	3	0	300	0	-300	0.00	0.00	0	0	0
0007	3T	2_6	214	1	0	100	0	-100	0.00	0.00	0	0	0
0007	3T	2_6	243	1	0	100	0	-100	0.00	0.00	0	0	0
0007	3T	2_6	246	1	0	100	0	-100	0.00	0.00	0	0	0
0007	3T	3_0	123	42	3	4200	2750	-1450	0.07	0.65	7	4	-3
0007	3T	3_0	124	46	3	4600	2630	-1970	0.07	0.57	8	4	-4
0007	3T	3_0	125	32	0	3200	0	-3200	0.00	0.00	5	0	-5
0007	3T	3_0	126	21	2	2100	4430	2330	0.10	2.11	3	7	4
0007	3T	3_0	132	45	2	4500	2040	-2460	0.04	0.45	7	3	-4
0007	3T	3_0	134	35	2	3500	1610	-1890	0.06	0.46	6	2	-4
0007	3T	3_0	135	18	1	1800	6440	4640	0.06	3.58	3	11	8
0007	3T	3_0	136	11	0	1100	0	-1100	0.00	0.00	1	0	-1
0007	3T	3_0	142	25	1	2500	920	-1580	0.04	0.37	4	1	-3
0007	3T	3_0	143	23	0	2300	0	-2300	0.00	0.00	4	0	-4
0007	3T	3_0	145	15	0	1500	0	-1500	0.00	0.00	2	0	-2
0007	3T	3_0	146	6	0	600	0	-600	0.00	0.00	1	0	-1
0007	3T	3_0	152	9	0	900	0	-900	0.00	0.00	1	0	-1
0007	3T	3_0	153	5	2	500	7790	7290	0.40	15.58	0	13	13
0007	3T	3_0	154	8	0	800	0	-800	0.00	0.00	1	0	-1
0007	3T	3_0	156	7	0	700	0	-700	0.00	0.00	1	0	-1
0007	3T	3_0	162	5	0	500	0	-500	0.00	0.00	0	0	0
0007	3T	3_0	163	1	0	100	0	-100	0.00	0.00	0	0	0
0007	3T	3_0	164	4	0	400	0	-400	0.00	0.00	0	0	0
0007	3T	3_0	165	1	0	100	0	-100	0.00	0.00	0	0	0
0007	3T	3_0	213	5	0	500	0	-500	0.00	0.00	0	0	0
0007	3T	3_0	214	3	0	300	0	-300	0.00	0.00	0	0	0
0007	3T	3_0	215	2	0	200	0	-200	0.00	0.00	0	0	0
0007	3T	3_0	216	3	0	300	0	-300	0.00	0.00	0	0	0
0007	3T	3_0	231	2	0	200	0	-200	0.00	0.00	0	0	0
0007	3T	3_0	234	2	0	200	0	-200	0.00	0.00	0	0	0
0007	3T	3_0	235	4	0	400	0	-400	0.00	0.00	0	0	0
0007	3T	3_0	241	2	0	200	0	-200	0.00	0.00	0	0	0
0007	3T	3_0	243	3	0	300	0	-300	0.00	0.00	0	0	0
0007	3T	3_0	245	1	0	100	0	-100	0.00	0.00	0	0	0
0007	3T	3_0	246	1	0	100	0	-100	0.00	0.00	0	0	0
0007	3T	3_0	251	2	0	200	0	-200	0.00	0.00	0	0	0
0007	3T	3_0	253	1	0	100	0	-100	0.00	0.00	0	0	0
0007	3T	3_0	254	2	0	200	0	-200	0.00	0.00	0	0	0
0007	3T	3_0	256	1	0	100	0	-100	0.00	0.00	0	0	0
0007	3T	3_0	263	2	0	200	0	-200	0.00	0.00	0	0	0
0007	3T	3_1	123	145	10	14500	11880	-2620	0.07	0.82	25	21	-4
0007	3T	3_1	124	118	13	11800	13430	1630	0.11	1.14	20	23	3
0007	3T	3_1	125	72	3	7200	3400	-3800	0.04	0.47	12	6	-6
0007	3T	3_1	126	48	3	4800	2230	-2570	0.06	0.46	8	3	-5
0007	3T	3_1	132	91	5	9100	4010	-5090	0.05	0.44	16	7	-9
0007	3T	3_1	134	91	8	9100	11370	2270	0.09	1.25	16	20	4
0007	3T	3_1	135	59	4	5900	7510	1610	0.07	1.27	10	13	3
0007	3T	3_1	136	45	2	4500	2920	-1580	0.04	0.65	7	5	-2
0007	3T	3_1	142	50	0	5000	0	-5000	0.00	0.00	8	0	-8
0007	3T	3_1	143	50	2	5000	3660	-1340	0.04	0.73	8	6	-2
0007	3T	3_1	145	36	1	3600	1680	-1920	0.03	0.47	6	2	-4
0007	3T	3_1	146	25	0	2500	0	-2500	0.00	0.00	4	0	-4
0007	3T	3_1	152	23	0	2300	0	-2300	0.00	0.00	4	0	-4
0007	3T	3_1	153	20	1	2000	3490	1490	0.05	1.75	3	6	3
0007	3T	3_1	154	19	1	1900	1860	-40	0.05	0.98	3	3	0
0007	3T	3_1	156	13	0	1300	0	-1300	0.00	0.00	2	0	-2
0007	3T	3_1	162	17	0	1700	0	-1700	0.00	0.00	3	0	-3
0007	3T	3_1	163	10	0	1000	0	-1000	0.00	0.00	1	0	-1
0007	3T	3_1	164	4	0	400	0	-400	0.00	0.00	0	0	0
0007	3T	3_1	165	7	1	700	29400	28700	0.14	42.00	1	52	51
0007	3T	3_1	213	12	0	1200	0	-1200	0.00	0.00	2	0	-2
0007	3T	3_1	214	8	1	800	1570	770	0.13	1.96	1	2	1
0007	3T	3_1	215	4	0	400	0	-400	0.00	0.00	0	0	0
0007	3T	3_1	216	9	0	900	0	-900	0.00	0.00	1	0	-1
0007	3T	3_1	231	5	0	500	0	-500	0.00	0.00	0	0	0
0007	3T	3_1	234	5	0	500	0	-500	0.00	0.00	0	0	0
0007	3T	3_1	235	4	0	400	0	-400	0.00	0.00	0	0	0
0007	3T	3_1	236	3	0	300	0	-300	0.00	0.00	0	0	0
0007	3T	3_1	241	7	0	700	0	-700	0.00	0.00	1	0	-1
0007	3T	3_1	243	3	0	300	0	-300	0.00	0.00	0	0	0
0007	3T	3_1	245	3	0	300	0	-300	0.00	0.00	0	0	0
0007	3T	3_1	251	1	0	100	0	-100	0.00	0.00	0	0	0
0007	3T	3_1	253	2	0	200	0	-200	0.00	0.00	0	0	0
0007	3T	3_1	254	4	0	400	0	-400	0.00	0.00	0	0	0
0007	3T	3_1	256	2	0	200	0	-200	0.00	0.00	0	0	0
0007	3T	3_1	261	1	0	100	0	-100	0.00	0.00	0	0	0
0007	3T	3_1	264	1	0	100	0	-100	0.00	0.00	0	0	0
0007	3T	3_1	265	3	1	300	8860	8560	0.33	29.53	0	15	15
0007	3T	3_2	123	184	13	18400	17980	-420	0.07	0.98	32	31	-1
0007	3T	3_2	124	155	13	15500	13570	-1930	0.08	0.88	27	24	-3
0007	3T	3_2	125	121	8	12100	12350	250	0.07	1.02	21	21	0
0007	3T	3_2	126	98	5	9800	11280	1480	0.05	1.15	17	19	2
0007	3T	3_2	132	98	8	9800	9670	-130	0.08	0.99	17	17	0
0007	3T	3_2	134	98	10	9800	9570	-230	0.10	0.98	17	16	-1
0007	3T	3_2	135	90	2	9000	7420	-1580	0.02	0.82	15	13	-2
0007	3T	3_2	136	53	2	5300	3220	-2080	0.04	0.61	9	5	-4
0007	3T	3_2	142	54	4	5400	4440	-960	0.07	0.82	9	7	-2
0007	3T	3_2	143	52	3	5200	4360	-840	0.06	0.84	9	7	-2
0007	3T	3_2	145	50	2	5000	5700	700	0.04	1.14	8	10	2
0007	3T	3_2	146	24	0	2400	0	-2400	0.00	0.00	4	0	-4
0007	3T	3_2	152	37	1	3700	740	-2960	0.03	0.20	6	1	-5
0007	3T	3_2	153	28	0	2800	0	-2800	0.00	0.00	4	0	-4
0007	3T	3_2	154	21	0	2100	0	-2100	0.00	0.00	3	0	-3
0007	3T	3_2	156	25	0	2500	0	-2500	0.00	0.00	4	0	-4
0007	3T	3_2	162	16	0	1600	0	-1600	0.00	0.00	2	0	-2
0007	3T	3_2	163	17	0	1700	0	-1700	0.00	0.00	3	0	-3
0007	3T	3_2	164	13	0	1300	0	-1300	0.00	0.00	2	0	-2
0007	3T	3_2	165	7	1	700	2070	1370	0.14	2.96	1	3	2
0007	3T	3_2	213	32	0	3200	0	-3200	0.00	0.00	5	0	-5
0007	3T	3_2	214	29	1	2900	5620	2720	0.03	1.94	5	9	4
0007	3T	3_2	215	26	0	2600	0	-2600	0.00	0.00	4	0	-4
0007	3T	3_2	216	14	0	1400	0	-1400	0.00	0.00	2	0	-2
0007	3T	3_2	231	6	0	600	0	-600	0.00	0.00	1	0	-1
0007	3T	3_2	234	20	0	2000	0	-2000	0.00	0.00	3	0	-3
0007	3T	3_2	235	20	0	2000	0	-2000	0.00	0.00	3	0	-3
0007	3T	3_2	236	14	0	1400	0	-1400	0.00	0.00	2	0	-2
0007	3T	3_2	241	7	0	700	0	-700	0.00	0.00	1	0	-1
0007	3T	3_2	243	6	0	600	0	-600	0.00	0.00	1	0	-1
0007	3T	3_2	245	4	0	400	0	-400	0.00	0.00	0	0	0
0007	3T	3_2	246	8	0	800	0	-800	0.00	0.00	1	0	-1
0007	3T	3_2	251	8	0	800	0	-800	0.00	0.00	1	0	-1
0007	3T	3_2	253	3	0	300	0	-300	0.00	0.00	0	0	0
0007	3T	3_2	254	6	0	600	0	-600	0.00	0.00	1	0	-1
0007	3T	3_2	256	2	0	200	0	-200	0.00	0.00	0	0	0
0007	3T	3_2	261	3	0	300	0	-300	0.00	0.00	0	0	0
0007	3T	3_2	263	6	0	600	0	-600	0.00	0.00	1	0	-1
0007	3T	3_2	264	3	0	300	0	-300	0.00	0.00	0	0	0
0007	3T	3_2	265	3	0	300	0	-300	0.00	0.00	0	0	0
0007	3T	3_3	123	271	29	27100	37550	10450	0.11	1.39	47	66	19
0007	3T	3_3	124	239	21	23900	26270	2370	0.09	1.10	42	46	4
0007	3T	3_3	125	198	15	19800	31280	11480	0.08	1.58	35	55	20
0007	3T	3_3	126	156	6	15600	11000	-4600	0.04	0.71	27	19	-8
0007	3T	3_3	132	212	15	21200	28170	6970	0.07	1.33	37	49	12
0007	3T	3_3	134	177	12	17700	13860	-3840	0.07	0.78	31	24	-7
0007	3T	3_3	135	142	6	14200	7000	-7200	0.04	0.49	25	12	-13
0007	3T	3_3	136	123	7	12300	15500	3200	0.06	1.26	21	27	6
0007	3T	3_3	142	102	5	10200	5730	-4470	0.05	0.56	18	10	-8
0007	3T	3_3	143	103	4	10300	4380	-5920	0.04	0.43	18	7	-11
0007	3T	3_3	145	74	5	7400	9950	2550	0.07	1.34	13	17	4
0007	3T	3_3	146	51	1	5100	1280	-3820	0.02	0.25	9	2	-7
0007	3T	3_3	152	55	5	5500	15780	10280	0.09	2.87	9	27	18
0007	3T	3_3	153	59	5	5900	9310	3410	0.08	1.58	10	16	6
0007	3T	3_3	154	44	0	4400	0	-4400	0.00	0.00	7	0	-7
0007	3T	3_3	156	42	2	4200	2470	-1730	0.05	0.59	7	4	-3
0007	3T	3_3	162	32	0	3200	0	-3200	0.00	0.00	5	0	-5
0007	3T	3_3	163	25	1	2500	2280	-220	0.04	0.91	4	4	0
0007	3T	3_3	164	28	0	2800	0	-2800	0.00	0.00	4	0	-4
0007	3T	3_3	165	16	1	1600	12080	10480	0.06	7.55	2	21	19
0007	3T	3_3	213	56	2	5600	3000	-2600	0.04	0.54	9	5	-4
0007	3T	3_3	214	54	2	5400	2100	-3300	0.04	0.39	9	3	-6
0007	3T	3_3	215	47	2	4700	1760	-2940	0.04	0.37	8	3	-5
0007	3T	3_3	216	53	3	5300	4390	-910	0.06	0.83	9	7	-2
0007	3T	3_3	231	15	0	1500	0	-1500	0.00	0.00	2	0	-2
0007	3T	3_3	234	47	0	4700	0	-4700	0.00	0.00	8	0	-8
0007	3T	3_3	235	31	0	3100	0	-3100	0.00	0.00	5	0	-5
0007	3T	3_3	236	23	0	2300	0	-2300	0.00	0.00	4	0	-4
0007	3T	3_3	241	7	0	700	0	-700	0.00	0.00	1	0	-1
0007	3T	3_3	243	21	3	2100	9110	7010	0.14	4.34	3	16	13
0007	3T	3_3	245	12	0	1200	0	-1200	0.00	0.00	2	0	-2
0007	3T	3_3	246	23	1	2300	2040	-260	0.04	0.89	4	3	-1
0007	3T	3_3	251	15	0	1500	0	-1500	0.00	0.00	2	0	-2
0007	3T	3_3	253	15	0	1500	0	-1500	0.00	0.00	2	0	-2
0007	3T	3_3	254	11	0	1100	0	-1100	0.00	0.00	1	0	-1
0007	3T	3_3	256	21	0	2100	0	-2100	0.00	0.00	3	0	-3
0007	3T	3_3	261	8	0	800	0	-800	0.00	0.00	1	0	-1
0007	3T	3_3	263	16	0	1600	0	-1600	0.00	0.00	2	0	-2
0007	3T	3_3	264	17	1	1700	3460	1760	0.06	2.04	3	6	3
0007	3T	3_3	265	2	0	200	0	-200	0.00	0.00	0	0	0
0007	3T	3_4	123	209	24	20900	24680	3780	0.11	1.18	36	43	7
0007	3T	3_4	124	235	15	23500	19750	-3750	0.06	0.84	41	34	-7
0007	3T	3_4	125	177	6	17700	8260	-9440	0.03	0.47	31	14	-17
0007	3T	3_4	126	152	6	15200	12390	-2810	0.04	0.82	26	21	-5
0007	3T	3_4	132	129	9	12900	12460	-440	0.07	0.97	22	22	0
0007	3T	3_4	134	161	14	16100	20540	4440	0.09	1.28	28	36	8
0007	3T	3_4	135	143	5	14300	10850	-3450	0.03	0.76	25	19	-6
0007	3T	3_4	136	115	1	11500	2260	-9240	0.01	0.20	20	4	-16
0007	3T	3_4	142	65	2	6500	5420	-1080	0.03	0.83	11	9	-2
0007	3T	3_4	143	105	4	10500	9160	-1340	0.04	0.87	18	16	-2
0007	3T	3_4	145	68	2	6800	2180	-4620	0.03	0.32	12	3	-9
0007	3T	3_4	146	63	3	6300	8380	2080	0.05	1.33	11	14	3
0007	3T	3_4	152	43	1	4300	3510	-790	0.02	0.82	7	6	-1
0007	3T	3_4	153	45	1	4500	660	-3840	0.02	0.15	7	1	-6
0007	3T	3_4	154	36	2	3600	2850	-750	0.06	0.79	6	5	-1
0007	3T	3_4	156	39	0	3900	0	-3900	0.00	0.00	6	0	-6
0007	3T	3_4	162	18	1	1800	1550	-250	0.06	0.86	3	2	-1
0007	3T	3_4	163	21	1	2100	1120	-980	0.05	0.53	3	1	-2
0007	3T	3_4	164	24	0	2400	0	-2400	0.00	0.00	4	0	-4
0007	3T	3_4	165	19	0	1900	0	-1900	0.00	0.00	3	0	-3
0007	3T	3_4	213	18	0	1800	0	-1800	0.00	0.00	3	0	-3
0007	3T	3_4	214	23	2	2300	1330	-970	0.09	0.58	4	2	-2
0007	3T	3_4	215	9	0	900	0	-900	0.00	0.00	1	0	-1
0007	3T	3_4	216	16	0	1600	0	-1600	0.00	0.00	2	0	-2
0007	3T	3_4	231	4	0	400	0	-400	0.00	0.00	0	0	0
0007	3T	3_4	234	8	0	800	0	-800	0.00	0.00	1	0	-1
0007	3T	3_4	235	12	1	1200	1810	610	0.08	1.51	2	3	1
0007	3T	3_4	236	11	0	1100	0	-1100	0.00	0.00	1	0	-1
0007	3T	3_4	241	1	0	100	0	-100	0.00	0.00	0	0	0
0007	3T	3_4	243	5	0	500	0	-500	0.00	0.00	0	0	0
0007	3T	3_4	245	8	0	800	0	-800	0.00	0.00	1	0	-1
0007	3T	3_4	246	5	0	500	0	-500	0.00	0.00	0	0	0
0007	3T	3_4	251	2	0	200	0	-200	0.00	0.00	0	0	0
0007	3T	3_4	253	4	0	400	0	-400	0.00	0.00	0	0	0
0007	3T	3_4	254	4	0	400	0	-400	0.00	0.00	0	0	0
0007	3T	3_4	256	8	0	800	0	-800	0.00	0.00	1	0	-1
0007	3T	3_4	263	3	0	300	0	-300	0.00	0.00	0	0	0
0007	3T	3_4	264	6	0	600	0	-600	0.00	0.00	1	0	-1
0007	3T	3_4	265	1	0	100	0	-100	0.00	0.00	0	0	0
0007	3T	3_5	123	86	12	8600	8900	300	0.14	1.03	15	15	0
0007	3T	3_5	124	85	6	8500	3600	-4900	0.07	0.42	15	6	-9
0007	3T	3_5	125	60	2	6000	3540	-2460	0.03	0.59	10	6	-4
0007	3T	3_5	126	52	0	5200	0	-5200	0.00	0.00	9	0	-9
0007	3T	3_5	132	39	6	3900	6810	2910	0.15	1.75	6	12	6
0007	3T	3_5	134	41	2	4100	1200	-2900	0.05	0.29	7	2	-5
0007	3T	3_5	135	38	2	3800	2630	-1170	0.05	0.69	6	4	-2
0007	3T	3_5	136	29	0	2900	0	-2900	0.00	0.00	5	0	-5
0007	3T	3_5	142	25	2	2500	2320	-180	0.08	0.93	4	4	0
0007	3T	3_5	143	30	1	3000	2010	-990	0.03	0.67	5	3	-2
0007	3T	3_5	145	23	1	2300	890	-1410	0.04	0.39	4	1	-3
0007	3T	3_5	146	25	3	2500	3520	1020	0.12	1.41	4	6	2
0007	3T	3_5	152	9	1	900	3310	2410	0.11	3.68	1	5	4
0007	3T	3_5	153	9	0	900	0	-900	0.00	0.00	1	0	-1
0007	3T	3_5	154	18	0	1800	0	-1800	0.00	0.00	3	0	-3
0007	3T	3_5	156	9	1	900	2380	1480	0.11	2.64	1	4	3
0007	3T	3_5	162	4	0	400	0	-400	0.00	0.00	0	0	0
0007	3T	3_5	163	4	0	400	0	-400	0.00	0.00	0	0	0
0007	3T	3_5	164	3	0	300	0	-300	0.00	0.00	0	0	0
0007	3T	3_5	165	4	0	400	0	-400	0.00	0.00	0	0	0
0007	3T	3_5	214	2	1	200	590	390	0.50	2.95	0	1	1
0007	3T	3_5	215	2	0	200	0	-200	0.00	0.00	0	0	0
0007	3T	3_5	216	4	1	400	13940	13540	0.25	34.85	0	24	24
0007	3T	3_5	243	1	0	100	0	-100	0.00	0.00	0	0	0
0007	3T	3_5	245	1	0	100	0	-100	0.00	0.00	0	0	0
0007	3T	3_5	261	1	0	100	0	-100	0.00	0.00	0	0	0
0007	3T	3_6	123	24	2	2400	1210	-1190	0.08	0.50	4	2	-2
0007	3T	3_6	124	36	3	3600	2550	-1050	0.08	0.71	6	4	-2
0007	3T	3_6	125	15	1	1500	2270	770	0.07	1.51	2	4	2
0007	3T	3_6	126	23	2	2300	3530	1230	0.09	1.53	4	6	2
0007	3T	3_6	132	14	4	1400	5970	4570	0.29	4.26	2	10	8
0007	3T	3_6	134	15	1	1500	790	-710	0.07	0.53	2	1	-1
0007	3T	3_6	135	12	0	1200	0	-1200	0.00	0.00	2	0	-2
0007	3T	3_6	136	20	2	2000	4070	2070	0.10	2.04	3	7	4
0007	3T	3_6	142	4	0	400	0	-400	0.00	0.00	0	0	0
0007	3T	3_6	143	13	0	1300	0	-1300	0.00	0.00	2	0	-2
0007	3T	3_6	145	10	0	1000	0	-1000	0.00	0.00	1	0	-1
0007	3T	3_6	146	13	0	1300	0	-1300	0.00	0.00	2	0	-2
0007	3T	3_6	152	3	0	300	0	-300	0.00	0.00	0	0	0
0007	3T	3_6	153	2	0	200	0	-200	0.00	0.00	0	0	0
0007	3T	3_6	154	4	0	400	0	-400	0.00	0.00	0	0	0
0007	3T	3_6	156	5	0	500	0	-500	0.00	0.00	0	0	0
0007	3T	3_6	162	1	0	100	0	-100	0.00	0.00	0	0	0
0007	3T	3_6	163	2	0	200	0	-200	0.00	0.00	0	0	0
0007	3T	3_6	164	2	0	200	0	-200	0.00	0.00	0	0	0
0007	3T	3_6	165	2	0	200	0	-200	0.00	0.00	0	0	0
0007	3T	3_6	214	3	0	300	0	-300	0.00	0.00	0	0	0
0007	3T	3_6	216	1	0	100	0	-100	0.00	0.00	0	0	0
0007	3T	3_6	246	1	0	100	0	-100	0.00	0.00	0	0	0
0007	3T	4_0	123	32	4	3200	2780	-420	0.13	0.87	5	4	-1
0007	3T	4_0	124	21	0	2100	0	-2100	0.00	0.00	3	0	-3
0007	3T	4_0	125	23	1	2300	1750	-550	0.04	0.76	4	3	-1
0007	3T	4_0	126	9	0	900	0	-900	0.00	0.00	1	0	-1
0007	3T	4_0	132	26	4	2600	7620	5020	0.15	2.93	4	13	9
0007	3T	4_0	134	19	3	1900	4620	2720	0.16	2.43	3	8	5
0007	3T	4_0	135	11	0	1100	0	-1100	0.00	0.00	1	0	-1
0007	3T	4_0	136	6	0	600	0	-600	0.00	0.00	1	0	-1
0007	3T	4_0	142	6	0	600	0	-600	0.00	0.00	1	0	-1
0007	3T	4_0	143	9	0	900	0	-900	0.00	0.00	1	0	-1
0007	3T	4_0	145	6	1	600	1530	930	0.17	2.55	1	2	1
0007	3T	4_0	146	9	0	900	0	-900	0.00	0.00	1	0	-1
0007	3T	4_0	152	6	0	600	0	-600	0.00	0.00	1	0	-1
0007	3T	4_0	153	9	0	900	0	-900	0.00	0.00	1	0	-1
0007	3T	4_0	154	8	0	800	0	-800	0.00	0.00	1	0	-1
0007	3T	4_0	156	7	0	700	0	-700	0.00	0.00	1	0	-1
0007	3T	4_0	162	6	1	600	2070	1470	0.17	3.45	1	3	2
0007	3T	4_0	163	5	1	500	4490	3990	0.20	8.98	0	7	7
0007	3T	4_0	164	3	0	300	0	-300	0.00	0.00	0	0	0
0007	3T	4_0	165	1	0	100	0	-100	0.00	0.00	0	0	0
0007	3T	4_0	213	2	0	200	0	-200	0.00	0.00	0	0	0
0007	3T	4_0	214	2	0	200	0	-200	0.00	0.00	0	0	0
0007	3T	4_0	215	3	0	300	0	-300	0.00	0.00	0	0	0
0007	3T	4_0	216	5	0	500	0	-500	0.00	0.00	0	0	0
0007	3T	4_0	231	6	0	600	0	-600	0.00	0.00	1	0	-1
0007	3T	4_0	234	3	0	300	0	-300	0.00	0.00	0	0	0
0007	3T	4_0	235	2	0	200	0	-200	0.00	0.00	0	0	0
0007	3T	4_0	241	3	0	300	0	-300	0.00	0.00	0	0	0
0007	3T	4_0	243	2	0	200	0	-200	0.00	0.00	0	0	0
0007	3T	4_0	245	1	0	100	0	-100	0.00	0.00	0	0	0
0007	3T	4_0	251	2	0	200	0	-200	0.00	0.00	0	0	0
0007	3T	4_0	254	1	0	100	0	-100	0.00	0.00	0	0	0
0007	3T	4_0	261	1	0	100	0	-100	0.00	0.00	0	0	0
0007	3T	4_1	123	164	24	16400	21590	5190	0.15	1.32	29	38	9
0007	3T	4_1	124	104	9	10400	7180	-3220	0.09	0.69	18	12	-6
0007	3T	4_1	125	55	1	5500	510	-4990	0.02	0.09	9	0	-9
0007	3T	4_1	126	36	2	3600	4230	630	0.06	1.18	6	7	1
0007	3T	4_1	132	76	8	7600	7660	60	0.11	1.01	13	13	0
0007	3T	4_1	134	55	6	5500	8020	2520	0.11	1.46	9	14	5
0007	3T	4_1	135	47	3	4700	3960	-740	0.06	0.84	8	7	-1
0007	3T	4_1	136	31	2	3100	1340	-1760	0.06	0.43	5	2	-3
0007	3T	4_1	142	43	3	4300	3280	-1020	0.07	0.76	7	5	-2
0007	3T	4_1	143	42	1	4200	2790	-1410	0.02	0.66	7	4	-3
0007	3T	4_1	145	24	0	2400	0	-2400	0.00	0.00	4	0	-4
0007	3T	4_1	146	18	1	1800	1460	-340	0.06	0.81	3	2	-1
0007	3T	4_1	152	14	2	1400	5540	4140	0.14	3.96	2	9	7
0007	3T	4_1	153	14	0	1400	0	-1400	0.00	0.00	2	0	-2
0007	3T	4_1	154	9	1	900	3850	2950	0.11	4.28	1	6	5
0007	3T	4_1	156	5	0	500	0	-500	0.00	0.00	0	0	0
0007	3T	4_1	162	13	0	1300	0	-1300	0.00	0.00	2	0	-2
0007	3T	4_1	163	13	1	1300	11580	10280	0.08	8.91	2	20	18
0007	3T	4_1	164	3	0	300	0	-300	0.00	0.00	0	0	0
0007	3T	4_1	165	5	0	500	0	-500	0.00	0.00	0	0	0
0007	3T	4_1	213	8	0	800	0	-800	0.00	0.00	1	0	-1
0007	3T	4_1	214	7	1	700	680	-20	0.14	0.97	1	1	0
0007	3T	4_1	215	5	0	500	0	-500	0.00	0.00	0	0	0
0007	3T	4_1	216	4	0	400	0	-400	0.00	0.00	0	0	0
0007	3T	4_1	231	4	0	400	0	-400	0.00	0.00	0	0	0
0007	3T	4_1	234	4	0	400	0	-400	0.00	0.00	0	0	0
0007	3T	4_1	235	5	0	500	0	-500	0.00	0.00	0	0	0
0007	3T	4_1	236	2	0	200	0	-200	0.00	0.00	0	0	0
0007	3T	4_1	241	3	0	300	0	-300	0.00	0.00	0	0	0
0007	3T	4_1	243	4	0	400	0	-400	0.00	0.00	0	0	0
0007	3T	4_1	245	3	0	300	0	-300	0.00	0.00	0	0	0
0007	3T	4_1	251	2	0	200	0	-200	0.00	0.00	0	0	0
0007	3T	4_1	253	3	0	300	0	-300	0.00	0.00	0	0	0
0007	3T	4_1	254	2	0	200	0	-200	0.00	0.00	0	0	0
0007	3T	4_1	256	1	0	100	0	-100	0.00	0.00	0	0	0
0007	3T	4_1	261	3	0	300	0	-300	0.00	0.00	0	0	0
0007	3T	4_1	263	2	0	200	0	-200	0.00	0.00	0	0	0
0007	3T	4_1	264	1	0	100	0	-100	0.00	0.00	0	0	0
0007	3T	4_2	123	183	21	18300	20460	2160	0.11	1.12	32	36	4
0007	3T	4_2	124	161	11	16100	8030	-8070	0.07	0.50	28	14	-14
0007	3T	4_2	125	95	6	9500	8000	-1500	0.06	0.84	16	14	-2
0007	3T	4_2	126	55	4	5500	4250	-1250	0.07	0.77	9	7	-2
0007	3T	4_2	132	118	7	11800	9420	-2380	0.06	0.80	20	16	-4
0007	3T	4_2	134	77	8	7700	12490	4790	0.10	1.62	13	22	9
0007	3T	4_2	135	58	2	5800	1730	-4070	0.03	0.30	10	3	-7
0007	3T	4_2	136	50	1	5000	1540	-3460	0.02	0.31	8	2	-6
0007	3T	4_2	142	64	3	6400	3300	-3100	0.05	0.52	11	5	-6
0007	3T	4_2	143	60	2	6000	2280	-3720	0.03	0.38	10	4	-6
0007	3T	4_2	145	37	2	3700	1560	-2140	0.05	0.42	6	2	-4
0007	3T	4_2	146	26	0	2600	0	-2600	0.00	0.00	4	0	-4
0007	3T	4_2	152	17	1	1700	2230	530	0.06	1.31	3	3	0
0007	3T	4_2	153	15	1	1500	1030	-470	0.07	0.69	2	1	-1
0007	3T	4_2	154	14	0	1400	0	-1400	0.00	0.00	2	0	-2
0007	3T	4_2	156	7	0	700	0	-700	0.00	0.00	1	0	-1
0007	3T	4_2	162	15	1	1500	4720	3220	0.07	3.15	2	8	6
0007	3T	4_2	163	13	1	1300	690	-610	0.08	0.53	2	1	-1
0007	3T	4_2	164	8	2	800	3240	2440	0.25	4.05	1	5	4
0007	3T	4_2	165	3	0	300	0	-300	0.00	0.00	0	0	0
0007	3T	4_2	213	22	2	2200	1720	-480	0.09	0.78	3	3	0
0007	3T	4_2	214	20	2	2000	12180	10180	0.10	6.09	3	21	18
0007	3T	4_2	215	11	1	1100	980	-120	0.09	0.89	1	1	0
0007	3T	4_2	216	10	0	1000	0	-1000	0.00	0.00	1	0	-1
0007	3T	4_2	231	11	0	1100	0	-1100	0.00	0.00	1	0	-1
0007	3T	4_2	234	10	0	1000	0	-1000	0.00	0.00	1	0	-1
0007	3T	4_2	235	8	0	800	0	-800	0.00	0.00	1	0	-1
0007	3T	4_2	236	6	0	600	0	-600	0.00	0.00	1	0	-1
0007	3T	4_2	241	2	0	200	0	-200	0.00	0.00	0	0	0
0007	3T	4_2	243	11	0	1100	0	-1100	0.00	0.00	1	0	-1
0007	3T	4_2	245	2	0	200	0	-200	0.00	0.00	0	0	0
0007	3T	4_2	246	7	0	700	0	-700	0.00	0.00	1	0	-1
0007	3T	4_2	251	3	0	300	0	-300	0.00	0.00	0	0	0
0007	3T	4_2	253	4	0	400	0	-400	0.00	0.00	0	0	0
0007	3T	4_2	254	4	0	400	0	-400	0.00	0.00	0	0	0
0007	3T	4_2	256	4	0	400	0	-400	0.00	0.00	0	0	0
0007	3T	4_2	261	5	0	500	0	-500	0.00	0.00	0	0	0
0007	3T	4_2	263	2	2	200	1820	1620	1.00	9.10	0	3	3
0007	3T	4_2	264	3	0	300	0	-300	0.00	0.00	0	0	0
0007	3T	4_2	265	4	0	400	0	-400	0.00	0.00	0	0	0
0007	3T	4_3	123	290	35	29000	34460	5460	0.12	1.19	51	60	9
0007	3T	4_3	124	243	18	24300	15690	-8610	0.07	0.65	43	27	-16
0007	3T	4_3	125	182	12	18200	23960	5760	0.07	1.32	32	42	10
0007	3T	4_3	126	125	6	12500	17220	4720	0.05	1.38	22	30	8
0007	3T	4_3	132	176	13	17600	23970	6370	0.07	1.36	31	42	11
0007	3T	4_3	134	183	12	18300	8440	-9860	0.07	0.46	32	14	-18
0007	3T	4_3	135	112	11	11200	15630	4430	0.10	1.40	19	27	8
0007	3T	4_3	136	111	7	11100	12080	980	0.06	1.09	19	21	2
0007	3T	4_3	142	107	14	10700	19240	8540	0.13	1.80	18	34	16
0007	3T	4_3	143	76	4	7600	4680	-2920	0.05	0.62	13	8	-5
0007	3T	4_3	145	56	4	5600	6500	900	0.07	1.16	9	11	2
0007	3T	4_3	146	48	0	4800	0	-4800	0.00	0.00	8	0	-8
0007	3T	4_3	152	55	1	5500	870	-4630	0.02	0.16	9	1	-8
0007	3T	4_3	153	48	1	4800	4020	-780	0.02	0.84	8	7	-1
0007	3T	4_3	154	27	0	2700	0	-2700	0.00	0.00	4	0	-4
0007	3T	4_3	156	23	0	2300	0	-2300	0.00	0.00	4	0	-4
0007	3T	4_3	162	22	1	2200	1950	-250	0.05	0.89	3	3	0
0007	3T	4_3	163	15	0	1500	0	-1500	0.00	0.00	2	0	-2
0007	3T	4_3	164	20	0	2000	0	-2000	0.00	0.00	3	0	-3
0007	3T	4_3	165	15	0	1500	0	-1500	0.00	0.00	2	0	-2
0007	3T	4_3	213	36	1	3600	1890	-1710	0.03	0.53	6	3	-3
0007	3T	4_3	214	28	2	2800	2130	-670	0.07	0.76	4	3	-1
0007	3T	4_3	215	23	3	2300	5480	3180	0.13	2.38	4	9	5
0007	3T	4_3	216	22	0	2200	0	-2200	0.00	0.00	3	0	-3
0007	3T	4_3	231	17	0	1700	0	-1700	0.00	0.00	3	0	-3
0007	3T	4_3	234	20	0	2000	0	-2000	0.00	0.00	3	0	-3
0007	3T	4_3	235	24	2	2400	2650	250	0.08	1.10	4	4	0
0007	3T	4_3	236	23	2	2300	2830	530	0.09	1.23	4	5	1
0007	3T	4_3	241	4	0	400	0	-400	0.00	0.00	0	0	0
0007	3T	4_3	243	8	0	800	0	-800	0.00	0.00	1	0	-1
0007	3T	4_3	245	7	0	700	0	-700	0.00	0.00	1	0	-1
0007	3T	4_3	246	8	1	800	1540	740	0.13	1.93	1	2	1
0007	3T	4_3	251	3	0	300	0	-300	0.00	0.00	0	0	0
0007	3T	4_3	253	9	0	900	0	-900	0.00	0.00	1	0	-1
0007	3T	4_3	254	7	0	700	0	-700	0.00	0.00	1	0	-1
0007	3T	4_3	256	6	0	600	0	-600	0.00	0.00	1	0	-1
0007	3T	4_3	261	2	0	200	0	-200	0.00	0.00	0	0	0
0007	3T	4_3	263	9	0	900	0	-900	0.00	0.00	1	0	-1
0007	3T	4_3	264	3	0	300	0	-300	0.00	0.00	0	0	0
0007	3T	4_3	265	1	0	100	0	-100	0.00	0.00	0	0	0
0007	3T	4_4	123	271	33	27100	25610	-1490	0.12	0.95	47	45	-2
0007	3T	4_4	124	236	19	23600	19870	-3730	0.08	0.84	41	35	-6
0007	3T	4_4	125	171	13	17100	13080	-4020	0.08	0.76	30	23	-7
0007	3T	4_4	126	113	6	11300	12540	1240	0.05	1.11	20	22	2
0007	3T	4_4	132	104	10	10400	11040	640	0.10	1.06	18	19	1
0007	3T	4_4	134	127	11	12700	8660	-4040	0.09	0.68	22	15	-7
0007	3T	4_4	135	88	4	8800	3150	-5650	0.05	0.36	15	5	-10
0007	3T	4_4	136	72	4	7200	4090	-3110	0.06	0.57	12	7	-5
0007	3T	4_4	142	65	4	6500	4450	-2050	0.06	0.68	11	7	-4
0007	3T	4_4	143	65	3	6500	4790	-1710	0.05	0.74	11	8	-3
0007	3T	4_4	145	59	4	5900	3930	-1970	0.07	0.67	10	6	-4
0007	3T	4_4	146	43	1	4300	1190	-3110	0.02	0.28	7	2	-5
0007	3T	4_4	152	23	2	2300	3150	850	0.09	1.37	4	5	1
0007	3T	4_4	153	24	0	2400	0	-2400	0.00	0.00	4	0	-4
0007	3T	4_4	154	25	0	2500	0	-2500	0.00	0.00	4	0	-4
0007	3T	4_4	156	16	0	1600	0	-1600	0.00	0.00	2	0	-2
0007	3T	4_4	162	9	1	900	1870	970	0.11	2.08	1	3	2
0007	3T	4_4	163	12	0	1200	0	-1200	0.00	0.00	2	0	-2
0007	3T	4_4	164	11	0	1100	0	-1100	0.00	0.00	1	0	-1
0007	3T	4_4	165	7	0	700	0	-700	0.00	0.00	1	0	-1
0007	3T	4_4	213	5	0	500	0	-500	0.00	0.00	0	0	0
0007	3T	4_4	214	10	0	1000	0	-1000	0.00	0.00	1	0	-1
0007	3T	4_4	215	12	0	1200	0	-1200	0.00	0.00	2	0	-2
0007	3T	4_4	216	3	0	300	0	-300	0.00	0.00	0	0	0
0007	3T	4_4	231	5	0	500	0	-500	0.00	0.00	0	0	0
0007	3T	4_4	234	7	0	700	0	-700	0.00	0.00	1	0	-1
0007	3T	4_4	235	1	0	100	0	-100	0.00	0.00	0	0	0
0007	3T	4_4	236	5	1	500	4080	3580	0.20	8.16	0	7	7
0007	3T	4_4	241	4	1	400	1940	1540	0.25	4.85	0	3	3
0007	3T	4_4	243	6	0	600	0	-600	0.00	0.00	1	0	-1
0007	3T	4_4	245	5	0	500	0	-500	0.00	0.00	0	0	0
0007	3T	4_4	246	3	0	300	0	-300	0.00	0.00	0	0	0
0007	3T	4_4	251	5	0	500	0	-500	0.00	0.00	0	0	0
0007	3T	4_4	253	2	0	200	0	-200	0.00	0.00	0	0	0
0007	3T	4_4	254	1	0	100	0	-100	0.00	0.00	0	0	0
0007	3T	4_4	256	2	0	200	0	-200	0.00	0.00	0	0	0
0007	3T	4_4	261	2	0	200	0	-200	0.00	0.00	0	0	0
0007	3T	4_4	264	2	0	200	0	-200	0.00	0.00	0	0	0
0007	3T	4_5	123	126	12	12600	6700	-5900	0.10	0.53	22	11	-11
0007	3T	4_5	124	126	10	12600	6610	-5990	0.08	0.52	22	11	-11
0007	3T	4_5	125	63	3	6300	3050	-3250	0.05	0.48	11	5	-6
0007	3T	4_5	126	41	0	4100	0	-4100	0.00	0.00	7	0	-7
0007	3T	4_5	132	46	5	4600	13780	9180	0.11	3.00	8	24	16
0007	3T	4_5	134	57	6	5700	4550	-1150	0.11	0.80	10	8	-2
0007	3T	4_5	135	41	4	4100	4180	80	0.10	1.02	7	7	0
0007	3T	4_5	136	30	1	3000	470	-2530	0.03	0.16	5	0	-5
0007	3T	4_5	142	20	3	2000	2210	210	0.15	1.11	3	3	0
0007	3T	4_5	143	15	0	1500	0	-1500	0.00	0.00	2	0	-2
0007	3T	4_5	145	16	1	1600	1980	380	0.06	1.24	2	3	1
0007	3T	4_5	146	15	0	1500	0	-1500	0.00	0.00	2	0	-2
0007	3T	4_5	152	4	0	400	0	-400	0.00	0.00	0	0	0
0007	3T	4_5	153	2	0	200	0	-200	0.00	0.00	0	0	0
0007	3T	4_5	154	5	0	500	0	-500	0.00	0.00	0	0	0
0007	3T	4_5	156	4	0	400	0	-400	0.00	0.00	0	0	0
0007	3T	4_5	163	4	0	400	0	-400	0.00	0.00	0	0	0
0007	3T	4_5	165	1	0	100	0	-100	0.00	0.00	0	0	0
0007	3T	4_5	214	2	0	200	0	-200	0.00	0.00	0	0	0
0007	3T	4_5	216	1	0	100	0	-100	0.00	0.00	0	0	0
0007	3T	4_5	234	1	0	100	0	-100	0.00	0.00	0	0	0
0007	3T	4_5	243	1	0	100	0	-100	0.00	0.00	0	0	0
0007	3T	4_6	123	54	8	5400	4520	-880	0.15	0.84	9	8	-1
0007	3T	4_6	124	50	2	5000	1960	-3040	0.04	0.39	8	3	-5
0007	3T	4_6	125	28	2	2800	4460	1660	0.07	1.59	4	7	3
0007	3T	4_6	126	21	0	2100	0	-2100	0.00	0.00	3	0	-3
0007	3T	4_6	132	20	0	2000	0	-2000	0.00	0.00	3	0	-3
0007	3T	4_6	134	23	3	2300	3470	1170	0.13	1.51	4	6	2
0007	3T	4_6	135	11	1	1100	1410	310	0.09	1.28	1	2	1
0007	3T	4_6	136	5	0	500	0	-500	0.00	0.00	0	0	0
0007	3T	4_6	142	6	0	600	0	-600	0.00	0.00	1	0	-1
0007	3T	4_6	143	6	1	600	1760	1160	0.17	2.93	1	3	2
0007	3T	4_6	145	4	0	400	0	-400	0.00	0.00	0	0	0
0007	3T	4_6	146	2	0	200	0	-200	0.00	0.00	0	0	0
0007	3T	4_6	152	4	0	400	0	-400	0.00	0.00	0	0	0
0007	3T	4_6	153	1	0	100	0	-100	0.00	0.00	0	0	0
0007	3T	4_6	154	3	0	300	0	-300	0.00	0.00	0	0	0
0007	3T	4_6	156	3	0	300	0	-300	0.00	0.00	0	0	0
0007	3T	4_6	162	2	0	200	0	-200	0.00	0.00	0	0	0
0007	3T	4_6	215	1	0	100	0	-100	0.00	0.00	0	0	0
0007	3T	5_0	123	47	2	4700	2190	-2510	0.04	0.47	8	3	-5
0007	3T	5_0	124	40	2	4000	2850	-1150	0.05	0.71	7	5	-2
0007	3T	5_0	125	20	2	2000	7070	5070	0.10	3.54	3	12	9
0007	3T	5_0	126	17	0	1700	0	-1700	0.00	0.00	3	0	-3
0007	3T	5_0	132	21	0	2100	0	-2100	0.00	0.00	3	0	-3
0007	3T	5_0	134	25	1	2500	1040	-1460	0.04	0.42	4	1	-3
0007	3T	5_0	135	18	2	1800	2060	260	0.11	1.14	3	3	0
0007	3T	5_0	136	18	0	1800	0	-1800	0.00	0.00	3	0	-3
0007	3T	5_0	142	17	0	1700	0	-1700	0.00	0.00	3	0	-3
0007	3T	5_0	143	17	0	1700	0	-1700	0.00	0.00	3	0	-3
0007	3T	5_0	145	5	0	500	0	-500	0.00	0.00	0	0	0
0007	3T	5_0	146	6	0	600	0	-600	0.00	0.00	1	0	-1
0007	3T	5_0	152	8	1	800	790	-10	0.13	0.99	1	1	0
0007	3T	5_0	153	8	0	800	0	-800	0.00	0.00	1	0	-1
0007	3T	5_0	154	7	0	700	0	-700	0.00	0.00	1	0	-1
0007	3T	5_0	156	3	0	300	0	-300	0.00	0.00	0	0	0
0007	3T	5_0	162	4	0	400	0	-400	0.00	0.00	0	0	0
0007	3T	5_0	163	1	0	100	0	-100	0.00	0.00	0	0	0
0007	3T	5_0	164	2	0	200	0	-200	0.00	0.00	0	0	0
0007	3T	5_0	165	3	0	300	0	-300	0.00	0.00	0	0	0
0007	3T	5_0	213	6	0	600	0	-600	0.00	0.00	1	0	-1
0007	3T	5_0	214	5	1	500	3580	3080	0.20	7.16	0	6	6
0007	3T	5_0	215	3	0	300	0	-300	0.00	0.00	0	0	0
0007	3T	5_0	231	3	0	300	0	-300	0.00	0.00	0	0	0
0007	3T	5_0	234	1	0	100	0	-100	0.00	0.00	0	0	0
0007	3T	5_0	235	2	0	200	0	-200	0.00	0.00	0	0	0
0007	3T	5_0	241	1	0	100	0	-100	0.00	0.00	0	0	0
0007	3T	5_0	243	1	0	100	0	-100	0.00	0.00	0	0	0
0007	3T	5_0	251	2	0	200	0	-200	0.00	0.00	0	0	0
0007	3T	5_0	253	3	0	300	0	-300	0.00	0.00	0	0	0
0007	3T	5_0	254	2	0	200	0	-200	0.00	0.00	0	0	0
0007	3T	5_0	264	1	0	100	0	-100	0.00	0.00	0	0	0
0007	3T	5_1	123	101	8	10100	6400	-3700	0.08	0.63	17	11	-6
0007	3T	5_1	124	77	8	7700	6450	-1250	0.10	0.84	13	11	-2
0007	3T	5_1	125	60	4	6000	5030	-970	0.07	0.84	10	8	-2
0007	3T	5_1	126	27	0	2700	0	-2700	0.00	0.00	4	0	-4
0007	3T	5_1	132	66	7	6600	12580	5980	0.11	1.91	11	22	11
0007	3T	5_1	134	47	3	4700	6110	1410	0.06	1.30	8	10	2
0007	3T	5_1	135	34	0	3400	0	-3400	0.00	0.00	6	0	-6
0007	3T	5_1	136	24	0	2400	0	-2400	0.00	0.00	4	0	-4
0007	3T	5_1	142	38	4	3800	5120	1320	0.11	1.35	6	9	3
0007	3T	5_1	143	40	2	4000	3340	-660	0.05	0.84	7	5	-2
0007	3T	5_1	145	20	0	2000	0	-2000	0.00	0.00	3	0	-3
0007	3T	5_1	146	11	0	1100	0	-1100	0.00	0.00	1	0	-1
0007	3T	5_1	152	20	0	2000	0	-2000	0.00	0.00	3	0	-3
0007	3T	5_1	153	16	1	1600	1550	-50	0.06	0.97	2	2	0
0007	3T	5_1	154	7	0	700	0	-700	0.00	0.00	1	0	-1
0007	3T	5_1	156	3	0	300	0	-300	0.00	0.00	0	0	0
0007	3T	5_1	162	8	0	800	0	-800	0.00	0.00	1	0	-1
0007	3T	5_1	163	9	0	900	0	-900	0.00	0.00	1	0	-1
0007	3T	5_1	164	2	0	200	0	-200	0.00	0.00	0	0	0
0007	3T	5_1	213	4	0	400	0	-400	0.00	0.00	0	0	0
0007	3T	5_1	214	2	0	200	0	-200	0.00	0.00	0	0	0
0007	3T	5_1	215	5	0	500	0	-500	0.00	0.00	0	0	0
0007	3T	5_1	231	4	0	400	0	-400	0.00	0.00	0	0	0
0007	3T	5_1	234	2	0	200	0	-200	0.00	0.00	0	0	0
0007	3T	5_1	235	6	0	600	0	-600	0.00	0.00	1	0	-1
0007	3T	5_1	236	1	0	100	0	-100	0.00	0.00	0	0	0
0007	3T	5_1	241	3	0	300	0	-300	0.00	0.00	0	0	0
0007	3T	5_1	243	1	1	100	1840	1740	1.00	18.40	0	3	3
0007	3T	5_1	245	1	0	100	0	-100	0.00	0.00	0	0	0
0007	3T	5_1	246	1	0	100	0	-100	0.00	0.00	0	0	0
0007	3T	5_1	251	1	0	100	0	-100	0.00	0.00	0	0	0
0007	3T	5_1	253	3	0	300	0	-300	0.00	0.00	0	0	0
0007	3T	5_1	254	1	0	100	0	-100	0.00	0.00	0	0	0
0007	3T	5_1	256	1	0	100	0	-100	0.00	0.00	0	0	0
0007	3T	5_1	265	1	0	100	0	-100	0.00	0.00	0	0	0
0007	3T	5_2	123	141	17	14100	13880	-220	0.12	0.98	24	24	0
0007	3T	5_2	124	126	11	12600	9170	-3430	0.09	0.73	22	16	-6
0007	3T	5_2	125	72	2	7200	1710	-5490	0.03	0.24	12	3	-9
0007	3T	5_2	126	54	1	5400	990	-4410	0.02	0.18	9	1	-8
0007	3T	5_2	132	81	4	8100	4600	-3500	0.05	0.57	14	8	-6
0007	3T	5_2	134	74	6	7400	6410	-990	0.08	0.87	13	11	-2
0007	3T	5_2	135	49	1	4900	330	-4570	0.02	0.07	8	0	-8
0007	3T	5_2	136	41	1	4100	890	-3210	0.02	0.22	7	1	-6
0007	3T	5_2	142	50	2	5000	3470	-1530	0.04	0.69	8	6	-2
0007	3T	5_2	143	45	3	4500	3000	-1500	0.07	0.67	7	5	-2
0007	3T	5_2	145	40	2	4000	2220	-1780	0.05	0.56	7	3	-4
0007	3T	5_2	146	17	0	1700	0	-1700	0.00	0.00	3	0	-3
0007	3T	5_2	152	19	1	1900	770	-1130	0.05	0.41	3	1	-2
0007	3T	5_2	153	23	0	2300	0	-2300	0.00	0.00	4	0	-4
0007	3T	5_2	154	16	0	1600	0	-1600	0.00	0.00	2	0	-2
0007	3T	5_2	156	4	0	400	0	-400	0.00	0.00	0	0	0
0007	3T	5_2	162	15	0	1500	0	-1500	0.00	0.00	2	0	-2
0007	3T	5_2	163	5	0	500	0	-500	0.00	0.00	0	0	0
0007	3T	5_2	164	7	0	700	0	-700	0.00	0.00	1	0	-1
0007	3T	5_2	165	7	0	700	0	-700	0.00	0.00	1	0	-1
0007	3T	5_2	213	8	0	800	0	-800	0.00	0.00	1	0	-1
0007	3T	5_2	214	10	0	1000	0	-1000	0.00	0.00	1	0	-1
0007	3T	5_2	215	12	0	1200	0	-1200	0.00	0.00	2	0	-2
0007	3T	5_2	216	3	0	300	0	-300	0.00	0.00	0	0	0
0007	3T	5_2	231	4	0	400	0	-400	0.00	0.00	0	0	0
0007	3T	5_2	234	9	0	900	0	-900	0.00	0.00	1	0	-1
0007	3T	5_2	235	1	0	100	0	-100	0.00	0.00	0	0	0
0007	3T	5_2	236	2	0	200	0	-200	0.00	0.00	0	0	0
0007	3T	5_2	241	3	1	300	1550	1250	0.33	5.17	0	2	2
0007	3T	5_2	243	4	0	400	0	-400	0.00	0.00	0	0	0
0007	3T	5_2	245	3	0	300	0	-300	0.00	0.00	0	0	0
0007	3T	5_2	246	1	0	100	0	-100	0.00	0.00	0	0	0
0007	3T	5_2	251	3	0	300	0	-300	0.00	0.00	0	0	0
0007	3T	5_2	253	3	0	300	0	-300	0.00	0.00	0	0	0
0007	3T	5_2	254	4	0	400	0	-400	0.00	0.00	0	0	0
0007	3T	5_2	256	1	0	100	0	-100	0.00	0.00	0	0	0
0007	3T	5_2	264	1	0	100	0	-100	0.00	0.00	0	0	0
0007	3T	5_2	265	2	0	200	0	-200	0.00	0.00	0	0	0
0007	3T	5_3	123	214	21	21400	25700	4300	0.10	1.20	37	45	8
0007	3T	5_3	124	228	20	22800	19790	-3010	0.09	0.87	40	35	-5
0007	3T	5_3	125	122	7	12200	10740	-1460	0.06	0.88	21	19	-2
0007	3T	5_3	126	102	3	10200	12910	2710	0.03	1.27	18	22	4
0007	3T	5_3	132	123	9	12300	7730	-4570	0.07	0.63	21	13	-8
0007	3T	5_3	134	127	6	12700	9910	-2790	0.05	0.78	22	17	-5
0007	3T	5_3	135	115	5	11500	5910	-5590	0.04	0.51	20	10	-10
0007	3T	5_3	136	56	1	5600	7090	1490	0.02	1.27	9	12	3
0007	3T	5_3	142	69	8	6900	9990	3090	0.12	1.45	12	17	5
0007	3T	5_3	143	88	3	8800	1940	-6860	0.03	0.22	15	3	-12
0007	3T	5_3	145	68	1	6800	750	-6050	0.01	0.11	12	1	-11
0007	3T	5_3	146	36	2	3600	1510	-2090	0.06	0.42	6	2	-4
0007	3T	5_3	152	33	1	3300	500	-2800	0.03	0.15	5	0	-5
0007	3T	5_3	153	43	2	4300	3310	-990	0.05	0.77	7	5	-2
0007	3T	5_3	154	27	0	2700	0	-2700	0.00	0.00	4	0	-4
0007	3T	5_3	156	7	0	700	0	-700	0.00	0.00	1	0	-1
0007	3T	5_3	162	17	0	1700	0	-1700	0.00	0.00	3	0	-3
0007	3T	5_3	163	14	2	1400	3290	1890	0.14	2.35	2	5	3
0007	3T	5_3	164	13	0	1300	0	-1300	0.00	0.00	2	0	-2
0007	3T	5_3	165	10	0	1000	0	-1000	0.00	0.00	1	0	-1
0007	3T	5_3	213	15	0	1500	0	-1500	0.00	0.00	2	0	-2
0007	3T	5_3	214	12	1	1200	960	-240	0.08	0.80	2	1	-1
0007	3T	5_3	215	9	1	900	3800	2900	0.11	4.22	1	6	5
0007	3T	5_3	216	13	1	1300	4600	3300	0.08	3.54	2	8	6
0007	3T	5_3	231	8	0	800	0	-800	0.00	0.00	1	0	-1
0007	3T	5_3	234	9	0	900	0	-900	0.00	0.00	1	0	-1
0007	3T	5_3	235	8	0	800	0	-800	0.00	0.00	1	0	-1
0007	3T	5_3	236	4	0	400	0	-400	0.00	0.00	0	0	0
0007	3T	5_3	241	1	0	100	0	-100	0.00	0.00	0	0	0
0007	3T	5_3	243	5	0	500	0	-500	0.00	0.00	0	0	0
0007	3T	5_3	245	5	0	500	0	-500	0.00	0.00	0	0	0
0007	3T	5_3	246	4	0	400	0	-400	0.00	0.00	0	0	0
0007	3T	5_3	251	2	0	200	0	-200	0.00	0.00	0	0	0
0007	3T	5_3	253	1	0	100	0	-100	0.00	0.00	0	0	0
0007	3T	5_3	254	3	0	300	0	-300	0.00	0.00	0	0	0
0007	3T	5_3	261	1	0	100	0	-100	0.00	0.00	0	0	0
0007	3T	5_3	264	1	0	100	0	-100	0.00	0.00	0	0	0
0007	3T	5_4	123	147	22	14700	21510	6810	0.15	1.46	26	38	12
0007	3T	5_4	124	148	11	14800	16800	2000	0.07	1.14	26	29	3
0007	3T	5_4	125	94	7	9400	8280	-1120	0.07	0.88	16	14	-2
0007	3T	5_4	126	78	2	7800	1800	-6000	0.03	0.23	13	3	-10
0007	3T	5_4	132	80	6	8000	5040	-2960	0.08	0.63	14	8	-6
0007	3T	5_4	134	87	4	8700	6370	-2330	0.05	0.73	15	11	-4
0007	3T	5_4	135	79	3	7900	3630	-4270	0.04	0.46	13	6	-7
0007	3T	5_4	136	53	2	5300	4370	-930	0.04	0.82	9	7	-2
0007	3T	5_4	142	57	4	5700	3410	-2290	0.07	0.60	10	6	-4
0007	3T	5_4	143	46	1	4600	900	-3700	0.02	0.20	8	1	-7
0007	3T	5_4	145	46	3	4600	4260	-340	0.07	0.93	8	7	-1
0007	3T	5_4	146	35	0	3500	0	-3500	0.00	0.00	6	0	-6
0007	3T	5_4	152	19	2	1900	3030	1130	0.11	1.59	3	5	2
0007	3T	5_4	153	17	0	1700	0	-1700	0.00	0.00	3	0	-3
0007	3T	5_4	154	12	1	1200	3310	2110	0.08	2.76	2	5	3
0007	3T	5_4	156	12	0	1200	0	-1200	0.00	0.00	2	0	-2
0007	3T	5_4	162	10	0	1000	0	-1000	0.00	0.00	1	0	-1
0007	3T	5_4	163	9	1	900	630	-270	0.11	0.70	1	1	0
0007	3T	5_4	164	4	1	400	2460	2060	0.25	6.15	0	4	4
0007	3T	5_4	165	4	0	400	0	-400	0.00	0.00	0	0	0
0007	3T	5_4	213	9	0	900	0	-900	0.00	0.00	1	0	-1
0007	3T	5_4	214	6	0	600	0	-600	0.00	0.00	1	0	-1
0007	3T	5_4	215	5	0	500	0	-500	0.00	0.00	0	0	0
0007	3T	5_4	216	3	0	300	0	-300	0.00	0.00	0	0	0
0007	3T	5_4	231	4	0	400	0	-400	0.00	0.00	0	0	0
0007	3T	5_4	234	3	0	300	0	-300	0.00	0.00	0	0	0
0007	3T	5_4	235	6	0	600	0	-600	0.00	0.00	1	0	-1
0007	3T	5_4	236	4	0	400	0	-400	0.00	0.00	0	0	0
0007	3T	5_4	243	1	0	100	0	-100	0.00	0.00	0	0	0
0007	3T	5_4	246	1	0	100	0	-100	0.00	0.00	0	0	0
0007	3T	5_4	251	1	0	100	0	-100	0.00	0.00	0	0	0
0007	3T	5_4	256	1	0	100	0	-100	0.00	0.00	0	0	0
0007	3T	5_4	261	1	0	100	0	-100	0.00	0.00	0	0	0
0007	3T	5_5	123	120	9	12000	4620	-7380	0.08	0.39	21	8	-13
0007	3T	5_5	124	115	12	11500	8060	-3440	0.10	0.70	20	14	-6
0007	3T	5_5	125	86	7	8600	7020	-1580	0.08	0.82	15	12	-3
0007	3T	5_5	126	55	2	5500	3200	-2300	0.04	0.58	9	5	-4
0007	3T	5_5	132	47	4	4700	2890	-1810	0.09	0.61	8	5	-3
0007	3T	5_5	134	54	6	5400	6810	1410	0.11	1.26	9	12	3
0007	3T	5_5	135	48	4	4800	8500	3700	0.08	1.77	8	15	7
0007	3T	5_5	136	21	0	2100	0	-2100	0.00	0.00	3	0	-3
0007	3T	5_5	142	28	1	2800	1410	-1390	0.04	0.50	4	2	-2
0007	3T	5_5	143	16	0	1600	0	-1600	0.00	0.00	2	0	-2
0007	3T	5_5	145	26	1	2600	1210	-1390	0.04	0.47	4	2	-2
0007	3T	5_5	146	16	1	1600	7080	5480	0.06	4.43	2	12	10
0007	3T	5_5	152	3	0	300	0	-300	0.00	0.00	0	0	0
0007	3T	5_5	153	9	0	900	0	-900	0.00	0.00	1	0	-1
0007	3T	5_5	154	13	0	1300	0	-1300	0.00	0.00	2	0	-2
0007	3T	5_5	156	11	0	1100	0	-1100	0.00	0.00	1	0	-1
0007	3T	5_5	162	2	0	200	0	-200	0.00	0.00	0	0	0
0007	3T	5_5	163	1	0	100	0	-100	0.00	0.00	0	0	0
0007	3T	5_5	165	1	0	100	0	-100	0.00	0.00	0	0	0
0007	3T	5_5	213	2	0	200	0	-200	0.00	0.00	0	0	0
0007	3T	5_5	214	7	0	700	0	-700	0.00	0.00	1	0	-1
0007	3T	5_5	215	4	0	400	0	-400	0.00	0.00	0	0	0
0007	3T	5_5	234	3	0	300	0	-300	0.00	0.00	0	0	0
0007	3T	5_5	235	1	0	100	0	-100	0.00	0.00	0	0	0
0007	3T	5_5	251	1	0	100	0	-100	0.00	0.00	0	0	0
0007	3T	5_5	254	2	0	200	0	-200	0.00	0.00	0	0	0
0007	3T	5_6	123	35	5	3500	2620	-880	0.14	0.75	6	4	-2
0007	3T	5_6	124	37	6	3700	4580	880	0.16	1.24	6	8	2
0007	3T	5_6	125	29	3	2900	6720	3820	0.10	2.32	5	11	6
0007	3T	5_6	126	22	0	2200	0	-2200	0.00	0.00	3	0	-3
0007	3T	5_6	132	18	2	1800	1610	-190	0.11	0.89	3	2	-1
0007	3T	5_6	134	24	1	2400	1320	-1080	0.04	0.55	4	2	-2
0007	3T	5_6	135	14	0	1400	0	-1400	0.00	0.00	2	0	-2
0007	3T	5_6	136	7	0	700	0	-700	0.00	0.00	1	0	-1
0007	3T	5_6	142	4	1	400	1510	1110	0.25	3.78	0	2	2
0007	3T	5_6	143	3	1	300	3320	3020	0.33	11.07	0	5	5
0007	3T	5_6	145	4	1	400	1450	1050	0.25	3.63	0	2	2
0007	3T	5_6	146	2	0	200	0	-200	0.00	0.00	0	0	0
0007	3T	5_6	152	4	0	400	0	-400	0.00	0.00	0	0	0
0007	3T	5_6	153	4	0	400	0	-400	0.00	0.00	0	0	0
0007	3T	5_6	154	4	0	400	0	-400	0.00	0.00	0	0	0
0007	3T	5_6	156	4	0	400	0	-400	0.00	0.00	0	0	0
0007	3T	5_6	162	2	0	200	0	-200	0.00	0.00	0	0	0
0007	3T	5_6	163	4	0	400	0	-400	0.00	0.00	0	0	0
0007	3T	5_6	213	2	0	200	0	-200	0.00	0.00	0	0	0
0007	3T	5_6	214	2	0	200	0	-200	0.00	0.00	0	0	0
0007	3T	5_6	245	1	0	100	0	-100	0.00	0.00	0	0	0
0007	3T	5_6	264	1	0	100	0	-100	0.00	0.00	0	0	0
0007	3T	6_0	123	6	0	600	0	-600	0.00	0.00	1	0	-1
0007	3T	6_0	124	1	0	100	0	-100	0.00	0.00	0	0	0
0007	3T	6_0	125	1	1	100	2970	2870	1.00	29.70	0	5	5
0007	3T	6_0	132	4	1	400	630	230	0.25	1.58	0	1	1
0007	3T	6_0	134	4	0	400	0	-400	0.00	0.00	0	0	0
0007	3T	6_0	136	1	0	100	0	-100	0.00	0.00	0	0	0
0007	3T	6_0	142	1	0	100	0	-100	0.00	0.00	0	0	0
0007	3T	6_0	143	2	0	200	0	-200	0.00	0.00	0	0	0
0007	3T	6_0	152	1	0	100	0	-100	0.00	0.00	0	0	0
0007	3T	6_0	153	1	0	100	0	-100	0.00	0.00	0	0	0
0007	3T	6_0	154	1	0	100	0	-100	0.00	0.00	0	0	0
0007	3T	6_0	156	2	0	200	0	-200	0.00	0.00	0	0	0
0007	3T	6_0	162	1	0	100	0	-100	0.00	0.00	0	0	0
0007	3T	6_0	213	1	0	100	0	-100	0.00	0.00	0	0	0
0007	3T	6_0	231	1	0	100	0	-100	0.00	0.00	0	0	0
0007	3T	6_0	236	1	0	100	0	-100	0.00	0.00	0	0	0
0007	3T	6_0	251	1	0	100	0	-100	0.00	0.00	0	0	0
0007	3T	6_0	253	1	0	100	0	-100	0.00	0.00	0	0	0
0007	3T	6_1	123	12	1	1200	560	-640	0.08	0.47	2	0	-2
0007	3T	6_1	124	5	1	500	560	60	0.20	1.12	0	0	0
0007	3T	6_1	125	2	0	200	0	-200	0.00	0.00	0	0	0
0007	3T	6_1	126	1	0	100	0	-100	0.00	0.00	0	0	0
0007	3T	6_1	132	3	0	300	0	-300	0.00	0.00	0	0	0
0007	3T	6_1	134	4	1	400	680	280	0.25	1.70	0	1	1
0007	3T	6_1	135	4	0	400	0	-400	0.00	0.00	0	0	0
0007	3T	6_1	136	3	0	300	0	-300	0.00	0.00	0	0	0
0007	3T	6_1	142	2	0	200	0	-200	0.00	0.00	0	0	0
0007	3T	6_1	143	3	0	300	0	-300	0.00	0.00	0	0	0
0007	3T	6_1	145	1	0	100	0	-100	0.00	0.00	0	0	0
0007	3T	6_1	146	3	0	300	0	-300	0.00	0.00	0	0	0
0007	3T	6_1	152	1	0	100	0	-100	0.00	0.00	0	0	0
0007	3T	6_1	153	1	0	100	0	-100	0.00	0.00	0	0	0
0007	3T	6_1	154	1	0	100	0	-100	0.00	0.00	0	0	0
0007	3T	6_1	156	1	0	100	0	-100	0.00	0.00	0	0	0
0007	3T	6_1	214	1	0	100	0	-100	0.00	0.00	0	0	0
0007	3T	6_1	215	1	0	100	0	-100	0.00	0.00	0	0	0
0007	3T	6_2	123	9	0	900	0	-900	0.00	0.00	1	0	-1
0007	3T	6_2	124	12	2	1200	2040	840	0.17	1.70	2	3	1
0007	3T	6_2	125	2	0	200	0	-200	0.00	0.00	0	0	0
0007	3T	6_2	126	2	0	200	0	-200	0.00	0.00	0	0	0
0007	3T	6_2	132	7	0	700	0	-700	0.00	0.00	1	0	-1
0007	3T	6_2	134	4	0	400	0	-400	0.00	0.00	0	0	0
0007	3T	6_2	135	4	0	400	0	-400	0.00	0.00	0	0	0
0007	3T	6_2	136	4	1	400	690	290	0.25	1.73	0	1	1
0007	3T	6_2	143	2	0	200	0	-200	0.00	0.00	0	0	0
0007	3T	6_2	145	5	0	500	0	-500	0.00	0.00	0	0	0
0007	3T	6_2	146	1	0	100	0	-100	0.00	0.00	0	0	0
0007	3T	6_2	152	2	0	200	0	-200	0.00	0.00	0	0	0
0007	3T	6_2	153	2	0	200	0	-200	0.00	0.00	0	0	0
0007	3T	6_2	154	1	0	100	0	-100	0.00	0.00	0	0	0
0007	3T	6_2	156	1	0	100	0	-100	0.00	0.00	0	0	0
0007	3T	6_2	214	1	0	100	0	-100	0.00	0.00	0	0	0
0007	3T	6_2	265	1	0	100	0	-100	0.00	0.00	0	0	0
0007	3T	6_3	123	17	0	1700	0	-1700	0.00	0.00	3	0	-3
0007	3T	6_3	124	15	1	1500	440	-1060	0.07	0.29	2	0	-2
0007	3T	6_3	125	9	0	900	0	-900	0.00	0.00	1	0	-1
0007	3T	6_3	126	2	0	200	0	-200	0.00	0.00	0	0	0
0007	3T	6_3	132	10	1	1000	450	-550	0.10	0.45	1	0	-1
0007	3T	6_3	134	12	2	1200	1360	160	0.17	1.13	2	2	0
0007	3T	6_3	135	7	0	700	0	-700	0.00	0.00	1	0	-1
0007	3T	6_3	136	5	1	500	2830	2330	0.20	5.66	0	5	5
0007	3T	6_3	142	4	0	400	0	-400	0.00	0.00	0	0	0
0007	3T	6_3	143	5	0	500	0	-500	0.00	0.00	0	0	0
0007	3T	6_3	145	4	0	400	0	-400	0.00	0.00	0	0	0
0007	3T	6_3	146	1	0	100	0	-100	0.00	0.00	0	0	0
0007	3T	6_3	152	2	0	200	0	-200	0.00	0.00	0	0	0
0007	3T	6_3	153	6	0	600	0	-600	0.00	0.00	1	0	-1
0007	3T	6_3	154	1	0	100	0	-100	0.00	0.00	0	0	0
0007	3T	6_3	156	2	0	200	0	-200	0.00	0.00	0	0	0
0007	3T	6_3	162	1	1	100	6760	6660	1.00	67.60	0	11	11
0007	3T	6_3	163	4	0	400	0	-400	0.00	0.00	0	0	0
0007	3T	6_3	164	2	0	200	0	-200	0.00	0.00	0	0	0
0007	3T	6_3	165	2	0	200	0	-200	0.00	0.00	0	0	0
0007	3T	6_3	213	1	1	100	2490	2390	1.00	24.90	0	4	4
0007	3T	6_3	215	1	0	100	0	-100	0.00	0.00	0	0	0
0007	3T	6_3	216	1	0	100	0	-100	0.00	0.00	0	0	0
0007	3T	6_3	234	1	0	100	0	-100	0.00	0.00	0	0	0
0007	3T	6_3	235	1	0	100	0	-100	0.00	0.00	0	0	0
0007	3T	6_3	236	1	0	100	0	-100	0.00	0.00	0	0	0
0007	3T	6_3	246	1	0	100	0	-100	0.00	0.00	0	0	0
0007	3T	6_3	253	1	0	100	0	-100	0.00	0.00	0	0	0
0007	3T	6_3	263	1	0	100	0	-100	0.00	0.00	0	0	0
0007	3T	6_4	123	15	0	1500	0	-1500	0.00	0.00	2	0	-2
0007	3T	6_4	124	20	1	2000	600	-1400	0.05	0.30	3	1	-2
0007	3T	6_4	125	11	2	1100	5460	4360	0.18	4.96	1	9	8
0007	3T	6_4	126	7	0	700	0	-700	0.00	0.00	1	0	-1
0007	3T	6_4	132	7	1	700	990	290	0.14	1.41	1	1	0
0007	3T	6_4	134	10	1	1000	750	-250	0.10	0.75	1	1	0
0007	3T	6_4	135	5	0	500	0	-500	0.00	0.00	0	0	0
0007	3T	6_4	136	6	0	600	0	-600	0.00	0.00	1	0	-1
0007	3T	6_4	142	6	0	600	0	-600	0.00	0.00	1	0	-1
0007	3T	6_4	143	3	0	300	0	-300	0.00	0.00	0	0	0
0007	3T	6_4	145	6	1	600	820	220	0.17	1.37	1	1	0
0007	3T	6_4	146	1	0	100	0	-100	0.00	0.00	0	0	0
0007	3T	6_4	153	1	0	100	0	-100	0.00	0.00	0	0	0
0007	3T	6_4	154	4	0	400	0	-400	0.00	0.00	0	0	0
0007	3T	6_4	156	4	0	400	0	-400	0.00	0.00	0	0	0
0007	3T	6_4	163	1	0	100	0	-100	0.00	0.00	0	0	0
0007	3T	6_4	164	2	0	200	0	-200	0.00	0.00	0	0	0
0007	3T	6_4	214	1	0	100	0	-100	0.00	0.00	0	0	0
0007	3T	6_5	123	11	2	1100	1240	140	0.18	1.13	1	2	1
0007	3T	6_5	124	7	1	700	830	130	0.14	1.19	1	1	0
0007	3T	6_5	125	3	0	300	0	-300	0.00	0.00	0	0	0
0007	3T	6_5	126	5	0	500	0	-500	0.00	0.00	0	0	0
0007	3T	6_5	132	4	0	400	0	-400	0.00	0.00	0	0	0
0007	3T	6_5	134	7	0	700	0	-700	0.00	0.00	1	0	-1
0007	3T	6_5	135	1	0	100	0	-100	0.00	0.00	0	0	0
0007	3T	6_5	136	3	0	300	0	-300	0.00	0.00	0	0	0
0007	3T	6_5	142	2	0	200	0	-200	0.00	0.00	0	0	0
0007	3T	6_5	143	1	0	100	0	-100	0.00	0.00	0	0	0
0007	3T	6_5	145	2	0	200	0	-200	0.00	0.00	0	0	0
0007	3T	6_5	153	2	0	200	0	-200	0.00	0.00	0	0	0
0007	3T	6_5	165	1	0	100	0	-100	0.00	0.00	0	0	0
0007	3T	6_6	123	5	0	500	0	-500	0.00	0.00	0	0	0
0007	3T	6_6	124	4	1	400	870	470	0.25	2.18	0	1	1
0007	3T	6_6	125	3	0	300	0	-300	0.00	0.00	0	0	0
0007	3T	6_6	126	3	0	300	0	-300	0.00	0.00	0	0	0
0007	3T	6_6	134	3	0	300	0	-300	0.00	0.00	0	0	0
0007	3T	6_6	135	1	0	100	0	-100	0.00	0.00	0	0	0
0007	3T	6_6	136	1	0	100	0	-100	0.00	0.00	0	0	0
0007	3T	6_6	142	3	0	300	0	-300	0.00	0.00	0	0	0
0007	3T	6_6	143	1	0	100	0	-100	0.00	0.00	0	0	0
0007	3T	6_6	213	1	0	100	0	-100	0.00	0.00	0	0	0
0007	3T	7_0	123	84	3	8400	1990	-6410	0.04	0.24	14	3	-11
0007	3T	7_0	124	67	6	6700	5830	-870	0.09	0.87	11	10	-1
0007	3T	7_0	125	45	4	4500	6080	1580	0.09	1.35	7	10	3
0007	3T	7_0	126	26	2	2600	3340	740	0.08	1.28	4	5	1
0007	3T	7_0	132	56	2	5600	1530	-4070	0.04	0.27	9	2	-7
0007	3T	7_0	134	44	4	4400	7280	2880	0.09	1.65	7	12	5
0007	3T	7_0	135	29	3	2900	3390	490	0.10	1.17	5	6	1
0007	3T	7_0	136	19	1	1900	2900	1000	0.05	1.53	3	5	2
0007	3T	7_0	142	23	0	2300	0	-2300	0.00	0.00	4	0	-4
0007	3T	7_0	143	22	1	2200	3300	1100	0.05	1.50	3	5	2
0007	3T	7_0	145	9	0	900	0	-900	0.00	0.00	1	0	-1
0007	3T	7_0	146	6	0	600	0	-600	0.00	0.00	1	0	-1
0007	3T	7_0	152	10	0	1000	0	-1000	0.00	0.00	1	0	-1
0007	3T	7_0	153	21	1	2100	2520	420	0.05	1.20	3	4	1
0007	3T	7_0	154	7	0	700	0	-700	0.00	0.00	1	0	-1
0007	3T	7_0	156	3	0	300	0	-300	0.00	0.00	0	0	0
0007	3T	7_0	162	6	0	600	0	-600	0.00	0.00	1	0	-1
0007	3T	7_0	163	8	0	800	0	-800	0.00	0.00	1	0	-1
0007	3T	7_0	164	2	0	200	0	-200	0.00	0.00	0	0	0
0007	3T	7_0	165	3	0	300	0	-300	0.00	0.00	0	0	0
0007	3T	7_0	213	9	0	900	0	-900	0.00	0.00	1	0	-1
0007	3T	7_0	214	6	0	600	0	-600	0.00	0.00	1	0	-1
0007	3T	7_0	215	3	0	300	0	-300	0.00	0.00	0	0	0
0007	3T	7_0	216	7	0	700	0	-700	0.00	0.00	1	0	-1
0007	3T	7_0	231	6	0	600	0	-600	0.00	0.00	1	0	-1
0007	3T	7_0	234	10	1	1000	8560	7560	0.10	8.56	1	15	14
0007	3T	7_0	235	8	0	800	0	-800	0.00	0.00	1	0	-1
0007	3T	7_0	236	2	0	200	0	-200	0.00	0.00	0	0	0
0007	3T	7_0	241	5	0	500	0	-500	0.00	0.00	0	0	0
0007	3T	7_0	243	10	0	1000	0	-1000	0.00	0.00	1	0	-1
0007	3T	7_0	245	3	0	300	0	-300	0.00	0.00	0	0	0
0007	3T	7_0	246	2	0	200	0	-200	0.00	0.00	0	0	0
0007	3T	7_0	251	1	0	100	0	-100	0.00	0.00	0	0	0
0007	3T	7_0	253	2	0	200	0	-200	0.00	0.00	0	0	0
0007	3T	7_0	254	1	0	100	0	-100	0.00	0.00	0	0	0
0007	3T	7_0	261	2	0	200	0	-200	0.00	0.00	0	0	0
0007	3T	7_0	263	2	0	200	0	-200	0.00	0.00	0	0	0
0007	3T	7_0	264	1	0	100	0	-100	0.00	0.00	0	0	0
0007	3T	7_0	265	1	0	100	0	-100	0.00	0.00	0	0	0
0007	3T	7_1	123	262	35	26200	26600	400	0.13	1.02	46	47	1
0007	3T	7_1	124	192	14	19200	15260	-3940	0.07	0.79	33	27	-6
0007	3T	7_1	125	106	8	10600	9650	-950	0.08	0.91	18	17	-1
0007	3T	7_1	126	56	5	5600	8520	2920	0.09	1.52	9	15	6
0007	3T	7_1	132	162	10	16200	9000	-7200	0.06	0.56	28	15	-13
0007	3T	7_1	134	107	13	10700	11870	1170	0.12	1.11	18	21	3
0007	3T	7_1	135	88	5	8800	11160	2360	0.06	1.27	15	19	4
0007	3T	7_1	136	62	4	6200	4260	-1940	0.06	0.69	10	7	-3
0007	3T	7_1	142	83	2	8300	3320	-4980	0.02	0.40	14	5	-9
0007	3T	7_1	143	68	1	6800	1200	-5600	0.01	0.18	12	2	-10
0007	3T	7_1	145	41	2	4100	2810	-1290	0.05	0.69	7	4	-3
0007	3T	7_1	146	27	0	2700	0	-2700	0.00	0.00	4	0	-4
0007	3T	7_1	152	38	1	3800	4360	560	0.03	1.15	6	7	1
0007	3T	7_1	153	29	1	2900	1440	-1460	0.03	0.50	5	2	-3
0007	3T	7_1	154	27	0	2700	0	-2700	0.00	0.00	4	0	-4
0007	3T	7_1	156	18	0	1800	0	-1800	0.00	0.00	3	0	-3
0007	3T	7_1	162	14	0	1400	0	-1400	0.00	0.00	2	0	-2
0007	3T	7_1	163	5	0	500	0	-500	0.00	0.00	0	0	0
0007	3T	7_1	164	6	0	600	0	-600	0.00	0.00	1	0	-1
0007	3T	7_1	165	7	0	700	0	-700	0.00	0.00	1	0	-1
0007	3T	7_1	213	12	0	1200	0	-1200	0.00	0.00	2	0	-2
0007	3T	7_1	214	9	0	900	0	-900	0.00	0.00	1	0	-1
0007	3T	7_1	215	11	0	1100	0	-1100	0.00	0.00	1	0	-1
0007	3T	7_1	216	4	0	400	0	-400	0.00	0.00	0	0	0
0007	3T	7_1	231	5	0	500	0	-500	0.00	0.00	0	0	0
0007	3T	7_1	234	12	0	1200	0	-1200	0.00	0.00	2	0	-2
0007	3T	7_1	235	5	0	500	0	-500	0.00	0.00	0	0	0
0007	3T	7_1	236	6	1	600	12340	11740	0.17	20.57	1	21	20
0007	3T	7_1	241	4	0	400	0	-400	0.00	0.00	0	0	0
0007	3T	7_1	243	4	0	400	0	-400	0.00	0.00	0	0	0
0007	3T	7_1	245	2	0	200	0	-200	0.00	0.00	0	0	0
0007	3T	7_1	246	3	0	300	0	-300	0.00	0.00	0	0	0
0007	3T	7_1	251	3	0	300	0	-300	0.00	0.00	0	0	0
0007	3T	7_1	253	4	0	400	0	-400	0.00	0.00	0	0	0
0007	3T	7_1	254	2	0	200	0	-200	0.00	0.00	0	0	0
0007	3T	7_1	256	3	0	300	0	-300	0.00	0.00	0	0	0
0007	3T	7_1	263	1	0	100	0	-100	0.00	0.00	0	0	0
0007	3T	7_1	264	1	0	100	0	-100	0.00	0.00	0	0	0
0007	3T	7_1	265	1	0	100	0	-100	0.00	0.00	0	0	0
0007	3T	7_2	123	322	35	32200	36630	4430	0.11	1.14	56	64	8
0007	3T	7_2	124	297	31	29700	33080	3380	0.10	1.11	52	58	6
0007	3T	7_2	125	176	9	17600	12750	-4850	0.05	0.72	31	22	-9
0007	3T	7_2	126	104	8	10400	16000	5600	0.08	1.54	18	28	10
0007	3T	7_2	132	202	17	20200	15740	-4460	0.08	0.78	35	27	-8
0007	3T	7_2	134	162	12	16200	14100	-2100	0.07	0.87	28	24	-4
0007	3T	7_2	135	113	5	11300	5160	-6140	0.04	0.46	20	9	-11
0007	3T	7_2	136	80	9	8000	8970	970	0.11	1.12	14	15	1
0007	3T	7_2	142	119	9	11900	13740	1840	0.08	1.15	21	24	3
0007	3T	7_2	143	133	8	13300	10770	-2530	0.06	0.81	23	19	-4
0007	3T	7_2	145	69	3	6900	2740	-4160	0.04	0.40	12	4	-8
0007	3T	7_2	146	40	2	4000	1560	-2440	0.05	0.39	7	2	-5
0007	3T	7_2	152	40	1	4000	530	-3470	0.03	0.13	7	0	-7
0007	3T	7_2	153	24	1	2400	1150	-1250	0.04	0.48	4	2	-2
0007	3T	7_2	154	41	3	4100	3310	-790	0.07	0.81	7	5	-2
0007	3T	7_2	156	23	0	2300	0	-2300	0.00	0.00	4	0	-4
0007	3T	7_2	162	21	1	2100	620	-1480	0.05	0.30	3	1	-2
0007	3T	7_2	163	17	1	1700	3700	2000	0.06	2.18	3	6	3
0007	3T	7_2	164	25	1	2500	760	-1740	0.04	0.30	4	1	-3
0007	3T	7_2	165	11	0	1100	0	-1100	0.00	0.00	1	0	-1
0007	3T	7_2	213	20	1	2000	630	-1370	0.05	0.32	3	1	-2
0007	3T	7_2	214	22	0	2200	0	-2200	0.00	0.00	3	0	-3
0007	3T	7_2	215	15	0	1500	0	-1500	0.00	0.00	2	0	-2
0007	3T	7_2	216	12	0	1200	0	-1200	0.00	0.00	2	0	-2
0007	3T	7_2	231	12	0	1200	0	-1200	0.00	0.00	2	0	-2
0007	3T	7_2	234	18	0	1800	0	-1800	0.00	0.00	3	0	-3
0007	3T	7_2	235	12	0	1200	0	-1200	0.00	0.00	2	0	-2
0007	3T	7_2	236	7	0	700	0	-700	0.00	0.00	1	0	-1
0007	3T	7_2	241	8	0	800	0	-800	0.00	0.00	1	0	-1
0007	3T	7_2	243	4	0	400	0	-400	0.00	0.00	0	0	0
0007	3T	7_2	245	5	0	500	0	-500	0.00	0.00	0	0	0
0007	3T	7_2	246	7	0	700	0	-700	0.00	0.00	1	0	-1
0007	3T	7_2	251	4	0	400	0	-400	0.00	0.00	0	0	0
0007	3T	7_2	253	5	0	500	0	-500	0.00	0.00	0	0	0
0007	3T	7_2	254	5	0	500	0	-500	0.00	0.00	0	0	0
0007	3T	7_2	256	5	0	500	0	-500	0.00	0.00	0	0	0
0007	3T	7_2	263	3	0	300	0	-300	0.00	0.00	0	0	0
0007	3T	7_2	264	2	0	200	0	-200	0.00	0.00	0	0	0
0007	3T	7_2	265	2	0	200	0	-200	0.00	0.00	0	0	0
0007	3T	7_3	123	340	41	34000	33670	-330	0.12	0.99	60	59	-1
0007	3T	7_3	124	338	24	33800	25310	-8490	0.07	0.75	59	44	-15
0007	3T	7_3	125	190	15	19000	23790	4790	0.08	1.25	33	42	9
0007	3T	7_3	126	166	7	16600	14360	-2240	0.04	0.87	29	25	-4
0007	3T	7_3	132	152	13	15200	13450	-1750	0.09	0.88	26	23	-3
0007	3T	7_3	134	173	12	17300	16760	-540	0.07	0.97	30	29	-1
0007	3T	7_3	135	140	15	14000	13690	-310	0.11	0.98	24	24	0
0007	3T	7_3	136	106	7	10600	8840	-1760	0.07	0.83	18	15	-3
0007	3T	7_3	142	109	5	10900	5710	-5190	0.05	0.52	19	10	-9
0007	3T	7_3	143	104	4	10400	7830	-2570	0.04	0.75	18	13	-5
0007	3T	7_3	145	68	4	6800	10960	4160	0.06	1.61	12	19	7
0007	3T	7_3	146	59	0	5900	0	-5900	0.00	0.00	10	0	-10
0007	3T	7_3	152	37	1	3700	1150	-2550	0.03	0.31	6	2	-4
0007	3T	7_3	153	34	0	3400	0	-3400	0.00	0.00	6	0	-6
0007	3T	7_3	154	34	1	3400	1830	-1570	0.03	0.54	6	3	-3
0007	3T	7_3	156	23	0	2300	0	-2300	0.00	0.00	4	0	-4
0007	3T	7_3	162	23	1	2300	3130	830	0.04	1.36	4	5	1
0007	3T	7_3	163	24	1	2400	2230	-170	0.04	0.93	4	3	-1
0007	3T	7_3	164	18	0	1800	0	-1800	0.00	0.00	3	0	-3
0007	3T	7_3	165	8	0	800	0	-800	0.00	0.00	1	0	-1
0007	3T	7_3	213	22	2	2200	3690	1490	0.09	1.68	3	6	3
0007	3T	7_3	214	18	2	1800	2180	380	0.11	1.21	3	3	0
0007	3T	7_3	215	9	0	900	0	-900	0.00	0.00	1	0	-1
0007	3T	7_3	216	11	3	1100	10240	9140	0.27	9.31	1	18	17
0007	3T	7_3	231	3	0	300	0	-300	0.00	0.00	0	0	0
0007	3T	7_3	234	10	0	1000	0	-1000	0.00	0.00	1	0	-1
0007	3T	7_3	235	11	0	1100	0	-1100	0.00	0.00	1	0	-1
0007	3T	7_3	236	6	0	600	0	-600	0.00	0.00	1	0	-1
0007	3T	7_3	241	3	0	300	0	-300	0.00	0.00	0	0	0
0007	3T	7_3	243	9	0	900	0	-900	0.00	0.00	1	0	-1
0007	3T	7_3	245	5	0	500	0	-500	0.00	0.00	0	0	0
0007	3T	7_3	246	6	0	600	0	-600	0.00	0.00	1	0	-1
0007	3T	7_3	251	2	0	200	0	-200	0.00	0.00	0	0	0
0007	3T	7_3	253	4	0	400	0	-400	0.00	0.00	0	0	0
0007	3T	7_3	254	2	0	200	0	-200	0.00	0.00	0	0	0
0007	3T	7_3	256	3	0	300	0	-300	0.00	0.00	0	0	0
0007	3T	7_3	261	3	0	300	0	-300	0.00	0.00	0	0	0
0007	3T	7_3	263	2	0	200	0	-200	0.00	0.00	0	0	0
0007	3T	7_3	265	1	0	100	0	-100	0.00	0.00	0	0	0
0007	3T	7_4	123	178	21	17800	15660	-2140	0.12	0.88	31	27	-4
0007	3T	7_4	124	191	18	19100	15990	-3110	0.09	0.84	33	28	-5
0007	3T	7_4	125	90	8	9000	11430	2430	0.09	1.27	15	20	5
0007	3T	7_4	126	94	4	9400	6000	-3400	0.04	0.64	16	10	-6
0007	3T	7_4	132	82	5	8200	8420	220	0.06	1.03	14	14	0
0007	3T	7_4	134	82	5	8200	4840	-3360	0.06	0.59	14	8	-6
0007	3T	7_4	135	68	3	6800	3540	-3260	0.04	0.52	12	6	-6
0007	3T	7_4	136	53	1	5300	1180	-4120	0.02	0.22	9	2	-7
0007	3T	7_4	142	49	3	4900	6400	1500	0.06	1.31	8	11	3
0007	3T	7_4	143	45	3	4500	5800	1300	0.07	1.29	7	10	3
0007	3T	7_4	145	50	1	5000	760	-4240	0.02	0.15	8	1	-7
0007	3T	7_4	146	24	1	2400	2830	430	0.04	1.18	4	5	1
0007	3T	7_4	152	12	1	1200	2480	1280	0.08	2.07	2	4	2
0007	3T	7_4	153	12	0	1200	0	-1200	0.00	0.00	2	0	-2
0007	3T	7_4	154	17	1	1700	2720	1020	0.06	1.60	3	4	1
0007	3T	7_4	156	15	2	1500	4930	3430	0.13	3.29	2	8	6
0007	3T	7_4	162	3	0	300	0	-300	0.00	0.00	0	0	0
0007	3T	7_4	163	12	0	1200	0	-1200	0.00	0.00	2	0	-2
0007	3T	7_4	164	7	0	700	0	-700	0.00	0.00	1	0	-1
0007	3T	7_4	165	1	0	100	0	-100	0.00	0.00	0	0	0
0007	3T	7_4	213	5	0	500	0	-500	0.00	0.00	0	0	0
0007	3T	7_4	214	4	0	400	0	-400	0.00	0.00	0	0	0
0007	3T	7_4	215	3	0	300	0	-300	0.00	0.00	0	0	0
0007	3T	7_4	216	5	0	500	0	-500	0.00	0.00	0	0	0
0007	3T	7_4	231	1	0	100	0	-100	0.00	0.00	0	0	0
0007	3T	7_4	234	3	0	300	0	-300	0.00	0.00	0	0	0
0007	3T	7_4	235	1	0	100	0	-100	0.00	0.00	0	0	0
0007	3T	7_4	236	3	0	300	0	-300	0.00	0.00	0	0	0
0007	3T	7_4	241	1	0	100	0	-100	0.00	0.00	0	0	0
0007	3T	7_4	243	4	0	400	0	-400	0.00	0.00	0	0	0
0007	3T	7_4	245	2	0	200	0	-200	0.00	0.00	0	0	0
0007	3T	7_4	246	1	0	100	0	-100	0.00	0.00	0	0	0
0007	3T	7_4	253	4	1	400	4950	4550	0.25	12.38	0	8	8
0007	3T	7_4	254	1	0	100	0	-100	0.00	0.00	0	0	0
0007	3T	7_4	263	1	0	100	0	-100	0.00	0.00	0	0	0
0007	3T	7_5	123	131	18	13100	12720	-380	0.14	0.97	23	22	-1
0007	3T	7_5	124	138	8	13800	5840	-7960	0.06	0.42	24	10	-14
0007	3T	7_5	125	75	6	7500	7960	460	0.08	1.06	13	14	1
0007	3T	7_5	126	77	5	7700	8960	1260	0.06	1.16	13	15	2
0007	3T	7_5	132	54	5	5400	7770	2370	0.09	1.44	9	13	4
0007	3T	7_5	134	60	4	6000	8170	2170	0.07	1.36	10	14	4
0007	3T	7_5	135	37	5	3700	9570	5870	0.14	2.59	6	16	10
0007	3T	7_5	136	33	1	3300	2800	-500	0.03	0.85	5	4	-1
0007	3T	7_5	142	24	0	2400	0	-2400	0.00	0.00	4	0	-4
0007	3T	7_5	143	25	0	2500	0	-2500	0.00	0.00	4	0	-4
0007	3T	7_5	145	36	3	3600	7770	4170	0.08	2.16	6	13	7
0007	3T	7_5	146	21	0	2100	0	-2100	0.00	0.00	3	0	-3
0007	3T	7_5	152	10	1	1000	1880	880	0.10	1.88	1	3	2
0007	3T	7_5	153	12	1	1200	6230	5030	0.08	5.19	2	11	9
0007	3T	7_5	154	15	1	1500	5110	3610	0.07	3.41	2	9	7
0007	3T	7_5	156	2	0	200	0	-200	0.00	0.00	0	0	0
0007	3T	7_5	162	2	0	200	0	-200	0.00	0.00	0	0	0
0007	3T	7_5	163	5	0	500	0	-500	0.00	0.00	0	0	0
0007	3T	7_5	164	3	0	300	0	-300	0.00	0.00	0	0	0
0007	3T	7_5	165	2	0	200	0	-200	0.00	0.00	0	0	0
0007	3T	7_5	213	2	0	200	0	-200	0.00	0.00	0	0	0
0007	3T	7_5	214	6	0	600	0	-600	0.00	0.00	1	0	-1
0007	3T	7_5	231	1	0	100	0	-100	0.00	0.00	0	0	0
0007	3T	7_5	234	2	0	200	0	-200	0.00	0.00	0	0	0
0007	3T	7_5	251	1	0	100	0	-100	0.00	0.00	0	0	0
0007	3T	7_6	123	87	11	8700	7810	-890	0.13	0.90	15	13	-2
0007	3T	7_6	124	88	8	8800	6260	-2540	0.09	0.71	15	11	-4
0007	3T	7_6	125	62	4	6200	6360	160	0.06	1.03	10	11	1
0007	3T	7_6	126	50	0	5000	0	-5000	0.00	0.00	8	0	-8
0007	3T	7_6	132	33	2	3300	2410	-890	0.06	0.73	5	4	-1
0007	3T	7_6	134	25	2	2500	2470	-30	0.08	0.99	4	4	0
0007	3T	7_6	135	37	0	3700	0	-3700	0.00	0.00	6	0	-6
0007	3T	7_6	136	29	0	2900	0	-2900	0.00	0.00	5	0	-5
0007	3T	7_6	142	25	5	2500	9480	6980	0.20	3.79	4	16	12
0007	3T	7_6	143	25	2	2500	5950	3450	0.08	2.38	4	10	6
0007	3T	7_6	145	16	0	1600	0	-1600	0.00	0.00	2	0	-2
0007	3T	7_6	146	14	0	1400	0	-1400	0.00	0.00	2	0	-2
0007	3T	7_6	152	7	0	700	0	-700	0.00	0.00	1	0	-1
0007	3T	7_6	153	2	0	200	0	-200	0.00	0.00	0	0	0
0007	3T	7_6	154	10	0	1000	0	-1000	0.00	0.00	1	0	-1
0007	3T	7_6	156	7	0	700	0	-700	0.00	0.00	1	0	-1
0007	3T	7_6	162	2	0	200	0	-200	0.00	0.00	0	0	0
0007	3T	7_6	163	4	0	400	0	-400	0.00	0.00	0	0	0
0007	3T	7_6	164	3	0	300	0	-300	0.00	0.00	0	0	0
0007	3T	7_6	213	2	0	200	0	-200	0.00	0.00	0	0	0
0007	3T	7_6	216	1	0	100	0	-100	0.00	0.00	0	0	0
0007	3T	7_6	235	1	0	100	0	-100	0.00	0.00	0	0	0
0007	3T	7_6	236	1	0	100	0	-100	0.00	0.00	0	0	0
0007	3T	7_6	243	1	0	100	0	-100	0.00	0.00	0	0	0
0025	3T	13	146	65	3	6500	1970	-4530	0.05	0.30	11	3	-8
0025	3T	13	152	4	1	400	540	140	0.25	1.35	0	0	0
0025	3T	13	153	2	0	200	0	-200	0.00	0.00	0	0	0
0025	3T	13	154	2	0	200	0	-200	0.00	0.00	0	0	0
0025	3T	13	156	14	0	1400	0	-1400	0.00	0.00	2	0	-2
0025	3T	13	164	3	0	300	0	-300	0.00	0.00	0	0	0
0025	3T	13	165	2	0	200	0	-200	0.00	0.00	0	0	0
0025	3T	13	234	13	0	1300	0	-1300	0.00	0.00	2	0	-2
0025	3T	13	235	3	1	300	680	380	0.33	2.27	0	1	1
0025	3T	13	236	2	0	200	0	-200	0.00	0.00	0	0	0
0025	3T	13	245	2	0	200	0	-200	0.00	0.00	0	0	0
0025	3T	13	256	1	0	100	0	-100	0.00	0.00	0	0	0
0025	3T	14	123	319	35	31900	24860	-7040	0.11	0.78	56	44	-12
0025	3T	14	124	533	39	53300	34470	-18830	0.07	0.65	94	61	-33
0025	3T	14	125	245	16	24500	15420	-9080	0.07	0.63	43	27	-16
0025	3T	14	126	218	11	21800	20910	-890	0.05	0.96	38	37	-1
0025	3T	14	132	4	0	400	0	-400	0.00	0.00	0	0	0
0025	3T	14	134	114	7	11400	6710	-4690	0.06	0.59	20	11	-9
0025	3T	14	135	140	10	14000	11700	-2300	0.07	0.84	24	20	-4
0025	3T	14	136	131	4	13100	3630	-9470	0.03	0.28	23	6	-17
0025	3T	14	142	3	0	300	0	-300	0.00	0.00	0	0	0
0025	3T	14	143	21	3	2100	2180	80	0.14	1.04	3	3	0
0025	3T	14	145	56	0	5600	0	-5600	0.00	0.00	9	0	-9
0025	3T	14	146	40	0	4000	0	-4000	0.00	0.00	7	0	-7
0025	3T	14	152	1	0	100	0	-100	0.00	0.00	0	0	0
0025	3T	14	153	2	0	200	0	-200	0.00	0.00	0	0	0
0025	3T	14	156	13	2	1300	2760	1460	0.15	2.12	2	4	2
0025	3T	14	164	2	0	200	0	-200	0.00	0.00	0	0	0
0025	3T	14	214	2	0	200	0	-200	0.00	0.00	0	0	0
0025	3T	14	216	1	0	100	0	-100	0.00	0.00	0	0	0
0025	3T	14	234	8	0	800	0	-800	0.00	0.00	1	0	-1
0025	3T	14	235	8	0	800	0	-800	0.00	0.00	1	0	-1
0025	3T	14	236	11	0	1100	0	-1100	0.00	0.00	1	0	-1
0025	3T	14	245	2	0	200	0	-200	0.00	0.00	0	0	0
0025	3T	14	246	3	0	300	0	-300	0.00	0.00	0	0	0
0025	3T	14	256	1	0	100	0	-100	0.00	0.00	0	0	0
0025	3T	15	123	268	26	26800	22720	-4080	0.10	0.85	47	40	-7
0025	3T	15	124	761	76	76100	47740	-28360	0.10	0.63	134	84	-50
0025	3T	15	125	274	18	27400	25360	-2040	0.07	0.93	48	44	-4
0025	3T	15	126	317	16	31700	21350	-10350	0.05	0.67	56	37	-19
0025	3T	15	132	5	0	500	0	-500	0.00	0.00	0	0	0
0025	3T	15	134	234	25	23400	18720	-4680	0.11	0.80	41	33	-8
0025	3T	15	135	135	9	13500	8780	-4720	0.07	0.65	23	15	-8
0025	3T	15	136	150	12	15000	12660	-2340	0.08	0.84	26	22	-4
0025	3T	15	142	10	1	1000	650	-350	0.10	0.65	1	1	0
0025	3T	15	143	8	0	800	0	-800	0.00	0.00	1	0	-1
0025	3T	15	145	46	3	4600	3260	-1340	0.07	0.71	8	5	-3
0025	3T	15	146	55	4	5500	10170	4670	0.07	1.85	9	18	9
0025	3T	15	153	1	0	100	0	-100	0.00	0.00	0	0	0
0025	3T	15	156	29	0	2900	0	-2900	0.00	0.00	5	0	-5
0025	3T	15	163	1	0	100	0	-100	0.00	0.00	0	0	0
0025	3T	15	164	2	0	200	0	-200	0.00	0.00	0	0	0
0025	3T	15	165	1	0	100	0	-100	0.00	0.00	0	0	0
0025	3T	15	234	3	0	300	0	-300	0.00	0.00	0	0	0
0025	3T	15	235	6	1	600	1340	740	0.17	2.23	1	2	1
0025	3T	15	236	7	0	700	0	-700	0.00	0.00	1	0	-1
0025	3T	15	245	1	0	100	0	-100	0.00	0.00	0	0	0
0012	1T	1_1	1	6743	3273	674300	632890	-41410	0.49	0.94	1193	1120	-73
0012	1T	1_1	2	1173	383	117300	103010	-14290	0.33	0.88	207	182	-25
0012	1T	1_2	1	1101	684	110100	99390	-10710	0.62	0.90	194	175	-19
0012	1T	1_2	2	27	7	2700	3270	570	0.26	1.21	4	5	1
0012	1T	1_3	1	7	5	700	860	160	0.71	1.23	1	1	0
0012	1T	1_4	1	600	392	60000	53910	-6090	0.65	0.90	106	95	-11
0012	1T	1_4	2	13	4	1300	1910	610	0.31	1.47	2	3	1
0012	1T	1_5	1	600	364	60000	51660	-8340	0.61	0.86	106	91	-15
0012	1T	1_5	2	33	9	3300	4880	1580	0.27	1.48	5	8	3
0012	1T	1_else	1	2328	1568	232800	213380	-19420	0.67	0.92	412	377	-35
0012	1T	1_else	2	57	5	5700	3150	-2550	0.09	0.55	10	5	-5
0012	1T	2_1	1	5961	2819	596100	545140	-50960	0.47	0.91	1055	964	-91
0012	1T	2_1	2	1449	499	144900	135460	-9440	0.34	0.93	256	239	-17
0012	1T	2_2	1	1233	775	123300	113900	-9400	0.63	0.92	218	201	-17
0012	1T	2_2	2	47	19	4700	4690	-10	0.40	1.00	8	8	0
0012	1T	2_3	1	7	4	700	590	-110	0.57	0.84	1	1	0
0012	1T	2_4	1	649	427	64900	59990	-4910	0.66	0.92	114	106	-8
0012	1T	2_4	2	10	1	1000	150	-850	0.10	0.15	1	0	-1
0012	1T	2_5	1	620	364	62000	59300	-2700	0.59	0.96	109	104	-5
0012	1T	2_5	2	50	20	5000	4040	-960	0.40	0.81	8	7	-1
0012	1T	2_else	1	2045	1333	204500	182110	-22390	0.65	0.89	361	322	-39
0012	1T	2_else	2	46	5	4600	1720	-2880	0.11	0.37	8	3	-5
0012	1T	3_1	1	5260	2646	526000	508550	-17450	0.50	0.97	930	900	-30
0012	1T	3_1	2	1325	461	132500	129120	-3380	0.35	0.97	234	228	-6
0012	1T	3_2	1	992	632	99200	93990	-5210	0.64	0.95	175	166	-9
0012	1T	3_2	2	55	14	5500	3780	-1720	0.25	0.69	9	6	-3
0012	1T	3_3	1	676	363	67600	62300	-5300	0.54	0.92	119	110	-9
0012	1T	3_3	2	132	40	13200	13040	-160	0.30	0.99	23	23	0
0012	1T	3_4	1	638	432	63800	56290	-7510	0.68	0.88	112	99	-13
0012	1T	3_4	2	13	4	1300	1840	540	0.31	1.42	2	3	1
0012	1T	3_5	1	578	357	57800	53020	-4780	0.62	0.92	102	93	-9
0012	1T	3_5	2	40	13	4000	3130	-870	0.33	0.78	7	5	-2
0012	1T	3_6	1	332	251	33200	31650	-1550	0.76	0.95	58	56	-2
0012	1T	3_6	2	13	4	1300	1700	400	0.31	1.31	2	3	1
0012	1T	3_else	1	1979	1317	197900	186400	-11500	0.67	0.94	350	329	-21
0012	1T	3_else	2	62	18	6200	6840	640	0.29	1.10	10	12	2
0012	1T	4_1	1	3255	1669	325500	306440	-19060	0.51	0.94	576	542	-34
0012	1T	4_1	2	987	371	98700	84950	-13750	0.38	0.86	174	150	-24
0012	1T	4_2	1	481	325	48100	45650	-2450	0.68	0.95	85	80	-5
0012	1T	4_2	2	15	4	1500	2340	840	0.27	1.56	2	4	2
0012	1T	4_3	1	1449	845	144900	141420	-3480	0.58	0.98	256	250	-6
0012	1T	4_3	2	272	73	27200	30440	3240	0.27	1.12	48	53	5
0012	1T	4_4	1	427	313	42700	40600	-2100	0.73	0.95	75	71	-4
0012	1T	4_4	2	3	1	300	1270	970	0.33	4.23	0	2	2
0012	1T	4_5	1	416	285	41600	41060	-540	0.69	0.99	73	72	-1
0012	1T	4_5	2	13	2	1300	340	-960	0.15	0.26	2	0	-2
0012	1T	4_6	1	607	421	60700	54380	-6320	0.69	0.90	107	96	-11
0012	1T	4_6	2	15	5	1500	1490	-10	0.33	0.99	2	2	0
0012	1T	4_else	1	1992	1371	199200	178730	-20470	0.69	0.90	352	316	-36
0012	1T	4_else	2	34	7	3400	5280	1880	0.21	1.55	6	9	3
0012	1T	5_1	1	139	83	13900	14190	290	0.60	1.02	24	25	1
0012	1T	5_1	2	19	8	1900	2080	180	0.42	1.09	3	3	0
0012	1T	5_2	1	10	6	1000	770	-230	0.60	0.77	1	1	0
0012	1T	5_3	1	4133	2428	413300	397700	-15600	0.59	0.96	731	703	-28
0012	1T	5_3	2	443	138	44300	44110	-190	0.31	1.00	78	78	0
0012	1T	5_4	1	13	7	1300	910	-390	0.54	0.70	2	1	-1
0012	1T	5_4	2	4	1	400	340	-60	0.25	0.85	0	0	0
0012	1T	5_5	1	3	2	300	340	40	0.67	1.13	0	0	0
0012	1T	5_5	2	1	0	100	0	-100	0.00	0.00	0	0	0
0012	1T	5_6	1	1876	1356	187600	168620	-18980	0.72	0.90	332	298	-34
0012	1T	5_6	2	68	16	6800	5350	-1450	0.24	0.79	12	9	-3
0012	1T	5_else	1	1197	853	119700	109170	-10530	0.71	0.91	211	193	-18
0012	1T	5_else	2	26	3	2600	890	-1710	0.12	0.34	4	1	-3
0012	1T	6_3	1	372	203	37200	35790	-1410	0.55	0.96	65	63	-2
0012	1T	6_3	2	27	9	2700	3350	650	0.33	1.24	4	5	1
0012	1T	6_4	1	13	6	1300	940	-360	0.46	0.72	2	1	-1
0012	1T	6_4	2	1	1	100	560	460	1.00	5.60	0	0	0
0012	1T	6_6	1	157	120	15700	14480	-1220	0.76	0.92	27	25	-2
0012	1T	6_6	2	4	2	400	710	310	0.50	1.78	0	1	1
0012	1T	6_else	1	60	42	6000	5090	-910	0.70	0.85	10	9	-1
0012	1T	7_3	1	7106	4194	710600	654300	-56300	0.59	0.92	1257	1158	-99
0012	1T	7_3	2	853	258	85300	88210	2910	0.30	1.03	150	156	6
0012	1T	7_4	1	2159	1411	215900	198610	-17290	0.65	0.92	382	351	-31
0012	1T	7_4	2	108	29	10800	9130	-1670	0.27	0.85	19	16	-3
0012	1T	7_5	1	16	13	1600	1540	-60	0.81	0.96	2	2	0
0012	1T	7_7	1	1105	772	110500	97200	-13300	0.70	0.88	195	172	-23
0012	1T	7_7	2	21	4	2100	1070	-1030	0.19	0.51	3	1	-2
0012	1T	7_else	1	1537	1099	153700	144930	-8770	0.72	0.94	272	256	-16
0012	1T	7_else	2	29	6	2900	4730	1830	0.21	1.63	5	8	3
0012	2F	1_1	12	2704	709	270400	239350	-31050	0.26	0.89	478	423	-55
0012	2F	1_1	13	1734	405	173400	140960	-32440	0.23	0.81	306	249	-57
0012	2F	1_1	14	1050	197	105000	84890	-20110	0.19	0.81	185	150	-35
0012	2F	1_1	15	392	57	39200	42590	3390	0.15	1.09	69	75	6
0012	2F	1_1	16	229	30	22900	20910	-1990	0.13	0.91	40	37	-3
0012	2F	1_1	23	246	39	24600	21750	-2850	0.16	0.88	43	38	-5
0012	2F	1_1	24	138	15	13800	9330	-4470	0.11	0.68	24	16	-8
0012	2F	1_1	25	72	6	7200	8490	1290	0.08	1.18	12	15	3
0012	2F	1_1	26	59	5	5900	4540	-1360	0.08	0.77	10	8	-2
0012	2F	1_2	12	446	138	44600	44370	-230	0.31	0.99	78	78	0
0012	2F	1_2	13	267	72	26700	22890	-3810	0.27	0.86	47	40	-7
0012	2F	1_2	14	176	27	17600	15750	-1850	0.15	0.89	31	27	-4
0012	2F	1_2	15	46	2	4600	3380	-1220	0.04	0.73	8	5	-3
0012	2F	1_2	16	17	0	1700	0	-1700	0.00	0.00	3	0	-3
0012	2F	1_2	23	6	0	600	0	-600	0.00	0.00	1	0	-1
0012	2F	1_2	24	6	0	600	0	-600	0.00	0.00	1	0	-1
0012	2F	1_3	12	1	0	100	0	-100	0.00	0.00	0	0	0
0012	2F	1_3	13	3	0	300	0	-300	0.00	0.00	0	0	0
0012	2F	1_3	14	2	0	200	0	-200	0.00	0.00	0	0	0
0012	2F	1_4	12	193	56	19300	17080	-2220	0.29	0.88	34	30	-4
0012	2F	1_4	13	184	45	18400	14750	-3650	0.24	0.80	32	26	-6
0012	2F	1_4	14	94	22	9400	8980	-420	0.23	0.96	16	15	-1
0012	2F	1_4	15	40	1	4000	1550	-2450	0.03	0.39	7	2	-5
0012	2F	1_4	16	9	2	900	2220	1320	0.22	2.47	1	3	2
0012	2F	1_4	23	3	1	300	270	-30	0.33	0.90	0	0	0
0012	2F	1_4	24	2	1	200	1440	1240	0.50	7.20	0	2	2
0012	2F	1_5	12	258	73	25800	19290	-6510	0.28	0.75	45	34	-11
0012	2F	1_5	13	146	37	14600	13180	-1420	0.25	0.90	25	23	-2
0012	2F	1_5	14	93	21	9300	7770	-1530	0.23	0.84	16	13	-3
0012	2F	1_5	15	19	3	1900	2760	860	0.16	1.45	3	4	1
0012	2F	1_5	16	10	2	1000	2410	1410	0.20	2.41	1	4	3
0012	2F	1_5	23	5	1	500	650	150	0.20	1.30	0	1	1
0012	2F	1_5	24	3	0	300	0	-300	0.00	0.00	0	0	0
0012	2F	1_5	25	3	0	300	0	-300	0.00	0.00	0	0	0
0012	2F	1_else	12	1002	313	100200	82170	-18030	0.31	0.82	177	145	-32
0012	2F	1_else	13	573	144	57300	53630	-3670	0.25	0.94	101	94	-7
0012	2F	1_else	14	368	64	36800	28300	-8500	0.17	0.77	65	50	-15
0012	2F	1_else	15	113	10	11300	6830	-4470	0.09	0.60	20	12	-8
0012	2F	1_else	16	30	1	3000	910	-2090	0.03	0.30	5	1	-4
0012	2F	1_else	23	13	0	1300	0	-1300	0.00	0.00	2	0	-2
0012	2F	1_else	24	6	0	600	0	-600	0.00	0.00	1	0	-1
0012	2F	1_else	25	1	0	100	0	-100	0.00	0.00	0	0	0
0012	2F	2_1	12	2419	696	241900	222680	-19220	0.29	0.92	428	394	-34
0012	2F	2_1	13	1377	324	137700	116550	-21150	0.24	0.85	243	206	-37
0012	2F	2_1	14	927	189	92700	70360	-22340	0.20	0.76	164	124	-40
0012	2F	2_1	15	405	46	40500	27480	-13020	0.11	0.68	71	48	-23
0012	2F	2_1	16	347	51	34700	36040	1340	0.15	1.04	61	63	2
0012	2F	2_1	23	243	39	24300	25720	1420	0.16	1.06	43	45	2
0012	2F	2_1	24	183	27	18300	15040	-3260	0.15	0.82	32	26	-6
0012	2F	2_1	25	130	8	13000	6280	-6720	0.06	0.48	23	11	-12
0012	2F	2_1	26	115	15	11500	14590	3090	0.13	1.27	20	25	5
0012	2F	2_2	12	439	121	43900	33860	-10040	0.28	0.77	77	59	-18
0012	2F	2_2	13	340	103	34000	31060	-2940	0.30	0.91	60	54	-6
0012	2F	2_2	14	204	36	20400	14290	-6110	0.18	0.70	36	25	-11
0012	2F	2_2	15	68	13	6800	8940	2140	0.19	1.31	12	15	3
0012	2F	2_2	16	40	0	4000	0	-4000	0.00	0.00	7	0	-7
0012	2F	2_2	23	8	2	800	560	-240	0.25	0.70	1	0	-1
0012	2F	2_2	24	3	0	300	0	-300	0.00	0.00	0	0	0
0012	2F	2_2	25	4	1	400	480	80	0.25	1.20	0	0	0
0012	2F	2_3	12	3	2	300	380	80	0.67	1.27	0	0	0
0012	2F	2_3	13	2	0	200	0	-200	0.00	0.00	0	0	0
0012	2F	2_3	15	1	0	100	0	-100	0.00	0.00	0	0	0
0012	2F	2_4	12	256	84	25600	24560	-1040	0.33	0.96	45	43	-2
0012	2F	2_4	13	170	47	17000	13480	-3520	0.28	0.79	30	23	-7
0012	2F	2_4	14	126	32	12600	12310	-290	0.25	0.98	22	21	-1
0012	2F	2_4	15	36	9	3600	3740	140	0.25	1.04	6	6	0
0012	2F	2_4	16	9	0	900	0	-900	0.00	0.00	1	0	-1
0012	2F	2_4	24	3	0	300	0	-300	0.00	0.00	0	0	0
0012	2F	2_4	25	1	0	100	0	-100	0.00	0.00	0	0	0
0012	2F	2_5	12	257	86	25700	24170	-1530	0.33	0.94	45	42	-3
0012	2F	2_5	13	156	39	15600	12770	-2830	0.25	0.82	27	22	-5
0012	2F	2_5	14	98	27	9800	9300	-500	0.28	0.95	17	16	-1
0012	2F	2_5	15	31	4	3100	2210	-890	0.13	0.71	5	3	-2
0012	2F	2_5	16	17	1	1700	490	-1210	0.06	0.29	3	0	-3
0012	2F	2_5	23	9	0	900	0	-900	0.00	0.00	1	0	-1
0012	2F	2_5	24	6	3	600	1920	1320	0.50	3.20	1	3	2
0012	2F	2_5	25	3	0	300	0	-300	0.00	0.00	0	0	0
0012	2F	2_5	26	1	0	100	0	-100	0.00	0.00	0	0	0
0012	2F	2_else	12	891	256	89100	73230	-15870	0.29	0.82	157	129	-28
0012	2F	2_else	13	538	149	53800	50980	-2820	0.28	0.95	95	90	-5
0012	2F	2_else	14	289	72	28900	27980	-920	0.25	0.97	51	49	-2
0012	2F	2_else	15	83	5	8300	4020	-4280	0.06	0.48	14	7	-7
0012	2F	2_else	16	19	1	1900	100	-1800	0.05	0.05	3	0	-3
0012	2F	2_else	23	9	1	900	1320	420	0.11	1.47	1	2	1
0012	2F	2_else	24	5	0	500	0	-500	0.00	0.00	0	0	0
0012	2F	2_else	25	4	1	400	1330	930	0.25	3.33	0	2	2
0012	2F	2_else	26	3	0	300	0	-300	0.00	0.00	0	0	0
0012	2F	3_1	12	2091	599	209100	192300	-16800	0.29	0.92	370	340	-30
0012	2F	3_1	13	1258	308	125800	104330	-21470	0.24	0.83	222	184	-38
0012	2F	3_1	14	782	148	78200	54850	-23350	0.19	0.70	138	97	-41
0012	2F	3_1	15	404	66	40400	30990	-9410	0.16	0.77	71	54	-17
0012	2F	3_1	16	281	27	28100	18460	-9640	0.10	0.66	49	32	-17
0012	2F	3_1	23	242	30	24200	15290	-8910	0.12	0.63	42	27	-15
0012	2F	3_1	24	116	15	11600	7720	-3880	0.13	0.67	20	13	-7
0012	2F	3_1	25	120	14	12000	6190	-5810	0.12	0.52	21	10	-11
0012	2F	3_1	26	120	15	12000	9520	-2480	0.13	0.79	21	16	-5
0012	2F	3_2	12	371	109	37100	29380	-7720	0.29	0.79	65	52	-13
0012	2F	3_2	13	268	74	26800	24370	-2430	0.28	0.91	47	43	-4
0012	2F	3_2	14	142	29	14200	11290	-2910	0.20	0.80	25	19	-6
0012	2F	3_2	15	68	11	6800	6270	-530	0.16	0.92	12	11	-1
0012	2F	3_2	16	35	5	3500	7490	3990	0.14	2.14	6	13	7
0012	2F	3_2	23	7	0	700	0	-700	0.00	0.00	1	0	-1
0012	2F	3_2	24	6	1	600	500	-100	0.17	0.83	1	0	-1
0012	2F	3_2	25	3	1	300	2970	2670	0.33	9.90	0	5	5
0012	2F	3_2	26	4	1	400	790	390	0.25	1.98	0	1	1
0012	2F	3_3	12	256	68	25600	24030	-1570	0.27	0.94	45	42	-3
0012	2F	3_3	13	153	49	15300	15780	480	0.32	1.03	27	27	0
0012	2F	3_3	14	115	20	11500	6890	-4610	0.17	0.60	20	12	-8
0012	2F	3_3	15	57	6	5700	2560	-3140	0.11	0.45	10	4	-6
0012	2F	3_3	16	24	5	2400	4540	2140	0.21	1.89	4	8	4
0012	2F	3_3	23	23	3	2300	1640	-660	0.13	0.71	4	2	-2
0012	2F	3_3	24	26	4	2600	3280	680	0.15	1.26	4	5	1
0012	2F	3_3	25	13	2	1300	920	-380	0.15	0.71	2	1	-1
0012	2F	3_3	26	9	0	900	0	-900	0.00	0.00	1	0	-1
0012	2F	3_4	12	266	96	26600	28300	1700	0.36	1.06	47	50	3
0012	2F	3_4	13	164	50	16400	13830	-2570	0.30	0.84	29	24	-5
0012	2F	3_4	14	108	27	10800	10630	-170	0.25	0.98	19	18	-1
0012	2F	3_4	15	39	10	3900	4660	760	0.26	1.19	6	8	2
0012	2F	3_4	16	18	2	1800	2340	540	0.11	1.30	3	4	1
0012	2F	3_4	23	1	0	100	0	-100	0.00	0.00	0	0	0
0012	2F	3_4	24	2	0	200	0	-200	0.00	0.00	0	0	0
0012	2F	3_5	12	243	79	24300	20760	-3540	0.33	0.85	43	36	-7
0012	2F	3_5	13	140	43	14000	14870	870	0.31	1.06	24	26	2
0012	2F	3_5	14	99	21	9900	7200	-2700	0.21	0.73	17	12	-5
0012	2F	3_5	15	36	4	3600	3310	-290	0.11	0.92	6	5	-1
0012	2F	3_5	16	16	2	1600	2730	1130	0.13	1.71	2	4	2
0012	2F	3_5	23	3	1	300	820	520	0.33	2.73	0	1	1
0012	2F	3_5	24	4	0	400	0	-400	0.00	0.00	0	0	0
0012	2F	3_5	25	2	0	200	0	-200	0.00	0.00	0	0	0
0012	2F	3_6	12	158	63	15800	11680	-4120	0.40	0.74	27	20	-7
0012	2F	3_6	13	79	26	7900	8590	690	0.33	1.09	13	15	2
0012	2F	3_6	14	47	8	4700	3030	-1670	0.17	0.64	8	5	-3
0012	2F	3_6	15	14	0	1400	0	-1400	0.00	0.00	2	0	-2
0012	2F	3_6	16	2	0	200	0	-200	0.00	0.00	0	0	0
0012	2F	3_6	23	3	0	300	0	-300	0.00	0.00	0	0	0
0012	2F	3_6	26	2	0	200	0	-200	0.00	0.00	0	0	0
0012	2F	3_else	12	894	306	89400	74610	-14790	0.34	0.83	158	132	-26
0012	2F	3_else	13	471	123	47100	33440	-13660	0.26	0.71	83	59	-24
0012	2F	3_else	14	272	65	27200	24700	-2500	0.24	0.91	48	43	-5
0012	2F	3_else	15	100	22	10000	11990	1990	0.22	1.20	17	21	4
0012	2F	3_else	16	54	11	5400	4970	-430	0.20	0.92	9	8	-1
0012	2F	3_else	23	8	0	800	0	-800	0.00	0.00	1	0	-1
0012	2F	3_else	24	8	0	800	0	-800	0.00	0.00	1	0	-1
0012	2F	3_else	25	9	0	900	0	-900	0.00	0.00	1	0	-1
0012	2F	3_else	26	1	0	100	0	-100	0.00	0.00	0	0	0
0012	2F	4_1	12	1348	419	134800	133470	-1330	0.31	0.99	238	236	-2
0012	2F	4_1	13	797	200	79700	60100	-19600	0.25	0.75	141	106	-35
0012	2F	4_1	14	540	124	54000	39980	-14020	0.23	0.74	95	70	-25
0012	2F	4_1	15	247	37	24700	17900	-6800	0.15	0.72	43	31	-12
0012	2F	4_1	16	136	17	13600	14070	470	0.13	1.03	24	24	0
0012	2F	4_1	23	212	40	21200	23540	2340	0.19	1.11	37	41	4
0012	2F	4_1	24	115	17	11500	5970	-5530	0.15	0.52	20	10	-10
0012	2F	4_1	25	104	20	10400	14580	4180	0.19	1.40	18	25	7
0012	2F	4_1	26	57	4	5700	1960	-3740	0.07	0.34	10	3	-7
0012	2F	4_2	12	195	61	19500	17070	-2430	0.31	0.88	34	30	-4
0012	2F	4_2	13	133	46	13300	14740	1440	0.35	1.11	23	26	3
0012	2F	4_2	14	77	23	7700	9120	1420	0.30	1.18	13	16	3
0012	2F	4_2	15	28	4	2800	1530	-1270	0.14	0.55	4	2	-2
0012	2F	4_2	16	12	1	1200	1230	30	0.08	1.03	2	2	0
0012	2F	4_2	23	2	0	200	0	-200	0.00	0.00	0	0	0
0012	2F	4_2	24	3	0	300	0	-300	0.00	0.00	0	0	0
0012	2F	4_2	25	2	0	200	0	-200	0.00	0.00	0	0	0
0012	2F	4_2	26	1	0	100	0	-100	0.00	0.00	0	0	0
0012	2F	4_3	12	536	132	53600	41980	-11620	0.25	0.78	94	74	-20
0012	2F	4_3	13	354	92	35400	28470	-6930	0.26	0.80	62	50	-12
0012	2F	4_3	14	255	49	25500	16340	-9160	0.19	0.64	45	28	-17
0012	2F	4_3	15	93	11	9300	4100	-5200	0.12	0.44	16	7	-9
0012	2F	4_3	16	57	14	5700	9050	3350	0.25	1.59	10	16	6
0012	2F	4_3	23	66	12	6600	6680	80	0.18	1.01	11	11	0
0012	2F	4_3	24	37	5	3700	3010	-690	0.14	0.81	6	5	-1
0012	2F	4_3	25	34	6	3400	5150	1750	0.18	1.51	6	9	3
0012	2F	4_3	26	23	1	2300	210	-2090	0.04	0.09	4	0	-4
0012	2F	4_4	12	172	60	17200	15010	-2190	0.35	0.87	30	26	-4
0012	2F	4_4	13	115	37	11500	10960	-540	0.32	0.95	20	19	-1
0012	2F	4_4	14	71	17	7100	6640	-460	0.24	0.94	12	11	-1
0012	2F	4_4	15	25	3	2500	1570	-930	0.12	0.63	4	2	-2
0012	2F	4_4	16	6	2	600	1310	710	0.33	2.18	1	2	1
0012	2F	4_4	25	1	0	100	0	-100	0.00	0.00	0	0	0
0012	2F	4_5	12	190	63	19000	16940	-2060	0.33	0.89	33	29	-4
0012	2F	4_5	13	108	32	10800	9700	-1100	0.30	0.90	19	17	-2
0012	2F	4_5	14	51	15	5100	4870	-230	0.29	0.95	9	8	-1
0012	2F	4_5	15	19	6	1900	2900	1000	0.32	1.53	3	5	2
0012	2F	4_5	16	8	0	800	0	-800	0.00	0.00	1	0	-1
0012	2F	4_5	23	4	0	400	0	-400	0.00	0.00	0	0	0
0012	2F	4_5	24	2	0	200	0	-200	0.00	0.00	0	0	0
0012	2F	4_5	25	2	0	200	0	-200	0.00	0.00	0	0	0
0012	2F	4_5	26	1	0	100	0	-100	0.00	0.00	0	0	0
0012	2F	4_6	12	276	104	27600	22480	-5120	0.38	0.81	48	39	-9
0012	2F	4_6	13	174	56	17400	16810	-590	0.32	0.97	30	29	-1
0012	2F	4_6	14	76	11	7600	4820	-2780	0.14	0.63	13	8	-5
0012	2F	4_6	15	23	4	2300	2260	-40	0.17	0.98	4	4	0
0012	2F	4_6	16	7	0	700	0	-700	0.00	0.00	1	0	-1
0012	2F	4_6	23	2	0	200	0	-200	0.00	0.00	0	0	0
0012	2F	4_6	24	2	0	200	0	-200	0.00	0.00	0	0	0
0012	2F	4_6	25	2	0	200	0	-200	0.00	0.00	0	0	0
0012	2F	4_else	12	861	278	86100	74240	-11860	0.32	0.86	152	131	-21
0012	2F	4_else	13	504	124	50400	44640	-5760	0.25	0.89	89	79	-10
0012	2F	4_else	14	330	58	33000	24420	-8580	0.18	0.74	58	43	-15
0012	2F	4_else	15	75	6	7500	4440	-3060	0.08	0.59	13	7	-6
0012	2F	4_else	16	19	1	1900	560	-1340	0.05	0.29	3	0	-3
0012	2F	4_else	23	7	0	700	0	-700	0.00	0.00	1	0	-1
0012	2F	4_else	24	5	1	500	480	-20	0.20	0.96	0	0	0
0012	2F	4_else	25	2	0	200	0	-200	0.00	0.00	0	0	0
0012	2F	5_1	12	40	13	4000	3940	-60	0.33	0.99	7	6	-1
0012	2F	5_1	13	41	13	4100	3730	-370	0.32	0.91	7	6	-1
0012	2F	5_1	14	22	9	2200	2600	400	0.41	1.18	3	4	1
0012	2F	5_1	15	13	3	1300	1320	20	0.23	1.02	2	2	0
0012	2F	5_1	16	10	2	1000	1180	180	0.20	1.18	1	2	1
0012	2F	5_1	23	3	0	300	0	-300	0.00	0.00	0	0	0
0012	2F	5_1	24	3	1	300	470	170	0.33	1.57	0	0	0
0012	2F	5_1	25	5	1	500	1890	1390	0.20	3.78	0	3	3
0012	2F	5_1	26	1	0	100	0	-100	0.00	0.00	0	0	0
0012	2F	5_2	12	3	2	300	680	380	0.67	2.27	0	1	1
0012	2F	5_2	13	2	1	200	370	170	0.50	1.85	0	0	0
0012	2F	5_2	14	5	1	500	340	-160	0.20	0.68	0	0	0
0012	2F	5_3	12	1508	435	150800	135990	-14810	0.29	0.90	266	240	-26
0012	2F	5_3	13	980	262	98000	81480	-16520	0.27	0.83	173	144	-29
0012	2F	5_3	14	689	175	68900	52760	-16140	0.25	0.77	121	93	-28
0012	2F	5_3	15	304	52	30400	23190	-7210	0.17	0.76	53	41	-12
0012	2F	5_3	16	204	32	20400	17350	-3050	0.16	0.85	36	30	-6
0012	2F	5_3	23	89	6	8900	3960	-4940	0.07	0.44	15	7	-8
0012	2F	5_3	24	47	8	4700	3270	-1430	0.17	0.70	8	5	-3
0012	2F	5_3	25	41	4	4100	4470	370	0.10	1.09	7	7	0
0012	2F	5_3	26	27	2	2700	1230	-1470	0.07	0.46	4	2	-2
0012	2F	5_4	12	8	3	800	770	-30	0.38	0.96	1	1	0
0012	2F	5_4	13	1	0	100	0	-100	0.00	0.00	0	0	0
0012	2F	5_4	14	3	0	300	0	-300	0.00	0.00	0	0	0
0012	2F	5_4	15	1	0	100	0	-100	0.00	0.00	0	0	0
0012	2F	5_4	23	2	0	200	0	-200	0.00	0.00	0	0	0
0012	2F	5_4	25	1	0	100	0	-100	0.00	0.00	0	0	0
0012	2F	5_5	13	1	0	100	0	-100	0.00	0.00	0	0	0
0012	2F	5_5	14	1	1	100	560	460	1.00	5.60	0	0	0
0012	2F	5_5	15	1	0	100	0	-100	0.00	0.00	0	0	0
0012	2F	5_5	26	1	0	100	0	-100	0.00	0.00	0	0	0
0012	2F	5_6	12	958	401	95800	80170	-15630	0.42	0.84	169	141	-28
0012	2F	5_6	13	486	134	48600	45420	-3180	0.28	0.93	86	80	-6
0012	2F	5_6	14	196	38	19600	19210	-390	0.19	0.98	34	34	0
0012	2F	5_6	15	65	4	6500	3960	-2540	0.06	0.61	11	7	-4
0012	2F	5_6	16	15	0	1500	0	-1500	0.00	0.00	2	0	-2
0012	2F	5_6	23	14	2	1400	1410	10	0.14	1.01	2	2	0
0012	2F	5_6	24	4	0	400	0	-400	0.00	0.00	0	0	0
0012	2F	5_6	25	1	0	100	0	-100	0.00	0.00	0	0	0
0012	2F	5_6	26	1	0	100	0	-100	0.00	0.00	0	0	0
0012	2F	5_else	12	584	211	58400	52170	-6230	0.36	0.89	103	92	-11
0012	2F	5_else	13	301	82	30100	30530	430	0.27	1.01	53	54	1
0012	2F	5_else	14	165	38	16500	19830	3330	0.23	1.20	29	35	6
0012	2F	5_else	15	43	5	4300	3800	-500	0.12	0.88	7	6	-1
0012	2F	5_else	16	9	0	900	0	-900	0.00	0.00	1	0	-1
0012	2F	5_else	23	3	0	300	0	-300	0.00	0.00	0	0	0
0012	2F	5_else	24	4	0	400	0	-400	0.00	0.00	0	0	0
0012	2F	5_else	25	1	0	100	0	-100	0.00	0.00	0	0	0
0012	2F	6_3	12	113	28	11300	9370	-1930	0.25	0.83	20	16	-4
0012	2F	6_3	13	78	17	7800	4390	-3410	0.22	0.56	13	7	-6
0012	2F	6_3	14	62	13	6200	10240	4040	0.21	1.65	10	18	8
0012	2F	6_3	15	37	5	3700	1830	-1870	0.14	0.49	6	3	-3
0012	2F	6_3	16	30	4	3000	3140	140	0.13	1.05	5	5	0
0012	2F	6_3	23	5	1	500	1970	1470	0.20	3.94	0	3	3
0012	2F	6_3	24	4	0	400	0	-400	0.00	0.00	0	0	0
0012	2F	6_3	25	1	0	100	0	-100	0.00	0.00	0	0	0
0012	2F	6_3	26	3	0	300	0	-300	0.00	0.00	0	0	0
0012	2F	6_4	12	5	2	500	520	20	0.40	1.04	0	0	0
0012	2F	6_4	13	2	1	200	170	-30	0.50	0.85	0	0	0
0012	2F	6_4	14	3	0	300	0	-300	0.00	0.00	0	0	0
0012	2F	6_4	23	1	1	100	850	750	1.00	8.50	0	1	1
0012	2F	6_6	12	80	34	8000	6410	-1590	0.43	0.80	14	11	-3
0012	2F	6_6	13	35	5	3500	1530	-1970	0.14	0.44	6	2	-4
0012	2F	6_6	14	18	3	1800	1800	0	0.17	1.00	3	3	0
0012	2F	6_6	15	6	0	600	0	-600	0.00	0.00	1	0	-1
0012	2F	6_6	16	1	0	100	0	-100	0.00	0.00	0	0	0
0012	2F	6_6	24	1	0	100	0	-100	0.00	0.00	0	0	0
0012	2F	6_else	12	29	9	2900	2120	-780	0.31	0.73	5	3	-2
0012	2F	6_else	13	19	4	1900	910	-990	0.21	0.48	3	1	-2
0012	2F	6_else	14	4	1	400	340	-60	0.25	0.85	0	0	0
0012	2F	6_else	15	3	0	300	0	-300	0.00	0.00	0	0	0
0012	2F	6_else	16	1	0	100	0	-100	0.00	0.00	0	0	0
0012	2F	7_3	12	2797	898	279700	254150	-25550	0.32	0.91	495	449	-46
0012	2F	7_3	13	1655	442	165500	148180	-17320	0.27	0.90	292	262	-30
0012	2F	7_3	14	1086	264	108600	96690	-11910	0.24	0.89	192	171	-21
0012	2F	7_3	15	457	80	45700	44770	-930	0.18	0.98	80	79	-1
0012	2F	7_3	16	298	44	29800	23390	-6410	0.15	0.78	52	41	-11
0012	2F	7_3	23	186	20	18600	15920	-2680	0.11	0.86	32	28	-4
0012	2F	7_3	24	84	13	8400	6730	-1670	0.15	0.80	14	11	-3
0012	2F	7_3	25	70	5	7000	3390	-3610	0.07	0.48	12	6	-6
0012	2F	7_3	26	68	7	6800	5520	-1280	0.10	0.81	12	9	-3
0012	2F	7_4	12	1027	374	102700	87430	-15270	0.36	0.85	181	154	-27
0012	2F	7_4	13	498	118	49800	41860	-7940	0.24	0.84	88	74	-14
0012	2F	7_4	14	286	46	28600	23210	-5390	0.16	0.81	50	41	-9
0012	2F	7_4	15	91	6	9100	3670	-5430	0.07	0.40	16	6	-10
0012	2F	7_4	16	41	1	4100	1050	-3050	0.02	0.26	7	1	-6
0012	2F	7_4	23	22	0	2200	0	-2200	0.00	0.00	3	0	-3
0012	2F	7_4	24	11	1	1100	1270	170	0.09	1.15	1	2	1
0012	2F	7_4	25	5	0	500	0	-500	0.00	0.00	0	0	0
0012	2F	7_5	12	6	0	600	0	-600	0.00	0.00	1	0	-1
0012	2F	7_5	13	2	1	200	240	40	0.50	1.20	0	0	0
0012	2F	7_5	14	3	1	300	360	60	0.33	1.20	0	0	0
0012	2F	7_5	15	1	0	100	0	-100	0.00	0.00	0	0	0
0012	2F	7_5	16	2	1	200	250	50	0.50	1.25	0	0	0
0012	2F	7_7	12	550	189	55000	43900	-11100	0.34	0.80	97	77	-20
0012	2F	7_7	13	228	46	22800	15420	-7380	0.20	0.68	40	27	-13
0012	2F	7_7	14	164	29	16400	12680	-3720	0.18	0.77	29	22	-7
0012	2F	7_7	15	47	7	4700	5620	920	0.15	1.20	8	9	1
0012	2F	7_7	16	11	1	1100	1020	-80	0.09	0.93	1	1	0
0012	2F	7_7	23	3	0	300	0	-300	0.00	0.00	0	0	0
0012	2F	7_7	24	1	0	100	0	-100	0.00	0.00	0	0	0
0012	2F	7_else	12	741	264	74100	66310	-7790	0.36	0.89	131	117	-14
0012	2F	7_else	13	389	96	38900	32960	-5940	0.25	0.85	68	58	-10
0012	2F	7_else	14	224	49	22400	20140	-2260	0.22	0.90	39	35	-4
0012	2F	7_else	15	48	5	4800	5480	680	0.10	1.14	8	9	1
0012	2F	7_else	16	15	2	1500	5490	3990	0.13	3.66	2	9	7
0012	2F	7_else	23	6	0	600	0	-600	0.00	0.00	1	0	-1
0012	2F	7_else	24	4	0	400	0	-400	0.00	0.00	0	0	0
0012	2F	7_else	25	2	0	200	0	-200	0.00	0.00	0	0	0
0012	2F	7_else	26	1	0	100	0	-100	0.00	0.00	0	0	0
0012	2T	1_1	12	2300	416	230000	194970	-35030	0.18	0.85	407	345	-62
0012	2T	1_1	13	1734	274	173400	135390	-38010	0.16	0.78	306	239	-67
0012	2T	1_1	14	1050	148	105000	90600	-14400	0.14	0.86	185	160	-25
0012	2T	1_1	15	392	44	39200	47240	8040	0.11	1.21	69	83	14
0012	2T	1_1	16	229	23	22900	28950	6050	0.10	1.26	40	51	11
0012	2T	1_1	21	404	48	40400	34490	-5910	0.12	0.85	71	61	-10
0012	2T	1_1	23	246	18	24600	22600	-2000	0.07	0.92	43	40	-3
0012	2T	1_1	24	138	8	13800	11330	-2470	0.06	0.82	24	20	-4
0012	2T	1_1	25	72	3	7200	6320	-880	0.04	0.88	12	11	-1
0012	2T	1_1	26	59	1	5900	3570	-2330	0.02	0.61	10	6	-4
0012	2T	1_2	12	435	108	43500	40340	-3160	0.25	0.93	76	71	-5
0012	2T	1_2	13	267	58	26700	22570	-4130	0.22	0.85	47	39	-8
0012	2T	1_2	14	176	22	17600	13900	-3700	0.13	0.79	31	24	-7
0012	2T	1_2	15	46	2	4600	3530	-1070	0.04	0.77	8	6	-2
0012	2T	1_2	16	17	0	1700	0	-1700	0.00	0.00	3	0	-3
0012	2T	1_2	21	11	1	1100	1110	10	0.09	1.01	1	1	0
0012	2T	1_2	23	6	0	600	0	-600	0.00	0.00	1	0	-1
0012	2T	1_2	24	6	0	600	0	-600	0.00	0.00	1	0	-1
0012	2T	1_3	12	1	0	100	0	-100	0.00	0.00	0	0	0
0012	2T	1_3	13	3	0	300	0	-300	0.00	0.00	0	0	0
0012	2T	1_3	14	2	0	200	0	-200	0.00	0.00	0	0	0
0012	2T	1_4	12	188	48	18800	18820	20	0.26	1.00	33	33	0
0012	2T	1_4	13	184	34	18400	13270	-5130	0.18	0.72	32	23	-9
0012	2T	1_4	14	94	19	9400	8750	-650	0.20	0.93	16	15	-1
0012	2T	1_4	15	40	1	4000	1460	-2540	0.03	0.37	7	2	-5
0012	2T	1_4	16	9	2	900	2470	1570	0.22	2.74	1	4	3
0012	2T	1_4	21	5	0	500	0	-500	0.00	0.00	0	0	0
0012	2T	1_4	23	3	0	300	0	-300	0.00	0.00	0	0	0
0012	2T	1_4	24	2	1	200	2240	2040	0.50	11.20	0	3	3
0012	2T	1_5	12	245	51	24500	17010	-7490	0.21	0.69	43	30	-13
0012	2T	1_5	13	146	31	14600	13140	-1460	0.21	0.90	25	23	-2
0012	2T	1_5	14	93	18	9300	8060	-1240	0.19	0.87	16	14	-2
0012	2T	1_5	15	19	1	1900	1110	-790	0.05	0.58	3	1	-2
0012	2T	1_5	16	10	2	1000	2880	1880	0.20	2.88	1	5	4
0012	2T	1_5	21	13	4	1300	1590	290	0.31	1.22	2	2	0
0012	2T	1_5	23	5	1	500	1000	500	0.20	2.00	0	1	1
0012	2T	1_5	24	3	0	300	0	-300	0.00	0.00	0	0	0
0012	2T	1_5	25	3	0	300	0	-300	0.00	0.00	0	0	0
0012	2T	1_else	12	972	251	97200	79750	-17450	0.26	0.82	172	141	-31
0012	2T	1_else	13	573	109	57300	45130	-12170	0.19	0.79	101	79	-22
0012	2T	1_else	14	368	56	36800	29690	-7110	0.15	0.81	65	52	-13
0012	2T	1_else	15	113	8	11300	6550	-4750	0.07	0.58	20	11	-9
0012	2T	1_else	16	30	1	3000	4150	1150	0.03	1.38	5	7	2
0012	2T	1_else	21	30	1	3000	1380	-1620	0.03	0.46	5	2	-3
0012	2T	1_else	23	13	0	1300	0	-1300	0.00	0.00	2	0	-2
0012	2T	1_else	24	6	0	600	0	-600	0.00	0.00	1	0	-1
0012	2T	1_else	25	1	0	100	0	-100	0.00	0.00	0	0	0
0012	2T	2_1	12	1962	394	196200	175670	-20530	0.20	0.90	347	310	-37
0012	2T	2_1	13	1377	236	137700	116630	-21070	0.17	0.85	243	206	-37
0012	2T	2_1	14	927	132	92700	71030	-21670	0.14	0.77	164	125	-39
0012	2T	2_1	15	405	28	40500	22950	-17550	0.07	0.57	71	40	-31
0012	2T	2_1	16	347	35	34700	31800	-2900	0.10	0.92	61	56	-5
0012	2T	2_1	21	457	62	45700	47410	1710	0.14	1.04	80	83	3
0012	2T	2_1	23	243	22	24300	25010	710	0.09	1.03	43	44	1
0012	2T	2_1	24	183	15	18300	12860	-5440	0.08	0.70	32	22	-10
0012	2T	2_1	25	130	3	13000	3490	-9510	0.02	0.27	23	6	-17
0012	2T	2_1	26	115	13	11500	16740	5240	0.11	1.46	20	29	9
0012	2T	2_2	12	424	86	42400	31110	-11290	0.20	0.73	75	55	-20
0012	2T	2_2	13	340	77	34000	27590	-6410	0.23	0.81	60	48	-12
0012	2T	2_2	14	204	28	20400	16190	-4210	0.14	0.79	36	28	-8
0012	2T	2_2	15	68	10	6800	7890	1090	0.15	1.16	12	13	1
0012	2T	2_2	16	40	0	4000	0	-4000	0.00	0.00	7	0	-7
0012	2T	2_2	21	15	0	1500	0	-1500	0.00	0.00	2	0	-2
0012	2T	2_2	23	8	1	800	300	-500	0.13	0.38	1	0	-1
0012	2T	2_2	24	3	0	300	0	-300	0.00	0.00	0	0	0
0012	2T	2_2	25	4	1	400	830	430	0.25	2.08	0	1	1
0012	2T	2_3	12	3	1	300	200	-100	0.33	0.67	0	0	0
0012	2T	2_3	13	2	0	200	0	-200	0.00	0.00	0	0	0
0012	2T	2_3	15	1	0	100	0	-100	0.00	0.00	0	0	0
0012	2T	2_4	12	252	69	25200	23950	-1250	0.27	0.95	44	42	-2
0012	2T	2_4	13	170	37	17000	13770	-3230	0.22	0.81	30	24	-6
0012	2T	2_4	14	126	26	12600	10930	-1670	0.21	0.87	22	19	-3
0012	2T	2_4	15	36	7	3600	4570	970	0.19	1.27	6	8	2
0012	2T	2_4	16	9	0	900	0	-900	0.00	0.00	1	0	-1
0012	2T	2_4	21	4	0	400	0	-400	0.00	0.00	0	0	0
0012	2T	2_4	24	3	0	300	0	-300	0.00	0.00	0	0	0
0012	2T	2_4	25	1	0	100	0	-100	0.00	0.00	0	0	0
0012	2T	2_5	12	234	63	23400	22510	-890	0.27	0.96	41	39	-2
0012	2T	2_5	13	156	33	15600	13980	-1620	0.21	0.90	27	24	-3
0012	2T	2_5	14	98	23	9800	9890	90	0.23	1.01	17	17	0
0012	2T	2_5	15	31	3	3100	2320	-780	0.10	0.75	5	4	-1
0012	2T	2_5	16	17	0	1700	0	-1700	0.00	0.00	3	0	-3
0012	2T	2_5	21	23	4	2300	2460	160	0.17	1.07	4	4	0
0012	2T	2_5	23	9	0	900	0	-900	0.00	0.00	1	0	-1
0012	2T	2_5	24	6	1	600	1680	1080	0.17	2.80	1	2	1
0012	2T	2_5	25	3	0	300	0	-300	0.00	0.00	0	0	0
0012	2T	2_5	26	1	0	100	0	-100	0.00	0.00	0	0	0
0012	2T	2_else	12	872	208	87200	70030	-17170	0.24	0.80	154	123	-31
0012	2T	2_else	13	538	123	53800	50920	-2880	0.23	0.95	95	90	-5
0012	2T	2_else	14	289	59	28900	27450	-1450	0.20	0.95	51	48	-3
0012	2T	2_else	15	83	5	8300	3510	-4790	0.06	0.42	14	6	-8
0012	2T	2_else	16	19	0	1900	0	-1900	0.00	0.00	3	0	-3
0012	2T	2_else	21	19	0	1900	0	-1900	0.00	0.00	3	0	-3
0012	2T	2_else	23	9	0	900	0	-900	0.00	0.00	1	0	-1
0012	2T	2_else	24	5	0	500	0	-500	0.00	0.00	0	0	0
0012	2T	2_else	25	4	1	400	2180	1780	0.25	5.45	0	3	3
0012	2T	2_else	26	3	0	300	0	-300	0.00	0.00	0	0	0
0012	2T	3_1	12	1702	346	170200	152550	-17650	0.20	0.90	301	270	-31
0012	2T	3_1	13	1258	230	125800	105820	-19980	0.18	0.84	222	187	-35
0012	2T	3_1	14	782	101	78200	51480	-26720	0.13	0.66	138	91	-47
0012	2T	3_1	15	404	46	40400	32180	-8220	0.11	0.80	71	56	-15
0012	2T	3_1	16	281	19	28100	20990	-7110	0.07	0.75	49	37	-12
0012	2T	3_1	21	389	58	38900	34240	-4660	0.15	0.88	68	60	-8
0012	2T	3_1	23	242	19	24200	21910	-2290	0.08	0.91	42	38	-4
0012	2T	3_1	24	116	11	11600	11200	-400	0.09	0.97	20	19	-1
0012	2T	3_1	25	120	12	12000	9200	-2800	0.10	0.77	21	16	-5
0012	2T	3_1	26	120	13	12000	12140	140	0.11	1.01	21	21	0
0012	2T	3_2	12	352	84	35200	29260	-5940	0.24	0.83	62	51	-11
0012	2T	3_2	13	268	61	26800	24720	-2080	0.23	0.92	47	43	-4
0012	2T	3_2	14	142	25	14200	13180	-1020	0.18	0.93	25	23	-2
0012	2T	3_2	15	68	9	6800	6750	-50	0.13	0.99	12	11	-1
0012	2T	3_2	16	35	5	3500	7900	4400	0.14	2.26	6	13	7
0012	2T	3_2	21	19	2	1900	1370	-530	0.11	0.72	3	2	-1
0012	2T	3_2	23	7	0	700	0	-700	0.00	0.00	1	0	-1
0012	2T	3_2	24	6	1	600	640	40	0.17	1.07	1	1	0
0012	2T	3_2	25	3	0	300	0	-300	0.00	0.00	0	0	0
0012	2T	3_2	26	4	0	400	0	-400	0.00	0.00	0	0	0
0012	2T	3_3	12	233	41	23300	19120	-4180	0.18	0.82	41	33	-8
0012	2T	3_3	13	153	32	15300	14570	-730	0.21	0.95	27	25	-2
0012	2T	3_3	14	115	11	11500	4370	-7130	0.10	0.38	20	7	-13
0012	2T	3_3	15	57	4	5700	2530	-3170	0.07	0.44	10	4	-6
0012	2T	3_3	16	24	1	2400	320	-2080	0.04	0.13	4	0	-4
0012	2T	3_3	21	23	4	2300	4380	2080	0.17	1.90	4	7	3
0012	2T	3_3	23	23	2	2300	1980	-320	0.09	0.86	4	3	-1
0012	2T	3_3	24	26	2	2600	2830	230	0.08	1.09	4	5	1
0012	2T	3_3	25	13	2	1300	1350	50	0.15	1.04	2	2	0
0012	2T	3_3	26	9	0	900	0	-900	0.00	0.00	1	0	-1
0012	2T	3_4	12	259	73	25900	24930	-970	0.28	0.96	45	44	-1
0012	2T	3_4	13	164	38	16400	12360	-4040	0.23	0.75	29	21	-8
0012	2T	3_4	14	108	21	10800	10150	-650	0.19	0.94	19	17	-2
0012	2T	3_4	15	39	9	3900	4600	700	0.23	1.18	6	8	2
0012	2T	3_4	16	18	2	1800	2830	1030	0.11	1.57	3	5	2
0012	2T	3_4	21	7	1	700	4130	3430	0.14	5.90	1	7	6
0012	2T	3_4	23	1	0	100	0	-100	0.00	0.00	0	0	0
0012	2T	3_4	24	2	0	200	0	-200	0.00	0.00	0	0	0
0012	2T	3_5	12	225	61	22500	19920	-2580	0.27	0.89	39	35	-4
0012	2T	3_5	13	140	34	14000	12390	-1610	0.24	0.89	24	21	-3
0012	2T	3_5	14	99	16	9900	6900	-3000	0.16	0.70	17	12	-5
0012	2T	3_5	15	36	3	3600	2720	-880	0.08	0.76	6	4	-2
0012	2T	3_5	16	16	2	1600	2450	850	0.13	1.53	2	4	2
0012	2T	3_5	21	18	4	1800	2450	650	0.22	1.36	3	4	1
0012	2T	3_5	23	3	1	300	1040	740	0.33	3.47	0	1	1
0012	2T	3_5	24	4	0	400	0	-400	0.00	0.00	0	0	0
0012	2T	3_5	25	2	0	200	0	-200	0.00	0.00	0	0	0
0012	2T	3_6	12	153	52	15300	12510	-2790	0.34	0.82	27	22	-5
0012	2T	3_6	13	79	23	7900	8000	100	0.29	1.01	13	14	1
0012	2T	3_6	14	47	7	4700	2880	-1820	0.15	0.61	8	5	-3
0012	2T	3_6	15	14	0	1400	0	-1400	0.00	0.00	2	0	-2
0012	2T	3_6	16	2	0	200	0	-200	0.00	0.00	0	0	0
0012	2T	3_6	21	5	0	500	0	-500	0.00	0.00	0	0	0
0012	2T	3_6	23	3	0	300	0	-300	0.00	0.00	0	0	0
0012	2T	3_6	26	2	0	200	0	-200	0.00	0.00	0	0	0
0012	2T	3_else	12	870	238	87000	69690	-17310	0.27	0.80	153	123	-30
0012	2T	3_else	13	471	95	47100	31920	-15180	0.20	0.68	83	56	-27
0012	2T	3_else	14	272	46	27200	20170	-7030	0.17	0.74	48	35	-13
0012	2T	3_else	15	100	19	10000	12110	2110	0.19	1.21	17	21	4
0012	2T	3_else	16	54	9	5400	5060	-340	0.17	0.94	9	8	-1
0012	2T	3_else	21	24	3	2400	1010	-1390	0.13	0.42	4	1	-3
0012	2T	3_else	23	8	0	800	0	-800	0.00	0.00	1	0	-1
0012	2T	3_else	24	8	0	800	0	-800	0.00	0.00	1	0	-1
0012	2T	3_else	25	9	0	900	0	-900	0.00	0.00	1	0	-1
0012	2T	3_else	26	1	0	100	0	-100	0.00	0.00	0	0	0
0012	2T	4_1	12	1099	242	109900	113400	3500	0.22	1.03	194	200	6
0012	2T	4_1	13	797	148	79700	62470	-17230	0.19	0.78	141	110	-31
0012	2T	4_1	14	540	85	54000	41790	-12210	0.16	0.77	95	73	-22
0012	2T	4_1	15	247	27	24700	17020	-7680	0.11	0.69	43	30	-13
0012	2T	4_1	16	136	10	13600	11890	-1710	0.07	0.87	24	21	-3
0012	2T	4_1	21	249	39	24900	24580	-320	0.16	0.99	44	43	-1
0012	2T	4_1	23	212	14	21200	16150	-5050	0.07	0.76	37	28	-9
0012	2T	4_1	24	115	9	11500	6190	-5310	0.08	0.54	20	10	-10
0012	2T	4_1	25	104	16	10400	20690	10290	0.15	1.99	18	36	18
0012	2T	4_1	26	57	2	5700	1160	-4540	0.04	0.20	10	2	-8
0012	2T	4_2	12	189	50	18900	18190	-710	0.26	0.96	33	32	-1
0012	2T	4_2	13	133	37	13300	15410	2110	0.28	1.16	23	27	4
0012	2T	4_2	14	77	19	7700	8770	1070	0.25	1.14	13	15	2
0012	2T	4_2	15	28	4	2800	2020	-780	0.14	0.72	4	3	-1
0012	2T	4_2	16	12	1	1200	2020	820	0.08	1.68	2	3	1
0012	2T	4_2	21	6	0	600	0	-600	0.00	0.00	1	0	-1
0012	2T	4_2	23	2	0	200	0	-200	0.00	0.00	0	0	0
0012	2T	4_2	24	3	0	300	0	-300	0.00	0.00	0	0	0
0012	2T	4_2	25	2	0	200	0	-200	0.00	0.00	0	0	0
0012	2T	4_2	26	1	0	100	0	-100	0.00	0.00	0	0	0
0012	2T	4_3	12	479	93	47900	33840	-14060	0.19	0.71	84	59	-25
0012	2T	4_3	13	354	77	35400	30130	-5270	0.22	0.85	62	53	-9
0012	2T	4_3	14	255	35	25500	18390	-7110	0.14	0.72	45	32	-13
0012	2T	4_3	15	93	9	9300	5840	-3460	0.10	0.63	16	10	-6
0012	2T	4_3	16	57	10	5700	10090	4390	0.18	1.77	10	17	7
0012	2T	4_3	21	57	7	5700	9450	3750	0.12	1.66	10	16	6
0012	2T	4_3	23	66	11	6600	10300	3700	0.17	1.56	11	18	7
0012	2T	4_3	24	37	2	3700	1920	-1780	0.05	0.52	6	3	-3
0012	2T	4_3	25	34	3	3400	2810	-590	0.09	0.83	6	4	-2
0012	2T	4_3	26	23	1	2300	240	-2060	0.04	0.10	4	0	-4
0012	2T	4_4	12	170	52	17000	15630	-1370	0.31	0.92	30	27	-3
0012	2T	4_4	13	115	32	11500	11090	-410	0.28	0.96	20	19	-1
0012	2T	4_4	14	71	14	7100	6540	-560	0.20	0.92	12	11	-1
0012	2T	4_4	15	25	3	2500	1740	-760	0.12	0.70	4	3	-1
0012	2T	4_4	16	6	2	600	2290	1690	0.33	3.82	1	4	3
0012	2T	4_4	21	2	1	200	1210	1010	0.50	6.05	0	2	2
0012	2T	4_4	25	1	0	100	0	-100	0.00	0.00	0	0	0
0012	2T	4_5	12	187	48	18700	15780	-2920	0.26	0.84	33	27	-6
0012	2T	4_5	13	108	29	10800	10010	-790	0.27	0.93	19	17	-2
0012	2T	4_5	14	51	14	5100	5300	200	0.27	1.04	9	9	0
0012	2T	4_5	15	19	6	1900	3730	1830	0.32	1.96	3	6	3
0012	2T	4_5	16	8	0	800	0	-800	0.00	0.00	1	0	-1
0012	2T	4_5	21	3	0	300	0	-300	0.00	0.00	0	0	0
0012	2T	4_5	23	4	0	400	0	-400	0.00	0.00	0	0	0
0012	2T	4_5	24	2	0	200	0	-200	0.00	0.00	0	0	0
0012	2T	4_5	25	2	0	200	0	-200	0.00	0.00	0	0	0
0012	2T	4_5	26	1	0	100	0	-100	0.00	0.00	0	0	0
0012	2T	4_6	12	269	80	26900	20070	-6830	0.30	0.75	47	35	-12
0012	2T	4_6	13	174	52	17400	18040	640	0.30	1.04	30	31	1
0012	2T	4_6	14	76	8	7600	4850	-2750	0.11	0.64	13	8	-5
0012	2T	4_6	15	23	4	2300	2550	250	0.17	1.11	4	4	0
0012	2T	4_6	16	7	0	700	0	-700	0.00	0.00	1	0	-1
0012	2T	4_6	21	7	3	700	1740	1040	0.43	2.49	1	3	2
0012	2T	4_6	23	2	0	200	0	-200	0.00	0.00	0	0	0
0012	2T	4_6	24	2	0	200	0	-200	0.00	0.00	0	0	0
0012	2T	4_6	25	2	0	200	0	-200	0.00	0.00	0	0	0
0012	2T	4_else	12	846	209	84600	66840	-17760	0.25	0.79	149	118	-31
0012	2T	4_else	13	504	103	50400	42900	-7500	0.20	0.85	89	75	-14
0012	2T	4_else	14	330	48	33000	24710	-8290	0.15	0.75	58	43	-15
0012	2T	4_else	15	75	6	7500	5350	-2150	0.08	0.71	13	9	-4
0012	2T	4_else	16	19	1	1900	680	-1220	0.05	0.36	3	1	-2
0012	2T	4_else	21	15	2	1500	4040	2540	0.13	2.69	2	7	5
0012	2T	4_else	23	7	0	700	0	-700	0.00	0.00	1	0	-1
0012	2T	4_else	24	5	1	500	540	40	0.20	1.08	0	0	0
0012	2T	4_else	25	2	0	200	0	-200	0.00	0.00	0	0	0
0012	2T	5_1	12	37	6	3700	2690	-1010	0.16	0.73	6	4	-2
0012	2T	5_1	13	41	9	4100	3780	-320	0.22	0.92	7	6	-1
0012	2T	5_1	14	22	8	2200	2740	540	0.36	1.25	3	4	1
0012	2T	5_1	15	13	2	1300	1230	-70	0.15	0.95	2	2	0
0012	2T	5_1	16	10	2	1000	1360	360	0.20	1.36	1	2	1
0012	2T	5_1	21	3	2	300	980	680	0.67	3.27	0	1	1
0012	2T	5_1	23	3	0	300	0	-300	0.00	0.00	0	0	0
0012	2T	5_1	24	3	0	300	0	-300	0.00	0.00	0	0	0
0012	2T	5_1	25	5	0	500	0	-500	0.00	0.00	0	0	0
0012	2T	5_1	26	1	0	100	0	-100	0.00	0.00	0	0	0
0012	2T	5_2	12	3	0	300	0	-300	0.00	0.00	0	0	0
0012	2T	5_2	13	2	1	200	380	180	0.50	1.90	0	0	0
0012	2T	5_2	14	5	1	500	420	-80	0.20	0.84	0	0	0
0012	2T	5_3	12	1382	308	138200	119790	-18410	0.22	0.87	244	212	-32
0012	2T	5_3	13	980	192	98000	77080	-20920	0.20	0.79	173	136	-37
0012	2T	5_3	14	689	126	68900	55020	-13880	0.18	0.80	121	97	-24
0012	2T	5_3	15	304	38	30400	25080	-5320	0.13	0.83	53	44	-9
0012	2T	5_3	16	204	27	20400	19540	-860	0.13	0.96	36	34	-2
0012	2T	5_3	21	126	21	12600	25080	12480	0.17	1.99	22	44	22
0012	2T	5_3	23	89	4	8900	5090	-3810	0.04	0.57	15	9	-6
0012	2T	5_3	24	47	4	4700	2090	-2610	0.09	0.44	8	3	-5
0012	2T	5_3	25	41	4	4100	7680	3580	0.10	1.87	7	13	6
0012	2T	5_3	26	27	1	2700	790	-1910	0.04	0.29	4	1	-3
0012	2T	5_4	12	7	3	700	960	260	0.43	1.37	1	1	0
0012	2T	5_4	13	1	0	100	0	-100	0.00	0.00	0	0	0
0012	2T	5_4	14	3	0	300	0	-300	0.00	0.00	0	0	0
0012	2T	5_4	15	1	0	100	0	-100	0.00	0.00	0	0	0
0012	2T	5_4	21	1	0	100	0	-100	0.00	0.00	0	0	0
0012	2T	5_4	23	2	0	200	0	-200	0.00	0.00	0	0	0
0012	2T	5_4	25	1	0	100	0	-100	0.00	0.00	0	0	0
0012	2T	5_5	13	1	0	100	0	-100	0.00	0.00	0	0	0
0012	2T	5_5	14	1	0	100	0	-100	0.00	0.00	0	0	0
0012	2T	5_5	15	1	0	100	0	-100	0.00	0.00	0	0	0
0012	2T	5_5	26	1	0	100	0	-100	0.00	0.00	0	0	0
0012	2T	5_6	12	927	316	92700	74500	-18200	0.34	0.80	164	131	-33
0012	2T	5_6	13	486	119	48600	44300	-4300	0.24	0.91	86	78	-8
0012	2T	5_6	14	196	34	19600	19350	-250	0.17	0.99	34	34	0
0012	2T	5_6	15	65	4	6500	5070	-1430	0.06	0.78	11	8	-3
0012	2T	5_6	16	15	0	1500	0	-1500	0.00	0.00	2	0	-2
0012	2T	5_6	21	31	4	3100	2450	-650	0.13	0.79	5	4	-1
0012	2T	5_6	23	14	2	1400	3060	1660	0.14	2.19	2	5	3
0012	2T	5_6	24	4	0	400	0	-400	0.00	0.00	0	0	0
0012	2T	5_6	25	1	0	100	0	-100	0.00	0.00	0	0	0
0012	2T	5_6	26	1	0	100	0	-100	0.00	0.00	0	0	0
0012	2T	5_else	12	569	161	56900	47320	-9580	0.28	0.83	100	83	-17
0012	2T	5_else	13	301	64	30100	28750	-1350	0.21	0.96	53	50	-3
0012	2T	5_else	14	165	33	16500	23940	7440	0.20	1.45	29	42	13
0012	2T	5_else	15	43	5	4300	4850	550	0.12	1.13	7	8	1
0012	2T	5_else	16	9	0	900	0	-900	0.00	0.00	1	0	-1
0012	2T	5_else	21	15	1	1500	960	-540	0.07	0.64	2	1	-1
0012	2T	5_else	23	3	0	300	0	-300	0.00	0.00	0	0	0
0012	2T	5_else	24	4	0	400	0	-400	0.00	0.00	0	0	0
0012	2T	5_else	25	1	0	100	0	-100	0.00	0.00	0	0	0
0012	2T	6_3	12	106	18	10600	7460	-3140	0.17	0.70	18	13	-5
0012	2T	6_3	13	78	9	7800	2650	-5150	0.12	0.34	13	4	-9
0012	2T	6_3	14	62	10	6200	10520	4320	0.16	1.70	10	18	8
0012	2T	6_3	15	37	3	3700	1460	-2240	0.08	0.39	6	2	-4
0012	2T	6_3	16	30	2	3000	3370	370	0.07	1.12	5	5	0
0012	2T	6_3	21	7	1	700	390	-310	0.14	0.56	1	0	-1
0012	2T	6_3	23	5	0	500	0	-500	0.00	0.00	0	0	0
0012	2T	6_3	24	4	0	400	0	-400	0.00	0.00	0	0	0
0012	2T	6_3	25	1	0	100	0	-100	0.00	0.00	0	0	0
0012	2T	6_3	26	3	0	300	0	-300	0.00	0.00	0	0	0
0012	2T	6_4	12	5	2	500	720	220	0.40	1.44	0	1	1
0012	2T	6_4	13	2	1	200	290	90	0.50	1.45	0	0	0
0012	2T	6_4	14	3	0	300	0	-300	0.00	0.00	0	0	0
0012	2T	6_4	23	1	1	100	1820	1720	1.00	18.20	0	3	3
0012	2T	6_6	12	78	25	7800	5890	-1910	0.32	0.76	13	10	-3
0012	2T	6_6	13	35	5	3500	1570	-1930	0.14	0.45	6	2	-4
0012	2T	6_6	14	18	1	1800	380	-1420	0.06	0.21	3	0	-3
0012	2T	6_6	15	6	0	600	0	-600	0.00	0.00	1	0	-1
0012	2T	6_6	16	1	0	100	0	-100	0.00	0.00	0	0	0
0012	2T	6_6	21	2	0	200	0	-200	0.00	0.00	0	0	0
0012	2T	6_6	24	1	0	100	0	-100	0.00	0.00	0	0	0
0012	2T	6_else	12	29	6	2900	1630	-1270	0.21	0.56	5	2	-3
0012	2T	6_else	13	19	3	1900	760	-1140	0.16	0.40	3	1	-2
0012	2T	6_else	14	4	1	400	330	-70	0.25	0.83	0	0	0
0012	2T	6_else	15	3	0	300	0	-300	0.00	0.00	0	0	0
0012	2T	6_else	16	1	0	100	0	-100	0.00	0.00	0	0	0
0012	2T	7_3	12	2581	620	258100	220750	-37350	0.24	0.86	456	390	-66
0012	2T	7_3	13	1655	350	165500	146970	-18530	0.21	0.89	292	260	-32
0012	2T	7_3	14	1086	197	108600	92840	-15760	0.18	0.85	192	164	-28
0012	2T	7_3	15	457	58	45700	44440	-1260	0.13	0.97	80	78	-2
0012	2T	7_3	16	298	32	29800	23180	-6620	0.11	0.78	52	41	-11
0012	2T	7_3	21	216	35	21600	29480	7880	0.16	1.36	38	52	14
0012	2T	7_3	23	186	13	18600	20600	2000	0.07	1.11	32	36	4
0012	2T	7_3	24	84	9	8400	7030	-1370	0.11	0.84	14	12	-2
0012	2T	7_3	25	70	3	7000	4370	-2630	0.04	0.62	12	7	-5
0012	2T	7_3	26	68	4	6800	5700	-1100	0.06	0.84	12	10	-2
0012	2T	7_4	12	989	299	98900	89720	-9180	0.30	0.91	175	158	-17
0012	2T	7_4	13	498	96	49800	39310	-10490	0.19	0.79	88	69	-19
0012	2T	7_4	14	286	42	28600	24650	-3950	0.15	0.86	50	43	-7
0012	2T	7_4	15	91	6	9100	5080	-4020	0.07	0.56	16	8	-8
0012	2T	7_4	16	41	1	4100	1150	-2950	0.02	0.28	7	2	-5
0012	2T	7_4	21	38	6	3800	3560	-240	0.16	0.94	6	6	0
0012	2T	7_4	23	22	0	2200	0	-2200	0.00	0.00	3	0	-3
0012	2T	7_4	24	11	1	1100	1730	630	0.09	1.57	1	3	2
0012	2T	7_4	25	5	0	500	0	-500	0.00	0.00	0	0	0
0012	2T	7_5	12	6	0	600	0	-600	0.00	0.00	1	0	-1
0012	2T	7_5	13	2	1	200	290	90	0.50	1.45	0	0	0
0012	2T	7_5	14	3	1	300	560	260	0.33	1.87	0	0	0
0012	2T	7_5	15	1	0	100	0	-100	0.00	0.00	0	0	0
0012	2T	7_5	16	2	1	200	330	130	0.50	1.65	0	0	0
0012	2T	7_7	12	537	159	53700	45870	-7830	0.30	0.85	95	81	-14
0012	2T	7_7	13	228	42	22800	16270	-6530	0.18	0.71	40	28	-12
0012	2T	7_7	14	164	25	16400	12880	-3520	0.15	0.79	29	22	-7
0012	2T	7_7	15	47	6	4700	6370	1670	0.13	1.36	8	11	3
0012	2T	7_7	16	11	1	1100	990	-110	0.09	0.90	1	1	0
0012	2T	7_7	21	13	2	1300	1380	80	0.15	1.06	2	2	0
0012	2T	7_7	23	3	0	300	0	-300	0.00	0.00	0	0	0
0012	2T	7_7	24	1	0	100	0	-100	0.00	0.00	0	0	0
0012	2T	7_else	12	727	211	72700	63930	-8770	0.29	0.88	128	113	-15
0012	2T	7_else	13	389	81	38900	33470	-5430	0.21	0.86	68	59	-9
0012	2T	7_else	14	224	41	22400	20240	-2160	0.18	0.90	39	35	-4
0012	2T	7_else	15	48	5	4800	5570	770	0.10	1.16	8	9	1
0012	2T	7_else	16	15	1	1500	440	-1060	0.07	0.29	2	0	-2
0012	2T	7_else	21	14	4	1400	6880	5480	0.29	4.91	2	12	10
0012	2T	7_else	23	6	0	600	0	-600	0.00	0.00	1	0	-1
0012	2T	7_else	24	4	0	400	0	-400	0.00	0.00	0	0	0
0012	2T	7_else	25	2	0	200	0	-200	0.00	0.00	0	0	0
0012	2T	7_else	26	1	0	100	0	-100	0.00	0.00	0	0	0
0012	3F	1_1	123	1239	212	123900	95120	-28780	0.17	0.77	219	168	-51
0012	3F	1_1	124	932	171	93200	83430	-9770	0.18	0.90	164	147	-17
0012	3F	1_1	125	515	63	51500	37080	-14420	0.12	0.72	91	65	-26
0012	3F	1_1	126	403	51	40300	39730	-570	0.13	0.99	71	70	-1
0012	3F	1_1	134	740	108	74000	61270	-12730	0.15	0.83	130	108	-22
0012	3F	1_1	135	384	40	38400	27700	-10700	0.10	0.72	67	49	-18
0012	3F	1_1	136	300	31	30000	30240	240	0.10	1.01	53	53	0
0012	3F	1_1	145	238	25	23800	18360	-5440	0.11	0.77	42	32	-10
0012	3F	1_1	146	190	8	19000	6990	-12010	0.04	0.37	33	12	-21
0012	3F	1_1	156	107	4	10700	3760	-6940	0.04	0.35	18	6	-12
0012	3F	1_1	234	99	10	9900	9480	-420	0.10	0.96	17	16	-1
0012	3F	1_1	235	54	7	5400	4830	-570	0.13	0.89	9	8	-1
0012	3F	1_1	236	57	4	5700	3940	-1760	0.07	0.69	10	6	-4
0012	3F	1_1	245	25	2	2500	1010	-1490	0.08	0.40	4	1	-3
0012	3F	1_1	246	33	4	3300	4990	1690	0.12	1.51	5	8	3
0012	3F	1_1	256	28	1	2800	4190	1390	0.04	1.50	4	7	3
0012	3F	1_2	123	197	37	19700	16940	-2760	0.19	0.86	34	29	-5
0012	3F	1_2	124	167	30	16700	15550	-1150	0.18	0.93	29	27	-2
0012	3F	1_2	125	89	14	8900	11440	2540	0.16	1.29	15	20	5
0012	3F	1_2	126	63	4	6300	2770	-3530	0.06	0.44	11	4	-7
0012	3F	1_2	134	93	10	9300	6100	-3200	0.11	0.66	16	10	-6
0012	3F	1_2	135	59	7	5900	3490	-2410	0.12	0.59	10	6	-4
0012	3F	1_2	136	45	1	4500	490	-4010	0.02	0.11	7	0	-7
0012	3F	1_2	145	44	2	4400	4630	230	0.05	1.05	7	8	1
0012	3F	1_2	146	22	2	2200	2790	590	0.09	1.27	3	4	1
0012	3F	1_2	156	13	0	1300	0	-1300	0.00	0.00	2	0	-2
0012	3F	1_2	235	4	0	400	0	-400	0.00	0.00	0	0	0
0012	3F	1_2	245	3	0	300	0	-300	0.00	0.00	0	0	0
0012	3F	1_3	123	1	0	100	0	-100	0.00	0.00	0	0	0
0012	3F	1_3	135	2	0	200	0	-200	0.00	0.00	0	0	0
0012	3F	1_3	145	2	0	200	0	-200	0.00	0.00	0	0	0
0012	3F	1_4	123	85	14	8500	5430	-3070	0.16	0.64	15	9	-6
0012	3F	1_4	124	59	11	5900	5530	-370	0.19	0.94	10	9	-1
0012	3F	1_4	125	47	6	4700	4520	-180	0.13	0.96	8	8	0
0012	3F	1_4	126	34	5	3400	8140	4740	0.15	2.39	6	14	8
0012	3F	1_4	134	75	15	7500	10110	2610	0.20	1.35	13	17	4
0012	3F	1_4	135	41	4	4100	2820	-1280	0.10	0.69	7	4	-3
0012	3F	1_4	136	45	3	4500	3260	-1240	0.07	0.72	7	5	-2
0012	3F	1_4	145	23	1	2300	1720	-580	0.04	0.75	4	3	-1
0012	3F	1_4	146	18	0	1800	0	-1800	0.00	0.00	3	0	-3
0012	3F	1_4	156	14	2	1400	7960	6560	0.14	5.69	2	14	12
0012	3F	1_4	234	1	0	100	0	-100	0.00	0.00	0	0	0
0012	3F	1_4	235	1	0	100	0	-100	0.00	0.00	0	0	0
0012	3F	1_5	123	85	18	8500	6850	-1650	0.21	0.81	15	12	-3
0012	3F	1_5	124	104	24	10400	8920	-1480	0.23	0.86	18	15	-3
0012	3F	1_5	125	48	7	4800	4430	-370	0.15	0.92	8	7	-1
0012	3F	1_5	126	36	4	3600	4500	900	0.11	1.25	6	7	1
0012	3F	1_5	134	54	15	5400	11020	5620	0.28	2.04	9	19	10
0012	3F	1_5	135	43	3	4300	1300	-3000	0.07	0.30	7	2	-5
0012	3F	1_5	136	30	2	3000	2090	-910	0.07	0.70	5	3	-2
0012	3F	1_5	145	16	0	1600	0	-1600	0.00	0.00	2	0	-2
0012	3F	1_5	146	19	2	1900	1420	-480	0.11	0.75	3	2	-1
0012	3F	1_5	156	1	0	100	0	-100	0.00	0.00	0	0	0
0012	3F	1_5	234	5	1	500	1400	900	0.20	2.80	0	2	2
0012	3F	1_5	235	2	0	200	0	-200	0.00	0.00	0	0	0
0012	3F	1_5	245	1	0	100	0	-100	0.00	0.00	0	0	0
0012	3F	1_5	246	1	0	100	0	-100	0.00	0.00	0	0	0
0012	3F	1_else	123	452	92	45200	33640	-11560	0.20	0.74	80	59	-21
0012	3F	1_else	124	361	49	36100	22450	-13650	0.14	0.62	63	39	-24
0012	3F	1_else	125	187	18	18700	15010	-3690	0.10	0.80	33	26	-7
0012	3F	1_else	126	141	7	14100	17990	3890	0.05	1.28	24	31	7
0012	3F	1_else	134	254	41	25400	25890	490	0.16	1.02	44	45	1
0012	3F	1_else	135	114	8	11400	7800	-3600	0.07	0.68	20	13	-7
0012	3F	1_else	136	64	5	6400	7290	890	0.08	1.14	11	12	1
0012	3F	1_else	145	90	9	9000	8680	-320	0.10	0.96	15	15	0
0012	3F	1_else	146	62	5	6200	10290	4090	0.08	1.66	10	18	8
0012	3F	1_else	156	26	0	2600	0	-2600	0.00	0.00	4	0	-4
0012	3F	1_else	234	7	0	700	0	-700	0.00	0.00	1	0	-1
0012	3F	1_else	235	2	0	200	0	-200	0.00	0.00	0	0	0
0012	3F	1_else	245	2	0	200	0	-200	0.00	0.00	0	0	0
0012	3F	2_1	123	1020	190	102000	82290	-19710	0.19	0.81	180	145	-35
0012	3F	2_1	124	750	139	75000	63090	-11910	0.19	0.84	132	111	-21
0012	3F	2_1	125	535	78	53500	46140	-7360	0.15	0.86	94	81	-13
0012	3F	2_1	126	513	72	51300	48350	-2950	0.14	0.94	90	85	-5
0012	3F	2_1	134	512	81	51200	50990	-210	0.16	1.00	90	90	0
0012	3F	2_1	135	308	37	30800	21590	-9210	0.12	0.70	54	38	-16
0012	3F	2_1	136	339	46	33900	25120	-8780	0.14	0.74	60	44	-16
0012	3F	2_1	145	223	30	22300	13940	-8360	0.13	0.63	39	24	-15
0012	3F	2_1	146	192	17	19200	19910	710	0.09	1.04	33	35	2
0012	3F	2_1	156	106	6	10600	4760	-5840	0.06	0.45	18	8	-10
0012	3F	2_1	234	85	15	8500	10660	2160	0.18	1.25	15	18	3
0012	3F	2_1	235	68	7	6800	9620	2820	0.10	1.41	12	17	5
0012	3F	2_1	236	84	11	8400	7770	-630	0.13	0.93	14	13	-1
0012	3F	2_1	245	55	6	5500	10510	5010	0.11	1.91	9	18	9
0012	3F	2_1	246	45	4	4500	4570	70	0.09	1.02	7	8	1
0012	3F	2_1	256	52	9	5200	11140	5940	0.17	2.14	9	19	10
0012	3F	2_2	123	199	35	19900	14990	-4910	0.18	0.75	35	26	-9
0012	3F	2_2	124	166	29	16600	13540	-3060	0.17	0.82	29	23	-6
0012	3F	2_2	125	84	13	8400	7260	-1140	0.15	0.86	14	12	-2
0012	3F	2_2	126	79	7	7900	3700	-4200	0.09	0.47	13	6	-7
0012	3F	2_2	134	108	13	10800	5800	-5000	0.12	0.54	19	10	-9
0012	3F	2_2	135	70	5	7000	3280	-3720	0.07	0.47	12	5	-7
0012	3F	2_2	136	76	6	7600	5750	-1850	0.08	0.76	13	10	-3
0012	3F	2_2	145	58	4	5800	4630	-1170	0.07	0.80	10	8	-2
0012	3F	2_2	146	43	2	4300	1530	-2770	0.05	0.36	7	2	-5
0012	3F	2_2	156	19	1	1900	870	-1030	0.05	0.46	3	1	-2
0012	3F	2_2	234	2	0	200	0	-200	0.00	0.00	0	0	0
0012	3F	2_2	236	2	0	200	0	-200	0.00	0.00	0	0	0
0012	3F	2_2	245	2	0	200	0	-200	0.00	0.00	0	0	0
0012	3F	2_2	246	1	0	100	0	-100	0.00	0.00	0	0	0
0012	3F	2_2	256	1	0	100	0	-100	0.00	0.00	0	0	0
0012	3F	2_3	123	1	1	100	700	600	1.00	7.00	0	1	1
0012	3F	2_3	124	1	0	100	0	-100	0.00	0.00	0	0	0
0012	3F	2_3	125	1	0	100	0	-100	0.00	0.00	0	0	0
0012	3F	2_3	136	1	0	100	0	-100	0.00	0.00	0	0	0
0012	3F	2_4	123	108	22	10800	6940	-3860	0.20	0.64	19	12	-7
0012	3F	2_4	124	86	14	8600	4910	-3690	0.16	0.57	15	8	-7
0012	3F	2_4	125	57	7	5700	4860	-840	0.12	0.85	10	8	-2
0012	3F	2_4	126	44	2	4400	2120	-2280	0.05	0.48	7	3	-4
0012	3F	2_4	134	62	8	6200	4830	-1370	0.13	0.78	10	8	-2
0012	3F	2_4	135	44	5	4400	2070	-2330	0.11	0.47	7	3	-4
0012	3F	2_4	136	31	1	3100	590	-2510	0.03	0.19	5	1	-4
0012	3F	2_4	145	28	2	2800	850	-1950	0.07	0.30	4	1	-3
0012	3F	2_4	146	25	0	2500	0	-2500	0.00	0.00	4	0	-4
0012	3F	2_4	156	5	0	500	0	-500	0.00	0.00	0	0	0
0012	3F	2_4	234	1	0	100	0	-100	0.00	0.00	0	0	0
0012	3F	2_4	235	1	0	100	0	-100	0.00	0.00	0	0	0
0012	3F	2_4	245	1	0	100	0	-100	0.00	0.00	0	0	0
0012	3F	2_5	123	92	27	9200	11080	1880	0.29	1.20	16	19	3
0012	3F	2_5	124	89	25	8900	11170	2270	0.28	1.26	15	19	4
0012	3F	2_5	125	53	7	5300	2260	-3040	0.13	0.43	9	4	-5
0012	3F	2_5	126	42	2	4200	530	-3670	0.05	0.13	7	0	-7
0012	3F	2_5	134	57	5	5700	5810	110	0.09	1.02	10	10	0
0012	3F	2_5	135	42	9	4200	6880	2680	0.21	1.64	7	12	5
0012	3F	2_5	136	34	2	3400	2770	-630	0.06	0.81	6	4	-2
0012	3F	2_5	145	27	1	2700	280	-2420	0.04	0.10	4	0	-4
0012	3F	2_5	146	15	1	1500	460	-1040	0.07	0.31	2	0	-2
0012	3F	2_5	156	5	1	500	1100	600	0.20	2.20	0	1	1
0012	3F	2_5	234	1	1	100	770	670	1.00	7.70	0	1	1
0012	3F	2_5	235	3	0	300	0	-300	0.00	0.00	0	0	0
0012	3F	2_5	236	4	0	400	0	-400	0.00	0.00	0	0	0
0012	3F	2_5	245	1	0	100	0	-100	0.00	0.00	0	0	0
0012	3F	2_5	246	2	0	200	0	-200	0.00	0.00	0	0	0
0012	3F	2_5	256	1	0	100	0	-100	0.00	0.00	0	0	0
0012	3F	2_else	123	455	87	45500	39880	-5620	0.19	0.88	80	70	-10
0012	3F	2_else	124	312	63	31200	29620	-1580	0.20	0.95	55	52	-3
0012	3F	2_else	125	147	16	14700	13650	-1050	0.11	0.93	26	24	-2
0012	3F	2_else	126	118	7	11800	7230	-4570	0.06	0.61	20	12	-8
0012	3F	2_else	134	217	36	21700	21280	-420	0.17	0.98	38	37	-1
0012	3F	2_else	135	121	7	12100	7310	-4790	0.06	0.60	21	12	-9
0012	3F	2_else	136	59	7	5900	4610	-1290	0.12	0.78	10	8	-2
0012	3F	2_else	145	57	6	5700	6800	1100	0.11	1.19	10	12	2
0012	3F	2_else	146	28	2	2800	1170	-1630	0.07	0.42	4	2	-2
0012	3F	2_else	156	14	0	1400	0	-1400	0.00	0.00	2	0	-2
0012	3F	2_else	234	4	0	400	0	-400	0.00	0.00	0	0	0
0012	3F	2_else	235	1	0	100	0	-100	0.00	0.00	0	0	0
0012	3F	2_else	245	3	0	300	0	-300	0.00	0.00	0	0	0
0012	3F	2_else	246	1	0	100	0	-100	0.00	0.00	0	0	0
0012	3F	3_1	123	857	168	85700	71500	-14200	0.20	0.83	151	126	-25
0012	3F	3_1	124	671	112	67100	47700	-19400	0.17	0.71	118	84	-34
0012	3F	3_1	125	487	71	48700	32130	-16570	0.15	0.66	86	56	-30
0012	3F	3_1	126	443	53	44300	39110	-5190	0.12	0.88	78	69	-9
0012	3F	3_1	134	439	66	43900	37260	-6640	0.15	0.85	77	65	-12
0012	3F	3_1	135	323	46	32300	22080	-10220	0.14	0.68	57	39	-18
0012	3F	3_1	136	265	31	26500	26530	30	0.12	1.00	46	46	0
0012	3F	3_1	145	187	21	18700	17180	-1520	0.11	0.92	33	30	-3
0012	3F	3_1	146	144	15	14400	12750	-1650	0.10	0.89	25	22	-3
0012	3F	3_1	156	121	9	12100	11590	-510	0.07	0.96	21	20	-1
0012	3F	3_1	234	57	4	5700	1390	-4310	0.07	0.24	10	2	-8
0012	3F	3_1	235	67	8	6700	10130	3430	0.12	1.51	11	17	6
0012	3F	3_1	236	80	6	8000	2310	-5690	0.08	0.29	14	4	-10
0012	3F	3_1	245	33	3	3300	4180	880	0.09	1.27	5	7	2
0012	3F	3_1	246	35	2	3500	1850	-1650	0.06	0.53	6	3	-3
0012	3F	3_1	256	38	5	3800	7480	3680	0.13	1.97	6	13	7
0012	3F	3_2	123	144	28	14400	12460	-1940	0.19	0.87	25	22	-3
0012	3F	3_2	124	138	14	13800	7240	-6560	0.10	0.52	24	12	-12
0012	3F	3_2	125	77	6	7700	2630	-5070	0.08	0.34	13	4	-9
0012	3F	3_2	126	76	7	7600	9290	1690	0.09	1.22	13	16	3
0012	3F	3_2	134	102	19	10200	13420	3220	0.19	1.32	18	23	5
0012	3F	3_2	135	75	11	7500	7200	-300	0.15	0.96	13	12	-1
0012	3F	3_2	136	51	3	5100	3470	-1630	0.06	0.68	9	6	-3
0012	3F	3_2	145	43	4	4300	3140	-1160	0.09	0.73	7	5	-2
0012	3F	3_2	146	25	3	2500	1490	-1010	0.12	0.60	4	2	-2
0012	3F	3_2	156	15	0	1500	0	-1500	0.00	0.00	2	0	-2
0012	3F	3_2	234	6	0	600	0	-600	0.00	0.00	1	0	-1
0012	3F	3_2	235	3	0	300	0	-300	0.00	0.00	0	0	0
0012	3F	3_2	246	1	0	100	0	-100	0.00	0.00	0	0	0
0012	3F	3_3	123	110	18	11000	6990	-4010	0.16	0.64	19	12	-7
0012	3F	3_3	124	89	16	8900	8190	-710	0.18	0.92	15	14	-1
0012	3F	3_3	125	62	8	6200	4050	-2150	0.13	0.65	10	7	-3
0012	3F	3_3	126	41	3	4100	2020	-2080	0.07	0.49	7	3	-4
0012	3F	3_3	134	64	14	6400	6320	-80	0.22	0.99	11	11	0
0012	3F	3_3	135	44	6	4400	3400	-1000	0.14	0.77	7	6	-1
0012	3F	3_3	136	20	4	2000	2550	550	0.20	1.28	3	4	1
0012	3F	3_3	145	32	4	3200	1900	-1300	0.13	0.59	5	3	-2
0012	3F	3_3	146	18	3	1800	2950	1150	0.17	1.64	3	5	2
0012	3F	3_3	156	10	0	1000	0	-1000	0.00	0.00	1	0	-1
0012	3F	3_3	234	11	0	1100	0	-1100	0.00	0.00	1	0	-1
0012	3F	3_3	235	7	0	700	0	-700	0.00	0.00	1	0	-1
0012	3F	3_3	236	4	0	400	0	-400	0.00	0.00	0	0	0
0012	3F	3_3	245	1	0	100	0	-100	0.00	0.00	0	0	0
0012	3F	3_3	246	7	0	700	0	-700	0.00	0.00	1	0	-1
0012	3F	3_3	256	1	0	100	0	-100	0.00	0.00	0	0	0
0012	3F	3_4	123	103	25	10300	10260	-40	0.24	1.00	18	18	0
0012	3F	3_4	124	109	22	10900	12260	1360	0.20	1.12	19	21	2
0012	3F	3_4	125	55	6	5500	4700	-800	0.11	0.85	9	8	-1
0012	3F	3_4	126	48	3	4800	10260	5460	0.06	2.14	8	18	10
0012	3F	3_4	134	54	11	5400	5670	270	0.20	1.05	9	10	1
0012	3F	3_4	135	39	3	3900	1270	-2630	0.08	0.33	6	2	-4
0012	3F	3_4	136	30	5	3000	4100	1100	0.17	1.37	5	7	2
0012	3F	3_4	145	28	5	2800	4700	1900	0.18	1.68	4	8	4
0012	3F	3_4	146	20	0	2000	0	-2000	0.00	0.00	3	0	-3
0012	3F	3_4	156	11	1	1100	800	-300	0.09	0.73	1	1	0
0012	3F	3_4	236	1	0	100	0	-100	0.00	0.00	0	0	0
0012	3F	3_4	245	1	0	100	0	-100	0.00	0.00	0	0	0
0012	3F	3_5	123	99	23	9900	10090	190	0.23	1.02	17	17	0
0012	3F	3_5	124	68	17	6800	6850	50	0.25	1.01	12	12	0
0012	3F	3_5	125	58	8	5800	4680	-1120	0.14	0.81	10	8	-2
0012	3F	3_5	126	43	3	4300	920	-3380	0.07	0.21	7	1	-6
0012	3F	3_5	134	55	5	5500	1710	-3790	0.09	0.31	9	3	-6
0012	3F	3_5	135	34	4	3400	3790	390	0.12	1.11	6	6	0
0012	3F	3_5	136	35	1	3500	1230	-2270	0.03	0.35	6	2	-4
0012	3F	3_5	145	19	1	1900	300	-1600	0.05	0.16	3	0	-3
0012	3F	3_5	146	23	3	2300	2200	-100	0.13	0.96	4	3	-1
0012	3F	3_5	156	10	0	1000	0	-1000	0.00	0.00	1	0	-1
0012	3F	3_5	234	2	0	200	0	-200	0.00	0.00	0	0	0
0012	3F	3_5	235	1	1	100	920	820	1.00	9.20	0	1	1
0012	3F	3_5	245	2	0	200	0	-200	0.00	0.00	0	0	0
0012	3F	3_5	246	1	0	100	0	-100	0.00	0.00	0	0	0
0012	3F	3_6	123	62	21	6200	5810	-390	0.34	0.94	10	10	0
0012	3F	3_6	124	56	17	5600	6820	1220	0.30	1.22	9	12	3
0012	3F	3_6	125	28	1	2800	460	-2340	0.04	0.16	4	0	-4
0012	3F	3_6	126	17	3	1700	1850	150	0.18	1.09	3	3	0
0012	3F	3_6	134	29	2	2900	1780	-1120	0.07	0.61	5	3	-2
0012	3F	3_6	135	14	0	1400	0	-1400	0.00	0.00	2	0	-2
0012	3F	3_6	136	13	0	1300	0	-1300	0.00	0.00	2	0	-2
0012	3F	3_6	145	15	0	1500	0	-1500	0.00	0.00	2	0	-2
0012	3F	3_6	146	6	0	600	0	-600	0.00	0.00	1	0	-1
0012	3F	3_6	156	1	0	100	0	-100	0.00	0.00	0	0	0
0012	3F	3_6	234	1	0	100	0	-100	0.00	0.00	0	0	0
0012	3F	3_6	246	1	0	100	0	-100	0.00	0.00	0	0	0
0012	3F	3_else	123	384	86	38400	29550	-8850	0.22	0.77	67	52	-15
0012	3F	3_else	124	291	53	29100	21470	-7630	0.18	0.74	51	38	-13
0012	3F	3_else	125	161	19	16100	9370	-6730	0.12	0.58	28	16	-12
0012	3F	3_else	126	127	18	12700	12880	180	0.14	1.01	22	22	0
0012	3F	3_else	134	172	23	17200	10710	-6490	0.13	0.62	30	18	-12
0012	3F	3_else	135	108	15	10800	8750	-2050	0.14	0.81	19	15	-4
0012	3F	3_else	136	66	8	6600	5330	-1270	0.12	0.81	11	9	-2
0012	3F	3_else	145	69	7	6900	3960	-2940	0.10	0.57	12	7	-5
0012	3F	3_else	146	36	3	3600	1910	-1690	0.08	0.53	6	3	-3
0012	3F	3_else	156	18	3	1800	2600	800	0.17	1.44	3	4	1
0012	3F	3_else	234	2	0	200	0	-200	0.00	0.00	0	0	0
0012	3F	3_else	235	3	0	300	0	-300	0.00	0.00	0	0	0
0012	3F	3_else	245	1	0	100	0	-100	0.00	0.00	0	0	0
0012	3F	3_else	246	4	0	400	0	-400	0.00	0.00	0	0	0
0012	3F	3_else	256	2	0	200	0	-200	0.00	0.00	0	0	0
0012	3F	4_1	123	579	122	57900	46580	-11320	0.21	0.80	102	82	-20
0012	3F	4_1	124	453	78	45300	31270	-14030	0.17	0.69	80	55	-25
0012	3F	4_1	125	319	50	31900	29250	-2650	0.16	0.92	56	51	-5
0012	3F	4_1	126	231	21	23100	16150	-6950	0.09	0.70	40	28	-12
0012	3F	4_1	134	314	58	31400	30910	-490	0.18	0.98	55	54	-1
0012	3F	4_1	135	202	26	20200	11520	-8680	0.13	0.57	35	20	-15
0012	3F	4_1	136	150	13	15000	9200	-5800	0.09	0.61	26	16	-10
0012	3F	4_1	145	126	15	12600	10300	-2300	0.12	0.82	22	18	-4
0012	3F	4_1	146	77	7	7700	3740	-3960	0.09	0.49	13	6	-7
0012	3F	4_1	156	46	8	4600	10990	6390	0.17	2.39	8	19	11
0012	3F	4_1	234	77	8	7700	4980	-2720	0.10	0.65	13	8	-5
0012	3F	4_1	235	67	12	6700	10550	3850	0.18	1.57	11	18	7
0012	3F	4_1	236	41	6	4100	4130	30	0.15	1.01	7	7	0
0012	3F	4_1	245	38	3	3800	2730	-1070	0.08	0.72	6	4	-2
0012	3F	4_1	246	32	1	3200	3990	790	0.03	1.25	5	7	2
0012	3F	4_1	256	20	0	2000	0	-2000	0.00	0.00	3	0	-3
0012	3F	4_2	123	88	15	8800	7040	-1760	0.17	0.80	15	12	-3
0012	3F	4_2	124	68	19	6800	7020	220	0.28	1.03	12	12	0
0012	3F	4_2	125	49	11	4900	7210	2310	0.22	1.47	8	12	4
0012	3F	4_2	126	39	2	3900	2200	-1700	0.05	0.56	6	3	-3
0012	3F	4_2	134	56	8	5600	3520	-2080	0.14	0.63	9	6	-3
0012	3F	4_2	135	32	4	3200	2130	-1070	0.13	0.67	5	3	-2
0012	3F	4_2	136	26	6	2600	3930	1330	0.23	1.51	4	6	2
0012	3F	4_2	145	9	1	900	380	-520	0.11	0.42	1	0	-1
0012	3F	4_2	146	18	2	1800	3310	1510	0.11	1.84	3	5	2
0012	3F	4_2	156	6	0	600	0	-600	0.00	0.00	1	0	-1
0012	3F	4_2	234	1	0	100	0	-100	0.00	0.00	0	0	0
0012	3F	4_2	235	1	0	100	0	-100	0.00	0.00	0	0	0
0012	3F	4_2	236	2	0	200	0	-200	0.00	0.00	0	0	0
0012	3F	4_2	245	2	0	200	0	-200	0.00	0.00	0	0	0
0012	3F	4_3	123	250	56	25000	23800	-1200	0.22	0.95	44	42	-2
0012	3F	4_3	124	190	30	19000	10710	-8290	0.16	0.56	33	18	-15
0012	3F	4_3	125	133	20	13300	14490	1190	0.15	1.09	23	25	2
0012	3F	4_3	126	82	10	8200	7400	-800	0.12	0.90	14	13	-1
0012	3F	4_3	134	146	25	14600	16390	1790	0.17	1.12	25	29	4
0012	3F	4_3	135	91	12	9100	5810	-3290	0.13	0.64	16	10	-6
0012	3F	4_3	136	61	6	6100	3120	-2980	0.10	0.51	10	5	-5
0012	3F	4_3	145	56	3	5600	1580	-4020	0.05	0.28	9	2	-7
0012	3F	4_3	146	37	2	3700	2400	-1300	0.05	0.65	6	4	-2
0012	3F	4_3	156	14	0	1400	0	-1400	0.00	0.00	2	0	-2
0012	3F	4_3	234	24	3	2400	1300	-1100	0.13	0.54	4	2	-2
0012	3F	4_3	235	23	6	2300	3200	900	0.26	1.39	4	5	1
0012	3F	4_3	236	17	2	1700	400	-1300	0.12	0.24	3	0	-3
0012	3F	4_3	245	15	2	1500	600	-900	0.13	0.40	2	1	-1
0012	3F	4_3	246	9	0	900	0	-900	0.00	0.00	1	0	-1
0012	3F	4_3	256	8	1	800	1830	1030	0.13	2.29	1	3	2
0012	3F	4_4	123	77	17	7700	6490	-1210	0.22	0.84	13	11	-2
0012	3F	4_4	124	69	14	6900	4810	-2090	0.20	0.70	12	8	-4
0012	3F	4_4	125	40	4	4000	2120	-1880	0.10	0.53	7	3	-4
0012	3F	4_4	126	21	0	2100	0	-2100	0.00	0.00	3	0	-3
0012	3F	4_4	134	52	10	5200	5260	60	0.19	1.01	9	9	0
0012	3F	4_4	135	26	3	2600	2600	0	0.12	1.00	4	4	0
0012	3F	4_4	136	14	5	1400	2610	1210	0.36	1.86	2	4	2
0012	3F	4_4	145	11	3	1100	1120	20	0.27	1.02	1	1	0
0012	3F	4_4	146	11	0	1100	0	-1100	0.00	0.00	1	0	-1
0012	3F	4_4	156	6	1	600	1480	880	0.17	2.47	1	2	1
0012	3F	4_4	256	1	0	100	0	-100	0.00	0.00	0	0	0
0012	3F	4_5	123	69	10	6900	4170	-2730	0.14	0.60	12	7	-5
0012	3F	4_5	124	63	7	6300	3500	-2800	0.11	0.56	11	6	-5
0012	3F	4_5	125	41	5	4100	2090	-2010	0.12	0.51	7	3	-4
0012	3F	4_5	126	26	2	2600	3790	1190	0.08	1.46	4	6	2
0012	3F	4_5	134	49	7	4900	3850	-1050	0.14	0.79	8	6	-2
0012	3F	4_5	135	19	5	1900	4380	2480	0.26	2.31	3	7	4
0012	3F	4_5	136	18	1	1800	1000	-800	0.06	0.56	3	1	-2
0012	3F	4_5	145	8	1	800	690	-110	0.13	0.86	1	1	0
0012	3F	4_5	146	6	1	600	570	-30	0.17	0.95	1	1	0
0012	3F	4_5	156	2	0	200	0	-200	0.00	0.00	0	0	0
0012	3F	4_5	234	2	0	200	0	-200	0.00	0.00	0	0	0
0012	3F	4_5	236	2	0	200	0	-200	0.00	0.00	0	0	0
0012	3F	4_5	245	1	1	100	370	270	1.00	3.70	0	0	0
0012	3F	4_6	123	119	29	11900	7490	-4410	0.24	0.63	21	13	-8
0012	3F	4_6	124	101	17	10100	5630	-4470	0.17	0.56	17	9	-8
0012	3F	4_6	125	46	7	4600	3440	-1160	0.15	0.75	8	6	-2
0012	3F	4_6	126	33	0	3300	0	-3300	0.00	0.00	5	0	-5
0012	3F	4_6	134	64	13	6400	7210	810	0.20	1.13	11	12	1
0012	3F	4_6	135	43	4	4300	3240	-1060	0.09	0.75	7	5	-2
0012	3F	4_6	136	30	5	3000	8860	5860	0.17	2.95	5	15	10
0012	3F	4_6	145	23	0	2300	0	-2300	0.00	0.00	4	0	-4
0012	3F	4_6	146	10	1	1000	2650	1650	0.10	2.65	1	4	3
0012	3F	4_6	156	4	0	400	0	-400	0.00	0.00	0	0	0
0012	3F	4_6	234	1	0	100	0	-100	0.00	0.00	0	0	0
0012	3F	4_6	236	1	0	100	0	-100	0.00	0.00	0	0	0
0012	3F	4_6	245	2	0	200	0	-200	0.00	0.00	0	0	0
0012	3F	4_6	256	1	0	100	0	-100	0.00	0.00	0	0	0
0012	3F	4_else	123	463	104	46300	35680	-10620	0.22	0.77	81	63	-18
0012	3F	4_else	124	304	45	30400	21470	-8930	0.15	0.71	53	38	-15
0012	3F	4_else	125	139	12	13900	12200	-1700	0.09	0.88	24	21	-3
0012	3F	4_else	126	91	13	9100	11640	2540	0.14	1.28	16	20	4
0012	3F	4_else	134	211	33	21100	18210	-2890	0.16	0.86	37	32	-5
0012	3F	4_else	135	102	9	10200	5800	-4400	0.09	0.57	18	10	-8
0012	3F	4_else	136	53	2	5300	3470	-1830	0.04	0.65	9	6	-3
0012	3F	4_else	145	89	4	8900	4620	-4280	0.04	0.52	15	8	-7
0012	3F	4_else	146	40	3	4000	3320	-680	0.08	0.83	7	5	-2
0012	3F	4_else	156	8	0	800	0	-800	0.00	0.00	1	0	-1
0012	3F	4_else	234	5	0	500	0	-500	0.00	0.00	0	0	0
0012	3F	4_else	236	1	0	100	0	-100	0.00	0.00	0	0	0
0012	3F	4_else	245	1	0	100	0	-100	0.00	0.00	0	0	0
0012	3F	5_1	123	21	6	2100	2540	440	0.29	1.21	3	4	1
0012	3F	5_1	124	17	5	1700	1940	240	0.29	1.14	3	3	0
0012	3F	5_1	125	12	5	1200	4110	2910	0.42	3.43	2	7	5
0012	3F	5_1	126	7	0	700	0	-700	0.00	0.00	1	0	-1
0012	3F	5_1	134	15	3	1500	1170	-330	0.20	0.78	2	2	0
0012	3F	5_1	135	12	2	1200	850	-350	0.17	0.71	2	1	-1
0012	3F	5_1	136	9	0	900	0	-900	0.00	0.00	1	0	-1
0012	3F	5_1	145	7	0	700	0	-700	0.00	0.00	1	0	-1
0012	3F	5_1	146	4	0	400	0	-400	0.00	0.00	0	0	0
0012	3F	5_1	156	3	0	300	0	-300	0.00	0.00	0	0	0
0012	3F	5_1	234	1	1	100	500	400	1.00	5.00	0	0	0
0012	3F	5_1	235	2	0	200	0	-200	0.00	0.00	0	0	0
0012	3F	5_1	236	1	0	100	0	-100	0.00	0.00	0	0	0
0012	3F	5_1	245	1	0	100	0	-100	0.00	0.00	0	0	0
0012	3F	5_1	256	2	0	200	0	-200	0.00	0.00	0	0	0
0012	3F	5_2	124	2	1	200	330	130	0.50	1.65	0	0	0
0012	3F	5_2	125	1	0	100	0	-100	0.00	0.00	0	0	0
0012	3F	5_2	134	1	0	100	0	-100	0.00	0.00	0	0	0
0012	3F	5_2	135	1	1	100	370	270	1.00	3.70	0	0	0
0012	3F	5_2	136	1	1	100	440	340	1.00	4.40	0	0	0
0012	3F	5_2	146	1	1	100	360	260	1.00	3.60	0	0	0
0012	3F	5_3	123	681	142	68100	58340	-9760	0.21	0.86	120	103	-17
0012	3F	5_3	124	572	112	57200	47730	-9470	0.20	0.83	101	84	-17
0012	3F	5_3	125	323	38	32300	19700	-12600	0.12	0.61	57	34	-23
0012	3F	5_3	126	243	26	24300	22670	-1630	0.11	0.93	43	40	-3
0012	3F	5_3	134	374	65	37400	28480	-8920	0.17	0.76	66	50	-16
0012	3F	5_3	135	246	32	24600	20210	-4390	0.13	0.82	43	35	-8
0012	3F	5_3	136	179	17	17900	9920	-7980	0.09	0.55	31	17	-14
0012	3F	5_3	145	158	21	15800	14780	-1020	0.13	0.94	27	26	-1
0012	3F	5_3	146	107	17	10700	5850	-4850	0.16	0.55	18	10	-8
0012	3F	5_3	156	60	9	6000	9860	3860	0.15	1.64	10	17	7
0012	3F	5_3	234	25	3	2500	1700	-800	0.12	0.68	4	3	-1
0012	3F	5_3	235	25	0	2500	0	-2500	0.00	0.00	4	0	-4
0012	3F	5_3	236	17	1	1700	470	-1230	0.06	0.28	3	0	-3
0012	3F	5_3	245	17	3	1700	1140	-560	0.18	0.67	3	2	-1
0012	3F	5_3	246	10	0	1000	0	-1000	0.00	0.00	1	0	-1
0012	3F	5_3	256	10	0	1000	0	-1000	0.00	0.00	1	0	-1
0012	3F	5_4	123	3	2	300	470	170	0.67	1.57	0	0	0
0012	3F	5_4	124	2	0	200	0	-200	0.00	0.00	0	0	0
0012	3F	5_4	126	2	0	200	0	-200	0.00	0.00	0	0	0
0012	3F	5_4	134	1	0	100	0	-100	0.00	0.00	0	0	0
0012	3F	5_4	135	1	0	100	0	-100	0.00	0.00	0	0	0
0012	3F	5_4	145	2	1	200	530	330	0.50	2.65	0	0	0
0012	3F	5_4	235	3	0	300	0	-300	0.00	0.00	0	0	0
0012	3F	5_5	123	1	0	100	0	-100	0.00	0.00	0	0	0
0012	3F	5_5	135	1	0	100	0	-100	0.00	0.00	0	0	0
0012	3F	5_5	146	1	0	100	0	-100	0.00	0.00	0	0	0
0012	3F	5_6	123	404	120	40400	33070	-7330	0.30	0.82	71	58	-13
0012	3F	5_6	124	315	66	31500	26550	-4950	0.21	0.84	55	46	-9
0012	3F	5_6	125	173	16	17300	13010	-4290	0.09	0.75	30	23	-7
0012	3F	5_6	126	120	13	12000	17620	5620	0.11	1.47	21	31	10
0012	3F	5_6	134	196	35	19600	20810	1210	0.18	1.06	34	36	2
0012	3F	5_6	135	94	5	9400	5710	-3690	0.05	0.61	16	10	-6
0012	3F	5_6	136	54	5	5400	10350	4950	0.09	1.92	9	18	9
0012	3F	5_6	145	60	3	6000	2670	-3330	0.05	0.45	10	4	-6
0012	3F	5_6	146	29	0	2900	0	-2900	0.00	0.00	5	0	-5
0012	3F	5_6	156	17	0	1700	0	-1700	0.00	0.00	3	0	-3
0012	3F	5_6	234	3	1	300	2400	2100	0.33	8.00	0	4	4
0012	3F	5_6	235	1	0	100	0	-100	0.00	0.00	0	0	0
0012	3F	5_6	236	3	0	300	0	-300	0.00	0.00	0	0	0
0012	3F	5_6	245	1	0	100	0	-100	0.00	0.00	0	0	0
0012	3F	5_6	246	2	0	200	0	-200	0.00	0.00	0	0	0
0012	3F	5_else	123	300	72	30000	26340	-3660	0.24	0.88	53	46	-7
0012	3F	5_else	124	212	41	21200	18250	-2950	0.19	0.86	37	32	-5
0012	3F	5_else	125	89	6	8900	3990	-4910	0.07	0.45	15	7	-8
0012	3F	5_else	126	49	3	4900	2510	-2390	0.06	0.51	8	4	-4
0012	3F	5_else	134	125	13	12500	6900	-5600	0.10	0.55	22	12	-10
0012	3F	5_else	135	63	6	6300	3790	-2510	0.10	0.60	11	6	-5
0012	3F	5_else	136	29	3	2900	5340	2440	0.10	1.84	5	9	4
0012	3F	5_else	145	28	2	2800	1950	-850	0.07	0.70	4	3	-1
0012	3F	5_else	146	19	1	1900	2220	320	0.05	1.17	3	3	0
0012	3F	5_else	156	7	1	700	1060	360	0.14	1.51	1	1	0
0012	3F	5_else	234	2	1	200	1720	1520	0.50	8.60	0	3	3
0012	3F	5_else	236	2	0	200	0	-200	0.00	0.00	0	0	0
0012	3F	5_else	245	1	0	100	0	-100	0.00	0.00	0	0	0
0012	3F	5_else	246	1	0	100	0	-100	0.00	0.00	0	0	0
0012	3F	6_3	123	47	5	4700	1360	-3340	0.11	0.29	8	2	-6
0012	3F	6_3	124	46	11	4600	5340	740	0.24	1.16	8	9	1
0012	3F	6_3	125	25	4	2500	1970	-530	0.16	0.79	4	3	-1
0012	3F	6_3	126	13	3	1300	4940	3640	0.23	3.80	2	8	6
0012	3F	6_3	134	31	5	3100	1540	-1560	0.16	0.50	5	2	-3
0012	3F	6_3	135	14	1	1400	260	-1140	0.07	0.19	2	0	-2
0012	3F	6_3	136	26	5	2600	3070	470	0.19	1.18	4	5	1
0012	3F	6_3	145	19	3	1900	1750	-150	0.16	0.92	3	3	0
0012	3F	6_3	146	15	1	1500	840	-660	0.07	0.56	2	1	-1
0012	3F	6_3	156	8	1	800	250	-550	0.13	0.31	1	0	-1
0012	3F	6_3	234	2	0	200	0	-200	0.00	0.00	0	0	0
0012	3F	6_3	235	1	0	100	0	-100	0.00	0.00	0	0	0
0012	3F	6_3	236	1	0	100	0	-100	0.00	0.00	0	0	0
0012	3F	6_3	256	1	0	100	0	-100	0.00	0.00	0	0	0
0012	3F	6_4	123	3	0	300	0	-300	0.00	0.00	0	0	0
0012	3F	6_4	124	3	0	300	0	-300	0.00	0.00	0	0	0
0012	3F	6_4	134	1	0	100	0	-100	0.00	0.00	0	0	0
0012	3F	6_4	145	1	0	100	0	-100	0.00	0.00	0	0	0
0012	3F	6_6	123	29	3	2900	920	-1980	0.10	0.32	5	1	-4
0012	3F	6_6	124	26	3	2600	1350	-1250	0.12	0.52	4	2	-2
0012	3F	6_6	125	13	5	1300	4210	2910	0.38	3.24	2	7	5
0012	3F	6_6	126	11	1	1100	710	-390	0.09	0.65	1	1	0
0012	3F	6_6	134	23	1	2300	1040	-1260	0.04	0.45	4	1	-3
0012	3F	6_6	135	7	1	700	1620	920	0.14	2.31	1	2	1
0012	3F	6_6	136	4	1	400	1890	1490	0.25	4.73	0	3	3
0012	3F	6_6	145	4	1	400	660	260	0.25	1.65	0	1	1
0012	3F	6_6	156	3	0	300	0	-300	0.00	0.00	0	0	0
0012	3F	6_6	246	1	0	100	0	-100	0.00	0.00	0	0	0
0012	3F	6_else	123	19	2	1900	550	-1350	0.11	0.29	3	0	-3
0012	3F	6_else	124	7	0	700	0	-700	0.00	0.00	1	0	-1
0012	3F	6_else	125	3	0	300	0	-300	0.00	0.00	0	0	0
0012	3F	6_else	126	1	1	100	400	300	1.00	4.00	0	0	0
0012	3F	6_else	134	7	2	700	600	-100	0.29	0.86	1	1	0
0012	3F	6_else	135	5	1	500	150	-350	0.20	0.30	0	0	0
0012	3F	6_else	136	1	0	100	0	-100	0.00	0.00	0	0	0
0012	3F	6_else	145	4	1	400	210	-190	0.25	0.53	0	0	0
0012	3F	6_else	156	1	1	100	490	390	1.00	4.90	0	0	0
0012	3F	7_3	123	1158	251	115800	102360	-13440	0.22	0.88	204	181	-23
0012	3F	7_3	124	956	188	95600	79610	-15990	0.20	0.83	169	140	-29
0012	3F	7_3	125	550	77	55000	40810	-14190	0.14	0.74	97	72	-25
0012	3F	7_3	126	455	69	45500	46500	1000	0.15	1.02	80	82	2
0012	3F	7_3	134	619	110	61900	50450	-11450	0.18	0.82	109	89	-20
0012	3F	7_3	135	380	49	38000	28460	-9540	0.13	0.75	67	50	-17
0012	3F	7_3	136	293	48	29300	32700	3400	0.16	1.12	51	57	6
0012	3F	7_3	145	239	30	23900	20770	-3130	0.13	0.87	42	36	-6
0012	3F	7_3	146	190	12	19000	7400	-11600	0.06	0.39	33	13	-20
0012	3F	7_3	156	87	14	8700	12370	3670	0.16	1.42	15	21	6
0012	3F	7_3	234	44	2	4400	1330	-3070	0.05	0.30	7	2	-5
0012	3F	7_3	235	56	9	5600	5780	180	0.16	1.03	9	10	1
0012	3F	7_3	236	42	1	4200	480	-3720	0.02	0.11	7	0	-7
0012	3F	7_3	245	24	4	2400	2330	-70	0.17	0.97	4	4	0
0012	3F	7_3	246	19	0	1900	0	-1900	0.00	0.00	3	0	-3
0012	3F	7_3	256	27	0	2700	0	-2700	0.00	0.00	4	0	-4
0012	3F	7_4	123	429	114	42900	36570	-6330	0.27	0.85	75	64	-11
0012	3F	7_4	124	340	70	34000	28730	-5270	0.21	0.85	60	50	-10
0012	3F	7_4	125	203	23	20300	17980	-2320	0.11	0.89	35	31	-4
0012	3F	7_4	126	131	11	13100	11210	-1890	0.08	0.86	23	19	-4
0012	3F	7_4	134	199	25	19900	17040	-2860	0.13	0.86	35	30	-5
0012	3F	7_4	135	110	8	11000	6450	-4550	0.07	0.59	19	11	-8
0012	3F	7_4	136	58	1	5800	400	-5400	0.02	0.07	10	0	-10
0012	3F	7_4	145	75	6	7500	7270	-230	0.08	0.97	13	12	-1
0012	3F	7_4	146	48	1	4800	1420	-3380	0.02	0.30	8	2	-6
0012	3F	7_4	156	28	1	2800	740	-2060	0.04	0.26	4	1	-3
0012	3F	7_4	234	8	0	800	0	-800	0.00	0.00	1	0	-1
0012	3F	7_4	235	3	0	300	0	-300	0.00	0.00	0	0	0
0012	3F	7_4	236	3	0	300	0	-300	0.00	0.00	0	0	0
0012	3F	7_4	245	2	0	200	0	-200	0.00	0.00	0	0	0
0012	3F	7_5	123	1	1	100	370	270	1.00	3.70	0	0	0
0012	3F	7_5	124	3	1	300	1230	930	0.33	4.10	0	2	2
0012	3F	7_5	125	1	0	100	0	-100	0.00	0.00	0	0	0
0012	3F	7_5	134	1	0	100	0	-100	0.00	0.00	0	0	0
0012	3F	7_5	135	1	0	100	0	-100	0.00	0.00	0	0	0
0012	3F	7_5	136	1	0	100	0	-100	0.00	0.00	0	0	0
0012	3F	7_7	123	220	50	22000	19120	-2880	0.23	0.87	38	33	-5
0012	3F	7_7	124	194	36	19400	14000	-5400	0.19	0.72	34	24	-10
0012	3F	7_7	125	91	8	9100	6720	-2380	0.09	0.74	16	11	-5
0012	3F	7_7	126	85	2	8500	2980	-5520	0.02	0.35	15	5	-10
0012	3F	7_7	134	103	15	10300	9060	-1240	0.15	0.88	18	16	-2
0012	3F	7_7	135	42	1	4200	1250	-2950	0.02	0.30	7	2	-5
0012	3F	7_7	136	33	3	3300	4190	890	0.09	1.27	5	7	2
0012	3F	7_7	145	50	3	5000	3920	-1080	0.06	0.78	8	6	-2
0012	3F	7_7	146	28	0	2800	0	-2800	0.00	0.00	4	0	-4
0012	3F	7_7	156	10	1	1000	2560	1560	0.10	2.56	1	4	3
0012	3F	7_7	234	1	0	100	0	-100	0.00	0.00	0	0	0
0012	3F	7_7	245	1	0	100	0	-100	0.00	0.00	0	0	0
0012	3F	7_else	123	375	94	37500	32830	-4670	0.25	0.88	66	58	-8
0012	3F	7_else	124	264	39	26400	16100	-10300	0.15	0.61	46	28	-18
0012	3F	7_else	125	127	19	12700	13450	750	0.15	1.06	22	23	1
0012	3F	7_else	126	58	4	5800	1850	-3950	0.07	0.32	10	3	-7
0012	3F	7_else	134	163	28	16300	17440	1140	0.17	1.07	28	30	2
0012	3F	7_else	135	66	7	6600	4730	-1870	0.11	0.72	11	8	-3
0012	3F	7_else	136	39	2	3900	4990	1090	0.05	1.28	6	8	2
0012	3F	7_else	145	40	7	4000	10850	6850	0.18	2.71	7	19	12
0012	3F	7_else	146	22	0	2200	0	-2200	0.00	0.00	3	0	-3
0012	3F	7_else	156	10	1	1000	800	-200	0.10	0.80	1	1	0
0012	3F	7_else	234	5	0	500	0	-500	0.00	0.00	0	0	0
0012	3F	7_else	235	1	0	100	0	-100	0.00	0.00	0	0	0
0012	3F	7_else	245	2	0	200	0	-200	0.00	0.00	0	0	0
0012	3T	1_1	123	702	51	70200	60740	-9460	0.07	0.87	124	107	-17
0012	3T	1_1	124	560	41	56000	45750	-10250	0.07	0.82	99	80	-19
0012	3T	1_1	125	356	20	35600	27570	-8030	0.06	0.77	63	48	-15
0012	3T	1_1	126	290	12	29000	19590	-9410	0.04	0.68	51	34	-17
0012	3T	1_1	132	425	19	42500	31660	-10840	0.04	0.74	75	56	-19
0012	3T	1_1	134	468	26	46800	52980	6180	0.06	1.13	82	93	11
0012	3T	1_1	135	291	8	29100	15040	-14060	0.03	0.52	51	26	-25
0012	3T	1_1	136	247	9	24700	25330	630	0.04	1.03	43	44	1
0012	3T	1_1	142	256	12	25600	9020	-16580	0.05	0.35	45	15	-30
0012	3T	1_1	143	272	16	27200	25730	-1470	0.06	0.95	48	45	-3
0012	3T	1_1	145	159	5	15900	11990	-3910	0.03	0.75	28	21	-7
0012	3T	1_1	146	147	2	14700	3410	-11290	0.01	0.23	26	6	-20
0012	3T	1_1	152	83	3	8300	11050	2750	0.04	1.33	14	19	5
0012	3T	1_1	153	93	4	9300	16520	7220	0.04	1.78	16	29	13
0012	3T	1_1	154	79	3	7900	7210	-690	0.04	0.91	13	12	-1
0012	3T	1_1	156	73	1	7300	2660	-4640	0.01	0.36	12	4	-8
0012	3T	1_1	162	41	1	4100	1100	-3000	0.02	0.27	7	1	-6
0012	3T	1_1	163	53	4	5300	15240	9940	0.08	2.88	9	26	17
0012	3T	1_1	164	43	2	4300	3810	-490	0.05	0.89	7	6	-1
0012	3T	1_1	165	34	1	3400	2750	-650	0.03	0.81	6	4	-2
0012	3T	1_1	213	94	6	9400	8550	-850	0.06	0.91	16	15	-1
0012	3T	1_1	214	100	0	10000	0	-10000	0.00	0.00	17	0	-17
0012	3T	1_1	215	64	3	6400	10660	4260	0.05	1.67	11	18	7
0012	3T	1_1	216	63	2	6300	2330	-3970	0.03	0.37	11	4	-7
0012	3T	1_1	231	18	0	1800	0	-1800	0.00	0.00	3	0	-3
0012	3T	1_1	234	65	1	6500	5430	-1070	0.02	0.84	11	9	-2
0012	3T	1_1	235	42	0	4200	0	-4200	0.00	0.00	7	0	-7
0012	3T	1_1	236	43	0	4300	0	-4300	0.00	0.00	7	0	-7
0012	3T	1_1	241	16	1	1600	1110	-490	0.06	0.69	2	1	-1
0012	3T	1_1	243	34	0	3400	0	-3400	0.00	0.00	6	0	-6
0012	3T	1_1	245	17	1	1700	980	-720	0.06	0.58	3	1	-2
0012	3T	1_1	246	25	0	2500	0	-2500	0.00	0.00	4	0	-4
0012	3T	1_1	251	12	0	1200	0	-1200	0.00	0.00	2	0	-2
0012	3T	1_1	253	12	1	1200	1890	690	0.08	1.58	2	3	1
0012	3T	1_1	254	8	0	800	0	-800	0.00	0.00	1	0	-1
0012	3T	1_1	256	17	0	1700	0	-1700	0.00	0.00	3	0	-3
0012	3T	1_1	261	9	0	900	0	-900	0.00	0.00	1	0	-1
0012	3T	1_1	263	14	0	1400	0	-1400	0.00	0.00	2	0	-2
0012	3T	1_1	264	8	0	800	0	-800	0.00	0.00	1	0	-1
0012	3T	1_1	265	11	0	1100	0	-1100	0.00	0.00	1	0	-1
0012	3T	1_2	123	112	9	11200	8260	-2940	0.08	0.74	19	14	-5
0012	3T	1_2	124	127	13	12700	19710	7010	0.10	1.55	22	34	12
0012	3T	1_2	125	75	9	7500	16570	9070	0.12	2.21	13	29	16
0012	3T	1_2	126	60	1	6000	1010	-4990	0.02	0.17	10	1	-9
0012	3T	1_2	132	79	7	7900	9960	2060	0.09	1.26	13	17	4
0012	3T	1_2	134	60	6	6000	4680	-1320	0.10	0.78	10	8	-2
0012	3T	1_2	135	50	2	5000	3180	-1820	0.04	0.64	8	5	-3
0012	3T	1_2	136	41	1	4100	1120	-2980	0.02	0.27	7	1	-6
0012	3T	1_2	142	40	4	4000	6380	2380	0.10	1.60	7	11	4
0012	3T	1_2	143	33	0	3300	0	-3300	0.00	0.00	5	0	-5
0012	3T	1_2	145	36	0	3600	0	-3600	0.00	0.00	6	0	-6
0012	3T	1_2	146	21	2	2100	7470	5370	0.10	3.56	3	13	10
0012	3T	1_2	152	14	0	1400	0	-1400	0.00	0.00	2	0	-2
0012	3T	1_2	153	9	0	900	0	-900	0.00	0.00	1	0	-1
0012	3T	1_2	154	8	1	800	10640	9840	0.13	13.30	1	18	17
0012	3T	1_2	156	7	0	700	0	-700	0.00	0.00	1	0	-1
0012	3T	1_2	162	2	0	200	0	-200	0.00	0.00	0	0	0
0012	3T	1_2	163	4	0	400	0	-400	0.00	0.00	0	0	0
0012	3T	1_2	164	1	0	100	0	-100	0.00	0.00	0	0	0
0012	3T	1_2	165	6	0	600	0	-600	0.00	0.00	1	0	-1
0012	3T	1_2	213	5	0	500	0	-500	0.00	0.00	0	0	0
0012	3T	1_2	216	1	0	100	0	-100	0.00	0.00	0	0	0
0012	3T	1_2	231	1	0	100	0	-100	0.00	0.00	0	0	0
0012	3T	1_2	235	4	0	400	0	-400	0.00	0.00	0	0	0
0012	3T	1_2	245	3	0	300	0	-300	0.00	0.00	0	0	0
0012	3T	1_3	132	1	0	100	0	-100	0.00	0.00	0	0	0
0012	3T	1_3	135	2	0	200	0	-200	0.00	0.00	0	0	0
0012	3T	1_3	145	2	0	200	0	-200	0.00	0.00	0	0	0
0012	3T	1_4	123	45	3	4500	1960	-2540	0.07	0.44	7	3	-4
0012	3T	1_4	124	40	2	4000	2150	-1850	0.05	0.54	7	3	-4
0012	3T	1_4	125	41	3	4100	4640	540	0.07	1.13	7	8	1
0012	3T	1_4	126	29	3	2900	9560	6660	0.10	3.30	5	16	11
0012	3T	1_4	132	37	1	3700	870	-2830	0.03	0.24	6	1	-5
0012	3T	1_4	134	53	6	5300	7900	2600	0.11	1.49	9	13	4
0012	3T	1_4	135	34	1	3400	1860	-1540	0.03	0.55	6	3	-3
0012	3T	1_4	136	43	2	4300	3800	-500	0.05	0.88	7	6	-1
0012	3T	1_4	142	17	3	1700	3090	1390	0.18	1.82	3	5	2
0012	3T	1_4	143	22	1	2200	1240	-960	0.05	0.56	3	2	-1
0012	3T	1_4	145	14	1	1400	3550	2150	0.07	2.54	2	6	4
0012	3T	1_4	146	18	0	1800	0	-1800	0.00	0.00	3	0	-3
0012	3T	1_4	152	6	0	600	0	-600	0.00	0.00	1	0	-1
0012	3T	1_4	153	7	0	700	0	-700	0.00	0.00	1	0	-1
0012	3T	1_4	154	9	0	900	0	-900	0.00	0.00	1	0	-1
0012	3T	1_4	156	11	1	1100	10580	9480	0.09	9.62	1	18	17
0012	3T	1_4	162	2	1	200	3260	3060	0.50	16.30	0	5	5
0012	3T	1_4	163	2	0	200	0	-200	0.00	0.00	0	0	0
0012	3T	1_4	165	3	0	300	0	-300	0.00	0.00	0	0	0
0012	3T	1_4	213	1	0	100	0	-100	0.00	0.00	0	0	0
0012	3T	1_4	214	1	0	100	0	-100	0.00	0.00	0	0	0
0012	3T	1_4	216	3	0	300	0	-300	0.00	0.00	0	0	0
0012	3T	1_4	231	2	0	200	0	-200	0.00	0.00	0	0	0
0012	3T	1_4	235	1	0	100	0	-100	0.00	0.00	0	0	0
0012	3T	1_4	241	1	0	100	0	-100	0.00	0.00	0	0	0
0012	3T	1_4	243	1	0	100	0	-100	0.00	0.00	0	0	0
0012	3T	1_5	123	55	4	5500	4620	-880	0.07	0.84	9	8	-1
0012	3T	1_5	124	75	9	7500	7700	200	0.12	1.03	13	13	0
0012	3T	1_5	125	41	0	4100	0	-4100	0.00	0.00	7	0	-7
0012	3T	1_5	126	34	4	3400	8700	5300	0.12	2.56	6	15	9
0012	3T	1_5	132	26	1	2600	1240	-1360	0.04	0.48	4	2	-2
0012	3T	1_5	134	34	6	3400	7530	4130	0.18	2.21	6	13	7
0012	3T	1_5	135	36	1	3600	850	-2750	0.03	0.24	6	1	-5
0012	3T	1_5	136	29	0	2900	0	-2900	0.00	0.00	5	0	-5
0012	3T	1_5	142	24	2	2400	1500	-900	0.08	0.63	4	2	-2
0012	3T	1_5	143	20	3	2000	5610	3610	0.15	2.81	3	9	6
0012	3T	1_5	145	12	0	1200	0	-1200	0.00	0.00	2	0	-2
0012	3T	1_5	146	14	0	1400	0	-1400	0.00	0.00	2	0	-2
0012	3T	1_5	152	4	1	400	4410	4010	0.25	11.03	0	7	7
0012	3T	1_5	153	7	0	700	0	-700	0.00	0.00	1	0	-1
0012	3T	1_5	154	4	0	400	0	-400	0.00	0.00	0	0	0
0012	3T	1_5	156	1	0	100	0	-100	0.00	0.00	0	0	0
0012	3T	1_5	162	1	0	100	0	-100	0.00	0.00	0	0	0
0012	3T	1_5	163	1	0	100	0	-100	0.00	0.00	0	0	0
0012	3T	1_5	164	5	1	500	4330	3830	0.20	8.66	0	7	7
0012	3T	1_5	213	4	0	400	0	-400	0.00	0.00	0	0	0
0012	3T	1_5	214	5	1	500	810	310	0.20	1.62	0	1	1
0012	3T	1_5	215	3	1	300	1500	1200	0.33	5.00	0	2	2
0012	3T	1_5	216	1	0	100	0	-100	0.00	0.00	0	0	0
0012	3T	1_5	234	3	1	300	4290	3990	0.33	14.30	0	7	7
0012	3T	1_5	235	1	0	100	0	-100	0.00	0.00	0	0	0
0012	3T	1_5	243	2	0	200	0	-200	0.00	0.00	0	0	0
0012	3T	1_5	246	1	0	100	0	-100	0.00	0.00	0	0	0
0012	3T	1_5	253	1	0	100	0	-100	0.00	0.00	0	0	0
0012	3T	1_5	254	1	0	100	0	-100	0.00	0.00	0	0	0
0012	3T	1_else	123	284	27	28400	20610	-7790	0.10	0.73	50	36	-14
0012	3T	1_else	124	252	19	25200	14620	-10580	0.08	0.58	44	25	-19
0012	3T	1_else	125	149	8	14900	11730	-3170	0.05	0.79	26	20	-6
0012	3T	1_else	126	133	5	13300	28140	14840	0.04	2.12	23	49	26
0012	3T	1_else	132	163	9	16300	17180	880	0.06	1.05	28	30	2
0012	3T	1_else	134	159	12	15900	14260	-1640	0.08	0.90	28	25	-3
0012	3T	1_else	135	91	2	9100	3580	-5520	0.02	0.39	16	6	-10
0012	3T	1_else	136	58	3	5800	8940	3140	0.05	1.54	10	15	5
0012	3T	1_else	142	97	0	9700	0	-9700	0.00	0.00	17	0	-17
0012	3T	1_else	143	95	7	9500	8380	-1120	0.07	0.88	16	14	-2
0012	3T	1_else	145	57	2	5700	7190	1490	0.04	1.26	10	12	2
0012	3T	1_else	146	57	4	5700	12640	6940	0.07	2.22	10	22	12
0012	3T	1_else	152	32	0	3200	0	-3200	0.00	0.00	5	0	-5
0012	3T	1_else	153	23	0	2300	0	-2300	0.00	0.00	4	0	-4
0012	3T	1_else	154	33	0	3300	0	-3300	0.00	0.00	5	0	-5
0012	3T	1_else	156	19	0	1900	0	-1900	0.00	0.00	3	0	-3
0012	3T	1_else	162	6	0	600	0	-600	0.00	0.00	1	0	-1
0012	3T	1_else	163	6	0	600	0	-600	0.00	0.00	1	0	-1
0012	3T	1_else	164	5	0	500	0	-500	0.00	0.00	0	0	0
0012	3T	1_else	165	7	0	700	0	-700	0.00	0.00	1	0	-1
0012	3T	1_else	213	4	0	400	0	-400	0.00	0.00	0	0	0
0012	3T	1_else	214	10	0	1000	0	-1000	0.00	0.00	1	0	-1
0012	3T	1_else	215	6	0	600	0	-600	0.00	0.00	1	0	-1
0012	3T	1_else	216	2	0	200	0	-200	0.00	0.00	0	0	0
0012	3T	1_else	231	1	0	100	0	-100	0.00	0.00	0	0	0
0012	3T	1_else	234	6	0	600	0	-600	0.00	0.00	1	0	-1
0012	3T	1_else	235	2	0	200	0	-200	0.00	0.00	0	0	0
0012	3T	1_else	241	2	0	200	0	-200	0.00	0.00	0	0	0
0012	3T	1_else	243	1	0	100	0	-100	0.00	0.00	0	0	0
0012	3T	1_else	245	1	0	100	0	-100	0.00	0.00	0	0	0
0012	3T	1_else	254	1	0	100	0	-100	0.00	0.00	0	0	0
0012	3T	2_1	123	533	45	53300	54610	1310	0.08	1.02	94	96	2
0012	3T	2_1	124	411	32	41100	36500	-4600	0.08	0.89	72	64	-8
0012	3T	2_1	125	331	17	33100	19460	-13640	0.05	0.59	58	34	-24
0012	3T	2_1	126	316	17	31600	19100	-12500	0.05	0.60	55	33	-22
0012	3T	2_1	132	339	27	33900	50660	16760	0.08	1.49	60	89	29
0012	3T	2_1	134	287	21	28700	38540	9840	0.07	1.34	50	68	18
0012	3T	2_1	135	225	13	22500	17360	-5140	0.06	0.77	39	30	-9
0012	3T	2_1	136	256	15	25600	24670	-930	0.06	0.96	45	43	-2
0012	3T	2_1	142	215	18	21500	34380	12880	0.08	1.60	38	60	22
0012	3T	2_1	143	225	9	22500	12280	-10220	0.04	0.55	39	21	-18
0012	3T	2_1	145	160	7	16000	10050	-5950	0.04	0.63	28	17	-11
0012	3T	2_1	146	138	5	13800	19940	6140	0.04	1.44	24	35	11
0012	3T	2_1	152	119	2	11900	3350	-8550	0.02	0.28	21	5	-16
0012	3T	2_1	153	83	2	8300	1900	-6400	0.02	0.23	14	3	-11
0012	3T	2_1	154	63	1	6300	1450	-4850	0.02	0.23	11	2	-9
0012	3T	2_1	156	67	1	6700	1480	-5220	0.01	0.22	11	2	-9
0012	3T	2_1	162	77	3	7700	8200	500	0.04	1.06	13	14	1
0012	3T	2_1	163	83	2	8300	5720	-2580	0.02	0.69	14	10	-4
0012	3T	2_1	164	54	2	5400	2940	-2460	0.04	0.54	9	5	-4
0012	3T	2_1	165	39	0	3900	0	-3900	0.00	0.00	6	0	-6
0012	3T	2_1	213	111	6	11100	8500	-2600	0.05	0.77	19	15	-4
0012	3T	2_1	214	96	3	9600	11330	1730	0.03	1.18	16	20	4
0012	3T	2_1	215	70	4	7000	31570	24570	0.06	4.51	12	55	43
0012	3T	2_1	216	103	5	10300	10740	440	0.05	1.04	18	19	1
0012	3T	2_1	231	37	0	3700	0	-3700	0.00	0.00	6	0	-6
0012	3T	2_1	234	45	2	4500	6100	1600	0.04	1.36	7	10	3
0012	3T	2_1	235	46	1	4600	9950	5350	0.02	2.16	8	17	9
0012	3T	2_1	236	54	2	5400	2840	-2560	0.04	0.53	9	5	-4
0012	3T	2_1	241	28	0	2800	0	-2800	0.00	0.00	4	0	-4
0012	3T	2_1	243	40	2	4000	2020	-1980	0.05	0.51	7	3	-4
0012	3T	2_1	245	28	0	2800	0	-2800	0.00	0.00	4	0	-4
0012	3T	2_1	246	30	1	3000	9550	6550	0.03	3.18	5	16	11
0012	3T	2_1	251	15	0	1500	0	-1500	0.00	0.00	2	0	-2
0012	3T	2_1	253	22	0	2200	0	-2200	0.00	0.00	3	0	-3
0012	3T	2_1	254	27	0	2700	0	-2700	0.00	0.00	4	0	-4
0012	3T	2_1	256	28	0	2800	0	-2800	0.00	0.00	4	0	-4
0012	3T	2_1	261	17	0	1700	0	-1700	0.00	0.00	3	0	-3
0012	3T	2_1	263	30	2	3000	6140	3140	0.07	2.05	5	10	5
0012	3T	2_1	264	15	2	1500	2870	1370	0.13	1.91	2	5	3
0012	3T	2_1	265	24	0	2400	0	-2400	0.00	0.00	4	0	-4
0012	3T	2_2	123	126	12	12600	11620	-980	0.10	0.92	22	20	-2
0012	3T	2_2	124	115	13	11500	18020	6520	0.11	1.57	20	31	11
0012	3T	2_2	125	63	4	6300	3530	-2770	0.06	0.56	11	6	-5
0012	3T	2_2	126	65	2	6500	1950	-4550	0.03	0.30	11	3	-8
0012	3T	2_2	132	70	5	7000	7180	180	0.07	1.03	12	12	0
0012	3T	2_2	134	73	6	7300	6470	-830	0.08	0.89	12	11	-1
0012	3T	2_2	135	55	1	5500	690	-4810	0.02	0.13	9	1	-8
0012	3T	2_2	136	68	4	6800	7450	650	0.06	1.10	12	13	1
0012	3T	2_2	142	48	3	4800	5790	990	0.06	1.21	8	10	2
0012	3T	2_2	143	35	2	3500	4900	1400	0.06	1.40	6	8	2
0012	3T	2_2	145	43	0	4300	0	-4300	0.00	0.00	7	0	-7
0012	3T	2_2	146	37	1	3700	760	-2940	0.03	0.21	6	1	-5
0012	3T	2_2	152	16	1	1600	770	-830	0.06	0.48	2	1	-1
0012	3T	2_2	153	15	1	1500	970	-530	0.07	0.65	2	1	-1
0012	3T	2_2	154	15	1	1500	2070	570	0.07	1.38	2	3	1
0012	3T	2_2	156	10	0	1000	0	-1000	0.00	0.00	1	0	-1
0012	3T	2_2	162	9	0	900	0	-900	0.00	0.00	1	0	-1
0012	3T	2_2	163	8	0	800	0	-800	0.00	0.00	1	0	-1
0012	3T	2_2	164	6	0	600	0	-600	0.00	0.00	1	0	-1
0012	3T	2_2	165	9	0	900	0	-900	0.00	0.00	1	0	-1
0012	3T	2_2	214	2	0	200	0	-200	0.00	0.00	0	0	0
0012	3T	2_2	215	5	0	500	0	-500	0.00	0.00	0	0	0
0012	3T	2_2	216	5	0	500	0	-500	0.00	0.00	0	0	0
0012	3T	2_2	231	3	0	300	0	-300	0.00	0.00	0	0	0
0012	3T	2_2	234	2	0	200	0	-200	0.00	0.00	0	0	0
0012	3T	2_2	236	2	0	200	0	-200	0.00	0.00	0	0	0
0012	3T	2_2	241	1	0	100	0	-100	0.00	0.00	0	0	0
0012	3T	2_2	246	1	0	100	0	-100	0.00	0.00	0	0	0
0012	3T	2_2	254	2	0	200	0	-200	0.00	0.00	0	0	0
0012	3T	2_2	256	1	0	100	0	-100	0.00	0.00	0	0	0
0012	3T	2_3	123	1	0	100	0	-100	0.00	0.00	0	0	0
0012	3T	2_3	124	1	0	100	0	-100	0.00	0.00	0	0	0
0012	3T	2_3	125	1	0	100	0	-100	0.00	0.00	0	0	0
0012	3T	2_3	136	1	0	100	0	-100	0.00	0.00	0	0	0
0012	3T	2_4	123	72	10	7200	6880	-320	0.14	0.96	12	12	0
0012	3T	2_4	124	57	2	5700	1810	-3890	0.04	0.32	10	3	-7
0012	3T	2_4	125	47	3	4700	4690	-10	0.06	1.00	8	8	0
0012	3T	2_4	126	43	2	4300	3670	-630	0.05	0.85	7	6	-1
0012	3T	2_4	132	36	1	3600	790	-2810	0.03	0.22	6	1	-5
0012	3T	2_4	134	35	3	3500	4550	1050	0.09	1.30	6	8	2
0012	3T	2_4	135	39	1	3900	790	-3110	0.03	0.20	6	1	-5
0012	3T	2_4	136	28	0	2800	0	-2800	0.00	0.00	4	0	-4
0012	3T	2_4	142	27	3	2700	2960	260	0.11	1.10	4	5	1
0012	3T	2_4	143	27	0	2700	0	-2700	0.00	0.00	4	0	-4
0012	3T	2_4	145	20	1	2000	880	-1120	0.05	0.44	3	1	-2
0012	3T	2_4	146	23	0	2300	0	-2300	0.00	0.00	4	0	-4
0012	3T	2_4	152	9	1	900	1400	500	0.11	1.56	1	2	1
0012	3T	2_4	153	5	0	500	0	-500	0.00	0.00	0	0	0
0012	3T	2_4	154	8	0	800	0	-800	0.00	0.00	1	0	-1
0012	3T	2_4	156	5	0	500	0	-500	0.00	0.00	0	0	0
0012	3T	2_4	162	1	0	100	0	-100	0.00	0.00	0	0	0
0012	3T	2_4	163	3	0	300	0	-300	0.00	0.00	0	0	0
0012	3T	2_4	164	2	0	200	0	-200	0.00	0.00	0	0	0
0012	3T	2_4	214	2	0	200	0	-200	0.00	0.00	0	0	0
0012	3T	2_4	215	1	0	100	0	-100	0.00	0.00	0	0	0
0012	3T	2_4	243	1	0	100	0	-100	0.00	0.00	0	0	0
0012	3T	2_4	245	1	0	100	0	-100	0.00	0.00	0	0	0
0012	3T	2_4	253	1	0	100	0	-100	0.00	0.00	0	0	0
0012	3T	2_5	123	59	5	5900	5120	-780	0.08	0.87	10	9	-1
0012	3T	2_5	124	58	11	5800	12770	6970	0.19	2.20	10	22	12
0012	3T	2_5	125	45	2	4500	1860	-2640	0.04	0.41	7	3	-4
0013	3T	5_B1	215	21	0	2100	0	-2100	0.00	0.00	3	0	-3
0013	3T	5_B1	216	15	2	1500	4290	2790	0.13	2.86	2	7	5
0013	3T	5_B1	231	14	0	1400	0	-1400	0.00	0.00	2	0	-2
0013	3T	5_B1	234	13	0	1300	0	-1300	0.00	0.00	2	0	-2
0013	3T	5_B1	235	10	1	1000	3090	2090	0.10	3.09	1	5	4
0013	3T	5_B1	236	6	0	600	0	-600	0.00	0.00	1	0	-1
0013	3T	5_B1	241	3	0	300	0	-300	0.00	0.00	0	0	0
0013	3T	5_B1	243	11	1	1100	3630	2530	0.09	3.30	1	6	5
0013	3T	5_B1	245	9	0	900	0	-900	0.00	0.00	1	0	-1
0013	3T	5_B1	246	8	0	800	0	-800	0.00	0.00	1	0	-1
0013	3T	5_B1	251	6	0	600	0	-600	0.00	0.00	1	0	-1
0013	3T	5_B1	253	7	0	700	0	-700	0.00	0.00	1	0	-1
0013	3T	5_B1	254	2	0	200	0	-200	0.00	0.00	0	0	0
0013	3T	5_B1	256	7	0	700	0	-700	0.00	0.00	1	0	-1
0013	3T	5_B1	261	4	0	400	0	-400	0.00	0.00	0	0	0
0013	3T	5_B1	263	8	0	800	0	-800	0.00	0.00	1	0	-1
0013	3T	5_B1	264	2	0	200	0	-200	0.00	0.00	0	0	0
0012	3T	2_5	126	34	1	3400	670	-2730	0.03	0.20	6	1	-5
0012	3T	2_5	132	26	4	2600	5110	2510	0.15	1.97	4	9	5
0012	3T	2_5	134	35	1	3500	450	-3050	0.03	0.13	6	0	-6
0012	3T	2_5	135	30	2	3000	2250	-750	0.07	0.75	5	3	-2
0013	3T	5_B1	265	3	0	300	0	-300	0.00	0.00	0	0	0
0013	3T	5_B2	123	15	2	1500	1130	-370	0.13	0.75	2	2	0
0013	3T	5_B2	124	12	2	1200	1650	450	0.17	1.38	2	2	0
0013	3T	5_B2	125	9	0	900	0	-900	0.00	0.00	1	0	-1
0013	3T	5_B2	126	2	0	200	0	-200	0.00	0.00	0	0	0
0013	3T	5_B2	132	3	0	300	0	-300	0.00	0.00	0	0	0
0013	3T	5_B2	134	9	0	900	0	-900	0.00	0.00	1	0	-1
0013	3T	5_B2	135	5	0	500	0	-500	0.00	0.00	0	0	0
0013	3T	5_B2	142	4	0	400	0	-400	0.00	0.00	0	0	0
0013	3T	5_B2	143	3	0	300	0	-300	0.00	0.00	0	0	0
0013	3T	5_B2	145	4	0	400	0	-400	0.00	0.00	0	0	0
0013	3T	5_B2	146	2	0	200	0	-200	0.00	0.00	0	0	0
0013	3T	5_B2	152	1	0	100	0	-100	0.00	0.00	0	0	0
0013	3T	5_B2	153	2	0	200	0	-200	0.00	0.00	0	0	0
0013	3T	5_B2	154	1	0	100	0	-100	0.00	0.00	0	0	0
0013	3T	5_B2	156	1	0	100	0	-100	0.00	0.00	0	0	0
0013	3T	5_B2	162	2	0	200	0	-200	0.00	0.00	0	0	0
0013	3T	5_B2	165	1	0	100	0	-100	0.00	0.00	0	0	0
0013	3T	5_B2	213	1	0	100	0	-100	0.00	0.00	0	0	0
0013	3T	5_B2	215	1	0	100	0	-100	0.00	0.00	0	0	0
0013	3T	5_B2	231	2	0	200	0	-200	0.00	0.00	0	0	0
0013	3T	5_B2	234	2	0	200	0	-200	0.00	0.00	0	0	0
0013	3T	5_B2	235	3	0	300	0	-300	0.00	0.00	0	0	0
0013	3T	5_B2	236	2	0	200	0	-200	0.00	0.00	0	0	0
0013	3T	5_B2	241	4	0	400	0	-400	0.00	0.00	0	0	0
0013	3T	5_B2	243	1	0	100	0	-100	0.00	0.00	0	0	0
0013	3T	5_B2	245	1	0	100	0	-100	0.00	0.00	0	0	0
0013	3T	5_B2	246	1	0	100	0	-100	0.00	0.00	0	0	0
0013	3T	5_B2	251	1	0	100	0	-100	0.00	0.00	0	0	0
0013	3T	5_B2	253	2	0	200	0	-200	0.00	0.00	0	0	0
0013	3T	5_B2	254	2	0	200	0	-200	0.00	0.00	0	0	0
0013	3T	5_B2	261	1	0	100	0	-100	0.00	0.00	0	0	0
0013	3T	5_B2	265	2	0	200	0	-200	0.00	0.00	0	0	0
0013	3T	6_A1	123	39	2	3900	1390	-2510	0.05	0.36	6	2	-4
0013	3T	6_A1	124	50	3	5000	1980	-3020	0.06	0.40	8	3	-5
0013	3T	6_A1	125	16	2	1600	4230	2630	0.13	2.64	2	7	5
0013	3T	6_A1	126	14	0	1400	0	-1400	0.00	0.00	2	0	-2
0013	3T	6_A1	132	17	2	1700	1170	-530	0.12	0.69	3	2	-1
0013	3T	6_A1	134	17	2	1700	2550	850	0.12	1.50	3	4	1
0013	3T	6_A1	135	9	0	900	0	-900	0.00	0.00	1	0	-1
0013	3T	6_A1	136	7	1	700	2830	2130	0.14	4.04	1	5	4
0013	3T	6_A1	142	6	0	600	0	-600	0.00	0.00	1	0	-1
0013	3T	6_A1	143	3	0	300	0	-300	0.00	0.00	0	0	0
0013	3T	6_A1	145	7	0	700	0	-700	0.00	0.00	1	0	-1
0013	3T	6_A1	146	3	0	300	0	-300	0.00	0.00	0	0	0
0013	3T	6_A1	152	3	1	300	1090	790	0.33	3.63	0	1	1
0013	3T	6_A1	153	5	0	500	0	-500	0.00	0.00	0	0	0
0013	3T	6_A1	154	3	0	300	0	-300	0.00	0.00	0	0	0
0013	3T	6_A1	156	1	0	100	0	-100	0.00	0.00	0	0	0
0013	3T	6_A1	163	1	0	100	0	-100	0.00	0.00	0	0	0
0013	3T	6_A1	213	1	0	100	0	-100	0.00	0.00	0	0	0
0013	3T	6_A1	215	1	0	100	0	-100	0.00	0.00	0	0	0
0013	3T	6_A2	123	19	2	1900	1170	-730	0.11	0.62	3	2	-1
0013	3T	6_A2	124	17	0	1700	0	-1700	0.00	0.00	3	0	-3
0013	3T	6_A2	125	16	0	1600	0	-1600	0.00	0.00	2	0	-2
0013	3T	6_A2	126	6	0	600	0	-600	0.00	0.00	1	0	-1
0013	3T	6_A2	132	14	0	1400	0	-1400	0.00	0.00	2	0	-2
0013	3T	6_A2	134	16	2	1600	1390	-210	0.13	0.87	2	2	0
0013	3T	6_A2	135	2	0	200	0	-200	0.00	0.00	0	0	0
0013	3T	6_A2	136	5	0	500	0	-500	0.00	0.00	0	0	0
0013	3T	6_A2	142	10	1	1000	940	-60	0.10	0.94	1	1	0
0013	3T	6_A2	143	8	0	800	0	-800	0.00	0.00	1	0	-1
0013	3T	6_A2	145	4	1	400	820	420	0.25	2.05	0	1	1
0013	3T	6_A2	146	1	0	100	0	-100	0.00	0.00	0	0	0
0013	3T	6_A2	152	1	0	100	0	-100	0.00	0.00	0	0	0
0013	3T	6_A2	153	4	0	400	0	-400	0.00	0.00	0	0	0
0013	3T	6_A2	154	3	0	300	0	-300	0.00	0.00	0	0	0
0013	3T	6_A2	162	1	0	100	0	-100	0.00	0.00	0	0	0
0013	3T	6_A2	164	4	0	400	0	-400	0.00	0.00	0	0	0
0013	3T	6_A2	213	1	1	100	2490	2390	1.00	24.90	0	4	4
0013	3T	6_A2	241	1	0	100	0	-100	0.00	0.00	0	0	0
0013	3T	6_B1	123	13	0	1300	0	-1300	0.00	0.00	2	0	-2
0013	3T	6_B1	124	55	2	5500	1110	-4390	0.04	0.20	9	1	-8
0013	3T	6_B1	125	12	0	1200	0	-1200	0.00	0.00	2	0	-2
0013	3T	6_B1	126	2	0	200	0	-200	0.00	0.00	0	0	0
0013	3T	6_B1	132	5	0	500	0	-500	0.00	0.00	0	0	0
0013	3T	6_B1	134	8	0	800	0	-800	0.00	0.00	1	0	-1
0013	3T	6_B1	135	7	0	700	0	-700	0.00	0.00	1	0	-1
0013	3T	6_B1	136	2	0	200	0	-200	0.00	0.00	0	0	0
0013	3T	6_B1	142	7	0	700	0	-700	0.00	0.00	1	0	-1
0013	3T	6_B1	143	3	0	300	0	-300	0.00	0.00	0	0	0
0013	3T	6_B1	145	2	0	200	0	-200	0.00	0.00	0	0	0
0013	3T	6_B1	146	3	0	300	0	-300	0.00	0.00	0	0	0
0013	3T	6_B1	153	2	0	200	0	-200	0.00	0.00	0	0	0
0013	3T	6_B1	154	3	0	300	0	-300	0.00	0.00	0	0	0
0013	3T	6_B1	156	1	0	100	0	-100	0.00	0.00	0	0	0
0013	3T	6_B1	162	1	1	100	990	890	1.00	9.90	0	1	1
0013	3T	6_B1	163	2	0	200	0	-200	0.00	0.00	0	0	0
0013	3T	6_B1	213	2	0	200	0	-200	0.00	0.00	0	0	0
0013	3T	6_B1	214	3	0	300	0	-300	0.00	0.00	0	0	0
0013	3T	6_B1	215	3	0	300	0	-300	0.00	0.00	0	0	0
0013	3T	6_B1	231	2	0	200	0	-200	0.00	0.00	0	0	0
0013	3T	6_B1	234	6	0	600	0	-600	0.00	0.00	1	0	-1
0013	3T	6_B1	235	2	1	200	4620	4420	0.50	23.10	0	8	8
0013	3T	6_B1	241	2	0	200	0	-200	0.00	0.00	0	0	0
0013	3T	6_B1	243	2	0	200	0	-200	0.00	0.00	0	0	0
0013	3T	6_B2	124	2	1	200	590	390	0.50	2.95	0	1	1
0013	3T	6_B2	125	1	0	100	0	-100	0.00	0.00	0	0	0
0013	3T	6_B2	165	1	0	100	0	-100	0.00	0.00	0	0	0
0013	3T	6_B2	264	1	0	100	0	-100	0.00	0.00	0	0	0
0013	3T	7_	123	6	1	600	1060	460	0.17	1.77	1	1	0
0013	3T	7_	125	1	0	100	0	-100	0.00	0.00	0	0	0
0013	3T	7_	126	1	0	100	0	-100	0.00	0.00	0	0	0
0013	3T	7_	134	1	0	100	0	-100	0.00	0.00	0	0	0
0013	3T	7_	135	1	0	100	0	-100	0.00	0.00	0	0	0
0013	3T	7_	136	1	0	100	0	-100	0.00	0.00	0	0	0
0013	3T	7_	142	1	0	100	0	-100	0.00	0.00	0	0	0
0013	3T	7_	146	1	0	100	0	-100	0.00	0.00	0	0	0
0013	3T	7_	153	1	0	100	0	-100	0.00	0.00	0	0	0
0013	3T	7_	156	1	0	100	0	-100	0.00	0.00	0	0	0
0013	3T	7_	163	1	0	100	0	-100	0.00	0.00	0	0	0
0013	3T	7_A1	123	628	70	62800	65670	2870	0.11	1.05	111	116	5
0013	3T	7_A1	124	587	43	58700	33870	-24830	0.07	0.58	103	59	-44
0013	3T	7_A1	125	269	15	26900	28220	1320	0.06	1.05	47	49	2
0013	3T	7_A1	126	173	7	17300	12500	-4800	0.04	0.72	30	22	-8
0013	3T	7_A1	132	259	14	25900	19310	-6590	0.05	0.75	45	34	-11
0013	3T	7_A1	134	298	22	29800	29910	110	0.07	1.00	52	52	0
0013	3T	7_A1	135	141	5	14100	3140	-10960	0.04	0.22	24	5	-19
0013	3T	7_A1	136	88	3	8800	4140	-4660	0.03	0.47	15	7	-8
0013	3T	7_A1	142	163	14	16300	17970	1670	0.09	1.10	28	31	3
0013	3T	7_A1	143	190	6	19000	13790	-5210	0.03	0.73	33	24	-9
0013	3T	7_A1	145	69	3	6900	4420	-2480	0.04	0.64	12	7	-5
0013	3T	7_A1	146	63	2	6300	3000	-3300	0.03	0.48	11	5	-6
0013	3T	7_A1	152	35	1	3500	540	-2960	0.03	0.15	6	0	-6
0013	3T	7_A1	153	46	2	4600	4040	-560	0.04	0.88	8	7	-1
0013	3T	7_A1	154	41	1	4100	2470	-1630	0.02	0.60	7	4	-3
0013	3T	7_A1	156	11	0	1100	0	-1100	0.00	0.00	1	0	-1
0013	3T	7_A1	162	14	0	1400	0	-1400	0.00	0.00	2	0	-2
0013	3T	7_A1	163	10	1	1000	2070	1070	0.10	2.07	1	3	2
0013	3T	7_A1	164	9	0	900	0	-900	0.00	0.00	1	0	-1
0013	3T	7_A1	165	3	0	300	0	-300	0.00	0.00	0	0	0
0013	3T	7_A1	213	7	0	700	0	-700	0.00	0.00	1	0	-1
0013	3T	7_A1	214	5	1	500	1510	1010	0.20	3.02	0	2	2
0013	3T	7_A1	215	5	0	500	0	-500	0.00	0.00	0	0	0
0013	3T	7_A1	231	3	0	300	0	-300	0.00	0.00	0	0	0
0013	3T	7_A1	234	2	0	200	0	-200	0.00	0.00	0	0	0
0013	3T	7_A1	235	1	0	100	0	-100	0.00	0.00	0	0	0
0013	3T	7_A1	236	1	0	100	0	-100	0.00	0.00	0	0	0
0013	3T	7_A1	243	2	0	200	0	-200	0.00	0.00	0	0	0
0013	3T	7_A1	245	1	0	100	0	-100	0.00	0.00	0	0	0
0013	3T	7_A1	246	1	0	100	0	-100	0.00	0.00	0	0	0
0013	3T	7_A1	263	1	0	100	0	-100	0.00	0.00	0	0	0
0013	3T	7_A2	123	524	55	52400	47590	-4810	0.10	0.91	92	84	-8
0013	3T	7_A2	124	456	27	45600	34030	-11570	0.06	0.75	80	60	-20
0013	3T	7_A2	125	312	18	31200	16530	-14670	0.06	0.53	55	29	-26
0013	3T	7_A2	126	169	12	16900	16710	-190	0.07	0.99	29	29	0
0013	3T	7_A2	132	300	23	30000	33240	3240	0.08	1.11	53	58	5
0013	3T	7_A2	134	272	12	27200	15170	-12030	0.04	0.56	48	26	-22
0013	3T	7_A2	135	179	7	17900	14310	-3590	0.04	0.80	31	25	-6
0013	3T	7_A2	136	119	6	11900	5060	-6840	0.05	0.43	21	8	-13
0013	3T	7_A2	142	205	14	20500	19870	-630	0.07	0.97	36	35	-1
0013	3T	7_A2	143	161	5	16100	5690	-10410	0.03	0.35	28	10	-18
0013	3T	7_A2	145	99	3	9900	7050	-2850	0.03	0.71	17	12	-5
0013	3T	7_A2	146	72	1	7200	730	-6470	0.01	0.10	12	1	-11
0013	3T	7_A2	152	49	1	4900	1880	-3020	0.02	0.38	8	3	-5
0013	3T	7_A2	153	57	1	5700	2270	-3430	0.02	0.40	10	4	-6
0013	3T	7_A2	154	52	1	5200	3330	-1870	0.02	0.64	9	5	-4
0013	3T	7_A2	156	29	0	2900	0	-2900	0.00	0.00	5	0	-5
0013	3T	7_A2	162	32	3	3200	8270	5070	0.09	2.58	5	14	9
0013	3T	7_A2	163	25	2	2500	4470	1970	0.08	1.79	4	7	3
0013	3T	7_A2	164	25	0	2500	0	-2500	0.00	0.00	4	0	-4
0013	3T	7_A2	165	11	0	1100	0	-1100	0.00	0.00	1	0	-1
0013	3T	7_A2	213	15	0	1500	0	-1500	0.00	0.00	2	0	-2
0013	3T	7_A2	214	10	0	1000	0	-1000	0.00	0.00	1	0	-1
0013	3T	7_A2	215	10	0	1000	0	-1000	0.00	0.00	1	0	-1
0013	3T	7_A2	216	6	0	600	0	-600	0.00	0.00	1	0	-1
0013	3T	7_A2	231	2	0	200	0	-200	0.00	0.00	0	0	0
0013	3T	7_A2	234	2	0	200	0	-200	0.00	0.00	0	0	0
0013	3T	7_A2	235	2	0	200	0	-200	0.00	0.00	0	0	0
0013	3T	7_A2	236	1	0	100	0	-100	0.00	0.00	0	0	0
0013	3T	7_A2	241	3	0	300	0	-300	0.00	0.00	0	0	0
0013	3T	7_A2	243	5	0	500	0	-500	0.00	0.00	0	0	0
0013	3T	7_A2	245	2	0	200	0	-200	0.00	0.00	0	0	0
0013	3T	7_A2	246	1	0	100	0	-100	0.00	0.00	0	0	0
0013	3T	7_A2	253	5	0	500	0	-500	0.00	0.00	0	0	0
0013	3T	7_A2	256	2	0	200	0	-200	0.00	0.00	0	0	0
0013	3T	7_A2	261	1	0	100	0	-100	0.00	0.00	0	0	0
0013	3T	7_A2	264	2	0	200	0	-200	0.00	0.00	0	0	0
0013	3T	7_B1	123	255	18	25500	18210	-7290	0.07	0.71	45	32	-13
0013	3T	7_B1	124	228	20	22800	29880	7080	0.09	1.31	40	52	12
0013	3T	7_B1	125	181	8	18100	18780	680	0.04	1.04	32	33	1
0013	3T	7_B1	126	158	7	15800	15200	-600	0.04	0.96	27	26	-1
0013	3T	7_B1	132	138	8	13800	10150	-3650	0.06	0.74	24	17	-7
0013	3T	7_B1	134	129	10	12900	13520	620	0.08	1.05	22	23	1
0013	3T	7_B1	135	111	7	11100	15400	4300	0.06	1.39	19	27	8
0013	3T	7_B1	136	91	5	9100	6530	-2570	0.05	0.72	16	11	-5
0013	3T	7_B1	142	93	9	9300	19470	10170	0.10	2.09	16	34	18
0013	3T	7_B1	143	104	6	10400	12600	2200	0.06	1.21	18	22	4
0013	3T	7_B1	145	64	0	6400	0	-6400	0.00	0.00	11	0	-11
0013	3T	7_B1	146	76	1	7600	2090	-5510	0.01	0.28	13	3	-10
0013	3T	7_B1	152	34	0	3400	0	-3400	0.00	0.00	6	0	-6
0013	3T	7_B1	153	55	2	5500	3220	-2280	0.04	0.59	9	5	-4
0013	3T	7_B1	154	28	0	2800	0	-2800	0.00	0.00	4	0	-4
0013	3T	7_B1	156	33	0	3300	0	-3300	0.00	0.00	5	0	-5
0013	3T	7_B1	162	41	0	4100	0	-4100	0.00	0.00	7	0	-7
0013	3T	7_B1	163	36	0	3600	0	-3600	0.00	0.00	6	0	-6
0013	3T	7_B1	164	16	0	1600	0	-1600	0.00	0.00	2	0	-2
0013	3T	7_B1	165	14	0	1400	0	-1400	0.00	0.00	2	0	-2
0013	3T	7_B1	213	56	2	5600	4410	-1190	0.04	0.79	9	7	-2
0013	3T	7_B1	214	36	4	3600	14390	10790	0.11	4.00	6	25	19
0013	3T	7_B1	215	32	0	3200	0	-3200	0.00	0.00	5	0	-5
0013	3T	7_B1	216	29	1	2900	2250	-650	0.03	0.78	5	3	-2
0013	3T	7_B1	231	21	1	2100	3760	1660	0.05	1.79	3	6	3
0013	3T	7_B1	234	29	0	2900	0	-2900	0.00	0.00	5	0	-5
0013	3T	7_B1	235	27	0	2700	0	-2700	0.00	0.00	4	0	-4
0013	3T	7_B1	236	26	0	2600	0	-2600	0.00	0.00	4	0	-4
0013	3T	7_B1	241	15	0	1500	0	-1500	0.00	0.00	2	0	-2
0013	3T	7_B1	243	15	1	1500	1390	-110	0.07	0.93	2	2	0
0013	3T	7_B1	245	14	0	1400	0	-1400	0.00	0.00	2	0	-2
0013	3T	7_B1	246	9	0	900	0	-900	0.00	0.00	1	0	-1
0013	3T	7_B1	251	8	0	800	0	-800	0.00	0.00	1	0	-1
0013	3T	7_B1	253	18	2	1800	6210	4410	0.11	3.45	3	10	7
0013	3T	7_B1	254	8	0	800	0	-800	0.00	0.00	1	0	-1
0013	3T	7_B1	256	12	0	1200	0	-1200	0.00	0.00	2	0	-2
0013	3T	7_B1	261	6	0	600	0	-600	0.00	0.00	1	0	-1
0013	3T	7_B1	263	10	0	1000	0	-1000	0.00	0.00	1	0	-1
0013	3T	7_B1	264	6	0	600	0	-600	0.00	0.00	1	0	-1
0013	3T	7_B1	265	7	0	700	0	-700	0.00	0.00	1	0	-1
0013	3T	7_B2	123	17	1	1700	640	-1060	0.06	0.38	3	1	-2
0013	3T	7_B2	124	9	0	900	0	-900	0.00	0.00	1	0	-1
0013	3T	7_B2	125	6	2	600	2040	1440	0.33	3.40	1	3	2
0013	3T	7_B2	126	5	0	500	0	-500	0.00	0.00	0	0	0
0013	3T	7_B2	132	9	2	900	1730	830	0.22	1.92	1	3	2
0013	3T	7_B2	134	5	1	500	490	-10	0.20	0.98	0	0	0
0013	3T	7_B2	135	8	0	800	0	-800	0.00	0.00	1	0	-1
0013	3T	7_B2	136	6	1	600	3650	3050	0.17	6.08	1	6	5
0013	3T	7_B2	142	4	0	400	0	-400	0.00	0.00	0	0	0
0013	3T	7_B2	143	3	0	300	0	-300	0.00	0.00	0	0	0
0013	3T	7_B2	145	2	0	200	0	-200	0.00	0.00	0	0	0
0013	3T	7_B2	146	3	0	300	0	-300	0.00	0.00	0	0	0
0013	3T	7_B2	152	4	0	400	0	-400	0.00	0.00	0	0	0
0013	3T	7_B2	154	2	1	200	800	600	0.50	4.00	0	1	1
0013	3T	7_B2	156	3	0	300	0	-300	0.00	0.00	0	0	0
0013	3T	7_B2	162	1	0	100	0	-100	0.00	0.00	0	0	0
0013	3T	7_B2	163	2	0	200	0	-200	0.00	0.00	0	0	0
0013	3T	7_B2	213	4	1	400	5360	4960	0.25	13.40	0	9	9
0013	3T	7_B2	214	3	0	300	0	-300	0.00	0.00	0	0	0
0013	3T	7_B2	215	1	0	100	0	-100	0.00	0.00	0	0	0
0013	3T	7_B2	216	1	0	100	0	-100	0.00	0.00	0	0	0
0013	3T	7_B2	231	3	1	300	1600	1300	0.33	5.33	0	2	2
0013	3T	7_B2	234	5	0	500	0	-500	0.00	0.00	0	0	0
0013	3T	7_B2	235	6	0	600	0	-600	0.00	0.00	1	0	-1
0013	3T	7_B2	236	1	0	100	0	-100	0.00	0.00	0	0	0
0013	3T	7_B2	241	1	0	100	0	-100	0.00	0.00	0	0	0
0013	3T	7_B2	243	3	0	300	0	-300	0.00	0.00	0	0	0
0013	3T	7_B2	251	1	0	100	0	-100	0.00	0.00	0	0	0
0013	3T	7_B2	261	2	0	200	0	-200	0.00	0.00	0	0	0
0013	3T	7_B2	263	1	0	100	0	-100	0.00	0.00	0	0	0
0013	3T	7_B2	264	1	0	100	0	-100	0.00	0.00	0	0	0
0005	2F	02	14	334	50	33400	21130	-12270	0.15	0.63	59	37	-22
0005	2F	02	15	184	29	18400	25220	6820	0.16	1.37	32	44	12
0005	2F	02	16	71	5	7100	4460	-2640	0.07	0.63	12	7	-5
0005	2F	02	23	67	8	6700	3290	-3410	0.12	0.49	11	5	-6
0005	2F	02	24	41	8	4100	4000	-100	0.20	0.98	7	7	0
0005	2F	02	25	33	4	3300	3120	-180	0.12	0.95	5	5	0
0005	2F	02	26	16	0	1600	0	-1600	0.00	0.00	2	0	-2
0005	2F	03	12	744	213	74400	70090	-4310	0.29	0.94	131	124	-7
0005	2F	03	13	411	94	41100	35480	-5620	0.23	0.86	72	62	-10
0005	2F	03	14	253	49	25300	21410	-3890	0.19	0.85	44	37	-7
0005	2F	03	15	142	20	14200	18970	4770	0.14	1.34	25	33	8
0005	2F	03	16	75	8	7500	9160	1660	0.11	1.22	13	16	3
0005	2F	03	23	67	11	6700	5140	-1560	0.16	0.77	11	9	-2
0005	2F	03	24	37	3	3700	1550	-2150	0.08	0.42	6	2	-4
0005	2F	03	25	35	0	3500	0	-3500	0.00	0.00	6	0	-6
0005	2F	03	26	15	0	1500	0	-1500	0.00	0.00	2	0	-2
0002	1T	0	1	4041	2064	404100	367660	-36440	0.51	0.91	715	650	-65
0002	1T	0	2	150	42	15000	12990	-2010	0.28	0.87	26	22	-4
0002	1T	1	1	8439	5556	843900	766320	-77580	0.66	0.91	1493	1356	-137
0002	1T	1	2	424	161	42400	38170	-4230	0.38	0.90	75	67	-8
0002	1T	2	1	11380	6494	1138000	1049100	-88900	0.57	0.92	2014	1856	-158
0002	1T	2	2	2066	829	206600	187650	-18950	0.40	0.91	365	332	-33
0002	1T	3	1	17546	9715	1754600	1663310	-91290	0.55	0.95	3105	2943	-162
0002	1T	3	2	4318	1529	431800	386800	-45000	0.35	0.90	764	684	-80
0002	1T	4	1	12824	7510	1282400	1143870	-138530	0.59	0.89	2269	2024	-245
0002	1T	4	2	918	303	91800	75320	-16480	0.33	0.82	162	133	-29
0002	1T	5	1	4773	3239	477300	432430	-44870	0.68	0.91	844	765	-79
0002	1T	5	2	37	10	3700	2940	-760	0.27	0.79	6	5	-1
0002	1T	6	1	3433	2379	343300	314420	-28880	0.69	0.92	607	556	-51
0002	1T	6	2	4	2	400	690	290	0.50	1.73	0	1	1
0002	2F	0	12	2563	729	256300	222580	-33720	0.28	0.87	453	393	-60
0002	2F	0	13	974	191	97400	70210	-27190	0.20	0.72	172	124	-48
0002	2F	0	14	396	70	39600	32220	-7380	0.18	0.81	70	57	-13
0002	2F	0	15	100	12	10000	6500	-3500	0.12	0.65	17	11	-6
0002	2F	0	16	6	0	600	0	-600	0.00	0.00	1	0	-1
0002	2F	0	23	17	4	1700	3500	1800	0.24	2.06	3	6	3
0002	2F	0	24	13	1	1300	630	-670	0.08	0.48	2	1	-1
0002	2F	0	25	3	1	300	1680	1380	0.33	5.60	0	2	2
0002	2F	1	12	5368	1764	536800	461240	-75560	0.33	0.86	950	816	-134
0002	2F	1	13	1912	576	191200	153450	-37750	0.30	0.80	338	271	-67
0002	2F	1	14	615	177	61500	52730	-8770	0.29	0.86	108	93	-15
0002	2F	1	15	236	39	23600	14310	-9290	0.17	0.61	41	25	-16
0002	2F	1	16	128	19	12800	10270	-2530	0.15	0.80	22	18	-4
0002	2F	1	23	11	1	1100	230	-870	0.09	0.21	1	0	-1
0002	2F	1	24	2	1	200	640	440	0.50	3.20	0	1	1
0002	2F	1	25	3	1	300	460	160	0.33	1.53	0	0	0
0002	2F	1	26	8	1	800	330	-470	0.13	0.41	1	0	-1
0002	2F	2	12	5307	1886	530700	470680	-60020	0.36	0.89	939	833	-106
0002	2F	2	13	2412	800	241200	179860	-61340	0.33	0.75	426	318	-108
0002	2F	2	14	2328	743	232800	172780	-60020	0.32	0.74	412	305	-107
0002	2F	2	15	923	199	92300	77160	-15140	0.22	0.84	163	136	-27
0002	2F	2	16	442	96	44200	40820	-3380	0.22	0.92	78	72	-6
0002	2F	2	23	38	12	3800	3820	20	0.32	1.01	6	6	0
0002	2F	2	24	128	29	12800	9750	-3050	0.23	0.76	22	17	-5
0002	2F	2	25	147	20	14700	8840	-5860	0.14	0.60	26	15	-11
0002	2F	2	26	134	18	13400	9540	-3860	0.13	0.71	23	16	-7
0002	2F	3	12	8392	2788	839200	732040	-107160	0.33	0.87	1485	1295	-190
0002	2F	3	13	4825	1655	482500	408850	-73650	0.34	0.85	853	723	-130
0002	2F	3	14	2834	784	283400	221980	-61420	0.28	0.78	501	392	-109
0002	2F	3	15	1165	237	116500	95430	-21070	0.20	0.82	206	168	-38
0002	2F	3	16	688	144	68800	73830	5030	0.21	1.07	121	130	9
0002	2F	3	23	164	43	16400	13380	-3020	0.26	0.82	29	23	-6
0002	2F	3	24	227	43	22700	16750	-5950	0.19	0.74	40	29	-11
0002	2F	3	25	377	52	37700	23150	-14550	0.14	0.61	66	40	-26
0002	2F	3	26	339	59	33900	32180	-1720	0.17	0.95	60	56	-4
0002	2F	4	12	7277	2414	727700	617040	-110660	0.33	0.85	1287	1092	-195
0002	2F	4	13	3516	1101	351600	293520	-58080	0.31	0.83	622	519	-103
0002	2F	4	14	1310	339	131000	105590	-25410	0.26	0.81	231	186	-45
0002	2F	4	15	322	54	32200	23030	-9170	0.17	0.72	56	40	-16
0002	2F	4	16	188	24	18800	12490	-6310	0.13	0.66	33	22	-11
0002	2F	4	23	41	10	4100	2890	-1210	0.24	0.70	7	5	-2
0002	2F	4	24	36	4	3600	1240	-2360	0.11	0.34	6	2	-4
0002	2F	4	25	51	1	5100	350	-4750	0.02	0.07	9	0	-9
0002	2F	4	26	48	7	4800	3220	-1580	0.15	0.67	8	5	-3
0002	2F	5	12	3611	1192	361100	284330	-76770	0.33	0.79	639	503	-136
0002	2F	5	13	858	223	85800	62350	-23450	0.26	0.73	151	110	-41
0002	2F	5	14	191	46	19100	14550	-4550	0.24	0.76	33	25	-8
0002	2F	5	15	8	1	800	300	-500	0.13	0.38	1	0	-1
0002	2F	5	16	4	0	400	0	-400	0.00	0.00	0	0	0
0002	2F	5	23	1	0	100	0	-100	0.00	0.00	0	0	0
0002	2F	5	24	1	0	100	0	-100	0.00	0.00	0	0	0
0002	2F	5	25	1	0	100	0	-100	0.00	0.00	0	0	0
0002	2F	5	26	2	0	200	0	-200	0.00	0.00	0	0	0
0002	2F	6	12	3076	914	307600	237700	-69900	0.30	0.77	544	420	-124
0002	2F	6	13	263	69	26300	21700	-4600	0.26	0.83	46	38	-8
0002	2F	6	14	39	11	3900	3710	-190	0.28	0.95	6	6	0
0002	2F	6	15	3	1	300	400	100	0.33	1.33	0	0	0
0002	2T	0	12	2563	527	256300	217160	-39140	0.21	0.85	453	384	-69
0002	2T	0	13	974	147	97400	74330	-23070	0.15	0.76	172	131	-41
0002	2T	0	14	396	52	39600	32830	-6770	0.13	0.83	70	58	-12
0002	2T	0	15	100	8	10000	5890	-4110	0.08	0.59	17	10	-7
0002	2T	0	16	6	0	600	0	-600	0.00	0.00	1	0	-1
0002	2T	0	23	17	2	1700	1440	-260	0.12	0.85	3	2	-1
0002	2T	0	24	13	1	1300	1100	-200	0.08	0.85	2	1	-1
0002	2T	0	25	3	0	300	0	-300	0.00	0.00	0	0	0
0002	2T	1	12	5335	1444	533500	439490	-94010	0.27	0.82	944	777	-167
0002	2T	1	13	1912	456	191200	148330	-42870	0.24	0.78	338	262	-76
0002	2T	1	14	615	131	61500	52850	-8650	0.21	0.86	108	93	-15
0002	2T	1	15	236	27	23600	13370	-10230	0.11	0.57	41	23	-18
0002	2T	1	16	128	16	12800	10330	-2470	0.13	0.81	22	18	-4
0002	2T	1	21	33	3	3300	1500	-1800	0.09	0.45	5	2	-3
0002	2T	1	23	11	1	1100	350	-750	0.09	0.32	1	0	-1
0002	2T	1	24	2	1	200	1180	980	0.50	5.90	0	2	2
0002	2T	1	25	3	0	300	0	-300	0.00	0.00	0	0	0
0002	2T	1	26	8	1	800	710	-90	0.13	0.89	1	1	0
0002	2T	2	12	4937	1314	493700	419720	-73980	0.27	0.85	873	742	-131
0002	2T	2	13	2412	574	241200	185320	-55880	0.24	0.77	426	328	-98
0002	2T	2	14	2328	530	232800	175120	-57680	0.23	0.75	412	309	-103
0002	2T	2	15	923	136	92300	77410	-14890	0.15	0.84	163	137	-26
0002	2T	2	16	442	64	44200	44910	710	0.14	1.02	78	79	1
0002	2T	2	21	370	40	37000	35960	-1040	0.11	0.97	65	63	-2
0002	2T	2	23	38	7	3800	4720	920	0.18	1.24	6	8	2
0002	2T	2	24	128	15	12800	9020	-3780	0.12	0.70	22	15	-7
0002	2T	2	25	147	12	14700	7530	-7170	0.08	0.51	26	13	-13
0002	2T	2	26	134	12	13400	8230	-5170	0.09	0.61	23	14	-9
0002	2T	3	12	7364	1842	736400	612260	-124140	0.25	0.83	1303	1083	-220
0002	2T	3	13	4825	1162	482500	393920	-88580	0.24	0.82	853	697	-156
0002	2T	3	14	2834	583	283400	230520	-52880	0.21	0.81	501	408	-93
0002	2T	3	15	1165	167	116500	91560	-24940	0.14	0.79	206	162	-44
0002	2T	3	16	688	104	68800	80780	11980	0.15	1.17	121	142	21
0002	2T	3	21	1028	109	102800	97480	-5320	0.11	0.95	181	172	-9
0002	2T	3	23	164	27	16400	13650	-2750	0.16	0.83	29	24	-5
0002	2T	3	24	227	21	22700	12130	-10570	0.09	0.53	40	21	-19
0002	2T	3	25	377	31	37700	21550	-16150	0.08	0.57	66	38	-28
0002	2T	3	26	339	35	33900	30910	-2990	0.10	0.91	60	54	-6
0002	2T	4	12	7012	1765	701200	565860	-135340	0.25	0.81	1241	1001	-240
0002	2T	4	13	3516	840	351600	283940	-67660	0.24	0.81	622	502	-120
0002	2T	4	14	1310	253	131000	103410	-27590	0.19	0.79	231	183	-48
0002	2T	4	15	322	41	32200	25600	-6600	0.13	0.80	56	45	-11
0002	2T	4	16	188	19	18800	16550	-2250	0.10	0.88	33	29	-4
0002	2T	4	21	265	29	26500	26490	-10	0.11	1.00	46	46	0
0002	2T	4	23	41	4	4100	2130	-1970	0.10	0.52	7	3	-4
0002	2T	4	24	36	3	3600	910	-2690	0.08	0.25	6	1	-5
0002	2T	4	25	51	1	5100	640	-4460	0.02	0.13	9	1	-8
0002	2T	4	26	48	3	4800	2150	-2650	0.06	0.45	8	3	-5
0002	2T	5	12	3596	965	359600	274960	-84640	0.27	0.76	636	486	-150
0002	2T	5	13	858	182	85800	59580	-26220	0.21	0.69	151	105	-46
0002	2T	5	14	191	33	19100	12040	-7060	0.17	0.63	33	21	-12
0002	2T	5	15	8	0	800	0	-800	0.00	0.00	1	0	-1
0002	2T	5	16	4	0	400	0	-400	0.00	0.00	0	0	0
0002	2T	5	21	15	1	1500	1340	-160	0.07	0.89	2	2	0
0002	2T	5	23	1	0	100	0	-100	0.00	0.00	0	0	0
0002	2T	5	24	1	0	100	0	-100	0.00	0.00	0	0	0
0002	2T	5	25	1	0	100	0	-100	0.00	0.00	0	0	0
0002	2T	5	26	2	0	200	0	-200	0.00	0.00	0	0	0
0002	2T	6	12	3075	764	307500	238310	-69190	0.25	0.77	544	421	-123
0002	2T	6	13	263	55	26300	20540	-5760	0.21	0.78	46	36	-10
0002	2T	6	14	39	10	3900	4280	380	0.26	1.10	6	7	1
0002	2T	6	15	3	1	300	570	270	0.33	1.90	0	1	1
0002	2T	6	21	1	0	100	0	-100	0.00	0.00	0	0	0
0002	3F	0	123	971	169	97100	72980	-24120	0.17	0.75	171	129	-42
0002	3F	0	124	354	55	35400	26400	-9000	0.16	0.75	62	46	-16
0002	3F	0	125	734	86	73400	57940	-15460	0.12	0.79	129	102	-27
0002	3F	0	126	378	32	37800	27790	-10010	0.08	0.74	66	49	-17
0002	3F	0	134	225	29	22500	17470	-5030	0.13	0.78	39	30	-9
0002	3F	0	135	197	16	19700	10760	-8940	0.08	0.55	34	19	-15
0002	3F	0	136	224	16	22400	17040	-5360	0.07	0.76	39	30	-9
0002	3F	0	145	186	25	18600	19190	590	0.13	1.03	32	33	1
0002	3F	0	146	45	6	4500	5020	520	0.13	1.12	7	8	1
0002	3F	0	234	7	1	700	400	-300	0.14	0.57	1	0	-1
0002	3F	0	235	3	0	300	0	-300	0.00	0.00	0	0	0
0002	3F	0	236	1	0	100	0	-100	0.00	0.00	0	0	0
0002	3F	0	245	9	0	900	0	-900	0.00	0.00	1	0	-1
0002	3F	0	246	1	0	100	0	-100	0.00	0.00	0	0	0
0002	3F	1	123	1456	314	145600	118820	-26780	0.22	0.82	257	210	-47
0002	3F	1	124	1452	294	145200	112400	-32800	0.20	0.77	256	198	-58
0002	3F	1	125	1315	179	131500	89020	-42480	0.14	0.68	232	157	-75
0002	3F	1	126	1069	135	106900	86330	-20570	0.13	0.81	189	152	-37
0002	3F	1	134	569	110	56900	42530	-14370	0.19	0.75	100	75	-25
0002	3F	1	135	473	66	47300	28880	-18420	0.14	0.61	83	51	-32
0002	3F	1	136	436	57	43600	37060	-6540	0.13	0.85	77	65	-12
0002	3F	1	145	189	31	18900	14900	-4000	0.16	0.79	33	26	-7
0002	3F	1	146	97	16	9700	7860	-1840	0.16	0.81	17	13	-4
0002	3F	1	156	72	8	7200	9570	2370	0.11	1.33	12	16	4
0002	3F	1	234	3	1	300	410	110	0.33	1.37	0	0	0
0002	3F	1	235	5	0	500	0	-500	0.00	0.00	0	0	0
0002	3F	2	123	1413	382	141300	116250	-25050	0.27	0.82	250	205	-45
0002	3F	2	124	1687	426	168700	129030	-39670	0.25	0.76	298	228	-70
0002	3F	2	125	1160	229	116000	103990	-12010	0.20	0.90	205	184	-21
0002	3F	2	126	1022	164	102200	84190	-18010	0.16	0.82	180	149	-31
0002	3F	2	134	683	171	68300	54860	-13440	0.25	0.80	120	97	-23
0002	3F	2	135	564	97	56400	34990	-21410	0.17	0.62	99	61	-38
0002	3F	2	136	490	79	49000	38180	-10820	0.16	0.78	86	67	-19
0002	3F	2	145	470	91	47000	39980	-7020	0.19	0.85	83	70	-13
0002	3F	2	146	254	33	25400	20490	-4910	0.13	0.81	44	36	-8
0002	3F	2	156	126	22	12600	10380	-2220	0.17	0.82	22	18	-4
0002	3F	2	234	4	3	400	1090	690	0.75	2.73	0	1	1
0002	3F	2	235	15	3	1500	1390	-110	0.20	0.93	2	2	0
0002	3F	2	236	11	0	1100	0	-1100	0.00	0.00	1	0	-1
0002	3F	2	245	16	3	1600	1960	360	0.19	1.23	2	3	1
0002	3F	2	246	32	3	3200	1740	-1460	0.09	0.54	5	3	-2
0002	3F	2	256	39	4	3900	2900	-1000	0.10	0.74	6	5	-1
0002	3F	3	123	1415	466	141500	115580	-25920	0.33	0.82	250	204	-46
0002	3F	3	124	2721	697	272100	218750	-53350	0.26	0.80	481	387	-94
0002	3F	3	125	1916	361	191600	154550	-37050	0.19	0.81	339	273	-66
0002	3F	3	126	2311	361	231100	195770	-35330	0.16	0.85	409	346	-63
0002	3F	3	134	1321	371	132100	103920	-28180	0.28	0.79	233	183	-50
0002	3F	3	135	1290	282	129000	97020	-31980	0.22	0.75	228	171	-57
0002	3F	3	136	1496	267	149600	117430	-32170	0.18	0.78	264	207	-57
0002	3F	3	145	646	147	64600	56940	-7660	0.23	0.88	114	100	-14
0002	3F	3	146	614	96	61400	56600	-4800	0.16	0.92	108	100	-8
0002	3F	3	156	382	50	38200	29320	-8880	0.13	0.77	67	51	-16
0002	3F	3	234	38	6	3800	2380	-1420	0.16	0.63	6	4	-2
0002	3F	3	235	43	9	4300	2780	-1520	0.21	0.65	7	4	-3
0002	3F	3	236	65	6	6500	4420	-2080	0.09	0.68	11	7	-4
0002	3F	3	245	67	6	6700	2060	-4640	0.09	0.31	11	3	-8
0002	3F	3	246	56	6	5600	4810	-790	0.11	0.86	9	8	-1
0002	3F	3	256	106	14	10600	7600	-3000	0.13	0.72	18	13	-5
0002	3F	4	123	959	281	95900	76530	-19370	0.29	0.80	169	135	-34
0002	3F	4	124	3263	711	326300	249160	-77140	0.22	0.76	577	440	-137
0002	3F	4	125	1610	237	161000	115060	-45940	0.15	0.71	284	203	-81
0002	3F	4	126	1441	173	144100	116820	-27280	0.12	0.81	255	206	-49
0002	3F	4	134	1190	254	119000	92730	-26270	0.21	0.78	210	164	-46
0002	3F	4	135	1104	211	110400	93110	-17290	0.19	0.84	195	164	-31
0002	3F	4	136	999	128	99900	79570	-20330	0.13	0.80	176	140	-36
0002	3F	4	145	387	56	38700	24220	-14480	0.14	0.63	68	42	-26
0002	3F	4	146	298	36	29800	23930	-5870	0.12	0.80	52	42	-10
0002	3F	4	156	115	13	11500	9080	-2420	0.11	0.79	20	16	-4
0002	3F	4	234	10	1	1000	440	-560	0.10	0.44	1	0	-1
0002	3F	4	235	12	1	1200	560	-640	0.08	0.47	2	0	-2
0002	3F	4	236	18	2	1800	830	-970	0.11	0.46	3	1	-2
0002	3F	4	245	9	1	900	640	-260	0.11	0.71	1	1	0
0002	3F	4	246	18	3	1800	2160	360	0.17	1.20	3	3	0
0002	3F	4	256	25	2	2500	2930	430	0.08	1.17	4	5	1
0002	3F	5	123	680	175	68000	57150	-10850	0.26	0.84	120	101	-19
0002	3F	5	124	2252	384	225200	145770	-79430	0.17	0.65	398	258	-140
0002	3F	5	125	379	45	37900	25520	-12380	0.12	0.67	67	45	-22
0002	3F	5	126	300	24	30000	26450	-3550	0.08	0.88	53	46	-7
0002	3F	5	134	421	68	42100	31290	-10810	0.16	0.74	74	55	-19
0002	3F	5	135	193	22	19300	12160	-7140	0.11	0.63	34	21	-13
0002	3F	5	136	196	21	19600	21090	1490	0.11	1.08	34	37	3
0002	3F	5	145	49	5	4900	3740	-1160	0.10	0.76	8	6	-2
0002	3F	5	146	21	3	2100	2440	340	0.14	1.16	3	4	1
0002	3F	5	156	1	0	100	0	-100	0.00	0.00	0	0	0
0002	3F	5	236	1	0	100	0	-100	0.00	0.00	0	0	0
0002	3F	5	246	1	0	100	0	-100	0.00	0.00	0	0	0
0002	3F	6	123	789	161	78900	60790	-18110	0.20	0.77	139	107	-32
0002	3F	6	124	2093	318	209300	143990	-65310	0.15	0.69	370	254	-116
0002	3F	6	125	99	7	9900	4280	-5620	0.07	0.43	17	7	-10
0002	3F	6	126	95	6	9500	9180	-320	0.06	0.97	16	16	0
0002	3F	6	134	151	33	15100	18920	3820	0.22	1.25	26	33	7
0002	3F	6	135	45	5	4500	3530	-970	0.11	0.78	7	6	-1
0002	3F	6	136	48	2	4800	1050	-3750	0.04	0.22	8	1	-7
0002	3F	6	145	8	1	800	300	-500	0.13	0.38	1	0	-1
0002	3F	6	146	6	0	600	0	-600	0.00	0.00	1	0	-1
0002	3F	6	156	2	0	200	0	-200	0.00	0.00	0	0	0
0002	3T	0	123	900	57	90000	63960	-26040	0.06	0.71	159	113	-46
0002	3T	0	124	354	25	35400	29570	-5830	0.07	0.84	62	52	-10
0002	3T	0	125	732	49	73200	85410	12210	0.07	1.17	129	151	22
0002	3T	0	126	374	13	37400	28820	-8580	0.03	0.77	66	51	-15
0002	3T	0	132	71	4	7100	4280	-2820	0.06	0.60	12	7	-5
0002	3T	0	134	172	6	17200	6640	-10560	0.03	0.39	30	11	-19
0002	3T	0	135	168	8	16800	8860	-7940	0.05	0.53	29	15	-14
0002	3T	0	136	223	7	22300	13140	-9160	0.03	0.59	39	23	-16
0002	3T	0	143	53	2	5300	3350	-1950	0.04	0.63	9	5	-4
0002	3T	0	145	186	11	18600	32750	14150	0.06	1.76	32	57	25
0002	3T	0	146	44	3	4400	5610	1210	0.07	1.28	7	9	2
0002	3T	0	152	2	0	200	0	-200	0.00	0.00	0	0	0
0002	3T	0	153	29	0	2900	0	-2900	0.00	0.00	5	0	-5
0002	3T	0	162	4	0	400	0	-400	0.00	0.00	0	0	0
0002	3T	0	163	1	0	100	0	-100	0.00	0.00	0	0	0
0002	3T	0	164	1	0	100	0	-100	0.00	0.00	0	0	0
0002	3T	0	234	7	0	700	0	-700	0.00	0.00	1	0	-1
0002	3T	0	235	3	0	300	0	-300	0.00	0.00	0	0	0
0002	3T	0	236	1	0	100	0	-100	0.00	0.00	0	0	0
0002	3T	0	245	9	0	900	0	-900	0.00	0.00	1	0	-1
0002	3T	0	246	1	0	100	0	-100	0.00	0.00	0	0	0
0002	3T	1	123	1441	154	144100	121100	-23000	0.11	0.84	255	214	-41
0002	3T	1	124	1430	139	143000	112380	-30620	0.10	0.79	253	198	-55
0002	3T	1	125	1306	93	130600	104870	-25730	0.07	0.80	231	185	-46
0002	3T	1	126	1051	57	105100	80840	-24260	0.05	0.77	186	143	-43
0002	3T	1	132	15	2	1500	1770	270	0.13	1.18	2	3	1
0002	3T	1	134	468	41	46800	32460	-14340	0.09	0.69	82	57	-25
0002	3T	1	135	454	26	45400	27310	-18090	0.06	0.60	80	48	-32
0002	3T	1	136	435	19	43500	25250	-18250	0.04	0.58	76	44	-32
0002	3T	1	142	16	2	1600	3220	1620	0.13	2.01	2	5	3
0002	3T	1	143	101	9	10100	10080	-20	0.09	1.00	17	17	0
0002	3T	1	145	187	12	18700	15980	-2720	0.06	0.85	33	28	-5
0002	3T	1	146	97	8	9700	9630	-70	0.08	0.99	17	17	0
0002	3T	1	152	1	0	100	0	-100	0.00	0.00	0	0	0
0002	3T	1	153	19	1	1900	770	-1130	0.05	0.41	3	1	-2
0002	3T	1	154	2	0	200	0	-200	0.00	0.00	0	0	0
0002	3T	1	156	70	1	7000	890	-6110	0.01	0.13	12	1	-11
0002	3T	1	163	1	0	100	0	-100	0.00	0.00	0	0	0
0002	3T	1	165	2	0	200	0	-200	0.00	0.00	0	0	0
0002	3T	1	214	5	0	500	0	-500	0.00	0.00	0	0	0
0002	3T	1	215	8	0	800	0	-800	0.00	0.00	1	0	-1
0002	3T	1	216	18	1	1800	1570	-230	0.06	0.87	3	2	-1
0002	3T	1	234	3	1	300	880	580	0.33	2.93	0	1	1
0002	3T	1	235	5	0	500	0	-500	0.00	0.00	0	0	0
0002	3T	1	241	1	0	100	0	-100	0.00	0.00	0	0	0
0002	3T	2	123	1360	154	136000	109190	-26810	0.11	0.80	240	193	-47
0002	3T	2	124	1552	154	155200	112110	-43090	0.10	0.72	274	198	-76
0002	3T	2	125	1063	84	106300	93780	-12520	0.08	0.88	188	165	-23
0002	3T	2	126	849	60	84900	77570	-7330	0.07	0.91	150	137	-13
0002	3T	2	132	22	3	2200	2410	210	0.14	1.10	3	4	1
0002	3T	2	134	559	62	55900	43850	-12050	0.11	0.78	98	77	-21
0002	3T	2	135	551	38	55100	31030	-24070	0.07	0.56	97	54	-43
0002	3T	2	136	465	29	46500	37840	-8660	0.06	0.81	82	66	-16
0002	3T	2	142	80	8	8000	5560	-2440	0.10	0.70	14	9	-5
0002	3T	2	143	124	8	12400	13290	890	0.06	1.07	21	23	2
0002	3T	2	145	470	27	47000	30600	-16400	0.06	0.65	83	54	-29
0002	3T	2	146	249	12	24900	14180	-10720	0.05	0.57	44	25	-19
0002	3T	2	152	8	1	800	880	80	0.13	1.10	1	1	0
0002	3T	2	153	13	0	1300	0	-1300	0.00	0.00	2	0	-2
0002	3T	2	156	88	6	8800	6880	-1920	0.07	0.78	15	12	-3
0002	3T	2	162	5	1	500	3000	2500	0.20	6.00	0	5	5
0002	3T	2	163	25	0	2500	0	-2500	0.00	0.00	4	0	-4
0002	3T	2	164	5	0	500	0	-500	0.00	0.00	0	0	0
0002	3T	2	165	38	1	3800	1360	-2440	0.03	0.36	6	2	-4
0002	3T	2	213	30	3	3000	3420	420	0.10	1.14	5	6	1
0002	3T	2	214	53	2	5300	5220	-80	0.04	0.98	9	9	0
0002	3T	2	215	85	3	8500	11640	3140	0.04	1.37	15	20	5
0002	3T	2	216	168	7	16800	19870	3070	0.04	1.18	29	35	6
0002	3T	2	231	1	0	100	0	-100	0.00	0.00	0	0	0
0002	3T	2	234	4	2	400	2320	1920	0.50	5.80	0	4	4
0002	3T	2	235	10	1	1000	680	-320	0.10	0.68	1	1	0
0002	3T	2	236	11	0	1100	0	-1100	0.00	0.00	1	0	-1
0002	3T	2	241	2	0	200	0	-200	0.00	0.00	0	0	0
0002	3T	2	245	15	1	1500	980	-520	0.07	0.65	2	1	-1
0002	3T	2	246	30	3	3000	4960	1960	0.10	1.65	5	8	3
0002	3T	2	251	4	0	400	0	-400	0.00	0.00	0	0	0
0002	3T	2	253	5	0	500	0	-500	0.00	0.00	0	0	0
0002	3T	2	254	1	0	100	0	-100	0.00	0.00	0	0	0
0002	3T	2	256	35	2	3500	5080	1580	0.06	1.45	6	8	2
0002	3T	2	264	2	0	200	0	-200	0.00	0.00	0	0	0
0002	3T	2	265	4	1	400	4810	4410	0.25	12.03	0	8	8
0002	3T	3	123	1356	202	135600	122310	-13290	0.15	0.90	240	216	-24
0002	3T	3	124	2534	248	253400	206470	-46930	0.10	0.81	448	365	-83
0002	3T	3	125	1652	138	165200	133750	-31450	0.08	0.81	292	236	-56
0002	3T	3	126	1759	121	175900	179860	3960	0.07	1.02	311	318	7
0002	3T	3	132	32	5	3200	3540	340	0.16	1.11	5	6	1
0002	3T	3	134	1314	161	131400	116710	-14690	0.12	0.89	232	206	-26
0002	3T	3	135	1282	116	128200	96180	-32020	0.09	0.75	226	170	-56
0002	3T	3	136	1495	122	149500	137570	-11930	0.08	0.92	264	243	-21
0002	3T	3	142	2	0	200	0	-200	0.00	0.00	0	0	0
0002	3T	3	143	7	0	700	0	-700	0.00	0.00	1	0	-1
0002	3T	3	145	643	48	64300	55270	-9030	0.07	0.86	113	97	-16
0002	3T	3	146	603	39	60300	58490	-1810	0.06	0.97	106	103	-3
0002	3T	3	153	8	2	800	6620	5820	0.25	8.28	1	11	10
0002	3T	3	154	3	0	300	0	-300	0.00	0.00	0	0	0
0002	3T	3	156	369	20	36900	33390	-3510	0.05	0.90	65	59	-6
0002	3T	3	163	1	0	100	0	-100	0.00	0.00	0	0	0
0002	3T	3	164	11	2	1100	3240	2140	0.18	2.95	1	5	4
0002	3T	3	165	13	0	1300	0	-1300	0.00	0.00	2	0	-2
0002	3T	3	213	27	2	2700	3070	370	0.07	1.14	4	5	1
0002	3T	3	214	185	8	18500	16080	-2420	0.04	0.87	32	28	-4
0002	3T	3	215	264	6	26400	11900	-14500	0.02	0.45	46	21	-25
0002	3T	3	216	552	16	55200	46110	-9090	0.03	0.84	97	81	-16
0002	3T	3	234	38	1	3800	1680	-2120	0.03	0.44	6	2	-4
0002	3T	3	235	41	3	4100	2250	-1850	0.07	0.55	7	3	-4
0002	3T	3	236	65	2	6500	2880	-3620	0.03	0.44	11	5	-6
0002	3T	3	245	67	1	6700	1340	-5360	0.01	0.20	11	2	-9
0002	3T	3	246	56	3	5600	2330	-3270	0.05	0.42	9	4	-5
0002	3T	3	253	2	0	200	0	-200	0.00	0.00	0	0	0
0002	3T	3	256	105	3	10500	4830	-5670	0.03	0.46	18	8	-10
0002	3T	3	265	1	0	100	0	-100	0.00	0.00	0	0	0
0002	3T	4	123	957	132	95700	86670	-9030	0.14	0.91	169	153	-16
0002	3T	4	124	3235	320	323500	261140	-62360	0.10	0.81	572	462	-110
0002	3T	4	125	1550	111	155000	127030	-27970	0.07	0.82	274	224	-50
0002	3T	4	126	1265	83	126500	103600	-22900	0.07	0.82	223	183	-40
0002	3T	4	132	1	0	100	0	-100	0.00	0.00	0	0	0
0002	3T	4	134	1190	127	119000	113410	-5590	0.11	0.95	210	200	-10
0002	3T	4	135	1104	95	110400	94970	-15430	0.09	0.86	195	168	-27
0002	3T	4	136	999	58	99900	87910	-11990	0.06	0.88	176	155	-21
0002	3T	4	145	386	18	38600	21100	-17500	0.05	0.55	68	37	-31
0002	3T	4	146	290	17	29000	27290	-1710	0.06	0.94	51	48	-3
0002	3T	4	154	1	0	100	0	-100	0.00	0.00	0	0	0
0002	3T	4	156	112	5	11200	8840	-2360	0.04	0.79	19	15	-4
0002	3T	4	164	8	0	800	0	-800	0.00	0.00	1	0	-1
0002	3T	4	165	3	1	300	3000	2700	0.33	10.00	0	5	5
0002	3T	4	213	1	0	100	0	-100	0.00	0.00	0	0	0
0002	3T	4	214	28	2	2800	2070	-730	0.07	0.74	4	3	-1
0002	3T	4	215	60	2	6000	4070	-1930	0.03	0.68	10	7	-3
0002	3T	4	216	176	12	17600	51910	34310	0.07	2.95	31	91	60
0002	3T	4	234	10	0	1000	0	-1000	0.00	0.00	1	0	-1
0002	3T	4	235	12	0	1200	0	-1200	0.00	0.00	2	0	-2
0002	3T	4	236	18	0	1800	0	-1800	0.00	0.00	3	0	-3
0002	3T	4	245	9	0	900	0	-900	0.00	0.00	1	0	-1
0002	3T	4	246	18	1	1800	1350	-450	0.06	0.75	3	2	-1
0002	3T	4	256	24	0	2400	0	-2400	0.00	0.00	4	0	-4
0002	3T	4	265	1	0	100	0	-100	0.00	0.00	0	0	0
0002	3T	5	123	680	83	68000	59710	-8290	0.12	0.88	120	105	-15
0002	3T	5	124	2251	168	225100	130510	-94590	0.07	0.58	398	230	-168
0002	3T	5	125	376	23	37600	28780	-8820	0.06	0.77	66	50	-16
0002	3T	5	126	289	14	28900	30640	1740	0.05	1.06	51	54	3
0002	3T	5	134	421	25	42100	25520	-16580	0.06	0.61	74	45	-29
0002	3T	5	135	193	10	19300	12990	-6310	0.05	0.67	34	22	-12
0002	3T	5	136	196	12	19600	17840	-1760	0.06	0.91	34	31	-3
0002	3T	5	145	48	1	4800	2200	-2600	0.02	0.46	8	3	-5
0002	3T	5	146	21	3	2100	3980	1880	0.14	1.90	3	7	4
0002	3T	5	154	1	0	100	0	-100	0.00	0.00	0	0	0
0002	3T	5	156	1	0	100	0	-100	0.00	0.00	0	0	0
0002	3T	5	214	1	0	100	0	-100	0.00	0.00	0	0	0
0002	3T	5	215	3	0	300	0	-300	0.00	0.00	0	0	0
0002	3T	5	216	11	0	1100	0	-1100	0.00	0.00	1	0	-1
0002	3T	5	236	1	0	100	0	-100	0.00	0.00	0	0	0
0002	3T	5	246	1	0	100	0	-100	0.00	0.00	0	0	0
0002	3T	6	123	789	72	78900	59420	-19480	0.09	0.75	139	105	-34
0002	3T	6	124	2093	146	209300	131820	-77480	0.07	0.63	370	233	-137
0002	3T	6	125	99	4	9900	4510	-5390	0.04	0.46	17	7	-10
0002	3T	6	126	94	3	9400	9550	150	0.03	1.02	16	16	0
0002	3T	6	134	150	18	15000	20810	5810	0.12	1.39	26	36	10
0002	3T	6	135	45	2	4500	2170	-2330	0.04	0.48	7	3	-4
0002	3T	6	136	48	1	4800	700	-4100	0.02	0.15	8	1	-7
0002	3T	6	143	1	0	100	0	-100	0.00	0.00	0	0	0
0002	3T	6	145	8	0	800	0	-800	0.00	0.00	1	0	-1
0002	3T	6	146	6	0	600	0	-600	0.00	0.00	1	0	-1
0002	3T	6	156	2	0	200	0	-200	0.00	0.00	0	0	0
0002	3T	6	216	1	0	100	0	-100	0.00	0.00	0	0	0
0005	2F	04	12	838	227	83800	77030	-6770	0.27	0.92	148	136	-12
0005	2F	04	13	471	104	47100	36280	-10820	0.22	0.77	83	64	-19
0005	2F	04	14	312	59	31200	30310	-890	0.19	0.97	55	53	-2
0005	2F	04	15	171	20	17100	10820	-6280	0.12	0.63	30	19	-11
0005	2F	04	16	112	18	11200	13900	2700	0.16	1.24	19	24	5
0005	2F	04	23	63	11	6300	6300	0	0.17	1.00	11	11	0
0005	2F	04	24	42	3	4200	820	-3380	0.07	0.20	7	1	-6
0005	2F	04	25	27	1	2700	1250	-1450	0.04	0.46	4	2	-2
0005	2F	04	26	15	1	1500	460	-1040	0.07	0.31	2	0	-2
0005	2F	05	12	959	268	95900	85290	-10610	0.28	0.89	169	150	-19
0005	2F	05	13	545	135	54500	50940	-3560	0.25	0.93	96	90	-6
0005	2F	05	14	379	86	37900	36570	-1330	0.23	0.96	67	64	-3
0005	2F	05	15	171	20	17100	10870	-6230	0.12	0.64	30	19	-11
0005	2F	05	16	88	7	8800	4130	-4670	0.08	0.47	15	7	-8
0005	2F	05	23	85	13	8500	5490	-3010	0.15	0.65	15	9	-6
0005	2F	05	24	46	4	4600	1490	-3110	0.09	0.32	8	2	-6
0005	2F	05	25	26	3	2600	1770	-830	0.12	0.68	4	3	-1
0005	2F	05	26	21	1	2100	290	-1810	0.05	0.14	3	0	-3
0005	2F	06	12	1058	307	105800	94290	-11510	0.29	0.89	187	166	-21
0005	2F	06	13	653	139	65300	50210	-15090	0.21	0.77	115	88	-27
0005	2F	06	14	351	66	35100	26130	-8970	0.19	0.74	62	46	-16
0005	2F	06	15	203	33	20300	17770	-2530	0.16	0.88	35	31	-4
0005	2F	06	16	118	17	11800	9560	-2240	0.14	0.81	20	16	-4
0005	2F	06	23	58	7	5800	4110	-1690	0.12	0.71	10	7	-3
0005	2F	06	24	35	7	3500	5300	1800	0.20	1.51	6	9	3
0005	2F	06	25	35	7	3500	8600	5100	0.20	2.46	6	15	9
0005	2F	06	26	18	1	1800	300	-1500	0.06	0.17	3	0	-3
0005	2F	07	12	1050	305	105000	97480	-7520	0.29	0.93	185	172	-13
0005	2F	07	13	647	175	64700	57130	-7570	0.27	0.88	114	101	-13
0005	2F	07	14	382	85	38200	30670	-7530	0.22	0.80	67	54	-13
0005	2F	07	15	201	39	20100	20110	10	0.19	1.00	35	35	0
0005	2F	07	16	104	13	10400	10850	450	0.13	1.04	18	19	1
0005	2F	07	23	55	9	5500	5280	-220	0.16	0.96	9	9	0
0005	2F	07	24	33	4	3300	2250	-1050	0.12	0.68	5	3	-2
0005	2F	07	25	28	2	2800	1210	-1590	0.07	0.43	4	2	-2
0005	2F	07	26	34	8	3400	9790	6390	0.24	2.88	6	17	11
0005	2F	08	12	1076	331	107600	98970	-8630	0.31	0.92	190	175	-15
0005	2F	08	13	596	147	59600	47820	-11780	0.25	0.80	105	84	-21
0005	2F	08	14	366	77	36600	27620	-8980	0.21	0.75	64	48	-16
0005	2F	08	15	153	26	15300	14370	-930	0.17	0.94	27	25	-2
0005	2F	08	16	135	27	13500	14610	1110	0.20	1.08	23	25	2
0005	2F	08	23	34	4	3400	1680	-1720	0.12	0.49	6	2	-4
0005	2F	08	24	28	6	2800	2840	40	0.21	1.01	4	5	1
0005	2F	08	25	26	8	2600	5460	2860	0.31	2.10	4	9	5
0005	2F	08	26	22	1	2200	1870	-330	0.05	0.85	3	3	0
0005	2F	09	12	1199	414	119900	103610	-16290	0.35	0.86	212	183	-29
0005	2F	09	13	642	177	64200	57830	-6370	0.28	0.90	113	102	-11
0005	2F	09	14	382	75	38200	29610	-8590	0.20	0.78	67	52	-15
0005	2F	09	15	166	23	16600	11950	-4650	0.14	0.72	29	21	-8
0005	2F	09	16	90	14	9000	10340	1340	0.16	1.15	15	18	3
0005	2F	09	23	55	10	5500	4150	-1350	0.18	0.75	9	7	-2
0005	2F	09	24	26	5	2600	1890	-710	0.19	0.73	4	3	-1
0005	2F	09	25	29	1	2900	290	-2610	0.03	0.10	5	0	-5
0005	2F	09	26	19	2	1900	930	-970	0.11	0.49	3	1	-2
0005	2F	10	12	1128	384	112800	94590	-18210	0.34	0.84	199	167	-32
0005	2F	10	13	642	168	64200	49930	-14270	0.26	0.78	113	88	-25
0018	1T	01_1	1	484	265	48400	43330	-5070	0.55	0.90	85	76	-9
0018	1T	01_1	2	56	25	5600	6070	470	0.45	1.08	9	10	1
0018	1T	01_2	1	457	216	45700	35190	-10510	0.47	0.77	80	62	-18
0018	1T	01_2	2	55	24	5500	6450	950	0.44	1.17	9	11	2
0018	1T	01_3	1	435	237	43500	40240	-3260	0.54	0.93	76	71	-5
0018	1T	01_3	2	64	20	6400	5190	-1210	0.31	0.81	11	9	-2
0018	1T	01_4	1	428	242	42800	37780	-5020	0.57	0.88	75	66	-9
0018	1T	01_4	2	67	32	6700	6260	-440	0.48	0.93	11	11	0
0018	1T	01_5	1	312	193	31200	28670	-2530	0.62	0.92	55	50	-5
0018	1T	01_5	2	12	5	1200	1080	-120	0.42	0.90	2	1	-1
0018	1T	01_6	1	31	18	3100	2410	-690	0.58	0.78	5	4	-1
0018	1T	01_6	2	3	1	300	220	-80	0.33	0.73	0	0	0
0018	1T	01_7	1	523	351	52300	55360	3060	0.67	1.06	92	97	5
0018	1T	01_7	2	28	5	2800	1440	-1360	0.18	0.51	4	2	-2
0018	1T	02_1	1	502	232	50200	42640	-7560	0.46	0.85	88	75	-13
0018	1T	02_1	2	93	25	9300	5340	-3960	0.27	0.57	16	9	-7
0018	1T	02_2	1	493	221	49300	42300	-7000	0.45	0.86	87	74	-13
0018	1T	02_2	2	88	42	8800	8260	-540	0.48	0.94	15	14	-1
0018	1T	02_3	1	526	254	52600	46690	-5910	0.48	0.89	93	82	-11
0018	1T	02_3	2	84	26	8400	5410	-2990	0.31	0.64	14	9	-5
0018	1T	02_4	1	313	170	31300	29770	-1530	0.54	0.95	55	52	-3
0018	1T	02_4	2	71	29	7100	8030	930	0.41	1.13	12	14	2
0018	1T	02_5	1	204	107	20400	16670	-3730	0.52	0.82	36	29	-7
0018	1T	02_5	2	10	2	1000	480	-520	0.20	0.48	1	0	-1
0018	1T	02_6	1	12	3	1200	630	-570	0.25	0.53	2	1	-1
0018	1T	02_7	1	516	257	51600	45020	-6580	0.50	0.87	91	79	-12
0018	1T	02_7	2	78	20	7800	6030	-1770	0.26	0.77	13	10	-3
0018	1T	03_1	1	376	185	37600	34070	-3530	0.49	0.91	66	60	-6
0018	1T	03_1	2	57	17	5700	4010	-1690	0.30	0.70	10	7	-3
0018	1T	03_2	1	319	136	31900	27140	-4760	0.43	0.85	56	48	-8
0018	1T	03_2	2	75	31	7500	8390	890	0.41	1.12	13	14	1
0018	1T	03_3	1	406	216	40600	41640	1040	0.53	1.03	71	73	2
0018	1T	03_3	2	60	19	6000	4120	-1880	0.32	0.69	10	7	-3
0018	1T	03_4	1	253	138	25300	24540	-760	0.55	0.97	44	43	-1
0018	1T	03_4	2	27	10	2700	2020	-680	0.37	0.75	4	3	-1
0018	1T	03_5	1	159	84	15900	14410	-1490	0.53	0.91	28	25	-3
0018	1T	03_5	2	18	6	1800	1370	-430	0.33	0.76	3	2	-1
0018	1T	03_7	1	376	198	37600	37070	-530	0.53	0.99	66	65	-1
0018	1T	03_7	2	72	24	7200	6630	-570	0.33	0.92	12	11	-1
0018	1T	04_1	1	422	199	42200	34350	-7850	0.47	0.81	74	60	-14
0018	1T	04_1	2	44	16	4400	4290	-110	0.36	0.98	7	7	0
0018	1T	04_2	1	409	196	40900	40160	-740	0.48	0.98	72	71	-1
0018	1T	04_2	2	44	18	4400	3610	-790	0.41	0.82	7	6	-1
0018	1T	04_3	1	420	223	42000	39650	-2350	0.53	0.94	74	70	-4
0018	1T	04_3	2	65	24	6500	6050	-450	0.37	0.93	11	10	-1
0018	1T	04_4	1	308	175	30800	30270	-530	0.57	0.98	54	53	-1
0018	1T	04_4	2	37	14	3700	3810	110	0.38	1.03	6	6	0
0018	1T	04_5	1	296	137	29600	23420	-6180	0.46	0.79	52	41	-11
0018	1T	04_5	2	24	8	2400	2410	10	0.33	1.00	4	4	0
0018	1T	04_7	1	384	202	38400	34750	-3650	0.53	0.90	67	61	-6
0018	1T	04_7	2	71	23	7100	5880	-1220	0.32	0.83	12	10	-2
0018	1T	05_1	1	496	284	49600	47270	-2330	0.57	0.95	87	83	-4
0018	1T	05_1	2	69	27	6900	5960	-940	0.39	0.86	12	10	-2
0018	1T	05_2	1	455	257	45500	44750	-750	0.56	0.98	80	79	-1
0018	1T	05_2	2	86	31	8600	8990	390	0.36	1.05	15	15	0
0018	1T	05_3	1	435	260	43500	47040	3540	0.60	1.08	76	83	7
0018	1T	05_3	2	89	34	8900	7970	-930	0.38	0.90	15	14	-1
0018	1T	05_4	1	370	226	37000	35350	-1650	0.61	0.96	65	62	-3
0018	1T	05_4	2	66	23	6600	4560	-2040	0.35	0.69	11	8	-3
0018	1T	05_5	1	288	173	28800	25850	-2950	0.60	0.90	50	45	-5
0018	1T	05_5	2	20	5	2000	1170	-830	0.25	0.59	3	2	-1
0018	1T	05_6	1	11	8	1100	1360	260	0.73	1.24	1	2	1
0018	1T	05_6	2	1	1	100	180	80	1.00	1.80	0	0	0
0018	1T	05_7	1	461	273	46100	43110	-2990	0.59	0.94	81	76	-5
0018	1T	05_7	2	75	25	7500	7250	-250	0.33	0.97	13	12	-1
0018	1T	06_1	1	530	286	53000	46540	-6460	0.54	0.88	93	82	-11
0018	1T	06_1	2	88	39	8800	9100	300	0.44	1.03	15	16	1
0018	1T	06_2	1	510	260	51000	44810	-6190	0.51	0.88	90	79	-11
0018	1T	06_2	2	106	41	10600	9760	-840	0.39	0.92	18	17	-1
0018	1T	06_3	1	494	271	49400	45410	-3990	0.55	0.92	87	80	-7
0018	1T	06_3	2	103	40	10300	10350	50	0.39	1.00	18	18	0
0018	1T	06_4	1	330	173	33000	27750	-5250	0.52	0.84	58	49	-9
0018	1T	06_4	2	76	25	7600	7220	-380	0.33	0.95	13	12	-1
0018	1T	06_5	1	214	124	21400	17640	-3760	0.58	0.82	37	31	-6
0018	1T	06_5	2	30	8	3000	2260	-740	0.27	0.75	5	4	-1
0018	1T	06_6	1	27	11	2700	1740	-960	0.41	0.64	4	3	-1
0018	1T	06_6	2	3	2	300	300	0	0.67	1.00	0	0	0
0018	1T	06_7	1	578	335	57800	52620	-5180	0.58	0.91	102	93	-9
0018	1T	06_7	2	64	21	6400	4290	-2110	0.33	0.67	11	7	-4
0018	1T	07_1	1	490	295	49000	49760	760	0.60	1.02	86	88	2
0018	1T	07_1	2	70	29	7000	8310	1310	0.41	1.19	12	14	2
0018	1T	07_2	1	495	290	49500	49320	-180	0.59	1.00	87	87	0
0018	1T	07_2	2	71	28	7100	6650	-450	0.39	0.94	12	11	-1
0018	1T	07_3	1	488	280	48800	46830	-1970	0.57	0.96	86	82	-4
0018	1T	07_3	2	75	31	7500	7160	-340	0.41	0.95	13	12	-1
0018	1T	07_4	1	428	262	42800	40880	-1920	0.61	0.96	75	72	-3
0018	1T	07_4	2	60	13	6000	2340	-3660	0.22	0.39	10	4	-6
0018	1T	07_5	1	358	229	35800	33930	-1870	0.64	0.95	63	60	-3
0018	1T	07_5	2	26	7	2600	1980	-620	0.27	0.76	4	3	-1
0018	1T	07_6	1	56	35	5600	5340	-260	0.63	0.95	9	9	0
0018	1T	07_6	2	1	0	100	0	-100	0.00	0.00	0	0	0
0018	1T	07_7	1	534	316	53400	47560	-5840	0.59	0.89	94	84	-10
0018	1T	07_7	2	34	12	3400	3400	0	0.35	1.00	6	6	0
0018	1T	08_1	1	599	339	59900	54780	-5120	0.57	0.91	106	96	-10
0018	1T	08_1	2	38	14	3800	2820	-980	0.37	0.74	6	4	-2
0018	1T	08_2	1	614	375	61400	59400	-2000	0.61	0.97	108	105	-3
0018	1T	08_2	2	43	14	4300	2530	-1770	0.33	0.59	7	4	-3
0018	1T	08_3	1	572	346	57200	53920	-3280	0.60	0.94	101	95	-6
0018	1T	08_3	2	82	26	8200	7400	-800	0.32	0.90	14	13	-1
0018	1T	08_4	1	186	117	18600	17210	-1390	0.63	0.93	32	30	-2
0018	1T	08_4	2	20	8	2000	2200	200	0.40	1.10	3	3	0
0018	1T	08_5	1	144	86	14400	12600	-1800	0.60	0.88	25	22	-3
0018	1T	08_5	2	3	1	300	150	-150	0.33	0.50	0	0	0
0018	1T	08_6	1	22	16	2200	2630	430	0.73	1.20	3	4	1
0018	1T	08_6	2	1	0	100	0	-100	0.00	0.00	0	0	0
0018	1T	08_7	1	642	406	64200	60960	-3240	0.63	0.95	113	107	-6
0018	1T	08_7	2	61	23	6100	5530	-570	0.38	0.91	10	9	-1
0018	1T	09_1	1	464	276	46400	44540	-1860	0.59	0.96	82	78	-4
0018	1T	09_1	2	90	44	9000	9320	320	0.49	1.04	15	16	1
0018	1T	09_2	1	463	277	46300	44730	-1570	0.60	0.97	81	79	-2
0018	1T	09_2	2	69	29	6900	5960	-940	0.42	0.86	12	10	-2
0018	1T	09_3	1	465	271	46500	45530	-970	0.58	0.98	82	80	-2
0018	1T	09_3	2	71	22	7100	6160	-940	0.31	0.87	12	10	-2
0018	1T	09_4	1	398	231	39800	37710	-2090	0.58	0.95	70	66	-4
0018	1T	09_4	2	70	33	7000	6110	-890	0.47	0.87	12	10	-2
0018	1T	09_5	1	449	306	44900	44510	-390	0.68	0.99	79	78	-1
0018	1T	09_5	2	26	11	2600	3390	790	0.42	1.30	4	6	2
0018	1T	09_7	1	569	395	56900	52740	-4160	0.69	0.93	100	93	-7
0018	1T	09_7	2	25	6	2500	1080	-1420	0.24	0.43	4	1	-3
0018	1T	10_1	1	388	232	38800	33640	-5160	0.60	0.87	68	59	-9
0018	1T	10_1	2	114	39	11400	10370	-1030	0.34	0.91	20	18	-2
0018	1T	10_2	1	374	225	37400	37670	270	0.60	1.01	66	66	0
0018	1T	10_2	2	113	46	11300	12280	980	0.41	1.09	20	21	1
0018	1T	10_3	1	405	208	40500	33900	-6600	0.51	0.84	71	60	-11
0018	1T	10_3	2	88	28	8800	6190	-2610	0.32	0.70	15	10	-5
0018	1T	10_4	1	381	227	38100	35240	-2860	0.60	0.92	67	62	-5
0018	1T	10_4	2	98	39	9800	10850	1050	0.40	1.11	17	19	2
0018	1T	10_5	1	358	222	35800	31260	-4540	0.62	0.87	63	55	-8
0018	1T	10_5	2	31	12	3100	2650	-450	0.39	0.85	5	4	-1
0018	1T	10_6	1	11	7	1100	1060	-40	0.64	0.96	1	1	0
0018	1T	10_6	2	1	0	100	0	-100	0.00	0.00	0	0	0
0018	1T	10_7	1	550	351	55000	48490	-6510	0.64	0.88	97	85	-12
0018	1T	10_7	2	11	2	1100	520	-580	0.18	0.47	1	0	-1
0018	1T	11_1	1	444	198	44400	34540	-9860	0.45	0.78	78	61	-17
0018	1T	11_1	2	50	11	5000	2120	-2880	0.22	0.42	8	3	-5
0018	1T	11_2	1	417	204	41700	35130	-6570	0.49	0.84	73	62	-11
0018	1T	11_2	2	62	25	6200	5960	-240	0.40	0.96	10	10	0
0018	1T	11_3	1	390	196	39000	32880	-6120	0.50	0.84	69	58	-11
0018	1T	11_3	2	89	36	8900	8960	60	0.40	1.01	15	15	0
0018	1T	11_4	1	362	194	36200	31520	-4680	0.54	0.87	64	55	-9
0018	1T	11_4	2	74	34	7400	8180	780	0.46	1.11	13	14	1
0018	1T	11_5	1	368	212	36800	33360	-3440	0.58	0.91	65	59	-6
0018	1T	11_5	2	15	4	1500	1030	-470	0.27	0.69	2	1	-1
0018	1T	11_7	1	490	306	49000	45640	-3360	0.62	0.93	86	80	-6
0018	1T	11_7	2	28	7	2800	1390	-1410	0.25	0.50	4	2	-2
0018	1T	12_1	1	446	267	44600	40610	-3990	0.60	0.91	78	71	-7
0018	1T	12_1	2	56	24	5600	5030	-570	0.43	0.90	9	8	-1
0018	1T	12_2	1	442	257	44200	39790	-4410	0.58	0.90	78	70	-8
0018	1T	12_2	2	52	18	5200	4080	-1120	0.35	0.78	9	7	-2
0018	1T	12_3	1	446	246	44600	38870	-5730	0.55	0.87	78	68	-10
0018	1T	12_3	2	58	25	5800	6410	610	0.43	1.11	10	11	1
0018	1T	12_4	1	353	200	35300	28440	-6860	0.57	0.81	62	50	-12
0018	1T	12_4	2	78	30	7800	7650	-150	0.38	0.98	13	13	0
0018	1T	12_5	1	364	254	36400	35400	-1000	0.70	0.97	64	62	-2
0018	1T	12_5	2	12	5	1200	930	-270	0.42	0.78	2	1	-1
0018	1T	12_6	1	33	16	3300	2220	-1080	0.48	0.67	5	3	-2
0018	1T	12_6	2	2	2	200	420	220	1.00	2.10	0	0	0
0018	1T	12_7	1	498	307	49800	44090	-5710	0.62	0.89	88	78	-10
0018	1T	12_7	2	34	9	3400	1960	-1440	0.26	0.58	6	3	-3
0018	1T	13_1	1	465	263	46500	41770	-4730	0.57	0.90	82	73	-9
0018	1T	13_1	2	47	14	4700	3070	-1630	0.30	0.65	8	5	-3
0018	1T	13_2	1	398	218	39800	33990	-5810	0.55	0.85	70	60	-10
0018	1T	13_2	2	72	30	7200	6290	-910	0.42	0.87	12	11	-1
0018	1T	13_3	1	384	216	38400	36350	-2050	0.56	0.95	67	64	-3
0018	1T	13_3	2	98	36	9800	8150	-1650	0.37	0.83	17	14	-3
0018	1T	13_4	1	371	244	37100	36470	-630	0.66	0.98	65	64	-1
0018	1T	13_4	2	77	25	7700	5280	-2420	0.32	0.69	13	9	-4
0018	1T	13_5	1	382	259	38200	35990	-2210	0.68	0.94	67	63	-4
0018	1T	13_5	2	10	3	1000	800	-200	0.30	0.80	1	1	0
0018	1T	13_6	1	48	20	4800	3030	-1770	0.42	0.63	8	5	-3
0018	1T	13_6	2	4	1	400	180	-220	0.25	0.45	0	0	0
0018	1T	13_7	1	455	313	45500	44650	-850	0.69	0.98	80	79	-1
0018	1T	13_7	2	37	12	3700	3950	250	0.32	1.07	6	6	0
0018	1T	14_1	1	413	218	41300	37240	-4060	0.53	0.90	73	65	-8
0018	1T	14_1	2	77	34	7700	8160	460	0.44	1.06	13	14	1
0018	1T	14_2	1	421	222	42100	39810	-2290	0.53	0.95	74	70	-4
0018	1T	14_2	2	102	43	10200	12470	2270	0.42	1.22	18	22	4
0018	1T	14_3	1	443	235	44300	41850	-2450	0.53	0.94	78	74	-4
0018	1T	14_3	2	110	25	11000	7060	-3940	0.23	0.64	19	12	-7
0018	1T	14_4	1	340	199	34000	30450	-3550	0.59	0.90	60	53	-7
0018	1T	14_4	2	75	31	7500	12200	4700	0.41	1.63	13	21	8
0018	1T	14_5	1	227	122	22700	17420	-5280	0.54	0.77	40	30	-10
0018	1T	14_5	2	21	5	2100	1200	-900	0.24	0.57	3	2	-1
0018	1T	14_6	1	23	13	2300	1810	-490	0.57	0.79	4	3	-1
0018	1T	14_7	1	462	243	46200	40130	-6070	0.53	0.87	81	71	-10
0018	1T	14_7	2	50	15	5000	4590	-410	0.30	0.92	8	8	0
0018	1T	15_1	1	497	287	49700	46340	-3360	0.58	0.93	87	82	-5
0018	1T	15_1	2	56	14	5600	2580	-3020	0.25	0.46	9	4	-5
0018	1T	15_2	1	485	266	48500	43840	-4660	0.55	0.90	85	77	-8
0018	1T	15_2	2	62	19	6200	4100	-2100	0.31	0.66	10	7	-3
0018	1T	15_3	1	510	281	51000	45620	-5380	0.55	0.89	90	80	-10
0018	1T	15_3	2	63	22	6300	4900	-1400	0.35	0.78	11	8	-3
0018	1T	15_4	1	404	206	40400	29900	-10500	0.51	0.74	71	52	-19
0018	1T	15_4	2	64	24	6400	6040	-360	0.38	0.94	11	10	-1
0018	1T	15_5	1	369	221	36900	32660	-4240	0.60	0.89	65	57	-8
0018	1T	15_5	2	23	7	2300	2320	20	0.30	1.01	4	4	0
0018	1T	15_6	1	67	31	6700	4630	-2070	0.46	0.69	11	8	-3
0018	1T	15_7	1	564	344	56400	49460	-6940	0.61	0.88	99	87	-12
0018	1T	15_7	2	35	14	3500	5000	1500	0.40	1.43	6	8	2
0018	1T	16_1	1	536	324	53600	53010	-590	0.60	0.99	94	93	-1
0018	1T	16_1	2	59	26	5900	4780	-1120	0.44	0.81	10	8	-2
0018	1T	16_2	1	479	256	47900	42030	-5870	0.53	0.88	84	74	-10
0018	1T	16_2	2	86	29	8600	6870	-1730	0.34	0.80	15	12	-3
0018	1T	16_3	1	469	272	46900	44680	-2220	0.58	0.95	83	79	-4
0018	1T	16_3	2	71	21	7100	5610	-1490	0.30	0.79	12	9	-3
0018	1T	16_4	1	426	261	42600	37570	-5030	0.61	0.88	75	66	-9
0018	1T	16_4	2	72	29	7200	6950	-250	0.40	0.97	12	12	0
0018	1T	16_5	1	452	272	45200	39020	-6180	0.60	0.86	80	69	-11
0018	1T	16_5	2	17	2	1700	510	-1190	0.12	0.30	3	0	-3
0018	1T	16_7	1	564	388	56400	55300	-1100	0.69	0.98	99	97	-2
0018	1T	16_7	2	18	6	1800	1580	-220	0.33	0.88	3	2	-1
0018	1T	17_1	1	489	270	48900	43750	-5150	0.55	0.89	86	77	-9
0018	1T	17_1	2	73	35	7300	9040	1740	0.48	1.24	12	16	4
0018	1T	17_2	1	492	280	49200	48380	-820	0.57	0.98	87	85	-2
0018	1T	17_2	2	70	28	7000	5880	-1120	0.40	0.84	12	10	-2
0018	1T	17_3	1	495	290	49500	52040	2540	0.59	1.05	87	92	5
0018	1T	17_3	2	79	36	7900	8780	880	0.46	1.11	13	15	2
0018	1T	17_4	1	394	261	39400	41570	2170	0.66	1.06	69	73	4
0018	1T	17_4	2	64	28	6400	6400	0	0.44	1.00	11	11	0
0018	1T	17_5	1	387	242	38700	34200	-4500	0.63	0.88	68	60	-8
0018	1T	17_5	2	29	10	2900	2930	30	0.34	1.01	5	5	0
0018	1T	17_7	1	553	377	55300	52850	-2450	0.68	0.96	97	93	-4
0018	1T	17_7	2	30	8	3000	1600	-1400	0.27	0.53	5	2	-3
0018	1T	18_1	1	431	280	43100	41860	-1240	0.65	0.97	76	74	-2
0018	1T	18_1	2	128	58	12800	10650	-2150	0.45	0.83	22	18	-4
0018	1T	18_2	1	452	294	45200	42970	-2230	0.65	0.95	80	76	-4
0018	1T	18_2	2	97	44	9700	9420	-280	0.45	0.97	17	16	-1
0018	1T	18_3	1	428	287	42800	40030	-2770	0.67	0.94	75	70	-5
0018	1T	18_3	2	111	40	11100	9440	-1660	0.36	0.85	19	16	-3
0018	1T	18_4	1	431	299	43100	41700	-1400	0.69	0.97	76	73	-3
0018	1T	18_4	2	104	37	10400	9620	-780	0.36	0.93	18	17	-1
0018	1T	18_5	1	492	387	49200	48400	-800	0.79	0.98	87	85	-2
0018	1T	18_5	2	12	3	1200	430	-770	0.25	0.36	2	0	-2
0018	1T	18_6	1	59	43	5900	5330	-570	0.73	0.90	10	9	-1
0018	1T	18_7	1	567	432	56700	53970	-2730	0.76	0.95	100	95	-5
0018	1T	18_7	2	24	5	2400	1850	-550	0.21	0.77	4	3	-1
0018	1T	19_1	1	476	282	47600	43260	-4340	0.59	0.91	84	76	-8
0018	1T	19_1	2	34	16	3400	3880	480	0.47	1.14	6	6	0
0018	1T	19_2	1	437	257	43700	39800	-3900	0.59	0.91	77	70	-7
0018	1T	19_2	2	50	19	5000	4350	-650	0.38	0.87	8	7	-1
0018	1T	19_3	1	447	268	44700	40670	-4030	0.60	0.91	79	71	-8
0018	1T	19_3	2	62	25	6200	5820	-380	0.40	0.94	10	10	0
0018	1T	19_4	1	398	252	39800	36440	-3360	0.63	0.92	70	64	-6
0018	1T	19_4	2	45	17	4500	3820	-680	0.38	0.85	7	6	-1
0018	1T	19_5	1	289	190	28900	28120	-780	0.66	0.97	51	49	-2
0018	1T	19_5	2	21	7	2100	2700	600	0.33	1.29	3	4	1
0018	1T	19_6	1	36	25	3600	3360	-240	0.69	0.93	6	5	-1
0018	1T	19_6	2	6	2	600	570	-30	0.33	0.95	1	1	0
0018	1T	19_7	1	482	315	48200	45530	-2670	0.65	0.94	85	80	-5
0018	1T	19_7	2	42	18	4200	4450	250	0.43	1.06	7	7	0
0018	1T	20_1	1	516	314	51600	50000	-1600	0.61	0.97	91	88	-3
0018	1T	20_1	2	29	15	2900	3640	740	0.52	1.26	5	6	1
0018	1T	20_2	1	500	273	50000	44560	-5440	0.55	0.89	88	78	-10
0018	1T	20_2	2	22	12	2200	2870	670	0.55	1.30	3	5	2
0018	1T	20_3	1	491	291	49100	46480	-2620	0.59	0.95	86	82	-4
0018	1T	20_3	2	29	10	2900	1980	-920	0.34	0.68	5	3	-2
0018	1T	20_4	1	417	242	41700	38900	-2800	0.58	0.93	73	68	-5
0018	1T	20_4	2	28	11	2800	2380	-420	0.39	0.85	4	4	0
0018	1T	20_5	1	346	212	34600	34260	-340	0.61	0.99	61	60	-1
0018	1T	20_5	2	25	9	2500	2060	-440	0.36	0.82	4	3	-1
0018	1T	20_6	1	69	39	6900	5660	-1240	0.57	0.82	12	10	-2
0018	1T	20_6	2	7	5	700	1360	660	0.71	1.94	1	2	1
0018	1T	20_7	1	520	299	52000	43790	-8210	0.58	0.84	92	77	-15
0018	1T	20_7	2	28	7	2800	4590	1790	0.25	1.64	4	8	4
0018	1T	21_1	1	518	322	51800	45690	-6110	0.62	0.88	91	80	-11
0018	1T	21_1	2	36	18	3600	3760	160	0.50	1.04	6	6	0
0018	1T	21_2	1	521	303	52100	43720	-8380	0.58	0.84	92	77	-15
0018	1T	21_2	2	45	16	4500	3830	-670	0.36	0.85	7	6	-1
0018	1T	21_3	1	507	325	50700	47000	-3700	0.64	0.93	89	83	-6
0018	1T	21_3	2	51	17	5100	2850	-2250	0.33	0.56	9	5	-4
0018	1T	21_4	1	448	296	44800	42950	-1850	0.66	0.96	79	76	-3
0018	1T	21_4	2	38	10	3800	3300	-500	0.26	0.87	6	5	-1
0018	1T	21_5	1	406	289	40600	37660	-2940	0.71	0.93	71	66	-5
0018	1T	21_5	2	17	8	1700	2570	870	0.47	1.51	3	4	1
0018	1T	21_6	1	32	20	3200	3890	690	0.63	1.22	5	6	1
0018	1T	21_6	2	3	1	300	250	-50	0.33	0.83	0	0	0
0018	1T	21_7	1	542	356	54200	48860	-5340	0.66	0.90	95	86	-9
0018	1T	21_7	2	21	10	2100	2390	290	0.48	1.14	3	4	1
0018	1T	22_1	1	422	238	42200	38180	-4020	0.56	0.90	74	67	-7
0018	1T	22_1	2	70	23	7000	5300	-1700	0.33	0.76	12	9	-3
0018	1T	22_2	1	410	206	41000	32990	-8010	0.50	0.80	72	58	-14
0018	1T	22_2	2	66	29	6600	6690	90	0.44	1.01	11	11	0
0018	1T	22_3	1	378	221	37800	40010	2210	0.58	1.06	66	70	4
0018	1T	22_3	2	72	20	7200	5020	-2180	0.28	0.70	12	8	-4
0018	1T	22_4	1	380	232	38000	38600	600	0.61	1.02	67	68	1
0018	1T	22_4	2	74	27	7400	5470	-1930	0.36	0.74	13	9	-4
0018	1T	22_5	1	339	214	33900	33150	-750	0.63	0.98	60	58	-2
0018	1T	22_5	2	38	16	3800	4000	200	0.42	1.05	6	7	1
0018	1T	22_7	1	458	265	45800	38900	-6900	0.58	0.85	81	68	-13
0018	1T	22_7	2	46	20	4600	4960	360	0.43	1.08	8	8	0
0018	1T	23_1	1	452	240	45200	50500	5300	0.53	1.12	80	89	9
0018	1T	23_1	2	36	12	3600	2680	-920	0.33	0.74	6	4	-2
0018	1T	23_2	1	457	223	45700	36150	-9550	0.49	0.79	80	63	-17
0018	1T	23_2	2	55	22	5500	4210	-1290	0.40	0.77	9	7	-2
0018	1T	23_3	1	455	251	45500	40470	-5030	0.55	0.89	80	71	-9
0018	1T	23_3	2	63	28	6300	5970	-330	0.44	0.95	11	10	-1
0018	1T	23_4	1	424	282	42400	40660	-1740	0.67	0.96	75	71	-4
0018	1T	23_4	2	39	12	3900	3230	-670	0.31	0.83	6	5	-1
0018	1T	23_5	1	340	222	34000	31270	-2730	0.65	0.92	60	55	-5
0018	1T	23_5	2	22	4	2200	750	-1450	0.18	0.34	3	1	-2
0018	1T	23_6	1	33	21	3300	3050	-250	0.64	0.92	5	5	0
0018	1T	23_6	2	2	1	200	240	40	0.50	1.20	0	0	0
0018	1T	23_7	1	548	330	54800	49250	-5550	0.60	0.90	96	87	-9
0018	1T	23_7	2	20	10	2000	1980	-20	0.50	0.99	3	3	0
0018	1T	24_1	1	537	364	53700	53670	-30	0.68	1.00	95	94	-1
0018	1T	24_1	2	51	36	5100	7360	2260	0.71	1.44	9	13	4
0018	1T	24_2	1	516	351	51600	48290	-3310	0.68	0.94	91	85	-6
0018	1T	24_2	2	61	25	6100	6130	30	0.41	1.00	10	10	0
0018	1T	24_3	1	566	394	56600	54480	-2120	0.70	0.96	100	96	-4
0018	1T	24_3	2	35	16	3500	6760	3260	0.46	1.93	6	11	5
0018	1T	24_4	1	404	290	40400	39590	-810	0.72	0.98	71	70	-1
0018	1T	24_4	2	18	6	1800	1110	-690	0.33	0.62	3	1	-2
0018	1T	24_5	1	220	169	22000	22920	920	0.77	1.04	38	40	2
0018	1T	24_5	2	12	3	1200	890	-310	0.25	0.74	2	1	-1
0018	1T	24_6	1	54	47	5400	6000	600	0.87	1.11	9	10	1
0018	1T	24_6	2	1	0	100	0	-100	0.00	0.00	0	0	0
0018	1T	24_7	1	593	447	59300	57300	-2000	0.75	0.97	104	101	-3
0018	1T	24_7	2	18	6	1800	2600	800	0.33	1.44	3	4	1
0018	2F	01_1	12	292	92	29200	24360	-4840	0.32	0.83	51	43	-8
0018	2F	01_1	13	100	28	10000	8690	-1310	0.28	0.87	17	15	-2
0018	2F	01_1	14	41	11	4100	3730	-370	0.27	0.91	7	6	-1
0018	2F	01_1	15	46	12	4600	2410	-2190	0.26	0.52	8	4	-4
0018	2F	01_1	16	4	1	400	230	-170	0.25	0.58	0	0	0
0018	2F	01_1	23	2	1	200	1340	1140	0.50	6.70	0	2	2
0018	2F	01_1	24	4	2	400	630	230	0.50	1.58	0	1	1
0018	2F	01_1	25	1	0	100	0	-100	0.00	0.00	0	0	0
0018	2F	01_1	26	1	1	100	940	840	1.00	9.40	0	1	1
0018	2F	01_2	12	248	50	24800	11940	-12860	0.20	0.48	43	21	-22
0018	2F	01_2	13	91	21	9100	4370	-4730	0.23	0.48	16	7	-9
0018	2F	01_2	14	54	12	5400	3110	-2290	0.22	0.58	9	5	-4
0018	2F	01_2	15	46	16	4600	3440	-1160	0.35	0.75	8	6	-2
0018	2F	01_2	16	8	0	800	0	-800	0.00	0.00	1	0	-1
0018	2F	01_2	23	5	0	500	0	-500	0.00	0.00	0	0	0
0018	2F	01_2	24	4	1	400	490	90	0.25	1.23	0	0	0
0018	2F	01_2	25	1	0	100	0	-100	0.00	0.00	0	0	0
0018	2F	01_2	26	4	1	400	330	-70	0.25	0.83	0	0	0
0018	2F	01_3	12	249	77	24900	22850	-2050	0.31	0.92	44	40	-4
0018	2F	01_3	13	84	30	8400	9130	730	0.36	1.09	14	16	2
0018	2F	01_3	14	62	18	6200	5190	-1010	0.29	0.84	10	9	-1
0018	2F	01_3	15	35	13	3500	2390	-1110	0.37	0.68	6	4	-2
0018	2F	01_3	16	5	2	500	450	-50	0.40	0.90	0	0	0
0018	2F	01_3	23	1	1	100	170	70	1.00	1.70	0	0	0
0018	2F	01_3	24	4	1	400	430	30	0.25	1.08	0	0	0
0018	2F	01_3	26	8	2	800	880	80	0.25	1.10	1	1	0
0018	2F	01_4	12	270	96	27000	25030	-1970	0.36	0.93	47	44	-3
0018	2F	01_4	13	73	26	7300	7670	370	0.36	1.05	12	13	1
0018	2F	01_4	14	35	9	3500	1930	-1570	0.26	0.55	6	3	-3
0018	2F	01_4	15	28	10	2800	2030	-770	0.36	0.73	4	3	-1
0018	2F	01_4	16	7	0	700	0	-700	0.00	0.00	1	0	-1
0018	2F	01_4	23	4	0	400	0	-400	0.00	0.00	0	0	0
0018	2F	01_4	24	4	1	400	370	-30	0.25	0.93	0	0	0
0018	2F	01_4	25	6	1	600	620	20	0.17	1.03	1	1	0
0018	2F	01_4	26	3	0	300	0	-300	0.00	0.00	0	0	0
0018	2F	01_5	12	183	61	18300	17190	-1110	0.33	0.94	32	30	-2
0018	2F	01_5	13	70	19	7000	5800	-1200	0.27	0.83	12	10	-2
0018	2F	01_5	14	29	8	2900	2570	-330	0.28	0.89	5	4	-1
0018	2F	01_5	15	17	5	1700	1840	140	0.29	1.08	3	3	0
0018	2F	01_5	16	4	0	400	0	-400	0.00	0.00	0	0	0
0018	2F	01_5	23	1	0	100	0	-100	0.00	0.00	0	0	0
0018	2F	01_5	24	2	0	200	0	-200	0.00	0.00	0	0	0
0018	2F	01_5	25	1	0	100	0	-100	0.00	0.00	0	0	0
0018	2F	01_6	12	17	4	1700	780	-920	0.24	0.46	3	1	-2
0018	2F	01_6	13	2	0	200	0	-200	0.00	0.00	0	0	0
0018	2F	01_6	14	6	0	600	0	-600	0.00	0.00	1	0	-1
0018	2F	01_6	15	2	0	200	0	-200	0.00	0.00	0	0	0
0018	2F	01_6	16	1	0	100	0	-100	0.00	0.00	0	0	0
0018	2F	01_7	12	291	92	29100	23120	-5980	0.32	0.79	51	40	-11
0018	2F	01_7	13	114	30	11400	10190	-1210	0.26	0.89	20	18	-2
0018	2F	01_7	14	64	15	6400	4270	-2130	0.23	0.67	11	7	-4
0018	2F	01_7	15	25	8	2500	2110	-390	0.32	0.84	4	3	-1
0018	2F	01_7	16	12	0	1200	0	-1200	0.00	0.00	2	0	-2
0018	2F	01_7	23	4	0	400	0	-400	0.00	0.00	0	0	0
0018	2F	01_7	24	1	0	100	0	-100	0.00	0.00	0	0	0
0018	2F	01_7	25	1	0	100	0	-100	0.00	0.00	0	0	0
0018	2F	01_7	26	2	1	200	620	420	0.50	3.10	0	1	1
0018	2F	02_1	12	283	73	28300	27650	-650	0.26	0.98	50	48	-2
0018	2F	02_1	13	112	25	11200	7910	-3290	0.22	0.71	19	14	-5
0018	2F	02_1	14	64	17	6400	5850	-550	0.27	0.91	11	10	-1
0018	2F	02_1	15	9	2	900	610	-290	0.22	0.68	1	1	0
0018	2F	02_1	16	10	1	1000	310	-690	0.10	0.31	1	0	-1
0018	2F	02_1	23	3	1	300	230	-70	0.33	0.77	0	0	0
0018	2F	02_1	24	9	1	900	420	-480	0.11	0.47	1	0	-1
0018	2F	02_1	25	1	0	100	0	-100	0.00	0.00	0	0	0
0018	2F	02_1	26	8	0	800	0	-800	0.00	0.00	1	0	-1
0018	2F	02_2	12	290	71	29000	21930	-7070	0.24	0.76	51	38	-13
0018	2F	02_2	13	87	22	8700	7630	-1070	0.25	0.88	15	13	-2
0018	2F	02_2	14	64	17	6400	5620	-780	0.27	0.88	11	9	-2
0018	2F	02_2	15	13	2	1300	1140	-160	0.15	0.88	2	2	0
0018	2F	02_2	16	10	1	1000	320	-680	0.10	0.32	1	0	-1
0018	2F	02_2	23	8	1	800	160	-640	0.13	0.20	1	0	-1
0018	2F	02_2	24	2	1	200	230	30	0.50	1.15	0	0	0
0018	2F	02_2	25	2	1	200	380	180	0.50	1.90	0	0	0
0018	2F	02_2	26	4	1	400	370	-30	0.25	0.93	0	0	0
0018	2F	02_3	12	306	82	30600	27400	-3200	0.27	0.90	54	48	-6
0018	2F	02_3	13	98	28	9800	8680	-1120	0.29	0.89	17	15	-2
0018	2F	02_3	14	73	13	7300	5260	-2040	0.18	0.72	12	9	-3
0018	2F	02_3	15	7	1	700	360	-340	0.14	0.51	1	0	-1
0018	2F	02_3	16	20	6	2000	3720	1720	0.30	1.86	3	6	3
0018	2F	02_3	23	6	3	600	1040	440	0.50	1.73	1	1	0
0018	2F	02_3	24	8	0	800	0	-800	0.00	0.00	1	0	-1
0018	2F	02_3	26	10	1	1000	460	-540	0.10	0.46	1	0	-1
0018	2F	02_4	12	189	49	18900	14100	-4800	0.26	0.75	33	24	-9
0018	2F	02_4	13	52	12	5200	2700	-2500	0.23	0.52	9	4	-5
0018	2F	02_4	14	50	14	5000	5000	0	0.28	1.00	8	8	0
0018	2F	02_4	15	8	1	800	1630	830	0.13	2.04	1	2	1
0018	2F	02_4	16	2	0	200	0	-200	0.00	0.00	0	0	0
0018	2F	02_4	23	6	2	600	820	220	0.33	1.37	1	1	0
0018	2F	02_4	24	5	4	500	1750	1250	0.80	3.50	0	3	3
0018	2F	02_4	25	3	0	300	0	-300	0.00	0.00	0	0	0
0018	2F	02_4	26	2	1	200	390	190	0.50	1.95	0	0	0
0018	2F	02_5	12	136	44	13600	10980	-2620	0.32	0.81	24	19	-5
0018	2F	02_5	13	26	4	2600	1000	-1600	0.15	0.38	4	1	-3
0018	2F	02_5	14	25	6	2500	2200	-300	0.24	0.88	4	3	-1
0018	2F	02_5	15	7	1	700	510	-190	0.14	0.73	1	0	-1
0018	2F	02_5	16	7	1	700	280	-420	0.14	0.40	1	0	-1
0018	2F	02_6	12	8	3	800	960	160	0.38	1.20	1	1	0
0018	2F	02_6	13	3	0	300	0	-300	0.00	0.00	0	0	0
0018	2F	02_6	14	1	1	100	220	120	1.00	2.20	0	0	0
0018	2F	02_7	12	309	90	30900	27070	-3830	0.29	0.88	54	47	-7
0018	2F	02_7	13	103	26	10300	8160	-2140	0.25	0.79	18	14	-4
0018	2F	02_7	14	67	19	6700	5210	-1490	0.28	0.78	11	9	-2
0018	2F	02_7	15	10	3	1000	1100	100	0.30	1.10	1	1	0
0018	2F	02_7	16	7	1	700	400	-300	0.14	0.57	1	0	-1
0018	2F	02_7	23	6	0	600	0	-600	0.00	0.00	1	0	-1
0018	2F	02_7	24	6	0	600	0	-600	0.00	0.00	1	0	-1
0018	2F	02_7	25	4	0	400	0	-400	0.00	0.00	0	0	0
0018	2F	02_7	26	6	0	600	0	-600	0.00	0.00	1	0	-1
0018	2F	03_1	12	176	53	17600	14980	-2620	0.30	0.85	31	26	-5
0018	2F	03_1	13	102	33	10200	10560	360	0.32	1.04	18	18	0
0018	2F	03_1	14	50	10	5000	3240	-1760	0.20	0.65	8	5	-3
0018	2F	03_1	15	17	2	1700	1000	-700	0.12	0.59	3	1	-2
0018	2F	03_1	16	10	1	1000	690	-310	0.10	0.69	1	1	0
0018	2F	03_1	23	7	0	700	0	-700	0.00	0.00	1	0	-1
0018	2F	03_1	24	3	0	300	0	-300	0.00	0.00	0	0	0
0018	2F	03_1	25	2	2	200	640	440	1.00	3.20	0	1	1
0018	2F	03_1	26	2	0	200	0	-200	0.00	0.00	0	0	0
0018	2F	03_2	12	163	51	16300	12610	-3690	0.31	0.77	28	22	-6
0018	2F	03_2	13	69	21	6900	6600	-300	0.30	0.96	12	11	-1
0018	2F	03_2	14	47	13	4700	3410	-1290	0.28	0.73	8	6	-2
0018	2F	03_2	15	19	4	1900	1400	-500	0.21	0.74	3	2	-1
0018	2F	03_2	16	13	3	1300	5720	4420	0.23	4.40	2	10	8
0018	2F	03_2	23	6	3	600	830	230	0.50	1.38	1	1	0
0018	2F	03_2	24	2	1	200	490	290	0.50	2.45	0	0	0
0018	2F	03_2	25	4	0	400	0	-400	0.00	0.00	0	0	0
0018	2F	03_2	26	6	0	600	0	-600	0.00	0.00	1	0	-1
0018	2F	03_3	12	196	78	19600	19320	-280	0.40	0.99	34	34	0
0018	2F	03_3	13	100	30	10000	9290	-710	0.30	0.93	17	16	-1
0018	2F	03_3	14	56	14	5600	3370	-2230	0.25	0.60	9	5	-4
0018	2F	03_3	15	24	4	2400	1520	-880	0.17	0.63	4	2	-2
0018	2F	03_3	16	19	5	1900	2770	870	0.26	1.46	3	4	1
0018	2F	03_3	23	10	2	1000	810	-190	0.20	0.81	1	1	0
0018	2F	03_3	24	3	0	300	0	-300	0.00	0.00	0	0	0
0018	2F	03_3	26	1	0	100	0	-100	0.00	0.00	0	0	0
0018	2F	03_4	12	119	42	11900	10640	-1260	0.35	0.89	21	18	-3
0018	2F	03_4	13	64	19	6400	5330	-1070	0.30	0.83	11	9	-2
0018	2F	03_4	14	33	10	3300	3460	160	0.30	1.05	5	6	1
0018	2F	03_4	15	16	2	1600	670	-930	0.13	0.42	2	1	-1
0018	2F	03_4	16	6	0	600	0	-600	0.00	0.00	1	0	-1
0018	2F	03_4	23	3	0	300	0	-300	0.00	0.00	0	0	0
0018	2F	03_4	24	1	0	100	0	-100	0.00	0.00	0	0	0
0018	2F	03_4	26	1	0	100	0	-100	0.00	0.00	0	0	0
0018	2F	03_5	12	84	37	8400	8530	130	0.44	1.02	14	15	1
0018	2F	03_5	13	29	4	2900	1110	-1790	0.14	0.38	5	1	-4
0018	2F	03_5	14	12	1	1200	320	-880	0.08	0.27	2	0	-2
0018	2F	03_5	15	12	3	1200	1760	560	0.25	1.47	2	3	1
0018	2F	03_5	16	7	1	700	300	-400	0.14	0.43	1	0	-1
0018	2F	03_5	24	1	0	100	0	-100	0.00	0.00	0	0	0
0018	2F	03_5	26	1	0	100	0	-100	0.00	0.00	0	0	0
0018	2F	03_7	12	185	53	18500	14180	-4320	0.29	0.77	32	25	-7
0018	2F	03_7	13	101	28	10100	8420	-1680	0.28	0.83	17	14	-3
0018	2F	03_7	14	35	4	3500	1300	-2200	0.11	0.37	6	2	-4
0018	2F	03_7	15	23	4	2300	2760	460	0.17	1.20	4	4	0
0018	2F	03_7	16	15	1	1500	220	-1280	0.07	0.15	2	0	-2
0018	2F	03_7	23	4	0	400	0	-400	0.00	0.00	0	0	0
0018	2F	03_7	24	1	0	100	0	-100	0.00	0.00	0	0	0
0018	2F	03_7	25	3	1	300	290	-10	0.33	0.97	0	0	0
0018	2F	03_7	26	2	1	200	530	330	0.50	2.65	0	0	0
0018	2F	04_1	12	193	61	19300	24110	4810	0.32	1.25	34	42	8
0018	2F	04_1	13	99	28	9900	7880	-2020	0.28	0.80	17	13	-4
0018	2F	04_1	14	84	19	8400	6380	-2020	0.23	0.76	14	11	-3
0018	2F	04_1	15	17	4	1700	1650	-50	0.24	0.97	3	2	-1
0018	2F	04_1	16	16	5	1600	2990	1390	0.31	1.87	2	5	3
0018	2F	04_1	24	7	1	700	320	-380	0.14	0.46	1	0	-1
0018	2F	04_1	25	1	0	100	0	-100	0.00	0.00	0	0	0
0018	2F	04_1	26	7	1	700	320	-380	0.14	0.46	1	0	-1
0018	2F	04_2	12	188	62	18800	19380	580	0.33	1.03	33	34	1
0018	2F	04_2	13	110	29	11000	7820	-3180	0.26	0.71	19	13	-6
0018	2F	04_2	14	66	11	6600	4060	-2540	0.17	0.62	11	7	-4
0018	2F	04_2	15	26	6	2600	3230	630	0.23	1.24	4	5	1
0018	2F	04_2	16	15	2	1500	770	-730	0.13	0.51	2	1	-1
0018	2F	04_2	23	4	2	400	360	-40	0.50	0.90	0	0	0
0018	2F	04_2	24	3	0	300	0	-300	0.00	0.00	0	0	0
0018	2F	04_2	25	2	0	200	0	-200	0.00	0.00	0	0	0
0018	2F	04_2	26	3	0	300	0	-300	0.00	0.00	0	0	0
0018	2F	04_3	12	230	73	23000	19550	-3450	0.32	0.85	40	34	-6
0018	2F	04_3	13	113	32	11300	10150	-1150	0.28	0.90	20	17	-3
0018	2F	04_3	14	37	7	3700	1670	-2030	0.19	0.45	6	2	-4
0018	2F	04_3	15	17	2	1700	520	-1180	0.12	0.31	3	0	-3
0018	2F	04_3	16	13	7	1300	2190	890	0.54	1.68	2	3	1
0018	2F	04_3	23	7	3	700	2270	1570	0.43	3.24	1	4	3
0018	2F	04_3	24	3	0	300	0	-300	0.00	0.00	0	0	0
0018	2F	04_3	25	4	1	400	590	190	0.25	1.48	0	1	1
0018	2F	04_3	26	2	0	200	0	-200	0.00	0.00	0	0	0
0018	2F	04_4	12	155	44	15500	14140	-1360	0.28	0.91	27	25	-2
0018	2F	04_4	13	90	35	9000	9560	560	0.39	1.06	15	16	1
0018	2F	04_4	14	41	15	4100	4370	270	0.37	1.07	7	7	0
0018	2F	04_4	15	12	4	1200	1220	20	0.33	1.02	2	2	0
0018	2F	04_4	16	8	2	800	660	-140	0.25	0.83	1	1	0
0018	2F	04_4	23	2	0	200	0	-200	0.00	0.00	0	0	0
0018	2F	04_4	24	2	0	200	0	-200	0.00	0.00	0	0	0
0018	2F	04_4	25	3	0	300	0	-300	0.00	0.00	0	0	0
0018	2F	04_5	12	143	39	14300	10160	-4140	0.27	0.71	25	17	-8
0018	2F	04_5	13	72	17	7200	5090	-2110	0.24	0.71	12	9	-3
0018	2F	04_5	14	27	6	2700	2160	-540	0.22	0.80	4	3	-1
0018	2F	04_5	15	17	5	1700	3060	1360	0.29	1.80	3	5	2
0018	2F	04_5	16	26	4	2600	2390	-210	0.15	0.92	4	4	0
0018	2F	04_5	23	2	1	200	570	370	0.50	2.85	0	1	1
0018	2F	04_5	24	3	0	300	0	-300	0.00	0.00	0	0	0
0018	2F	04_5	25	3	1	300	480	180	0.33	1.60	0	0	0
0018	2F	04_5	26	4	0	400	0	-400	0.00	0.00	0	0	0
0018	2F	04_7	12	194	62	19400	21050	1650	0.32	1.09	34	37	3
0018	2F	04_7	13	95	22	9500	6430	-3070	0.23	0.68	16	11	-5
0018	2F	04_7	14	43	9	4300	3790	-510	0.21	0.88	7	6	-1
0018	2F	04_7	15	28	4	2800	1690	-1110	0.14	0.60	4	2	-2
0018	2F	04_7	16	14	2	1400	590	-810	0.14	0.42	2	1	-1
0018	2F	04_7	23	5	1	500	320	-180	0.20	0.64	0	0	0
0018	2F	04_7	24	3	0	300	0	-300	0.00	0.00	0	0	0
0018	2F	04_7	25	3	0	300	0	-300	0.00	0.00	0	0	0
0018	2F	04_7	26	6	1	600	2260	1660	0.17	3.77	1	4	3
0018	2F	05_1	12	274	92	27400	27220	-180	0.34	0.99	48	48	0
0018	2F	05_1	13	119	32	11900	8610	-3290	0.27	0.72	21	15	-6
0018	2F	05_1	14	70	25	7000	6260	-740	0.36	0.89	12	11	-1
0018	2F	05_1	15	16	5	1600	2120	520	0.31	1.33	2	3	1
0018	2F	05_1	16	6	0	600	0	-600	0.00	0.00	1	0	-1
0018	2F	05_1	23	1	0	100	0	-100	0.00	0.00	0	0	0
0018	2F	05_1	24	1	1	100	350	250	1.00	3.50	0	0	0
0018	2F	05_1	25	3	0	300	0	-300	0.00	0.00	0	0	0
0018	2F	05_1	26	3	0	300	0	-300	0.00	0.00	0	0	0
0018	2F	05_2	12	240	73	24000	20170	-3830	0.30	0.84	42	35	-7
0018	2F	05_2	13	105	34	10500	9280	-1220	0.32	0.88	18	16	-2
0018	2F	05_2	14	73	26	7300	5690	-1610	0.36	0.78	12	10	-2
0018	2F	05_2	15	22	6	2200	3130	930	0.27	1.42	3	5	2
0018	2F	05_2	16	10	0	1000	0	-1000	0.00	0.00	1	0	-1
0018	2F	05_2	23	2	0	200	0	-200	0.00	0.00	0	0	0
0018	2F	05_2	24	11	4	1100	1070	-30	0.36	0.97	1	1	0
0018	2F	05_2	25	3	0	300	0	-300	0.00	0.00	0	0	0
0018	2F	05_2	26	8	1	800	380	-420	0.13	0.48	1	0	-1
0018	2F	05_3	12	233	70	23300	20560	-2740	0.30	0.88	41	36	-5
0018	2F	05_3	13	89	28	8900	7190	-1710	0.31	0.81	15	12	-3
0018	2F	05_3	14	74	13	7400	3290	-4110	0.18	0.44	13	5	-8
0018	2F	05_3	15	18	2	1800	1060	-740	0.11	0.59	3	1	-2
0018	2F	05_3	16	18	2	1800	1590	-210	0.11	0.88	3	2	-1
0018	2F	05_3	23	7	1	700	180	-520	0.14	0.26	1	0	-1
0018	2F	05_3	24	5	2	500	480	-20	0.40	0.96	0	0	0
0018	2F	05_3	25	2	0	200	0	-200	0.00	0.00	0	0	0
0018	2F	05_3	26	7	1	700	350	-350	0.14	0.50	1	0	-1
0018	2F	05_4	12	205	68	20500	18820	-1680	0.33	0.92	36	33	-3
0018	2F	05_4	13	94	25	9400	6250	-3150	0.27	0.66	16	11	-5
0018	2F	05_4	14	45	22	4500	5850	1350	0.49	1.30	7	10	3
0018	2F	05_4	15	17	2	1700	460	-1240	0.12	0.27	3	0	-3
0018	2F	05_4	16	1	0	100	0	-100	0.00	0.00	0	0	0
0018	2F	05_4	23	7	2	700	480	-220	0.29	0.69	1	0	-1
0018	2F	05_4	24	2	0	200	0	-200	0.00	0.00	0	0	0
0018	2F	05_4	25	4	1	400	290	-110	0.25	0.73	0	0	0
0018	2F	05_4	26	1	0	100	0	-100	0.00	0.00	0	0	0
0018	2F	05_5	12	157	40	15700	11150	-4550	0.25	0.71	27	19	-8
0018	2F	05_5	13	61	16	6100	4450	-1650	0.26	0.73	10	7	-3
0018	2F	05_5	14	42	17	4200	4320	120	0.40	1.03	7	7	0
0018	2F	05_5	15	15	6	1500	2450	950	0.40	1.63	2	4	2
0018	2F	05_5	16	4	0	400	0	-400	0.00	0.00	0	0	0
0018	2F	05_5	23	1	0	100	0	-100	0.00	0.00	0	0	0
0018	2F	05_5	24	1	1	100	170	70	1.00	1.70	0	0	0
0018	2F	05_5	26	1	0	100	0	-100	0.00	0.00	0	0	0
0018	2F	05_6	12	4	2	400	330	-70	0.50	0.83	0	0	0
0018	2F	05_6	13	1	0	100	0	-100	0.00	0.00	0	0	0
0018	2F	05_6	14	2	0	200	0	-200	0.00	0.00	0	0	0
0018	2F	05_6	15	1	1	100	230	130	1.00	2.30	0	0	0
0018	2F	05_6	16	2	2	200	1010	810	1.00	5.05	0	1	1
0018	2F	05_7	12	230	65	23000	18090	-4910	0.28	0.79	40	32	-8
0018	2F	05_7	13	107	27	10700	7760	-2940	0.25	0.73	18	13	-5
0018	2F	05_7	14	64	12	6400	3520	-2880	0.19	0.55	11	6	-5
0018	2F	05_7	15	21	2	2100	370	-1730	0.10	0.18	3	0	-3
0018	2F	05_7	16	16	4	1600	2400	800	0.25	1.50	2	4	2
0018	2F	05_7	23	7	1	700	210	-490	0.14	0.30	1	0	-1
0018	2F	05_7	24	5	0	500	0	-500	0.00	0.00	0	0	0
0018	2F	05_7	25	2	1	200	400	200	0.50	2.00	0	0	0
0018	2F	05_7	26	5	0	500	0	-500	0.00	0.00	0	0	0
0018	2F	06_1	12	288	87	28800	25530	-3270	0.30	0.89	50	45	-5
0018	2F	06_1	13	147	45	14700	12070	-2630	0.31	0.82	26	21	-5
0018	2F	06_1	14	61	18	6100	5230	-870	0.30	0.86	10	9	-1
0018	2F	06_1	15	19	5	1900	1210	-690	0.26	0.64	3	2	-1
0018	2F	06_1	16	12	4	1200	1590	390	0.33	1.33	2	2	0
0018	2F	06_1	23	1	0	100	0	-100	0.00	0.00	0	0	0
0018	2F	06_1	24	4	0	400	0	-400	0.00	0.00	0	0	0
0018	2F	06_1	25	1	0	100	0	-100	0.00	0.00	0	0	0
0018	2F	06_1	26	4	0	400	0	-400	0.00	0.00	0	0	0
0018	2F	06_2	12	277	89	27700	25370	-2330	0.32	0.92	49	44	-5
0018	2F	06_2	13	126	37	12600	9030	-3570	0.29	0.72	22	15	-7
0018	2F	06_2	14	74	21	7400	6330	-1070	0.28	0.86	13	11	-2
0018	2F	06_2	15	16	3	1600	1140	-460	0.19	0.71	2	2	0
0018	2F	06_2	16	10	1	1000	490	-510	0.10	0.49	1	0	-1
0018	2F	06_2	23	3	2	300	710	410	0.67	2.37	0	1	1
0018	2F	06_2	24	4	2	400	720	320	0.50	1.80	0	1	1
0018	2F	06_2	25	3	0	300	0	-300	0.00	0.00	0	0	0
0018	2F	06_2	26	7	3	700	1220	520	0.43	1.74	1	2	1
0018	2F	06_3	12	271	81	27100	22950	-4150	0.30	0.85	47	40	-7
0018	2F	06_3	13	123	39	12300	9380	-2920	0.32	0.76	21	16	-5
0018	2F	06_3	14	76	21	7600	6000	-1600	0.28	0.79	13	10	-3
0018	2F	06_3	15	15	4	1500	820	-680	0.27	0.55	2	1	-1
0018	2F	06_3	16	6	1	600	1280	680	0.17	2.13	1	2	1
0018	2F	06_3	23	6	1	600	430	-170	0.17	0.72	1	0	-1
0018	2F	06_3	24	4	2	400	2060	1660	0.50	5.15	0	3	3
0018	2F	06_3	25	6	1	600	3420	2820	0.17	5.70	1	6	5
0018	2F	06_3	26	4	0	400	0	-400	0.00	0.00	0	0	0
0018	2F	06_4	12	181	57	18100	14870	-3230	0.31	0.82	32	26	-6
0018	2F	06_4	13	86	20	8600	6470	-2130	0.23	0.75	15	11	-4
0018	2F	06_4	14	37	6	3700	1630	-2070	0.16	0.44	6	2	-4
0018	2F	06_4	15	11	0	1100	0	-1100	0.00	0.00	1	0	-1
0018	2F	06_4	16	5	0	500	0	-500	0.00	0.00	0	0	0
0018	2F	06_4	23	4	0	400	0	-400	0.00	0.00	0	0	0
0018	2F	06_4	24	6	0	600	0	-600	0.00	0.00	1	0	-1
0018	2F	06_4	25	6	2	600	1200	600	0.33	2.00	1	2	1
0018	2F	06_4	26	4	0	400	0	-400	0.00	0.00	0	0	0
0018	2F	06_5	12	117	37	11700	12060	360	0.32	1.03	20	21	1
0018	2F	06_5	13	47	13	4700	3250	-1450	0.28	0.69	8	5	-3
0018	2F	06_5	14	29	7	2900	4620	1720	0.24	1.59	5	8	3
0018	2F	06_5	15	9	5	900	1980	1080	0.56	2.20	1	3	2
0018	2F	06_5	16	9	1	900	240	-660	0.11	0.27	1	0	-1
0018	2F	06_5	23	1	0	100	0	-100	0.00	0.00	0	0	0
0018	2F	06_5	24	2	0	200	0	-200	0.00	0.00	0	0	0
0018	2F	06_5	26	3	0	300	0	-300	0.00	0.00	0	0	0
0018	2F	06_6	12	16	5	1600	2280	680	0.31	1.43	2	4	2
0018	2F	06_6	13	5	0	500	0	-500	0.00	0.00	0	0	0
0018	2F	06_6	14	5	3	500	1290	790	0.60	2.58	0	2	2
0018	2F	06_6	16	2	0	200	0	-200	0.00	0.00	0	0	0
0018	2F	06_7	12	304	91	30400	24740	-5660	0.30	0.81	53	43	-10
0018	2F	06_7	13	143	41	14300	10240	-4060	0.29	0.72	25	18	-7
0018	2F	06_7	14	90	24	9000	7160	-1840	0.27	0.80	15	12	-3
0018	2F	06_7	15	15	3	1500	920	-580	0.20	0.61	2	1	-1
0018	2F	06_7	16	11	3	1100	2550	1450	0.27	2.32	1	4	3
0018	2F	06_7	23	3	0	300	0	-300	0.00	0.00	0	0	0
0018	2F	06_7	24	8	1	800	910	110	0.13	1.14	1	1	0
0018	2F	06_7	25	3	0	300	0	-300	0.00	0.00	0	0	0
0018	2F	06_7	26	4	1	400	1360	960	0.25	3.40	0	2	2
0018	2F	07_1	12	239	71	23900	20850	-3050	0.30	0.87	42	36	-6
0018	2F	07_1	13	134	46	13400	10810	-2590	0.34	0.81	23	19	-4
0018	2F	07_1	14	54	16	5400	3930	-1470	0.30	0.73	9	6	-3
0018	2F	07_1	15	26	6	2600	2290	-310	0.23	0.88	4	4	0
0018	2F	07_1	16	15	3	1500	860	-640	0.20	0.57	2	1	-1
0018	2F	07_1	23	9	2	900	840	-60	0.22	0.93	1	1	0
0018	2F	07_1	24	1	0	100	0	-100	0.00	0.00	0	0	0
0018	2F	07_1	25	6	0	600	0	-600	0.00	0.00	1	0	-1
0018	2F	07_1	26	6	0	600	0	-600	0.00	0.00	1	0	-1
0018	2F	07_2	12	216	62	21600	18300	-3300	0.29	0.85	38	32	-6
0018	2F	07_2	13	137	52	13700	12380	-1320	0.38	0.90	24	21	-3
0018	2F	07_2	14	80	27	8000	6900	-1100	0.34	0.86	14	12	-2
0018	2F	07_2	15	28	6	2800	2010	-790	0.21	0.72	4	3	-1
0018	2F	07_2	16	16	6	1600	2150	550	0.38	1.34	2	3	1
0018	2F	07_2	23	3	1	300	230	-70	0.33	0.77	0	0	0
0018	2F	07_2	24	5	0	500	0	-500	0.00	0.00	0	0	0
0018	2F	07_2	25	1	0	100	0	-100	0.00	0.00	0	0	0
0018	2F	07_2	26	9	1	900	710	-190	0.11	0.79	1	1	0
0018	2F	07_3	12	250	83	25000	21780	-3220	0.33	0.87	44	38	-6
0018	2F	07_3	13	127	38	12700	9450	-3250	0.30	0.74	22	16	-6
0018	2F	07_3	14	60	21	6000	6260	260	0.35	1.04	10	11	1
0018	2F	07_3	15	15	2	1500	820	-680	0.13	0.55	2	1	-1
0018	2F	07_3	16	18	7	1800	3340	1540	0.39	1.86	3	5	2
0018	2F	07_3	23	8	1	800	610	-190	0.13	0.76	1	1	0
0018	2F	07_3	24	2	0	200	0	-200	0.00	0.00	0	0	0
0018	2F	07_3	25	6	0	600	0	-600	0.00	0.00	1	0	-1
0018	2F	07_3	26	3	0	300	0	-300	0.00	0.00	0	0	0
0018	2F	07_4	12	216	70	21600	18180	-3420	0.32	0.84	38	32	-6
0018	2F	07_4	13	123	43	12300	13140	840	0.35	1.07	21	23	2
0018	2F	07_4	14	55	18	5500	4390	-1110	0.33	0.80	9	7	-2
0018	2F	07_4	15	18	4	1800	1510	-290	0.22	0.84	3	2	-1
0018	2F	07_4	16	4	2	400	1960	1560	0.50	4.90	0	3	3
0018	2F	07_4	23	7	1	700	290	-410	0.14	0.41	1	0	-1
0018	2F	07_4	24	1	0	100	0	-100	0.00	0.00	0	0	0
0018	2F	07_4	25	4	0	400	0	-400	0.00	0.00	0	0	0
0018	2F	07_4	26	2	1	200	210	10	0.50	1.05	0	0	0
0018	2F	07_5	12	173	51	17300	12400	-4900	0.29	0.72	30	21	-9
0018	2F	07_5	13	85	32	8500	9030	530	0.38	1.06	15	15	0
0018	2F	07_5	14	50	13	5000	3240	-1760	0.26	0.65	8	5	-3
0018	2F	07_5	15	15	4	1500	1460	-40	0.27	0.97	2	2	0
0018	2F	07_5	16	11	4	1100	1400	300	0.36	1.27	1	2	1
0018	2F	07_5	23	1	0	100	0	-100	0.00	0.00	0	0	0
0018	2F	07_6	12	23	5	2300	1290	-1010	0.22	0.56	4	2	-2
0018	2F	07_6	13	16	3	1600	690	-910	0.19	0.43	2	1	-1
0018	2F	07_6	14	8	4	800	1140	340	0.50	1.43	1	2	1
0018	2F	07_6	15	4	0	400	0	-400	0.00	0.00	0	0	0
0018	2F	07_6	16	1	0	100	0	-100	0.00	0.00	0	0	0
0018	2F	07_7	12	282	91	28200	24050	-4150	0.32	0.85	49	42	-7
0018	2F	07_7	13	142	49	14200	12220	-1980	0.35	0.86	25	21	-4
0018	2F	07_7	14	62	17	6200	4630	-1570	0.27	0.75	10	8	-2
0018	2F	07_7	15	14	2	1400	610	-790	0.14	0.44	2	1	-1
0018	2F	07_7	16	8	0	800	0	-800	0.00	0.00	1	0	-1
0018	2F	07_7	23	3	0	300	0	-300	0.00	0.00	0	0	0
0018	2F	07_7	24	1	0	100	0	-100	0.00	0.00	0	0	0
0018	2F	07_7	25	1	0	100	0	-100	0.00	0.00	0	0	0
0018	2F	07_7	26	1	0	100	0	-100	0.00	0.00	0	0	0
0018	2F	08_1	12	291	87	29100	23650	-5450	0.30	0.81	51	41	-10
0018	2F	08_1	13	156	43	15600	11580	-4020	0.28	0.74	27	20	-7
0018	2F	08_1	14	65	15	6500	4540	-1960	0.23	0.70	11	8	-3
0018	2F	08_1	15	22	3	2200	2090	-110	0.14	0.95	3	3	0
0018	2F	08_1	16	54	12	5400	4290	-1110	0.22	0.79	9	7	-2
0018	2F	08_1	23	2	1	200	1210	1010	0.50	6.05	0	2	2
0018	2F	08_1	24	1	1	100	290	190	1.00	2.90	0	0	0
0018	2F	08_1	25	2	0	200	0	-200	0.00	0.00	0	0	0
0018	2F	08_1	26	5	0	500	0	-500	0.00	0.00	0	0	0
0018	2F	08_2	12	314	95	31400	24430	-6970	0.30	0.78	55	43	-12
0018	2F	08_2	13	147	48	14700	11960	-2740	0.33	0.81	26	21	-5
0018	2F	08_2	14	74	28	7400	6560	-840	0.38	0.89	13	11	-2
0018	2F	08_2	15	28	9	2800	2830	30	0.32	1.01	4	5	1
0018	2F	08_2	16	37	11	3700	4060	360	0.30	1.10	6	7	1
0018	2F	08_2	23	4	2	400	480	80	0.50	1.20	0	0	0
0018	2F	08_2	26	1	0	100	0	-100	0.00	0.00	0	0	0
0018	2F	08_3	12	322	111	32200	27520	-4680	0.34	0.85	56	48	-8
0018	2F	08_3	13	135	38	13500	9630	-3870	0.28	0.71	23	17	-6
0018	2F	08_3	14	76	24	7600	5720	-1880	0.32	0.75	13	10	-3
0018	2F	08_3	15	20	4	2000	1690	-310	0.20	0.85	3	2	-1
0018	2F	08_3	16	9	1	900	350	-550	0.11	0.39	1	0	-1
0018	2F	08_3	23	6	1	600	330	-270	0.17	0.55	1	0	-1
0018	2F	08_3	24	8	1	800	430	-370	0.13	0.54	1	0	-1
0018	2F	08_3	25	4	0	400	0	-400	0.00	0.00	0	0	0
0018	2F	08_3	26	1	0	100	0	-100	0.00	0.00	0	0	0
0018	2F	08_4	12	110	38	11000	11020	20	0.35	1.00	19	19	0
0018	2F	08_4	13	43	15	4300	3940	-360	0.35	0.92	7	6	-1
0018	2F	08_4	14	19	5	1900	1380	-520	0.26	0.73	3	2	-1
0018	2F	08_4	15	9	3	900	910	10	0.33	1.01	1	1	0
0018	2F	08_4	16	2	1	200	340	140	0.50	1.70	0	0	0
0018	2F	08_4	23	2	0	200	0	-200	0.00	0.00	0	0	0
0018	2F	08_4	25	2	1	200	730	530	0.50	3.65	0	1	1
0018	2F	08_5	12	66	22	6600	4680	-1920	0.33	0.71	11	8	-3
0018	2F	08_5	13	47	14	4700	2630	-2070	0.30	0.56	8	4	-4
0018	2F	08_5	14	20	2	2000	400	-1600	0.10	0.20	3	0	-3
0018	2F	08_5	15	6	1	600	220	-380	0.17	0.37	1	0	-1
0018	2F	08_5	16	3	1	300	480	180	0.33	1.60	0	0	0
0018	2F	08_6	12	12	4	1200	930	-270	0.33	0.78	2	1	-1
0018	2F	08_6	13	9	2	900	450	-450	0.22	0.50	1	0	-1
0018	2F	08_6	15	1	0	100	0	-100	0.00	0.00	0	0	0
0018	2F	08_7	12	362	121	36200	29710	-6490	0.33	0.82	64	52	-12
0018	2F	08_7	13	150	39	15000	10630	-4370	0.26	0.71	26	18	-8
0018	2F	08_7	14	66	14	6600	4190	-2410	0.21	0.63	11	7	-4
0018	2F	08_7	15	22	6	2200	3110	910	0.27	1.41	3	5	2
0018	2F	08_7	16	13	3	1300	1180	-120	0.23	0.91	2	2	0
0018	2F	08_7	23	4	0	400	0	-400	0.00	0.00	0	0	0
0018	2F	08_7	24	4	1	400	240	-160	0.25	0.60	0	0	0
0018	2F	08_7	25	3	1	300	320	20	0.33	1.07	0	0	0
0018	2F	08_7	26	6	1	600	390	-210	0.17	0.65	1	0	-1
0018	2F	09_1	12	319	113	31900	27190	-4710	0.35	0.85	56	48	-8
0018	2F	09_1	13	97	37	9700	9560	-140	0.38	0.99	17	16	-1
0018	2F	09_1	14	22	0	2200	0	-2200	0.00	0.00	3	0	-3
0018	2F	09_1	15	13	3	1300	1270	-30	0.23	0.98	2	2	0
0018	2F	09_1	16	7	1	700	300	-400	0.14	0.43	1	0	-1
0018	2F	09_1	23	2	1	200	330	130	0.50	1.65	0	0	0
0018	2F	09_1	24	6	0	600	0	-600	0.00	0.00	1	0	-1
0018	2F	09_1	25	3	0	300	0	-300	0.00	0.00	0	0	0
0018	2F	09_1	26	7	1	700	570	-130	0.14	0.81	1	1	0
0018	2F	09_2	12	270	91	27000	25310	-1690	0.34	0.94	47	44	-3
0018	2F	09_2	13	106	29	10600	6500	-4100	0.27	0.61	18	11	-7
0018	2F	09_2	14	51	20	5100	5240	140	0.39	1.03	9	9	0
0018	2F	09_2	15	17	2	1700	490	-1210	0.12	0.29	3	0	-3
0018	2F	09_2	16	12	2	1200	630	-570	0.17	0.53	2	1	-1
0018	2F	09_2	23	6	2	600	750	150	0.33	1.25	1	1	0
0018	2F	09_2	24	3	1	300	300	0	0.33	1.00	0	0	0
0018	2F	09_2	25	1	0	100	0	-100	0.00	0.00	0	0	0
0018	2F	09_2	26	5	1	500	380	-120	0.20	0.76	0	0	0
0018	2F	09_3	12	258	82	25800	22230	-3570	0.32	0.86	45	39	-6
0018	2F	09_3	13	109	31	10900	8170	-2730	0.28	0.75	19	14	-5
0018	2F	09_3	14	49	10	4900	3110	-1790	0.20	0.63	8	5	-3
0018	2F	09_3	15	24	5	2400	1790	-610	0.21	0.75	4	3	-1
0018	2F	09_3	16	10	3	1000	1110	110	0.30	1.11	1	1	0
0018	2F	09_3	23	4	1	400	100	-300	0.25	0.25	0	0	0
0018	2F	09_3	24	3	0	300	0	-300	0.00	0.00	0	0	0
0018	2F	09_3	26	11	0	1100	0	-1100	0.00	0.00	1	0	-1
0018	2F	09_4	12	236	85	23600	22340	-1260	0.36	0.95	41	39	-2
0018	2F	09_4	13	81	26	8100	6880	-1220	0.32	0.85	14	12	-2
0018	2F	09_4	14	39	10	3900	3300	-600	0.26	0.85	6	5	-1
0018	2F	09_4	15	23	4	2300	1310	-990	0.17	0.57	4	2	-2
0018	2F	09_4	16	8	2	800	1100	300	0.25	1.38	1	1	0
0018	2F	09_4	23	5	1	500	240	-260	0.20	0.48	0	0	0
0018	2F	09_4	24	3	0	300	0	-300	0.00	0.00	0	0	0
0018	2F	09_4	25	1	0	100	0	-100	0.00	0.00	0	0	0
0018	2F	09_4	26	8	1	800	750	-50	0.13	0.94	1	1	0
0018	2F	09_5	12	281	118	28100	24110	-3990	0.42	0.86	49	42	-7
0018	2F	09_5	13	97	34	9700	7460	-2240	0.35	0.77	17	13	-4
0018	2F	09_5	14	40	10	4000	2520	-1480	0.25	0.63	7	4	-3
0018	2F	09_5	15	9	1	900	160	-740	0.11	0.18	1	0	-1
0018	2F	09_5	16	10	2	1000	570	-430	0.20	0.57	1	1	0
0018	2F	09_5	23	1	0	100	0	-100	0.00	0.00	0	0	0
0018	2F	09_5	26	1	0	100	0	-100	0.00	0.00	0	0	0
0018	2F	09_7	12	349	144	34900	32810	-2090	0.41	0.94	61	58	-3
0018	2F	09_7	13	115	41	11500	11360	-140	0.36	0.99	20	20	0
0018	2F	09_7	14	68	15	6800	3630	-3170	0.22	0.53	12	6	-6
0018	2F	09_7	15	11	1	1100	320	-780	0.09	0.29	1	0	-1
0018	2F	09_7	16	13	0	1300	0	-1300	0.00	0.00	2	0	-2
0018	2F	09_7	23	2	1	200	720	520	0.50	3.60	0	1	1
0018	2F	09_7	24	1	0	100	0	-100	0.00	0.00	0	0	0
0018	2F	09_7	25	1	0	100	0	-100	0.00	0.00	0	0	0
0018	2F	09_7	26	1	0	100	0	-100	0.00	0.00	0	0	0
0018	2F	10_1	12	253	94	25300	22260	-3040	0.37	0.88	44	39	-5
0018	2F	10_1	13	85	34	8500	7150	-1350	0.40	0.84	15	12	-3
0018	2F	10_1	14	44	8	4400	2660	-1740	0.18	0.60	7	4	-3
0018	2F	10_1	15	4	1	400	500	100	0.25	1.25	0	0	0
0018	2F	10_1	16	7	1	700	290	-410	0.14	0.41	1	0	-1
0018	2F	10_1	23	7	0	700	0	-700	0.00	0.00	1	0	-1
0018	2F	10_1	24	5	1	500	320	-180	0.20	0.64	0	0	0
0018	2F	10_1	26	2	1	200	440	240	0.50	2.20	0	0	0
0018	2F	10_2	12	191	70	19100	15550	-3550	0.37	0.81	33	27	-6
0018	2F	10_2	13	116	29	11600	7230	-4370	0.25	0.62	20	12	-8
0018	2F	10_2	14	64	21	6400	6360	-40	0.33	0.99	11	11	0
0018	2F	10_2	15	5	3	500	770	270	0.60	1.54	0	1	1
0018	2F	10_2	16	4	0	400	0	-400	0.00	0.00	0	0	0
0018	2F	10_2	23	12	5	1200	3390	2190	0.42	2.83	2	6	4
0018	2F	10_2	24	14	2	1400	2630	1230	0.14	1.88	2	4	2
0018	2F	10_2	25	7	0	700	0	-700	0.00	0.00	1	0	-1
0018	2F	10_2	26	5	1	500	400	-100	0.20	0.80	0	0	0
0018	2F	10_3	12	259	84	25900	22790	-3110	0.32	0.88	45	40	-5
0018	2F	10_3	13	92	32	9200	7760	-1440	0.35	0.84	16	13	-3
0018	2F	10_3	14	55	16	5500	5060	-440	0.29	0.92	9	8	-1
0018	2F	10_3	15	5	0	500	0	-500	0.00	0.00	0	0	0
0018	2F	10_3	23	7	1	700	330	-370	0.14	0.47	1	0	-1
0018	2F	10_3	24	4	0	400	0	-400	0.00	0.00	0	0	0
0018	2F	10_3	25	1	0	100	0	-100	0.00	0.00	0	0	0
0018	2F	10_3	26	1	0	100	0	-100	0.00	0.00	0	0	0
0018	2F	10_4	12	224	79	22400	17460	-4940	0.35	0.78	39	30	-9
0018	2F	10_4	13	106	28	10600	7890	-2710	0.26	0.74	18	13	-5
0018	2F	10_4	14	52	12	5200	3780	-1420	0.23	0.73	9	6	-3
0018	2F	10_4	15	2	0	200	0	-200	0.00	0.00	0	0	0
0018	2F	10_4	16	1	1	100	200	100	1.00	2.00	0	0	0
0018	2F	10_4	23	8	2	800	580	-220	0.25	0.73	1	1	0
0018	2F	10_4	24	14	3	1400	2390	990	0.21	1.71	2	4	2
0018	2F	10_4	26	2	1	200	170	-30	0.50	0.85	0	0	0
0018	2F	10_5	12	236	89	23600	19990	-3610	0.38	0.85	41	35	-6
0018	2F	10_5	13	39	14	3900	2360	-1540	0.36	0.61	6	4	-2
0018	2F	10_5	14	60	23	6000	6150	150	0.38	1.03	10	10	0
0018	2F	10_5	16	1	0	100	0	-100	0.00	0.00	0	0	0
0018	2F	10_5	23	1	0	100	0	-100	0.00	0.00	0	0	0
0018	2F	10_5	24	8	1	800	260	-540	0.13	0.33	1	0	-1
0018	2F	10_6	12	6	1	600	200	-400	0.17	0.33	1	0	-1
0018	2F	10_6	13	1	0	100	0	-100	0.00	0.00	0	0	0
0018	2F	10_6	14	4	0	400	0	-400	0.00	0.00	0	0	0
0018	2F	10_7	12	503	156	50300	39910	-10390	0.31	0.79	89	70	-19
0018	2F	10_7	13	47	11	4700	3600	-1100	0.23	0.77	8	6	-2
0018	2F	11_1	12	243	77	24300	22070	-2230	0.32	0.91	43	39	-4
0018	2F	11_1	13	122	41	12200	11250	-950	0.34	0.92	21	19	-2
0018	2F	11_1	14	46	11	4600	3140	-1460	0.24	0.68	8	5	-3
0018	2F	11_1	15	13	1	1300	930	-370	0.08	0.72	2	1	-1
0018	2F	11_1	16	12	1	1200	990	-210	0.08	0.83	2	1	-1
0018	2F	11_1	23	3	1	300	550	250	0.33	1.83	0	0	0
0018	2F	11_1	24	2	1	200	500	300	0.50	2.50	0	0	0
0018	2F	11_1	25	1	0	100	0	-100	0.00	0.00	0	0	0
0018	2F	11_1	26	1	0	100	0	-100	0.00	0.00	0	0	0
0018	2F	11_2	12	209	67	20900	17570	-3330	0.32	0.84	36	31	-5
0018	2F	11_2	13	114	41	11400	9870	-1530	0.36	0.87	20	17	-3
0018	2F	11_2	14	47	11	4700	3430	-1270	0.23	0.73	8	6	-2
0018	2F	11_2	15	18	4	1800	1160	-640	0.22	0.64	3	2	-1
0018	2F	11_2	16	22	1	2200	230	-1970	0.05	0.10	3	0	-3
0018	2F	11_2	23	3	2	300	660	360	0.67	2.20	0	1	1
0018	2F	11_2	24	3	0	300	0	-300	0.00	0.00	0	0	0
0018	2F	11_2	25	5	1	500	180	-320	0.20	0.36	0	0	0
0018	2F	11_2	26	4	1	400	270	-130	0.25	0.68	0	0	0
0018	2F	11_3	12	218	90	21800	22650	850	0.41	1.04	38	40	2
0018	2F	11_3	13	98	23	9800	5070	-4730	0.23	0.52	17	8	-9
0018	2F	11_3	14	36	7	3600	2000	-1600	0.19	0.56	6	3	-3
0018	2F	11_3	15	25	6	2500	2260	-240	0.24	0.90	4	4	0
0018	2F	11_3	16	8	1	800	600	-200	0.13	0.75	1	1	0
0018	2F	11_3	23	7	1	700	200	-500	0.14	0.29	1	0	-1
0018	2F	11_3	24	2	1	200	300	100	0.50	1.50	0	0	0
0018	2F	11_3	25	7	0	700	0	-700	0.00	0.00	1	0	-1
0018	2F	11_3	26	6	3	600	970	370	0.50	1.62	1	1	0
0018	2F	11_4	12	200	67	20000	19950	-50	0.34	1.00	35	35	0
0018	2F	11_4	13	104	30	10400	8010	-2390	0.29	0.77	18	14	-4
0018	2F	11_4	14	39	11	3900	2930	-970	0.28	0.75	6	5	-1
0018	2F	11_4	15	9	1	900	400	-500	0.11	0.44	1	0	-1
0018	2F	11_4	16	3	0	300	0	-300	0.00	0.00	0	0	0
0018	2F	11_4	23	8	1	800	210	-590	0.13	0.26	1	0	-1
0018	2F	11_4	24	4	1	400	400	0	0.25	1.00	0	0	0
0018	2F	11_4	25	7	1	700	290	-410	0.14	0.41	1	0	-1
0018	2F	11_4	26	2	1	200	560	360	0.50	2.80	0	0	0
0018	2F	11_5	12	195	84	19500	20690	1190	0.43	1.06	34	36	2
0018	2F	11_5	13	90	35	9000	9140	140	0.39	1.02	15	16	1
0018	2F	11_5	14	54	14	5400	3280	-2120	0.26	0.61	9	5	-4
0018	2F	11_5	15	8	0	800	0	-800	0.00	0.00	1	0	-1
0018	2F	11_5	16	13	3	1300	1770	470	0.23	1.36	2	3	1
0018	2F	11_5	23	1	0	100	0	-100	0.00	0.00	0	0	0
0018	2F	11_5	24	1	0	100	0	-100	0.00	0.00	0	0	0
0018	2F	11_5	26	1	0	100	0	-100	0.00	0.00	0	0	0
0018	2F	11_7	12	293	120	29300	27550	-1750	0.41	0.94	51	48	-3
0018	2F	11_7	13	130	41	13000	10780	-2220	0.32	0.83	23	19	-4
0018	2F	11_7	14	44	14	4400	3930	-470	0.32	0.89	7	6	-1
0018	2F	11_7	15	10	0	1000	0	-1000	0.00	0.00	1	0	-1
0018	2F	11_7	16	6	1	600	290	-310	0.17	0.48	1	0	-1
0018	2F	11_7	23	1	0	100	0	-100	0.00	0.00	0	0	0
0018	2F	11_7	24	1	0	100	0	-100	0.00	0.00	0	0	0
0018	2F	11_7	26	1	0	100	0	-100	0.00	0.00	0	0	0
0018	2F	12_1	12	254	88	25400	24020	-1380	0.35	0.95	44	42	-2
0018	2F	12_1	13	102	31	10200	7220	-2980	0.30	0.71	18	12	-6
0018	2F	12_1	14	46	9	4600	2620	-1980	0.20	0.57	8	4	-4
0018	2F	12_1	15	16	3	1600	990	-610	0.19	0.62	2	1	-1
0018	2F	12_1	16	10	0	1000	0	-1000	0.00	0.00	1	0	-1
0018	2F	12_1	23	5	2	500	890	390	0.40	1.78	0	1	1
0018	2F	12_1	24	4	1	400	260	-140	0.25	0.65	0	0	0
0018	2F	12_1	25	1	0	100	0	-100	0.00	0.00	0	0	0
0018	2F	12_1	26	2	1	200	200	0	0.50	1.00	0	0	0
0018	2F	12_2	12	241	77	24100	18720	-5380	0.32	0.78	42	33	-9
0018	2F	12_2	13	93	26	9300	6030	-3270	0.28	0.65	16	10	-6
0018	2F	12_2	14	57	18	5700	3840	-1860	0.32	0.67	10	6	-4
0018	2F	12_2	15	23	7	2300	2430	130	0.30	1.06	4	4	0
0018	2F	12_2	16	19	6	1900	1790	-110	0.32	0.94	3	3	0
0018	2F	12_2	23	1	0	100	0	-100	0.00	0.00	0	0	0
0018	2F	12_2	24	4	0	400	0	-400	0.00	0.00	0	0	0
0018	2F	12_2	25	2	0	200	0	-200	0.00	0.00	0	0	0
0018	2F	12_2	26	6	0	600	0	-600	0.00	0.00	1	0	-1
0018	2F	12_3	12	229	64	22900	17120	-5780	0.28	0.75	40	30	-10
0018	2F	12_3	13	114	27	11400	6820	-4580	0.24	0.60	20	12	-8
0018	2F	12_3	14	62	9	6200	2840	-3360	0.15	0.46	10	5	-5
0018	2F	12_3	15	18	5	1800	1990	190	0.28	1.11	3	3	0
0018	2F	12_3	16	21	5	2100	960	-1140	0.24	0.46	3	1	-2
0018	2F	12_3	23	6	3	600	950	350	0.50	1.58	1	1	0
0018	2F	12_3	24	2	0	200	0	-200	0.00	0.00	0	0	0
0018	2F	12_3	25	2	0	200	0	-200	0.00	0.00	0	0	0
0018	2F	12_3	26	1	0	100	0	-100	0.00	0.00	0	0	0
0018	2F	12_4	12	226	79	22600	19050	-3550	0.35	0.84	40	33	-7
0018	2F	12_4	13	67	21	6700	5340	-1360	0.31	0.80	11	9	-2
0018	2F	12_4	14	38	10	3800	2970	-830	0.26	0.78	6	5	-1
0018	2F	12_4	15	17	1	1700	370	-1330	0.06	0.22	3	0	-3
0018	2F	12_4	16	5	1	500	160	-340	0.20	0.32	0	0	0
0018	2F	12_4	23	8	2	800	580	-220	0.25	0.73	1	1	0
0018	2F	12_4	24	7	2	700	670	-30	0.29	0.96	1	1	0
0018	2F	12_4	25	7	2	700	640	-60	0.29	0.91	1	1	0
0018	2F	12_4	26	4	1	400	180	-220	0.25	0.45	0	0	0
0018	2F	12_5	12	226	76	22600	18020	-4580	0.34	0.80	40	31	-9
0018	2F	12_5	13	76	24	7600	6060	-1540	0.32	0.80	13	10	-3
0018	2F	12_5	14	35	15	3500	3910	410	0.43	1.12	6	6	0
0018	2F	12_5	15	9	2	900	760	-140	0.22	0.84	1	1	0
0018	2F	12_5	16	6	4	600	1150	550	0.67	1.92	1	2	1
0018	2F	12_5	25	1	0	100	0	-100	0.00	0.00	0	0	0
0018	2F	12_6	12	21	8	2100	2200	100	0.38	1.05	3	3	0
0018	2F	12_6	13	9	5	900	1030	130	0.56	1.14	1	1	0
0018	2F	12_6	14	1	0	100	0	-100	0.00	0.00	0	0	0
0018	2F	12_6	16	2	0	200	0	-200	0.00	0.00	0	0	0
0018	2F	12_7	12	305	112	30500	27610	-2890	0.37	0.91	53	48	-5
0018	2F	12_7	13	111	31	11100	7750	-3350	0.28	0.70	19	13	-6
0018	2F	12_7	14	36	6	3600	1980	-1620	0.17	0.55	6	3	-3
0018	2F	12_7	15	24	3	2400	2310	-90	0.13	0.96	4	4	0
0018	2F	12_7	16	5	1	500	340	-160	0.20	0.68	0	0	0
0018	2F	12_7	23	3	1	300	210	-90	0.33	0.70	0	0	0
0018	2F	12_7	24	2	0	200	0	-200	0.00	0.00	0	0	0
0018	2F	13_1	12	214	66	21400	15990	-5410	0.31	0.75	37	28	-9
0018	2F	13_1	13	134	40	13400	9140	-4260	0.30	0.68	23	16	-7
0018	2F	13_1	14	91	26	9100	5910	-3190	0.29	0.65	16	10	-6
0018	2F	13_1	15	5	0	500	0	-500	0.00	0.00	0	0	0
0018	2F	13_1	16	12	2	1200	950	-250	0.17	0.79	2	1	-1
0018	2F	13_1	23	2	1	200	300	100	0.50	1.50	0	0	0
0018	2F	13_1	24	4	0	400	0	-400	0.00	0.00	0	0	0
0018	2F	13_1	25	1	0	100	0	-100	0.00	0.00	0	0	0
0018	2F	13_2	12	173	55	17300	16450	-850	0.32	0.95	30	29	-1
0018	2F	13_2	13	105	31	10500	7280	-3220	0.30	0.69	18	12	-6
0018	2F	13_2	14	70	26	7000	5830	-1170	0.37	0.83	12	10	-2
0018	2F	13_2	15	32	12	3200	3490	290	0.38	1.09	5	6	1
0018	2F	13_2	16	16	3	1600	1230	-370	0.19	0.77	2	2	0
0018	2F	13_2	24	4	2	400	550	150	0.50	1.38	0	0	0
0018	2F	13_2	25	4	1	400	270	-130	0.25	0.68	0	0	0
0018	2F	13_2	26	2	0	200	0	-200	0.00	0.00	0	0	0
0018	2F	13_3	12	202	59	20200	15840	-4360	0.29	0.78	35	28	-7
0018	2F	13_3	13	95	35	9500	10690	1190	0.37	1.13	16	18	2
0018	2F	13_3	14	44	13	4400	4060	-340	0.30	0.92	7	7	0
0018	2F	13_3	15	23	3	2300	470	-1830	0.13	0.20	4	0	-4
0018	2F	13_3	16	13	2	1300	810	-490	0.15	0.62	2	1	-1
0018	2F	13_3	23	5	1	500	380	-120	0.20	0.76	0	0	0
0018	2F	13_3	24	9	0	900	0	-900	0.00	0.00	1	0	-1
0018	2F	13_3	25	10	0	1000	0	-1000	0.00	0.00	1	0	-1
0018	2F	13_3	26	5	0	500	0	-500	0.00	0.00	0	0	0
0018	2F	13_4	12	199	60	19900	16520	-3380	0.30	0.83	35	29	-6
0018	2F	13_4	13	81	32	8100	6800	-1300	0.40	0.84	14	12	-2
0018	2F	13_4	14	65	20	6500	5260	-1240	0.31	0.81	11	9	-2
0018	2F	13_4	15	19	7	1900	1890	-10	0.37	0.99	3	3	0
0018	2F	13_4	16	6	1	600	310	-290	0.17	0.52	1	0	-1
0018	2F	13_4	23	8	0	800	0	-800	0.00	0.00	1	0	-1
0018	2F	13_4	24	5	0	500	0	-500	0.00	0.00	0	0	0
0018	2F	13_4	25	4	0	400	0	-400	0.00	0.00	0	0	0
0018	2F	13_4	26	3	0	300	0	-300	0.00	0.00	0	0	0
0018	2F	13_5	12	197	79	19700	16520	-3180	0.40	0.84	34	29	-5
0018	2F	13_5	13	85	30	8500	8470	-30	0.35	1.00	15	14	-1
0018	2F	13_5	14	55	21	5500	5410	-90	0.38	0.98	9	9	0
0018	2F	13_5	15	12	0	1200	0	-1200	0.00	0.00	2	0	-2
0018	2F	13_5	16	23	8	2300	1430	-870	0.35	0.62	4	2	-2
0018	2F	13_5	23	2	0	200	0	-200	0.00	0.00	0	0	0
0018	2F	13_5	24	1	0	100	0	-100	0.00	0.00	0	0	0
0018	2F	13_5	26	2	0	200	0	-200	0.00	0.00	0	0	0
0018	2F	13_6	12	21	8	2100	1760	-340	0.38	0.84	3	3	0
0018	2F	13_6	13	14	7	1400	1680	280	0.50	1.20	2	2	0
0018	2F	13_6	14	10	0	1000	0	-1000	0.00	0.00	1	0	-1
0018	2F	13_6	15	3	0	300	0	-300	0.00	0.00	0	0	0
0018	2F	13_7	12	229	99	22900	23920	1020	0.43	1.04	40	42	2
0018	2F	13_7	13	117	36	11700	12040	340	0.31	1.03	20	21	1
0018	2F	13_7	14	63	24	6300	6390	90	0.38	1.01	11	11	0
0018	2F	13_7	15	19	6	1900	1890	-10	0.32	0.99	3	3	0
0018	2F	13_7	16	12	3	1200	910	-290	0.25	0.76	2	1	-1
0018	2F	13_7	23	3	2	300	490	190	0.67	1.63	0	0	0
0018	2F	13_7	24	3	0	300	0	-300	0.00	0.00	0	0	0
0018	2F	13_7	25	2	0	200	0	-200	0.00	0.00	0	0	0
0018	2F	14_1	12	262	83	26200	24130	-2070	0.32	0.92	46	42	-4
0018	2F	14_1	13	60	19	6000	5840	-160	0.32	0.97	10	10	0
0018	2F	14_1	14	82	17	8200	5550	-2650	0.21	0.68	14	9	-5
0018	2F	14_1	15	2	0	200	0	-200	0.00	0.00	0	0	0
0018	2F	14_1	16	1	0	100	0	-100	0.00	0.00	0	0	0
0018	2F	14_1	23	5	0	500	0	-500	0.00	0.00	0	0	0
0018	2F	14_1	24	16	3	1600	1420	-180	0.19	0.89	2	2	0
0018	2F	14_1	25	1	0	100	0	-100	0.00	0.00	0	0	0
0018	2F	14_2	12	268	77	26800	21290	-5510	0.29	0.79	47	37	-10
0018	2F	14_2	13	58	15	5800	4200	-1600	0.26	0.72	10	7	-3
0018	2F	14_2	14	85	22	8500	6190	-2310	0.26	0.73	15	10	-5
0018	2F	14_2	15	8	2	800	820	20	0.25	1.03	1	1	0
0018	2F	14_2	16	2	0	200	0	-200	0.00	0.00	0	0	0
0018	2F	14_2	23	6	2	600	800	200	0.33	1.33	1	1	0
0018	2F	14_2	24	14	1	1400	960	-440	0.07	0.69	2	1	-1
0018	2F	14_3	12	280	83	28000	28410	410	0.30	1.01	49	50	1
0018	2F	14_3	13	56	18	5600	5140	-460	0.32	0.92	9	9	0
0018	2F	14_3	14	102	22	10200	10070	-130	0.22	0.99	18	17	-1
0018	2F	14_3	23	9	2	900	850	-50	0.22	0.94	1	1	0
0018	2F	14_3	24	17	2	1700	1740	40	0.12	1.02	3	3	0
0018	2F	14_4	12	204	61	20400	16040	-4360	0.30	0.79	36	28	-8
0018	2F	14_4	13	67	17	6700	4670	-2030	0.25	0.70	11	8	-3
0018	2F	14_4	14	40	13	4000	3690	-310	0.33	0.92	7	6	-1
0018	2F	14_4	15	10	0	1000	0	-1000	0.00	0.00	1	0	-1
0018	2F	14_4	16	9	3	900	610	-290	0.33	0.68	1	1	0
0018	2F	14_4	23	13	5	1300	1390	90	0.38	1.07	2	2	0
0018	2F	14_4	24	5	2	500	380	-120	0.40	0.76	0	0	0
0018	2F	14_4	25	2	0	200	0	-200	0.00	0.00	0	0	0
0018	2F	14_4	26	6	1	600	310	-290	0.17	0.52	1	0	-1
0018	2F	14_5	12	126	32	12600	8190	-4410	0.25	0.65	22	14	-8
0018	2F	14_5	13	37	8	3700	2520	-1180	0.22	0.68	6	4	-2
0018	2F	14_5	14	32	6	3200	1580	-1620	0.19	0.49	5	2	-3
0018	2F	14_5	15	14	1	1400	280	-1120	0.07	0.20	2	0	-2
0018	2F	14_5	16	10	1	1000	330	-670	0.10	0.33	1	0	-1
0018	2F	14_5	23	2	0	200	0	-200	0.00	0.00	0	0	0
0018	2F	14_5	25	1	0	100	0	-100	0.00	0.00	0	0	0
0018	2F	14_5	26	2	0	200	0	-200	0.00	0.00	0	0	0
0018	2F	14_6	12	12	3	1200	1050	-150	0.25	0.88	2	1	-1
0018	2F	14_6	13	5	2	500	360	-140	0.40	0.72	0	0	0
0018	2F	14_6	14	4	0	400	0	-400	0.00	0.00	0	0	0
0018	2F	14_6	15	1	0	100	0	-100	0.00	0.00	0	0	0
0018	2F	14_6	16	1	0	100	0	-100	0.00	0.00	0	0	0
0018	2F	14_7	12	264	76	26400	21430	-4970	0.29	0.81	46	37	-9
0018	2F	14_7	13	83	18	8300	5580	-2720	0.22	0.67	14	9	-5
0018	2F	14_7	14	69	21	6900	6780	-120	0.30	0.98	12	12	0
0018	2F	14_7	15	19	1	1900	290	-1610	0.05	0.15	3	0	-3
0018	2F	14_7	16	7	2	700	900	200	0.29	1.29	1	1	0
0018	2F	14_7	23	3	0	300	0	-300	0.00	0.00	0	0	0
0018	2F	14_7	24	3	2	300	750	450	0.67	2.50	0	1	1
0018	2F	14_7	26	1	0	100	0	-100	0.00	0.00	0	0	0
0018	2F	15_1	12	277	86	27700	23190	-4510	0.31	0.84	49	41	-8
0018	2F	15_1	13	142	37	14200	9270	-4930	0.26	0.65	25	16	-9
0018	2F	15_1	14	36	9	3600	2920	-680	0.25	0.81	6	5	-1
0018	2F	15_1	15	17	3	1700	1060	-640	0.18	0.62	3	1	-2
0018	2F	15_1	16	18	3	1800	1990	190	0.17	1.11	3	3	0
0018	2F	15_1	23	4	2	400	850	450	0.50	2.13	0	1	1
0018	2F	15_1	25	1	0	100	0	-100	0.00	0.00	0	0	0
0018	2F	15_1	26	2	1	200	330	130	0.50	1.65	0	0	0
0018	2F	15_2	12	257	86	25700	23160	-2540	0.33	0.90	45	40	-5
0018	2F	15_2	13	107	33	10700	8040	-2660	0.31	0.75	18	14	-4
0018	2F	15_2	14	67	18	6700	4370	-2330	0.27	0.65	11	7	-4
0018	2F	15_2	15	23	4	2300	2490	190	0.17	1.08	4	4	0
0018	2F	15_2	16	14	3	1400	1120	-280	0.21	0.80	2	1	-1
0018	2F	15_2	23	7	1	700	160	-540	0.14	0.23	1	0	-1
0018	2F	15_2	24	2	1	200	390	190	0.50	1.95	0	0	0
0018	2F	15_2	26	4	1	400	600	200	0.25	1.50	0	1	1
0018	2F	15_3	12	275	76	27500	18120	-9380	0.28	0.66	48	32	-16
0018	2F	15_3	13	112	37	11200	9400	-1800	0.33	0.84	19	16	-3
0018	2F	15_3	14	73	24	7300	9660	2360	0.33	1.32	12	17	5
0018	2F	15_3	15	21	3	2100	2130	30	0.14	1.01	3	3	0
0018	2F	15_3	16	12	2	1200	520	-680	0.17	0.43	2	0	-2
0018	2F	15_3	23	2	0	200	0	-200	0.00	0.00	0	0	0
0018	2F	15_3	24	1	0	100	0	-100	0.00	0.00	0	0	0
0018	2F	15_3	25	7	2	700	430	-270	0.29	0.61	1	0	-1
0018	2F	15_3	26	3	0	300	0	-300	0.00	0.00	0	0	0
0018	2F	15_4	12	236	80	23600	19720	-3880	0.34	0.84	41	34	-7
0018	2F	15_4	13	79	27	7900	6830	-1070	0.34	0.86	13	12	-1
0018	2F	15_4	14	58	15	5800	5690	-110	0.26	0.98	10	10	0
0018	2F	15_4	15	15	1	1500	240	-1260	0.07	0.16	2	0	-2
0018	2F	15_4	16	10	2	1000	1180	180	0.20	1.18	1	2	1
0018	2F	15_4	23	6	1	600	380	-220	0.17	0.63	1	0	-1
0018	2F	15_4	24	3	1	300	400	100	0.33	1.33	0	0	0
0018	2F	15_4	25	3	0	300	0	-300	0.00	0.00	0	0	0
0018	2F	15_4	26	2	0	200	0	-200	0.00	0.00	0	0	0
0018	2F	15_5	12	208	56	20800	13090	-7710	0.27	0.63	36	23	-13
0018	2F	15_5	13	80	29	8000	8210	210	0.36	1.03	14	14	0
0018	2F	15_5	14	36	11	3600	2890	-710	0.31	0.80	6	5	-1
0018	2F	15_5	15	19	5	1900	1510	-390	0.26	0.79	3	2	-1
0018	2F	15_5	16	14	4	1400	1540	140	0.29	1.10	2	2	0
0018	2F	15_5	23	2	0	200	0	-200	0.00	0.00	0	0	0
0018	2F	15_5	25	3	0	300	0	-300	0.00	0.00	0	0	0
0018	2F	15_5	26	3	0	300	0	-300	0.00	0.00	0	0	0
0018	2F	15_6	12	38	12	3800	2760	-1040	0.32	0.73	6	4	-2
0018	2F	15_6	13	12	4	1200	950	-250	0.33	0.79	2	1	-1
0018	2F	15_6	14	7	2	700	500	-200	0.29	0.71	1	0	-1
0018	2F	15_6	15	5	2	500	660	160	0.40	1.32	0	1	1
0018	2F	15_6	16	2	2	200	1040	840	1.00	5.20	0	1	1
0018	2F	15_7	12	330	115	33000	27530	-5470	0.35	0.83	58	48	-10
0018	2F	15_7	13	134	40	13400	10010	-3390	0.30	0.75	23	17	-6
0018	2F	15_7	14	45	11	4500	3110	-1390	0.24	0.69	7	5	-2
0018	2F	15_7	15	13	2	1300	1370	70	0.15	1.05	2	2	0
0018	2F	15_7	16	20	7	2000	2750	750	0.35	1.38	3	4	1
0018	2F	15_7	23	2	0	200	0	-200	0.00	0.00	0	0	0
0018	2F	15_7	24	2	0	200	0	-200	0.00	0.00	0	0	0
0018	2F	15_7	26	3	0	300	0	-300	0.00	0.00	0	0	0
0018	2F	16_1	12	336	98	33600	26240	-7360	0.29	0.78	59	46	-13
0018	2F	16_1	13	93	25	9300	7450	-1850	0.27	0.80	16	13	-3
0018	2F	16_1	14	67	19	6700	4190	-2510	0.28	0.63	11	7	-4
0018	2F	16_1	15	16	3	1600	1100	-500	0.19	0.69	2	1	-1
0018	2F	16_1	16	18	2	1800	820	-980	0.11	0.46	3	1	-2
0018	2F	16_1	25	2	0	200	0	-200	0.00	0.00	0	0	0
0018	2F	16_1	26	3	0	300	0	-300	0.00	0.00	0	0	0
0018	2F	16_2	12	237	80	23700	21650	-2050	0.34	0.91	41	38	-3
0018	2F	16_2	13	94	23	9400	5350	-4050	0.24	0.57	16	9	-7
0018	2F	16_2	14	80	29	8000	7170	-830	0.36	0.90	14	12	-2
0018	2F	16_2	15	16	4	1600	1490	-110	0.25	0.93	2	2	0
0018	2F	16_2	16	36	7	3600	2930	-670	0.19	0.81	6	5	-1
0018	2F	16_2	23	3	1	300	230	-70	0.33	0.77	0	0	0
0018	2F	16_2	24	2	1	200	630	430	0.50	3.15	0	1	1
0018	2F	16_2	25	3	1	300	320	20	0.33	1.07	0	0	0
0018	2F	16_2	26	10	0	1000	0	-1000	0.00	0.00	1	0	-1
0018	2F	16_3	12	235	74	23500	17730	-5770	0.31	0.75	41	31	-10
0018	2F	16_3	13	118	36	11800	9020	-2780	0.31	0.76	20	15	-5
0018	2F	16_3	14	75	19	7500	3920	-3580	0.25	0.52	13	6	-7
0018	2F	16_3	15	31	5	3100	3630	530	0.16	1.17	5	6	1
0018	2F	16_3	16	11	2	1100	1560	460	0.18	1.42	1	2	1
0018	2F	16_3	23	4	0	400	0	-400	0.00	0.00	0	0	0
0018	2F	16_3	24	4	0	400	0	-400	0.00	0.00	0	0	0
0018	2F	16_3	25	3	1	300	780	480	0.33	2.60	0	1	1
0018	2F	16_3	26	7	1	700	330	-370	0.14	0.47	1	0	-1
0018	2F	16_4	12	253	93	25300	21890	-3410	0.37	0.87	44	38	-6
0018	2F	16_4	13	72	24	7200	5780	-1420	0.33	0.80	12	10	-2
0018	2F	16_4	14	72	39	7200	9780	2580	0.54	1.36	12	17	5
0018	2F	16_4	15	18	4	1800	2310	510	0.22	1.28	3	4	1
0018	2F	16_4	16	6	3	600	1400	800	0.50	2.33	1	2	1
0018	2F	16_4	23	4	2	400	990	590	0.50	2.48	0	1	1
0018	2F	16_4	24	4	1	400	510	110	0.25	1.28	0	0	0
0018	2F	16_4	25	6	3	600	2240	1640	0.50	3.73	1	3	2
0018	2F	16_4	26	2	0	200	0	-200	0.00	0.00	0	0	0
0018	2F	16_5	12	236	85	23600	18960	-4640	0.36	0.80	41	33	-8
0018	2F	16_5	13	84	25	8400	5680	-2720	0.30	0.68	14	10	-4
0018	2F	16_5	14	100	30	10000	6330	-3670	0.30	0.63	17	11	-6
0018	2F	16_5	15	10	3	1000	1190	190	0.30	1.19	1	2	1
0018	2F	16_5	16	5	0	500	0	-500	0.00	0.00	0	0	0
0018	2F	16_5	23	1	0	100	0	-100	0.00	0.00	0	0	0
0018	2F	16_7	12	329	122	32900	29260	-3640	0.37	0.89	58	51	-7
0018	2F	16_7	13	115	33	11500	9090	-2410	0.29	0.79	20	16	-4
0018	2F	16_7	14	68	21	6800	5580	-1220	0.31	0.82	12	9	-3
0018	2F	16_7	15	11	4	1100	1300	200	0.36	1.18	1	2	1
0018	2F	16_7	16	19	3	1900	1100	-800	0.16	0.58	3	1	-2
0018	2F	16_7	25	1	0	100	0	-100	0.00	0.00	0	0	0
0018	2F	16_7	26	1	1	100	670	570	1.00	6.70	0	1	1
0018	2F	17_1	12	279	71	27900	16370	-11530	0.25	0.59	49	28	-21
0018	2F	17_1	13	124	39	12400	9250	-3150	0.31	0.75	21	16	-5
0018	2F	17_1	14	60	13	6000	3190	-2810	0.22	0.53	10	5	-5
0018	2F	17_1	15	11	1	1100	460	-640	0.09	0.42	1	0	-1
0018	2F	17_1	16	4	1	400	720	320	0.25	1.80	0	1	1
0018	2F	17_1	23	4	1	400	450	50	0.25	1.13	0	0	0
0018	2F	17_1	24	4	0	400	0	-400	0.00	0.00	0	0	0
0018	2F	17_1	25	3	1	300	1240	940	0.33	4.13	0	2	2
0018	2F	17_2	12	280	86	28000	21760	-6240	0.31	0.78	49	38	-11
0018	2F	17_2	13	141	43	14100	12090	-2010	0.30	0.86	24	21	-3
0018	2F	17_2	14	49	11	4900	4120	-780	0.22	0.84	8	7	-1
0018	2F	17_2	15	15	4	1500	1290	-210	0.27	0.86	2	2	0
0018	2F	17_2	16	4	1	400	1330	930	0.25	3.33	0	2	2
0018	2F	17_2	23	8	1	800	230	-570	0.13	0.29	1	0	-1
0018	2F	17_2	24	5	1	500	240	-260	0.20	0.48	0	0	0
0018	2F	17_2	25	2	0	200	0	-200	0.00	0.00	0	0	0
0018	2F	17_3	12	278	92	27800	21800	-6000	0.33	0.78	49	38	-11
0018	2F	17_3	13	125	44	12500	10550	-1950	0.35	0.84	22	18	-4
0018	2F	17_3	14	47	15	4700	3880	-820	0.32	0.83	8	6	-2
0018	2F	17_3	15	25	3	2500	930	-1570	0.12	0.37	4	1	-3
0018	2F	17_3	16	9	0	900	0	-900	0.00	0.00	1	0	-1
0018	2F	17_3	23	4	1	400	380	-20	0.25	0.95	0	0	0
0018	2F	17_3	24	1	1	100	480	380	1.00	4.80	0	0	0
0018	2F	17_3	25	3	0	300	0	-300	0.00	0.00	0	0	0
0018	2F	17_3	26	3	1	300	650	350	0.33	2.17	0	1	1
0018	2F	17_4	12	228	70	22800	16360	-6440	0.31	0.72	40	28	-12
0018	2F	17_4	13	101	37	10100	7880	-2220	0.37	0.78	17	13	-4
0018	2F	17_4	14	47	14	4700	3410	-1290	0.30	0.73	8	6	-2
0018	2F	17_4	15	10	4	1000	1230	230	0.40	1.23	1	2	1
0018	2F	17_4	16	4	1	400	360	-40	0.25	0.90	0	0	0
0018	2F	17_4	23	1	1	100	450	350	1.00	4.50	0	0	0
0018	2F	17_4	24	3	1	300	270	-30	0.33	0.90	0	0	0
0018	2F	17_4	25	3	2	300	1050	750	0.67	3.50	0	1	1
0018	2F	17_5	12	227	78	22700	15870	-6830	0.34	0.70	40	28	-12
0018	2F	17_5	13	95	27	9500	7070	-2430	0.28	0.74	16	12	-4
0018	2F	17_5	14	45	17	4500	3980	-520	0.38	0.88	7	7	0
0018	2F	17_5	15	13	1	1300	610	-690	0.08	0.47	2	1	-1
0018	2F	17_5	16	2	1	200	250	50	0.50	1.25	0	0	0
0018	2F	17_5	23	3	0	300	0	-300	0.00	0.00	0	0	0
0018	2F	17_5	24	4	0	400	0	-400	0.00	0.00	0	0	0
0018	2F	17_7	12	310	95	31000	22020	-8980	0.31	0.71	54	38	-16
0018	2F	17_7	13	138	42	13800	9260	-4540	0.30	0.67	24	16	-8
0018	2F	17_7	14	66	15	6600	3880	-2720	0.23	0.59	11	6	-5
0018	2F	17_7	15	16	4	1600	2230	630	0.25	1.39	2	3	1
0018	2F	17_7	16	5	0	500	0	-500	0.00	0.00	0	0	0
0018	2F	17_7	24	2	0	200	0	-200	0.00	0.00	0	0	0
0018	2F	17_7	25	4	1	400	430	30	0.25	1.08	0	0	0
0018	2F	17_7	26	3	0	300	0	-300	0.00	0.00	0	0	0
0018	2F	18_1	12	254	75	25400	17310	-8090	0.30	0.68	44	30	-14
0018	2F	18_1	13	89	29	8900	7380	-1520	0.33	0.83	15	13	-2
0018	2F	18_1	14	66	22	6600	5800	-800	0.33	0.88	11	10	-1
0018	2F	18_1	15	13	3	1300	1420	120	0.23	1.09	2	2	0
0018	2F	18_1	16	9	2	900	530	-370	0.22	0.59	1	0	-1
0018	2F	18_1	23	6	2	600	750	150	0.33	1.25	1	1	0
0018	2F	18_1	24	5	2	500	600	100	0.40	1.20	0	1	1
0018	2F	18_1	25	4	0	400	0	-400	0.00	0.00	0	0	0
0018	2F	18_1	26	12	4	1200	1800	600	0.33	1.50	2	3	1
0018	2F	18_2	12	247	101	24700	24490	-210	0.41	0.99	43	43	0
0018	2F	18_2	13	98	24	9800	5820	-3980	0.24	0.59	17	10	-7
0018	2F	18_2	14	69	17	6900	5030	-1870	0.25	0.73	12	8	-4
0018	2F	18_2	15	19	6	1900	2190	290	0.32	1.15	3	3	0
0018	2F	18_2	16	12	5	1200	2200	1000	0.42	1.83	2	3	1
0018	2F	18_2	23	3	0	300	0	-300	0.00	0.00	0	0	0
0018	2F	18_2	24	6	2	600	570	-30	0.33	0.95	1	1	0
0018	2F	18_2	25	4	2	400	580	180	0.50	1.45	0	1	1
0018	2F	18_2	26	13	1	1300	610	-690	0.08	0.47	2	1	-1
0018	2F	18_3	12	253	105	25300	25430	130	0.42	1.01	44	45	1
0018	2F	18_3	13	78	34	7800	8800	1000	0.44	1.13	13	15	2
0018	2F	18_3	14	66	17	6600	5190	-1410	0.26	0.79	11	9	-2
0018	2F	18_3	15	23	3	2300	1350	-950	0.13	0.59	4	2	-2
0018	2F	18_3	16	17	1	1700	460	-1240	0.06	0.27	3	0	-3
0018	2F	18_3	23	6	1	600	280	-320	0.17	0.47	1	0	-1
0018	2F	18_3	24	8	0	800	0	-800	0.00	0.00	1	0	-1
0018	2F	18_3	25	2	0	200	0	-200	0.00	0.00	0	0	0
0018	2F	18_3	26	18	2	1800	670	-1130	0.11	0.37	3	1	-2
0018	2F	18_4	12	276	114	27600	25810	-1790	0.41	0.94	48	45	-3
0018	2F	18_4	13	73	19	7300	4190	-3110	0.26	0.57	12	7	-5
0018	2F	18_4	14	51	13	5100	4020	-1080	0.25	0.79	9	7	-2
0018	2F	18_4	15	18	6	1800	3100	1300	0.33	1.72	3	5	2
0018	2F	18_4	16	5	0	500	0	-500	0.00	0.00	0	0	0
0018	2F	18_4	23	7	1	700	230	-470	0.14	0.33	1	0	-1
0018	2F	18_4	24	1	0	100	0	-100	0.00	0.00	0	0	0
0018	2F	18_4	25	5	0	500	0	-500	0.00	0.00	0	0	0
0018	2F	18_4	26	3	0	300	0	-300	0.00	0.00	0	0	0
0018	2F	18_5	12	329	130	32900	28000	-4900	0.40	0.85	58	49	-9
0018	2F	18_5	13	64	16	6400	4360	-2040	0.25	0.68	11	7	-4
0018	2F	18_5	14	53	14	5300	3850	-1450	0.26	0.73	9	6	-3
0018	2F	18_5	15	37	9	3700	2290	-1410	0.24	0.62	6	4	-2
0018	2F	18_5	16	4	2	400	620	220	0.50	1.55	0	1	1
0018	2F	18_5	24	2	0	200	0	-200	0.00	0.00	0	0	0
0018	2F	18_6	12	33	16	3300	3130	-170	0.48	0.95	5	5	0
0018	2F	18_6	13	13	4	1300	1250	-50	0.31	0.96	2	2	0
0018	2F	18_6	14	11	3	1100	1050	-50	0.27	0.95	1	1	0
0018	2F	18_7	12	353	138	35300	30200	-5100	0.39	0.86	62	53	-9
0018	2F	18_7	13	103	28	10300	8240	-2060	0.27	0.80	18	14	-4
0018	2F	18_7	14	77	15	7700	4530	-3170	0.19	0.59	13	8	-5
0018	2F	18_7	15	11	3	1100	1790	690	0.27	1.63	1	3	2
0018	2F	18_7	16	7	2	700	1050	350	0.29	1.50	1	1	0
0018	2F	18_7	23	6	0	600	0	-600	0.00	0.00	1	0	-1
0018	2F	18_7	24	2	0	200	0	-200	0.00	0.00	0	0	0
0018	2F	19_1	12	227	71	22700	18030	-4670	0.31	0.79	40	31	-9
0018	2F	19_1	13	141	52	14100	11910	-2190	0.37	0.84	24	21	-3
0018	2F	19_1	14	68	31	6800	7100	300	0.46	1.04	12	12	0
0018	2F	19_1	15	3	0	300	0	-300	0.00	0.00	0	0	0
0018	2F	19_1	16	18	4	1800	1510	-290	0.22	0.84	3	2	-1
0018	2F	19_1	23	3	1	300	680	380	0.33	2.27	0	1	1
0018	2F	19_1	24	2	0	200	0	-200	0.00	0.00	0	0	0
0018	2F	19_1	26	2	0	200	0	-200	0.00	0.00	0	0	0
0018	2F	19_2	12	213	67	21300	19050	-2250	0.31	0.89	37	33	-4
0018	2F	19_2	13	117	41	11700	9930	-1770	0.35	0.85	20	17	-3
0018	2F	19_2	14	79	29	7900	6140	-1760	0.37	0.78	13	10	-3
0018	2F	19_2	15	7	1	700	490	-210	0.14	0.70	1	0	-1
0018	2F	19_2	16	13	2	1300	830	-470	0.15	0.64	2	1	-1
0018	2F	19_2	23	1	1	100	360	260	1.00	3.60	0	0	0
0018	2F	19_2	24	3	1	300	290	-10	0.33	0.97	0	0	0
0018	2F	19_2	26	8	3	800	960	160	0.38	1.20	1	1	0
0018	2F	19_3	12	222	77	22200	18990	-3210	0.35	0.86	39	33	-6
0018	2F	19_3	13	106	42	10600	9080	-1520	0.40	0.86	18	16	-2
0018	2F	19_3	14	79	24	7900	5500	-2400	0.30	0.70	13	9	-4
0018	2F	19_3	15	16	2	1600	690	-910	0.13	0.43	2	1	-1
0018	2F	19_3	16	13	2	1300	2300	1000	0.15	1.77	2	4	2
0018	2F	19_3	23	2	0	200	0	-200	0.00	0.00	0	0	0
0018	2F	19_3	26	7	1	700	390	-310	0.14	0.56	1	0	-1
0018	2F	19_4	12	205	71	20500	17300	-3200	0.35	0.84	36	30	-6
0018	2F	19_4	13	109	34	10900	7170	-3730	0.31	0.66	19	12	-7
0018	2F	19_4	14	52	15	5200	3390	-1810	0.29	0.65	9	6	-3
0018	2F	19_4	15	10	0	1000	0	-1000	0.00	0.00	1	0	-1
0018	2F	19_4	16	7	1	700	230	-470	0.14	0.33	1	0	-1
0018	2F	19_4	23	2	0	200	0	-200	0.00	0.00	0	0	0
0018	2F	19_4	24	3	0	300	0	-300	0.00	0.00	0	0	0
0018	2F	19_5	12	139	42	13900	9210	-4690	0.30	0.66	24	16	-8
0018	2F	19_5	13	87	28	8700	5570	-3130	0.32	0.64	15	9	-6
0018	2F	19_5	14	44	20	4400	6080	1680	0.45	1.38	7	10	3
0018	2F	19_5	15	4	1	400	190	-210	0.25	0.48	0	0	0
0018	2F	19_5	16	4	0	400	0	-400	0.00	0.00	0	0	0
0018	2F	19_5	23	4	0	400	0	-400	0.00	0.00	0	0	0
0018	2F	19_5	24	1	0	100	0	-100	0.00	0.00	0	0	0
0018	2F	19_5	25	1	0	100	0	-100	0.00	0.00	0	0	0
0018	2F	19_5	26	1	0	100	0	-100	0.00	0.00	0	0	0
0018	2F	19_6	12	18	7	1800	1230	-570	0.39	0.68	3	2	-1
0018	2F	19_6	13	7	2	700	410	-290	0.29	0.59	1	0	-1
0018	2F	19_6	14	7	1	700	170	-530	0.14	0.24	1	0	-1
0018	2F	19_6	15	2	0	200	0	-200	0.00	0.00	0	0	0
0018	2F	19_6	16	2	0	200	0	-200	0.00	0.00	0	0	0
0018	2F	19_6	23	1	0	100	0	-100	0.00	0.00	0	0	0
0018	2F	19_6	24	1	0	100	0	-100	0.00	0.00	0	0	0
0018	2F	19_7	12	242	75	24200	18590	-5610	0.31	0.77	42	32	-10
0018	2F	19_7	13	126	42	12600	10070	-2530	0.33	0.80	22	17	-5
0018	2F	19_7	14	79	25	7900	5680	-2220	0.32	0.72	13	10	-3
0018	2F	19_7	15	6	0	600	0	-600	0.00	0.00	1	0	-1
0018	2F	19_7	16	3	0	300	0	-300	0.00	0.00	0	0	0
0018	2F	19_7	23	5	0	500	0	-500	0.00	0.00	0	0	0
0018	2F	19_7	24	1	0	100	0	-100	0.00	0.00	0	0	0
0018	2F	19_7	25	2	0	200	0	-200	0.00	0.00	0	0	0
0018	2F	19_7	26	2	1	200	450	250	0.50	2.25	0	0	0
0018	2F	20_1	12	252	93	25200	25250	50	0.37	1.00	44	44	0
0018	2F	20_1	13	157	50	15700	10940	-4760	0.32	0.70	27	19	-8
0018	2F	20_1	14	71	22	7100	6000	-1100	0.31	0.85	12	10	-2
0018	2F	20_1	15	15	2	1500	500	-1000	0.13	0.33	2	0	-2
0018	2F	20_1	16	5	1	500	400	-100	0.20	0.80	0	0	0
0018	2F	20_1	23	1	0	100	0	-100	0.00	0.00	0	0	0
0018	2F	20_2	12	243	78	24300	18900	-5400	0.32	0.78	43	33	-10
0018	2F	20_2	13	128	40	12800	9030	-3770	0.31	0.71	22	15	-7
0018	2F	20_2	14	56	18	5600	3690	-1910	0.32	0.66	9	6	-3
0018	2F	20_2	15	28	7	2800	1940	-860	0.25	0.69	4	3	-1
0018	2F	20_2	16	32	7	3200	2190	-1010	0.22	0.68	5	3	-2
0018	2F	20_2	23	1	0	100	0	-100	0.00	0.00	0	0	0
0018	2F	20_2	24	1	0	100	0	-100	0.00	0.00	0	0	0
0018	2F	20_2	26	2	0	200	0	-200	0.00	0.00	0	0	0
0018	2F	20_3	12	270	107	27000	26680	-320	0.40	0.99	47	47	0
0018	2F	20_3	13	108	41	10800	10350	-450	0.38	0.96	19	18	-1
0018	2F	20_3	14	60	12	6000	3800	-2200	0.20	0.63	10	6	-4
0018	2F	20_3	15	29	8	2900	2490	-410	0.28	0.86	5	4	-1
0018	2F	20_3	16	15	5	1500	1490	-10	0.33	0.99	2	2	0
0018	2F	20_3	23	1	0	100	0	-100	0.00	0.00	0	0	0
0018	2F	20_3	24	2	0	200	0	-200	0.00	0.00	0	0	0
0018	2F	20_3	26	3	1	300	240	-60	0.33	0.80	0	0	0
0018	2F	20_4	12	222	70	22200	16440	-5760	0.32	0.74	39	29	-10
0018	2F	20_4	13	92	37	9200	8400	-800	0.40	0.91	16	14	-2
0018	2F	20_4	14	59	18	5900	4320	-1580	0.31	0.73	10	7	-3
0018	2F	20_4	15	31	11	3100	3220	120	0.35	1.04	5	5	0
0018	2F	20_4	16	4	1	400	650	250	0.25	1.63	0	1	1
0018	2F	20_4	23	2	1	200	420	220	0.50	2.10	0	0	0
0018	2F	20_4	24	2	1	200	230	30	0.50	1.15	0	0	0
0018	2F	20_5	12	226	88	22600	19910	-2690	0.39	0.88	40	35	-5
0018	2F	20_5	13	63	20	6300	5580	-720	0.32	0.89	11	9	-2
0018	2F	20_5	14	37	10	3700	2180	-1520	0.27	0.59	6	3	-3
0018	2F	20_5	15	8	3	800	1680	880	0.38	2.10	1	2	1
0018	2F	20_5	16	1	0	100	0	-100	0.00	0.00	0	0	0
0018	2F	20_5	23	1	0	100	0	-100	0.00	0.00	0	0	0
0018	2F	20_5	25	2	1	200	250	50	0.50	1.25	0	0	0
0018	2F	20_6	12	45	19	4500	4400	-100	0.42	0.98	7	7	0
0018	2F	20_6	13	15	5	1500	1430	-70	0.33	0.95	2	2	0
0018	2F	20_6	14	6	1	600	250	-350	0.17	0.42	1	0	-1
0018	2F	20_6	16	1	0	100	0	-100	0.00	0.00	0	0	0
0018	2F	20_6	23	1	0	100	0	-100	0.00	0.00	0	0	0
0018	2F	20_6	25	1	0	100	0	-100	0.00	0.00	0	0	0
0018	2F	20_7	12	299	91	29900	20310	-9590	0.30	0.68	52	35	-17
0018	2F	20_7	13	105	34	10500	9450	-1050	0.32	0.90	18	16	-2
0018	2F	20_7	14	73	20	7300	5620	-1680	0.27	0.77	12	9	-3
0018	2F	20_7	15	20	6	2000	1850	-150	0.30	0.93	3	3	0
0018	2F	20_7	16	10	3	1000	980	-20	0.30	0.98	1	1	0
0018	2F	20_7	23	4	1	400	240	-160	0.25	0.60	0	0	0
0018	2F	20_7	25	2	0	200	0	-200	0.00	0.00	0	0	0
0018	2F	20_7	26	2	0	200	0	-200	0.00	0.00	0	0	0
0018	2F	21_1	12	273	86	27300	18840	-8460	0.32	0.69	48	33	-15
0018	2F	21_1	13	145	61	14500	12850	-1650	0.42	0.89	25	22	-3
0018	2F	21_1	14	80	23	8000	5430	-2570	0.29	0.68	14	9	-5
0018	2F	21_1	15	2	0	200	0	-200	0.00	0.00	0	0	0
0018	2F	21_1	16	1	0	100	0	-100	0.00	0.00	0	0	0
0018	2F	21_1	23	2	0	200	0	-200	0.00	0.00	0	0	0
0018	2F	21_1	26	1	0	100	0	-100	0.00	0.00	0	0	0
0018	2F	21_2	12	282	98	28200	24600	-3600	0.35	0.87	49	43	-6
0018	2F	21_2	13	133	62	13300	14680	1380	0.47	1.10	23	25	2
0018	2F	21_2	14	84	37	8400	7840	-560	0.44	0.93	14	13	-1
0018	2F	21_2	15	14	4	1400	1020	-380	0.29	0.73	2	1	-1
0018	2F	21_2	16	1	1	100	830	730	1.00	8.30	0	1	1
0018	2F	21_2	25	1	1	100	280	180	1.00	2.80	0	0	0
0018	2F	21_2	26	5	1	500	330	-170	0.20	0.66	0	0	0
0018	2F	21_3	12	290	101	29000	24050	-4950	0.35	0.83	51	42	-9
0018	2F	21_3	13	112	46	11200	9520	-1680	0.41	0.85	19	16	-3
0018	2F	21_3	14	77	22	7700	4380	-3320	0.29	0.57	13	7	-6
0018	2F	21_3	15	18	6	1800	1920	120	0.33	1.07	3	3	0
0018	2F	21_3	16	8	2	800	1320	520	0.25	1.65	1	2	1
0018	2F	21_3	23	4	3	400	820	420	0.75	2.05	0	1	1
0018	2F	21_3	24	2	0	200	0	-200	0.00	0.00	0	0	0
0018	2F	21_3	26	1	0	100	0	-100	0.00	0.00	0	0	0
0018	2F	21_4	12	237	75	23700	17950	-5750	0.32	0.76	41	31	-10
0018	2F	21_4	13	122	45	12200	9000	-3200	0.37	0.74	21	15	-6
0018	2F	21_4	14	74	30	7400	5940	-1460	0.41	0.80	13	10	-3
0018	2F	21_4	15	5	2	500	520	20	0.40	1.04	0	0	0
0018	2F	21_4	16	2	0	200	0	-200	0.00	0.00	0	0	0
0018	2F	21_4	23	5	1	500	220	-280	0.20	0.44	0	0	0
0018	2F	21_4	24	1	0	100	0	-100	0.00	0.00	0	0	0
0018	2F	21_4	25	1	0	100	0	-100	0.00	0.00	0	0	0
0018	2F	21_4	26	3	0	300	0	-300	0.00	0.00	0	0	0
0018	2F	21_5	12	260	95	26000	21570	-4430	0.37	0.83	46	38	-8
0018	2F	21_5	13	79	24	7900	5700	-2200	0.30	0.72	13	10	-3
0018	2F	21_5	14	44	22	4400	4620	220	0.50	1.05	7	8	1
0018	2F	21_5	15	16	1	1600	260	-1340	0.06	0.16	2	0	-2
0018	2F	21_5	16	1	0	100	0	-100	0.00	0.00	0	0	0
0018	2F	21_5	24	1	0	100	0	-100	0.00	0.00	0	0	0
0018	2F	21_5	26	1	0	100	0	-100	0.00	0.00	0	0	0
0018	2F	21_6	12	21	6	2100	1130	-970	0.29	0.54	3	2	-1
0018	2F	21_6	13	5	2	500	1800	1300	0.40	3.60	0	3	3
0018	2F	21_6	14	6	0	600	0	-600	0.00	0.00	1	0	-1
0018	2F	21_6	16	1	0	100	0	-100	0.00	0.00	0	0	0
0018	2F	21_7	12	331	111	33100	25430	-7670	0.34	0.77	58	45	-13
0018	2F	21_7	13	95	36	9500	8720	-780	0.38	0.92	16	15	-1
0018	2F	21_7	14	69	25	6900	5850	-1050	0.36	0.85	12	10	-2
0018	2F	21_7	15	14	3	1400	900	-500	0.21	0.64	2	1	-1
0018	2F	21_7	16	9	0	900	0	-900	0.00	0.00	1	0	-1
0018	2F	21_7	23	2	2	200	880	680	1.00	4.40	0	1	1
0018	2F	21_7	24	1	0	100	0	-100	0.00	0.00	0	0	0
0018	2F	21_7	25	1	0	100	0	-100	0.00	0.00	0	0	0
0018	2F	21_7	26	1	1	100	430	330	1.00	4.30	0	0	0
0018	2F	22_1	12	245	66	24500	18050	-6450	0.27	0.74	43	31	-12
0018	2F	22_1	13	92	33	9200	7410	-1790	0.36	0.81	16	13	-3
0018	2F	22_1	14	50	16	5000	3470	-1530	0.32	0.69	8	6	-2
0018	2F	22_1	15	6	3	600	910	310	0.50	1.52	1	1	0
0018	2F	22_1	16	7	2	700	720	20	0.29	1.03	1	1	0
0018	2F	22_1	23	3	2	300	680	380	0.67	2.27	0	1	1
0018	2F	22_1	24	4	1	400	270	-130	0.25	0.68	0	0	0
0018	2F	22_1	25	2	1	200	180	-20	0.50	0.90	0	0	0
0018	2F	22_1	26	1	0	100	0	-100	0.00	0.00	0	0	0
0018	2F	22_2	12	199	73	19900	20250	350	0.37	1.02	35	35	0
0018	2F	22_2	13	97	27	9700	6670	-3030	0.28	0.69	17	11	-6
0018	2F	22_2	14	71	21	7100	5810	-1290	0.30	0.82	12	10	-2
0018	2F	22_2	15	18	5	1800	2230	430	0.28	1.24	3	3	0
0018	2F	22_2	16	16	2	1600	870	-730	0.13	0.54	2	1	-1
0018	2F	22_2	23	5	1	500	220	-280	0.20	0.44	0	0	0
0018	2F	22_2	24	1	0	100	0	-100	0.00	0.00	0	0	0
0018	2F	22_2	25	2	0	200	0	-200	0.00	0.00	0	0	0
0018	2F	22_2	26	4	1	400	670	270	0.25	1.68	0	1	1
0018	2F	22_3	12	189	74	18900	20270	1370	0.39	1.07	33	35	2
0018	2F	22_3	13	105	34	10500	10760	260	0.32	1.02	18	19	1
0018	2F	22_3	14	54	16	5400	4200	-1200	0.30	0.78	9	7	-2
0018	2F	22_3	15	16	5	1600	1600	0	0.31	1.00	2	2	0
0018	2F	22_3	16	5	1	500	560	60	0.20	1.12	0	0	0
0018	2F	22_3	23	4	0	400	0	-400	0.00	0.00	0	0	0
0018	2F	22_3	24	4	0	400	0	-400	0.00	0.00	0	0	0
0018	2F	22_3	25	3	0	300	0	-300	0.00	0.00	0	0	0
0018	2F	22_3	26	2	1	200	340	140	0.50	1.70	0	0	0
0018	2F	22_4	12	183	71	18300	16510	-1790	0.39	0.90	32	29	-3
0018	2F	22_4	13	110	41	11000	9390	-1610	0.37	0.85	19	16	-3
0018	2F	22_4	14	56	15	5600	3200	-2400	0.27	0.57	9	5	-4
0018	2F	22_4	15	20	8	2000	2420	420	0.40	1.21	3	4	1
0018	2F	22_4	16	7	0	700	0	-700	0.00	0.00	1	0	-1
0018	2F	22_4	23	6	3	600	730	130	0.50	1.22	1	1	0
0018	2F	22_4	24	4	3	400	820	420	0.75	2.05	0	1	1
0018	2F	22_4	25	4	1	400	350	-50	0.25	0.88	0	0	0
0018	2F	22_4	26	5	2	500	860	360	0.40	1.72	0	1	1
0018	2F	22_5	12	193	78	19300	18270	-1030	0.40	0.95	34	32	-2
0018	2F	22_5	13	84	38	8400	8840	440	0.45	1.05	14	15	1
0018	2F	22_5	14	49	13	4900	2760	-2140	0.27	0.56	8	4	-4
0018	2F	22_5	15	2	0	200	0	-200	0.00	0.00	0	0	0
0018	2F	22_5	16	2	0	200	0	-200	0.00	0.00	0	0	0
0018	2F	22_5	23	2	2	200	650	450	1.00	3.25	0	1	1
0018	2F	22_5	24	1	0	100	0	-100	0.00	0.00	0	0	0
0018	2F	22_7	12	267	102	26700	25310	-1390	0.38	0.95	47	44	-3
0018	2F	22_7	13	107	19	10700	4720	-5980	0.18	0.44	18	8	-10
0018	2F	22_7	14	53	8	5300	1990	-3310	0.15	0.38	9	3	-6
0018	2F	22_7	15	13	2	1300	1020	-280	0.15	0.78	2	1	-1
0018	2F	22_7	16	6	0	600	0	-600	0.00	0.00	1	0	-1
0018	2F	22_7	23	4	1	400	290	-110	0.25	0.73	0	0	0
0018	2F	22_7	25	1	0	100	0	-100	0.00	0.00	0	0	0
0018	2F	23_1	12	269	97	26900	24380	-2520	0.36	0.91	47	43	-4
0018	2F	23_1	13	113	38	11300	8290	-3010	0.34	0.73	20	14	-6
0018	2F	23_1	14	51	15	5100	6380	1280	0.29	1.25	9	11	2
0018	2F	23_1	15	11	4	1100	1110	10	0.36	1.01	1	1	0
0018	2F	23_1	16	1	0	100	0	-100	0.00	0.00	0	0	0
0018	2F	23_1	23	2	0	200	0	-200	0.00	0.00	0	0	0
0018	2F	23_1	24	2	0	200	0	-200	0.00	0.00	0	0	0
0018	2F	23_1	25	2	1	200	270	70	0.50	1.35	0	0	0
0018	2F	23_2	12	264	97	26400	25400	-1000	0.37	0.96	46	44	-2
0018	2F	23_2	13	117	43	11700	8980	-2720	0.37	0.77	20	15	-5
0018	2F	23_2	14	55	18	5500	6020	520	0.33	1.09	9	10	1
0018	2F	23_2	15	15	4	1500	1160	-340	0.27	0.77	2	2	0
0018	2F	23_2	16	2	0	200	0	-200	0.00	0.00	0	0	0
0018	2F	23_2	23	3	0	300	0	-300	0.00	0.00	0	0	0
0018	2F	23_2	24	6	1	600	400	-200	0.17	0.67	1	0	-1
0018	2F	23_2	25	5	2	500	610	110	0.40	1.22	0	1	1
0018	2F	23_3	12	240	75	24000	21970	-2030	0.31	0.92	42	38	-4
0018	2F	23_3	13	141	50	14100	12310	-1790	0.35	0.87	24	21	-3
0018	2F	23_3	14	53	9	5300	2340	-2960	0.17	0.44	9	4	-5
0018	2F	23_3	15	17	5	1700	1390	-310	0.29	0.82	3	2	-1
0018	2F	23_3	16	4	1	400	890	490	0.25	2.23	0	1	1
0018	2F	23_3	23	3	2	300	1130	830	0.67	3.77	0	2	2
0018	2F	23_3	24	2	1	200	510	310	0.50	2.55	0	0	0
0018	2F	23_3	25	4	0	400	0	-400	0.00	0.00	0	0	0
0018	2F	23_4	12	266	90	26600	18770	-7830	0.34	0.71	47	33	-14
0018	2F	23_4	13	111	46	11100	9110	-1990	0.41	0.82	19	16	-3
0018	2F	23_4	14	32	12	3200	3680	480	0.38	1.15	5	6	1
0018	2F	23_4	15	5	0	500	0	-500	0.00	0.00	0	0	0
0018	2F	23_4	16	5	0	500	0	-500	0.00	0.00	0	0	0
0018	2F	23_4	23	3	1	300	200	-100	0.33	0.67	0	0	0
0018	2F	23_4	24	11	0	1100	0	-1100	0.00	0.00	1	0	-1
0018	2F	23_4	25	1	0	100	0	-100	0.00	0.00	0	0	0
0018	2F	23_4	26	2	0	200	0	-200	0.00	0.00	0	0	0
0018	2F	23_5	12	187	68	18700	14390	-4310	0.36	0.77	33	25	-8
0018	2F	23_5	13	84	26	8400	6360	-2040	0.31	0.76	14	11	-3
0018	2F	23_5	14	50	12	5000	3000	-2000	0.24	0.60	8	5	-3
0018	2F	23_5	15	10	1	1000	270	-730	0.10	0.27	1	0	-1
0018	2F	23_5	16	1	0	100	0	-100	0.00	0.00	0	0	0
0018	2F	23_5	23	2	0	200	0	-200	0.00	0.00	0	0	0
0018	2F	23_5	24	5	0	500	0	-500	0.00	0.00	0	0	0
0018	2F	23_5	25	2	1	200	460	260	0.50	2.30	0	0	0
0018	2F	23_6	12	16	11	1600	2570	970	0.69	1.61	2	4	2
0018	2F	23_6	13	10	2	1000	390	-610	0.20	0.39	1	0	-1
0018	2F	23_6	14	3	2	300	420	120	0.67	1.40	0	0	0
0018	2F	23_6	15	2	0	200	0	-200	0.00	0.00	0	0	0
0018	2F	23_6	16	2	1	200	310	110	0.50	1.55	0	0	0
0018	2F	23_7	12	275	93	27500	21940	-5560	0.34	0.80	48	38	-10
0018	2F	23_7	13	151	49	15100	11850	-3250	0.32	0.78	26	20	-6
0018	2F	23_7	14	81	22	8100	5300	-2800	0.27	0.65	14	9	-5
0018	2F	23_7	15	12	4	1200	1720	520	0.33	1.43	2	3	1
0018	2F	23_7	16	15	4	1500	2150	650	0.27	1.43	2	3	1
0018	2F	23_7	23	1	0	100	0	-100	0.00	0.00	0	0	0
0018	2F	24_1	12	320	94	32000	21130	-10870	0.29	0.66	56	37	-19
0018	2F	24_1	13	121	46	12100	10190	-1910	0.38	0.84	21	18	-3
0018	2F	24_1	14	36	13	3600	3610	10	0.36	1.00	6	6	0
0018	2F	24_1	15	13	4	1300	840	-460	0.31	0.65	2	1	-1
0018	2F	24_1	16	25	9	2500	2270	-230	0.36	0.91	4	4	0
0018	2F	24_1	23	1	1	100	960	860	1.00	9.60	0	1	1
0018	2F	24_1	25	1	0	100	0	-100	0.00	0.00	0	0	0
0018	2F	24_1	26	10	0	1000	0	-1000	0.00	0.00	1	0	-1
0018	2F	24_2	12	275	103	27500	23180	-4320	0.37	0.84	48	41	-7
0018	2F	24_2	13	146	64	14600	15960	1360	0.44	1.09	25	28	3
0018	2F	24_2	14	47	19	4700	4280	-420	0.40	0.91	8	7	-1
0018	2F	24_2	15	11	5	1100	1320	220	0.45	1.20	1	2	1
0018	2F	24_2	16	24	6	2400	990	-1410	0.25	0.41	4	1	-3
0018	2F	24_2	23	1	0	100	0	-100	0.00	0.00	0	0	0
0018	2F	24_2	24	1	1	100	160	60	1.00	1.60	0	0	0
0018	2F	24_2	25	1	0	100	0	-100	0.00	0.00	0	0	0
0018	2F	24_2	26	1	0	100	0	-100	0.00	0.00	0	0	0
0018	2F	24_3	12	314	113	31400	24690	-6710	0.36	0.79	55	43	-12
0018	2F	24_3	13	151	55	15100	10810	-4290	0.36	0.72	26	19	-7
0018	2F	24_3	14	71	28	7100	5510	-1590	0.39	0.78	12	9	-3
0018	2F	24_3	15	14	6	1400	2030	630	0.43	1.45	2	3	1
0018	2F	24_3	16	5	2	500	530	30	0.40	1.06	0	0	0
0018	2F	24_3	23	2	0	200	0	-200	0.00	0.00	0	0	0
0018	2F	24_3	24	1	0	100	0	-100	0.00	0.00	0	0	0
0018	2F	24_3	26	3	1	300	420	120	0.33	1.40	0	0	0
0018	2F	24_4	12	210	72	21000	17530	-3470	0.34	0.83	37	31	-6
0018	2F	24_4	13	120	53	12000	12100	100	0.44	1.01	21	21	0
0018	2F	24_4	14	48	21	4800	4590	-210	0.44	0.96	8	8	0
0018	2F	24_4	15	12	6	1200	1660	460	0.50	1.38	2	2	0
0018	2F	24_4	16	7	2	700	640	-60	0.29	0.91	1	1	0
0018	2F	24_4	24	1	0	100	0	-100	0.00	0.00	0	0	0
0018	2F	24_5	12	140	59	14000	12220	-1780	0.42	0.87	24	21	-3
0018	2F	24_5	13	39	7	3900	1680	-2220	0.18	0.43	6	2	-4
0018	2F	24_5	14	31	8	3100	1480	-1620	0.26	0.48	5	2	-3
0018	2F	24_5	15	7	2	700	640	-60	0.29	0.91	1	1	0
0018	2F	24_5	16	2	0	200	0	-200	0.00	0.00	0	0	0
0018	2F	24_5	23	3	0	300	0	-300	0.00	0.00	0	0	0
0018	2F	24_6	12	28	12	2800	2500	-300	0.43	0.89	4	4	0
0018	2F	24_6	13	14	5	1400	900	-500	0.36	0.64	2	1	-1
0018	2F	24_6	14	8	4	800	800	0	0.50	1.00	1	1	0
0018	2F	24_6	15	2	0	200	0	-200	0.00	0.00	0	0	0
0018	2F	24_6	16	1	0	100	0	-100	0.00	0.00	0	0	0
0018	2F	24_6	26	1	0	100	0	-100	0.00	0.00	0	0	0
0018	2F	24_7	12	361	140	36100	31250	-4850	0.39	0.87	63	55	-8
0018	2F	24_7	13	124	46	12400	11770	-630	0.37	0.95	21	20	-1
0018	2F	24_7	14	58	16	5800	4700	-1100	0.28	0.81	10	8	-2
0018	2F	24_7	15	17	4	1700	1010	-690	0.24	0.59	3	1	-2
0018	2F	24_7	16	20	6	2000	1510	-490	0.30	0.76	3	2	-1
0018	2F	24_7	23	3	0	300	0	-300	0.00	0.00	0	0	0
0018	2F	24_7	24	1	0	100	0	-100	0.00	0.00	0	0	0
0018	2F	24_7	25	1	0	100	0	-100	0.00	0.00	0	0	0
0018	2F	24_7	26	1	1	100	750	650	1.00	7.50	0	1	1
0018	2T	01_1	12	285	70	28500	22320	-6180	0.25	0.78	50	39	-11
0018	2T	01_1	13	100	17	10000	7640	-2360	0.17	0.76	17	13	-4
0018	2T	01_1	14	41	7	4100	3440	-660	0.17	0.84	7	6	-1
0018	2T	01_1	15	46	6	4600	2330	-2270	0.13	0.51	8	4	-4
0018	2T	01_1	16	4	1	400	350	-50	0.25	0.88	0	0	0
0018	2T	01_1	21	7	0	700	0	-700	0.00	0.00	1	0	-1
0018	2T	01_1	23	2	1	200	2310	2110	0.50	11.55	0	4	4
0018	2T	01_1	24	4	2	400	880	480	0.50	2.20	0	1	1
0018	2T	01_1	25	1	0	100	0	-100	0.00	0.00	0	0	0
0018	2T	01_1	26	1	0	100	0	-100	0.00	0.00	0	0	0
0018	2T	01_2	12	247	32	24700	10900	-13800	0.13	0.44	43	19	-24
0018	2T	01_2	13	91	19	9100	5220	-3880	0.21	0.57	16	9	-7
0018	2T	01_2	14	54	8	5400	3410	-1990	0.15	0.63	9	6	-3
0018	2T	01_2	15	46	11	4600	3270	-1330	0.24	0.71	8	5	-3
0018	2T	01_2	16	8	0	800	0	-800	0.00	0.00	1	0	-1
0018	2T	01_2	21	1	0	100	0	-100	0.00	0.00	0	0	0
0018	2T	01_2	23	5	0	500	0	-500	0.00	0.00	0	0	0
0018	2T	01_2	24	4	0	400	0	-400	0.00	0.00	0	0	0
0018	2T	01_2	25	1	0	100	0	-100	0.00	0.00	0	0	0
0018	2T	01_2	26	4	1	400	710	310	0.25	1.78	0	1	1
0018	2T	01_3	12	245	62	24500	23740	-760	0.25	0.97	43	42	-1
0018	2T	01_3	13	84	19	8400	8180	-220	0.23	0.97	14	14	0
0018	2T	01_3	14	62	8	6200	4910	-1290	0.13	0.79	10	8	-2
0018	2T	01_3	15	35	9	3500	2820	-680	0.26	0.81	6	4	-2
0018	2T	01_3	16	5	1	500	750	250	0.20	1.50	0	1	1
0018	2T	01_3	21	4	1	400	330	-70	0.25	0.83	0	0	0
0018	2T	01_3	23	1	0	100	0	-100	0.00	0.00	0	0	0
0018	2T	01_3	24	4	0	400	0	-400	0.00	0.00	0	0	0
0018	2T	01_3	26	8	0	800	0	-800	0.00	0.00	1	0	-1
0018	2T	01_4	12	270	71	27000	21710	-5290	0.26	0.80	47	38	-9
0018	2T	01_4	13	73	19	7300	7650	350	0.26	1.05	12	13	1
0018	2T	01_4	14	35	6	3500	2710	-790	0.17	0.77	6	4	-2
0018	2T	01_4	15	28	7	2800	2370	-430	0.25	0.85	4	4	0
0018	2T	01_4	16	7	0	700	0	-700	0.00	0.00	1	0	-1
0018	2T	01_4	23	4	0	400	0	-400	0.00	0.00	0	0	0
0018	2T	01_4	24	4	1	400	500	100	0.25	1.25	0	0	0
0018	2T	01_4	25	6	1	600	860	260	0.17	1.43	1	1	0
0018	2T	01_4	26	3	0	300	0	-300	0.00	0.00	0	0	0
0018	2T	01_5	12	183	48	18300	16240	-2060	0.26	0.89	32	28	-4
0018	2T	01_5	13	70	14	7000	5190	-1810	0.20	0.74	12	9	-3
0018	2T	01_5	14	29	5	2900	2060	-840	0.17	0.71	5	3	-2
0018	2T	01_5	15	17	4	1700	2170	470	0.24	1.28	3	3	0
0018	2T	01_5	16	4	0	400	0	-400	0.00	0.00	0	0	0
0018	2T	01_5	23	1	0	100	0	-100	0.00	0.00	0	0	0
0018	2T	01_5	24	2	0	200	0	-200	0.00	0.00	0	0	0
0018	2T	01_5	25	1	0	100	0	-100	0.00	0.00	0	0	0
0018	2T	01_6	12	16	3	1600	650	-950	0.19	0.41	2	1	-1
0018	2T	01_6	13	2	0	200	0	-200	0.00	0.00	0	0	0
0018	2T	01_6	14	6	0	600	0	-600	0.00	0.00	1	0	-1
0018	2T	01_6	15	2	0	200	0	-200	0.00	0.00	0	0	0
0018	2T	01_6	16	1	0	100	0	-100	0.00	0.00	0	0	0
0018	2T	01_6	21	1	0	100	0	-100	0.00	0.00	0	0	0
0018	2T	01_7	12	291	82	29100	26160	-2940	0.28	0.90	51	46	-5
0018	2T	01_7	13	114	23	11400	9340	-2060	0.20	0.82	20	16	-4
0018	2T	01_7	14	64	12	6400	4460	-1940	0.19	0.70	11	7	-4
0018	2T	01_7	15	25	8	2500	2800	300	0.32	1.12	4	4	0
0018	2T	01_7	16	12	0	1200	0	-1200	0.00	0.00	2	0	-2
0018	2T	01_7	23	4	0	400	0	-400	0.00	0.00	0	0	0
0018	2T	01_7	24	1	0	100	0	-100	0.00	0.00	0	0	0
0018	2T	01_7	25	1	0	100	0	-100	0.00	0.00	0	0	0
0018	2T	01_7	26	2	1	200	650	450	0.50	3.25	0	1	1
0018	2T	02_1	12	265	52	26500	25100	-1400	0.20	0.95	46	44	-2
0018	2T	02_1	13	112	14	11200	8480	-2720	0.13	0.76	19	15	-4
0018	2T	02_1	14	64	7	6400	5490	-910	0.11	0.86	11	9	-2
0018	2T	02_1	15	9	1	900	440	-460	0.11	0.49	1	0	-1
0018	2T	02_1	16	10	1	1000	600	-400	0.10	0.60	1	1	0
0018	2T	02_1	21	18	1	1800	1480	-320	0.06	0.82	3	2	-1
0018	2T	02_1	23	3	0	300	0	-300	0.00	0.00	0	0	0
0018	2T	02_1	24	9	0	900	0	-900	0.00	0.00	1	0	-1
0018	2T	02_1	25	1	0	100	0	-100	0.00	0.00	0	0	0
0018	2T	02_1	26	8	0	800	0	-800	0.00	0.00	1	0	-1
0018	2T	02_2	12	277	53	27700	24890	-2810	0.19	0.90	49	44	-5
0018	2T	02_2	13	87	14	8700	6400	-2300	0.16	0.74	15	11	-4
0018	2T	02_2	14	64	10	6400	5260	-1140	0.16	0.82	11	9	-2
0018	2T	02_2	15	13	2	1300	1540	240	0.15	1.18	2	2	0
0018	2T	02_2	16	10	1	1000	580	-420	0.10	0.58	1	1	0
0018	2T	02_2	21	13	2	1300	1710	410	0.15	1.32	2	3	1
0018	2T	02_2	23	8	0	800	0	-800	0.00	0.00	1	0	-1
0018	2T	02_2	24	2	1	200	380	180	0.50	1.90	0	0	0
0018	2T	02_2	25	2	1	200	740	540	0.50	3.70	0	1	1
0018	2T	02_2	26	4	1	400	610	210	0.25	1.53	0	1	1
0018	2T	02_3	12	289	57	28900	27740	-1160	0.20	0.96	51	49	-2
0018	2T	02_3	13	98	18	9800	8040	-1760	0.18	0.82	17	14	-3
0018	2T	02_3	14	73	7	7300	4960	-2340	0.10	0.68	12	8	-4
0018	2T	02_3	15	7	1	700	660	-40	0.14	0.94	1	1	0
0018	2T	02_3	16	20	5	2000	5340	3340	0.25	2.67	3	9	6
0018	2T	02_3	21	17	2	1700	1450	-250	0.12	0.85	3	2	-1
0018	2T	02_3	23	6	3	600	2170	1570	0.50	3.62	1	3	2
0018	2T	02_3	24	8	0	800	0	-800	0.00	0.00	1	0	-1
0018	2T	02_3	26	10	0	1000	0	-1000	0.00	0.00	1	0	-1
0018	2T	02_4	12	184	40	18400	15520	-2880	0.22	0.84	32	27	-5
0018	2T	02_4	13	52	9	5200	2830	-2370	0.17	0.54	9	5	-4
0018	2T	02_4	14	50	6	5000	4200	-800	0.12	0.84	8	7	-1
0018	2T	02_4	15	8	1	800	2120	1320	0.13	2.65	1	3	2
0018	2T	02_4	16	2	0	200	0	-200	0.00	0.00	0	0	0
0018	2T	02_4	21	5	0	500	0	-500	0.00	0.00	0	0	0
0018	2T	02_4	23	6	2	600	1310	710	0.33	2.18	1	2	1
0018	2T	02_4	24	5	3	500	2070	1570	0.60	4.14	0	3	3
0018	2T	02_4	25	3	0	300	0	-300	0.00	0.00	0	0	0
0018	2T	02_4	26	2	1	200	720	520	0.50	3.60	0	1	1
0018	2T	02_5	12	135	33	13500	11570	-1930	0.24	0.86	23	20	-3
0018	2T	02_5	13	26	3	2600	970	-1630	0.12	0.37	4	1	-3
0018	2T	02_5	14	25	4	2500	2050	-450	0.16	0.82	4	3	-1
0018	2T	02_5	15	7	1	700	660	-40	0.14	0.94	1	1	0
0018	2T	02_5	16	7	0	700	0	-700	0.00	0.00	1	0	-1
0018	2T	02_5	21	1	0	100	0	-100	0.00	0.00	0	0	0
0018	2T	02_6	12	8	1	800	520	-280	0.13	0.65	1	0	-1
0018	2T	02_6	13	3	0	300	0	-300	0.00	0.00	0	0	0
0018	2T	02_6	14	1	1	100	360	260	1.00	3.60	0	0	0
0018	2T	02_7	12	304	66	30400	26170	-4230	0.22	0.86	53	46	-7
0018	2T	02_7	13	103	18	10300	7360	-2940	0.17	0.71	18	13	-5
0018	2T	02_7	14	67	11	6700	4890	-1810	0.16	0.73	11	8	-3
0018	2T	02_7	15	10	0	1000	0	-1000	0.00	0.00	1	0	-1
0018	2T	02_7	16	7	1	700	600	-100	0.14	0.86	1	1	0
0018	2T	02_7	21	5	0	500	0	-500	0.00	0.00	0	0	0
0018	2T	02_7	23	6	0	600	0	-600	0.00	0.00	1	0	-1
0018	2T	02_7	24	6	0	600	0	-600	0.00	0.00	1	0	-1
0018	2T	02_7	25	4	0	400	0	-400	0.00	0.00	0	0	0
0018	2T	02_7	26	6	0	600	0	-600	0.00	0.00	1	0	-1
0018	2T	03_1	12	176	38	17600	14490	-3110	0.22	0.82	31	25	-6
0018	2T	03_1	13	102	22	10200	9610	-590	0.22	0.94	18	17	-1
0018	2T	03_1	14	50	8	5000	4370	-630	0.16	0.87	8	7	-1
0018	2T	03_1	15	17	2	1700	1260	-440	0.12	0.74	3	2	-1
0018	2T	03_1	16	10	0	1000	0	-1000	0.00	0.00	1	0	-1
0018	2T	03_1	23	7	0	700	0	-700	0.00	0.00	1	0	-1
0018	2T	03_1	24	3	0	300	0	-300	0.00	0.00	0	0	0
0018	2T	03_1	25	2	1	200	530	330	0.50	2.65	0	0	0
0018	2T	03_1	26	2	0	200	0	-200	0.00	0.00	0	0	0
0018	2T	03_2	12	163	24	16300	9630	-6670	0.15	0.59	28	17	-11
0018	2T	03_2	13	69	16	6900	7670	770	0.23	1.11	12	13	1
0018	2T	03_2	14	47	8	4700	3050	-1650	0.17	0.65	8	5	-3
0018	2T	03_2	15	19	2	1900	1440	-460	0.11	0.76	3	2	-1
0018	2T	03_2	16	13	3	1300	4880	3580	0.23	3.75	2	8	6
0018	2T	03_2	23	6	3	600	1280	680	0.50	2.13	1	2	1
0018	2T	03_2	24	2	0	200	0	-200	0.00	0.00	0	0	0
0018	2T	03_2	25	4	0	400	0	-400	0.00	0.00	0	0	0
0018	2T	03_2	26	6	0	600	0	-600	0.00	0.00	1	0	-1
0018	2T	03_3	12	196	58	19600	20520	920	0.30	1.05	34	36	2
0018	2T	03_3	13	100	18	10000	9300	-700	0.18	0.93	17	16	-1
0018	2T	03_3	14	56	10	5600	3880	-1720	0.18	0.69	9	6	-3
0018	2T	03_3	15	24	4	2400	2630	230	0.17	1.10	4	4	0
0018	2T	03_3	16	19	3	1900	2560	660	0.16	1.35	3	4	1
0018	2T	03_3	23	10	2	1000	980	-20	0.20	0.98	1	1	0
0018	2T	03_3	24	3	0	300	0	-300	0.00	0.00	0	0	0
0018	2T	03_3	26	1	0	100	0	-100	0.00	0.00	0	0	0
0018	2T	03_4	12	119	26	11900	10480	-1420	0.22	0.88	21	18	-3
0018	2T	03_4	13	64	15	6400	6170	-230	0.23	0.96	11	10	-1
0018	2T	03_4	14	33	7	3300	2600	-700	0.21	0.79	5	4	-1
0018	2T	03_4	15	16	0	1600	0	-1600	0.00	0.00	2	0	-2
0018	2T	03_4	16	6	0	600	0	-600	0.00	0.00	1	0	-1
0018	2T	03_4	23	3	0	300	0	-300	0.00	0.00	0	0	0
0018	2T	03_4	24	1	0	100	0	-100	0.00	0.00	0	0	0
0018	2T	03_4	26	1	0	100	0	-100	0.00	0.00	0	0	0
0018	2T	03_5	12	84	27	8400	8560	160	0.32	1.02	14	15	1
0018	2T	03_5	13	29	1	2900	280	-2620	0.03	0.10	5	0	-5
0018	2T	03_5	14	12	0	1200	0	-1200	0.00	0.00	2	0	-2
0018	2T	03_5	15	12	3	1200	2550	1350	0.25	2.13	2	4	2
0018	2T	03_5	16	7	1	700	510	-190	0.14	0.73	1	0	-1
0018	2T	03_5	24	1	0	100	0	-100	0.00	0.00	0	0	0
0018	2T	03_5	26	1	0	100	0	-100	0.00	0.00	0	0	0
0018	2T	03_7	12	184	35	18400	14130	-4270	0.19	0.77	32	25	-7
0018	2T	03_7	13	101	25	10100	11290	1190	0.25	1.12	17	19	2
0018	2T	03_7	14	35	4	3500	1690	-1810	0.11	0.48	6	2	-4
0018	2T	03_7	15	23	3	2300	2730	430	0.13	1.19	4	4	0
0018	2T	03_7	16	15	0	1500	0	-1500	0.00	0.00	2	0	-2
0018	2T	03_7	21	1	0	100	0	-100	0.00	0.00	0	0	0
0018	2T	03_7	23	4	0	400	0	-400	0.00	0.00	0	0	0
0018	2T	03_7	24	1	0	100	0	-100	0.00	0.00	0	0	0
0018	2T	03_7	25	3	1	300	420	120	0.33	1.40	0	0	0
0018	2T	03_7	26	2	0	200	0	-200	0.00	0.00	0	0	0
0018	2T	04_1	12	193	41	19300	18760	-540	0.21	0.97	34	33	-1
0018	2T	04_1	13	99	18	9900	6650	-3250	0.18	0.67	17	11	-6
0018	2T	04_1	14	84	11	8400	5360	-3040	0.13	0.64	14	9	-5
0018	2T	04_1	15	17	3	1700	1300	-400	0.18	0.76	3	2	-1
0018	2T	04_1	16	16	5	1600	4630	3030	0.31	2.89	2	8	6
0018	2T	04_1	24	7	1	700	510	-190	0.14	0.73	1	0	-1
0018	2T	04_1	25	1	0	100	0	-100	0.00	0.00	0	0	0
0018	2T	04_1	26	7	0	700	0	-700	0.00	0.00	1	0	-1
0018	2T	04_2	12	187	40	18700	16920	-1780	0.21	0.90	33	29	-4
0018	2T	04_2	13	110	23	11000	10570	-430	0.21	0.96	19	18	-1
0018	2T	04_2	14	66	7	6600	3430	-3170	0.11	0.52	11	6	-5
0018	2T	04_2	15	26	1	2600	660	-1940	0.04	0.25	4	1	-3
0018	2T	04_2	16	15	2	1500	950	-550	0.13	0.63	2	1	-1
0018	2T	04_2	21	1	0	100	0	-100	0.00	0.00	0	0	0
0018	2T	04_2	23	4	1	400	220	-180	0.25	0.55	0	0	0
0018	2T	04_2	24	3	0	300	0	-300	0.00	0.00	0	0	0
0018	2T	04_2	25	2	0	200	0	-200	0.00	0.00	0	0	0
0018	2T	04_2	26	3	0	300	0	-300	0.00	0.00	0	0	0
0018	2T	04_3	12	228	50	22800	21540	-1260	0.22	0.94	40	38	-2
0018	2T	04_3	13	113	25	11300	11180	-120	0.22	0.99	20	19	-1
0018	2T	04_3	14	37	5	3700	1790	-1910	0.14	0.48	6	3	-3
0018	2T	04_3	15	17	2	1700	1110	-590	0.12	0.65	3	1	-2
0018	2T	04_3	16	13	3	1300	1890	590	0.23	1.45	2	3	1
0018	2T	04_3	21	2	0	200	0	-200	0.00	0.00	0	0	0
0018	2T	04_3	23	7	1	700	1010	310	0.14	1.44	1	1	0
0018	2T	04_3	24	3	0	300	0	-300	0.00	0.00	0	0	0
0018	2T	04_3	25	4	1	400	940	540	0.25	2.35	0	1	1
0018	2T	04_3	26	2	0	200	0	-200	0.00	0.00	0	0	0
0018	2T	04_4	12	153	27	15300	11980	-3320	0.18	0.78	27	21	-6
0018	2T	04_4	13	90	28	9000	10160	1160	0.31	1.13	15	17	2
0018	2T	04_4	14	41	10	4100	3400	-700	0.24	0.83	7	6	-1
0018	2T	04_4	15	12	2	1200	790	-410	0.17	0.66	2	1	-1
0018	2T	04_4	16	8	2	800	720	-80	0.25	0.90	1	1	0
0018	2T	04_4	21	2	1	200	540	340	0.50	2.70	0	0	0
0018	2T	04_4	23	2	0	200	0	-200	0.00	0.00	0	0	0
0018	2T	04_4	24	2	0	200	0	-200	0.00	0.00	0	0	0
0018	2T	04_4	25	3	0	300	0	-300	0.00	0.00	0	0	0
0018	2T	04_5	12	143	27	14300	8280	-6020	0.19	0.58	25	14	-11
0018	2T	04_5	13	72	11	7200	4300	-2900	0.15	0.60	12	7	-5
0018	2T	04_5	14	27	5	2700	2920	220	0.19	1.08	4	5	1
0018	2T	04_5	15	17	0	1700	0	-1700	0.00	0.00	3	0	-3
0018	2T	04_5	16	26	3	2600	2840	240	0.12	1.09	4	5	1
0018	2T	04_5	23	2	1	200	1180	980	0.50	5.90	0	2	2
0018	2T	04_5	24	3	0	300	0	-300	0.00	0.00	0	0	0
0018	2T	04_5	25	3	1	300	1120	820	0.33	3.73	0	1	1
0018	2T	04_5	26	4	0	400	0	-400	0.00	0.00	0	0	0
0018	2T	04_7	12	192	43	19200	18080	-1120	0.22	0.94	33	32	-1
0018	2T	04_7	13	95	19	9500	7480	-2020	0.20	0.79	16	13	-3
0018	2T	04_7	14	43	5	4300	4640	340	0.12	1.08	7	8	1
0018	2T	04_7	15	28	3	2800	2050	-750	0.11	0.73	4	3	-1
0018	2T	04_7	16	14	1	1400	500	-900	0.07	0.36	2	0	-2
0018	2T	04_7	21	2	0	200	0	-200	0.00	0.00	0	0	0
0018	2T	04_7	23	5	1	500	390	-110	0.20	0.78	0	0	0
0018	2T	04_7	24	3	0	300	0	-300	0.00	0.00	0	0	0
0018	2T	04_7	25	3	0	300	0	-300	0.00	0.00	0	0	0
0018	2T	04_7	26	6	0	600	0	-600	0.00	0.00	1	0	-1
0018	2T	05_1	12	267	66	26700	25440	-1260	0.25	0.95	47	45	-2
0018	2T	05_1	13	119	21	11900	7440	-4460	0.18	0.63	21	13	-8
0018	2T	05_1	14	70	17	7000	6770	-230	0.24	0.97	12	11	-1
0018	2T	05_1	15	16	2	1600	860	-740	0.13	0.54	2	1	-1
0018	2T	05_1	16	6	0	600	0	-600	0.00	0.00	1	0	-1
0018	2T	05_1	21	7	0	700	0	-700	0.00	0.00	1	0	-1
0018	2T	05_1	23	1	0	100	0	-100	0.00	0.00	0	0	0
0018	2T	05_1	24	1	1	100	880	780	1.00	8.80	0	1	1
0018	2T	05_1	25	3	0	300	0	-300	0.00	0.00	0	0	0
0018	2T	05_1	26	3	0	300	0	-300	0.00	0.00	0	0	0
0018	2T	05_2	12	234	54	23400	18920	-4480	0.23	0.81	41	33	-8
0018	2T	05_2	13	105	23	10500	7700	-2800	0.22	0.73	18	13	-5
0018	2T	05_2	14	73	15	7300	5000	-2300	0.21	0.68	12	8	-4
0018	2T	05_2	15	22	5	2200	3860	1660	0.23	1.75	3	6	3
0018	2T	05_2	16	10	0	1000	0	-1000	0.00	0.00	1	0	-1
0018	2T	05_2	21	6	0	600	0	-600	0.00	0.00	1	0	-1
0018	2T	05_2	23	2	0	200	0	-200	0.00	0.00	0	0	0
0018	2T	05_2	24	11	4	1100	1780	680	0.36	1.62	1	3	2
0018	2T	05_2	25	3	0	300	0	-300	0.00	0.00	0	0	0
0018	2T	05_2	26	8	1	800	540	-260	0.13	0.68	1	0	-1
0018	2T	05_3	12	229	53	22900	22390	-510	0.23	0.98	40	39	-1
0018	2T	05_3	13	89	18	8900	6570	-2330	0.20	0.74	15	11	-4
0018	2T	05_3	14	74	10	7400	3680	-3720	0.14	0.50	13	6	-7
0018	2T	05_3	15	18	2	1800	1430	-370	0.11	0.79	3	2	-1
0018	2T	05_3	16	18	2	1800	2160	360	0.11	1.20	3	3	0
0018	2T	05_3	21	4	1	400	790	390	0.25	1.98	0	1	1
0018	2T	05_3	23	7	0	700	0	-700	0.00	0.00	1	0	-1
0018	2T	05_3	24	5	2	500	760	260	0.40	1.52	0	1	1
0018	2T	05_3	25	2	0	200	0	-200	0.00	0.00	0	0	0
0018	2T	05_3	26	7	1	700	510	-190	0.14	0.73	1	0	-1
0018	2T	05_4	12	203	54	20300	19040	-1260	0.27	0.94	35	33	-2
0018	2T	05_4	13	94	19	9400	6520	-2880	0.20	0.69	16	11	-5
0018	2T	05_4	14	45	17	4500	6160	1660	0.38	1.37	7	10	3
0018	2T	05_4	15	17	1	1700	320	-1380	0.06	0.19	3	0	-3
0018	2T	05_4	16	1	0	100	0	-100	0.00	0.00	0	0	0
0018	2T	05_4	21	2	1	200	1120	920	0.50	5.60	0	1	1
0018	2T	05_4	23	7	1	700	300	-400	0.14	0.43	1	0	-1
0018	2T	05_4	24	2	0	200	0	-200	0.00	0.00	0	0	0
0018	2T	05_4	25	4	1	400	430	30	0.25	1.08	0	0	0
0018	2T	05_4	26	1	0	100	0	-100	0.00	0.00	0	0	0
0018	2T	05_5	12	154	29	15400	10300	-5100	0.19	0.67	27	18	-9
0018	2T	05_5	13	61	12	6100	4060	-2040	0.20	0.67	10	7	-3
0018	2T	05_5	14	42	14	4200	5050	850	0.33	1.20	7	8	1
0018	2T	05_5	15	15	3	1500	1230	-270	0.20	0.82	2	2	0
0018	2T	05_5	16	4	0	400	0	-400	0.00	0.00	0	0	0
0018	2T	05_5	21	3	0	300	0	-300	0.00	0.00	0	0	0
0018	2T	05_5	23	1	0	100	0	-100	0.00	0.00	0	0	0
0018	2T	05_5	24	1	0	100	0	-100	0.00	0.00	0	0	0
0018	2T	05_5	26	1	0	100	0	-100	0.00	0.00	0	0	0
0018	2T	05_6	12	4	1	400	260	-140	0.25	0.65	0	0	0
0018	2T	05_6	13	1	0	100	0	-100	0.00	0.00	0	0	0
0018	2T	05_6	14	2	0	200	0	-200	0.00	0.00	0	0	0
0018	2T	05_6	15	1	0	100	0	-100	0.00	0.00	0	0	0
0018	2T	05_6	16	2	2	200	1530	1330	1.00	7.65	0	2	2
0018	2T	05_7	12	228	45	22800	17890	-4910	0.20	0.78	40	31	-9
0018	2T	05_7	13	107	19	10700	6840	-3860	0.18	0.64	18	12	-6
0018	2T	05_7	14	64	10	6400	3560	-2840	0.16	0.56	11	6	-5
0018	2T	05_7	15	21	2	2100	800	-1300	0.10	0.38	3	1	-2
0018	2T	05_7	16	16	4	1600	3370	1770	0.25	2.11	2	5	3
0018	2T	05_7	21	2	0	200	0	-200	0.00	0.00	0	0	0
0018	2T	05_7	23	7	0	700	0	-700	0.00	0.00	1	0	-1
0018	2T	05_7	24	5	0	500	0	-500	0.00	0.00	0	0	0
0018	2T	05_7	25	2	1	200	770	570	0.50	3.85	0	1	1
0018	2T	05_7	26	5	0	500	0	-500	0.00	0.00	0	0	0
0018	2T	06_1	12	280	59	28000	20800	-7200	0.21	0.74	49	36	-13
0018	2T	06_1	13	147	35	14700	14450	-250	0.24	0.98	26	25	-1
0018	2T	06_1	14	61	14	6100	6490	390	0.23	1.06	10	11	1
0018	2T	06_1	15	19	4	1900	1410	-490	0.21	0.74	3	2	-1
0018	2T	06_1	16	12	3	1200	1590	390	0.25	1.33	2	2	0
0018	2T	06_1	21	8	3	800	2960	2160	0.38	3.70	1	5	4
0018	2T	06_1	23	1	0	100	0	-100	0.00	0.00	0	0	0
0018	2T	06_1	24	4	0	400	0	-400	0.00	0.00	0	0	0
0018	2T	06_1	25	1	0	100	0	-100	0.00	0.00	0	0	0
0018	2T	06_1	26	4	0	400	0	-400	0.00	0.00	0	0	0
0018	2T	06_2	12	271	60	27100	23730	-3370	0.22	0.88	47	42	-5
0018	2T	06_2	13	126	24	12600	7710	-4890	0.19	0.61	22	13	-9
0018	2T	06_2	14	74	14	7400	5560	-1840	0.19	0.75	13	9	-4
0018	2T	06_2	15	16	1	1600	370	-1230	0.06	0.23	2	0	-2
0018	2T	06_2	16	10	1	1000	640	-360	0.10	0.64	1	1	0
0018	2T	06_2	21	6	0	600	0	-600	0.00	0.00	1	0	-1
0018	2T	06_2	23	3	0	300	0	-300	0.00	0.00	0	0	0
0018	2T	06_2	24	4	1	400	720	320	0.25	1.80	0	1	1
0018	2T	06_2	25	3	0	300	0	-300	0.00	0.00	0	0	0
0018	2T	06_2	26	7	0	700	0	-700	0.00	0.00	1	0	-1
0018	2T	06_3	12	261	64	26100	25540	-560	0.25	0.98	46	45	-1
0018	2T	06_3	13	123	19	12300	6380	-5920	0.15	0.52	21	11	-10
0018	2T	06_3	14	76	17	7600	6460	-1140	0.22	0.85	13	11	-2
0018	2T	06_3	15	15	3	1500	1080	-420	0.20	0.72	2	1	-1
0018	2T	06_3	16	6	1	600	1500	900	0.17	2.50	1	2	1
0018	2T	06_3	21	10	0	1000	0	-1000	0.00	0.00	1	0	-1
0018	2T	06_3	23	6	1	600	1610	1010	0.17	2.68	1	2	1
0018	2T	06_3	24	4	1	400	780	380	0.25	1.95	0	1	1
0018	2T	06_3	25	6	1	600	5180	4580	0.17	8.63	1	9	8
0018	2T	06_3	26	4	0	400	0	-400	0.00	0.00	0	0	0
0018	2T	06_4	12	174	38	17400	12650	-4750	0.22	0.73	30	22	-8
0018	2T	06_4	13	86	13	8600	6470	-2130	0.15	0.75	15	11	-4
0018	2T	06_4	14	37	3	3700	1130	-2570	0.08	0.31	6	2	-4
0018	2T	06_4	15	11	0	1100	0	-1100	0.00	0.00	1	0	-1
0018	2T	06_4	16	5	0	500	0	-500	0.00	0.00	0	0	0
0018	2T	06_4	21	7	0	700	0	-700	0.00	0.00	1	0	-1
0018	2T	06_4	23	4	0	400	0	-400	0.00	0.00	0	0	0
0018	2T	06_4	24	6	0	600	0	-600	0.00	0.00	1	0	-1
0018	2T	06_4	25	6	0	600	0	-600	0.00	0.00	1	0	-1
0018	2T	06_4	26	4	0	400	0	-400	0.00	0.00	0	0	0
0018	2T	06_5	12	110	23	11000	9840	-1160	0.21	0.89	19	17	-2
0018	2T	06_5	13	47	7	4700	2620	-2080	0.15	0.56	8	4	-4
0018	2T	06_5	14	29	6	2900	5100	2200	0.21	1.76	5	9	4
0018	2T	06_5	15	9	4	900	2300	1400	0.44	2.56	1	4	3
0018	2T	06_5	16	9	1	900	350	-550	0.11	0.39	1	0	-1
0018	2T	06_5	21	7	1	700	820	120	0.14	1.17	1	1	0
0018	2T	06_5	23	1	0	100	0	-100	0.00	0.00	0	0	0
0018	2T	06_5	24	2	0	200	0	-200	0.00	0.00	0	0	0
0018	2T	06_5	26	3	0	300	0	-300	0.00	0.00	0	0	0
0018	2T	06_6	12	14	4	1400	3470	2070	0.29	2.48	2	6	4
0018	2T	06_6	13	5	0	500	0	-500	0.00	0.00	0	0	0
0018	2T	06_6	14	5	1	500	1150	650	0.20	2.30	0	2	2
0018	2T	06_6	16	2	0	200	0	-200	0.00	0.00	0	0	0
0018	2T	06_6	21	2	0	200	0	-200	0.00	0.00	0	0	0
0018	2T	06_7	12	299	74	29900	23460	-6440	0.25	0.78	52	41	-11
0018	2T	06_7	13	143	26	14300	8010	-6290	0.18	0.56	25	14	-11
0018	2T	06_7	14	90	19	9000	7870	-1130	0.21	0.87	15	13	-2
0018	2T	06_7	15	15	3	1500	1150	-350	0.20	0.77	2	2	0
0018	2T	06_7	16	11	3	1100	3110	2010	0.27	2.83	1	5	4
0018	2T	06_7	21	5	0	500	0	-500	0.00	0.00	0	0	0
0018	2T	06_7	23	3	0	300	0	-300	0.00	0.00	0	0	0
0018	2T	06_7	24	8	1	800	1510	710	0.13	1.89	1	2	1
0018	2T	06_7	25	3	0	300	0	-300	0.00	0.00	0	0	0
0018	2T	06_7	26	4	0	400	0	-400	0.00	0.00	0	0	0
0018	2T	07_1	12	238	53	23800	22380	-1420	0.22	0.94	42	39	-3
0018	2T	07_1	13	134	29	13400	9730	-3670	0.22	0.73	23	17	-6
0018	2T	07_1	14	54	13	5400	3910	-1490	0.24	0.72	9	6	-3
0018	2T	07_1	15	26	4	2600	1680	-920	0.15	0.65	4	2	-2
0018	2T	07_1	16	15	3	1500	1480	-20	0.20	0.99	2	2	0
0018	2T	07_1	21	1	0	100	0	-100	0.00	0.00	0	0	0
0018	2T	07_1	23	9	2	900	1710	810	0.22	1.90	1	3	2
0018	2T	07_1	24	1	0	100	0	-100	0.00	0.00	0	0	0
0018	2T	07_1	25	6	0	600	0	-600	0.00	0.00	1	0	-1
0018	2T	07_1	26	6	0	600	0	-600	0.00	0.00	1	0	-1
0018	2T	07_2	12	215	49	21500	21920	420	0.23	1.02	38	38	0
0018	2T	07_2	13	137	36	13700	11140	-2560	0.26	0.81	24	19	-5
0018	2T	07_2	14	80	20	8000	7880	-120	0.25	0.99	14	13	-1
0018	2T	07_2	15	28	5	2800	2110	-690	0.18	0.75	4	3	-1
0018	2T	07_2	16	16	5	1600	2340	740	0.31	1.46	2	4	2
0018	2T	07_2	21	1	0	100	0	-100	0.00	0.00	0	0	0
0018	2T	07_2	23	3	1	300	360	60	0.33	1.20	0	0	0
0018	2T	07_2	24	5	0	500	0	-500	0.00	0.00	0	0	0
0018	2T	07_2	25	1	0	100	0	-100	0.00	0.00	0	0	0
0018	2T	07_2	26	9	1	900	980	80	0.11	1.09	1	1	0
0018	2T	07_3	12	250	58	25000	19650	-5350	0.23	0.79	44	34	-10
0018	2T	07_3	13	127	27	12700	9170	-3530	0.21	0.72	22	16	-6
0018	2T	07_3	14	60	14	6000	6030	30	0.23	1.01	10	10	0
0018	2T	07_3	15	15	1	1500	450	-1050	0.07	0.30	2	0	-2
0018	2T	07_3	16	18	5	1800	3730	1930	0.28	2.07	3	6	3
0018	2T	07_3	23	8	0	800	0	-800	0.00	0.00	1	0	-1
0018	2T	07_3	24	2	0	200	0	-200	0.00	0.00	0	0	0
0018	2T	07_3	25	6	0	600	0	-600	0.00	0.00	1	0	-1
0018	2T	07_3	26	3	0	300	0	-300	0.00	0.00	0	0	0
0018	2T	07_4	12	214	52	21400	16950	-4450	0.24	0.79	37	30	-7
0018	2T	07_4	13	123	27	12300	11110	-1190	0.22	0.90	21	19	-2
0018	2T	07_4	14	55	16	5500	4840	-660	0.29	0.88	9	8	-1
0018	2T	07_4	15	18	3	1800	1540	-260	0.17	0.86	3	2	-1
0018	2T	07_4	16	4	2	400	2860	2460	0.50	7.15	0	5	5
0018	2T	07_4	21	2	1	200	480	280	0.50	2.40	0	0	0
0018	2T	07_4	23	7	0	700	0	-700	0.00	0.00	1	0	-1
0018	2T	07_4	24	1	0	100	0	-100	0.00	0.00	0	0	0
0018	2T	07_4	25	4	0	400	0	-400	0.00	0.00	0	0	0
0018	2T	07_4	26	2	1	200	240	40	0.50	1.20	0	0	0
0018	2T	07_5	12	173	45	17300	14110	-3190	0.26	0.82	30	24	-6
0018	2T	07_5	13	85	22	8500	8830	330	0.26	1.04	15	15	0
0018	2T	07_5	14	50	10	5000	2930	-2070	0.20	0.59	8	5	-3
0018	2T	07_5	15	15	3	1500	1790	290	0.20	1.19	2	3	1
0018	2T	07_5	16	11	3	1100	1780	680	0.27	1.62	1	3	2
0018	2T	07_5	23	1	0	100	0	-100	0.00	0.00	0	0	0
0018	2T	07_6	12	23	4	2300	1250	-1050	0.17	0.54	4	2	-2
0018	2T	07_6	13	16	2	1600	690	-910	0.13	0.43	2	1	-1
0018	2T	07_6	14	8	3	800	1170	370	0.38	1.46	1	2	1
0018	2T	07_6	15	4	0	400	0	-400	0.00	0.00	0	0	0
0018	2T	07_6	16	1	0	100	0	-100	0.00	0.00	0	0	0
0018	2T	07_7	12	281	76	28100	25850	-2250	0.27	0.92	49	45	-4
0018	2T	07_7	13	142	36	14200	11990	-2210	0.25	0.84	25	21	-4
0018	2T	07_7	14	62	11	6200	3670	-2530	0.18	0.59	10	6	-4
0018	2T	07_7	15	14	2	1400	700	-700	0.14	0.50	2	1	-1
0018	2T	07_7	16	8	0	800	0	-800	0.00	0.00	1	0	-1
0018	2T	07_7	21	1	0	100	0	-100	0.00	0.00	0	0	0
0018	2T	07_7	23	3	0	300	0	-300	0.00	0.00	0	0	0
0018	2T	07_7	24	1	0	100	0	-100	0.00	0.00	0	0	0
0018	2T	07_7	25	1	0	100	0	-100	0.00	0.00	0	0	0
0018	2T	07_7	26	1	0	100	0	-100	0.00	0.00	0	0	0
0018	2T	08_1	12	291	76	29100	24560	-4540	0.26	0.84	51	43	-8
0018	2T	08_1	13	156	30	15600	11250	-4350	0.19	0.72	27	19	-8
0018	2T	08_1	14	65	11	6500	4740	-1760	0.17	0.73	11	8	-3
0018	2T	08_1	15	22	2	2200	2540	340	0.09	1.15	3	4	1
0018	2T	08_1	16	54	8	5400	3870	-1530	0.15	0.72	9	6	-3
0018	2T	08_1	23	2	0	200	0	-200	0.00	0.00	0	0	0
0018	2T	08_1	24	1	0	100	0	-100	0.00	0.00	0	0	0
0018	2T	08_1	25	2	0	200	0	-200	0.00	0.00	0	0	0
0018	2T	08_1	26	5	0	500	0	-500	0.00	0.00	0	0	0
0018	2T	08_2	12	312	77	31200	25580	-5620	0.25	0.82	55	45	-10
0018	2T	08_2	13	147	35	14700	12330	-2370	0.24	0.84	26	21	-5
0018	2T	08_2	14	74	22	7400	6910	-490	0.30	0.93	13	12	-1
0018	2T	08_2	15	28	6	2800	2690	-110	0.21	0.96	4	4	0
0018	2T	08_2	16	37	9	3700	3900	200	0.24	1.05	6	6	0
0018	2T	08_2	21	2	0	200	0	-200	0.00	0.00	0	0	0
0018	2T	08_2	23	4	2	400	600	200	0.50	1.50	0	1	1
0018	2T	08_2	26	1	0	100	0	-100	0.00	0.00	0	0	0
0018	2T	08_3	12	318	87	31800	28740	-3060	0.27	0.90	56	50	-6
0018	2T	08_3	13	135	29	13500	10740	-2760	0.21	0.80	23	19	-4
0018	2T	08_3	14	76	19	7600	7520	-80	0.25	0.99	13	13	0
0018	2T	08_3	15	20	1	2000	960	-1040	0.05	0.48	3	1	-2
0018	2T	08_3	16	9	0	900	0	-900	0.00	0.00	1	0	-1
0018	2T	08_3	21	4	1	400	860	460	0.25	2.15	0	1	1
0018	2T	08_3	23	6	1	600	810	210	0.17	1.35	1	1	0
0018	2T	08_3	24	8	0	800	0	-800	0.00	0.00	1	0	-1
0018	2T	08_3	25	4	0	400	0	-400	0.00	0.00	0	0	0
0018	2T	08_3	26	1	0	100	0	-100	0.00	0.00	0	0	0
0018	2T	08_4	12	109	30	10900	10030	-870	0.28	0.92	19	17	-2
0018	2T	08_4	13	43	11	4300	3500	-800	0.26	0.81	7	6	-1
0018	2T	08_4	14	19	3	1900	1490	-410	0.16	0.78	3	2	-1
0018	2T	08_4	15	9	1	900	800	-100	0.11	0.89	1	1	0
0018	2T	08_4	16	2	1	200	460	260	0.50	2.30	0	0	0
0018	2T	08_4	21	1	0	100	0	-100	0.00	0.00	0	0	0
0018	2T	08_4	23	2	0	200	0	-200	0.00	0.00	0	0	0
0018	2T	08_4	25	2	0	200	0	-200	0.00	0.00	0	0	0
0018	2T	08_5	12	65	13	6500	3370	-3130	0.20	0.52	11	5	-6
0018	2T	08_5	13	47	8	4700	2490	-2210	0.17	0.53	8	4	-4
0018	2T	08_5	14	20	1	2000	360	-1640	0.05	0.18	3	0	-3
0018	2T	08_5	15	6	1	600	360	-240	0.17	0.60	1	0	-1
0018	2T	08_5	16	3	1	300	670	370	0.33	2.23	0	1	1
0018	2T	08_5	21	1	0	100	0	-100	0.00	0.00	0	0	0
0018	2T	08_6	12	12	4	1200	940	-260	0.33	0.78	2	1	-1
0018	2T	08_6	13	9	2	900	720	-180	0.22	0.80	1	1	0
0018	2T	08_6	15	1	0	100	0	-100	0.00	0.00	0	0	0
0018	2T	08_7	12	361	93	36100	28570	-7530	0.26	0.79	63	50	-13
0018	2T	08_7	13	150	32	15000	10150	-4850	0.21	0.68	26	17	-9
0018	2T	08_7	14	66	11	6600	4430	-2170	0.17	0.67	11	7	-4
0018	2T	08_7	15	22	4	2200	2550	350	0.18	1.16	3	4	1
0018	2T	08_7	16	13	3	1300	1440	140	0.23	1.11	2	2	0
0018	2T	08_7	21	1	0	100	0	-100	0.00	0.00	0	0	0
0018	2T	08_7	23	4	0	400	0	-400	0.00	0.00	0	0	0
0018	2T	08_7	24	4	1	400	480	80	0.25	1.20	0	0	0
0018	2T	08_7	25	3	1	300	520	220	0.33	1.73	0	0	0
0018	2T	08_7	26	6	1	600	720	120	0.17	1.20	1	1	0
0018	2T	09_1	12	313	78	31300	24930	-6370	0.25	0.80	55	44	-11
0018	2T	09_1	13	97	25	9700	8660	-1040	0.26	0.89	17	15	-2
0018	2T	09_1	14	22	0	2200	0	-2200	0.00	0.00	3	0	-3
0018	2T	09_1	15	13	2	1300	1310	10	0.15	1.01	2	2	0
0018	2T	09_1	16	7	0	700	0	-700	0.00	0.00	1	0	-1
0018	2T	09_1	21	6	0	600	0	-600	0.00	0.00	1	0	-1
0018	2T	09_1	23	2	1	200	550	350	0.50	2.75	0	0	0
0018	2T	09_1	24	6	0	600	0	-600	0.00	0.00	1	0	-1
0018	2T	09_1	25	3	0	300	0	-300	0.00	0.00	0	0	0
0018	2T	09_1	26	7	0	700	0	-700	0.00	0.00	1	0	-1
0018	2T	09_2	12	263	68	26300	23690	-2610	0.26	0.90	46	41	-5
0018	2T	09_2	13	106	21	10600	6350	-4250	0.20	0.60	18	11	-7
0018	2T	09_2	14	51	11	5100	3830	-1270	0.22	0.75	9	6	-3
0018	2T	09_2	15	17	1	1700	430	-1270	0.06	0.25	3	0	-3
0018	2T	09_2	16	12	1	1200	690	-510	0.08	0.58	2	1	-1
0018	2T	09_2	21	7	0	700	0	-700	0.00	0.00	1	0	-1
0018	2T	09_2	23	6	2	600	1190	590	0.33	1.98	1	2	1
0018	2T	09_2	24	3	0	300	0	-300	0.00	0.00	0	0	0
0018	2T	09_2	25	1	0	100	0	-100	0.00	0.00	0	0	0
0018	2T	09_2	26	5	0	500	0	-500	0.00	0.00	0	0	0
0018	2T	09_3	12	253	56	25300	19550	-5750	0.22	0.77	44	34	-10
0018	2T	09_3	13	109	21	10900	6450	-4450	0.19	0.59	19	11	-8
0018	2T	09_3	14	49	8	4900	2720	-2180	0.16	0.56	8	4	-4
0018	2T	09_3	15	24	5	2400	2130	-270	0.21	0.89	4	3	-1
0018	2T	09_3	16	10	2	1000	1120	120	0.20	1.12	1	1	0
0018	2T	09_3	21	5	1	500	1460	960	0.20	2.92	0	2	2
0018	2T	09_3	23	4	0	400	0	-400	0.00	0.00	0	0	0
0018	2T	09_3	24	3	0	300	0	-300	0.00	0.00	0	0	0
0018	2T	09_3	26	11	0	1100	0	-1100	0.00	0.00	1	0	-1
0018	2T	09_4	12	231	59	23100	17270	-5830	0.26	0.75	40	30	-10
0018	2T	09_4	13	81	15	8100	5030	-3070	0.19	0.62	14	8	-6
0018	2T	09_4	14	39	8	3900	3380	-520	0.21	0.87	6	5	-1
0018	2T	09_4	15	23	3	2300	780	-1520	0.13	0.34	4	1	-3
0018	2T	09_4	16	8	2	800	1860	1060	0.25	2.33	1	3	2
0018	2T	09_4	21	5	1	500	1760	1260	0.20	3.52	0	3	3
0018	2T	09_4	23	5	0	500	0	-500	0.00	0.00	0	0	0
0018	2T	09_4	24	3	0	300	0	-300	0.00	0.00	0	0	0
0018	2T	09_4	25	1	0	100	0	-100	0.00	0.00	0	0	0
0018	2T	09_4	26	8	1	800	1260	460	0.13	1.58	1	2	1
0018	2T	09_5	12	280	94	28000	23610	-4390	0.34	0.84	49	41	-8
0018	2T	09_5	13	97	21	9700	7150	-2550	0.22	0.74	17	12	-5
0018	2T	09_5	14	40	8	4000	2590	-1410	0.20	0.65	7	4	-3
0018	2T	09_5	15	9	1	900	260	-640	0.11	0.29	1	0	-1
0018	2T	09_5	16	10	1	1000	780	-220	0.10	0.78	1	1	0
0018	2T	09_5	21	1	0	100	0	-100	0.00	0.00	0	0	0
0018	2T	09_5	23	1	0	100	0	-100	0.00	0.00	0	0	0
0018	2T	09_5	26	1	0	100	0	-100	0.00	0.00	0	0	0
0018	2T	09_7	12	349	118	34900	30390	-4510	0.34	0.87	61	53	-8
0018	2T	09_7	13	115	33	11500	11860	360	0.29	1.03	20	20	0
0018	2T	09_7	14	68	10	6800	3080	-3720	0.15	0.45	12	5	-7
0018	2T	09_7	15	11	1	1100	410	-690	0.09	0.37	1	0	-1
0018	2T	09_7	16	13	0	1300	0	-1300	0.00	0.00	2	0	-2
0018	2T	09_7	23	2	0	200	0	-200	0.00	0.00	0	0	0
0018	2T	09_7	24	1	0	100	0	-100	0.00	0.00	0	0	0
0018	2T	09_7	25	1	0	100	0	-100	0.00	0.00	0	0	0
0018	2T	09_7	26	1	0	100	0	-100	0.00	0.00	0	0	0
0018	2T	10_1	12	231	65	23100	20400	-2700	0.28	0.88	40	36	-4
0018	2T	10_1	13	85	25	8500	6620	-1880	0.29	0.78	15	11	-4
0018	2T	10_1	14	44	5	4400	2100	-2300	0.11	0.48	7	3	-4
0018	2T	10_1	15	4	1	400	570	170	0.25	1.43	0	1	1
0018	2T	10_1	16	7	0	700	0	-700	0.00	0.00	1	0	-1
0018	2T	10_1	21	22	2	2200	2390	190	0.09	1.09	3	4	1
0018	2T	10_1	23	7	0	700	0	-700	0.00	0.00	1	0	-1
0018	2T	10_1	24	5	1	500	1020	520	0.20	2.04	0	1	1
0018	2T	10_1	26	2	0	200	0	-200	0.00	0.00	0	0	0
0018	2T	10_2	12	174	55	17400	16400	-1000	0.32	0.94	30	29	-1
0018	2T	10_2	13	116	20	11600	7000	-4600	0.17	0.60	20	12	-8
0018	2T	10_2	14	64	16	6400	6750	350	0.25	1.05	11	11	0
0018	2T	10_2	15	5	1	500	470	-30	0.20	0.94	0	0	0
0018	2T	10_2	16	4	0	400	0	-400	0.00	0.00	0	0	0
0018	2T	10_2	21	17	0	1700	0	-1700	0.00	0.00	3	0	-3
0018	2T	10_2	23	12	2	1200	2730	1530	0.17	2.28	2	4	2
0018	2T	10_2	24	14	2	1400	3580	2180	0.14	2.56	2	6	4
0018	2T	10_2	25	7	0	700	0	-700	0.00	0.00	1	0	-1
0018	2T	10_2	26	5	1	500	670	170	0.20	1.34	0	1	1
0018	2T	10_3	12	223	56	22300	18170	-4130	0.25	0.81	39	32	-7
0018	2T	10_3	13	92	20	9200	6920	-2280	0.22	0.75	16	12	-4
0018	2T	10_3	14	55	14	5500	5810	310	0.25	1.06	9	10	1
0018	2T	10_3	15	5	0	500	0	-500	0.00	0.00	0	0	0
0018	2T	10_3	21	36	2	3600	1180	-2420	0.06	0.33	6	2	-4
0018	2T	10_3	23	7	1	700	590	-110	0.14	0.84	1	1	0
0018	2T	10_3	24	4	0	400	0	-400	0.00	0.00	0	0	0
0018	2T	10_3	25	1	0	100	0	-100	0.00	0.00	0	0	0
0018	2T	10_3	26	1	0	100	0	-100	0.00	0.00	0	0	0
0018	2T	10_4	12	210	62	21000	16150	-4850	0.30	0.77	37	28	-9
0018	2T	10_4	13	106	20	10600	7330	-3270	0.19	0.69	18	12	-6
0018	2T	10_4	14	52	10	5200	3660	-1540	0.19	0.70	9	6	-3
0018	2T	10_4	15	2	0	200	0	-200	0.00	0.00	0	0	0
0018	2T	10_4	16	1	0	100	0	-100	0.00	0.00	0	0	0
0018	2T	10_4	21	14	3	1400	1810	410	0.21	1.29	2	3	1
0018	2T	10_4	23	8	1	800	200	-600	0.13	0.25	1	0	-1
0018	2T	10_4	24	14	1	1400	370	-1030	0.07	0.26	2	0	-2
0018	2T	10_4	26	2	1	200	330	130	0.50	1.65	0	0	0
0018	2T	10_5	12	220	58	22000	14590	-7410	0.26	0.66	38	25	-13
0018	2T	10_5	13	39	7	3900	1630	-2270	0.18	0.42	6	2	-4
0018	2T	10_5	14	60	17	6000	7200	1200	0.28	1.20	10	12	2
0018	2T	10_5	16	1	0	100	0	-100	0.00	0.00	0	0	0
0018	2T	10_5	21	16	1	1600	250	-1350	0.06	0.16	2	0	-2
0018	2T	10_5	23	1	0	100	0	-100	0.00	0.00	0	0	0
0018	2T	10_5	24	8	1	800	330	-470	0.13	0.41	1	0	-1
0018	2T	10_6	12	6	1	600	170	-430	0.17	0.28	1	0	-1
0018	2T	10_6	13	1	0	100	0	-100	0.00	0.00	0	0	0
0018	2T	10_6	14	4	0	400	0	-400	0.00	0.00	0	0	0
0018	2T	10_7	12	503	118	50300	37700	-12600	0.23	0.75	89	66	-23
0018	2T	10_7	13	47	10	4700	5030	330	0.21	1.07	8	8	0
0018	2T	11_1	12	240	46	24000	19190	-4810	0.19	0.80	42	33	-9
0018	2T	11_1	13	122	21	12200	7300	-4900	0.17	0.60	21	12	-9
0018	2T	11_1	14	46	8	4600	3550	-1050	0.17	0.77	8	6	-2
0018	2T	11_1	15	13	1	1300	1160	-140	0.08	0.89	2	2	0
0018	2T	11_1	16	12	1	1200	1360	160	0.08	1.13	2	2	0
0018	2T	11_1	21	3	0	300	0	-300	0.00	0.00	0	0	0
0018	2T	11_1	23	3	0	300	0	-300	0.00	0.00	0	0	0
0018	2T	11_1	24	2	1	200	1900	1700	0.50	9.50	0	3	3
0018	2T	11_1	25	1	0	100	0	-100	0.00	0.00	0	0	0
0018	2T	11_1	26	1	0	100	0	-100	0.00	0.00	0	0	0
0018	2T	11_2	12	209	49	20900	15030	-5870	0.23	0.72	36	26	-10
0018	2T	11_2	13	114	30	11400	10320	-1080	0.26	0.91	20	18	-2
0018	2T	11_2	14	47	6	4700	2790	-1910	0.13	0.59	8	4	-4
0018	2T	11_2	15	18	3	1800	1060	-740	0.17	0.59	3	1	-2
0018	2T	11_2	16	22	0	2200	0	-2200	0.00	0.00	3	0	-3
0018	2T	11_2	23	3	2	300	960	660	0.67	3.20	0	1	1
0018	2T	11_2	24	3	0	300	0	-300	0.00	0.00	0	0	0
0018	2T	11_2	25	5	1	500	320	-180	0.20	0.64	0	0	0
0018	2T	11_2	26	4	1	400	520	120	0.25	1.30	0	0	0
0018	2T	11_3	12	218	63	21800	19990	-1810	0.29	0.92	38	35	-3
0018	2T	11_3	13	98	13	9800	3740	-6060	0.13	0.38	17	6	-11
0018	2T	11_3	14	36	5	3600	2470	-1130	0.14	0.69	6	4	-2
0018	2T	11_3	15	25	3	2500	1510	-990	0.12	0.60	4	2	-2
0018	2T	11_3	16	8	1	800	680	-120	0.13	0.85	1	1	0
0018	2T	11_3	23	7	1	700	680	-20	0.14	0.97	1	1	0
0018	2T	11_3	24	2	0	200	0	-200	0.00	0.00	0	0	0
0018	2T	11_3	25	7	0	700	0	-700	0.00	0.00	1	0	-1
0018	2T	11_3	26	6	3	600	2060	1460	0.50	3.43	1	3	2
0018	2T	11_4	12	198	43	19800	15640	-4160	0.22	0.79	35	27	-8
0018	2T	11_4	13	104	26	10400	10040	-360	0.25	0.97	18	17	-1
0018	2T	11_4	14	39	9	3900	3340	-560	0.23	0.86	6	5	-1
0018	2T	11_4	15	9	1	900	690	-210	0.11	0.77	1	1	0
0018	2T	11_4	16	3	0	300	0	-300	0.00	0.00	0	0	0
0018	2T	11_4	21	2	0	200	0	-200	0.00	0.00	0	0	0
0018	2T	11_4	23	8	1	800	250	-550	0.13	0.31	1	0	-1
0018	2T	11_4	24	4	0	400	0	-400	0.00	0.00	0	0	0
0018	2T	11_4	25	7	1	700	770	70	0.14	1.10	1	1	0
0018	2T	11_4	26	2	0	200	0	-200	0.00	0.00	0	0	0
0018	2T	11_5	12	195	68	19500	22890	3390	0.35	1.17	34	40	6
0018	2T	11_5	13	90	21	9000	8480	-520	0.23	0.94	15	15	0
0018	2T	11_5	14	54	6	5400	2370	-3030	0.11	0.44	9	4	-5
0018	2T	11_5	15	8	0	800	0	-800	0.00	0.00	1	0	-1
0018	2T	11_5	16	13	1	1300	1040	-260	0.08	0.80	2	1	-1
0018	2T	11_5	23	1	0	100	0	-100	0.00	0.00	0	0	0
0018	2T	11_5	24	1	0	100	0	-100	0.00	0.00	0	0	0
0018	2T	11_5	26	1	0	100	0	-100	0.00	0.00	0	0	0
0018	2T	11_7	12	293	92	29300	27930	-1370	0.31	0.95	51	49	-2
0018	2T	11_7	13	130	32	13000	10870	-2130	0.25	0.84	23	19	-4
0018	2T	11_7	14	44	11	4400	4630	230	0.25	1.05	7	8	1
0018	2T	11_7	15	10	0	1000	0	-1000	0.00	0.00	1	0	-1
0018	2T	11_7	16	6	1	600	450	-150	0.17	0.75	1	0	-1
0018	2T	11_7	23	1	0	100	0	-100	0.00	0.00	0	0	0
0018	2T	11_7	24	1	0	100	0	-100	0.00	0.00	0	0	0
0018	2T	11_7	26	1	0	100	0	-100	0.00	0.00	0	0	0
0018	2T	12_1	12	252	69	25200	23660	-1540	0.27	0.94	44	41	-3
0018	2T	12_1	13	102	18	10200	5160	-5040	0.18	0.51	18	9	-9
0018	2T	12_1	14	46	6	4600	2520	-2080	0.13	0.55	8	4	-4
0018	2T	12_1	15	16	2	1600	790	-810	0.13	0.49	2	1	-1
0018	2T	12_1	16	10	0	1000	0	-1000	0.00	0.00	1	0	-1
0018	2T	12_1	21	2	0	200	0	-200	0.00	0.00	0	0	0
0018	2T	12_1	23	5	2	500	1130	630	0.40	2.26	0	2	2
0018	2T	12_1	24	4	1	400	310	-90	0.25	0.78	0	0	0
0018	2T	12_1	25	1	0	100	0	-100	0.00	0.00	0	0	0
0018	2T	12_1	26	2	1	200	740	540	0.50	3.70	0	1	1
0018	2T	12_2	12	241	54	24100	18060	-6040	0.22	0.75	42	31	-11
0018	2T	12_2	13	93	19	9300	5400	-3900	0.20	0.58	16	9	-7
0018	2T	12_2	14	57	13	5700	4600	-1100	0.23	0.81	10	8	-2
0018	2T	12_2	15	23	5	2300	2480	180	0.22	1.08	4	4	0
0018	2T	12_2	16	19	4	1900	1230	-670	0.21	0.65	3	2	-1
0018	2T	12_2	23	1	0	100	0	-100	0.00	0.00	0	0	0
0018	2T	12_2	24	4	0	400	0	-400	0.00	0.00	0	0	0
0018	2T	12_2	25	2	0	200	0	-200	0.00	0.00	0	0	0
0018	2T	12_2	26	6	0	600	0	-600	0.00	0.00	1	0	-1
0018	2T	12_3	12	224	48	22400	16260	-6140	0.21	0.73	39	28	-11
0018	2T	12_3	13	114	19	11400	6720	-4680	0.17	0.59	20	11	-9
0018	2T	12_3	14	62	6	6200	2800	-3400	0.10	0.45	10	4	-6
0018	2T	12_3	15	18	4	1800	1860	60	0.22	1.03	3	3	0
0018	2T	12_3	16	21	3	2100	740	-1360	0.14	0.35	3	1	-2
0018	2T	12_3	21	5	0	500	0	-500	0.00	0.00	0	0	0
0018	2T	12_3	23	6	3	600	1950	1350	0.50	3.25	1	3	2
0018	2T	12_3	24	2	0	200	0	-200	0.00	0.00	0	0	0
0018	2T	12_3	25	2	0	200	0	-200	0.00	0.00	0	0	0
0018	2T	12_3	26	1	0	100	0	-100	0.00	0.00	0	0	0
0018	2T	12_4	12	219	62	21900	18950	-2950	0.28	0.87	38	33	-5
0018	2T	12_4	13	67	14	6700	4730	-1970	0.21	0.71	11	8	-3
0018	2T	12_4	14	38	7	3800	2690	-1110	0.18	0.71	6	4	-2
0018	2T	12_4	15	17	0	1700	0	-1700	0.00	0.00	3	0	-3
0018	2T	12_4	16	5	1	500	200	-300	0.20	0.40	0	0	0
0018	2T	12_4	21	7	0	700	0	-700	0.00	0.00	1	0	-1
0018	2T	12_4	23	8	2	800	910	110	0.25	1.14	1	1	0
0018	2T	12_4	24	7	2	700	500	-200	0.29	0.71	1	0	-1
0018	2T	12_4	25	7	2	700	1260	560	0.29	1.80	1	2	1
0018	2T	12_4	26	4	0	400	0	-400	0.00	0.00	0	0	0
0018	2T	12_5	12	226	63	22600	18420	-4180	0.28	0.82	40	32	-8
0018	2T	12_5	13	76	20	7600	6220	-1380	0.26	0.82	13	11	-2
0018	2T	12_5	14	35	12	3500	4080	580	0.34	1.17	6	7	1
0018	2T	12_5	15	9	2	900	1090	190	0.22	1.21	1	1	0
0018	2T	12_5	16	6	4	600	1680	1080	0.67	2.80	1	2	1
0018	2T	12_5	25	1	0	100	0	-100	0.00	0.00	0	0	0
0018	2T	12_6	12	21	7	2100	2390	290	0.33	1.14	3	4	1
0018	2T	12_6	13	9	2	900	400	-500	0.22	0.44	1	0	-1
0018	2T	12_6	14	1	0	100	0	-100	0.00	0.00	0	0	0
0018	2T	12_6	16	2	0	200	0	-200	0.00	0.00	0	0	0
0018	2T	12_7	12	303	84	30300	25640	-4660	0.28	0.85	53	45	-8
0018	2T	12_7	13	111	26	11100	8270	-2830	0.23	0.75	19	14	-5
0018	2T	12_7	14	36	4	3600	1810	-1790	0.11	0.50	6	3	-3
0018	2T	12_7	15	24	3	2400	2780	380	0.13	1.16	4	4	0
0018	2T	12_7	16	5	1	500	410	-90	0.20	0.82	0	0	0
0018	2T	12_7	21	2	0	200	0	-200	0.00	0.00	0	0	0
0018	2T	12_7	23	3	0	300	0	-300	0.00	0.00	0	0	0
0018	2T	12_7	24	2	0	200	0	-200	0.00	0.00	0	0	0
0018	2T	13_1	12	212	49	21200	16250	-4950	0.23	0.77	37	28	-9
0018	2T	13_1	13	134	27	13400	8290	-5110	0.20	0.62	23	14	-9
0018	2T	13_1	14	91	21	9100	7070	-2030	0.23	0.78	16	12	-4
0018	2T	13_1	15	5	0	500	0	-500	0.00	0.00	0	0	0
0018	2T	13_1	16	12	2	1200	1030	-170	0.17	0.86	2	1	-1
0018	2T	13_1	21	2	0	200	0	-200	0.00	0.00	0	0	0
0018	2T	13_1	23	2	0	200	0	-200	0.00	0.00	0	0	0
0018	2T	13_1	24	4	0	400	0	-400	0.00	0.00	0	0	0
0018	2T	13_1	25	1	0	100	0	-100	0.00	0.00	0	0	0
0018	2T	13_2	12	170	37	17000	13960	-3040	0.22	0.82	30	24	-6
0018	2T	13_2	13	105	22	10500	7580	-2920	0.21	0.72	18	13	-5
0018	2T	13_2	14	70	19	7000	6330	-670	0.27	0.90	12	11	-1
0018	2T	13_2	15	32	10	3200	4030	830	0.31	1.26	5	7	2
0018	2T	13_2	16	16	2	1600	1430	-170	0.13	0.89	2	2	0
0018	2T	13_2	21	3	0	300	0	-300	0.00	0.00	0	0	0
0018	2T	13_2	24	4	2	400	810	410	0.50	2.03	0	1	1
0018	2T	13_2	25	4	0	400	0	-400	0.00	0.00	0	0	0
0018	2T	13_2	26	2	0	200	0	-200	0.00	0.00	0	0	0
0018	2T	13_3	12	198	49	19800	16200	-3600	0.25	0.82	35	28	-7
0018	2T	13_3	13	95	21	9500	8670	-830	0.22	0.91	16	15	-1
0018	2T	13_3	14	44	9	4400	3500	-900	0.20	0.80	7	6	-1
0018	2T	13_3	15	23	1	2300	380	-1920	0.04	0.17	4	0	-4
0018	2T	13_3	16	13	2	1300	1410	110	0.15	1.08	2	2	0
0018	2T	13_3	21	4	1	400	1340	940	0.25	3.35	0	2	2
0018	2T	13_3	23	5	1	500	500	0	0.20	1.00	0	0	0
0018	2T	13_3	24	9	0	900	0	-900	0.00	0.00	1	0	-1
0018	2T	13_3	25	10	0	1000	0	-1000	0.00	0.00	1	0	-1
0018	2T	13_3	26	5	0	500	0	-500	0.00	0.00	0	0	0
0018	2T	13_4	12	196	46	19600	13880	-5720	0.23	0.71	34	24	-10
0018	2T	13_4	13	81	22	8100	6060	-2040	0.27	0.75	14	10	-4
0018	2T	13_4	14	65	19	6500	6680	180	0.29	1.03	11	11	0
0018	2T	13_4	15	19	6	1900	2580	680	0.32	1.36	3	4	1
0018	2T	13_4	16	6	0	600	0	-600	0.00	0.00	1	0	-1
0018	2T	13_4	21	3	0	300	0	-300	0.00	0.00	0	0	0
0018	2T	13_4	23	8	0	800	0	-800	0.00	0.00	1	0	-1
0018	2T	13_4	24	5	0	500	0	-500	0.00	0.00	0	0	0
0018	2T	13_4	25	4	0	400	0	-400	0.00	0.00	0	0	0
0018	2T	13_4	26	3	0	300	0	-300	0.00	0.00	0	0	0
0018	2T	13_5	12	197	67	19700	17420	-2280	0.34	0.88	34	30	-4
0018	2T	13_5	13	85	20	8500	6950	-1550	0.24	0.82	15	12	-3
0018	2T	13_5	14	55	18	5500	5960	460	0.33	1.08	9	10	1
0018	2T	13_5	15	12	0	1200	0	-1200	0.00	0.00	2	0	-2
0018	2T	13_5	16	23	5	2300	2000	-300	0.22	0.87	4	3	-1
0018	2T	13_5	23	2	0	200	0	-200	0.00	0.00	0	0	0
0018	2T	13_5	24	1	0	100	0	-100	0.00	0.00	0	0	0
0018	2T	13_5	26	2	0	200	0	-200	0.00	0.00	0	0	0
0018	2T	13_6	12	21	5	2100	1400	-700	0.24	0.67	3	2	-1
0018	2T	13_6	13	14	5	1400	1280	-120	0.36	0.91	2	2	0
0018	2T	13_6	14	10	0	1000	0	-1000	0.00	0.00	1	0	-1
0018	2T	13_6	15	3	0	300	0	-300	0.00	0.00	0	0	0
0018	2T	13_7	12	228	81	22800	23770	970	0.36	1.04	40	42	2
0018	2T	13_7	13	117	30	11700	11840	140	0.26	1.01	20	20	0
0018	2T	13_7	14	63	23	6300	8000	1700	0.37	1.27	11	14	3
0018	2T	13_7	15	19	4	1900	1620	-280	0.21	0.85	3	2	-1
0018	2T	13_7	16	12	2	1200	750	-450	0.17	0.63	2	1	-1
0018	2T	13_7	21	1	1	100	600	500	1.00	6.00	0	1	1
0018	2T	13_7	23	3	0	300	0	-300	0.00	0.00	0	0	0
0018	2T	13_7	24	3	0	300	0	-300	0.00	0.00	0	0	0
0018	2T	13_7	25	2	0	200	0	-200	0.00	0.00	0	0	0
0018	2T	14_1	12	240	53	24000	19400	-4600	0.22	0.81	42	34	-8
0018	2T	14_1	13	60	13	6000	6110	110	0.22	1.02	10	10	0
0018	2T	14_1	14	82	15	8200	6740	-1460	0.18	0.82	14	11	-3
0018	2T	14_1	15	2	0	200	0	-200	0.00	0.00	0	0	0
0018	2T	14_1	16	1	0	100	0	-100	0.00	0.00	0	0	0
0018	2T	14_1	21	22	5	2200	3630	1430	0.23	1.65	3	6	3
0018	2T	14_1	23	5	0	500	0	-500	0.00	0.00	0	0	0
0018	2T	14_1	24	16	2	1600	1040	-560	0.13	0.65	2	1	-1
0018	2T	14_1	25	1	0	100	0	-100	0.00	0.00	0	0	0
0018	2T	14_2	12	255	40	25500	13240	-12260	0.16	0.52	45	23	-22
0018	2T	14_2	13	58	11	5800	5520	-280	0.19	0.95	10	9	-1
0018	2T	14_2	14	85	18	8500	6240	-2260	0.21	0.73	15	11	-4
0018	2T	14_2	15	8	2	800	840	40	0.25	1.05	1	1	0
0018	2T	14_2	16	2	0	200	0	-200	0.00	0.00	0	0	0
0018	2T	14_2	21	13	2	1300	2300	1000	0.15	1.77	2	4	2
0018	2T	14_2	23	6	0	600	0	-600	0.00	0.00	1	0	-1
0018	2T	14_2	24	14	1	1400	850	-550	0.07	0.61	2	1	-1
0018	2T	14_3	12	280	64	28000	29550	1550	0.23	1.06	49	52	3
0018	2T	14_3	13	56	13	5600	4720	-880	0.23	0.84	9	8	-1
0018	2T	14_3	14	102	15	10200	7380	-2820	0.15	0.72	18	13	-5
0018	2T	14_3	23	9	1	900	1270	370	0.11	1.41	1	2	1
0018	2T	14_3	24	17	1	1700	1280	-420	0.06	0.75	3	2	-1
0018	2T	14_4	12	197	43	19700	12680	-7020	0.22	0.64	34	22	-12
0018	2T	14_4	13	67	12	6700	3900	-2800	0.18	0.58	11	6	-5
0018	2T	14_4	14	40	9	4000	3940	-60	0.23	0.99	7	6	-1
0018	2T	14_4	15	10	0	1000	0	-1000	0.00	0.00	1	0	-1
0018	2T	14_4	16	9	1	900	320	-580	0.11	0.36	1	0	-1
0018	2T	14_4	21	7	0	700	0	-700	0.00	0.00	1	0	-1
0018	2T	14_4	23	13	2	1300	1510	210	0.15	1.16	2	2	0
0018	2T	14_4	24	5	2	500	940	440	0.40	1.88	0	1	1
0018	2T	14_4	25	2	0	200	0	-200	0.00	0.00	0	0	0
0018	2T	14_4	26	6	1	600	690	90	0.17	1.15	1	1	0
0018	2T	14_5	12	124	21	12400	6120	-6280	0.17	0.49	21	10	-11
0018	2T	14_5	13	37	6	3700	2930	-770	0.16	0.79	6	5	-1
0018	2T	14_5	14	32	4	3200	1880	-1320	0.13	0.59	5	3	-2
0018	2T	14_5	15	14	1	1400	390	-1010	0.07	0.28	2	0	-2
0018	2T	14_5	16	10	1	1000	710	-290	0.10	0.71	1	1	0
0018	2T	14_5	21	2	0	200	0	-200	0.00	0.00	0	0	0
0018	2T	14_5	23	2	0	200	0	-200	0.00	0.00	0	0	0
0018	2T	14_5	25	1	0	100	0	-100	0.00	0.00	0	0	0
0018	2T	14_5	26	2	0	200	0	-200	0.00	0.00	0	0	0
0018	2T	14_6	12	12	3	1200	1060	-140	0.25	0.88	2	1	-1
0018	2T	14_6	13	5	1	500	260	-240	0.20	0.52	0	0	0
0018	2T	14_6	14	4	0	400	0	-400	0.00	0.00	0	0	0
0018	2T	14_6	15	1	0	100	0	-100	0.00	0.00	0	0	0
0018	2T	14_6	16	1	0	100	0	-100	0.00	0.00	0	0	0
0018	2T	14_7	12	263	57	26300	18690	-7610	0.22	0.71	46	33	-13
0018	2T	14_7	13	83	15	8300	6450	-1850	0.18	0.78	14	11	-3
0018	2T	14_7	14	69	14	6900	6180	-720	0.20	0.90	12	10	-2
0018	2T	14_7	15	19	0	1900	0	-1900	0.00	0.00	3	0	-3
0018	2T	14_7	16	7	1	700	820	120	0.14	1.17	1	1	0
0018	2T	14_7	21	1	0	100	0	-100	0.00	0.00	0	0	0
0018	2T	14_7	23	3	0	300	0	-300	0.00	0.00	0	0	0
0018	2T	14_7	24	3	1	300	300	0	0.33	1.00	0	0	0
0018	2T	14_7	26	1	0	100	0	-100	0.00	0.00	0	0	0
0018	2T	15_1	12	273	62	27300	21800	-5500	0.23	0.80	48	38	-10
0018	2T	15_1	13	142	26	14200	9300	-4900	0.18	0.65	25	16	-9
0018	2T	15_1	14	36	7	3600	2310	-1290	0.19	0.64	6	4	-2
0018	2T	15_1	15	17	1	1700	550	-1150	0.06	0.32	3	0	-3
0018	2T	15_1	16	18	2	1800	1250	-550	0.11	0.69	3	2	-1
0018	2T	15_1	21	4	0	400	0	-400	0.00	0.00	0	0	0
0018	2T	15_1	23	4	0	400	0	-400	0.00	0.00	0	0	0
0018	2T	15_1	25	1	0	100	0	-100	0.00	0.00	0	0	0
0018	2T	15_1	26	2	0	200	0	-200	0.00	0.00	0	0	0
0018	2T	15_2	12	257	60	25700	19350	-6350	0.23	0.75	45	34	-11
0018	2T	15_2	13	107	26	10700	9540	-1160	0.24	0.89	18	16	-2
0018	2T	15_2	14	67	11	6700	4030	-2670	0.16	0.60	11	7	-4
0018	2T	15_2	15	23	2	2300	2120	-180	0.09	0.92	4	3	-1
0018	2T	15_2	16	14	3	1400	1640	240	0.21	1.17	2	2	0
0018	2T	15_2	23	7	0	700	0	-700	0.00	0.00	1	0	-1
0018	2T	15_2	24	2	1	200	970	770	0.50	4.85	0	1	1
0018	2T	15_2	26	4	0	400	0	-400	0.00	0.00	0	0	0
0018	2T	15_3	12	275	49	27500	13660	-13840	0.18	0.50	48	24	-24
0018	2T	15_3	13	112	24	11200	8530	-2670	0.21	0.76	19	15	-4
0018	2T	15_3	14	73	18	7300	10290	2990	0.25	1.41	12	18	6
0018	2T	15_3	15	21	2	2100	1570	-530	0.10	0.75	3	2	-1
0018	2T	15_3	16	12	1	1200	490	-710	0.08	0.41	2	0	-2
0018	2T	15_3	23	2	0	200	0	-200	0.00	0.00	0	0	0
0018	2T	15_3	24	1	0	100	0	-100	0.00	0.00	0	0	0
0018	2T	15_3	25	7	0	700	0	-700	0.00	0.00	1	0	-1
0018	2T	15_3	26	3	0	300	0	-300	0.00	0.00	0	0	0
0018	2T	15_4	12	236	57	23600	16440	-7160	0.24	0.70	41	29	-12
0018	2T	15_4	13	79	18	7900	6610	-1290	0.23	0.84	13	11	-2
0018	2T	15_4	14	58	11	5800	3790	-2010	0.19	0.65	10	6	-4
0018	2T	15_4	15	15	1	1500	260	-1240	0.07	0.17	2	0	-2
0018	2T	15_4	16	10	2	1000	1450	450	0.20	1.45	1	2	1
0018	2T	15_4	23	6	1	600	580	-20	0.17	0.97	1	1	0
0018	2T	15_4	24	3	1	300	690	390	0.33	2.30	0	1	1
0018	2T	15_4	25	3	0	300	0	-300	0.00	0.00	0	0	0
0018	2T	15_4	26	2	0	200	0	-200	0.00	0.00	0	0	0
0018	2T	15_5	12	207	45	20700	12450	-8250	0.22	0.60	36	22	-14
0018	2T	15_5	13	80	20	8000	6540	-1460	0.25	0.82	14	11	-3
0018	2T	15_5	14	36	7	3600	2640	-960	0.19	0.73	6	4	-2
0018	2T	15_5	15	19	5	1900	2100	200	0.26	1.11	3	3	0
0018	2T	15_5	16	14	4	1400	1520	120	0.29	1.09	2	2	0
0018	2T	15_5	21	1	0	100	0	-100	0.00	0.00	0	0	0
0018	2T	15_5	23	2	0	200	0	-200	0.00	0.00	0	0	0
0018	2T	15_5	25	3	0	300	0	-300	0.00	0.00	0	0	0
0018	2T	15_5	26	3	0	300	0	-300	0.00	0.00	0	0	0
0018	2T	15_6	12	38	9	3800	2620	-1180	0.24	0.69	6	4	-2
0018	2T	15_6	13	12	2	1200	660	-540	0.17	0.55	2	1	-1
0018	2T	15_6	14	7	1	700	410	-290	0.14	0.59	1	0	-1
0018	2T	15_6	15	5	0	500	0	-500	0.00	0.00	0	0	0
0018	2T	15_6	16	2	2	200	1730	1530	1.00	8.65	0	3	3
0018	2T	15_7	12	330	91	33000	26730	-6270	0.28	0.81	58	47	-11
0018	2T	15_7	13	134	27	13400	8390	-5010	0.20	0.63	23	14	-9
0018	2T	15_7	14	45	9	4500	2910	-1590	0.20	0.65	7	5	-2
0018	2T	15_7	15	13	2	1300	2810	1510	0.15	2.16	2	4	2
0018	2T	15_7	16	20	7	2000	3570	1570	0.35	1.79	3	6	3
0018	2T	15_7	23	2	0	200	0	-200	0.00	0.00	0	0	0
0018	2T	15_7	24	2	0	200	0	-200	0.00	0.00	0	0	0
0018	2T	15_7	26	3	0	300	0	-300	0.00	0.00	0	0	0
0018	2T	16_1	12	332	75	33200	24370	-8830	0.23	0.73	58	43	-15
0018	2T	16_1	13	93	17	9300	6430	-2870	0.18	0.69	16	11	-5
0018	2T	16_1	14	67	15	6700	4430	-2270	0.22	0.66	11	7	-4
0018	2T	16_1	15	16	3	1600	1670	70	0.19	1.04	2	2	0
0018	2T	16_1	16	18	2	1800	1430	-370	0.11	0.79	3	2	-1
0018	2T	16_1	21	4	0	400	0	-400	0.00	0.00	0	0	0
0018	2T	16_1	25	2	0	200	0	-200	0.00	0.00	0	0	0
0018	2T	16_1	26	3	0	300	0	-300	0.00	0.00	0	0	0
0018	2T	16_2	12	236	61	23600	19080	-4520	0.26	0.81	41	33	-8
0018	2T	16_2	13	94	20	9400	6430	-2970	0.21	0.68	16	11	-5
0018	2T	16_2	14	80	20	8000	6790	-1210	0.25	0.85	14	12	-2
0018	2T	16_2	15	16	3	1600	1250	-350	0.19	0.78	2	2	0
0018	2T	16_2	16	36	4	3600	2380	-1220	0.11	0.66	6	4	-2
0018	2T	16_2	21	1	0	100	0	-100	0.00	0.00	0	0	0
0018	2T	16_2	23	3	1	300	340	40	0.33	1.13	0	0	0
0018	2T	16_2	24	2	0	200	0	-200	0.00	0.00	0	0	0
0018	2T	16_2	25	3	1	300	550	250	0.33	1.83	0	0	0
0018	2T	16_2	26	10	0	1000	0	-1000	0.00	0.00	1	0	-1
0018	2T	16_3	12	232	63	23200	20740	-2460	0.27	0.89	41	36	-5
0018	2T	16_3	13	118	25	11800	8970	-2830	0.21	0.76	20	15	-5
0018	2T	16_3	14	75	13	7500	4340	-3160	0.17	0.58	13	7	-6
0018	2T	16_3	15	31	3	3100	2490	-610	0.10	0.80	5	4	-1
0018	2T	16_3	16	11	2	1100	2460	1360	0.18	2.24	1	4	3
0018	2T	16_3	21	3	0	300	0	-300	0.00	0.00	0	0	0
0018	2T	16_3	23	4	0	400	0	-400	0.00	0.00	0	0	0
0018	2T	16_3	24	4	0	400	0	-400	0.00	0.00	0	0	0
0018	2T	16_3	25	3	1	300	1050	750	0.33	3.50	0	1	1
0018	2T	16_3	26	7	0	700	0	-700	0.00	0.00	1	0	-1
0018	2T	16_4	12	251	64	25100	19320	-5780	0.25	0.77	44	34	-10
0018	2T	16_4	13	72	17	7200	4650	-2550	0.24	0.65	12	8	-4
0018	2T	16_4	14	72	26	7200	10210	3010	0.36	1.42	12	18	6
0018	2T	16_4	15	18	3	1800	2790	990	0.17	1.55	3	4	1
0018	2T	16_4	16	6	2	600	1540	940	0.33	2.57	1	2	1
0018	2T	16_4	21	2	0	200	0	-200	0.00	0.00	0	0	0
0018	2T	16_4	23	4	2	400	1290	890	0.50	3.23	0	2	2
0018	2T	16_4	24	4	1	400	740	340	0.25	1.85	0	1	1
0018	2T	16_4	25	6	1	600	2780	2180	0.17	4.63	1	4	3
0018	2T	16_4	26	2	0	200	0	-200	0.00	0.00	0	0	0
0018	2T	16_5	12	235	62	23500	17220	-6280	0.26	0.73	41	30	-11
0018	2T	16_5	13	84	16	8400	4500	-3900	0.19	0.54	14	7	-7
0018	2T	16_5	14	100	23	10000	7160	-2840	0.23	0.72	17	12	-5
0018	2T	16_5	15	10	1	1000	410	-590	0.10	0.41	1	0	-1
0018	2T	16_5	16	5	0	500	0	-500	0.00	0.00	0	0	0
0018	2T	16_5	21	1	0	100	0	-100	0.00	0.00	0	0	0
0018	2T	16_5	23	1	0	100	0	-100	0.00	0.00	0	0	0
0018	2T	16_7	12	329	102	32900	29750	-3150	0.31	0.90	58	52	-6
0018	2T	16_7	13	115	22	11500	7190	-4310	0.19	0.63	20	12	-8
0018	2T	16_7	14	68	16	6800	5770	-1030	0.24	0.85	12	10	-2
0018	2T	16_7	15	11	4	1100	1860	760	0.36	1.69	1	3	2
0018	2T	16_7	16	19	3	1900	1660	-240	0.16	0.87	3	2	-1
0018	2T	16_7	25	1	0	100	0	-100	0.00	0.00	0	0	0
0018	2T	16_7	26	1	0	100	0	-100	0.00	0.00	0	0	0
0018	2T	17_1	12	276	60	27600	18160	-9440	0.22	0.66	48	32	-16
0018	2T	17_1	13	124	25	12400	7680	-4720	0.20	0.62	21	13	-8
0018	2T	17_1	14	60	9	6000	3250	-2750	0.15	0.54	10	5	-5
0018	2T	17_1	15	11	0	1100	0	-1100	0.00	0.00	1	0	-1
0018	2T	17_1	16	4	0	400	0	-400	0.00	0.00	0	0	0
0018	2T	17_1	21	3	0	300	0	-300	0.00	0.00	0	0	0
0018	2T	17_1	23	4	1	400	1160	760	0.25	2.90	0	2	2
0018	2T	17_1	24	4	0	400	0	-400	0.00	0.00	0	0	0
0018	2T	17_1	25	3	1	300	1330	1030	0.33	4.43	0	2	2
0018	2T	17_2	12	275	66	27500	20100	-7400	0.24	0.73	48	35	-13
0018	2T	17_2	13	141	31	14100	10290	-3810	0.22	0.73	24	18	-6
0018	2T	17_2	14	49	7	4900	2720	-2180	0.14	0.56	8	4	-4
0018	2T	17_2	15	15	3	1500	1530	30	0.20	1.02	2	2	0
0018	2T	17_2	16	4	1	400	1120	720	0.25	2.80	0	1	1
0018	2T	17_2	21	5	0	500	0	-500	0.00	0.00	0	0	0
0018	2T	17_2	23	8	0	800	0	-800	0.00	0.00	1	0	-1
0018	2T	17_2	24	5	1	500	610	110	0.20	1.22	0	1	1
0018	2T	17_2	25	2	0	200	0	-200	0.00	0.00	0	0	0
0018	2T	17_3	12	277	65	27700	21350	-6350	0.23	0.77	49	37	-12
0018	2T	17_3	13	125	34	12500	10300	-2200	0.27	0.82	22	18	-4
0018	2T	17_3	14	47	10	4700	3520	-1180	0.21	0.75	8	6	-2
0018	2T	17_3	15	25	2	2500	800	-1700	0.08	0.32	4	1	-3
0018	2T	17_3	16	9	0	900	0	-900	0.00	0.00	1	0	-1
0018	2T	17_3	21	1	0	100	0	-100	0.00	0.00	0	0	0
0018	2T	17_3	23	4	1	400	720	320	0.25	1.80	0	1	1
0018	2T	17_3	24	1	0	100	0	-100	0.00	0.00	0	0	0
0018	2T	17_3	25	3	0	300	0	-300	0.00	0.00	0	0	0
0018	2T	17_3	26	3	1	300	1810	1510	0.33	6.03	0	3	3
0018	2T	17_4	12	223	60	22300	17010	-5290	0.27	0.76	39	30	-9
0018	2T	17_4	13	101	35	10100	9940	-160	0.35	0.98	17	17	0
0018	2T	17_4	14	47	11	4700	3160	-1540	0.23	0.67	8	5	-3
0018	2T	17_4	15	10	3	1000	1300	300	0.30	1.30	1	2	1
0018	2T	17_4	16	4	1	400	600	200	0.25	1.50	0	1	1
0018	2T	17_4	21	5	1	500	690	190	0.20	1.38	0	1	1
0018	2T	17_4	23	1	0	100	0	-100	0.00	0.00	0	0	0
0018	2T	17_4	24	3	1	300	390	90	0.33	1.30	0	0	0
0018	2T	17_4	25	3	2	300	1770	1470	0.67	5.90	0	3	3
0018	2T	17_5	12	225	60	22500	15110	-7390	0.27	0.67	39	26	-13
0018	2T	17_5	13	95	21	9500	6890	-2610	0.22	0.73	16	12	-4
0018	2T	17_5	14	45	11	4500	3920	-580	0.24	0.87	7	6	-1
0018	2T	17_5	15	13	0	1300	0	-1300	0.00	0.00	2	0	-2
0018	2T	17_5	16	2	1	200	280	80	0.50	1.40	0	0	0
0018	2T	17_5	21	2	0	200	0	-200	0.00	0.00	0	0	0
0018	2T	17_5	23	3	0	300	0	-300	0.00	0.00	0	0	0
0018	2T	17_5	24	4	0	400	0	-400	0.00	0.00	0	0	0
0018	2T	17_7	12	309	79	30900	22380	-8520	0.26	0.72	54	39	-15
0018	2T	17_7	13	138	34	13800	10010	-3790	0.25	0.73	24	17	-7
0018	2T	17_7	14	66	11	6600	3950	-2650	0.17	0.60	11	6	-5
0018	2T	17_7	15	16	2	1600	1230	-370	0.13	0.77	2	2	0
0018	2T	17_7	16	5	0	500	0	-500	0.00	0.00	0	0	0
0018	2T	17_7	21	1	0	100	0	-100	0.00	0.00	0	0	0
0018	2T	17_7	24	2	0	200	0	-200	0.00	0.00	0	0	0
0018	2T	17_7	25	4	0	400	0	-400	0.00	0.00	0	0	0
0018	2T	17_7	26	3	0	300	0	-300	0.00	0.00	0	0	0
0018	2T	18_1	12	235	57	23500	15030	-8470	0.24	0.64	41	26	-15
0018	2T	18_1	13	89	20	8900	6780	-2120	0.22	0.76	15	12	-3
0018	2T	18_1	14	66	17	6600	5300	-1300	0.26	0.80	11	9	-2
0018	2T	18_1	15	13	3	1300	1300	0	0.23	1.00	2	2	0
0018	2T	18_1	16	9	1	900	340	-560	0.11	0.38	1	0	-1
0018	2T	18_1	21	19	6	1900	3870	1970	0.32	2.04	3	6	3
0018	2T	18_1	23	6	1	600	610	10	0.17	1.02	1	1	0
0018	2T	18_1	24	5	2	500	680	180	0.40	1.36	0	1	1
0018	2T	18_1	25	4	0	400	0	-400	0.00	0.00	0	0	0
0018	2T	18_1	26	12	3	1200	2030	830	0.25	1.69	2	3	1
0018	2T	18_2	12	238	77	23800	22260	-1540	0.32	0.94	42	39	-3
0018	2T	18_2	13	98	18	9800	6230	-3570	0.18	0.64	17	11	-6
0018	2T	18_2	14	69	14	6900	6090	-810	0.20	0.88	12	10	-2
0018	2T	18_2	15	19	5	1900	2580	680	0.26	1.36	3	4	1
0018	2T	18_2	16	12	4	1200	2300	1100	0.33	1.92	2	4	2
0018	2T	18_2	21	9	4	900	6860	5960	0.44	7.62	1	12	11
0018	2T	18_2	23	3	0	300	0	-300	0.00	0.00	0	0	0
0018	2T	18_2	24	6	0	600	0	-600	0.00	0.00	1	0	-1
0018	2T	18_2	25	4	1	400	380	-20	0.25	0.95	0	0	0
0018	2T	18_2	26	13	0	1300	0	-1300	0.00	0.00	2	0	-2
0018	2T	18_3	12	236	81	23600	22360	-1240	0.34	0.95	41	39	-2
0018	2T	18_3	13	78	25	7800	9270	1470	0.32	1.19	13	16	3
0018	2T	18_3	14	66	13	6600	5140	-1460	0.20	0.78	11	9	-2
0018	2T	18_3	15	23	3	2300	1600	-700	0.13	0.70	4	2	-2
0018	2T	18_3	16	17	0	1700	0	-1700	0.00	0.00	3	0	-3
0018	2T	18_3	21	17	3	1700	2850	1150	0.18	1.68	3	5	2
0018	2T	18_3	23	6	1	600	450	-150	0.17	0.75	1	0	-1
0018	2T	18_3	24	8	0	800	0	-800	0.00	0.00	1	0	-1
0018	2T	18_3	25	2	0	200	0	-200	0.00	0.00	0	0	0
0018	2T	18_3	26	18	2	1800	1550	-250	0.11	0.86	3	2	-1
0018	2T	18_4	12	271	98	27100	28060	960	0.36	1.04	47	49	2
0018	2T	18_4	13	73	17	7300	5290	-2010	0.23	0.72	12	9	-3
0018	2T	18_4	14	51	12	5100	4090	-1010	0.24	0.80	9	7	-2
0018	2T	18_4	15	18	3	1800	830	-970	0.17	0.46	3	1	-2
0018	2T	18_4	16	5	0	500	0	-500	0.00	0.00	0	0	0
0018	2T	18_4	21	5	0	500	0	-500	0.00	0.00	0	0	0
0018	2T	18_4	23	7	0	700	0	-700	0.00	0.00	1	0	-1
0018	2T	18_4	24	1	0	100	0	-100	0.00	0.00	0	0	0
0018	2T	18_4	25	5	0	500	0	-500	0.00	0.00	0	0	0
0018	2T	18_4	26	3	0	300	0	-300	0.00	0.00	0	0	0
0018	2T	18_5	12	327	110	32700	28020	-4680	0.34	0.86	57	49	-8
0018	2T	18_5	13	64	10	6400	3140	-3260	0.16	0.49	11	5	-6
0018	2T	18_5	14	53	14	5300	4770	-530	0.26	0.90	9	8	-1
0018	2T	18_5	15	37	7	3700	2620	-1080	0.19	0.71	6	4	-2
0018	2T	18_5	16	4	2	400	730	330	0.50	1.83	0	1	1
0018	2T	18_5	21	2	0	200	0	-200	0.00	0.00	0	0	0
0018	2T	18_5	24	2	0	200	0	-200	0.00	0.00	0	0	0
0018	2T	18_6	12	33	10	3300	2300	-1000	0.30	0.70	5	4	-1
0018	2T	18_6	13	13	4	1300	1540	240	0.31	1.18	2	2	0
0018	2T	18_6	14	11	2	1100	630	-470	0.18	0.57	1	1	0
0018	2T	18_7	12	347	117	34700	29970	-4730	0.34	0.86	61	53	-8
0018	2T	18_7	13	103	25	10300	8100	-2200	0.24	0.79	18	14	-4
0018	2T	18_7	14	77	14	7700	4760	-2940	0.18	0.62	13	8	-5
0018	2T	18_7	15	11	3	1100	1600	500	0.27	1.45	1	2	1
0018	2T	18_7	16	7	2	700	1240	540	0.29	1.77	1	2	1
0018	2T	18_7	21	6	0	600	0	-600	0.00	0.00	1	0	-1
0018	2T	18_7	23	6	0	600	0	-600	0.00	0.00	1	0	-1
0018	2T	18_7	24	2	0	200	0	-200	0.00	0.00	0	0	0
0018	2T	19_1	12	225	54	22500	16990	-5510	0.24	0.76	39	30	-9
0018	2T	19_1	13	141	34	14100	11150	-2950	0.24	0.79	24	19	-5
0018	2T	19_1	14	68	25	6800	7120	320	0.37	1.05	12	12	0
0018	2T	19_1	15	3	0	300	0	-300	0.00	0.00	0	0	0
0018	2T	19_1	16	18	2	1800	1020	-780	0.11	0.57	3	1	-2
0018	2T	19_1	21	2	0	200	0	-200	0.00	0.00	0	0	0
0018	2T	19_1	23	3	1	300	1800	1500	0.33	6.00	0	3	3
0018	2T	19_1	24	2	0	200	0	-200	0.00	0.00	0	0	0
0018	2T	19_1	26	2	0	200	0	-200	0.00	0.00	0	0	0
0018	2T	19_2	12	213	50	21300	15660	-5640	0.23	0.74	37	27	-10
0018	2T	19_2	13	117	31	11700	10970	-730	0.26	0.94	20	19	-1
0018	2T	19_2	14	79	22	7900	6410	-1490	0.28	0.81	13	11	-2
0018	2T	19_2	15	7	0	700	0	-700	0.00	0.00	1	0	-1
0018	2T	19_2	16	13	1	1300	300	-1000	0.08	0.23	2	0	-2
0018	2T	19_2	23	1	0	100	0	-100	0.00	0.00	0	0	0
0018	2T	19_2	24	3	0	300	0	-300	0.00	0.00	0	0	0
0018	2T	19_2	26	8	0	800	0	-800	0.00	0.00	1	0	-1
0018	2T	19_3	12	221	54	22100	16860	-5240	0.24	0.76	39	29	-10
0018	2T	19_3	13	106	31	10600	9150	-1450	0.29	0.86	18	16	-2
0018	2T	19_3	14	79	14	7900	4660	-3240	0.18	0.59	13	8	-5
0018	2T	19_3	15	16	2	1600	940	-660	0.13	0.59	2	1	-1
0018	2T	19_3	16	13	0	1300	0	-1300	0.00	0.00	2	0	-2
0018	2T	19_3	21	1	0	100	0	-100	0.00	0.00	0	0	0
0018	2T	19_3	23	2	0	200	0	-200	0.00	0.00	0	0	0
0018	2T	19_3	26	7	0	700	0	-700	0.00	0.00	1	0	-1
0018	2T	19_4	12	203	51	20300	15720	-4580	0.25	0.77	35	27	-8
0018	2T	19_4	13	109	24	10900	7080	-3820	0.22	0.65	19	12	-7
0018	2T	19_4	14	52	12	5200	3730	-1470	0.23	0.72	9	6	-3
0018	2T	19_4	15	10	0	1000	0	-1000	0.00	0.00	1	0	-1
0018	2T	19_4	16	7	0	700	0	-700	0.00	0.00	1	0	-1
0018	2T	19_4	21	2	0	200	0	-200	0.00	0.00	0	0	0
0018	2T	19_4	23	2	0	200	0	-200	0.00	0.00	0	0	0
0018	2T	19_4	24	3	0	300	0	-300	0.00	0.00	0	0	0
0018	2T	19_5	12	138	36	13800	9340	-4460	0.26	0.68	24	16	-8
0018	2T	19_5	13	87	18	8700	4830	-3870	0.21	0.56	15	8	-7
0018	2T	19_5	14	44	17	4400	7060	2660	0.39	1.60	7	12	5
0018	2T	19_5	15	4	0	400	0	-400	0.00	0.00	0	0	0
0018	2T	19_5	16	4	0	400	0	-400	0.00	0.00	0	0	0
0018	2T	19_5	21	1	0	100	0	-100	0.00	0.00	0	0	0
0018	2T	19_5	23	4	0	400	0	-400	0.00	0.00	0	0	0
0018	2T	19_5	24	1	0	100	0	-100	0.00	0.00	0	0	0
0018	2T	19_5	25	1	0	100	0	-100	0.00	0.00	0	0	0
0018	2T	19_5	26	1	0	100	0	-100	0.00	0.00	0	0	0
0018	2T	19_6	12	18	6	1800	1260	-540	0.33	0.70	3	2	-1
0018	2T	19_6	13	7	2	700	620	-80	0.29	0.89	1	1	0
0018	2T	19_6	14	7	1	700	240	-460	0.14	0.34	1	0	-1
0018	2T	19_6	15	2	0	200	0	-200	0.00	0.00	0	0	0
0018	2T	19_6	16	2	0	200	0	-200	0.00	0.00	0	0	0
0018	2T	19_6	23	1	0	100	0	-100	0.00	0.00	0	0	0
0018	2T	19_6	24	1	0	100	0	-100	0.00	0.00	0	0	0
0018	2T	19_7	12	242	67	24200	18410	-5790	0.28	0.76	42	32	-10
0018	2T	19_7	13	126	31	12600	9220	-3380	0.25	0.73	22	16	-6
0018	2T	19_7	14	79	21	7900	6050	-1850	0.27	0.77	13	10	-3
0018	2T	19_7	15	6	0	600	0	-600	0.00	0.00	1	0	-1
0018	2T	19_7	16	3	0	300	0	-300	0.00	0.00	0	0	0
0018	2T	19_7	23	5	0	500	0	-500	0.00	0.00	0	0	0
0018	2T	19_7	24	1	0	100	0	-100	0.00	0.00	0	0	0
0018	2T	19_7	25	2	0	200	0	-200	0.00	0.00	0	0	0
0018	2T	19_7	26	2	0	200	0	-200	0.00	0.00	0	0	0
0018	2T	20_1	12	251	67	25100	22940	-2160	0.27	0.91	44	40	-4
0018	2T	20_1	13	157	36	15700	11100	-4600	0.23	0.71	27	19	-8
0018	2T	20_1	14	71	16	7100	5750	-1350	0.23	0.81	12	10	-2
0018	2T	20_1	15	15	1	1500	350	-1150	0.07	0.23	2	0	-2
0018	2T	20_1	16	5	1	500	640	140	0.20	1.28	0	1	1
0018	2T	20_1	21	1	0	100	0	-100	0.00	0.00	0	0	0
0018	2T	20_1	23	1	0	100	0	-100	0.00	0.00	0	0	0
0018	2T	20_2	12	242	57	24200	17850	-6350	0.24	0.74	42	31	-11
0018	2T	20_2	13	128	28	12800	8030	-4770	0.22	0.63	22	14	-8
0018	2T	20_2	14	56	14	5600	3960	-1640	0.25	0.71	9	7	-2
0018	2T	20_2	15	28	6	2800	2150	-650	0.21	0.77	4	3	-1
0018	2T	20_2	16	32	6	3200	3120	-80	0.19	0.98	5	5	0
0018	2T	20_2	21	1	0	100	0	-100	0.00	0.00	0	0	0
0018	2T	20_2	23	1	0	100	0	-100	0.00	0.00	0	0	0
0018	2T	20_2	24	1	0	100	0	-100	0.00	0.00	0	0	0
0018	2T	20_2	26	2	0	200	0	-200	0.00	0.00	0	0	0
0018	2T	20_3	12	269	76	26900	27100	200	0.28	1.01	47	47	0
0018	2T	20_3	13	108	31	10800	10780	-20	0.29	1.00	19	19	0
0018	2T	20_3	14	60	8	6000	3790	-2210	0.13	0.63	10	6	-4
0018	2T	20_3	15	29	8	2900	4190	1290	0.28	1.44	5	7	2
0018	2T	20_3	16	15	3	1500	1580	80	0.20	1.05	2	2	0
0018	2T	20_3	21	1	0	100	0	-100	0.00	0.00	0	0	0
0018	2T	20_3	23	1	0	100	0	-100	0.00	0.00	0	0	0
0018	2T	20_3	24	2	0	200	0	-200	0.00	0.00	0	0	0
0018	2T	20_3	26	3	1	300	650	350	0.33	2.17	0	1	1
0018	2T	20_4	12	221	54	22100	17490	-4610	0.24	0.79	39	30	-9
0018	2T	20_4	13	92	27	9200	8450	-750	0.29	0.92	16	14	-2
0018	2T	20_4	14	59	15	5900	5610	-290	0.25	0.95	10	9	-1
0018	2T	20_4	15	31	8	3100	3730	630	0.26	1.20	5	6	1
0018	2T	20_4	16	4	0	400	0	-400	0.00	0.00	0	0	0
0018	2T	20_4	21	1	0	100	0	-100	0.00	0.00	0	0	0
0018	2T	20_4	23	2	0	200	0	-200	0.00	0.00	0	0	0
0018	2T	20_4	24	2	0	200	0	-200	0.00	0.00	0	0	0
0018	2T	20_5	12	225	69	22500	19260	-3240	0.31	0.86	39	34	-5
0018	2T	20_5	13	63	14	6300	5410	-890	0.22	0.86	11	9	-2
0018	2T	20_5	14	37	7	3700	2110	-1590	0.19	0.57	6	3	-3
0018	2T	20_5	15	8	2	800	1080	280	0.25	1.35	1	1	0
0018	2T	20_5	16	1	0	100	0	-100	0.00	0.00	0	0	0
0018	2T	20_5	21	1	0	100	0	-100	0.00	0.00	0	0	0
0018	2T	20_5	23	1	0	100	0	-100	0.00	0.00	0	0	0
0018	2T	20_5	25	2	1	200	360	160	0.50	1.80	0	0	0
0018	2T	20_6	12	44	13	4400	3600	-800	0.30	0.82	7	6	-1
0018	2T	20_6	13	15	5	1500	1720	220	0.33	1.15	2	3	1
0018	2T	20_6	14	6	1	600	400	-200	0.17	0.67	1	0	-1
0018	2T	20_6	16	1	0	100	0	-100	0.00	0.00	0	0	0
0018	2T	20_6	21	1	1	100	330	230	1.00	3.30	0	0	0
0018	2T	20_6	23	1	0	100	0	-100	0.00	0.00	0	0	0
0018	2T	20_6	25	1	0	100	0	-100	0.00	0.00	0	0	0
0018	2T	20_7	12	299	72	29900	20580	-9320	0.24	0.69	52	36	-16
0018	2T	20_7	13	105	22	10500	7590	-2910	0.21	0.72	18	13	-5
0018	2T	20_7	14	73	14	7300	4840	-2460	0.19	0.66	12	8	-4
0018	2T	20_7	15	20	5	2000	2080	80	0.25	1.04	3	3	0
0018	2T	20_7	16	10	2	1000	760	-240	0.20	0.76	1	1	0
0018	2T	20_7	23	4	1	400	480	80	0.25	1.20	0	0	0
0018	2T	20_7	25	2	0	200	0	-200	0.00	0.00	0	0	0
0018	2T	20_7	26	2	0	200	0	-200	0.00	0.00	0	0	0
0018	2T	21_1	12	270	66	27000	18060	-8940	0.24	0.67	47	31	-16
0018	2T	21_1	13	145	46	14500	12000	-2500	0.32	0.83	25	21	-4
0018	2T	21_1	14	80	16	8000	5070	-2930	0.20	0.63	14	8	-6
0018	2T	21_1	15	2	0	200	0	-200	0.00	0.00	0	0	0
0018	2T	21_1	16	1	0	100	0	-100	0.00	0.00	0	0	0
0018	2T	21_1	21	3	1	300	480	180	0.33	1.60	0	0	0
0018	2T	21_1	23	2	0	200	0	-200	0.00	0.00	0	0	0
0018	2T	21_1	26	1	0	100	0	-100	0.00	0.00	0	0	0
0018	2T	21_2	12	278	74	27800	22520	-5280	0.27	0.81	49	39	-10
0018	2T	21_2	13	133	49	13300	14890	1590	0.37	1.12	23	26	3
0018	2T	21_2	14	84	26	8400	7600	-800	0.31	0.90	14	13	-1
0018	2T	21_2	15	14	3	1400	1470	70	0.21	1.05	2	2	0
0018	2T	21_2	16	1	1	100	690	590	1.00	6.90	0	1	1
0018	2T	21_2	21	4	0	400	0	-400	0.00	0.00	0	0	0
0018	2T	21_2	25	1	0	100	0	-100	0.00	0.00	0	0	0
0018	2T	21_2	26	5	1	500	540	40	0.20	1.08	0	0	0
0018	2T	21_3	12	281	75	28100	22300	-5800	0.27	0.79	49	39	-10
0018	2T	21_3	13	112	39	11200	10800	-400	0.35	0.96	19	19	0
0018	2T	21_3	14	77	16	7700	4160	-3540	0.21	0.54	13	7	-6
0018	2T	21_3	15	18	3	1800	1330	-470	0.17	0.74	3	2	-1
0018	2T	21_3	16	8	2	800	2060	1260	0.25	2.58	1	3	2
0018	2T	21_3	21	9	1	900	400	-500	0.11	0.44	1	0	-1
0018	2T	21_3	23	4	1	400	310	-90	0.25	0.78	0	0	0
0018	2T	21_3	24	2	0	200	0	-200	0.00	0.00	0	0	0
0018	2T	21_3	26	1	0	100	0	-100	0.00	0.00	0	0	0
0018	2T	21_4	12	234	60	23400	18360	-5040	0.26	0.78	41	32	-9
0018	2T	21_4	13	122	35	12200	9500	-2700	0.29	0.78	21	16	-5
0018	2T	21_4	14	74	19	7400	5400	-2000	0.26	0.73	13	9	-4
0018	2T	21_4	15	5	2	500	760	260	0.40	1.52	0	1	1
0018	2T	21_4	16	2	0	200	0	-200	0.00	0.00	0	0	0
0018	2T	21_4	21	3	0	300	0	-300	0.00	0.00	0	0	0
0018	2T	21_4	23	5	1	500	300	-200	0.20	0.60	0	0	0
0018	2T	21_4	24	1	0	100	0	-100	0.00	0.00	0	0	0
0018	2T	21_4	25	1	0	100	0	-100	0.00	0.00	0	0	0
0018	2T	21_4	26	3	0	300	0	-300	0.00	0.00	0	0	0
0018	2T	21_5	12	256	80	25600	21350	-4250	0.31	0.83	45	37	-8
0018	2T	21_5	13	79	22	7900	6120	-1780	0.28	0.77	13	10	-3
0018	2T	21_5	14	44	11	4400	2970	-1430	0.25	0.68	7	5	-2
0018	2T	21_5	15	16	1	1600	260	-1340	0.06	0.16	2	0	-2
0018	2T	21_5	16	1	0	100	0	-100	0.00	0.00	0	0	0
0018	2T	21_5	21	4	0	400	0	-400	0.00	0.00	0	0	0
0018	2T	21_5	24	1	0	100	0	-100	0.00	0.00	0	0	0
0018	2T	21_5	26	1	0	100	0	-100	0.00	0.00	0	0	0
0018	2T	21_6	12	19	4	1900	920	-980	0.21	0.48	3	1	-2
0018	2T	21_6	13	5	2	500	2280	1780	0.40	4.56	0	4	4
0018	2T	21_6	14	6	0	600	0	-600	0.00	0.00	1	0	-1
0018	2T	21_6	16	1	0	100	0	-100	0.00	0.00	0	0	0
0018	2T	21_6	21	2	1	200	360	160	0.50	1.80	0	0	0
0018	2T	21_7	12	328	84	32800	22780	-10020	0.26	0.69	58	40	-18
0018	2T	21_7	13	95	24	9500	7360	-2140	0.25	0.77	16	13	-3
0018	2T	21_7	14	69	20	6900	5820	-1080	0.29	0.84	12	10	-2
0018	2T	21_7	15	14	3	1400	910	-490	0.21	0.65	2	1	-1
0018	2T	21_7	16	9	0	900	0	-900	0.00	0.00	1	0	-1
0018	2T	21_7	21	3	1	300	490	190	0.33	1.63	0	0	0
0018	2T	21_7	23	2	1	200	860	660	0.50	4.30	0	1	1
0018	2T	21_7	24	1	0	100	0	-100	0.00	0.00	0	0	0
0018	2T	21_7	25	1	0	100	0	-100	0.00	0.00	0	0	0
0018	2T	21_7	26	1	0	100	0	-100	0.00	0.00	0	0	0
0018	2T	22_1	12	245	49	24500	16790	-7710	0.20	0.69	43	29	-14
0018	2T	22_1	13	92	25	9200	8290	-910	0.27	0.90	16	14	-2
0018	2T	22_1	14	50	13	5000	4200	-800	0.26	0.84	8	7	-1
0018	2T	22_1	15	6	2	600	730	130	0.33	1.22	1	1	0
0018	2T	22_1	16	7	1	700	650	-50	0.14	0.93	1	1	0
0018	2T	22_1	23	3	0	300	0	-300	0.00	0.00	0	0	0
0018	2T	22_1	24	4	1	400	480	80	0.25	1.20	0	0	0
0018	2T	22_1	25	2	1	200	370	170	0.50	1.85	0	0	0
0018	2T	22_1	26	1	0	100	0	-100	0.00	0.00	0	0	0
0018	2T	22_2	12	199	50	19900	18570	-1330	0.25	0.93	35	32	-3
0018	2T	22_2	13	97	17	9700	5700	-4000	0.18	0.59	17	10	-7
0018	2T	22_2	14	71	14	7100	4570	-2530	0.20	0.64	12	8	-4
0018	2T	22_2	15	18	4	1800	2340	540	0.22	1.30	3	4	1
0018	2T	22_2	16	16	1	1600	410	-1190	0.06	0.26	2	0	-2
0018	2T	22_2	23	5	0	500	0	-500	0.00	0.00	0	0	0
0018	2T	22_2	24	1	0	100	0	-100	0.00	0.00	0	0	0
0018	2T	22_2	25	2	0	200	0	-200	0.00	0.00	0	0	0
0018	2T	22_2	26	4	1	400	740	340	0.25	1.85	0	1	1
0018	2T	22_3	12	186	55	18600	19260	660	0.30	1.04	32	34	2
0018	2T	22_3	13	105	27	10500	12500	2000	0.26	1.19	18	22	4
0018	2T	22_3	14	54	11	5400	3570	-1830	0.20	0.66	9	6	-3
0018	2T	22_3	15	16	4	1600	1620	20	0.25	1.01	2	2	0
0018	2T	22_3	16	5	1	500	740	240	0.20	1.48	0	1	1
0018	2T	22_3	21	3	0	300	0	-300	0.00	0.00	0	0	0
0018	2T	22_3	23	4	0	400	0	-400	0.00	0.00	0	0	0
0018	2T	22_3	24	4	0	400	0	-400	0.00	0.00	0	0	0
0018	2T	22_3	25	3	0	300	0	-300	0.00	0.00	0	0	0
0018	2T	22_3	26	2	0	200	0	-200	0.00	0.00	0	0	0
0018	2T	22_4	12	182	53	18200	17440	-760	0.29	0.96	32	30	-2
0018	2T	22_4	13	110	30	11000	9520	-1480	0.27	0.87	19	16	-3
0018	2T	22_4	14	56	9	5600	2530	-3070	0.16	0.45	9	4	-5
0018	2T	22_4	15	20	6	2000	4630	2630	0.30	2.32	3	8	5
0018	2T	22_4	16	7	0	700	0	-700	0.00	0.00	1	0	-1
0018	2T	22_4	21	1	0	100	0	-100	0.00	0.00	0	0	0
0018	2T	22_4	23	6	1	600	380	-220	0.17	0.63	1	0	-1
0018	2T	22_4	24	4	1	400	300	-100	0.25	0.75	0	0	0
0018	2T	22_4	25	4	0	400	0	-400	0.00	0.00	0	0	0
0018	2T	22_4	26	5	1	500	470	-30	0.20	0.94	0	0	0
0018	2T	22_5	12	192	59	19200	16350	-2850	0.31	0.85	33	28	-5
0018	2T	22_5	13	84	31	8400	9550	1150	0.37	1.14	14	16	2
0018	2T	22_5	14	49	8	4900	2520	-2380	0.16	0.51	8	4	-4
0018	2T	22_5	15	2	0	200	0	-200	0.00	0.00	0	0	0
0018	2T	22_5	16	2	0	200	0	-200	0.00	0.00	0	0	0
0018	2T	22_5	21	1	1	100	2060	1960	1.00	20.60	0	3	3
0018	2T	22_5	23	2	0	200	0	-200	0.00	0.00	0	0	0
0018	2T	22_5	24	1	0	100	0	-100	0.00	0.00	0	0	0
0018	2T	22_7	12	267	71	26700	22590	-4110	0.27	0.85	47	39	-8
0018	2T	22_7	13	107	12	10700	3620	-7080	0.11	0.34	18	6	-12
0018	2T	22_7	14	53	7	5300	2340	-2960	0.13	0.44	9	4	-5
0018	2T	22_7	15	13	2	1300	1580	280	0.15	1.22	2	2	0
0018	2T	22_7	16	6	0	600	0	-600	0.00	0.00	1	0	-1
0018	2T	22_7	23	4	1	400	520	120	0.25	1.30	0	0	0
0018	2T	22_7	25	1	0	100	0	-100	0.00	0.00	0	0	0
0018	2T	23_1	12	268	68	26800	21960	-4840	0.25	0.82	47	38	-9
0018	2T	23_1	13	113	23	11300	6870	-4430	0.20	0.61	20	12	-8
0018	2T	23_1	14	51	7	5100	3170	-1930	0.14	0.62	9	5	-4
0018	2T	23_1	15	11	2	1100	1000	-100	0.18	0.91	1	1	0
0018	2T	23_1	16	1	0	100	0	-100	0.00	0.00	0	0	0
0018	2T	23_1	21	1	0	100	0	-100	0.00	0.00	0	0	0
0018	2T	23_1	23	2	0	200	0	-200	0.00	0.00	0	0	0
0018	2T	23_1	24	2	0	200	0	-200	0.00	0.00	0	0	0
0018	2T	23_1	25	2	0	200	0	-200	0.00	0.00	0	0	0
0018	2T	23_2	12	261	58	26100	22120	-3980	0.22	0.85	46	39	-7
0018	2T	23_2	13	117	28	11700	8350	-3350	0.24	0.71	20	14	-6
0018	2T	23_2	14	55	13	5500	5370	-130	0.24	0.98	9	9	0
0018	2T	23_2	15	15	2	1500	1150	-350	0.13	0.77	2	2	0
0018	2T	23_2	16	2	0	200	0	-200	0.00	0.00	0	0	0
0018	2T	23_2	21	3	1	300	700	400	0.33	2.33	0	1	1
0018	2T	23_2	23	3	0	300	0	-300	0.00	0.00	0	0	0
0018	2T	23_2	24	6	0	600	0	-600	0.00	0.00	1	0	-1
0018	2T	23_2	25	5	0	500	0	-500	0.00	0.00	0	0	0
0018	2T	23_3	12	236	51	23600	18310	-5290	0.22	0.78	41	32	-9
0018	2T	23_3	13	141	32	14100	11440	-2660	0.23	0.81	24	20	-4
0018	2T	23_3	14	53	7	5300	3190	-2110	0.13	0.60	9	5	-4
0018	2T	23_3	15	17	1	1700	770	-930	0.06	0.45	3	1	-2
0018	2T	23_3	16	4	1	400	1470	1070	0.25	3.68	0	2	2
0018	2T	23_3	21	4	1	400	400	0	0.25	1.00	0	0	0
0018	2T	23_3	23	3	2	300	2080	1780	0.67	6.93	0	3	3
0018	2T	23_3	24	2	1	200	840	640	0.50	4.20	0	1	1
0018	2T	23_3	25	4	0	400	0	-400	0.00	0.00	0	0	0
0018	2T	23_4	12	266	63	26600	15160	-11440	0.24	0.57	47	26	-21
0018	2T	23_4	13	111	35	11100	9050	-2050	0.32	0.82	19	16	-3
0018	2T	23_4	14	32	7	3200	3560	360	0.22	1.11	5	6	1
0018	2T	23_4	15	5	0	500	0	-500	0.00	0.00	0	0	0
0018	2T	23_4	16	5	0	500	0	-500	0.00	0.00	0	0	0
0018	2T	23_4	23	3	1	300	370	70	0.33	1.23	0	0	0
0018	2T	23_4	24	11	0	1100	0	-1100	0.00	0.00	1	0	-1
0018	2T	23_4	25	1	0	100	0	-100	0.00	0.00	0	0	0
0018	2T	23_4	26	2	0	200	0	-200	0.00	0.00	0	0	0
0018	2T	23_5	12	187	52	18700	12310	-6390	0.28	0.66	33	21	-12
0018	2T	23_5	13	84	22	8400	6940	-1460	0.26	0.83	14	12	-2
0018	2T	23_5	14	50	9	5000	3210	-1790	0.18	0.64	8	5	-3
0018	2T	23_5	15	10	1	1000	370	-630	0.10	0.37	1	0	-1
0018	2T	23_5	16	1	0	100	0	-100	0.00	0.00	0	0	0
0018	2T	23_5	23	2	0	200	0	-200	0.00	0.00	0	0	0
0018	2T	23_5	24	5	0	500	0	-500	0.00	0.00	0	0	0
0018	2T	23_5	25	2	0	200	0	-200	0.00	0.00	0	0	0
0018	2T	23_6	12	16	8	1600	2200	600	0.50	1.38	2	3	1
0018	2T	23_6	13	10	1	1000	300	-700	0.10	0.30	1	0	-1
0018	2T	23_6	14	3	2	300	910	610	0.67	3.03	0	1	1
0018	2T	23_6	15	2	0	200	0	-200	0.00	0.00	0	0	0
0018	2T	23_6	16	2	1	200	610	410	0.50	3.05	0	1	1
0018	2T	23_7	12	274	68	27400	19520	-7880	0.25	0.71	48	34	-14
0018	2T	23_7	13	151	35	15100	10600	-4500	0.23	0.70	26	18	-8
0018	2T	23_7	14	81	15	8100	5580	-2520	0.19	0.69	14	9	-5
0018	2T	23_7	15	12	4	1200	2080	880	0.33	1.73	2	3	1
0018	2T	23_7	16	15	2	1500	2060	560	0.13	1.37	2	3	1
0018	2T	23_7	21	1	1	100	790	690	1.00	7.90	0	1	1
0018	2T	23_7	23	1	0	100	0	-100	0.00	0.00	0	0	0
0018	2T	24_1	12	317	78	31700	21990	-9710	0.25	0.69	56	38	-18
0018	2T	24_1	13	121	34	12100	9320	-2780	0.28	0.77	21	16	-5
0018	2T	24_1	14	36	11	3600	3530	-70	0.31	0.98	6	6	0
0018	2T	24_1	15	13	3	1300	810	-490	0.23	0.62	2	1	-1
0018	2T	24_1	16	25	6	2500	2130	-370	0.24	0.85	4	3	-1
0018	2T	24_1	21	3	1	300	400	100	0.33	1.33	0	0	0
0018	2T	24_1	23	1	0	100	0	-100	0.00	0.00	0	0	0
0018	2T	24_1	25	1	0	100	0	-100	0.00	0.00	0	0	0
0018	2T	24_1	26	10	0	1000	0	-1000	0.00	0.00	1	0	-1
0018	2T	24_2	12	275	84	27500	22870	-4630	0.31	0.83	48	40	-8
0018	2T	24_2	13	146	50	14600	15350	750	0.34	1.05	25	27	2
0018	2T	24_2	14	47	18	4700	5810	1110	0.38	1.24	8	10	2
0018	2T	24_2	15	11	4	1100	1660	560	0.36	1.51	1	2	1
0018	2T	24_2	16	24	3	2400	720	-1680	0.13	0.30	4	1	-3
0018	2T	24_2	23	1	0	100	0	-100	0.00	0.00	0	0	0
0018	2T	24_2	24	1	1	100	180	80	1.00	1.80	0	0	0
0018	2T	24_2	25	1	0	100	0	-100	0.00	0.00	0	0	0
0018	2T	24_2	26	1	0	100	0	-100	0.00	0.00	0	0	0
0018	2T	24_3	12	312	96	31200	23860	-7340	0.31	0.76	55	42	-13
0018	2T	24_3	13	151	41	15100	10750	-4350	0.27	0.71	26	19	-7
0018	2T	24_3	14	71	19	7100	4650	-2450	0.27	0.65	12	8	-4
0018	2T	24_3	15	14	6	1400	2460	1060	0.43	1.76	2	4	2
0018	2T	24_3	16	5	1	500	560	60	0.20	1.12	0	0	0
0018	2T	24_3	21	2	1	200	530	330	0.50	2.65	0	0	0
0018	2T	24_3	23	2	0	200	0	-200	0.00	0.00	0	0	0
0018	2T	24_3	24	1	0	100	0	-100	0.00	0.00	0	0	0
0018	2T	24_3	26	3	1	300	920	620	0.33	3.07	0	1	1
0018	2T	24_4	12	209	62	20900	16470	-4430	0.30	0.79	36	29	-7
0018	2T	24_4	13	120	37	12000	11110	-890	0.31	0.93	21	19	-2
0018	2T	24_4	14	48	17	4800	5990	1190	0.35	1.25	8	10	2
0018	2T	24_4	15	12	4	1200	1040	-160	0.33	0.87	2	1	-1
0018	2T	24_4	16	7	1	700	520	-180	0.14	0.74	1	0	-1
0018	2T	24_4	21	1	0	100	0	-100	0.00	0.00	0	0	0
0018	2T	24_4	24	1	0	100	0	-100	0.00	0.00	0	0	0
0018	2T	24_5	12	139	52	13900	12950	-950	0.37	0.93	24	22	-2
0018	2T	24_5	13	39	5	3900	1750	-2150	0.13	0.45	6	3	-3
0018	2T	24_5	14	31	5	3100	1690	-1410	0.16	0.55	5	2	-3
0018	2T	24_5	15	7	2	700	900	200	0.29	1.29	1	1	0
0018	2T	24_5	16	2	0	200	0	-200	0.00	0.00	0	0	0
0018	2T	24_5	21	1	0	100	0	-100	0.00	0.00	0	0	0
0018	2T	24_5	23	3	0	300	0	-300	0.00	0.00	0	0	0
0018	2T	24_6	12	28	12	2800	2650	-150	0.43	0.95	4	4	0
0018	2T	24_6	13	14	4	1400	830	-570	0.29	0.59	2	1	-1
0018	2T	24_6	14	8	3	800	670	-130	0.38	0.84	1	1	0
0018	2T	24_6	15	2	0	200	0	-200	0.00	0.00	0	0	0
0018	2T	24_6	16	1	0	100	0	-100	0.00	0.00	0	0	0
0018	2T	24_6	26	1	0	100	0	-100	0.00	0.00	0	0	0
0018	2T	24_7	12	359	120	35900	31440	-4460	0.33	0.88	63	55	-8
0018	2T	24_7	13	124	33	12400	9360	-3040	0.27	0.75	21	16	-5
0018	2T	24_7	14	58	11	5800	4260	-1540	0.19	0.73	10	7	-3
0018	2T	24_7	15	17	2	1700	520	-1180	0.12	0.31	3	0	-3
0018	2T	24_7	16	20	4	2000	1550	-450	0.20	0.78	3	2	-1
0018	2T	24_7	21	2	0	200	0	-200	0.00	0.00	0	0	0
0018	2T	24_7	23	3	0	300	0	-300	0.00	0.00	0	0	0
0018	2T	24_7	24	1	0	100	0	-100	0.00	0.00	0	0	0
0018	2T	24_7	25	1	0	100	0	-100	0.00	0.00	0	0	0
0018	2T	24_7	26	1	1	100	1590	1490	1.00	15.90	0	2	2
0018	3F	01_1	123	76	20	7600	5830	-1770	0.26	0.77	13	10	-3
0018	3F	01_1	124	94	22	9400	8080	-1320	0.23	0.86	16	14	-2
0018	3F	01_1	125	60	13	6000	4940	-1060	0.22	0.82	10	8	-2
0018	3F	01_1	126	45	3	4500	1780	-2720	0.07	0.40	7	3	-4
0018	3F	01_1	134	20	4	2000	1370	-630	0.20	0.69	3	2	-1
0018	3F	01_1	135	31	5	3100	2710	-390	0.16	0.87	5	4	-1
0018	3F	01_1	136	31	3	3100	1390	-1710	0.10	0.45	5	2	-3
0018	3F	01_1	145	4	2	400	1250	850	0.50	3.13	0	2	2
0018	3F	01_1	146	5	2	500	860	360	0.40	1.72	0	1	1
0018	3F	01_1	156	2	1	200	560	360	0.50	2.80	0	0	0
0018	3F	01_1	234	1	1	100	630	530	1.00	6.30	0	1	1
0018	3F	01_1	235	1	0	100	0	-100	0.00	0.00	0	0	0
0018	3F	01_1	245	2	1	200	310	110	0.50	1.55	0	0	0
0018	3F	01_2	123	45	12	4500	2710	-1790	0.27	0.60	7	4	-3
0018	3F	01_2	124	84	18	8400	5890	-2510	0.21	0.70	14	10	-4
0018	3F	01_2	125	57	10	5700	3400	-2300	0.18	0.60	10	6	-4
0018	3F	01_2	126	45	4	4500	1890	-2610	0.09	0.42	7	3	-4
0018	3F	01_2	134	26	3	2600	1570	-1030	0.12	0.60	4	2	-2
0018	3F	01_2	135	26	3	2600	1380	-1220	0.12	0.53	4	2	-2
0018	3F	01_2	136	15	3	1500	890	-610	0.20	0.59	2	1	-1
0018	3F	01_2	145	8	0	800	0	-800	0.00	0.00	1	0	-1
0018	3F	01_2	146	11	1	1100	310	-790	0.09	0.28	1	0	-1
0018	3F	01_2	156	4	1	400	360	-40	0.25	0.90	0	0	0
0018	3F	01_2	234	1	1	100	220	120	1.00	2.20	0	0	0
0018	3F	01_2	236	3	0	300	0	-300	0.00	0.00	0	0	0
0018	3F	01_2	245	1	0	100	0	-100	0.00	0.00	0	0	0
0018	3F	01_3	123	48	13	4800	4260	-540	0.27	0.89	8	7	-1
0018	3F	01_3	124	96	11	9600	4360	-5240	0.11	0.45	16	7	-9
0018	3F	01_3	125	58	11	5800	5040	-760	0.19	0.87	10	8	-2
0018	3F	01_3	126	34	5	3400	2050	-1350	0.15	0.60	6	3	-3
0018	3F	01_3	134	17	2	1700	1340	-360	0.12	0.79	3	2	-1
0018	3F	01_3	135	26	6	2600	1490	-1110	0.23	0.57	4	2	-2
0018	3F	01_3	136	22	5	2200	2280	80	0.23	1.04	3	4	1
0018	3F	01_3	145	13	4	1300	1940	640	0.31	1.49	2	3	1
0018	3F	01_3	146	12	2	1200	1220	20	0.17	1.02	2	2	0
0018	3F	01_3	156	3	0	300	0	-300	0.00	0.00	0	0	0
0018	3F	01_3	234	1	1	100	300	200	1.00	3.00	0	0	0
0018	3F	01_3	245	2	0	200	0	-200	0.00	0.00	0	0	0
0018	3F	01_4	123	66	18	6600	5010	-1590	0.27	0.76	11	8	-3
0018	3F	01_4	124	101	18	10100	7500	-2600	0.18	0.74	17	13	-4
0018	3F	01_4	125	56	12	5600	3490	-2110	0.21	0.62	9	6	-3
0018	3F	01_4	126	36	6	3600	4560	960	0.17	1.27	6	8	2
0018	3F	01_4	134	21	4	2100	1780	-320	0.19	0.85	3	3	0
0018	3F	01_4	135	17	5	1700	2120	420	0.29	1.25	3	3	0
0018	3F	01_4	136	15	3	1500	830	-670	0.20	0.55	2	1	-1
0018	3F	01_4	145	8	1	800	520	-280	0.13	0.65	1	0	-1
0018	3F	01_4	146	3	0	300	0	-300	0.00	0.00	0	0	0
0018	3F	01_4	156	3	0	300	0	-300	0.00	0.00	0	0	0
0018	3F	01_4	235	3	0	300	0	-300	0.00	0.00	0	0	0
0018	3F	01_4	236	1	0	100	0	-100	0.00	0.00	0	0	0
0018	3F	01_4	245	2	0	200	0	-200	0.00	0.00	0	0	0
0018	3F	01_4	246	1	0	100	0	-100	0.00	0.00	0	0	0
0018	3F	01_4	256	2	0	200	0	-200	0.00	0.00	0	0	0
0018	3F	01_5	123	36	10	3600	3480	-120	0.28	0.97	6	6	0
0018	3F	01_5	124	68	17	6800	6650	-150	0.25	0.98	12	11	-1
0018	3F	01_5	125	48	9	4800	4100	-700	0.19	0.85	8	7	-1
0018	3F	01_5	126	20	3	2000	1400	-600	0.15	0.70	3	2	-1
0018	3F	01_5	134	20	3	2000	840	-1160	0.15	0.42	3	1	-2
0018	3F	01_5	135	25	4	2500	1710	-790	0.16	0.68	4	3	-1
0018	3F	01_5	136	7	1	700	350	-350	0.14	0.50	1	0	-1
0018	3F	01_5	145	8	0	800	0	-800	0.00	0.00	1	0	-1
0018	3F	01_5	146	3	0	300	0	-300	0.00	0.00	0	0	0
0018	3F	01_5	156	1	0	100	0	-100	0.00	0.00	0	0	0
0018	3F	01_5	245	1	0	100	0	-100	0.00	0.00	0	0	0
0018	3F	01_5	246	1	0	100	0	-100	0.00	0.00	0	0	0
0018	3F	01_6	123	2	1	200	330	130	0.50	1.65	0	0	0
0018	3F	01_6	124	7	0	700	0	-700	0.00	0.00	1	0	-1
0018	3F	01_6	125	4	2	400	1090	690	0.50	2.73	0	1	1
0018	3F	01_6	126	2	1	200	270	70	0.50	1.35	0	0	0
0018	3F	01_6	135	2	0	200	0	-200	0.00	0.00	0	0	0
0018	3F	01_6	145	1	0	100	0	-100	0.00	0.00	0	0	0
0018	3F	01_6	146	1	1	100	220	120	1.00	2.20	0	0	0
0018	3F	01_7	123	47	12	4700	3450	-1250	0.26	0.73	8	6	-2
0018	3F	01_7	124	119	19	11900	6850	-5050	0.16	0.58	21	12	-9
0018	3F	01_7	125	63	12	6300	3800	-2500	0.19	0.60	11	6	-5
0018	3F	01_7	126	45	9	4500	3350	-1150	0.20	0.74	7	5	-2
0018	3F	01_7	134	33	4	3300	1490	-1810	0.12	0.45	5	2	-3
0018	3F	01_7	135	27	3	2700	1530	-1170	0.11	0.57	4	2	-2
0018	3F	01_7	136	17	0	1700	0	-1700	0.00	0.00	3	0	-3
0018	3F	01_7	145	9	0	900	0	-900	0.00	0.00	1	0	-1
0018	3F	01_7	146	8	2	800	580	-220	0.25	0.73	1	1	0
0018	3F	01_7	156	1	0	100	0	-100	0.00	0.00	0	0	0
0018	3F	01_7	234	1	0	100	0	-100	0.00	0.00	0	0	0
0018	3F	01_7	236	2	0	200	0	-200	0.00	0.00	0	0	0
0018	3F	01_7	246	1	0	100	0	-100	0.00	0.00	0	0	0
0018	3F	01_7	256	1	0	100	0	-100	0.00	0.00	0	0	0
0018	3F	02_1	123	76	11	7600	5780	-1820	0.14	0.76	13	10	-3
0018	3F	02_1	124	93	10	9300	4820	-4480	0.11	0.52	16	8	-8
0018	3F	02_1	125	52	8	5200	4480	-720	0.15	0.86	9	7	-2
0018	3F	02_1	126	53	5	5300	6290	990	0.09	1.19	9	11	2
0018	3F	02_1	134	31	4	3100	2310	-790	0.13	0.75	5	4	-1
0018	3F	02_1	135	16	1	1600	480	-1120	0.06	0.30	2	0	-2
0018	3F	02_1	136	27	4	2700	5490	2790	0.15	2.03	4	9	5
0018	3F	02_1	145	13	2	1300	1160	-140	0.15	0.89	2	2	0
0018	3F	02_1	146	12	3	1200	2470	1270	0.25	2.06	2	4	2
0018	3F	02_1	234	1	0	100	0	-100	0.00	0.00	0	0	0
0018	3F	02_1	235	1	0	100	0	-100	0.00	0.00	0	0	0
0018	3F	02_1	236	1	0	100	0	-100	0.00	0.00	0	0	0
0018	3F	02_1	245	7	0	700	0	-700	0.00	0.00	1	0	-1
0018	3F	02_1	246	2	0	200	0	-200	0.00	0.00	0	0	0
0018	3F	02_1	256	1	0	100	0	-100	0.00	0.00	0	0	0
0018	3F	02_2	123	63	5	6300	1350	-4950	0.08	0.21	11	2	-9
0018	3F	02_2	124	81	12	8100	4540	-3560	0.15	0.56	14	8	-6
0018	3F	02_2	125	78	10	7800	3200	-4600	0.13	0.41	13	5	-8
0018	3F	02_2	126	56	9	5600	4700	-900	0.16	0.84	9	8	-1
0018	3F	02_2	134	23	4	2300	1340	-960	0.17	0.58	4	2	-2
0018	3F	02_2	135	16	4	1600	1530	-70	0.25	0.96	2	2	0
0018	3F	02_2	136	28	6	2800	2710	-90	0.21	0.97	4	4	0
0018	3F	02_2	145	8	1	800	420	-380	0.13	0.53	1	0	-1
0018	3F	02_2	146	15	3	1500	2260	760	0.20	1.51	2	4	2
0018	3F	02_2	156	4	0	400	0	-400	0.00	0.00	0	0	0
0018	3F	02_2	234	1	0	100	0	-100	0.00	0.00	0	0	0
0018	3F	02_2	235	1	0	100	0	-100	0.00	0.00	0	0	0
0018	3F	02_2	236	3	0	300	0	-300	0.00	0.00	0	0	0
0018	3F	02_2	246	1	0	100	0	-100	0.00	0.00	0	0	0
0018	3F	02_2	256	1	1	100	300	200	1.00	3.00	0	0	0
0018	3F	02_3	123	76	19	7600	6560	-1040	0.25	0.86	13	11	-2
0018	3F	02_3	124	79	13	7900	6130	-1770	0.16	0.78	13	10	-3
0018	3F	02_3	125	71	6	7100	2630	-4470	0.08	0.37	12	4	-8
0018	3F	02_3	126	67	12	6700	5860	-840	0.18	0.87	11	10	-1
0018	3F	02_3	134	21	3	2100	1750	-350	0.14	0.83	3	3	0
0018	3F	02_3	135	19	3	1900	1010	-890	0.16	0.53	3	1	-2
0018	3F	02_3	136	12	4	1200	2870	1670	0.33	2.39	2	5	3
0018	3F	02_3	145	14	2	1400	900	-500	0.14	0.64	2	1	-1
0018	3F	02_3	146	9	0	900	0	-900	0.00	0.00	1	0	-1
0018	3F	02_3	156	1	1	100	640	540	1.00	6.40	0	1	1
0018	3F	02_3	234	1	1	100	280	180	1.00	2.80	0	0	0
0018	3F	02_3	235	3	0	300	0	-300	0.00	0.00	0	0	0
0018	3F	02_3	236	2	0	200	0	-200	0.00	0.00	0	0	0
0018	3F	02_3	245	4	0	400	0	-400	0.00	0.00	0	0	0
0018	3F	02_3	246	1	0	100	0	-100	0.00	0.00	0	0	0
0018	3F	02_4	123	65	15	6500	5500	-1000	0.23	0.85	11	9	-2
0018	3F	02_4	124	66	12	6600	5420	-1180	0.18	0.82	11	9	-2
0018	3F	02_4	125	41	7	4100	4410	310	0.17	1.08	7	7	0
0018	3F	02_4	126	12	0	1200	0	-1200	0.00	0.00	2	0	-2
0018	3F	02_4	134	16	1	1600	310	-1290	0.06	0.19	2	0	-2
0018	3F	02_4	135	12	1	1200	250	-950	0.08	0.21	2	0	-2
0018	3F	02_4	136	5	1	500	1180	680	0.20	2.36	0	2	2
0018	3F	02_4	145	16	5	1600	1950	350	0.31	1.22	2	3	1
0018	3F	02_4	146	4	0	400	0	-400	0.00	0.00	0	0	0
0018	3F	02_4	234	1	0	100	0	-100	0.00	0.00	0	0	0
0018	3F	02_4	235	3	0	300	0	-300	0.00	0.00	0	0	0
0018	3F	02_4	236	2	0	200	0	-200	0.00	0.00	0	0	0
0018	3F	02_4	245	2	2	200	830	630	1.00	4.15	0	1	1
0018	3F	02_4	246	2	0	200	0	-200	0.00	0.00	0	0	0
0018	3F	02_5	123	27	5	2700	2300	-400	0.19	0.85	4	4	0
0018	3F	02_5	124	47	4	4700	1310	-3390	0.09	0.28	8	2	-6
0018	3F	02_5	125	34	3	3400	1180	-2220	0.09	0.35	6	2	-4
0018	3F	02_5	126	16	1	1600	1390	-210	0.06	0.87	2	2	0
0018	3F	02_5	134	6	4	600	1130	530	0.67	1.88	1	2	1
0018	3F	02_5	135	7	1	700	480	-220	0.14	0.69	1	0	-1
0018	3F	02_5	136	4	0	400	0	-400	0.00	0.00	0	0	0
0018	3F	02_5	145	6	0	600	0	-600	0.00	0.00	1	0	-1
0018	3F	02_5	146	3	1	300	600	300	0.33	2.00	0	1	1
0018	3F	02_6	123	4	2	400	670	270	0.50	1.68	0	1	1
0018	3F	02_6	124	2	0	200	0	-200	0.00	0.00	0	0	0
0018	3F	02_6	126	2	0	200	0	-200	0.00	0.00	0	0	0
0018	3F	02_6	134	1	0	100	0	-100	0.00	0.00	0	0	0
0018	3F	02_6	136	2	0	200	0	-200	0.00	0.00	0	0	0
0018	3F	02_7	123	65	11	6500	3630	-2870	0.17	0.56	11	6	-5
0018	3F	02_7	124	97	16	9700	7250	-2450	0.16	0.75	17	12	-5
0018	3F	02_7	125	70	10	7000	4090	-2910	0.14	0.58	12	7	-5
0018	3F	02_7	126	60	5	6000	3530	-2470	0.08	0.59	10	6	-4
0018	3F	02_7	134	40	8	4000	3370	-630	0.20	0.84	7	5	-2
0018	3F	02_7	135	27	4	2700	1860	-840	0.15	0.69	4	3	-1
0018	3F	02_7	136	14	1	1400	260	-1140	0.07	0.19	2	0	-2
0018	3F	02_7	145	10	2	1000	1610	610	0.20	1.61	1	2	1
0018	3F	02_7	146	11	0	1100	0	-1100	0.00	0.00	1	0	-1
0018	3F	02_7	234	2	1	200	400	200	0.50	2.00	0	0	0
0018	3F	02_7	235	1	0	100	0	-100	0.00	0.00	0	0	0
0018	3F	02_7	236	1	0	100	0	-100	0.00	0.00	0	0	0
0018	3F	02_7	245	1	0	100	0	-100	0.00	0.00	0	0	0
0018	3F	02_7	246	3	0	300	0	-300	0.00	0.00	0	0	0
0018	3F	02_7	256	1	0	100	0	-100	0.00	0.00	0	0	0
0018	3F	03_1	123	33	10	3300	3920	620	0.30	1.19	5	6	1
0018	3F	03_1	124	71	16	7100	6780	-320	0.23	0.95	12	12	0
0018	3F	03_1	125	34	4	3400	2610	-790	0.12	0.77	6	4	-2
0018	3F	03_1	126	31	5	3100	4370	1270	0.16	1.41	5	7	2
0018	3F	03_1	134	24	5	2400	2250	-150	0.21	0.94	4	3	-1
0018	3F	03_1	135	39	8	3900	4120	220	0.21	1.06	6	7	1
0018	3F	03_1	136	16	3	1600	1370	-230	0.19	0.86	2	2	0
0018	3F	03_1	145	6	0	600	0	-600	0.00	0.00	1	0	-1
0018	3F	03_1	146	11	1	1100	280	-820	0.09	0.25	1	0	-1
0018	3F	03_1	156	3	1	300	580	280	0.33	1.93	0	1	1
0018	3F	03_1	234	2	0	200	0	-200	0.00	0.00	0	0	0
0018	3F	03_1	235	2	0	200	0	-200	0.00	0.00	0	0	0
0018	3F	03_1	245	2	0	200	0	-200	0.00	0.00	0	0	0
0018	3F	03_2	123	42	15	4200	4320	120	0.36	1.03	7	7	0
0018	3F	03_2	124	39	7	3900	2580	-1320	0.18	0.66	6	4	-2
0018	3F	03_2	125	46	7	4600	3140	-1460	0.15	0.68	8	5	-3
0018	3F	03_2	126	26	5	2600	2690	90	0.19	1.03	4	4	0
0018	3F	03_2	134	13	2	1300	630	-670	0.15	0.48	2	1	-1
0018	3F	03_2	135	16	2	1600	820	-780	0.13	0.51	2	1	-1
0018	3F	03_2	136	21	2	2100	1120	-980	0.10	0.53	3	1	-2
0018	3F	03_2	145	6	2	600	830	230	0.33	1.38	1	1	0
0018	3F	03_2	146	8	1	800	250	-550	0.13	0.31	1	0	-1
0018	3F	03_2	156	8	2	800	1130	330	0.25	1.41	1	2	1
0018	3F	03_2	235	1	0	100	0	-100	0.00	0.00	0	0	0
0018	3F	03_2	236	2	0	200	0	-200	0.00	0.00	0	0	0
0018	3F	03_2	246	2	0	200	0	-200	0.00	0.00	0	0	0
0018	3F	03_2	256	1	0	100	0	-100	0.00	0.00	0	0	0
0018	3F	03_3	123	46	16	4600	5200	600	0.35	1.13	8	9	1
0018	3F	03_3	124	63	9	6300	4280	-2020	0.14	0.68	11	7	-4
0018	3F	03_3	125	35	4	3500	1220	-2280	0.11	0.35	6	2	-4
0018	3F	03_3	126	44	5	4400	2080	-2320	0.11	0.47	7	3	-4
0018	3F	03_3	134	31	7	3100	2020	-1080	0.23	0.65	5	3	-2
0018	3F	03_3	135	21	3	2100	840	-1260	0.14	0.40	3	1	-2
0018	3F	03_3	136	26	4	2600	2250	-350	0.15	0.87	4	3	-1
0018	3F	03_3	145	9	2	900	1670	770	0.22	1.86	1	2	1
0018	3F	03_3	146	16	1	1600	250	-1350	0.06	0.16	2	0	-2
0018	3F	03_3	156	2	0	200	0	-200	0.00	0.00	0	0	0
0018	3F	03_3	234	1	0	100	0	-100	0.00	0.00	0	0	0
0018	3F	03_3	235	1	0	100	0	-100	0.00	0.00	0	0	0
0018	3F	03_3	245	1	0	100	0	-100	0.00	0.00	0	0	0
0018	3F	03_3	246	1	0	100	0	-100	0.00	0.00	0	0	0
0018	3F	03_4	123	29	9	2900	3050	150	0.31	1.05	5	5	0
0018	3F	03_4	124	40	7	4000	2710	-1290	0.18	0.68	7	4	-3
0018	3F	03_4	125	31	6	3100	2340	-760	0.19	0.75	5	4	-1
0018	3F	03_4	126	15	4	1500	4770	3270	0.27	3.18	2	8	6
0018	3F	03_4	134	25	6	2500	2620	120	0.24	1.05	4	4	0
0018	3F	03_4	135	13	4	1300	1770	470	0.31	1.36	2	3	1
0018	3F	03_4	136	13	1	1300	500	-800	0.08	0.38	2	0	-2
0018	3F	03_4	145	10	1	1000	640	-360	0.10	0.64	1	1	0
0018	3F	03_4	146	3	1	300	700	400	0.33	2.33	0	1	1
0018	3F	03_4	156	1	1	100	1020	920	1.00	10.20	0	1	1
0018	3F	03_4	234	1	0	100	0	-100	0.00	0.00	0	0	0
0018	3F	03_4	235	1	0	100	0	-100	0.00	0.00	0	0	0
0018	3F	03_4	246	1	0	100	0	-100	0.00	0.00	0	0	0
0018	3F	03_5	123	29	5	2900	1470	-1430	0.17	0.51	5	2	-3
0018	3F	03_5	124	31	3	3100	1580	-1520	0.10	0.51	5	2	-3
0018	3F	03_5	125	15	3	1500	1280	-220	0.20	0.85	2	2	0
0018	3F	03_5	126	6	3	600	1710	1110	0.50	2.85	1	3	2
0018	3F	03_5	134	8	2	800	940	140	0.25	1.18	1	1	0
0018	3F	03_5	135	8	0	800	0	-800	0.00	0.00	1	0	-1
0018	3F	03_5	136	6	1	600	560	-40	0.17	0.93	1	0	-1
0018	3F	03_5	145	3	0	300	0	-300	0.00	0.00	0	0	0
0018	3F	03_5	146	3	0	300	0	-300	0.00	0.00	0	0	0
0018	3F	03_5	156	3	0	300	0	-300	0.00	0.00	0	0	0
0018	3F	03_5	246	1	0	100	0	-100	0.00	0.00	0	0	0
0018	3F	03_7	123	41	12	4100	3840	-260	0.29	0.94	7	6	-1
0018	3F	03_7	124	62	13	6200	5470	-730	0.21	0.88	10	9	-1
0018	3F	03_7	125	43	9	4300	3900	-400	0.21	0.91	7	6	-1
0018	3F	03_7	126	31	3	3100	2880	-220	0.10	0.93	5	5	0
0018	3F	03_7	134	35	5	3500	2560	-940	0.14	0.73	6	4	-2
0018	3F	03_7	135	22	3	2200	1350	-850	0.14	0.61	3	2	-1
0018	3F	03_7	136	19	0	1900	0	-1900	0.00	0.00	3	0	-3
0018	3F	03_7	145	5	2	500	620	120	0.40	1.24	0	1	1
0018	3F	03_7	146	7	1	700	400	-300	0.14	0.57	1	0	-1
0018	3F	03_7	156	7	0	700	0	-700	0.00	0.00	1	0	-1
0018	3F	03_7	234	1	0	100	0	-100	0.00	0.00	0	0	0
0018	3F	03_7	236	1	0	100	0	-100	0.00	0.00	0	0	0
0018	3F	03_7	256	1	0	100	0	-100	0.00	0.00	0	0	0
0018	3F	04_1	123	24	4	2400	1840	-560	0.17	0.77	4	3	-1
0018	3F	04_1	124	82	14	8200	5230	-2970	0.17	0.64	14	9	-5
0018	3F	04_1	125	39	9	3900	3690	-210	0.23	0.95	6	6	0
0018	3F	04_1	126	46	7	4600	5630	1030	0.15	1.22	8	9	1
0018	3F	04_1	134	28	4	2800	2600	-200	0.14	0.93	4	4	0
0018	3F	04_1	135	29	6	2900	2340	-560	0.21	0.81	5	4	-1
0018	3F	04_1	136	20	2	2000	520	-1480	0.10	0.26	3	0	-3
0018	3F	04_1	145	13	1	1300	880	-420	0.08	0.68	2	1	-1
0018	3F	04_1	146	16	1	1600	690	-910	0.06	0.43	2	1	-1
0018	3F	04_1	156	3	1	300	220	-80	0.33	0.73	0	0	0
0018	3F	04_1	245	2	0	200	0	-200	0.00	0.00	0	0	0
0018	3F	04_1	246	2	0	200	0	-200	0.00	0.00	0	0	0
0018	3F	04_2	123	39	12	3900	4050	150	0.31	1.04	6	7	1
0018	3F	04_2	124	54	18	5400	8220	2820	0.33	1.52	9	14	5
0018	3F	04_2	125	51	13	5100	7970	2870	0.25	1.56	9	14	5
0018	3F	04_2	126	39	4	3900	1810	-2090	0.10	0.46	6	3	-3
0018	3F	04_2	134	27	4	2700	1330	-1370	0.15	0.49	4	2	-2
0018	3F	04_2	135	31	5	3100	1870	-1230	0.16	0.60	5	3	-2
0018	3F	04_2	136	20	3	2000	1970	-30	0.15	0.99	3	3	0
0018	3F	04_2	145	8	0	800	0	-800	0.00	0.00	1	0	-1
0018	3F	04_2	146	11	3	1100	1350	250	0.27	1.23	1	2	1
0018	3F	04_2	156	3	1	300	400	100	0.33	1.33	0	0	0
0018	3F	04_2	235	1	1	100	180	80	1.00	1.80	0	0	0
0018	3F	04_2	236	2	1	200	420	220	0.50	2.10	0	0	0
0018	3F	04_3	123	48	14	4800	4970	170	0.29	1.04	8	8	0
0018	3F	04_3	124	69	15	6900	4830	-2070	0.22	0.70	12	8	-4
0018	3F	04_3	125	49	9	4900	3440	-1460	0.18	0.70	8	6	-2
0018	3F	04_3	126	53	10	5300	3950	-1350	0.19	0.75	9	6	-3
0018	3F	04_3	134	21	2	2100	520	-1580	0.10	0.25	3	0	-3
0018	3F	04_3	135	27	6	2700	1990	-710	0.22	0.74	4	3	-1
0018	3F	04_3	136	32	3	3200	1000	-2200	0.09	0.31	5	1	-4
0018	3F	04_3	145	14	3	1400	850	-550	0.21	0.61	2	1	-1
0018	3F	04_3	146	5	0	500	0	-500	0.00	0.00	0	0	0
0018	3F	04_3	156	4	0	400	0	-400	0.00	0.00	0	0	0
0018	3F	04_3	234	2	1	200	210	10	0.50	1.05	0	0	0
0018	3F	04_3	235	1	0	100	0	-100	0.00	0.00	0	0	0
0018	3F	04_3	236	3	1	300	1140	840	0.33	3.80	0	2	2
0018	3F	04_3	246	1	0	100	0	-100	0.00	0.00	0	0	0
0018	3F	04_4	123	29	9	2900	2140	-760	0.31	0.74	5	3	-2
0018	3F	04_4	124	72	14	7200	4710	-2490	0.19	0.65	12	8	-4
0018	3F	04_4	125	28	5	2800	1560	-1240	0.18	0.56	4	2	-2
0018	3F	04_4	126	20	3	2000	1070	-930	0.15	0.54	3	1	-2
0018	3F	04_4	134	25	9	2500	3160	660	0.36	1.26	4	5	1
0018	3F	04_4	135	19	5	1900	2080	180	0.26	1.09	3	3	0
0018	3F	04_4	136	23	8	2300	6530	4230	0.35	2.84	4	11	7
0018	3F	04_4	145	14	2	1400	970	-430	0.14	0.69	2	1	-1
0018	3F	04_4	146	5	1	500	360	-140	0.20	0.72	0	0	0
0018	3F	04_4	156	1	1	100	1520	1420	1.00	15.20	0	2	2
0018	3F	04_4	236	1	0	100	0	-100	0.00	0.00	0	0	0
0018	3F	04_5	123	32	7	3200	1960	-1240	0.22	0.61	5	3	-2
0018	3F	04_5	124	53	11	5300	4340	-960	0.21	0.82	9	7	-2
0018	3F	04_5	125	27	4	2700	3250	550	0.15	1.20	4	5	1
0018	3F	04_5	126	31	6	3100	3400	300	0.19	1.10	5	6	1
0018	3F	04_5	134	23	6	2300	1930	-370	0.26	0.84	4	3	-1
0018	3F	04_5	135	17	2	1700	1930	230	0.12	1.14	3	3	0
0018	3F	04_5	136	15	2	1500	560	-940	0.13	0.37	2	0	-2
0018	3F	04_5	145	4	0	400	0	-400	0.00	0.00	0	0	0
0018	3F	04_5	146	7	2	700	630	-70	0.29	0.90	1	1	0
0018	3F	04_5	156	1	1	100	890	790	1.00	8.90	0	1	1
0018	3F	04_5	234	1	1	100	290	190	1.00	2.90	0	0	0
0018	3F	04_7	123	28	5	2800	1580	-1220	0.18	0.56	4	2	-2
0018	3F	04_7	124	72	14	7200	5260	-1940	0.19	0.73	12	9	-3
0018	3F	04_7	125	48	11	4800	5280	480	0.23	1.10	8	9	1
0018	3F	04_7	126	40	7	4000	4160	160	0.18	1.04	7	7	0
0018	3F	04_7	134	27	5	2700	1990	-710	0.19	0.74	4	3	-1
0018	3F	04_7	135	26	4	2600	1450	-1150	0.15	0.56	4	2	-2
0018	3F	04_7	136	13	0	1300	0	-1300	0.00	0.00	2	0	-2
0018	3F	04_7	145	10	1	1000	400	-600	0.10	0.40	1	0	-1
0018	3F	04_7	146	8	2	800	3450	2650	0.25	4.31	1	6	5
0018	3F	04_7	156	8	1	800	480	-320	0.13	0.60	1	0	-1
0018	3F	04_7	234	2	0	200	0	-200	0.00	0.00	0	0	0
0018	3F	04_7	235	3	1	300	250	-50	0.33	0.83	0	0	0
0018	3F	04_7	246	1	0	100	0	-100	0.00	0.00	0	0	0
0018	3F	05_1	123	67	7	6700	3920	-2780	0.10	0.59	11	6	-5
0018	3F	05_1	124	82	21	8200	8830	630	0.26	1.08	14	15	1
0018	3F	05_1	125	59	13	5900	5820	-80	0.22	0.99	10	10	0
0018	3F	05_1	126	52	8	5200	7130	1930	0.15	1.37	9	12	3
0018	3F	05_1	134	28	6	2800	1730	-1070	0.21	0.62	4	3	-1
0018	3F	05_1	135	34	10	3400	3620	220	0.29	1.06	6	6	0
0018	3F	05_1	136	34	6	3400	3040	-360	0.18	0.89	6	5	-1
0018	3F	05_1	145	11	1	1100	520	-580	0.09	0.47	1	0	-1
0018	3F	05_1	146	7	0	700	0	-700	0.00	0.00	1	0	-1
0018	3F	05_1	156	4	0	400	0	-400	0.00	0.00	0	0	0
0018	3F	05_1	236	1	0	100	0	-100	0.00	0.00	0	0	0
0018	3F	05_2	123	33	8	3300	2880	-420	0.24	0.87	5	5	0
0018	3F	05_2	124	78	12	7800	3870	-3930	0.15	0.50	13	6	-7
0018	3F	05_2	125	65	12	6500	5760	-740	0.18	0.89	11	10	-1
0018	3F	05_2	126	50	9	5000	4280	-720	0.18	0.86	8	7	-1
0018	3F	05_2	134	18	4	1800	910	-890	0.22	0.51	3	1	-2
0018	3F	05_2	135	38	7	3800	2540	-1260	0.18	0.67	6	4	-2
0018	3F	05_2	136	24	6	2400	2200	-200	0.25	0.92	4	3	-1
0018	3F	05_2	145	9	1	900	450	-450	0.11	0.50	1	0	-1
0018	3F	05_2	146	5	0	500	0	-500	0.00	0.00	0	0	0
0018	3F	05_2	156	6	1	600	700	100	0.17	1.17	1	1	0
0018	3F	05_2	235	1	0	100	0	-100	0.00	0.00	0	0	0
0018	3F	05_2	245	5	0	500	0	-500	0.00	0.00	0	0	0
0018	3F	05_2	246	1	0	100	0	-100	0.00	0.00	0	0	0
0018	3F	05_3	123	45	11	4500	4970	470	0.24	1.10	7	8	1
0018	3F	05_3	124	65	14	6500	4280	-2220	0.22	0.66	11	7	-4
0018	3F	05_3	125	62	5	6200	2200	-4000	0.08	0.35	10	3	-7
0018	3F	05_3	126	47	7	4700	4390	-310	0.15	0.93	8	7	-1
0018	3F	05_3	134	17	4	1700	1580	-120	0.24	0.93	3	2	-1
0018	3F	05_3	135	35	8	3500	3090	-410	0.23	0.88	6	5	-1
0018	3F	05_3	136	14	4	1400	2750	1350	0.29	1.96	2	4	2
0018	3F	05_3	145	12	1	1200	580	-620	0.08	0.48	2	1	-1
0018	3F	05_3	146	15	2	1500	3180	1680	0.13	2.12	2	5	3
0018	3F	05_3	156	2	0	200	0	-200	0.00	0.00	0	0	0
0018	3F	05_3	234	2	1	200	280	80	0.50	1.40	0	0	0
0018	3F	05_3	235	1	0	100	0	-100	0.00	0.00	0	0	0
0018	3F	05_3	236	3	0	300	0	-300	0.00	0.00	0	0	0
0018	3F	05_3	245	1	1	100	240	140	1.00	2.40	0	0	0
0018	3F	05_3	246	1	0	100	0	-100	0.00	0.00	0	0	0
0018	3F	05_4	123	44	13	4400	3560	-840	0.30	0.81	7	6	-1
0018	3F	05_4	124	80	19	8000	7320	-680	0.24	0.92	14	12	-2
0018	3F	05_4	125	39	7	3900	2540	-1360	0.18	0.65	6	4	-2
0018	3F	05_4	126	26	2	2600	1610	-990	0.08	0.62	4	2	-2
0018	3F	05_4	134	34	4	3400	1540	-1860	0.12	0.45	6	2	-4
0018	3F	05_4	135	24	3	2400	970	-1430	0.13	0.40	4	1	-3
0018	3F	05_4	136	15	0	1500	0	-1500	0.00	0.00	2	0	-2
0018	3F	05_4	145	8	3	800	1170	370	0.38	1.46	1	2	1
0018	3F	05_4	146	2	0	200	0	-200	0.00	0.00	0	0	0
0018	3F	05_4	156	7	1	700	580	-120	0.14	0.83	1	1	0
0018	3F	05_4	234	1	0	100	0	-100	0.00	0.00	0	0	0
0018	3F	05_4	235	3	0	300	0	-300	0.00	0.00	0	0	0
0018	3F	05_4	236	1	1	100	420	320	1.00	4.20	0	0	0
0018	3F	05_5	123	17	4	1700	1730	30	0.24	1.02	3	3	0
0018	3F	05_5	124	75	15	7500	5070	-2430	0.20	0.68	13	8	-5
0018	3F	05_5	125	37	4	3700	2240	-1460	0.11	0.61	6	3	-3
0018	3F	05_5	126	15	3	1500	870	-630	0.20	0.58	2	1	-1
0018	3F	05_5	134	24	1	2400	620	-1780	0.04	0.26	4	1	-3
0018	3F	05_5	135	23	1	2300	260	-2040	0.04	0.11	4	0	-4
0018	3F	05_5	136	6	1	600	310	-290	0.17	0.52	1	0	-1
0018	3F	05_5	145	12	2	1200	710	-490	0.17	0.59	2	1	-1
0018	3F	05_5	146	1	0	100	0	-100	0.00	0.00	0	0	0
0018	3F	05_5	156	3	0	300	0	-300	0.00	0.00	0	0	0
0018	3F	05_5	235	1	0	100	0	-100	0.00	0.00	0	0	0
0018	3F	05_6	123	1	0	100	0	-100	0.00	0.00	0	0	0
0018	3F	05_6	124	1	0	100	0	-100	0.00	0.00	0	0	0
0018	3F	05_6	125	2	0	200	0	-200	0.00	0.00	0	0	0
0018	3F	05_7	123	43	10	4300	3280	-1020	0.23	0.76	7	5	-2
0018	3F	05_7	124	102	19	10200	6810	-3390	0.19	0.67	18	12	-6
0018	3F	05_7	125	47	3	4700	2500	-2200	0.06	0.53	8	4	-4
0018	3F	05_7	126	30	4	3000	2550	-450	0.13	0.85	5	4	-1
0018	3F	05_7	134	30	5	3000	1940	-1060	0.17	0.65	5	3	-2
0018	3F	05_7	135	30	4	3000	1530	-1470	0.13	0.51	5	2	-3
0018	3F	05_7	136	24	3	2400	1050	-1350	0.13	0.44	4	1	-3
0018	3F	05_7	145	9	2	900	2090	1190	0.22	2.32	1	3	2
0018	3F	05_7	146	9	1	900	770	-130	0.11	0.86	1	1	0
0018	3F	05_7	156	2	1	200	550	350	0.50	2.75	0	0	0
0018	3F	05_7	234	2	0	200	0	-200	0.00	0.00	0	0	0
0018	3F	05_7	235	3	0	300	0	-300	0.00	0.00	0	0	0
0018	3F	05_7	236	1	0	100	0	-100	0.00	0.00	0	0	0
0018	3F	05_7	246	1	0	100	0	-100	0.00	0.00	0	0	0
0018	3F	06_1	123	70	13	7000	5020	-1980	0.19	0.72	12	8	-4
0018	3F	06_1	124	65	20	6500	7700	1200	0.31	1.18	11	13	2
0018	3F	06_1	125	55	9	5500	5410	-90	0.16	0.98	9	9	0
0018	3F	06_1	126	81	9	8100	6900	-1200	0.11	0.85	14	12	-2
0018	3F	06_1	134	38	10	3800	2590	-1210	0.26	0.68	6	4	-2
0018	3F	06_1	135	28	8	2800	2410	-390	0.29	0.86	4	4	0
0018	3F	06_1	136	40	2	4000	810	-3190	0.05	0.20	7	1	-6
0018	3F	06_1	145	18	5	1800	1580	-220	0.28	0.88	3	2	-1
0018	3F	06_1	146	15	3	1500	1440	-60	0.20	0.96	2	2	0
0018	3F	06_1	156	2	1	200	490	290	0.50	2.45	0	0	0
0018	3F	06_1	235	1	0	100	0	-100	0.00	0.00	0	0	0
0018	3F	06_1	245	1	0	100	0	-100	0.00	0.00	0	0	0
0018	3F	06_1	256	1	0	100	0	-100	0.00	0.00	0	0	0
0018	3F	06_2	123	52	11	5200	4290	-910	0.21	0.83	9	7	-2
0018	3F	06_2	124	71	19	7100	5150	-1950	0.27	0.73	12	9	-3
0018	3F	06_2	125	71	14	7100	4550	-2550	0.20	0.64	12	8	-4
0018	3F	06_2	126	68	8	6800	2430	-4370	0.12	0.36	12	4	-8
0018	3F	06_2	134	40	7	4000	1840	-2160	0.18	0.46	7	3	-4
0018	3F	06_2	135	40	4	4000	1520	-2480	0.10	0.38	7	2	-5
0018	3F	06_2	136	32	8	3200	3260	60	0.25	1.02	5	5	0
0018	3F	06_2	145	18	2	1800	480	-1320	0.11	0.27	3	0	-3
0018	3F	06_2	146	18	3	1800	5820	4020	0.17	3.23	3	10	7
0018	3F	06_2	156	6	0	600	0	-600	0.00	0.00	1	0	-1
0018	3F	06_2	234	2	0	200	0	-200	0.00	0.00	0	0	0
0018	3F	06_2	235	1	1	100	250	150	1.00	2.50	0	0	0
0018	3F	06_2	246	2	1	200	160	-40	0.50	0.80	0	0	0
0018	3F	06_3	123	35	6	3500	2200	-1300	0.17	0.63	6	3	-3
0018	3F	06_3	124	71	14	7100	4460	-2640	0.20	0.63	12	7	-5
0018	3F	06_3	125	93	12	9300	5360	-3940	0.13	0.58	16	9	-7
0018	3F	06_3	126	61	6	6100	6710	610	0.10	1.10	10	11	1
0018	3F	06_3	134	24	3	2400	1500	-900	0.13	0.63	4	2	-2
0018	3F	06_3	135	42	6	4200	1910	-2290	0.14	0.45	7	3	-4
0018	3F	06_3	136	31	2	3100	2430	-670	0.06	0.78	5	4	-1
0018	3F	06_3	145	19	7	1900	3230	1330	0.37	1.70	3	5	2
0018	3F	06_3	146	13	3	1300	2460	1160	0.23	1.89	2	4	2
0018	3F	06_3	156	5	1	500	970	470	0.20	1.94	0	1	1
0018	3F	06_3	234	1	0	100	0	-100	0.00	0.00	0	0	0
0018	3F	06_3	235	2	1	200	790	590	0.50	3.95	0	1	1
0018	3F	06_3	236	3	0	300	0	-300	0.00	0.00	0	0	0
0018	3F	06_3	246	2	0	200	0	-200	0.00	0.00	0	0	0
0018	3F	06_3	256	2	0	200	0	-200	0.00	0.00	0	0	0
0018	3F	06_4	123	46	8	4600	2770	-1830	0.17	0.60	8	4	-4
0018	3F	06_4	124	50	11	5000	3520	-1480	0.22	0.70	8	6	-2
0018	3F	06_4	125	55	6	5500	1670	-3830	0.11	0.30	9	2	-7
0018	3F	06_4	126	25	3	2500	1880	-620	0.12	0.75	4	3	-1
0018	3F	06_4	134	32	2	3200	930	-2270	0.06	0.29	5	1	-4
0018	3F	06_4	135	29	6	2900	1940	-960	0.21	0.67	5	3	-2
0018	3F	06_4	136	11	2	1100	1410	310	0.18	1.28	1	2	1
0018	3F	06_4	145	15	2	1500	700	-800	0.13	0.47	2	1	-1
0018	3F	06_4	146	7	1	700	220	-480	0.14	0.31	1	0	-1
0018	3F	06_4	234	1	0	100	0	-100	0.00	0.00	0	0	0
0018	3F	06_4	235	1	0	100	0	-100	0.00	0.00	0	0	0
0018	3F	06_4	236	1	0	100	0	-100	0.00	0.00	0	0	0
0018	3F	06_4	245	3	0	300	0	-300	0.00	0.00	0	0	0
0018	3F	06_4	246	2	0	200	0	-200	0.00	0.00	0	0	0
0018	3F	06_5	123	28	8	2800	2510	-290	0.29	0.90	4	4	0
0018	3F	06_5	124	37	9	3700	2900	-800	0.24	0.78	6	5	-1
0018	3F	06_5	125	27	3	2700	890	-1810	0.11	0.33	4	1	-3
0018	3F	06_5	126	22	6	2200	5300	3100	0.27	2.41	3	9	6
0018	3F	06_5	134	14	6	1400	1890	490	0.43	1.35	2	3	1
0018	3F	06_5	135	11	1	1100	320	-780	0.09	0.29	1	0	-1
0018	3F	06_5	136	9	3	900	1380	480	0.33	1.53	1	2	1
0018	3F	06_5	145	4	2	400	1230	830	0.50	3.08	0	2	2
0018	3F	06_5	146	10	1	1000	360	-640	0.10	0.36	1	0	-1
0018	3F	06_5	156	3	0	300	0	-300	0.00	0.00	0	0	0
0018	3F	06_5	236	1	0	100	0	-100	0.00	0.00	0	0	0
0018	3F	06_5	245	1	0	100	0	-100	0.00	0.00	0	0	0
0018	3F	06_5	246	1	0	100	0	-100	0.00	0.00	0	0	0
0018	3F	06_6	123	7	1	700	240	-460	0.14	0.34	1	0	-1
0018	3F	06_6	124	3	1	300	240	-60	0.33	0.80	0	0	0
0018	3F	06_6	125	2	0	200	0	-200	0.00	0.00	0	0	0
0018	3F	06_6	126	4	2	400	1350	950	0.50	3.38	0	2	2
0018	3F	06_6	134	1	1	100	580	480	1.00	5.80	0	1	1
0018	3F	06_6	135	4	1	400	200	-200	0.25	0.50	0	0	0
0018	3F	06_6	145	1	1	100	950	850	1.00	9.50	0	1	1
0018	3F	06_6	146	2	0	200	0	-200	0.00	0.00	0	0	0
0018	3F	06_7	123	67	15	6700	4630	-2070	0.22	0.69	11	8	-3
0018	3F	06_7	124	81	18	8100	6730	-1370	0.22	0.83	14	11	-3
0018	3F	06_7	125	77	16	7700	6530	-1170	0.21	0.85	13	11	-2
0018	3F	06_7	126	62	12	6200	7450	1250	0.19	1.20	10	13	3
0018	3F	06_7	134	36	4	3600	1890	-1710	0.11	0.53	6	3	-3
0018	3F	06_7	135	42	7	4200	1790	-2410	0.17	0.43	7	3	-4
0018	3F	06_7	136	38	6	3800	2340	-1460	0.16	0.62	6	4	-2
0018	3F	06_7	145	28	5	2800	3500	700	0.18	1.25	4	6	2
0018	3F	06_7	146	12	2	1200	860	-340	0.17	0.72	2	1	-1
0018	3F	06_7	156	2	0	200	0	-200	0.00	0.00	0	0	0
0018	3F	06_7	235	2	0	200	0	-200	0.00	0.00	0	0	0
0018	3F	06_7	236	1	0	100	0	-100	0.00	0.00	0	0	0
0018	3F	06_7	245	1	0	100	0	-100	0.00	0.00	0	0	0
0018	3F	06_7	246	3	0	300	0	-300	0.00	0.00	0	0	0
0018	3F	07_1	123	36	8	3600	2700	-900	0.22	0.75	6	4	-2
0018	3F	07_1	124	86	8	8600	3000	-5600	0.09	0.35	15	5	-10
0018	3F	07_1	125	50	9	5000	5050	50	0.18	1.01	8	8	0
0018	3F	07_1	126	61	9	6100	8980	2880	0.15	1.47	10	15	5
0018	3F	07_1	134	55	21	5500	5910	410	0.38	1.07	9	10	1
0018	3F	07_1	135	33	4	3300	1540	-1760	0.12	0.47	5	2	-3
0018	3F	07_1	136	22	2	2200	1560	-640	0.09	0.71	3	2	-1
0018	3F	07_1	145	19	4	1900	920	-980	0.21	0.48	3	1	-2
0018	3F	07_1	146	4	1	400	1570	1170	0.25	3.93	0	2	2
0018	3F	07_1	156	7	2	700	1240	540	0.29	1.77	1	2	1
0018	3F	07_1	235	2	0	200	0	-200	0.00	0.00	0	0	0
0018	3F	07_1	236	5	1	500	400	-100	0.20	0.80	0	0	0
0018	3F	07_2	123	40	14	4000	4740	740	0.35	1.19	7	8	1
0018	3F	07_2	124	78	15	7800	4420	-3380	0.19	0.57	13	7	-6
0018	3F	07_2	125	57	9	5700	5170	-530	0.16	0.91	10	9	-1
0018	3F	07_2	126	38	7	3800	3760	-40	0.18	0.99	6	6	0
0018	3F	07_2	134	56	14	5600	3840	-1760	0.25	0.69	9	6	-3
0018	3F	07_2	135	28	6	2800	2120	-680	0.21	0.76	4	3	-1
0018	3F	07_2	136	29	10	2900	3850	950	0.34	1.33	5	6	1
0018	3F	07_2	145	22	10	2200	3420	1220	0.45	1.55	3	6	3
0018	3F	07_2	146	9	2	900	1740	840	0.22	1.93	1	3	2
0018	3F	07_2	156	7	3	700	1340	640	0.43	1.91	1	2	1
0018	3F	07_2	235	1	0	100	0	-100	0.00	0.00	0	0	0
0018	3F	07_2	236	1	0	100	0	-100	0.00	0.00	0	0	0
0018	3F	07_2	245	2	0	200	0	-200	0.00	0.00	0	0	0
0018	3F	07_3	123	50	15	5000	4380	-620	0.30	0.88	8	7	-1
0018	3F	07_3	124	101	24	10100	7550	-2550	0.24	0.75	17	13	-4
0018	3F	07_3	125	54	12	5400	5350	-50	0.22	0.99	9	9	0
0018	3F	07_3	126	41	6	4100	2710	-1390	0.15	0.66	7	4	-3
0018	3F	07_3	134	58	9	5800	3580	-2220	0.16	0.62	10	6	-4
0018	3F	07_3	135	32	4	3200	1160	-2040	0.13	0.36	5	2	-3
0018	3F	07_3	136	19	2	1900	1840	-60	0.11	0.97	3	3	0
0018	3F	07_3	145	18	4	1800	1540	-260	0.22	0.86	3	2	-1
0018	3F	07_3	146	5	1	500	620	120	0.20	1.24	0	1	1
0018	3F	07_3	156	4	2	400	1090	690	0.50	2.73	0	1	1
0018	3F	07_3	235	3	1	300	180	-120	0.33	0.60	0	0	0
0018	3F	07_3	236	1	0	100	0	-100	0.00	0.00	0	0	0
0018	3F	07_3	256	2	0	200	0	-200	0.00	0.00	0	0	0
0018	3F	07_4	123	54	17	5400	5590	190	0.31	1.04	9	9	0
0018	3F	07_4	124	81	15	8100	5580	-2520	0.19	0.69	14	9	-5
0018	3F	07_4	125	45	8	4500	3930	-570	0.18	0.87	7	6	-1
0018	3F	07_4	126	30	7	3000	3300	300	0.23	1.10	5	5	0
0018	3F	07_4	134	51	16	5100	7120	2020	0.31	1.40	9	12	3
0018	3F	07_4	135	28	5	2800	2860	60	0.18	1.02	4	5	1
0018	3F	07_4	136	18	1	1800	460	-1340	0.06	0.26	3	0	-3
0018	3F	07_4	145	20	6	2000	2530	530	0.30	1.27	3	4	1
0018	3F	07_4	146	6	1	600	440	-160	0.17	0.73	1	0	-1
0018	3F	07_4	156	3	0	300	0	-300	0.00	0.00	0	0	0
0018	3F	07_4	234	1	0	100	0	-100	0.00	0.00	0	0	0
0018	3F	07_4	235	3	0	300	0	-300	0.00	0.00	0	0	0
0018	3F	07_5	123	28	4	2800	1150	-1650	0.14	0.41	4	2	-2
0018	3F	07_5	124	73	16	7300	6110	-1190	0.22	0.84	12	10	-2
0018	3F	07_5	125	42	7	4200	3580	-620	0.17	0.85	7	6	-1
0018	3F	07_5	126	28	6	2800	3020	220	0.21	1.08	4	5	1
0018	3F	07_5	134	40	13	4000	4850	850	0.33	1.21	7	8	1
0018	3F	07_5	135	15	2	1500	550	-950	0.13	0.37	2	0	-2
0018	3F	07_5	136	17	4	1700	1300	-400	0.24	0.76	3	2	-1
0018	3F	07_5	145	12	2	1200	630	-570	0.17	0.53	2	1	-1
0018	3F	07_5	146	9	2	900	2020	1120	0.22	2.24	1	3	2
0018	3F	07_5	156	2	0	200	0	-200	0.00	0.00	0	0	0
0018	3F	07_5	235	1	0	100	0	-100	0.00	0.00	0	0	0
0018	3F	07_6	123	4	1	400	320	-80	0.25	0.80	0	0	0
0018	3F	07_6	124	9	0	900	0	-900	0.00	0.00	1	0	-1
0018	3F	07_6	125	2	0	200	0	-200	0.00	0.00	0	0	0
0018	3F	07_6	126	7	1	700	650	-50	0.14	0.93	1	1	0
0018	3F	07_6	134	5	2	500	810	310	0.40	1.62	0	1	1
0018	3F	07_6	135	5	0	500	0	-500	0.00	0.00	0	0	0
0018	3F	07_6	136	4	0	400	0	-400	0.00	0.00	0	0	0
0018	3F	07_6	145	4	0	400	0	-400	0.00	0.00	0	0	0
0018	3F	07_6	146	1	0	100	0	-100	0.00	0.00	0	0	0
0018	3F	07_7	123	56	14	5600	4630	-970	0.25	0.83	9	8	-1
0018	3F	07_7	124	126	22	12600	6830	-5770	0.17	0.54	22	12	-10
0018	3F	07_7	125	52	11	5200	4630	-570	0.21	0.89	9	8	-1
0018	3F	07_7	126	36	4	3600	2560	-1040	0.11	0.71	6	4	-2
0018	3F	07_7	134	47	12	4700	3620	-1080	0.26	0.77	8	6	-2
0018	3F	07_7	135	38	5	3800	1490	-2310	0.13	0.39	6	2	-4
0018	3F	07_7	136	20	6	2000	3080	1080	0.30	1.54	3	5	2
0018	3F	07_7	145	18	4	1800	1630	-170	0.22	0.91	3	2	-1
0018	3F	07_7	146	7	0	700	0	-700	0.00	0.00	1	0	-1
0018	3F	07_7	236	1	0	100	0	-100	0.00	0.00	0	0	0
0018	3F	08_1	123	53	11	5300	3500	-1800	0.21	0.66	9	6	-3
0018	3F	08_1	124	114	25	11400	9280	-2120	0.22	0.81	20	16	-4
0018	3F	08_1	125	52	8	5200	3400	-1800	0.15	0.65	9	6	-3
0018	3F	08_1	126	64	14	6400	7390	990	0.22	1.15	11	13	2
0018	3F	08_1	134	42	12	4200	4000	-200	0.29	0.95	7	7	0
0018	3F	08_1	135	36	6	3600	1950	-1650	0.17	0.54	6	3	-3
0018	3F	08_1	136	46	12	4600	5030	430	0.26	1.09	8	8	0
0018	3F	08_1	145	16	2	1600	790	-810	0.13	0.49	2	1	-1
0018	3F	08_1	146	11	3	1100	1030	-70	0.27	0.94	1	1	0
0018	3F	08_1	156	8	0	800	0	-800	0.00	0.00	1	0	-1
0018	3F	08_1	235	1	0	100	0	-100	0.00	0.00	0	0	0
0018	3F	08_1	236	1	0	100	0	-100	0.00	0.00	0	0	0
0018	3F	08_1	246	1	1	100	410	310	1.00	4.10	0	0	0
0018	3F	08_2	123	61	17	6100	4500	-1600	0.28	0.74	10	7	-3
0018	3F	08_2	124	110	32	11000	11620	620	0.29	1.06	19	20	1
0018	3F	08_2	125	53	8	5300	2620	-2680	0.15	0.49	9	4	-5
0018	3F	08_2	126	84	12	8400	4100	-4300	0.14	0.49	14	7	-7
0018	3F	08_2	134	49	13	4900	3850	-1050	0.27	0.79	8	6	-2
0018	3F	08_2	135	35	6	3500	1750	-1750	0.17	0.50	6	3	-3
0018	3F	08_2	136	38	4	3800	1190	-2610	0.11	0.31	6	2	-4
0018	3F	08_2	145	18	3	1800	1160	-640	0.17	0.64	3	2	-1
0018	3F	08_2	146	18	3	1800	810	-990	0.17	0.45	3	1	-2
0018	3F	08_2	156	10	1	1000	480	-520	0.10	0.48	1	0	-1
0018	3F	08_2	235	2	1	200	430	230	0.50	2.15	0	0	0
0018	3F	08_2	236	2	1	200	360	160	0.50	1.80	0	0	0
0018	3F	08_3	123	61	20	6100	4600	-1500	0.33	0.75	10	8	-2
0018	3F	08_3	124	125	27	12500	13800	1300	0.22	1.10	22	24	2
0018	3F	08_3	125	92	17	9200	6840	-2360	0.18	0.74	16	12	-4
0018	3F	08_3	126	36	9	3600	5060	1460	0.25	1.41	6	8	2
0018	3F	08_3	134	46	9	4600	3320	-1280	0.20	0.72	8	5	-3
0018	3F	08_3	135	44	9	4400	3960	-440	0.20	0.90	7	7	0
0018	3F	08_3	136	13	0	1300	0	-1300	0.00	0.00	2	0	-2
0018	3F	08_3	145	31	4	3100	1390	-1710	0.13	0.45	5	2	-3
0018	3F	08_3	146	8	2	800	680	-120	0.25	0.85	1	1	0
0018	3F	08_3	156	5	1	500	390	-110	0.20	0.78	0	0	0
0018	3F	08_3	234	3	1	300	360	60	0.33	1.20	0	0	0
0018	3F	08_3	236	2	1	200	380	180	0.50	1.90	0	0	0
0018	3F	08_3	245	2	0	200	0	-200	0.00	0.00	0	0	0
0018	3F	08_3	246	1	0	100	0	-100	0.00	0.00	0	0	0
0018	3F	08_4	123	21	2	2100	590	-1510	0.10	0.28	3	1	-2
0018	3F	08_4	124	43	11	4300	3180	-1120	0.26	0.74	7	5	-2
0018	3F	08_4	125	30	4	3000	1880	-1120	0.13	0.63	5	3	-2
0018	3F	08_4	126	10	1	1000	1070	70	0.10	1.07	1	1	0
0018	3F	08_4	134	16	6	1600	1790	190	0.38	1.12	2	3	1
0018	3F	08_4	135	16	2	1600	1160	-440	0.13	0.73	2	2	0
0018	3F	08_4	136	9	2	900	470	-430	0.22	0.52	1	0	-1
0018	3F	08_4	145	7	2	700	900	200	0.29	1.29	1	1	0
0018	3F	08_4	146	1	0	100	0	-100	0.00	0.00	0	0	0
0018	3F	08_4	156	2	1	200	250	50	0.50	1.25	0	0	0
0018	3F	08_4	235	2	1	200	390	190	0.50	1.95	0	0	0
0018	3F	08_5	123	19	7	1900	1770	-130	0.37	0.93	3	3	0
0018	3F	08_5	124	26	7	2600	1790	-810	0.27	0.69	4	3	-1
0018	3F	08_5	125	15	0	1500	0	-1500	0.00	0.00	2	0	-2
0018	3F	08_5	126	6	1	600	560	-40	0.17	0.93	1	0	-1
0018	3F	08_5	134	14	2	1400	380	-1020	0.14	0.27	2	0	-2
0018	3F	08_5	135	9	0	900	0	-900	0.00	0.00	1	0	-1
0018	3F	08_5	136	5	1	500	270	-230	0.20	0.54	0	0	0
0018	3F	08_5	145	8	3	800	940	140	0.38	1.18	1	1	0
0018	3F	08_5	146	1	0	100	0	-100	0.00	0.00	0	0	0
0018	3F	08_6	123	2	1	200	240	40	0.50	1.20	0	0	0
0018	3F	08_6	124	6	2	600	760	160	0.33	1.27	1	1	0
0018	3F	08_6	125	3	1	300	360	60	0.33	1.20	0	0	0
0018	3F	08_6	126	2	0	200	0	-200	0.00	0.00	0	0	0
0018	3F	08_6	134	2	1	200	240	40	0.50	1.20	0	0	0
0018	3F	08_6	135	2	1	200	210	10	0.50	1.05	0	0	0
0018	3F	08_6	136	4	0	400	0	-400	0.00	0.00	0	0	0
0018	3F	08_7	123	81	30	8100	9410	1310	0.37	1.16	14	16	2
0018	3F	08_7	124	132	25	13200	9710	-3490	0.19	0.74	23	17	-6
0018	3F	08_7	125	58	9	5800	4060	-1740	0.16	0.70	10	7	-3
0018	3F	08_7	126	68	10	6800	5390	-1410	0.15	0.79	12	9	-3
0018	3F	08_7	134	42	6	4200	2260	-1940	0.14	0.54	7	4	-3
0018	3F	08_7	135	29	1	2900	560	-2340	0.03	0.19	5	0	-5
0018	3F	08_7	136	33	2	3300	990	-2310	0.06	0.30	5	1	-4
0018	3F	08_7	145	9	2	900	540	-360	0.22	0.60	1	0	-1
0018	3F	08_7	146	13	1	1300	290	-1010	0.08	0.22	2	0	-2
0018	3F	08_7	156	4	1	400	510	110	0.25	1.28	0	0	0
0018	3F	08_7	235	2	0	200	0	-200	0.00	0.00	0	0	0
0018	3F	08_7	236	1	0	100	0	-100	0.00	0.00	0	0	0
0018	3F	08_7	245	1	0	100	0	-100	0.00	0.00	0	0	0
0018	3F	08_7	246	2	2	200	960	760	1.00	4.80	0	1	1
0018	3F	09_1	123	81	26	8100	7120	-980	0.32	0.88	14	12	-2
0018	3F	09_1	124	136	25	13600	10300	-3300	0.18	0.76	24	18	-6
0018	3F	09_1	125	59	15	5900	6450	550	0.25	1.09	10	11	1
0018	3F	09_1	126	28	4	2800	2110	-690	0.14	0.75	4	3	-1
0018	3F	09_1	134	31	7	3100	2460	-640	0.23	0.79	5	4	-1
0018	3F	09_1	135	29	6	2900	2740	-160	0.21	0.94	5	4	-1
0018	3F	09_1	136	15	4	1500	4130	2630	0.27	2.75	2	7	5
0018	3F	09_1	145	5	0	500	0	-500	0.00	0.00	0	0	0
0018	3F	09_1	146	5	1	500	990	490	0.20	1.98	0	1	1
0018	3F	09_1	156	2	0	200	0	-200	0.00	0.00	0	0	0
0018	3F	09_1	234	2	2	200	770	570	1.00	3.85	0	1	1
0018	3F	09_1	245	1	0	100	0	-100	0.00	0.00	0	0	0
0018	3F	09_1	246	5	1	500	1420	920	0.20	2.84	0	2	2
0018	3F	09_1	256	1	0	100	0	-100	0.00	0.00	0	0	0
0018	3F	09_2	123	73	11	7300	3160	-4140	0.15	0.43	12	5	-7
0018	3F	09_2	124	83	20	8300	8720	420	0.24	1.05	14	15	1
0018	3F	09_2	125	54	18	5400	8500	3100	0.33	1.57	9	15	6
0018	3F	09_2	126	36	4	3600	1090	-2510	0.11	0.30	6	1	-5
0018	3F	09_2	134	29	10	2900	3240	340	0.34	1.12	5	5	0
0018	3F	09_2	135	32	5	3200	2120	-1080	0.16	0.66	5	3	-2
0018	3F	09_2	136	25	2	2500	1110	-1390	0.08	0.44	4	1	-3
0018	3F	09_2	145	7	0	700	0	-700	0.00	0.00	1	0	-1
0018	3F	09_2	146	12	1	1200	600	-600	0.08	0.50	2	1	-1
0018	3F	09_2	156	8	1	800	250	-550	0.13	0.31	1	0	-1
0018	3F	09_2	234	2	0	200	0	-200	0.00	0.00	0	0	0
0018	3F	09_2	235	1	0	100	0	-100	0.00	0.00	0	0	0
0018	3F	09_2	236	2	0	200	0	-200	0.00	0.00	0	0	0
0018	3F	09_2	245	1	0	100	0	-100	0.00	0.00	0	0	0
0018	3F	09_2	246	2	0	200	0	-200	0.00	0.00	0	0	0
0018	3F	09_3	123	55	13	5500	4010	-1490	0.24	0.73	9	7	-2
0018	3F	09_3	124	84	23	8400	9530	1130	0.27	1.13	14	16	2
0018	3F	09_3	125	55	13	5500	6980	1480	0.24	1.27	9	12	3
0018	3F	09_3	126	45	7	4500	7120	2620	0.16	1.58	7	12	5
0018	3F	09_3	134	26	3	2600	720	-1880	0.12	0.28	4	1	-3
0018	3F	09_3	135	37	4	3700	1500	-2200	0.11	0.41	6	2	-4
0018	3F	09_3	136	26	1	2600	310	-2290	0.04	0.12	4	0	-4
0018	3F	09_3	145	13	3	1300	1820	520	0.23	1.40	2	3	1
0018	3F	09_3	146	5	1	500	420	-80	0.20	0.84	0	0	0
0018	3F	09_3	156	9	1	900	280	-620	0.11	0.31	1	0	-1
0018	3F	09_3	234	3	0	300	0	-300	0.00	0.00	0	0	0
0018	3F	09_3	236	1	0	100	0	-100	0.00	0.00	0	0	0
0018	3F	09_3	246	1	0	100	0	-100	0.00	0.00	0	0	0
0018	3F	09_4	123	41	10	4100	2490	-1610	0.24	0.61	7	4	-3
0018	3F	09_4	124	80	18	8000	7260	-740	0.23	0.91	14	12	-2
0018	3F	09_4	125	60	9	6000	3110	-2890	0.15	0.52	10	5	-5
0018	3F	09_4	126	40	5	4000	3590	-410	0.13	0.90	7	6	-1
0018	3F	09_4	134	24	10	2400	3560	1160	0.42	1.48	4	6	2
0018	3F	09_4	135	25	5	2500	2020	-480	0.20	0.81	4	3	-1
0018	3F	09_4	136	16	0	1600	0	-1600	0.00	0.00	2	0	-2
0018	3F	09_4	145	10	1	1000	310	-690	0.10	0.31	1	0	-1
0018	3F	09_4	146	9	3	900	1450	550	0.33	1.61	1	2	1
0018	3F	09_4	156	6	0	600	0	-600	0.00	0.00	1	0	-1
0018	3F	09_4	234	1	0	100	0	-100	0.00	0.00	0	0	0
0018	3F	09_4	235	1	1	100	560	460	1.00	5.60	0	0	0
0018	3F	09_4	236	3	0	300	0	-300	0.00	0.00	0	0	0
0018	3F	09_4	246	2	1	200	380	180	0.50	1.90	0	0	0
0018	3F	09_5	123	78	26	7800	5670	-2130	0.33	0.73	13	10	-3
0018	3F	09_5	124	103	20	10300	6160	-4140	0.19	0.60	18	10	-8
0018	3F	09_5	125	56	9	5600	3520	-2080	0.16	0.63	9	6	-3
0018	3F	09_5	126	29	7	2900	3620	720	0.24	1.25	5	6	1
0018	3F	09_5	134	33	8	3300	1890	-1410	0.24	0.57	5	3	-2
0018	3F	09_5	135	25	7	2500	3960	1460	0.28	1.58	4	7	3
0018	3F	09_5	136	15	3	1500	2790	1290	0.20	1.86	2	4	2
0018	3F	09_5	145	11	1	1100	420	-680	0.09	0.38	1	0	-1
0018	3F	09_5	146	8	1	800	320	-480	0.13	0.40	1	0	-1
0018	3F	09_5	156	3	1	300	300	0	0.33	1.00	0	0	0
0018	3F	09_5	235	1	0	100	0	-100	0.00	0.00	0	0	0
0018	3F	09_7	123	77	24	7700	6900	-800	0.31	0.90	13	12	-1
0018	3F	09_7	124	150	44	15000	14580	-420	0.29	0.97	26	25	-1
0018	3F	09_7	125	50	10	5000	3330	-1670	0.20	0.67	8	5	-3
0018	3F	09_7	126	41	6	4100	3600	-500	0.15	0.88	7	6	-1
0018	3F	09_7	134	35	5	3500	2540	-960	0.14	0.73	6	4	-2
0018	3F	09_7	135	29	5	2900	1660	-1240	0.17	0.57	5	2	-3
0018	3F	09_7	136	19	5	1900	2770	870	0.26	1.46	3	4	1
0018	3F	09_7	145	4	0	400	0	-400	0.00	0.00	0	0	0
0018	3F	09_7	146	11	2	1100	600	-500	0.18	0.55	1	1	0
0018	3F	09_7	156	2	0	200	0	-200	0.00	0.00	0	0	0
0018	3F	09_7	234	2	2	200	1080	880	1.00	5.40	0	1	1
0018	3F	10_1	123	67	19	6700	4500	-2200	0.28	0.67	11	7	-4
0018	3F	10_1	124	126	31	12600	14260	1660	0.25	1.13	22	25	3
0018	3F	10_1	125	34	3	3400	820	-2580	0.09	0.24	6	1	-5
0018	3F	10_1	126	19	3	1900	2490	590	0.16	1.31	3	4	1
0018	3F	10_1	134	44	10	4400	5610	1210	0.23	1.28	7	9	2
0018	3F	10_1	135	10	1	1000	430	-570	0.10	0.43	1	0	-1
0018	3F	10_1	136	3	0	300	0	-300	0.00	0.00	0	0	0
0018	3F	10_1	145	3	0	300	0	-300	0.00	0.00	0	0	0
0018	3F	10_1	146	6	0	600	0	-600	0.00	0.00	1	0	-1
0018	3F	10_1	235	3	0	300	0	-300	0.00	0.00	0	0	0
0018	3F	10_1	236	3	0	300	0	-300	0.00	0.00	0	0	0
0018	3F	10_1	245	1	0	100	0	-100	0.00	0.00	0	0	0
0018	3F	10_1	246	1	0	100	0	-100	0.00	0.00	0	0	0
0018	3F	10_2	123	66	22	6600	5980	-620	0.33	0.91	11	10	-1
0018	3F	10_2	124	67	12	6700	4730	-1970	0.18	0.71	11	8	-3
0018	3F	10_2	125	38	3	3800	730	-3070	0.08	0.19	6	1	-5
0018	3F	10_2	126	17	2	1700	670	-1030	0.12	0.39	3	1	-2
0018	3F	10_2	134	38	5	3800	1120	-2680	0.13	0.29	6	1	-5
0018	3F	10_2	135	40	6	4000	2220	-1780	0.15	0.56	7	3	-4
0018	3F	10_2	136	15	2	1500	1540	40	0.13	1.03	2	2	0
0018	3F	10_2	145	10	0	1000	0	-1000	0.00	0.00	1	0	-1
0018	3F	10_2	146	1	1	100	490	390	1.00	4.90	0	0	0
0018	3F	10_2	234	1	0	100	0	-100	0.00	0.00	0	0	0
0018	3F	10_2	235	7	3	700	1620	920	0.43	2.31	1	2	1
0018	3F	10_2	236	3	2	300	1050	750	0.67	3.50	0	1	1
0018	3F	10_2	245	4	1	400	690	290	0.25	1.73	0	1	1
0018	3F	10_2	246	4	1	400	260	-140	0.25	0.65	0	0	0
0018	3F	10_2	256	6	1	600	420	-180	0.17	0.70	1	0	-1
0018	3F	10_3	123	55	19	5500	5210	-290	0.35	0.95	9	9	0
0018	3F	10_3	124	74	15	7400	6120	-1280	0.20	0.83	13	10	-3
0018	3F	10_3	125	111	16	11100	10970	-130	0.14	0.99	19	19	0
0018	3F	10_3	126	19	5	1900	2040	140	0.26	1.07	3	3	0
0018	3F	10_3	134	18	4	1800	1260	-540	0.22	0.70	3	2	-1
0018	3F	10_3	135	52	5	5200	3290	-1910	0.10	0.63	9	5	-4
0018	3F	10_3	136	10	2	1000	490	-510	0.20	0.49	1	0	-1
0018	3F	10_3	145	29	1	2900	980	-1920	0.03	0.34	5	1	-4
0018	3F	10_3	156	1	0	100	0	-100	0.00	0.00	0	0	0
0018	3F	10_3	234	1	0	100	0	-100	0.00	0.00	0	0	0
0018	3F	10_3	235	2	0	200	0	-200	0.00	0.00	0	0	0
0018	3F	10_3	236	4	0	400	0	-400	0.00	0.00	0	0	0
0018	3F	10_3	245	2	0	200	0	-200	0.00	0.00	0	0	0
0018	3F	10_3	256	1	0	100	0	-100	0.00	0.00	0	0	0
0018	3F	10_4	123	60	14	6000	3690	-2310	0.23	0.62	10	6	-4
0018	3F	10_4	124	96	20	9600	7130	-2470	0.21	0.74	16	12	-4
0018	3F	10_4	125	54	7	5400	3480	-1920	0.13	0.64	9	6	-3
0018	3F	10_4	126	16	0	1600	0	-1600	0.00	0.00	2	0	-2
0018	3F	10_4	134	31	4	3100	1430	-1670	0.13	0.46	5	2	-3
0018	3F	10_4	135	35	3	3500	2090	-1410	0.09	0.60	6	3	-3
0018	3F	10_4	136	17	0	1700	0	-1700	0.00	0.00	3	0	-3
0018	3F	10_4	145	19	1	1900	830	-1070	0.05	0.44	3	1	-2
0018	3F	10_4	146	4	0	400	0	-400	0.00	0.00	0	0	0
0018	3F	10_4	235	5	1	500	190	-310	0.20	0.38	0	0	0
0018	3F	10_4	236	3	1	300	480	180	0.33	1.60	0	0	0
0018	3F	10_4	245	7	1	700	370	-330	0.14	0.53	1	0	-1
0018	3F	10_5	123	58	20	5800	5480	-320	0.34	0.94	10	9	-1
0018	3F	10_5	124	59	15	5900	5180	-720	0.25	0.88	10	9	-1
0018	3F	10_5	125	83	9	8300	6620	-1680	0.11	0.80	14	11	-3
0018	3F	10_5	126	12	0	1200	0	-1200	0.00	0.00	2	0	-2
0018	3F	10_5	134	22	7	2200	2010	-190	0.32	0.91	3	3	0
0018	3F	10_5	135	8	1	800	220	-580	0.13	0.28	1	0	-1
0018	3F	10_5	136	3	2	300	1040	740	0.67	3.47	0	1	1
0018	3F	10_5	145	22	3	2200	1610	-590	0.14	0.73	3	2	-1
0018	3F	10_5	146	6	1	600	1710	1110	0.17	2.85	1	3	2
0018	3F	10_5	236	1	0	100	0	-100	0.00	0.00	0	0	0
0018	3F	10_5	246	2	0	200	0	-200	0.00	0.00	0	0	0
0018	3F	10_6	123	6	1	600	340	-260	0.17	0.57	1	0	-1
0018	3F	10_6	134	4	1	400	150	-250	0.25	0.38	0	0	0
0018	3F	10_7	123	480	112	48000	44760	-3240	0.23	0.93	84	79	-5
0018	3F	10_7	124	23	2	2300	960	-1340	0.09	0.42	4	1	-3
0018	3F	11_1	123	46	13	4600	3570	-1030	0.28	0.78	8	6	-2
0018	3F	11_1	124	95	20	9500	8580	-920	0.21	0.90	16	15	-1
0018	3F	11_1	125	39	5	3900	1880	-2020	0.13	0.48	6	3	-3
0018	3F	11_1	126	38	3	3800	1740	-2060	0.08	0.46	6	3	-3
0018	3F	11_1	134	49	14	4900	3940	-960	0.29	0.80	8	6	-2
0018	3F	11_1	135	34	4	3400	1560	-1840	0.12	0.46	6	2	-4
0018	3F	11_1	136	17	3	1700	1430	-270	0.18	0.84	3	2	-1
0018	3F	11_1	145	10	1	1000	610	-390	0.10	0.61	1	1	0
0018	3F	11_1	146	6	0	600	0	-600	0.00	0.00	1	0	-1
0018	3F	11_1	156	2	0	200	0	-200	0.00	0.00	0	0	0
0018	3F	11_1	234	2	0	200	0	-200	0.00	0.00	0	0	0
0018	3F	11_1	235	1	0	100	0	-100	0.00	0.00	0	0	0
0018	3F	11_1	246	1	1	100	880	780	1.00	8.80	0	1	1
0018	3F	11_2	123	40	11	4000	3210	-790	0.28	0.80	7	5	-2
0018	3F	11_2	124	77	18	7700	5490	-2210	0.23	0.71	13	9	-4
0018	3F	11_2	125	21	1	2100	710	-1390	0.05	0.34	3	1	-2
0018	3F	11_2	126	44	9	4400	4880	480	0.20	1.11	7	8	1
0018	3F	11_2	134	34	15	3400	4120	720	0.44	1.21	6	7	1
0018	3F	11_2	135	15	7	1500	2530	1030	0.47	1.69	2	4	2
0018	3F	11_2	136	44	3	4400	790	-3610	0.07	0.18	7	1	-6
0018	3F	11_2	145	8	2	800	450	-350	0.25	0.56	1	0	-1
0018	3F	11_2	146	10	3	1000	1790	790	0.30	1.79	1	3	2
0018	3F	11_2	156	6	0	600	0	-600	0.00	0.00	1	0	-1
0018	3F	11_2	235	1	1	100	160	60	1.00	1.60	0	0	0
0018	3F	11_2	236	1	0	100	0	-100	0.00	0.00	0	0	0
0018	3F	11_2	246	1	0	100	0	-100	0.00	0.00	0	0	0
0018	3F	11_2	256	2	0	200	0	-200	0.00	0.00	0	0	0
0018	3F	11_3	123	47	11	4700	3250	-1450	0.23	0.69	8	5	-3
0018	3F	11_3	124	71	13	7100	5650	-1450	0.18	0.80	12	10	-2
0018	3F	11_3	125	46	11	4600	5300	700	0.24	1.15	8	9	1
0018	3F	11_3	126	34	6	3400	5940	2540	0.18	1.75	6	10	4
0018	3F	11_3	134	46	10	4600	2690	-1910	0.22	0.58	8	4	-4
0018	3F	11_3	135	21	1	2100	220	-1880	0.05	0.10	3	0	-3
0018	3F	11_3	136	23	1	2300	190	-2110	0.04	0.08	4	0	-4
0018	3F	11_3	145	10	2	1000	1310	310	0.20	1.31	1	2	1
0018	3F	11_3	146	7	0	700	0	-700	0.00	0.00	1	0	-1
0018	3F	11_3	156	4	1	400	330	-70	0.25	0.83	0	0	0
0018	3F	11_3	234	1	0	100	0	-100	0.00	0.00	0	0	0
0018	3F	11_3	235	3	0	300	0	-300	0.00	0.00	0	0	0
0018	3F	11_3	236	3	0	300	0	-300	0.00	0.00	0	0	0
0018	3F	11_3	245	1	1	100	400	300	1.00	4.00	0	0	0
0018	3F	11_3	246	1	0	100	0	-100	0.00	0.00	0	0	0
0018	3F	11_3	256	1	1	100	260	160	1.00	2.60	0	0	0
0018	3F	11_4	123	50	18	5000	5750	750	0.36	1.15	8	10	2
0018	3F	11_4	124	68	13	6800	3820	-2980	0.19	0.56	12	6	-6
0018	3F	11_4	125	48	6	4800	5270	470	0.13	1.10	8	9	1
0018	3F	11_4	126	23	0	2300	0	-2300	0.00	0.00	4	0	-4
0018	3F	11_4	134	43	7	4300	2060	-2240	0.16	0.48	7	3	-4
0018	3F	11_4	135	25	1	2500	720	-1780	0.04	0.29	4	1	-3
0018	3F	11_4	136	7	0	700	0	-700	0.00	0.00	1	0	-1
0018	3F	11_4	145	7	4	700	1490	790	0.57	2.13	1	2	1
0018	3F	11_4	146	6	1	600	380	-220	0.17	0.63	1	0	-1
0018	3F	11_4	156	2	0	200	0	-200	0.00	0.00	0	0	0
0018	3F	11_4	234	2	1	200	200	0	0.50	1.00	0	0	0
0018	3F	11_4	235	4	1	400	270	-130	0.25	0.68	0	0	0
0018	3F	11_4	236	2	0	200	0	-200	0.00	0.00	0	0	0
0018	3F	11_4	245	2	0	200	0	-200	0.00	0.00	0	0	0
0018	3F	11_4	246	1	0	100	0	-100	0.00	0.00	0	0	0
0018	3F	11_4	256	1	0	100	0	-100	0.00	0.00	0	0	0
0018	3F	11_5	123	51	12	5100	3460	-1640	0.24	0.68	9	6	-3
0018	3F	11_5	124	90	25	9000	9360	360	0.28	1.04	15	16	1
0018	3F	11_5	125	25	3	2500	1160	-1340	0.12	0.46	4	2	-2
0018	3F	11_5	126	19	3	1900	3680	1780	0.16	1.94	3	6	3
0018	3F	11_5	134	36	14	3600	4160	560	0.39	1.16	6	7	1
0018	3F	11_5	135	10	0	1000	0	-1000	0.00	0.00	1	0	-1
0018	3F	11_5	136	17	2	1700	620	-1080	0.12	0.36	3	1	-2
0018	3F	11_5	145	9	1	900	480	-420	0.11	0.53	1	0	-1
0018	3F	11_5	146	6	3	600	1320	720	0.50	2.20	1	2	1
0018	3F	11_7	123	75	25	7500	6950	-550	0.33	0.93	13	12	-1
0018	3F	11_7	124	104	21	10400	8120	-2280	0.20	0.78	18	14	-4
0018	3F	11_7	125	53	9	5300	4330	-970	0.17	0.82	9	7	-2
0018	3F	11_7	126	34	4	3400	2750	-650	0.12	0.81	6	4	-2
0018	3F	11_7	134	53	14	5300	4410	-890	0.26	0.83	9	7	-2
0018	3F	11_7	135	25	4	2500	1380	-1120	0.16	0.55	4	2	-2
0018	3F	11_7	136	19	1	1900	1120	-780	0.05	0.59	3	1	-2
0018	3F	11_7	145	6	0	600	0	-600	0.00	0.00	1	0	-1
0018	3F	11_7	146	7	0	700	0	-700	0.00	0.00	1	0	-1
0018	3F	11_7	156	1	0	100	0	-100	0.00	0.00	0	0	0
0018	3F	11_7	245	1	0	100	0	-100	0.00	0.00	0	0	0
0018	3F	12_1	123	37	10	3700	2370	-1330	0.27	0.64	6	4	-2
0018	3F	12_1	124	125	23	12500	8470	-4030	0.18	0.68	22	14	-8
0018	3F	12_1	125	53	13	5300	6230	930	0.25	1.18	9	11	2
0018	3F	12_1	126	39	8	3900	3210	-690	0.21	0.82	6	5	-1
0018	3F	12_1	134	33	6	3300	1990	-1310	0.18	0.60	5	3	-2
0018	3F	12_1	135	25	6	2500	1850	-650	0.24	0.74	4	3	-1
0018	3F	12_1	136	22	5	2200	1690	-510	0.23	0.77	3	2	-1
0018	3F	12_1	145	11	0	1100	0	-1100	0.00	0.00	1	0	-1
0018	3F	12_1	146	4	0	400	0	-400	0.00	0.00	0	0	0
0018	3F	12_1	156	2	1	200	1720	1520	0.50	8.60	0	3	3
0018	3F	12_1	234	2	1	200	230	30	0.50	1.15	0	0	0
0018	3F	12_1	235	2	0	200	0	-200	0.00	0.00	0	0	0
0018	3F	12_1	236	1	0	100	0	-100	0.00	0.00	0	0	0
0018	3F	12_1	245	1	0	100	0	-100	0.00	0.00	0	0	0
0018	3F	12_1	246	2	0	200	0	-200	0.00	0.00	0	0	0
0018	3F	12_2	123	39	8	3900	2160	-1740	0.21	0.55	6	3	-3
0018	3F	12_2	124	77	12	7700	3540	-4160	0.16	0.46	13	6	-7
0018	3F	12_2	125	65	15	6500	7260	760	0.23	1.12	11	12	1
0018	3F	12_2	126	50	8	5000	2530	-2470	0.16	0.51	8	4	-4
0018	3F	12_2	134	22	5	2200	1530	-670	0.23	0.70	3	2	-1
0018	3F	12_2	135	26	9	2600	2880	280	0.35	1.11	4	5	1
0018	3F	12_2	136	22	5	2200	1740	-460	0.23	0.79	3	3	0
0018	3F	12_2	145	12	2	1200	560	-640	0.17	0.47	2	0	-2
0018	3F	12_2	146	12	1	1200	220	-980	0.08	0.18	2	0	-2
0018	3F	12_2	156	3	1	300	720	420	0.33	2.40	0	1	1
0018	3F	12_2	236	1	0	100	0	-100	0.00	0.00	0	0	0
0018	3F	12_2	246	1	0	100	0	-100	0.00	0.00	0	0	0
0018	3F	12_3	123	41	9	4100	2170	-1930	0.22	0.53	7	3	-4
0018	3F	12_3	124	82	11	8200	4180	-4020	0.13	0.51	14	7	-7
0018	3F	12_3	125	54	8	5400	3560	-1840	0.15	0.66	9	6	-3
0018	3F	12_3	126	40	8	4000	3190	-810	0.20	0.80	7	5	-2
0018	3F	12_3	134	25	4	2500	1350	-1150	0.16	0.54	4	2	-2
0018	3F	12_3	135	29	5	2900	1370	-1530	0.17	0.47	5	2	-3
0018	3F	12_3	136	31	6	3100	1840	-1260	0.19	0.59	5	3	-2
0018	3F	12_3	145	20	2	2000	990	-1010	0.10	0.50	3	1	-2
0018	3F	12_3	146	9	1	900	440	-460	0.11	0.49	1	0	-1
0018	3F	12_3	156	2	1	200	320	120	0.50	1.60	0	0	0
0018	3F	12_3	234	1	0	100	0	-100	0.00	0.00	0	0	0
0018	3F	12_3	235	1	0	100	0	-100	0.00	0.00	0	0	0
0018	3F	12_3	236	3	1	300	420	120	0.33	1.40	0	0	0
0018	3F	12_3	245	1	0	100	0	-100	0.00	0.00	0	0	0
0018	3F	12_4	123	48	17	4800	4400	-400	0.35	0.92	8	7	-1
0018	3F	12_4	124	84	24	8400	8130	-270	0.29	0.97	14	14	0
0018	3F	12_4	125	58	6	5800	2860	-2940	0.10	0.49	10	5	-5
0018	3F	12_4	126	34	3	3400	920	-2480	0.09	0.27	6	1	-5
0018	3F	12_4	134	21	4	2100	1670	-430	0.19	0.80	3	2	-1
0018	3F	12_4	135	19	5	1900	1590	-310	0.26	0.84	3	2	-1
0018	3F	12_4	136	13	8	1300	3070	1770	0.62	2.36	2	5	3
0018	3F	12_4	145	8	3	800	1090	290	0.38	1.36	1	1	0
0018	3F	12_4	146	8	1	800	260	-540	0.13	0.33	1	0	-1
0018	3F	12_4	156	2	0	200	0	-200	0.00	0.00	0	0	0
0018	3F	12_4	234	2	0	200	0	-200	0.00	0.00	0	0	0
0018	3F	12_4	235	3	0	300	0	-300	0.00	0.00	0	0	0
0018	3F	12_4	245	1	0	100	0	-100	0.00	0.00	0	0	0
0018	3F	12_4	246	1	1	100	150	50	1.00	1.50	0	0	0
0018	3F	12_4	256	1	0	100	0	-100	0.00	0.00	0	0	0
0018	3F	12_5	123	40	14	4000	3250	-750	0.35	0.81	7	5	-2
0018	3F	12_5	124	115	26	11500	9200	-2300	0.23	0.80	20	16	-4
0018	3F	12_5	125	44	7	4400	3280	-1120	0.16	0.75	7	5	-2
0018	3F	12_5	126	25	7	2500	2240	-260	0.28	0.90	4	3	-1
0018	3F	12_5	134	22	4	2200	1510	-690	0.18	0.69	3	2	-1
0018	3F	12_5	135	25	6	2500	2690	190	0.24	1.08	4	4	0
0018	3F	12_5	136	8	1	800	1620	820	0.13	2.03	1	2	1
0018	3F	12_5	145	9	4	900	1620	720	0.44	1.80	1	2	1
0018	3F	12_5	146	2	1	200	700	500	0.50	3.50	0	1	1
0018	3F	12_5	156	1	1	100	460	360	1.00	4.60	0	0	0
0018	3F	12_6	123	4	2	400	630	230	0.50	1.58	0	1	1
0018	3F	12_6	124	5	1	500	240	-260	0.20	0.48	0	0	0
0018	3F	12_6	125	5	1	500	320	-180	0.20	0.64	0	0	0
0018	3F	12_6	126	5	0	500	0	-500	0.00	0.00	0	0	0
0018	3F	12_6	134	1	1	100	220	120	1.00	2.20	0	0	0
0018	3F	12_6	135	3	0	300	0	-300	0.00	0.00	0	0	0
0018	3F	12_6	136	2	1	200	1500	1300	0.50	7.50	0	2	2
0018	3F	12_7	123	66	19	6600	5160	-1440	0.29	0.78	11	9	-2
0018	3F	12_7	124	117	23	11700	7550	-4150	0.20	0.65	20	13	-7
0018	3F	12_7	125	69	10	6900	4300	-2600	0.14	0.62	12	7	-5
0018	3F	12_7	126	39	9	3900	4340	440	0.23	1.11	6	7	1
0018	3F	12_7	134	35	7	3500	2740	-760	0.20	0.78	6	4	-2
0018	3F	12_7	135	29	3	2900	1290	-1610	0.10	0.44	5	2	-3
0018	3F	12_7	136	17	1	1700	860	-840	0.06	0.51	3	1	-2
0018	3F	12_7	145	6	0	600	0	-600	0.00	0.00	1	0	-1
0018	3F	12_7	146	3	0	300	0	-300	0.00	0.00	0	0	0
0018	3F	12_7	234	2	0	200	0	-200	0.00	0.00	0	0	0
0018	3F	12_7	235	1	0	100	0	-100	0.00	0.00	0	0	0
0018	3F	12_7	245	2	0	200	0	-200	0.00	0.00	0	0	0
0018	3F	13_1	123	44	8	4400	2790	-1610	0.18	0.63	7	4	-3
0018	3F	13_1	124	120	32	12000	10150	-1850	0.27	0.85	21	17	-4
0018	3F	13_1	125	22	3	2200	1510	-690	0.14	0.69	3	2	-1
0018	3F	13_1	126	25	2	2500	600	-1900	0.08	0.24	4	1	-3
0018	3F	13_1	134	78	23	7800	6670	-1130	0.29	0.86	13	11	-2
0018	3F	13_1	135	15	3	1500	1460	-40	0.20	0.97	2	2	0
0018	3F	13_1	136	15	1	1500	400	-1100	0.07	0.27	2	0	-2
0018	3F	13_1	145	16	1	1600	290	-1310	0.06	0.18	2	0	-2
0018	3F	13_1	146	13	1	1300	450	-850	0.08	0.35	2	0	-2
0018	3F	13_1	156	1	0	100	0	-100	0.00	0.00	0	0	0
0018	3F	13_1	234	2	0	200	0	-200	0.00	0.00	0	0	0
0018	3F	13_1	246	1	0	100	0	-100	0.00	0.00	0	0	0
0018	3F	13_2	123	37	9	3700	4640	940	0.24	1.25	6	8	2
0018	3F	13_2	124	54	14	5400	5630	230	0.26	1.04	9	9	0
0018	3F	13_2	125	43	13	4300	5090	790	0.30	1.18	7	9	2
0018	3F	13_2	126	30	4	3000	1850	-1150	0.13	0.62	5	3	-2
0018	3F	13_2	134	30	5	3000	1750	-1250	0.17	0.58	5	3	-2
0018	3F	13_2	135	21	5	2100	1560	-540	0.24	0.74	3	2	-1
0018	3F	13_2	136	14	2	1400	650	-750	0.14	0.46	2	1	-1
0018	3F	13_2	145	11	2	1100	480	-620	0.18	0.44	1	0	-1
0018	3F	13_2	146	11	3	1100	1380	280	0.27	1.25	1	2	1
0018	3F	13_2	156	2	2	200	680	480	1.00	3.40	0	1	1
0018	3F	13_2	245	1	0	100	0	-100	0.00	0.00	0	0	0
0018	3F	13_3	123	33	6	3300	1580	-1720	0.18	0.48	5	2	-3
0018	3F	13_3	124	55	4	5500	2000	-3500	0.07	0.36	9	3	-6
0018	3F	13_3	125	53	12	5300	3980	-1320	0.23	0.75	9	7	-2
0018	3F	13_3	126	58	8	5800	6490	690	0.14	1.12	10	11	1
0018	3F	13_3	134	20	7	2000	3000	1000	0.35	1.50	3	5	2
0018	3F	13_3	135	30	8	3000	2750	-250	0.27	0.92	5	4	-1
0018	3F	13_3	136	33	6	3300	1930	-1370	0.18	0.58	5	3	-2
0018	3F	13_3	145	11	2	1100	660	-440	0.18	0.60	1	1	0
0018	3F	13_3	146	9	0	900	0	-900	0.00	0.00	1	0	-1
0018	3F	13_3	156	7	0	700	0	-700	0.00	0.00	1	0	-1
0018	3F	13_3	235	4	2	400	420	20	0.50	1.05	0	0	0
0018	3F	13_3	236	1	0	100	0	-100	0.00	0.00	0	0	0
0018	3F	13_3	245	4	1	400	240	-160	0.25	0.60	0	0	0
0018	3F	13_3	246	3	0	300	0	-300	0.00	0.00	0	0	0
0018	3F	13_3	256	2	0	200	0	-200	0.00	0.00	0	0	0
0018	3F	13_4	123	38	5	3800	1670	-2130	0.13	0.44	6	2	-4
0018	3F	13_4	124	70	14	7000	3800	-3200	0.20	0.54	12	6	-6
0018	3F	13_4	125	56	11	5600	3490	-2110	0.20	0.62	9	6	-3
0018	3F	13_4	126	24	3	2400	2090	-310	0.13	0.87	4	3	-1
0018	3F	13_4	134	30	13	3000	4620	1620	0.43	1.54	5	8	3
0018	3F	13_4	135	18	6	1800	2060	260	0.33	1.14	3	3	0
0018	3F	13_4	136	10	0	1000	0	-1000	0.00	0.00	1	0	-1
0018	3F	13_4	145	16	2	1600	980	-620	0.13	0.61	2	1	-1
0018	3F	13_4	146	9	1	900	470	-430	0.11	0.52	1	0	-1
0018	3F	13_4	156	2	0	200	0	-200	0.00	0.00	0	0	0
0018	3F	13_4	234	1	0	100	0	-100	0.00	0.00	0	0	0
0018	3F	13_4	235	3	1	300	290	-10	0.33	0.97	0	0	0
0018	3F	13_4	236	3	0	300	0	-300	0.00	0.00	0	0	0
0018	3F	13_4	245	1	0	100	0	-100	0.00	0.00	0	0	0
0018	3F	13_4	246	1	0	100	0	-100	0.00	0.00	0	0	0
0018	3F	13_5	123	40	11	4000	3270	-730	0.28	0.82	7	5	-2
0018	3F	13_5	124	87	21	8700	6940	-1760	0.24	0.80	15	12	-3
0018	3F	13_5	125	36	5	3600	1980	-1620	0.14	0.55	6	3	-3
0018	3F	13_5	126	31	10	3100	5870	2770	0.32	1.89	5	10	5
0018	3F	13_5	134	28	6	2800	2560	-240	0.21	0.91	4	4	0
0018	3F	13_5	135	14	2	1400	830	-570	0.14	0.59	2	1	-1
0018	3F	13_5	136	17	0	1700	0	-1700	0.00	0.00	3	0	-3
0018	3F	13_5	145	8	1	800	950	150	0.13	1.19	1	1	0
0018	3F	13_5	146	5	2	500	510	10	0.40	1.02	0	0	0
0018	3F	13_5	156	1	1	100	330	230	1.00	3.30	0	0	0
0018	3F	13_5	234	1	0	100	0	-100	0.00	0.00	0	0	0
0018	3F	13_6	123	1	0	100	0	-100	0.00	0.00	0	0	0
0018	3F	13_6	124	10	1	1000	270	-730	0.10	0.27	1	0	-1
0018	3F	13_6	125	6	2	600	990	390	0.33	1.65	1	1	0
0018	3F	13_6	126	4	1	400	280	-120	0.25	0.70	0	0	0
0018	3F	13_6	134	5	1	500	250	-250	0.20	0.50	0	0	0
0018	3F	13_6	135	1	0	100	0	-100	0.00	0.00	0	0	0
0018	3F	13_6	136	1	0	100	0	-100	0.00	0.00	0	0	0
0018	3F	13_6	146	2	0	200	0	-200	0.00	0.00	0	0	0
0018	3F	13_7	123	46	19	4600	5690	1090	0.41	1.24	8	10	2
0018	3F	13_7	124	86	18	8600	6960	-1640	0.21	0.81	15	12	-3
0018	3F	13_7	125	44	7	4400	2620	-1780	0.16	0.60	7	4	-3
0018	3F	13_7	126	41	8	4100	4530	430	0.20	1.10	7	8	1
0018	3F	13_7	134	33	10	3300	5120	1820	0.30	1.55	5	9	4
0018	3F	13_7	135	21	4	2100	1760	-340	0.19	0.84	3	3	0
0018	3F	13_7	136	18	4	1800	2170	370	0.22	1.21	3	3	0
0018	3F	13_7	145	8	0	800	0	-800	0.00	0.00	1	0	-1
0018	3F	13_7	146	10	2	1000	1160	160	0.20	1.16	1	2	1
0018	3F	13_7	156	3	0	300	0	-300	0.00	0.00	0	0	0
0018	3F	13_7	236	1	1	100	410	310	1.00	4.10	0	0	0
0018	3F	13_7	246	3	0	300	0	-300	0.00	0.00	0	0	0
0018	3F	14_1	123	64	14	6400	7890	1490	0.22	1.23	11	13	2
0018	3F	14_1	124	54	11	5400	2920	-2480	0.20	0.54	9	5	-4
0018	3F	14_1	125	96	16	9600	14640	5040	0.17	1.53	16	25	9
0018	3F	14_1	126	36	6	3600	5270	1670	0.17	1.46	6	9	3
0018	3F	14_1	134	21	1	2100	250	-1850	0.05	0.12	3	0	-3
0018	3F	14_1	135	19	5	1900	1770	-130	0.26	0.93	3	3	0
0018	3F	14_1	136	14	0	1400	0	-1400	0.00	0.00	2	0	-2
0018	3F	14_1	145	25	3	2500	1760	-740	0.12	0.70	4	3	-1
0018	3F	14_1	146	10	0	1000	0	-1000	0.00	0.00	1	0	-1
0018	3F	14_1	234	2	0	200	0	-200	0.00	0.00	0	0	0
0018	3F	14_1	235	1	0	100	0	-100	0.00	0.00	0	0	0
0018	3F	14_1	236	2	0	200	0	-200	0.00	0.00	0	0	0
0018	3F	14_1	245	6	1	600	1330	730	0.17	2.22	1	2	1
0018	3F	14_1	246	7	0	700	0	-700	0.00	0.00	1	0	-1
0018	3F	14_1	256	1	0	100	0	-100	0.00	0.00	0	0	0
0018	3F	14_2	123	120	21	12000	9640	-2360	0.18	0.80	21	17	-4
0018	3F	14_2	124	74	8	7400	2610	-4790	0.11	0.35	13	4	-9
0018	3F	14_2	125	25	6	2500	2570	70	0.24	1.03	4	4	0
0018	3F	14_2	126	32	3	3200	840	-2360	0.09	0.26	5	1	-4
0018	3F	14_2	134	46	8	4600	2410	-2190	0.17	0.52	8	4	-4
0018	3F	14_2	135	9	1	900	1080	180	0.11	1.20	1	1	0
0018	3F	14_2	136	2	1	200	420	220	0.50	2.10	0	0	0
0018	3F	14_2	145	8	0	800	0	-800	0.00	0.00	1	0	-1
0018	3F	14_2	146	7	2	700	1250	550	0.29	1.79	1	2	1
0018	3F	14_2	234	7	0	700	0	-700	0.00	0.00	1	0	-1
0018	3F	14_2	236	1	0	100	0	-100	0.00	0.00	0	0	0
0018	3F	14_2	246	1	0	100	0	-100	0.00	0.00	0	0	0
0018	3F	14_3	123	273	58	27300	28070	770	0.21	1.03	48	49	1
0018	3F	14_3	124	7	1	700	1060	360	0.14	1.51	1	1	0
0018	3F	14_3	134	100	14	10000	7020	-2980	0.14	0.70	17	12	-5
0018	3F	14_3	234	17	0	1700	0	-1700	0.00	0.00	3	0	-3
0018	3F	14_4	123	57	13	5700	3850	-1850	0.23	0.68	10	6	-4
0018	3F	14_4	124	76	14	7600	4430	-3170	0.18	0.58	13	7	-6
0018	3F	14_4	125	40	7	4000	3020	-980	0.18	0.76	7	5	-2
0018	3F	14_4	126	23	3	2300	2250	-50	0.13	0.98	4	3	-1
0018	3F	14_4	134	27	5	2700	1060	-1640	0.19	0.39	4	1	-3
0018	3F	14_4	135	16	4	1600	2350	750	0.25	1.47	2	4	2
0018	3F	14_4	136	8	1	800	470	-330	0.13	0.59	1	0	-1
0018	3F	14_4	145	7	2	700	1010	310	0.29	1.44	1	1	0
0018	3F	14_4	146	8	1	800	1340	540	0.13	1.68	1	2	1
0018	3F	14_4	156	2	1	200	380	180	0.50	1.90	0	0	0
0018	3F	14_4	234	3	2	300	700	400	0.67	2.33	0	1	1
0018	3F	14_4	235	8	0	800	0	-800	0.00	0.00	1	0	-1
0018	3F	14_4	236	2	1	200	440	240	0.50	2.20	0	0	0
0018	3F	14_4	245	2	0	200	0	-200	0.00	0.00	0	0	0
0018	3F	14_5	123	46	7	4600	3340	-1260	0.15	0.73	8	5	-3
0018	3F	14_5	124	36	3	3600	1260	-2340	0.08	0.35	6	2	-4
0018	3F	14_5	125	22	2	2200	1070	-1130	0.09	0.49	3	1	-2
0018	3F	14_5	126	17	3	1700	1450	-250	0.18	0.85	3	2	-1
0018	3F	14_5	134	14	2	1400	710	-690	0.14	0.51	2	1	-1
0018	3F	14_5	135	9	0	900	0	-900	0.00	0.00	1	0	-1
0018	3F	14_5	136	5	0	500	0	-500	0.00	0.00	0	0	0
0018	3F	14_5	145	7	0	700	0	-700	0.00	0.00	1	0	-1
0018	3F	14_5	146	6	0	600	0	-600	0.00	0.00	1	0	-1
0018	3F	14_5	156	3	0	300	0	-300	0.00	0.00	0	0	0
0018	3F	14_5	234	1	0	100	0	-100	0.00	0.00	0	0	0
0018	3F	14_5	236	1	1	100	290	190	1.00	2.90	0	0	0
0018	3F	14_5	256	1	0	100	0	-100	0.00	0.00	0	0	0
0018	3F	14_6	123	4	0	400	0	-400	0.00	0.00	0	0	0
0018	3F	14_6	124	4	0	400	0	-400	0.00	0.00	0	0	0
0018	3F	14_6	125	3	1	300	630	330	0.33	2.10	0	1	1
0018	3F	14_6	126	1	1	100	150	50	1.00	1.50	0	0	0
0018	3F	14_6	134	1	1	100	280	180	1.00	2.80	0	0	0
0018	3F	14_6	135	1	0	100	0	-100	0.00	0.00	0	0	0
0018	3F	14_6	136	1	0	100	0	-100	0.00	0.00	0	0	0
0018	3F	14_6	145	1	0	100	0	-100	0.00	0.00	0	0	0
0018	3F	14_6	146	1	0	100	0	-100	0.00	0.00	0	0	0
0018	3F	14_7	123	89	16	8900	7630	-1270	0.18	0.86	15	13	-2
0018	3F	14_7	124	82	16	8200	6170	-2030	0.20	0.75	14	10	-4
0018	3F	14_7	125	53	9	5300	5620	320	0.17	1.06	9	9	0
0018	3F	14_7	126	29	6	2900	3290	390	0.21	1.13	5	5	0
0018	3F	14_7	134	37	6	3700	3190	-510	0.16	0.86	6	5	-1
0018	3F	14_7	135	17	1	1700	950	-750	0.06	0.56	3	1	-2
0018	3F	14_7	136	6	2	600	800	200	0.33	1.33	1	1	0
0018	3F	14_7	145	17	0	1700	0	-1700	0.00	0.00	3	0	-3
0018	3F	14_7	146	5	1	500	390	-110	0.20	0.78	0	0	0
0018	3F	14_7	156	1	0	100	0	-100	0.00	0.00	0	0	0
0018	3F	14_7	234	1	0	100	0	-100	0.00	0.00	0	0	0
0018	3F	14_7	235	1	0	100	0	-100	0.00	0.00	0	0	0
0018	3F	14_7	236	1	0	100	0	-100	0.00	0.00	0	0	0
0018	3F	14_7	245	1	0	100	0	-100	0.00	0.00	0	0	0
0018	3F	15_1	123	54	11	5400	3500	-1900	0.20	0.65	9	6	-3
0018	3F	15_1	124	112	27	11200	7250	-3950	0.24	0.65	19	12	-7
0018	3F	15_1	125	52	17	5200	7530	2330	0.33	1.45	9	13	4
0018	3F	15_1	126	49	5	4900	2870	-2030	0.10	0.59	8	5	-3
0018	3F	15_1	134	58	18	5800	4030	-1770	0.31	0.69	10	7	-3
0018	3F	15_1	135	32	5	3200	1920	-1280	0.16	0.60	5	3	-2
0018	3F	15_1	136	29	5	2900	2760	-140	0.17	0.95	5	4	-1
0018	3F	15_1	145	6	0	600	0	-600	0.00	0.00	1	0	-1
0018	3F	15_1	146	6	1	600	830	230	0.17	1.38	1	1	0
0018	3F	15_1	156	7	0	700	0	-700	0.00	0.00	1	0	-1
0018	3F	15_1	234	1	0	100	0	-100	0.00	0.00	0	0	0
0018	3F	15_1	236	2	0	200	0	-200	0.00	0.00	0	0	0
0018	3F	15_2	123	39	7	3900	2040	-1860	0.18	0.52	6	3	-3
0018	3F	15_2	124	111	39	11100	10460	-640	0.35	0.94	19	18	-1
0018	3F	15_2	125	60	19	6000	12310	6310	0.32	2.05	10	21	11
0018	3F	15_2	126	42	7	4200	2940	-1260	0.17	0.70	7	5	-2
0018	3F	15_2	134	41	9	4100	2800	-1300	0.22	0.68	7	4	-3
0018	3F	15_2	135	27	7	2700	2150	-550	0.26	0.80	4	3	-1
0018	3F	15_2	136	20	4	2000	1540	-460	0.20	0.77	3	2	-1
0018	3F	15_2	145	9	2	900	780	-120	0.22	0.87	1	1	0
0018	3F	15_2	146	9	0	900	0	-900	0.00	0.00	1	0	-1
0018	3F	15_2	156	4	0	400	0	-400	0.00	0.00	0	0	0
0018	3F	15_2	235	1	0	100	0	-100	0.00	0.00	0	0	0
0018	3F	15_2	236	5	1	500	360	-140	0.20	0.72	0	0	0
0018	3F	15_2	245	1	1	100	420	320	1.00	4.20	0	0	0
0018	3F	15_3	123	51	12	5100	3340	-1760	0.24	0.65	9	5	-4
0018	3F	15_3	124	128	34	12800	10790	-2010	0.27	0.84	22	19	-3
0018	3F	15_3	125	51	7	5100	2860	-2240	0.14	0.56	9	5	-4
0018	3F	15_3	126	32	9	3200	4760	1560	0.28	1.49	5	8	3
0018	3F	15_3	134	41	10	4100	2990	-1110	0.24	0.73	7	5	-2
0018	3F	15_3	135	23	5	2300	1510	-790	0.22	0.66	4	2	-2
0018	3F	15_3	136	23	6	2300	2940	640	0.26	1.28	4	5	1
0018	3F	15_3	145	12	2	1200	630	-570	0.17	0.53	2	1	-1
0018	3F	15_3	146	9	2	900	1030	130	0.22	1.14	1	1	0
0018	3F	15_3	156	8	2	800	1960	1160	0.25	2.45	1	3	2
0018	3F	15_3	234	1	0	100	0	-100	0.00	0.00	0	0	0
0018	3F	15_3	245	1	0	100	0	-100	0.00	0.00	0	0	0
0018	3F	15_3	256	2	0	200	0	-200	0.00	0.00	0	0	0
0018	3F	15_4	123	53	14	5300	4500	-800	0.26	0.85	9	7	-2
0018	3F	15_4	124	108	29	10800	7520	-3280	0.27	0.70	19	13	-6
0018	3F	15_4	125	47	9	4700	3000	-1700	0.19	0.64	8	5	-3
0018	3F	15_4	126	26	3	2600	2390	-210	0.12	0.92	4	4	0
0018	3F	15_4	134	25	9	2500	2250	-250	0.36	0.90	4	3	-1
0018	3F	15_4	135	20	3	2000	1330	-670	0.15	0.67	3	2	-1
0018	3F	15_4	136	15	1	1500	470	-1030	0.07	0.31	2	0	-2
0018	3F	15_4	145	8	0	800	0	-800	0.00	0.00	1	0	-1
0018	3F	15_4	146	6	3	600	4310	3710	0.50	7.18	1	7	6
0018	3F	15_4	156	6	0	600	0	-600	0.00	0.00	1	0	-1
0018	3F	15_4	235	2	1	200	260	60	0.50	1.30	0	0	0
0018	3F	15_4	236	3	0	300	0	-300	0.00	0.00	0	0	0
0018	3F	15_5	123	39	12	3900	3190	-710	0.31	0.82	6	5	-1
0018	3F	15_5	124	112	18	11200	5570	-5630	0.16	0.50	19	9	-10
0018	3F	15_5	125	29	2	2900	900	-2000	0.07	0.31	5	1	-4
0018	3F	15_5	126	25	3	2500	1130	-1370	0.12	0.45	4	2	-2
0018	3F	15_5	134	26	7	2600	2420	-180	0.27	0.93	4	4	0
0018	3F	15_5	135	14	1	1400	270	-1130	0.07	0.19	2	0	-2
0018	3F	15_5	136	15	3	1500	1310	-190	0.20	0.87	2	2	0
0018	3F	15_5	145	4	2	400	620	220	0.50	1.55	0	1	1
0018	3F	15_5	146	2	0	200	0	-200	0.00	0.00	0	0	0
0018	3F	15_5	156	4	2	400	980	580	0.50	2.45	0	1	1
0018	3F	15_5	236	1	0	100	0	-100	0.00	0.00	0	0	0
0018	3F	15_5	256	1	0	100	0	-100	0.00	0.00	0	0	0
0018	3F	15_6	123	7	1	700	290	-410	0.14	0.41	1	0	-1
0018	3F	15_6	124	22	8	2200	2270	70	0.36	1.03	3	4	1
0018	3F	15_6	125	4	0	400	0	-400	0.00	0.00	0	0	0
0018	3F	15_6	126	5	1	500	430	-70	0.20	0.86	0	0	0
0018	3F	15_6	134	3	0	300	0	-300	0.00	0.00	0	0	0
0018	3F	15_6	135	5	1	500	1130	630	0.20	2.26	0	2	2
0018	3F	15_6	136	2	1	200	400	200	0.50	2.00	0	0	0
0018	3F	15_6	146	1	1	100	700	600	1.00	7.00	0	1	1
0018	3F	15_6	156	3	0	300	0	-300	0.00	0.00	0	0	0
0018	3F	15_7	123	61	17	6100	4960	-1140	0.28	0.81	10	8	-2
0018	3F	15_7	124	147	36	14700	10620	-4080	0.24	0.72	26	18	-8
0018	3F	15_7	125	59	10	5900	3770	-2130	0.17	0.64	10	6	-4
0018	3F	15_7	126	50	8	5000	5120	120	0.16	1.02	8	9	1
0018	3F	15_7	134	45	14	4500	4440	-60	0.31	0.99	7	7	0
0018	3F	15_7	135	24	0	2400	0	-2400	0.00	0.00	4	0	-4
0018	3F	15_7	136	31	4	3100	1630	-1470	0.13	0.53	5	2	-3
0018	3F	15_7	145	6	1	600	630	30	0.17	1.05	1	1	0
0018	3F	15_7	146	5	0	500	0	-500	0.00	0.00	0	0	0
0018	3F	15_7	156	3	0	300	0	-300	0.00	0.00	0	0	0
0018	3F	15_7	236	1	0	100	0	-100	0.00	0.00	0	0	0
0018	3F	15_7	246	1	0	100	0	-100	0.00	0.00	0	0	0
0018	3F	16_1	123	62	19	6200	3980	-2220	0.31	0.64	10	7	-3
0018	3F	16_1	124	152	34	15200	12450	-2750	0.22	0.82	26	22	-4
0018	3F	16_1	125	68	11	6800	4240	-2560	0.16	0.62	12	7	-5
0018	3F	16_1	126	43	8	4300	2940	-1360	0.19	0.68	7	5	-2
0018	3F	16_1	134	33	7	3300	2330	-970	0.21	0.71	5	4	-1
0018	3F	16_1	135	16	2	1600	790	-810	0.13	0.49	2	1	-1
0018	3F	16_1	136	28	4	2800	1710	-1090	0.14	0.61	4	3	-1
0018	3F	16_1	145	11	3	1100	960	-140	0.27	0.87	1	1	0
0018	3F	16_1	146	7	1	700	300	-400	0.14	0.43	1	0	-1
0018	3F	16_1	156	3	0	300	0	-300	0.00	0.00	0	0	0
0018	3F	16_2	123	53	17	5300	3780	-1520	0.32	0.71	9	6	-3
0018	3F	16_2	124	82	19	8200	7460	-740	0.23	0.91	14	13	-1
0018	3F	16_2	125	43	13	4300	5900	1600	0.30	1.37	7	10	3
0018	3F	16_2	126	44	11	4400	4850	450	0.25	1.10	7	8	1
0018	3F	16_2	134	30	4	3000	940	-2060	0.13	0.31	5	1	-4
0018	3F	16_2	135	23	4	2300	1220	-1080	0.17	0.53	4	2	-2
0018	3F	16_2	136	18	1	1800	230	-1570	0.06	0.13	3	0	-3
0018	3F	16_2	145	15	3	1500	2040	540	0.20	1.36	2	3	1
0018	3F	16_2	146	4	0	400	0	-400	0.00	0.00	0	0	0
0018	3F	16_2	156	4	1	400	220	-180	0.25	0.55	0	0	0
0018	3F	16_2	234	1	0	100	0	-100	0.00	0.00	0	0	0
0018	3F	16_2	236	2	1	200	350	150	0.50	1.75	0	0	0
0018	3F	16_2	245	2	0	200	0	-200	0.00	0.00	0	0	0
0018	3F	16_2	256	3	0	300	0	-300	0.00	0.00	0	0	0
0018	3F	16_3	123	58	17	5800	3280	-2520	0.29	0.57	10	5	-5
0018	3F	16_3	124	76	16	7600	5110	-2490	0.21	0.67	13	9	-4
0018	3F	16_3	125	46	9	4600	2540	-2060	0.20	0.55	8	4	-4
0018	3F	16_3	126	42	8	4200	2920	-1280	0.19	0.70	7	5	-2
0018	3F	16_3	134	23	6	2300	2020	-280	0.26	0.88	4	3	-1
0018	3F	16_3	135	21	8	2100	2690	590	0.38	1.28	3	4	1
0018	3F	16_3	136	31	4	3100	2660	-440	0.13	0.86	5	4	-1
0018	3F	16_3	145	14	3	1400	940	-460	0.21	0.67	2	1	-1
0018	3F	16_3	146	5	0	500	0	-500	0.00	0.00	0	0	0
0018	3F	16_3	156	14	1	1400	2110	710	0.07	1.51	2	3	1
0018	3F	16_3	235	4	1	400	200	-200	0.25	0.50	0	0	0
0018	3F	16_3	245	1	0	100	0	-100	0.00	0.00	0	0	0
0018	3F	16_4	123	73	25	7300	5330	-1970	0.34	0.73	12	9	-3
0018	3F	16_4	124	83	16	8300	7300	-1000	0.19	0.88	14	12	-2
0018	3F	16_4	125	54	10	5400	5130	-270	0.19	0.95	9	9	0
0018	3F	16_4	126	27	4	2700	1690	-1010	0.15	0.63	4	2	-2
0018	3F	16_4	134	28	5	2800	1480	-1320	0.18	0.53	4	2	-2
0018	3F	16_4	135	14	4	1400	1630	230	0.29	1.16	2	2	0
0018	3F	16_4	136	10	1	1000	740	-260	0.10	0.74	1	1	0
0018	3F	16_4	145	7	3	700	790	90	0.43	1.13	1	1	0
0018	3F	16_4	146	6	2	600	1510	910	0.33	2.52	1	2	1
0018	3F	16_4	156	3	0	300	0	-300	0.00	0.00	0	0	0
0018	3F	16_4	235	1	0	100	0	-100	0.00	0.00	0	0	0
0018	3F	16_4	236	2	1	200	580	380	0.50	2.90	0	1	1
0018	3F	16_4	246	2	0	200	0	-200	0.00	0.00	0	0	0
0018	3F	16_4	256	3	0	300	0	-300	0.00	0.00	0	0	0
0018	3F	16_5	123	51	17	5100	3360	-1740	0.33	0.66	9	5	-4
0018	3F	16_5	124	113	26	11300	8790	-2510	0.23	0.78	20	15	-5
0018	3F	16_5	125	39	7	3900	2500	-1400	0.18	0.64	6	4	-2
0018	3F	16_5	126	22	3	2200	1950	-250	0.14	0.89	3	3	0
0018	3F	16_5	134	20	4	2000	1260	-740	0.20	0.63	3	2	-1
0018	3F	16_5	135	20	4	2000	980	-1020	0.20	0.49	3	1	-2
0018	3F	16_5	136	12	2	1200	1260	60	0.17	1.05	2	2	0
0018	3F	16_5	145	17	1	1700	220	-1480	0.06	0.13	3	0	-3
0018	3F	16_5	146	11	2	1100	610	-490	0.18	0.55	1	1	0
0018	3F	16_5	156	4	0	400	0	-400	0.00	0.00	0	0	0
0018	3F	16_5	234	1	0	100	0	-100	0.00	0.00	0	0	0
0018	3F	16_7	123	71	24	7100	5530	-1570	0.34	0.78	12	9	-3
0018	3F	16_7	124	141	36	14100	13760	-340	0.26	0.98	24	24	0
0018	3F	16_7	125	48	6	4800	2300	-2500	0.13	0.48	8	4	-4
0018	3F	16_7	126	43	14	4300	5930	1630	0.33	1.38	7	10	3
0018	3F	16_7	134	40	4	4000	1640	-2360	0.10	0.41	7	2	-5
0018	3F	16_7	135	17	0	1700	0	-1700	0.00	0.00	3	0	-3
0018	3F	16_7	136	21	3	2100	930	-1170	0.14	0.44	3	1	-2
0018	3F	16_7	145	8	2	800	1060	260	0.25	1.33	1	1	0
0018	3F	16_7	146	9	3	900	1010	110	0.33	1.12	1	1	0
0018	3F	16_7	156	3	0	300	0	-300	0.00	0.00	0	0	0
0018	3F	17_1	123	71	25	7100	6750	-350	0.35	0.95	12	11	-1
0018	3F	17_1	124	112	21	11200	7300	-3900	0.19	0.65	19	12	-7
0018	3F	17_1	125	37	4	3700	2500	-1200	0.11	0.68	6	4	-2
0018	3F	17_1	126	35	2	3500	1730	-1770	0.06	0.49	6	3	-3
0018	3F	17_1	134	36	8	3600	3430	-170	0.22	0.95	6	6	0
0018	3F	17_1	135	37	5	3700	2200	-1500	0.14	0.59	6	3	-3
0018	3F	17_1	136	14	2	1400	860	-540	0.14	0.61	2	1	-1
0018	3F	17_1	145	18	2	1800	790	-1010	0.11	0.44	3	1	-2
0018	3F	17_1	146	5	1	500	560	60	0.20	1.12	0	0	0
0018	3F	17_1	156	3	0	300	0	-300	0.00	0.00	0	0	0
0018	3F	17_1	235	3	1	300	340	40	0.33	1.13	0	0	0
0018	3F	17_1	236	1	1	100	570	470	1.00	5.70	0	1	1
0018	3F	17_1	245	1	0	100	0	-100	0.00	0.00	0	0	0
0018	3F	17_1	246	1	0	100	0	-100	0.00	0.00	0	0	0
0018	3F	17_1	256	2	0	200	0	-200	0.00	0.00	0	0	0
0018	3F	17_2	123	55	12	5500	3290	-2210	0.22	0.60	9	5	-4
0018	3F	17_2	124	100	28	10000	12610	2610	0.28	1.26	17	22	5
0018	3F	17_2	125	50	11	5000	4270	-730	0.22	0.85	8	7	-1
0018	3F	17_2	126	48	8	4800	7070	2270	0.17	1.47	8	12	4
0018	3F	17_2	134	48	12	4800	4140	-660	0.25	0.86	8	7	-1
0018	3F	17_2	135	20	3	2000	1440	-560	0.15	0.72	3	2	-1
0018	3F	17_2	136	26	2	2600	850	-1750	0.08	0.33	4	1	-3
0018	3F	17_2	145	7	3	700	1360	660	0.43	1.94	1	2	1
0018	3F	17_2	146	8	1	800	360	-440	0.13	0.45	1	0	-1
0018	3F	17_2	156	4	1	400	420	20	0.25	1.05	0	0	0
0018	3F	17_2	234	1	0	100	0	-100	0.00	0.00	0	0	0
0018	3F	17_2	235	2	1	200	270	70	0.50	1.35	0	0	0
0018	3F	17_2	236	3	0	300	0	-300	0.00	0.00	0	0	0
0018	3F	17_2	245	1	0	100	0	-100	0.00	0.00	0	0	0
0018	3F	17_2	246	1	0	100	0	-100	0.00	0.00	0	0	0
0018	3F	17_2	256	1	0	100	0	-100	0.00	0.00	0	0	0
0018	3F	17_3	123	49	17	4900	4560	-340	0.35	0.93	8	8	0
0018	3F	17_3	124	103	20	10300	6520	-3780	0.19	0.63	18	11	-7
0018	3F	17_3	125	60	11	6000	4440	-1560	0.18	0.74	10	7	-3
0018	3F	17_3	126	49	4	4900	2870	-2030	0.08	0.59	8	5	-3
0018	3F	17_3	134	45	6	4500	2690	-1810	0.13	0.60	7	4	-3
0018	3F	17_3	135	24	0	2400	0	-2400	0.00	0.00	4	0	-4
0018	3F	17_3	136	18	3	1800	1670	-130	0.17	0.93	3	2	-1
0018	3F	17_3	145	10	2	1000	690	-310	0.20	0.69	1	1	0
0018	3F	17_3	146	5	2	500	1080	580	0.40	2.16	0	1	1
0018	3F	17_3	156	4	0	400	0	-400	0.00	0.00	0	0	0
0018	3F	17_3	234	2	1	200	310	110	0.50	1.55	0	0	0
0018	3F	17_3	235	1	1	100	520	420	1.00	5.20	0	0	0
0018	3F	17_3	246	1	1	100	460	360	1.00	4.60	0	0	0
0018	3F	17_3	256	1	0	100	0	-100	0.00	0.00	0	0	0
0018	3F	17_4	123	51	10	5100	3340	-1760	0.20	0.65	9	5	-4
0018	3F	17_4	124	82	11	8200	3570	-4630	0.13	0.44	14	6	-8
0018	3F	17_4	125	57	7	5700	1980	-3720	0.12	0.35	10	3	-7
0018	3F	17_4	126	25	3	2500	2200	-300	0.12	0.88	4	3	-1
0018	3F	17_4	134	34	9	3400	4190	790	0.26	1.23	6	7	1
0018	3F	17_4	135	26	6	2600	2400	-200	0.23	0.92	4	4	0
0018	3F	17_4	136	9	1	900	320	-580	0.11	0.36	1	0	-1
0018	3F	17_4	145	13	2	1300	1390	90	0.15	1.07	2	2	0
0018	3F	17_4	146	6	2	600	600	0	0.33	1.00	1	1	0
0018	3F	17_4	156	1	0	100	0	-100	0.00	0.00	0	0	0
0018	3F	17_4	236	1	1	100	690	590	1.00	6.90	0	1	1
0018	3F	17_4	245	1	1	100	250	150	1.00	2.50	0	0	0
0018	3F	17_4	246	1	0	100	0	-100	0.00	0.00	0	0	0
0018	3F	17_5	123	48	20	4800	4510	-290	0.42	0.94	8	7	-1
0018	3F	17_5	124	103	18	10300	5100	-5200	0.17	0.50	18	9	-9
0018	3F	17_5	125	51	10	5100	3760	-1340	0.20	0.74	9	6	-3
0018	3F	17_5	126	18	0	1800	0	-1800	0.00	0.00	3	0	-3
0018	3F	17_5	134	30	5	3000	1300	-1700	0.17	0.43	5	2	-3
0018	3F	17_5	135	21	4	2100	2470	370	0.19	1.18	3	4	1
0018	3F	17_5	136	10	2	1000	3460	2460	0.20	3.46	1	6	5
0018	3F	17_5	145	7	2	700	450	-250	0.29	0.64	1	0	-1
0018	3F	17_5	146	3	0	300	0	-300	0.00	0.00	0	0	0
0018	3F	17_5	156	2	0	200	0	-200	0.00	0.00	0	0	0
0018	3F	17_5	235	1	0	100	0	-100	0.00	0.00	0	0	0
0018	3F	17_5	236	2	0	200	0	-200	0.00	0.00	0	0	0
0018	3F	17_7	123	74	25	7400	7250	-150	0.34	0.98	13	12	-1
0018	3F	17_7	124	96	17	9600	5420	-4180	0.18	0.56	16	9	-7
0018	3F	17_7	125	82	16	8200	7490	-710	0.20	0.91	14	13	-1
0018	3F	17_7	126	46	4	4600	1990	-2610	0.09	0.43	8	3	-5
0018	3F	17_7	134	46	10	4600	3310	-1290	0.22	0.72	8	5	-3
0018	3F	17_7	135	29	0	2900	0	-2900	0.00	0.00	5	0	-5
0018	3F	17_7	136	16	4	1600	1660	60	0.25	1.04	2	2	0
0018	3F	17_7	145	8	0	800	0	-800	0.00	0.00	1	0	-1
0018	3F	17_7	146	9	2	900	2460	1560	0.22	2.73	1	4	3
0018	3F	17_7	156	4	1	400	440	40	0.25	1.10	0	0	0
0018	3F	17_7	235	2	1	200	1100	900	0.50	5.50	0	1	1
0018	3F	17_7	245	1	0	100	0	-100	0.00	0.00	0	0	0
0018	3F	17_7	256	1	0	100	0	-100	0.00	0.00	0	0	0
0018	3F	18_1	123	66	13	6600	4900	-1700	0.20	0.74	11	8	-3
0018	3F	18_1	124	61	15	6100	4750	-1350	0.25	0.78	10	8	-2
0018	3F	18_1	125	89	20	8900	7970	-930	0.22	0.90	15	14	-1
0018	3F	18_1	126	20	3	2000	1300	-700	0.15	0.65	3	2	-1
0018	3F	18_1	134	36	10	3600	2980	-620	0.28	0.83	6	5	-1
0018	3F	18_1	135	43	6	4300	1430	-2870	0.14	0.33	7	2	-5
0018	3F	18_1	136	11	1	1100	2100	1000	0.09	1.91	1	3	2
0018	3F	18_1	145	16	4	1600	1790	190	0.25	1.12	2	3	1
0018	3F	18_1	146	16	3	1600	910	-690	0.19	0.57	2	1	-1
0018	3F	18_1	234	1	1	100	540	440	1.00	5.40	0	0	0
0018	3F	18_1	235	1	0	100	0	-100	0.00	0.00	0	0	0
0018	3F	18_1	236	4	2	400	1240	840	0.50	3.10	0	2	2
0018	3F	18_1	245	3	1	300	330	30	0.33	1.10	0	0	0
0018	3F	18_2	123	74	11	7400	5810	-1590	0.15	0.79	13	10	-3
0018	3F	18_2	124	67	18	6700	5780	-920	0.27	0.86	11	10	-1
0018	3F	18_2	125	74	18	7400	8110	710	0.24	1.10	13	14	1
0018	3F	18_2	126	17	5	1700	1580	-120	0.29	0.93	3	2	-1
0018	3F	18_2	134	42	6	4200	1520	-2680	0.14	0.36	7	2	-5
0018	3F	18_2	135	29	6	2900	1690	-1210	0.21	0.58	5	2	-3
0018	3F	18_2	136	15	2	1500	750	-750	0.13	0.50	2	1	-1
0018	3F	18_2	145	14	1	1400	850	-550	0.07	0.61	2	1	-1
0018	3F	18_2	146	14	1	1400	290	-1110	0.07	0.21	2	0	-2
0018	3F	18_2	156	1	0	100	0	-100	0.00	0.00	0	0	0
0018	3F	18_2	236	3	0	300	0	-300	0.00	0.00	0	0	0
0018	3F	18_2	245	2	0	200	0	-200	0.00	0.00	0	0	0
0018	3F	18_2	246	2	1	200	320	120	0.50	1.60	0	0	0
0018	3F	18_2	256	1	0	100	0	-100	0.00	0.00	0	0	0
0018	3F	18_3	123	70	20	7000	7300	300	0.29	1.04	12	12	0
0018	3F	18_3	124	89	20	8900	5990	-2910	0.22	0.67	15	10	-5
0018	3F	18_3	125	60	13	6000	5330	-670	0.22	0.89	10	9	-1
0018	3F	18_3	126	27	6	2700	3040	340	0.22	1.13	4	5	1
0018	3F	18_3	134	40	12	4000	3140	-860	0.30	0.79	7	5	-2
0018	3F	18_3	135	20	3	2000	740	-1260	0.15	0.37	3	1	-2
0018	3F	18_3	136	4	0	400	0	-400	0.00	0.00	0	0	0
0018	3F	18_3	145	17	3	1700	900	-800	0.18	0.53	3	1	-2
0018	3F	18_3	146	7	2	700	540	-160	0.29	0.77	1	0	-1
0018	3F	18_3	156	2	0	200	0	-200	0.00	0.00	0	0	0
0018	3F	18_3	234	2	0	200	0	-200	0.00	0.00	0	0	0
0018	3F	18_3	235	1	0	100	0	-100	0.00	0.00	0	0	0
0018	3F	18_3	236	2	0	200	0	-200	0.00	0.00	0	0	0
0018	3F	18_3	245	1	0	100	0	-100	0.00	0.00	0	0	0
0018	3F	18_3	246	4	1	400	360	-40	0.25	0.90	0	0	0
0018	3F	18_3	256	1	0	100	0	-100	0.00	0.00	0	0	0
0018	3F	18_4	123	90	27	9000	9910	910	0.30	1.10	15	17	2
0018	3F	18_4	124	113	25	11300	8470	-2830	0.22	0.75	20	14	-6
0018	3F	18_4	125	47	14	4700	6830	2130	0.30	1.45	8	12	4
0018	3F	18_4	126	14	2	1400	730	-670	0.14	0.52	2	1	-1
0018	3F	18_4	134	28	7	2800	3680	880	0.25	1.31	4	6	2
0018	3F	18_4	135	25	6	2500	2390	-110	0.24	0.96	4	4	0
0018	3F	18_4	136	6	0	600	0	-600	0.00	0.00	1	0	-1
0018	3F	18_4	145	11	0	1100	0	-1100	0.00	0.00	1	0	-1
0018	3F	18_4	146	4	1	400	680	280	0.25	1.70	0	1	1
0018	3F	18_4	156	2	1	200	2540	2340	0.50	12.70	0	4	4
0018	3F	18_4	234	4	0	400	0	-400	0.00	0.00	0	0	0
0018	3F	18_4	235	2	0	200	0	-200	0.00	0.00	0	0	0
0018	3F	18_4	236	1	0	100	0	-100	0.00	0.00	0	0	0
0018	3F	18_4	246	1	0	100	0	-100	0.00	0.00	0	0	0
0018	3F	18_5	123	124	35	12400	11490	-910	0.28	0.93	21	20	-1
0018	3F	18_5	124	101	20	10100	7460	-2640	0.20	0.74	17	13	-4
0018	3F	18_5	125	87	11	8700	5650	-3050	0.13	0.65	15	10	-5
0018	3F	18_5	126	11	2	1100	1130	30	0.18	1.03	1	2	1
0018	3F	18_5	134	20	3	2000	760	-1240	0.15	0.38	3	1	-2
0018	3F	18_5	135	38	10	3800	3450	-350	0.26	0.91	6	6	0
0018	3F	18_5	136	4	1	400	600	200	0.25	1.50	0	1	1
0018	3F	18_5	145	15	6	1500	1700	200	0.40	1.13	2	3	1
0018	3F	18_5	146	6	2	600	1050	450	0.33	1.75	1	1	0
0018	3F	18_5	156	1	0	100	0	-100	0.00	0.00	0	0	0
0018	3F	18_5	246	1	0	100	0	-100	0.00	0.00	0	0	0
0018	3F	18_6	123	9	1	900	420	-480	0.11	0.47	1	0	-1
0018	3F	18_6	124	16	5	1600	1470	-130	0.31	0.92	2	2	0
0018	3F	18_6	125	6	3	600	1080	480	0.50	1.80	1	1	0
0018	3F	18_6	134	5	0	500	0	-500	0.00	0.00	0	0	0
0018	3F	18_6	135	1	1	100	570	470	1.00	5.70	0	1	1
0018	3F	18_6	145	1	0	100	0	-100	0.00	0.00	0	0	0
0018	3F	18_6	146	1	0	100	0	-100	0.00	0.00	0	0	0
0018	3F	18_7	123	85	16	8500	4580	-3920	0.19	0.54	15	8	-7
0018	3F	18_7	124	151	28	15100	13510	-1590	0.19	0.89	26	23	-3
0018	3F	18_7	125	76	15	7600	7380	-220	0.20	0.97	13	13	0
0018	3F	18_7	126	19	3	1900	1740	-160	0.16	0.92	3	3	0
0018	3F	18_7	134	38	7	3800	2840	-960	0.18	0.75	6	5	-1
0018	3F	18_7	135	25	2	2500	640	-1860	0.08	0.26	4	1	-3
0018	3F	18_7	136	5	0	500	0	-500	0.00	0.00	0	0	0
0018	3F	18_7	145	13	1	1300	470	-830	0.08	0.36	2	0	-2
0018	3F	18_7	146	7	1	700	290	-410	0.14	0.41	1	0	-1
0018	3F	18_7	234	1	0	100	0	-100	0.00	0.00	0	0	0
0018	3F	18_7	235	3	0	300	0	-300	0.00	0.00	0	0	0
0018	3F	18_7	236	1	0	100	0	-100	0.00	0.00	0	0	0
0018	3F	19_1	123	33	9	3300	3320	20	0.27	1.01	5	5	0
0018	3F	19_1	124	141	28	14100	7300	-6800	0.20	0.52	24	12	-12
0018	3F	19_1	125	22	4	2200	2850	650	0.18	1.30	3	5	2
0018	3F	19_1	126	22	5	2200	3840	1640	0.23	1.75	3	6	3
0018	3F	19_1	134	61	18	6100	5080	-1020	0.30	0.83	10	8	-2
0018	3F	19_1	135	21	3	2100	840	-1260	0.14	0.40	3	1	-2
0018	3F	19_1	136	25	6	2500	3460	960	0.24	1.38	4	6	2
0018	3F	19_1	145	7	4	700	1220	520	0.57	1.74	1	2	1
0018	3F	19_1	146	5	1	500	240	-260	0.20	0.48	0	0	0
0018	3F	19_1	236	1	0	100	0	-100	0.00	0.00	0	0	0
0018	3F	19_1	246	1	0	100	0	-100	0.00	0.00	0	0	0
0018	3F	19_2	123	38	9	3800	4750	950	0.24	1.25	6	8	2
0018	3F	19_2	124	95	23	9500	7050	-2450	0.24	0.74	16	12	-4
0018	3F	19_2	125	35	6	3500	2080	-1420	0.17	0.59	6	3	-3
0018	3F	19_2	126	33	7	3300	3320	20	0.21	1.01	5	5	0
0018	3F	19_2	134	40	9	4000	3190	-810	0.23	0.80	7	5	-2
0018	3F	19_2	135	21	4	2100	1510	-590	0.19	0.72	3	2	-1
0018	3F	19_2	136	33	8	3300	2780	-520	0.24	0.84	5	4	-1
0018	3F	19_2	145	14	3	1400	950	-450	0.21	0.68	2	1	-1
0018	3F	19_2	146	7	0	700	0	-700	0.00	0.00	1	0	-1
0018	3F	19_2	236	1	0	100	0	-100	0.00	0.00	0	0	0
0018	3F	19_2	246	1	1	100	670	570	1.00	6.70	0	1	1
0018	3F	19_3	123	38	10	3800	4200	400	0.26	1.11	6	7	1
0018	3F	19_3	124	91	22	9100	6280	-2820	0.24	0.69	16	11	-5
0018	3F	19_3	125	45	5	4500	2380	-2120	0.11	0.53	7	4	-3
0018	3F	19_3	126	41	4	4100	2400	-1700	0.10	0.59	7	4	-3
0018	3F	19_3	134	24	5	2400	1550	-850	0.21	0.65	4	2	-2
0018	3F	19_3	135	32	7	3200	2800	-400	0.22	0.88	5	4	-1
0018	3F	19_3	136	24	6	2400	1470	-930	0.25	0.61	4	2	-2
0018	3F	19_3	145	12	3	1200	1030	-170	0.25	0.86	2	1	-1
0018	3F	19_3	146	7	2	700	1290	590	0.29	1.84	1	2	1
0018	3F	19_3	156	3	0	300	0	-300	0.00	0.00	0	0	0
0018	3F	19_3	235	1	0	100	0	-100	0.00	0.00	0	0	0
0018	3F	19_3	236	1	0	100	0	-100	0.00	0.00	0	0	0
0018	3F	19_4	123	40	8	4000	1940	-2060	0.20	0.49	7	3	-4
0018	3F	19_4	124	104	26	10400	8940	-1460	0.25	0.86	18	15	-3
0018	3F	19_4	125	36	11	3600	6950	3350	0.31	1.93	6	12	6
0018	3F	19_4	126	13	2	1300	1630	330	0.15	1.25	2	2	0
0018	3F	19_4	134	39	12	3900	2710	-1190	0.31	0.69	6	4	-2
0018	3F	19_4	135	32	5	3200	1310	-1890	0.16	0.41	5	2	-3
0018	3F	19_4	136	12	0	1200	0	-1200	0.00	0.00	2	0	-2
0018	3F	19_4	145	7	1	700	270	-430	0.14	0.39	1	0	-1
0018	3F	19_4	146	1	0	100	0	-100	0.00	0.00	0	0	0
0018	3F	19_4	156	3	0	300	0	-300	0.00	0.00	0	0	0
0018	3F	19_4	234	1	0	100	0	-100	0.00	0.00	0	0	0
0018	3F	19_4	235	1	0	100	0	-100	0.00	0.00	0	0	0
0018	3F	19_4	245	1	0	100	0	-100	0.00	0.00	0	0	0
0018	3F	19_4	246	2	0	200	0	-200	0.00	0.00	0	0	0
0018	3F	19_5	123	26	5	2600	1760	-840	0.19	0.68	4	3	-1
0018	3F	19_5	124	70	17	7000	4980	-2020	0.24	0.71	12	8	-4
0018	3F	19_5	125	21	3	2100	1980	-120	0.14	0.94	3	3	0
0018	3F	19_5	126	16	2	1600	1520	-80	0.13	0.95	2	2	0
0018	3F	19_5	134	32	14	3200	3840	640	0.44	1.20	5	6	1
0018	3F	19_5	135	19	3	1900	750	-1150	0.16	0.39	3	1	-2
0018	3F	19_5	136	17	5	1700	1910	210	0.29	1.12	3	3	0
0018	3F	19_5	145	6	2	600	1100	500	0.33	1.83	1	1	0
0018	3F	19_5	146	5	1	500	580	80	0.20	1.16	0	1	1
0018	3F	19_5	234	2	0	200	0	-200	0.00	0.00	0	0	0
0018	3F	19_5	235	1	0	100	0	-100	0.00	0.00	0	0	0
0018	3F	19_6	123	5	1	500	240	-260	0.20	0.48	0	0	0
0018	3F	19_6	124	10	1	1000	290	-710	0.10	0.29	1	0	-1
0018	3F	19_6	125	1	0	100	0	-100	0.00	0.00	0	0	0
0018	3F	19_6	126	2	0	200	0	-200	0.00	0.00	0	0	0
0018	3F	19_6	134	1	1	100	350	250	1.00	3.50	0	0	0
0018	3F	19_6	135	3	1	300	250	-50	0.33	0.83	0	0	0
0018	3F	19_6	136	3	0	300	0	-300	0.00	0.00	0	0	0
0018	3F	19_6	145	1	1	100	210	110	1.00	2.10	0	0	0
0018	3F	19_6	236	1	0	100	0	-100	0.00	0.00	0	0	0
0018	3F	19_7	123	41	10	4100	2740	-1360	0.24	0.67	7	4	-3
0018	3F	19_7	124	125	31	12500	8880	-3620	0.25	0.71	22	15	-7
0018	3F	19_7	125	29	4	2900	1630	-1270	0.14	0.56	5	2	-3
0018	3F	19_7	126	27	1	2700	490	-2210	0.04	0.18	4	0	-4
0018	3F	19_7	134	37	10	3700	3740	40	0.27	1.01	6	6	0
0018	3F	19_7	135	17	4	1700	1100	-600	0.24	0.65	3	1	-2
0018	3F	19_7	136	28	2	2800	600	-2200	0.07	0.21	4	1	-3
0018	3F	19_7	145	9	0	900	0	-900	0.00	0.00	1	0	-1
0018	3F	19_7	146	7	0	700	0	-700	0.00	0.00	1	0	-1
0018	3F	19_7	235	2	0	200	0	-200	0.00	0.00	0	0	0
0018	3F	19_7	246	1	0	100	0	-100	0.00	0.00	0	0	0
0018	3F	20_1	123	72	23	7200	6250	-950	0.32	0.87	12	11	-1
0018	3F	20_1	124	124	32	12400	7650	-4750	0.26	0.62	21	13	-8
0018	3F	20_1	125	32	7	3200	3690	490	0.22	1.15	5	6	1
0018	3F	20_1	126	15	2	1500	770	-730	0.13	0.51	2	1	-1
0018	3F	20_1	134	41	12	4100	2950	-1150	0.29	0.72	7	5	-2
0018	3F	20_1	135	38	8	3800	3080	-720	0.21	0.81	6	5	-1
0018	3F	20_1	136	28	5	2800	2220	-580	0.18	0.79	4	3	-1
0018	3F	20_1	145	7	0	700	0	-700	0.00	0.00	1	0	-1
0018	3F	20_1	146	17	2	1700	930	-770	0.12	0.55	3	1	-2
0018	3F	20_1	156	1	0	100	0	-100	0.00	0.00	0	0	0
0018	3F	20_1	236	1	0	100	0	-100	0.00	0.00	0	0	0
0018	3F	20_2	123	58	17	5800	5260	-540	0.29	0.91	10	9	-1
0018	3F	20_2	124	97	23	9700	6280	-3420	0.24	0.65	17	11	-6
0018	3F	20_2	125	47	7	4700	2100	-2600	0.15	0.45	8	3	-5
0018	3F	20_2	126	34	7	3400	2860	-540	0.21	0.84	6	5	-1
0018	3F	20_2	134	26	3	2600	1360	-1240	0.12	0.52	4	2	-2
0018	3F	20_2	135	37	11	3700	3760	60	0.30	1.02	6	6	0
0018	3F	20_2	136	31	4	3100	1410	-1690	0.13	0.45	5	2	-3
0018	3F	20_2	145	12	2	1200	680	-520	0.17	0.57	2	1	-1
0018	3F	20_2	146	14	2	1400	2290	890	0.14	1.64	2	4	2
0018	3F	20_2	156	6	0	600	0	-600	0.00	0.00	1	0	-1
0018	3F	20_2	245	1	0	100	0	-100	0.00	0.00	0	0	0
0018	3F	20_3	123	51	19	5100	4510	-590	0.37	0.88	9	7	-2
0018	3F	20_3	124	97	27	9700	7190	-2510	0.28	0.74	17	12	-5
0018	3F	20_3	125	71	12	7100	5290	-1810	0.17	0.75	12	9	-3
0018	3F	20_3	126	40	2	4000	2080	-1920	0.05	0.52	7	3	-4
0018	3F	20_3	134	19	2	1900	620	-1280	0.11	0.33	3	1	-2
0018	3F	20_3	135	27	4	2700	1110	-1590	0.15	0.41	4	1	-3
0018	3F	20_3	136	29	3	2900	1000	-1900	0.10	0.34	5	1	-4
0018	3F	20_3	145	17	4	1700	1360	-340	0.24	0.80	3	2	-1
0018	3F	20_3	146	15	1	1500	350	-1150	0.07	0.23	2	0	-2
0018	3F	20_3	156	9	2	900	1390	490	0.22	1.54	1	2	1
0018	3F	20_3	235	1	0	100	0	-100	0.00	0.00	0	0	0
0018	3F	20_3	245	1	0	100	0	-100	0.00	0.00	0	0	0
0018	3F	20_4	123	48	13	4800	3860	-940	0.27	0.80	8	6	-2
0018	3F	20_4	124	98	24	9800	6590	-3210	0.24	0.67	17	11	-6
0018	3F	20_4	125	52	7	5200	2320	-2880	0.13	0.45	9	4	-5
0018	3F	20_4	126	17	2	1700	1030	-670	0.12	0.61	3	1	-2
0018	3F	20_4	134	28	3	2800	900	-1900	0.11	0.32	4	1	-3
0018	3F	20_4	135	23	9	2300	3990	1690	0.39	1.73	4	7	3
0018	3F	20_4	136	17	3	1700	840	-860	0.18	0.49	3	1	-2
0018	3F	20_4	145	19	3	1900	1410	-490	0.16	0.74	3	2	-1
0018	3F	20_4	146	8	0	800	0	-800	0.00	0.00	1	0	-1
0018	3F	20_4	156	9	3	900	1130	230	0.33	1.26	1	2	1
0018	3F	20_4	235	1	0	100	0	-100	0.00	0.00	0	0	0
0018	3F	20_4	236	1	1	100	850	750	1.00	8.50	0	1	1
0018	3F	20_4	245	2	1	200	210	10	0.50	1.05	0	0	0
0018	3F	20_5	123	50	8	5000	1830	-3170	0.16	0.37	8	3	-5
0018	3F	20_5	124	97	27	9700	7440	-2260	0.28	0.77	17	13	-4
0018	3F	20_5	125	61	8	6100	3100	-3000	0.13	0.51	10	5	-5
0018	3F	20_5	126	17	0	1700	0	-1700	0.00	0.00	3	0	-3
0018	3F	20_5	134	21	4	2100	1360	-740	0.19	0.65	3	2	-1
0018	3F	20_5	135	15	2	1500	820	-680	0.13	0.55	2	1	-1
0018	3F	20_5	136	10	1	1000	370	-630	0.10	0.37	1	0	-1
0018	3F	20_5	145	11	2	1100	1170	70	0.18	1.06	1	2	1
0018	3F	20_5	146	9	1	900	310	-590	0.11	0.34	1	0	-1
0018	3F	20_5	235	1	0	100	0	-100	0.00	0.00	0	0	0
0018	3F	20_6	123	8	2	800	570	-230	0.25	0.71	1	1	0
0018	3F	20_6	124	22	5	2200	1490	-710	0.23	0.68	3	2	-1
0018	3F	20_6	125	11	1	1100	360	-740	0.09	0.33	1	0	-1
0018	3F	20_6	126	4	2	400	800	400	0.50	2.00	0	1	1
0018	3F	20_6	134	5	1	500	400	-100	0.20	0.80	0	0	0
0018	3F	20_6	135	2	0	200	0	-200	0.00	0.00	0	0	0
0018	3F	20_6	136	3	0	300	0	-300	0.00	0.00	0	0	0
0018	3F	20_6	145	4	0	400	0	-400	0.00	0.00	0	0	0
0018	3F	20_7	123	57	13	5700	5050	-650	0.23	0.89	10	8	-2
0018	3F	20_7	124	140	28	14000	9170	-4830	0.20	0.66	24	16	-8
0018	3F	20_7	125	56	11	5600	4480	-1120	0.20	0.80	9	7	-2
0018	3F	20_7	126	31	5	3100	2000	-1100	0.16	0.65	5	3	-2
0018	3F	20_7	134	33	8	3300	2890	-410	0.24	0.88	5	5	0
0018	3F	20_7	135	25	5	2500	1550	-950	0.20	0.62	4	2	-2
0018	3F	20_7	136	15	4	1500	1910	410	0.27	1.27	2	3	1
0018	3F	20_7	145	12	2	1200	580	-620	0.17	0.48	2	1	-1
0018	3F	20_7	146	12	4	1200	3640	2440	0.33	3.03	2	6	4
0018	3F	20_7	156	5	1	500	850	350	0.20	1.70	0	1	1
0018	3F	21_1	123	70	15	7000	5920	-1080	0.21	0.85	12	10	-2
0018	3F	21_1	124	74	18	7400	5200	-2200	0.24	0.70	13	9	-4
0018	3F	21_1	125	69	11	6900	4480	-2420	0.16	0.65	12	7	-5
0018	3F	21_1	126	52	5	5200	1480	-3720	0.10	0.28	9	2	-7
0018	3F	21_1	134	38	12	3800	4130	330	0.32	1.09	6	7	1
0018	3F	21_1	135	69	18	6900	5870	-1030	0.26	0.85	12	10	-2
0018	3F	21_1	136	14	2	1400	1350	-50	0.14	0.96	2	2	0
0018	3F	21_1	145	26	3	2600	1010	-1590	0.12	0.39	4	1	-3
0018	3F	21_1	146	8	1	800	730	-70	0.13	0.91	1	1	0
0018	3F	21_1	235	1	0	100	0	-100	0.00	0.00	0	0	0
0018	3F	21_1	236	1	0	100	0	-100	0.00	0.00	0	0	0
0018	3F	21_1	246	1	0	100	0	-100	0.00	0.00	0	0	0
0018	3F	21_2	123	43	14	4300	6700	2400	0.33	1.56	7	11	4
0018	3F	21_2	124	83	25	8300	6790	-1510	0.30	0.82	14	12	-2
0018	3F	21_2	125	93	12	9300	4450	-4850	0.13	0.48	16	7	-9
0018	3F	21_2	126	46	7	4600	5340	740	0.15	1.16	8	9	1
0018	3F	21_2	134	25	7	2500	2190	-310	0.28	0.88	4	3	-1
0018	3F	21_2	135	60	15	6000	4750	-1250	0.25	0.79	10	8	-2
0018	3F	21_2	136	15	0	1500	0	-1500	0.00	0.00	2	0	-2
0018	3F	21_2	145	19	4	1900	1720	-180	0.21	0.91	3	3	0
0018	3F	21_2	146	6	2	600	1320	720	0.33	2.20	1	2	1
0018	3F	21_2	156	1	0	100	0	-100	0.00	0.00	0	0	0
0018	3F	21_3	123	75	25	7500	8270	770	0.33	1.10	13	14	1
0018	3F	21_3	124	93	22	9300	7090	-2210	0.24	0.76	16	12	-4
0018	3F	21_3	125	76	19	7600	7360	-240	0.25	0.97	13	13	0
0018	3F	21_3	126	34	8	3400	4090	690	0.24	1.20	6	7	1
0018	3F	21_3	134	29	6	2900	1710	-1190	0.21	0.59	5	3	-2
0018	3F	21_3	135	45	9	4500	2480	-2020	0.20	0.55	7	4	-3
0018	3F	21_3	136	9	0	900	0	-900	0.00	0.00	1	0	-1
0018	3F	21_3	145	15	2	1500	1060	-440	0.13	0.71	2	1	-1
0018	3F	21_3	146	9	1	900	360	-540	0.11	0.40	1	0	-1
0018	3F	21_3	156	4	0	400	0	-400	0.00	0.00	0	0	0
0018	3F	21_3	234	2	2	200	850	650	1.00	4.25	0	1	1
0018	3F	21_3	236	2	1	200	420	220	0.50	2.10	0	0	0
0018	3F	21_3	246	1	0	100	0	-100	0.00	0.00	0	0	0
0018	3F	21_4	123	53	13	5300	4330	-970	0.25	0.82	9	7	-2
0018	3F	21_4	124	65	11	6500	4290	-2210	0.17	0.66	11	7	-4
0018	3F	21_4	125	83	17	8300	7220	-1080	0.20	0.87	14	12	-2
0018	3F	21_4	126	29	2	2900	2540	-360	0.07	0.88	5	4	-1
0018	3F	21_4	134	36	7	3600	1690	-1910	0.19	0.47	6	2	-4
0018	3F	21_4	135	48	18	4800	5750	950	0.38	1.20	8	10	2
0018	3F	21_4	136	9	0	900	0	-900	0.00	0.00	1	0	-1
0018	3F	21_4	145	8	1	800	530	-270	0.13	0.66	1	0	-1
0018	3F	21_4	146	8	2	800	2940	2140	0.25	3.68	1	5	4
0018	3F	21_4	234	1	0	100	0	-100	0.00	0.00	0	0	0
0018	3F	21_4	235	1	0	100	0	-100	0.00	0.00	0	0	0
0018	3F	21_4	236	1	0	100	0	-100	0.00	0.00	0	0	0
0018	3F	21_4	245	1	0	100	0	-100	0.00	0.00	0	0	0
0018	3F	21_5	123	58	15	5800	3890	-1910	0.26	0.67	10	6	-4
0018	3F	21_5	124	119	24	11900	7970	-3930	0.20	0.67	21	14	-7
0018	3F	21_5	125	63	10	6300	4660	-1640	0.16	0.74	11	8	-3
0018	3F	21_5	126	15	3	1500	2160	660	0.20	1.44	2	3	1
0018	3F	21_5	134	18	1	1800	220	-1580	0.06	0.12	3	0	-3
0018	3F	21_5	135	35	9	3500	2460	-1040	0.26	0.70	6	4	-2
0018	3F	21_5	136	3	0	300	0	-300	0.00	0.00	0	0	0
0018	3F	21_5	145	8	2	800	1130	330	0.25	1.41	1	2	1
0018	3F	21_5	146	2	2	200	1110	910	1.00	5.55	0	1	1
0018	3F	21_6	123	8	2	800	870	70	0.25	1.09	1	1	0
0018	3F	21_6	124	9	1	900	200	-700	0.11	0.22	1	0	-1
0018	3F	21_6	125	2	0	200	0	-200	0.00	0.00	0	0	0
0018	3F	21_6	126	1	0	100	0	-100	0.00	0.00	0	0	0
0018	3F	21_6	134	1	0	100	0	-100	0.00	0.00	0	0	0
0018	3F	21_6	145	1	0	100	0	-100	0.00	0.00	0	0	0
0018	3F	21_6	146	1	1	100	280	180	1.00	2.80	0	0	0
0018	3F	21_7	123	86	13	8600	4690	-3910	0.15	0.55	15	8	-7
0018	3F	21_7	124	135	30	13500	10140	-3360	0.22	0.75	23	17	-6
0018	3F	21_7	125	70	14	7000	6260	-740	0.20	0.89	12	11	-1
0018	3F	21_7	126	28	1	2800	270	-2530	0.04	0.10	4	0	-4
0018	3F	21_7	134	35	8	3500	3100	-400	0.23	0.89	6	5	-1
0018	3F	21_7	135	25	2	2500	1300	-1200	0.08	0.52	4	2	-2
0018	3F	21_7	136	5	1	500	190	-310	0.20	0.38	0	0	0
0018	3F	21_7	145	12	3	1200	1050	-150	0.25	0.88	2	1	-1
0018	3F	21_7	146	4	0	400	0	-400	0.00	0.00	0	0	0
0018	3F	21_7	156	1	0	100	0	-100	0.00	0.00	0	0	0
0018	3F	21_7	234	2	1	200	1410	1210	0.50	7.05	0	2	2
0018	3F	21_7	256	1	0	100	0	-100	0.00	0.00	0	0	0
0018	3F	22_1	123	59	17	5900	5910	10	0.29	1.00	10	10	0
0018	3F	22_1	124	115	22	11500	6670	-4830	0.19	0.58	20	11	-9
0018	3F	22_1	125	29	3	2900	990	-1910	0.10	0.34	5	1	-4
0018	3F	22_1	126	34	2	3400	2000	-1400	0.06	0.59	6	3	-3
0018	3F	22_1	134	21	6	2100	1980	-120	0.29	0.94	3	3	0
0018	3F	22_1	135	24	3	2400	1060	-1340	0.13	0.44	4	1	-3
0018	3F	22_1	136	21	1	2100	320	-1780	0.05	0.15	3	0	-3
0018	3F	22_1	145	4	0	400	0	-400	0.00	0.00	0	0	0
0018	3F	22_1	146	3	0	300	0	-300	0.00	0.00	0	0	0
0018	3F	22_1	156	2	1	200	1150	950	0.50	5.75	0	2	2
0018	3F	22_1	235	1	1	100	300	200	1.00	3.00	0	0	0
0018	3F	22_1	236	1	0	100	0	-100	0.00	0.00	0	0	0
0018	3F	22_1	245	1	1	100	250	150	1.00	2.50	0	0	0
0018	3F	22_2	123	44	17	4400	4610	210	0.39	1.05	7	8	1
0018	3F	22_2	124	74	13	7400	4870	-2530	0.18	0.66	13	8	-5
0018	3F	22_2	125	24	5	2400	1520	-880	0.21	0.63	4	2	-2
0018	3F	22_2	126	41	4	4100	2900	-1200	0.10	0.71	7	5	-2
0018	3F	22_2	134	26	7	2600	2430	-170	0.27	0.93	4	4	0
0018	3F	22_2	135	18	2	1800	370	-1430	0.11	0.21	3	0	-3
0018	3F	22_2	136	27	3	2700	1190	-1510	0.11	0.44	4	2	-2
0018	3F	22_2	145	11	3	1100	960	-140	0.27	0.87	1	1	0
0018	3F	22_2	146	10	2	1000	1110	110	0.20	1.11	1	1	0
0018	3F	22_2	156	2	0	200	0	-200	0.00	0.00	0	0	0
0018	3F	22_2	234	1	0	100	0	-100	0.00	0.00	0	0	0
0018	3F	22_2	235	1	0	100	0	-100	0.00	0.00	0	0	0
0018	3F	22_2	245	1	0	100	0	-100	0.00	0.00	0	0	0
0018	3F	22_3	123	38	18	3800	5900	2100	0.47	1.55	6	10	4
0018	3F	22_3	124	73	15	7300	5900	-1400	0.21	0.81	12	10	-2
0018	3F	22_3	125	36	10	3600	2990	-610	0.28	0.83	6	5	-1
0018	3F	22_3	126	32	4	3200	3020	-180	0.13	0.94	5	5	0
0018	3F	22_3	134	31	6	3100	2280	-820	0.19	0.74	5	4	-1
0018	3F	22_3	135	24	3	2400	1190	-1210	0.13	0.50	4	2	-2
0018	3F	22_3	136	26	1	2600	360	-2240	0.04	0.14	4	0	-4
0018	3F	22_3	145	11	1	1100	400	-700	0.09	0.36	1	0	-1
0018	3F	22_3	146	3	1	300	510	210	0.33	1.70	0	0	0
0018	3F	22_3	156	2	0	200	0	-200	0.00	0.00	0	0	0
0018	3F	22_3	236	2	0	200	0	-200	0.00	0.00	0	0	0
0018	3F	22_3	245	2	1	200	380	180	0.50	1.90	0	0	0
0018	3F	22_4	123	37	13	3700	4050	350	0.35	1.09	6	7	1
0018	3F	22_4	124	62	14	6200	4430	-1770	0.23	0.71	10	7	-3
0018	3F	22_4	125	45	9	4500	4190	-310	0.20	0.93	7	7	0
0018	3F	22_4	126	30	3	3000	700	-2300	0.10	0.23	5	1	-4
0018	3F	22_4	134	33	7	3300	2070	-1230	0.21	0.63	5	3	-2
0018	3F	22_4	135	26	7	2600	2160	-440	0.27	0.83	4	3	-1
0018	3F	22_4	136	17	3	1700	1050	-650	0.18	0.62	3	1	-2
0018	3F	22_4	145	8	0	800	0	-800	0.00	0.00	1	0	-1
0018	3F	22_4	146	4	0	400	0	-400	0.00	0.00	0	0	0
0018	3F	22_4	156	2	1	200	420	220	0.50	2.10	0	0	0
0018	3F	22_4	234	3	2	300	440	140	0.67	1.47	0	0	0
0018	3F	22_4	236	1	1	100	230	130	1.00	2.30	0	0	0
0018	3F	22_4	245	1	1	100	230	130	1.00	2.30	0	0	0
0018	3F	22_4	246	1	0	100	0	-100	0.00	0.00	0	0	0
0018	3F	22_4	256	1	0	100	0	-100	0.00	0.00	0	0	0
0018	3F	22_5	123	54	18	5400	4890	-510	0.33	0.91	9	8	-1
0018	3F	22_5	124	100	28	10000	9920	-80	0.28	0.99	17	17	0
0018	3F	22_5	125	21	4	2100	1410	-690	0.19	0.67	3	2	-1
0018	3F	22_5	126	9	1	900	1310	410	0.11	1.46	1	2	1
0018	3F	22_5	134	26	2	2600	760	-1840	0.08	0.29	4	1	-3
0018	3F	22_5	135	25	4	2500	1730	-770	0.16	0.69	4	3	-1
0018	3F	22_5	136	4	0	400	0	-400	0.00	0.00	0	0	0
0018	3F	22_5	145	4	2	400	580	180	0.50	1.45	0	1	1
0018	3F	22_5	146	4	0	400	0	-400	0.00	0.00	0	0	0
0018	3F	22_5	234	1	1	100	390	290	1.00	3.90	0	0	0
0018	3F	22_5	245	1	0	100	0	-100	0.00	0.00	0	0	0
0018	3F	22_7	123	57	16	5700	3900	-1800	0.28	0.68	10	6	-4
0018	3F	22_7	124	117	31	11700	9960	-1740	0.26	0.85	20	17	-3
0018	3F	22_7	125	36	11	3600	5640	2040	0.31	1.57	6	9	3
0018	3F	22_7	126	34	5	3400	2260	-1140	0.15	0.66	6	4	-2
0018	3F	22_7	134	38	8	3800	2360	-1440	0.21	0.62	6	4	-2
0018	3F	22_7	135	18	4	1800	1910	110	0.22	1.06	3	3	0
0018	3F	22_7	136	13	0	1300	0	-1300	0.00	0.00	2	0	-2
0018	3F	22_7	145	9	0	900	0	-900	0.00	0.00	1	0	-1
0018	3F	22_7	146	4	1	400	1890	1490	0.25	4.73	0	3	3
0018	3F	22_7	156	1	0	100	0	-100	0.00	0.00	0	0	0
0018	3F	22_7	234	1	0	100	0	-100	0.00	0.00	0	0	0
0018	3F	22_7	235	1	0	100	0	-100	0.00	0.00	0	0	0
0018	3F	23_1	123	66	23	6600	6470	-130	0.35	0.98	11	11	0
0018	3F	23_1	124	104	20	10400	7210	-3190	0.19	0.69	18	12	-6
0018	3F	23_1	125	52	9	5200	4650	-550	0.17	0.89	9	8	-1
0018	3F	23_1	126	25	2	2500	1100	-1400	0.08	0.44	4	1	-3
0018	3F	23_1	134	23	2	2300	930	-1370	0.09	0.40	4	1	-3
0018	3F	23_1	135	25	3	2500	1260	-1240	0.12	0.50	4	2	-2
0018	3F	23_1	136	19	5	1900	5170	3270	0.26	2.72	3	9	6
0018	3F	23_1	145	10	2	1000	1560	560	0.20	1.56	1	2	1
0018	3F	23_1	146	9	3	900	3100	2200	0.33	3.44	1	5	4
0018	3F	23_1	246	1	0	100	0	-100	0.00	0.00	0	0	0
0018	3F	23_2	123	57	13	5700	2860	-2840	0.23	0.50	10	5	-5
0018	3F	23_2	124	109	28	10900	11790	890	0.26	1.08	19	20	1
0018	3F	23_2	125	52	17	5200	9560	4360	0.33	1.84	9	16	7
0018	3F	23_2	126	27	2	2700	1170	-1530	0.07	0.43	4	2	-2
0018	3F	23_2	134	43	8	4300	2910	-1390	0.19	0.68	7	5	-2
0018	3F	23_2	135	21	3	2100	950	-1150	0.14	0.45	3	1	-2
0018	3F	23_2	136	8	1	800	210	-590	0.13	0.26	1	0	-1
0018	3F	23_2	145	12	0	1200	0	-1200	0.00	0.00	2	0	-2
0018	3F	23_2	146	6	0	600	0	-600	0.00	0.00	1	0	-1
0018	3F	23_2	234	1	0	100	0	-100	0.00	0.00	0	0	0
0018	3F	23_2	236	2	0	200	0	-200	0.00	0.00	0	0	0
0018	3F	23_2	245	2	0	200	0	-200	0.00	0.00	0	0	0
0018	3F	23_2	246	1	0	100	0	-100	0.00	0.00	0	0	0
0018	3F	23_2	256	1	1	100	310	210	1.00	3.10	0	0	0
0018	3F	23_3	123	51	22	5100	6450	1350	0.43	1.26	9	11	2
0018	3F	23_3	124	97	23	9700	7980	-1720	0.24	0.82	17	14	-3
0018	3F	23_3	125	62	7	6200	2370	-3830	0.11	0.38	10	4	-6
0018	3F	23_3	126	16	3	1600	1720	120	0.19	1.08	2	3	1
0018	3F	23_3	134	45	11	4500	2920	-1580	0.24	0.65	7	5	-2
0018	3F	23_3	135	27	2	2700	930	-1770	0.07	0.34	4	1	-3
0018	3F	23_3	136	15	2	1500	2090	590	0.13	1.39	2	3	1
0018	3F	23_3	145	13	4	1300	1190	-110	0.31	0.92	2	2	0
0018	3F	23_3	146	4	0	400	0	-400	0.00	0.00	0	0	0
0018	3F	23_3	156	1	0	100	0	-100	0.00	0.00	0	0	0
0018	3F	23_3	234	2	0	200	0	-200	0.00	0.00	0	0	0
0018	3F	23_3	235	1	1	100	360	260	1.00	3.60	0	0	0
0018	3F	23_3	246	2	1	200	380	180	0.50	1.90	0	0	0
0018	3F	23_3	256	1	0	100	0	-100	0.00	0.00	0	0	0
0018	3F	23_4	123	75	31	7500	8430	930	0.41	1.12	13	14	1
0018	3F	23_4	124	101	18	10100	6130	-3970	0.18	0.61	17	10	-7
0018	3F	23_4	125	44	8	4400	4290	-110	0.18	0.98	7	7	0
0018	3F	23_4	126	17	1	1700	710	-990	0.06	0.42	3	1	-2
0018	3F	23_4	134	33	8	3300	2940	-360	0.24	0.89	5	5	0
0018	3F	23_4	135	21	7	2100	1900	-200	0.33	0.90	3	3	0
0018	3F	23_4	136	12	2	1200	620	-580	0.17	0.52	2	1	-1
0018	3F	23_4	145	11	3	1100	1070	-30	0.27	0.97	1	1	0
0018	3F	23_4	146	2	0	200	0	-200	0.00	0.00	0	0	0
0018	3F	23_4	156	1	0	100	0	-100	0.00	0.00	0	0	0
0018	3F	23_4	234	1	0	100	0	-100	0.00	0.00	0	0	0
0018	3F	23_4	235	2	0	200	0	-200	0.00	0.00	0	0	0
0018	3F	23_4	245	8	2	800	1140	340	0.25	1.43	1	2	1
0018	3F	23_5	123	43	8	4300	2170	-2130	0.19	0.50	7	3	-4
0018	3F	23_5	124	81	9	8100	3500	-4600	0.11	0.43	14	6	-8
0018	3F	23_5	125	32	5	3200	2130	-1070	0.16	0.67	5	3	-2
0018	3F	23_5	126	13	0	1300	0	-1300	0.00	0.00	2	0	-2
0018	3F	23_5	134	24	5	2400	1330	-1070	0.21	0.55	4	2	-2
0018	3F	23_5	135	18	2	1800	660	-1140	0.11	0.37	3	1	-2
0018	3F	23_5	136	5	1	500	430	-70	0.20	0.86	0	0	0
0018	3F	23_5	145	20	5	2000	1600	-400	0.25	0.80	3	2	-1
0018	3F	23_5	146	5	0	500	0	-500	0.00	0.00	0	0	0
0018	3F	23_5	156	2	0	200	0	-200	0.00	0.00	0	0	0
0018	3F	23_5	234	1	0	100	0	-100	0.00	0.00	0	0	0
0018	3F	23_5	235	1	0	100	0	-100	0.00	0.00	0	0	0
0018	3F	23_5	246	2	0	200	0	-200	0.00	0.00	0	0	0
0018	3F	23_6	123	2	2	200	470	270	1.00	2.35	0	0	0
0018	3F	23_6	124	6	1	600	700	100	0.17	1.17	1	1	0
0018	3F	23_6	125	6	0	600	0	-600	0.00	0.00	1	0	-1
0018	3F	23_6	126	1	0	100	0	-100	0.00	0.00	0	0	0
0018	3F	23_6	134	2	0	200	0	-200	0.00	0.00	0	0	0
0018	3F	23_6	135	3	0	300	0	-300	0.00	0.00	0	0	0
0018	3F	23_6	145	1	0	100	0	-100	0.00	0.00	0	0	0
0018	3F	23_7	123	59	14	5900	3620	-2280	0.24	0.61	10	6	-4
0018	3F	23_7	124	123	23	12300	7830	-4470	0.19	0.64	21	13	-8
0018	3F	23_7	125	50	5	5000	2200	-2800	0.10	0.44	8	3	-5
0018	3F	23_7	126	17	2	1700	1780	80	0.12	1.05	3	3	0
0018	3F	23_7	134	46	11	4600	4840	240	0.24	1.05	8	8	0
0018	3F	23_7	135	31	4	3100	2450	-650	0.13	0.79	5	4	-1
0018	3F	23_7	136	10	0	1000	0	-1000	0.00	0.00	1	0	-1
0018	3F	23_7	145	29	8	2900	3370	470	0.28	1.16	5	5	0
0018	3F	23_7	146	12	0	1200	0	-1200	0.00	0.00	2	0	-2
0018	3F	23_7	156	3	0	300	0	-300	0.00	0.00	0	0	0
0018	3F	24_1	123	79	18	7900	5760	-2140	0.23	0.73	13	10	-3
0018	3F	24_1	124	115	24	11500	10390	-1110	0.21	0.90	20	18	-2
0018	3F	24_1	125	47	6	4700	3080	-1620	0.13	0.66	8	5	-3
0018	3F	24_1	126	66	11	6600	4720	-1880	0.17	0.72	11	8	-3
0018	3F	24_1	134	34	10	3400	4110	710	0.29	1.21	6	7	1
0018	3F	24_1	135	15	0	1500	0	-1500	0.00	0.00	2	0	-2
0018	3F	24_1	136	38	4	3800	1330	-2470	0.11	0.35	6	2	-4
0018	3F	24_1	145	8	2	800	920	120	0.25	1.15	1	1	0
0018	3F	24_1	146	5	1	500	280	-220	0.20	0.56	0	0	0
0018	3F	24_1	156	3	1	300	280	-20	0.33	0.93	0	0	0
0018	3F	24_2	123	71	24	7100	8710	1610	0.34	1.23	12	15	3
0018	3F	24_2	124	101	13	10100	3850	-6250	0.13	0.38	17	6	-11
0018	3F	24_2	125	37	6	3700	2030	-1670	0.16	0.55	6	3	-3
0018	3F	24_2	126	45	8	4500	3360	-1140	0.18	0.75	7	5	-2
0018	3F	24_2	134	39	8	3900	3010	-890	0.21	0.77	6	5	-1
0018	3F	24_2	135	25	3	2500	880	-1620	0.12	0.35	4	1	-3
0018	3F	24_2	136	33	8	3300	2620	-680	0.24	0.79	5	4	-1
0018	3F	24_2	145	8	2	800	450	-350	0.25	0.56	1	0	-1
0018	3F	24_2	146	5	0	500	0	-500	0.00	0.00	0	0	0
0018	3F	24_2	156	2	1	200	990	790	0.50	4.95	0	1	1
0018	3F	24_2	245	1	0	100	0	-100	0.00	0.00	0	0	0
0018	3F	24_2	256	1	0	100	0	-100	0.00	0.00	0	0	0
0018	3F	24_3	123	87	26	8700	6410	-2290	0.30	0.74	15	11	-4
0018	3F	24_3	124	110	25	11000	8150	-2850	0.23	0.74	19	14	-5
0018	3F	24_3	125	62	6	6200	2760	-3440	0.10	0.45	10	4	-6
0018	3F	24_3	126	33	9	3300	3870	570	0.27	1.17	5	6	1
0018	3F	24_3	134	52	16	5200	4930	-270	0.31	0.95	9	8	-1
0018	3F	24_3	135	29	9	2900	3370	470	0.31	1.16	5	5	0
0018	3F	24_3	136	22	3	2200	1970	-230	0.14	0.90	3	3	0
0018	3F	24_3	145	12	3	1200	880	-320	0.25	0.73	2	1	-1
0018	3F	24_3	146	5	0	500	0	-500	0.00	0.00	0	0	0
0018	3F	24_3	156	1	0	100	0	-100	0.00	0.00	0	0	0
0018	3F	24_3	236	1	0	100	0	-100	0.00	0.00	0	0	0
0018	3F	24_3	246	1	0	100	0	-100	0.00	0.00	0	0	0
0018	3F	24_4	123	53	17	5300	3970	-1330	0.32	0.75	9	7	-2
0018	3F	24_4	124	86	16	8600	4270	-4330	0.19	0.50	15	7	-8
0018	3F	24_4	125	47	9	4700	5490	790	0.19	1.17	8	9	1
0018	3F	24_4	126	16	0	1600	0	-1600	0.00	0.00	2	0	-2
0018	3F	24_4	134	53	22	5300	6140	840	0.42	1.16	9	10	1
0018	3F	24_4	135	27	8	2700	3110	410	0.30	1.15	4	5	1
0018	3F	24_4	136	5	1	500	430	-70	0.20	0.86	0	0	0
0018	3F	24_4	145	9	2	900	570	-330	0.22	0.63	1	1	0
0018	3F	24_4	146	2	0	200	0	-200	0.00	0.00	0	0	0
0018	3F	24_4	245	1	0	100	0	-100	0.00	0.00	0	0	0
0018	3F	24_5	123	28	6	2800	1030	-1770	0.21	0.37	4	1	-3
0018	3F	24_5	124	58	14	5800	3980	-1820	0.24	0.69	10	7	-3
0018	3F	24_5	125	37	10	3700	5430	1730	0.27	1.47	6	9	3
0018	3F	24_5	126	11	5	1100	2160	1060	0.45	1.96	1	3	2
0018	3F	24_5	134	17	1	1700	620	-1080	0.06	0.36	3	1	-2
0018	3F	24_5	135	12	2	1200	600	-600	0.17	0.50	2	1	-1
0018	3F	24_5	136	2	1	200	250	50	0.50	1.25	0	0	0
0018	3F	24_5	145	5	1	500	410	-90	0.20	0.82	0	0	0
0018	3F	24_5	146	1	0	100	0	-100	0.00	0.00	0	0	0
0018	3F	24_5	234	1	0	100	0	-100	0.00	0.00	0	0	0
0018	3F	24_5	235	2	1	200	320	120	0.50	1.60	0	0	0
0018	3F	24_6	123	4	0	400	0	-400	0.00	0.00	0	0	0
0018	3F	24_6	124	16	3	1600	630	-970	0.19	0.39	2	1	-1
0018	3F	24_6	125	4	0	400	0	-400	0.00	0.00	0	0	0
0018	3F	24_6	126	3	1	300	400	100	0.33	1.33	0	0	0
0018	3F	24_6	134	3	2	300	460	160	0.67	1.53	0	0	0
0018	3F	24_6	135	7	1	700	150	-550	0.14	0.21	1	0	-1
0018	3F	24_6	136	1	0	100	0	-100	0.00	0.00	0	0	0
0018	3F	24_6	145	2	0	200	0	-200	0.00	0.00	0	0	0
0018	3F	24_7	123	86	30	8600	8670	70	0.35	1.01	15	15	0
0018	3F	24_7	124	133	37	13300	13300	0	0.28	1.00	23	23	0
0018	3F	24_7	125	71	14	7100	5840	-1260	0.20	0.82	12	10	-2
0018	3F	24_7	126	32	6	3200	2780	-420	0.19	0.87	5	4	-1
0018	3F	24_7	134	38	7	3800	2460	-1340	0.18	0.65	6	4	-2
0018	3F	24_7	135	30	4	3000	1990	-1010	0.13	0.66	5	3	-2
0018	3F	24_7	136	11	1	1100	150	-950	0.09	0.14	1	0	-1
0018	3F	24_7	145	10	1	1000	410	-590	0.10	0.41	1	0	-1
0018	3F	24_7	146	3	1	300	1280	980	0.33	4.27	0	2	2
0018	3F	24_7	234	1	0	100	0	-100	0.00	0.00	0	0	0
0018	3F	24_7	236	1	0	100	0	-100	0.00	0.00	0	0	0
0018	3T	01_1	123	76	7	7600	5630	-1970	0.09	0.74	13	9	-4
0018	3T	01_1	124	93	9	9300	6260	-3040	0.10	0.67	16	11	-5
0018	3T	01_1	125	57	9	5700	8460	2760	0.16	1.48	10	14	4
0018	3T	01_1	126	42	2	4200	1740	-2460	0.05	0.41	7	3	-4
0018	3T	01_1	134	20	2	2000	2690	690	0.10	1.35	3	4	1
0018	3T	01_1	135	31	1	3100	2210	-890	0.03	0.71	5	3	-2
0018	3T	01_1	136	31	1	3100	2080	-1020	0.03	0.67	5	3	-2
0018	3T	01_1	145	4	2	400	3320	2920	0.50	8.30	0	5	5
0018	3T	01_1	146	5	2	500	4200	3700	0.40	8.40	0	7	7
0018	3T	01_1	156	2	0	200	0	-200	0.00	0.00	0	0	0
0018	3T	01_1	214	1	0	100	0	-100	0.00	0.00	0	0	0
0018	3T	01_1	215	3	0	300	0	-300	0.00	0.00	0	0	0
0018	3T	01_1	216	3	0	300	0	-300	0.00	0.00	0	0	0
0018	3T	01_1	234	1	1	100	5280	5180	1.00	52.80	0	9	9
0018	3T	01_1	235	1	0	100	0	-100	0.00	0.00	0	0	0
0018	3T	01_1	245	2	0	200	0	-200	0.00	0.00	0	0	0
0018	3T	01_2	123	45	4	4500	2450	-2050	0.09	0.54	7	4	-3
0018	3T	01_2	124	84	4	8400	3550	-4850	0.05	0.42	14	6	-8
0018	3T	01_2	125	56	3	5600	3270	-2330	0.05	0.58	9	5	-4
0018	3T	01_2	126	45	0	4500	0	-4500	0.00	0.00	7	0	-7
0018	3T	01_2	134	26	1	2600	820	-1780	0.04	0.32	4	1	-3
0018	3T	01_2	135	26	1	2600	1550	-1050	0.04	0.60	4	2	-2
0018	3T	01_2	136	15	1	1500	550	-950	0.07	0.37	2	0	-2
0018	3T	01_2	145	7	0	700	0	-700	0.00	0.00	1	0	-1
0018	3T	01_2	146	11	0	1100	0	-1100	0.00	0.00	1	0	-1
0018	3T	01_2	154	1	0	100	0	-100	0.00	0.00	0	0	0
0018	3T	01_2	156	4	0	400	0	-400	0.00	0.00	0	0	0
0018	3T	01_2	215	1	0	100	0	-100	0.00	0.00	0	0	0
0018	3T	01_2	234	1	0	100	0	-100	0.00	0.00	0	0	0
0018	3T	01_2	236	3	0	300	0	-300	0.00	0.00	0	0	0
0018	3T	01_2	245	1	0	100	0	-100	0.00	0.00	0	0	0
0018	3T	01_3	123	47	8	4700	7980	3280	0.17	1.70	8	14	6
0018	3T	01_3	124	95	5	9500	6000	-3500	0.05	0.63	16	10	-6
0018	3T	01_3	125	56	6	5600	9270	3670	0.11	1.66	9	16	7
0018	3T	01_3	126	33	3	3300	2710	-590	0.09	0.82	5	4	-1
0018	3T	01_3	134	17	0	1700	0	-1700	0.00	0.00	3	0	-3
0018	3T	01_3	135	25	3	2500	3620	1120	0.12	1.45	4	6	2
0018	3T	01_3	136	22	1	2200	1460	-740	0.05	0.66	3	2	-1
0018	3T	01_3	142	1	0	100	0	-100	0.00	0.00	0	0	0
0018	3T	01_3	145	13	0	1300	0	-1300	0.00	0.00	2	0	-2
0018	3T	01_3	146	12	0	1200	0	-1200	0.00	0.00	2	0	-2
0018	3T	01_3	153	1	0	100	0	-100	0.00	0.00	0	0	0
0018	3T	01_3	156	3	0	300	0	-300	0.00	0.00	0	0	0
0018	3T	01_3	213	1	0	100	0	-100	0.00	0.00	0	0	0
0018	3T	01_3	215	2	0	200	0	-200	0.00	0.00	0	0	0
0018	3T	01_3	216	1	0	100	0	-100	0.00	0.00	0	0	0
0018	3T	01_3	234	1	0	100	0	-100	0.00	0.00	0	0	0
0018	3T	01_3	245	2	0	200	0	-200	0.00	0.00	0	0	0
0018	3T	01_4	123	65	12	6500	7630	1130	0.18	1.17	11	13	2
0018	3T	01_4	124	101	4	10100	2960	-7140	0.04	0.29	17	5	-12
0018	3T	01_4	125	56	8	5600	6570	970	0.14	1.17	9	11	2
0018	3T	01_4	126	36	4	3600	9870	6270	0.11	2.74	6	17	11
0018	3T	01_4	132	1	0	100	0	-100	0.00	0.00	0	0	0
0018	3T	01_4	134	21	3	2100	3240	1140	0.14	1.54	3	5	2
0018	3T	01_4	135	17	3	1700	3120	1420	0.18	1.84	3	5	2
0018	3T	01_4	136	15	1	1500	830	-670	0.07	0.55	2	1	-1
0018	3T	01_4	145	8	1	800	1590	790	0.13	1.99	1	2	1
0018	3T	01_4	146	3	0	300	0	-300	0.00	0.00	0	0	0
0018	3T	01_4	156	3	0	300	0	-300	0.00	0.00	0	0	0
0018	3T	01_4	235	3	0	300	0	-300	0.00	0.00	0	0	0
0018	3T	01_4	236	1	0	100	0	-100	0.00	0.00	0	0	0
0018	3T	01_4	245	2	0	200	0	-200	0.00	0.00	0	0	0
0018	3T	01_4	246	1	0	100	0	-100	0.00	0.00	0	0	0
0018	3T	01_4	256	2	0	200	0	-200	0.00	0.00	0	0	0
0018	3T	01_5	123	36	7	3600	5690	2090	0.19	1.58	6	10	4
0018	3T	01_5	124	68	11	6800	8660	1860	0.16	1.27	12	15	3
0018	3T	01_5	125	47	1	4700	720	-3980	0.02	0.15	8	1	-7
0018	3T	01_5	126	20	0	2000	0	-2000	0.00	0.00	3	0	-3
0018	3T	01_5	134	18	0	1800	0	-1800	0.00	0.00	3	0	-3
0018	3T	01_5	135	24	1	2400	910	-1490	0.04	0.38	4	1	-3
0018	3T	01_5	136	7	0	700	0	-700	0.00	0.00	1	0	-1
0018	3T	01_5	143	2	0	200	0	-200	0.00	0.00	0	0	0
0018	3T	01_5	145	8	0	800	0	-800	0.00	0.00	1	0	-1
0018	3T	01_5	146	2	0	200	0	-200	0.00	0.00	0	0	0
0018	3T	01_5	152	1	0	100	0	-100	0.00	0.00	0	0	0
0018	3T	01_5	153	1	0	100	0	-100	0.00	0.00	0	0	0
0018	3T	01_5	156	1	0	100	0	-100	0.00	0.00	0	0	0
0018	3T	01_5	164	1	0	100	0	-100	0.00	0.00	0	0	0
0018	3T	01_5	245	1	0	100	0	-100	0.00	0.00	0	0	0
0018	3T	01_5	246	1	0	100	0	-100	0.00	0.00	0	0	0
0018	3T	01_6	123	2	1	200	610	410	0.50	3.05	0	1	1
0018	3T	01_6	124	7	0	700	0	-700	0.00	0.00	1	0	-1
0018	3T	01_6	125	4	0	400	0	-400	0.00	0.00	0	0	0
0018	3T	01_6	126	1	0	100	0	-100	0.00	0.00	0	0	0
0018	3T	01_6	135	2	0	200	0	-200	0.00	0.00	0	0	0
0018	3T	01_6	145	1	0	100	0	-100	0.00	0.00	0	0	0
0018	3T	01_6	146	1	0	100	0	-100	0.00	0.00	0	0	0
0018	3T	01_6	216	1	0	100	0	-100	0.00	0.00	0	0	0
0018	3T	01_7	123	45	8	4500	5410	910	0.18	1.20	7	9	2
0018	3T	01_7	124	119	7	11900	5070	-6830	0.06	0.43	21	8	-13
0018	3T	01_7	125	62	6	6200	4600	-1600	0.10	0.74	10	8	-2
0018	3T	01_7	126	45	3	4500	2180	-2320	0.07	0.48	7	3	-4
0018	3T	01_7	132	2	0	200	0	-200	0.00	0.00	0	0	0
0018	3T	01_7	134	33	2	3300	3340	40	0.06	1.01	5	5	0
0018	3T	01_7	135	27	1	2700	2200	-500	0.04	0.81	4	3	-1
0018	3T	01_7	136	17	0	1700	0	-1700	0.00	0.00	3	0	-3
0018	3T	01_7	145	9	0	900	0	-900	0.00	0.00	1	0	-1
0018	3T	01_7	146	7	1	700	640	-60	0.14	0.91	1	1	0
0018	3T	01_7	152	1	0	100	0	-100	0.00	0.00	0	0	0
0018	3T	01_7	156	1	0	100	0	-100	0.00	0.00	0	0	0
0018	3T	01_7	164	1	0	100	0	-100	0.00	0.00	0	0	0
0018	3T	01_7	234	1	0	100	0	-100	0.00	0.00	0	0	0
0018	3T	01_7	236	2	0	200	0	-200	0.00	0.00	0	0	0
0018	3T	01_7	246	1	0	100	0	-100	0.00	0.00	0	0	0
0018	3T	01_7	256	1	0	100	0	-100	0.00	0.00	0	0	0
0018	3T	02_1	123	75	3	7500	3320	-4180	0.04	0.44	13	5	-8
0018	3T	02_1	124	92	2	9200	3970	-5230	0.02	0.43	16	7	-9
0018	3T	02_1	125	48	3	4800	6070	1270	0.06	1.26	8	10	2
0018	3T	02_1	126	40	2	4000	6870	2870	0.05	1.72	7	12	5
0018	3T	02_1	132	1	0	100	0	-100	0.00	0.00	0	0	0
0018	3T	02_1	134	30	2	3000	2980	-20	0.07	0.99	5	5	0
0018	3T	02_1	135	14	1	1400	1150	-250	0.07	0.82	2	2	0
0018	3T	02_1	136	27	2	2700	7260	4560	0.07	2.69	4	12	8
0018	3T	02_1	143	1	0	100	0	-100	0.00	0.00	0	0	0
0018	3T	02_1	145	12	1	1200	3450	2250	0.08	2.88	2	6	4
0018	3T	02_1	146	12	1	1200	5550	4350	0.08	4.63	2	9	7
0018	3T	02_1	153	2	0	200	0	-200	0.00	0.00	0	0	0
0018	3T	02_1	154	1	0	100	0	-100	0.00	0.00	0	0	0
0018	3T	02_1	214	1	0	100	0	-100	0.00	0.00	0	0	0
0018	3T	02_1	215	4	0	400	0	-400	0.00	0.00	0	0	0
0018	3T	02_1	216	13	0	1300	0	-1300	0.00	0.00	2	0	-2
0018	3T	02_1	234	1	0	100	0	-100	0.00	0.00	0	0	0
0018	3T	02_1	235	1	0	100	0	-100	0.00	0.00	0	0	0
0018	3T	02_1	236	1	0	100	0	-100	0.00	0.00	0	0	0
0018	3T	02_1	245	7	0	700	0	-700	0.00	0.00	1	0	-1
0018	3T	02_1	246	2	0	200	0	-200	0.00	0.00	0	0	0
0018	3T	02_1	256	1	0	100	0	-100	0.00	0.00	0	0	0
0018	3T	02_2	123	59	3	5900	2250	-3650	0.05	0.38	10	3	-7
0018	3T	02_2	124	80	5	8000	5690	-2310	0.06	0.71	14	10	-4
0018	3T	02_2	125	77	4	7700	4110	-3590	0.05	0.53	13	7	-6
0018	3T	02_2	126	45	4	4500	4850	350	0.09	1.08	7	8	1
0018	3T	02_2	132	4	1	400	660	260	0.25	1.65	0	1	1
0018	3T	02_2	134	21	3	2100	2660	560	0.14	1.27	3	4	1
0018	3T	02_2	135	14	2	1400	2710	1310	0.14	1.94	2	4	2
0018	3T	02_2	136	25	2	2500	2780	280	0.08	1.11	4	4	0
0018	3T	02_2	143	2	0	200	0	-200	0.00	0.00	0	0	0
0018	3T	02_2	145	8	0	800	0	-800	0.00	0.00	1	0	-1
0018	3T	02_2	146	14	1	1400	1710	310	0.07	1.22	2	3	1
0018	3T	02_2	153	2	1	200	1970	1770	0.50	9.85	0	3	3
0018	3T	02_2	156	4	0	400	0	-400	0.00	0.00	0	0	0
0018	3T	02_2	163	3	0	300	0	-300	0.00	0.00	0	0	0
0018	3T	02_2	164	1	0	100	0	-100	0.00	0.00	0	0	0
0018	3T	02_2	214	1	0	100	0	-100	0.00	0.00	0	0	0
0018	3T	02_2	215	1	0	100	0	-100	0.00	0.00	0	0	0
0018	3T	02_2	216	11	1	1100	4180	3080	0.09	3.80	1	7	6
0018	3T	02_2	234	1	0	100	0	-100	0.00	0.00	0	0	0
0018	3T	02_2	235	1	0	100	0	-100	0.00	0.00	0	0	0
0018	3T	02_2	236	3	0	300	0	-300	0.00	0.00	0	0	0
0018	3T	02_2	246	1	0	100	0	-100	0.00	0.00	0	0	0
0018	3T	02_2	256	1	1	100	1450	1350	1.00	14.50	0	2	2
0018	3T	02_3	123	74	6	7400	6410	-990	0.08	0.87	13	11	-2
0018	3T	02_3	124	78	4	7800	5870	-1930	0.05	0.75	13	10	-3
0018	3T	02_3	125	67	1	6700	2380	-4320	0.01	0.36	11	4	-7
0018	3T	02_3	126	55	3	5500	4070	-1430	0.05	0.74	9	7	-2
0018	3T	02_3	132	2	0	200	0	-200	0.00	0.00	0	0	0
0018	3T	02_3	134	21	0	2100	0	-2100	0.00	0.00	3	0	-3
0018	3T	02_3	135	19	0	1900	0	-1900	0.00	0.00	3	0	-3
0018	3T	02_3	136	12	1	1200	1410	210	0.08	1.18	2	2	0
0018	3T	02_3	145	14	0	1400	0	-1400	0.00	0.00	2	0	-2
0018	3T	02_3	146	9	0	900	0	-900	0.00	0.00	1	0	-1
0018	3T	02_3	156	1	0	100	0	-100	0.00	0.00	0	0	0
0018	3T	02_3	214	1	0	100	0	-100	0.00	0.00	0	0	0
0018	3T	02_3	215	4	0	400	0	-400	0.00	0.00	0	0	0
0018	3T	02_3	216	12	0	1200	0	-1200	0.00	0.00	2	0	-2
0018	3T	02_3	234	1	1	100	740	640	1.00	7.40	0	1	1
0018	3T	02_3	235	3	0	300	0	-300	0.00	0.00	0	0	0
0018	3T	02_3	236	2	0	200	0	-200	0.00	0.00	0	0	0
0018	3T	02_3	245	4	0	400	0	-400	0.00	0.00	0	0	0
0018	3T	02_3	246	1	0	100	0	-100	0.00	0.00	0	0	0
0018	3T	02_4	123	64	3	6400	2500	-3900	0.05	0.39	11	4	-7
0018	3T	02_4	124	64	7	6400	7200	800	0.11	1.13	11	12	1
0018	3T	02_4	125	38	3	3800	4370	570	0.08	1.15	6	7	1
0018	3T	02_4	126	11	0	1100	0	-1100	0.00	0.00	1	0	-1
0018	3T	02_4	132	1	1	100	720	620	1.00	7.20	0	1	1
0018	3T	02_4	134	14	0	1400	0	-1400	0.00	0.00	2	0	-2
0018	3T	02_4	135	11	1	1100	740	-360	0.09	0.67	1	1	0
0018	3T	02_4	136	5	0	500	0	-500	0.00	0.00	0	0	0
0018	3T	02_4	142	1	0	100	0	-100	0.00	0.00	0	0	0
0018	3T	02_4	143	2	0	200	0	-200	0.00	0.00	0	0	0
0018	3T	02_4	145	16	0	1600	0	-1600	0.00	0.00	2	0	-2
0018	3T	02_4	146	3	0	300	0	-300	0.00	0.00	0	0	0
0018	3T	02_4	153	1	0	100	0	-100	0.00	0.00	0	0	0
0018	3T	02_4	164	1	0	100	0	-100	0.00	0.00	0	0	0
0018	3T	02_4	214	1	0	100	0	-100	0.00	0.00	0	0	0
0018	3T	02_4	215	3	0	300	0	-300	0.00	0.00	0	0	0
0018	3T	02_4	216	1	0	100	0	-100	0.00	0.00	0	0	0
0018	3T	02_4	234	1	0	100	0	-100	0.00	0.00	0	0	0
0018	3T	02_4	235	3	0	300	0	-300	0.00	0.00	0	0	0
0018	3T	02_4	236	2	0	200	0	-200	0.00	0.00	0	0	0
0018	3T	02_4	245	2	1	200	1570	1370	0.50	7.85	0	2	2
0018	3T	02_4	246	2	0	200	0	-200	0.00	0.00	0	0	0
0018	3T	02_5	123	27	3	2700	4600	1900	0.11	1.70	4	8	4
0018	3T	02_5	124	47	1	4700	590	-4110	0.02	0.13	8	1	-7
0018	3T	02_5	125	34	2	3400	2110	-1290	0.06	0.62	6	3	-3
0018	3T	02_5	126	15	0	1500	0	-1500	0.00	0.00	2	0	-2
0018	3T	02_5	134	6	1	600	380	-220	0.17	0.63	1	0	-1
0018	3T	02_5	135	7	1	700	1090	390	0.14	1.56	1	1	0
0018	3T	02_5	136	4	0	400	0	-400	0.00	0.00	0	0	0
0018	3T	02_5	145	6	0	600	0	-600	0.00	0.00	1	0	-1
0018	3T	02_5	146	3	0	300	0	-300	0.00	0.00	0	0	0
0018	3T	02_5	216	1	0	100	0	-100	0.00	0.00	0	0	0
0018	3T	02_6	123	4	0	400	0	-400	0.00	0.00	0	0	0
0018	3T	02_6	124	2	0	200	0	-200	0.00	0.00	0	0	0
0018	3T	02_6	126	2	0	200	0	-200	0.00	0.00	0	0	0
0018	3T	02_6	134	1	0	100	0	-100	0.00	0.00	0	0	0
0018	3T	02_6	136	2	0	200	0	-200	0.00	0.00	0	0	0
0018	3T	02_7	123	64	4	6400	2830	-3570	0.06	0.44	11	5	-6
0018	3T	02_7	124	97	4	9700	3410	-6290	0.04	0.35	17	6	-11
0018	3T	02_7	125	69	5	6900	5170	-1730	0.07	0.75	12	9	-3
0018	3T	02_7	126	55	1	5500	1580	-3920	0.02	0.29	9	2	-7
0018	3T	02_7	132	1	0	100	0	-100	0.00	0.00	0	0	0
0018	3T	02_7	134	36	4	3600	4990	1390	0.11	1.39	6	8	2
0018	3T	02_7	135	27	1	2700	1470	-1230	0.04	0.54	4	2	-2
0018	3T	02_7	136	14	1	1400	830	-570	0.07	0.59	2	1	-1
0018	3T	02_7	143	4	0	400	0	-400	0.00	0.00	0	0	0
0018	3T	02_7	145	10	1	1000	1720	720	0.10	1.72	1	3	2
0018	3T	02_7	146	11	0	1100	0	-1100	0.00	0.00	1	0	-1
0018	3T	02_7	152	1	0	100	0	-100	0.00	0.00	0	0	0
0018	3T	02_7	216	5	0	500	0	-500	0.00	0.00	0	0	0
0018	3T	02_7	234	2	0	200	0	-200	0.00	0.00	0	0	0
0018	3T	02_7	235	1	0	100	0	-100	0.00	0.00	0	0	0
0018	3T	02_7	236	1	0	100	0	-100	0.00	0.00	0	0	0
0018	3T	02_7	245	1	0	100	0	-100	0.00	0.00	0	0	0
0018	3T	02_7	246	3	0	300	0	-300	0.00	0.00	0	0	0
0018	3T	02_7	256	1	0	100	0	-100	0.00	0.00	0	0	0
0018	3T	03_1	123	33	4	3300	4240	940	0.12	1.28	5	7	2
0018	3T	03_1	124	71	7	7100	9150	2050	0.10	1.29	12	16	4
0018	3T	03_1	125	34	0	3400	0	-3400	0.00	0.00	6	0	-6
0018	3T	03_1	126	31	2	3100	5990	2890	0.06	1.93	5	10	5
0018	3T	03_1	134	23	2	2300	2350	50	0.09	1.02	4	4	0
0018	3T	03_1	135	39	6	3900	7590	3690	0.15	1.95	6	13	7
0018	3T	03_1	136	16	1	1600	1010	-590	0.06	0.63	2	1	-1
0018	3T	03_1	143	1	0	100	0	-100	0.00	0.00	0	0	0
0018	3T	03_1	145	6	0	600	0	-600	0.00	0.00	1	0	-1
0018	3T	03_1	146	11	1	1100	980	-120	0.09	0.89	1	1	0
0018	3T	03_1	156	3	0	300	0	-300	0.00	0.00	0	0	0
0018	3T	03_1	234	2	0	200	0	-200	0.00	0.00	0	0	0
0018	3T	03_1	235	2	0	200	0	-200	0.00	0.00	0	0	0
0018	3T	03_1	245	2	0	200	0	-200	0.00	0.00	0	0	0
0018	3T	03_2	123	41	1	4100	1070	-3030	0.02	0.26	7	1	-6
0018	3T	03_2	124	39	1	3900	1560	-2340	0.03	0.40	6	2	-4
0018	3T	03_2	125	46	1	4600	1120	-3480	0.02	0.24	8	1	-7
0018	3T	03_2	126	26	3	2600	2900	300	0.12	1.12	4	5	1
0018	3T	03_2	132	1	0	100	0	-100	0.00	0.00	0	0	0
0018	3T	03_2	134	13	0	1300	0	-1300	0.00	0.00	2	0	-2
0018	3T	03_2	135	16	1	1600	1580	-20	0.06	0.99	2	2	0
0018	3T	03_2	136	21	0	2100	0	-2100	0.00	0.00	3	0	-3
0018	3T	03_2	145	6	0	600	0	-600	0.00	0.00	1	0	-1
0018	3T	03_2	146	7	0	700	0	-700	0.00	0.00	1	0	-1
0018	3T	03_2	156	8	0	800	0	-800	0.00	0.00	1	0	-1
0018	3T	03_2	164	1	0	100	0	-100	0.00	0.00	0	0	0
0018	3T	03_2	235	1	0	100	0	-100	0.00	0.00	0	0	0
0018	3T	03_2	236	2	0	200	0	-200	0.00	0.00	0	0	0
0018	3T	03_2	246	2	0	200	0	-200	0.00	0.00	0	0	0
0018	3T	03_2	256	1	0	100	0	-100	0.00	0.00	0	0	0
0018	3T	03_3	123	46	11	4600	7700	3100	0.24	1.67	8	13	5
0018	3T	03_3	124	62	3	6200	3580	-2620	0.05	0.58	10	6	-4
0018	3T	03_3	125	35	2	3500	1500	-2000	0.06	0.43	6	2	-4
0018	3T	03_3	126	44	1	4400	900	-3500	0.02	0.20	7	1	-6
0018	3T	03_3	134	30	3	3000	3710	710	0.10	1.24	5	6	1
0018	3T	03_3	135	21	2	2100	1280	-820	0.10	0.61	3	2	-1
0018	3T	03_3	136	26	1	2600	2420	-180	0.04	0.93	4	4	0
0018	3T	03_3	142	1	0	100	0	-100	0.00	0.00	0	0	0
0018	3T	03_3	143	1	0	100	0	-100	0.00	0.00	0	0	0
0018	3T	03_3	145	9	0	900	0	-900	0.00	0.00	1	0	-1
0018	3T	03_3	146	16	0	1600	0	-1600	0.00	0.00	2	0	-2
0018	3T	03_3	156	2	0	200	0	-200	0.00	0.00	0	0	0
0012	3T	2_5	136	30	2	3000	4680	1680	0.07	1.56	5	8	3
0012	3T	2_5	142	23	2	2300	1380	-920	0.09	0.60	4	2	-2
0012	3T	2_5	143	22	1	2200	2350	150	0.05	1.07	3	4	1
0012	3T	2_5	145	23	0	2300	0	-2300	0.00	0.00	4	0	-4
0012	3T	2_5	146	10	0	1000	0	-1000	0.00	0.00	1	0	-1
0012	3T	2_5	152	6	0	600	0	-600	0.00	0.00	1	0	-1
0012	3T	2_5	153	12	0	1200	0	-1200	0.00	0.00	2	0	-2
0012	3T	2_5	154	4	0	400	0	-400	0.00	0.00	0	0	0
0012	3T	2_5	156	4	0	400	0	-400	0.00	0.00	0	0	0
0012	3T	2_5	162	4	0	400	0	-400	0.00	0.00	0	0	0
0012	3T	2_5	163	4	0	400	0	-400	0.00	0.00	0	0	0
0012	3T	2_5	164	5	0	500	0	-500	0.00	0.00	0	0	0
0012	3T	2_5	165	1	0	100	0	-100	0.00	0.00	0	0	0
0012	3T	2_5	213	6	0	600	0	-600	0.00	0.00	1	0	-1
0012	3T	2_5	214	8	1	800	1120	320	0.13	1.40	1	1	0
0012	3T	2_5	215	1	1	100	1920	1820	1.00	19.20	0	3	3
0012	3T	2_5	216	4	0	400	0	-400	0.00	0.00	0	0	0
0012	3T	2_5	231	1	0	100	0	-100	0.00	0.00	0	0	0
0012	3T	2_5	235	3	0	300	0	-300	0.00	0.00	0	0	0
0012	3T	2_5	236	4	0	400	0	-400	0.00	0.00	0	0	0
0012	3T	2_5	243	1	0	100	0	-100	0.00	0.00	0	0	0
0012	3T	2_5	245	1	0	100	0	-100	0.00	0.00	0	0	0
0012	3T	2_5	246	2	0	200	0	-200	0.00	0.00	0	0	0
0012	3T	2_5	251	1	0	100	0	-100	0.00	0.00	0	0	0
0012	3T	2_5	256	1	0	100	0	-100	0.00	0.00	0	0	0
0012	3T	2_else	123	288	31	28800	25500	-3300	0.11	0.89	50	45	-5
0012	3T	2_else	124	211	21	21100	23800	2700	0.10	1.13	37	42	5
0012	3T	2_else	125	120	4	12000	18490	6490	0.03	1.54	21	32	11
0012	3T	2_else	126	113	6	11300	10050	-1250	0.05	0.89	20	17	-3
0012	3T	2_else	132	161	18	16100	26120	10020	0.11	1.62	28	46	18
0012	3T	2_else	134	133	11	13300	15300	2000	0.08	1.15	23	27	4
0012	3T	2_else	135	100	2	10000	2970	-7030	0.02	0.30	17	5	-12
0012	3T	2_else	136	54	4	5400	4240	-1160	0.07	0.79	9	7	-2
0012	3T	2_else	142	95	7	9500	9580	80	0.07	1.01	16	16	0
0012	3T	2_else	143	84	5	8400	7210	-1190	0.06	0.86	14	12	-2
0012	3T	2_else	145	39	1	3900	4050	150	0.03	1.04	6	7	1
0012	3T	2_else	146	25	2	2500	1930	-570	0.08	0.77	4	3	-1
0012	3T	2_else	152	22	0	2200	0	-2200	0.00	0.00	3	0	-3
0012	3T	2_else	153	21	0	2100	0	-2100	0.00	0.00	3	0	-3
0012	3T	2_else	154	18	1	1800	5180	3380	0.06	2.88	3	9	6
0012	3T	2_else	156	9	0	900	0	-900	0.00	0.00	1	0	-1
0012	3T	2_else	162	4	0	400	0	-400	0.00	0.00	0	0	0
0012	3T	2_else	163	5	0	500	0	-500	0.00	0.00	0	0	0
0012	3T	2_else	164	3	0	300	0	-300	0.00	0.00	0	0	0
0012	3T	2_else	165	5	0	500	0	-500	0.00	0.00	0	0	0
0012	3T	2_else	213	3	0	300	0	-300	0.00	0.00	0	0	0
0012	3T	2_else	214	6	0	600	0	-600	0.00	0.00	1	0	-1
0012	3T	2_else	215	5	0	500	0	-500	0.00	0.00	0	0	0
0012	3T	2_else	216	1	0	100	0	-100	0.00	0.00	0	0	0
0012	3T	2_else	231	3	0	300	0	-300	0.00	0.00	0	0	0
0012	3T	2_else	235	1	0	100	0	-100	0.00	0.00	0	0	0
0012	3T	2_else	243	4	0	400	0	-400	0.00	0.00	0	0	0
0012	3T	2_else	245	1	0	100	0	-100	0.00	0.00	0	0	0
0012	3T	2_else	254	2	0	200	0	-200	0.00	0.00	0	0	0
0012	3T	2_else	264	1	0	100	0	-100	0.00	0.00	0	0	0
0012	3T	3_1	123	432	35	43200	38090	-5110	0.08	0.88	76	67	-9
0012	3T	3_1	124	383	29	38300	28270	-10030	0.08	0.74	67	50	-17
0012	3T	3_1	125	309	23	30900	32170	1270	0.07	1.04	54	56	2
0012	3T	3_1	126	283	11	28300	23050	-5250	0.04	0.81	50	40	-10
0012	3T	3_1	132	293	17	29300	19880	-9420	0.06	0.68	51	35	-16
0012	3T	3_1	134	275	14	27500	27810	310	0.05	1.01	48	49	1
0012	3T	3_1	135	240	18	24000	23170	-830	0.08	0.97	42	41	-1
0012	3T	3_1	136	197	10	19700	14240	-5460	0.05	0.72	34	25	-9
0012	3T	3_1	142	186	6	18600	6430	-12170	0.03	0.35	32	11	-21
0012	3T	3_1	143	164	8	16400	12800	-3600	0.05	0.78	29	22	-7
0012	3T	3_1	145	137	7	13700	9290	-4410	0.05	0.68	24	16	-8
0012	3T	3_1	146	107	3	10700	2810	-7890	0.03	0.26	18	4	-14
0012	3T	3_1	152	92	1	9200	6880	-2320	0.01	0.75	16	12	-4
0012	3T	3_1	153	83	2	8300	4170	-4130	0.02	0.50	14	7	-7
0012	3T	3_1	154	50	1	5000	1230	-3770	0.02	0.25	8	2	-6
0012	3T	3_1	156	86	5	8600	23740	15140	0.06	2.76	15	42	27
0012	3T	3_1	162	62	1	6200	2750	-3450	0.02	0.44	10	4	-6
0012	3T	3_1	163	68	3	6800	6580	-220	0.04	0.97	12	11	-1
0012	3T	3_1	164	37	0	3700	0	-3700	0.00	0.00	6	0	-6
0012	3T	3_1	165	35	0	3500	0	-3500	0.00	0.00	6	0	-6
0012	3T	3_1	213	94	8	9400	9670	270	0.09	1.03	16	17	1
0012	3T	3_1	214	84	9	8400	19090	10690	0.11	2.27	14	33	19
0012	3T	3_1	215	64	3	6400	6540	140	0.05	1.02	11	11	0
0012	3T	3_1	216	83	5	8300	6430	-1870	0.06	0.77	14	11	-3
0012	3T	3_1	231	38	0	3800	0	-3800	0.00	0.00	6	0	-6
0012	3T	3_1	234	41	2	4100	1970	-2130	0.05	0.48	7	3	-4
0012	3T	3_1	235	45	0	4500	0	-4500	0.00	0.00	7	0	-7
0012	3T	3_1	236	55	2	5500	2850	-2650	0.04	0.52	9	5	-4
0012	3T	3_1	241	18	1	1800	1410	-390	0.06	0.78	3	2	-1
0012	3T	3_1	243	16	0	1600	0	-1600	0.00	0.00	2	0	-2
0012	3T	3_1	245	17	0	1700	0	-1700	0.00	0.00	3	0	-3
0012	3T	3_1	246	18	0	1800	0	-1800	0.00	0.00	3	0	-3
0012	3T	3_1	251	22	1	2200	5270	3070	0.05	2.40	3	9	6
0012	3T	3_1	253	22	1	2200	4130	1930	0.05	1.88	3	7	4
0012	3T	3_1	254	16	0	1600	0	-1600	0.00	0.00	2	0	-2
0012	3T	3_1	256	22	0	2200	0	-2200	0.00	0.00	3	0	-3
0012	3T	3_1	261	15	0	1500	0	-1500	0.00	0.00	2	0	-2
0012	3T	3_1	263	25	0	2500	0	-2500	0.00	0.00	4	0	-4
0012	3T	3_1	264	17	0	1700	0	-1700	0.00	0.00	3	0	-3
0012	3T	3_1	265	16	2	1600	7340	5740	0.13	4.59	2	12	10
0012	3T	3_2	123	89	9	8900	17030	8130	0.10	1.91	15	30	15
0012	3T	3_2	124	100	5	10000	5780	-4220	0.05	0.58	17	10	-7
0012	3T	3_2	125	62	2	6200	1360	-4840	0.03	0.22	10	2	-8
0012	3T	3_2	126	63	2	6300	8980	2680	0.03	1.43	11	15	4
0012	3T	3_2	132	51	4	5100	4420	-680	0.08	0.87	9	7	-2
0012	3T	3_2	134	64	9	6400	13590	7190	0.14	2.12	11	24	13
0012	3T	3_2	135	58	6	5800	9900	4100	0.10	1.71	10	17	7
0012	3T	3_2	136	41	1	4100	3560	-540	0.02	0.87	7	6	-1
0012	3T	3_2	142	28	0	2800	0	-2800	0.00	0.00	4	0	-4
0012	3T	3_2	143	38	1	3800	650	-3150	0.03	0.17	6	1	-5
0012	3T	3_2	145	29	1	2900	1040	-1860	0.03	0.36	5	1	-4
0012	3T	3_2	146	20	2	2000	2690	690	0.10	1.35	3	4	1
0012	3T	3_2	152	11	2	1100	4600	3500	0.18	4.18	1	8	7
0012	3T	3_2	153	17	0	1700	0	-1700	0.00	0.00	3	0	-3
0012	3T	3_2	154	14	0	1400	0	-1400	0.00	0.00	2	0	-2
0012	3T	3_2	156	10	0	1000	0	-1000	0.00	0.00	1	0	-1
0012	3T	3_2	162	10	0	1000	0	-1000	0.00	0.00	1	0	-1
0012	3T	3_2	163	10	1	1000	1020	20	0.10	1.02	1	1	0
0012	3T	3_2	164	5	0	500	0	-500	0.00	0.00	0	0	0
0012	3T	3_2	165	5	0	500	0	-500	0.00	0.00	0	0	0
0012	3T	3_2	213	4	0	400	0	-400	0.00	0.00	0	0	0
0012	3T	3_2	214	8	2	800	4000	3200	0.25	5.00	1	7	6
0012	3T	3_2	215	4	0	400	0	-400	0.00	0.00	0	0	0
0012	3T	3_2	216	2	0	200	0	-200	0.00	0.00	0	0	0
0012	3T	3_2	234	4	0	400	0	-400	0.00	0.00	0	0	0
0012	3T	3_2	235	3	0	300	0	-300	0.00	0.00	0	0	0
0012	3T	3_2	241	2	0	200	0	-200	0.00	0.00	0	0	0
0012	3T	3_2	243	2	0	200	0	-200	0.00	0.00	0	0	0
0012	3T	3_2	261	1	0	100	0	-100	0.00	0.00	0	0	0
0012	3T	3_2	264	1	0	100	0	-100	0.00	0.00	0	0	0
0012	3T	3_3	123	60	4	6000	3960	-2040	0.07	0.66	10	7	-3
0012	3T	3_3	124	55	3	5500	7850	2350	0.05	1.43	9	13	4
0012	3T	3_3	125	43	2	4300	2300	-2000	0.05	0.53	7	4	-3
0012	3T	3_3	126	33	1	3300	1450	-1850	0.03	0.44	5	2	-3
0012	3T	3_3	132	37	2	3700	2600	-1100	0.05	0.70	6	4	-2
0012	3T	3_3	134	41	6	4100	6770	2670	0.15	1.65	7	11	4
0012	3T	3_3	135	35	2	3500	1140	-2360	0.06	0.33	6	2	-4
0012	3T	3_3	136	13	1	1300	1290	-10	0.08	0.99	2	2	0
0012	3T	3_3	142	30	0	3000	0	-3000	0.00	0.00	5	0	-5
0012	3T	3_3	143	23	0	2300	0	-2300	0.00	0.00	4	0	-4
0012	3T	3_3	145	17	0	1700	0	-1700	0.00	0.00	3	0	-3
0012	3T	3_3	146	15	0	1500	0	-1500	0.00	0.00	2	0	-2
0012	3T	3_3	152	15	1	1500	830	-670	0.07	0.55	2	1	-1
0012	3T	3_3	153	9	0	900	0	-900	0.00	0.00	1	0	-1
0012	3T	3_3	154	15	0	1500	0	-1500	0.00	0.00	2	0	-2
0012	3T	3_3	156	8	0	800	0	-800	0.00	0.00	1	0	-1
0012	3T	3_3	162	3	0	300	0	-300	0.00	0.00	0	0	0
0012	3T	3_3	163	7	0	700	0	-700	0.00	0.00	1	0	-1
0012	3T	3_3	164	3	0	300	0	-300	0.00	0.00	0	0	0
0012	3T	3_3	165	2	0	200	0	-200	0.00	0.00	0	0	0
0012	3T	3_3	213	10	1	1000	4910	3910	0.10	4.91	1	8	7
0012	3T	3_3	214	3	0	300	0	-300	0.00	0.00	0	0	0
0012	3T	3_3	215	2	1	200	2140	1940	0.50	10.70	0	3	3
0012	3T	3_3	216	4	0	400	0	-400	0.00	0.00	0	0	0
0012	3T	3_3	231	3	0	300	0	-300	0.00	0.00	0	0	0
0012	3T	3_3	234	8	0	800	0	-800	0.00	0.00	1	0	-1
0012	3T	3_3	235	2	0	200	0	-200	0.00	0.00	0	0	0
0012	3T	3_3	236	4	0	400	0	-400	0.00	0.00	0	0	0
0012	3T	3_3	241	1	0	100	0	-100	0.00	0.00	0	0	0
0012	3T	3_3	243	3	0	300	0	-300	0.00	0.00	0	0	0
0012	3T	3_3	245	1	0	100	0	-100	0.00	0.00	0	0	0
0012	3T	3_3	246	4	0	400	0	-400	0.00	0.00	0	0	0
0012	3T	3_3	251	2	0	200	0	-200	0.00	0.00	0	0	0
0012	3T	3_3	253	5	0	500	0	-500	0.00	0.00	0	0	0
0012	3T	3_3	256	1	0	100	0	-100	0.00	0.00	0	0	0
0012	3T	3_3	261	1	0	100	0	-100	0.00	0.00	0	0	0
0012	3T	3_3	264	3	0	300	0	-300	0.00	0.00	0	0	0
0012	3T	3_4	123	60	7	6000	4640	-1360	0.12	0.77	10	8	-2
0012	3T	3_4	124	79	11	7900	13360	5460	0.14	1.69	13	23	10
0012	3T	3_4	125	49	2	4900	1230	-3670	0.04	0.25	8	2	-6
0012	3T	3_4	126	44	0	4400	0	-4400	0.00	0.00	7	0	-7
0012	3T	3_4	132	41	5	4100	5410	1310	0.12	1.32	7	9	2
0012	3T	3_4	134	34	2	3400	1310	-2090	0.06	0.39	6	2	-4
0012	3T	3_4	135	30	2	3000	1610	-1390	0.07	0.54	5	2	-3
0012	3T	3_4	136	27	1	2700	1360	-1340	0.04	0.50	4	2	-2
0012	3T	3_4	142	29	2	2900	3980	1080	0.07	1.37	5	7	2
0012	3T	3_4	143	20	1	2000	3500	1500	0.05	1.75	3	6	3
0012	3T	3_4	145	21	1	2100	1030	-1070	0.05	0.49	3	1	-2
0012	3T	3_4	146	17	0	1700	0	-1700	0.00	0.00	3	0	-3
0012	3T	3_4	152	6	0	600	0	-600	0.00	0.00	1	0	-1
0012	3T	3_4	153	9	1	900	660	-240	0.11	0.73	1	1	0
0012	3T	3_4	154	7	1	700	3540	2840	0.14	5.06	1	6	5
0012	3T	3_4	156	9	0	900	0	-900	0.00	0.00	1	0	-1
0012	3T	3_4	162	3	0	300	0	-300	0.00	0.00	0	0	0
0012	3T	3_4	163	3	0	300	0	-300	0.00	0.00	0	0	0
0012	3T	3_4	164	3	0	300	0	-300	0.00	0.00	0	0	0
0012	3T	3_4	165	2	0	200	0	-200	0.00	0.00	0	0	0
0012	3T	3_4	213	2	0	200	0	-200	0.00	0.00	0	0	0
0012	3T	3_4	214	1	0	100	0	-100	0.00	0.00	0	0	0
0012	3T	3_4	216	1	0	100	0	-100	0.00	0.00	0	0	0
0012	3T	3_4	236	1	0	100	0	-100	0.00	0.00	0	0	0
0012	3T	3_4	245	1	0	100	0	-100	0.00	0.00	0	0	0
0012	3T	3_5	123	60	7	6000	8600	2600	0.12	1.43	10	15	5
0012	3T	3_5	124	40	1	4000	1070	-2930	0.03	0.27	7	1	-6
0012	3T	3_5	125	46	7	4600	9120	4520	0.15	1.98	8	16	8
0012	3T	3_5	126	36	1	3600	510	-3090	0.03	0.14	6	0	-6
0012	3T	3_5	132	35	2	3500	1870	-1630	0.06	0.53	6	3	-3
0012	3T	3_5	134	29	1	2900	720	-2180	0.03	0.25	5	1	-4
0012	3T	3_5	135	25	0	2500	0	-2500	0.00	0.00	4	0	-4
0012	3T	3_5	136	32	1	3200	110	-3090	0.03	0.03	5	0	-5
0012	3T	3_5	142	21	1	2100	740	-1360	0.05	0.35	3	1	-2
0012	3T	3_5	143	26	2	2600	2600	0	0.08	1.00	4	4	0
0012	3T	3_5	145	17	0	1700	0	-1700	0.00	0.00	3	0	-3
0012	3T	3_5	146	19	1	1900	1920	20	0.05	1.01	3	3	0
0012	3T	3_5	152	8	0	800	0	-800	0.00	0.00	1	0	-1
0012	3T	3_5	153	9	0	900	0	-900	0.00	0.00	1	0	-1
0012	3T	3_5	154	2	0	200	0	-200	0.00	0.00	0	0	0
0012	3T	3_5	156	6	0	600	0	-600	0.00	0.00	1	0	-1
0012	3T	3_5	162	4	0	400	0	-400	0.00	0.00	0	0	0
0012	3T	3_5	163	3	0	300	0	-300	0.00	0.00	0	0	0
0012	3T	3_5	164	4	1	400	3240	2840	0.25	8.10	0	5	5
0012	3T	3_5	165	4	0	400	0	-400	0.00	0.00	0	0	0
0012	3T	3_5	213	4	1	400	1510	1110	0.25	3.78	0	2	2
0012	3T	3_5	214	6	1	600	730	130	0.17	1.22	1	1	0
0012	3T	3_5	215	4	0	400	0	-400	0.00	0.00	0	0	0
0012	3T	3_5	216	3	0	300	0	-300	0.00	0.00	0	0	0
0012	3T	3_5	234	1	0	100	0	-100	0.00	0.00	0	0	0
0012	3T	3_5	235	1	1	100	2480	2380	1.00	24.80	0	4	4
0012	3T	3_5	241	1	0	100	0	-100	0.00	0.00	0	0	0
0012	3T	3_5	243	1	0	100	0	-100	0.00	0.00	0	0	0
0012	3T	3_5	245	1	0	100	0	-100	0.00	0.00	0	0	0
0012	3T	3_5	246	1	0	100	0	-100	0.00	0.00	0	0	0
0012	3T	3_5	254	1	0	100	0	-100	0.00	0.00	0	0	0
0012	3T	3_6	123	44	5	4400	2740	-1660	0.11	0.62	7	4	-3
0012	3T	3_6	124	46	6	4600	4820	220	0.13	1.05	8	8	0
0012	3T	3_6	125	24	0	2400	0	-2400	0.00	0.00	4	0	-4
0012	3T	3_6	126	15	2	1500	2470	970	0.13	1.65	2	4	2
0012	3T	3_6	132	14	2	1400	1970	570	0.14	1.41	2	3	1
0012	3T	3_6	134	22	0	2200	0	-2200	0.00	0.00	3	0	-3
0012	3T	3_6	135	13	0	1300	0	-1300	0.00	0.00	2	0	-2
0012	3T	3_6	136	12	0	1200	0	-1200	0.00	0.00	2	0	-2
0012	3T	3_6	142	9	1	900	590	-310	0.11	0.66	1	1	0
0012	3T	3_6	143	7	0	700	0	-700	0.00	0.00	1	0	-1
0012	3T	3_6	145	10	0	1000	0	-1000	0.00	0.00	1	0	-1
0012	3T	3_6	146	6	0	600	0	-600	0.00	0.00	1	0	-1
0012	3T	3_6	152	4	0	400	0	-400	0.00	0.00	0	0	0
0012	3T	3_6	153	1	0	100	0	-100	0.00	0.00	0	0	0
0012	3T	3_6	154	5	0	500	0	-500	0.00	0.00	0	0	0
0012	3T	3_6	156	1	0	100	0	-100	0.00	0.00	0	0	0
0012	3T	3_6	163	1	0	100	0	-100	0.00	0.00	0	0	0
0012	3T	3_6	213	3	0	300	0	-300	0.00	0.00	0	0	0
0012	3T	3_6	214	1	0	100	0	-100	0.00	0.00	0	0	0
0012	3T	3_6	216	1	0	100	0	-100	0.00	0.00	0	0	0
0012	3T	3_6	231	1	0	100	0	-100	0.00	0.00	0	0	0
0012	3T	3_6	234	1	0	100	0	-100	0.00	0.00	0	0	0
0012	3T	3_6	261	1	0	100	0	-100	0.00	0.00	0	0	0
0012	3T	3_6	264	1	0	100	0	-100	0.00	0.00	0	0	0
0012	3T	3_else	123	245	24	24500	19710	-4790	0.10	0.80	43	34	-9
0012	3T	3_else	124	225	20	22500	15980	-6520	0.09	0.71	39	28	-11
0012	3T	3_else	125	140	10	14000	11460	-2540	0.07	0.82	24	20	-4
0012	3T	3_else	126	107	7	10700	9700	-1000	0.07	0.91	18	17	-1
0012	3T	3_else	132	126	13	12600	9890	-2710	0.10	0.78	22	17	-5
0012	3T	3_else	134	102	8	10200	9290	-910	0.08	0.91	18	16	-2
0012	3T	3_else	135	84	4	8400	5140	-3260	0.05	0.61	14	9	-5
0012	3T	3_else	136	50	2	5000	3530	-1470	0.04	0.71	8	6	-2
0012	3T	3_else	142	59	3	5900	3760	-2140	0.05	0.64	10	6	-4
0012	3T	3_else	143	70	2	7000	5630	-1370	0.03	0.80	12	9	-3
0012	3T	3_else	145	45	1	4500	580	-3920	0.02	0.13	7	1	-6
0012	3T	3_else	146	33	2	3300	2110	-1190	0.06	0.64	5	3	-2
0012	3T	3_else	152	15	1	1500	430	-1070	0.07	0.29	2	0	-2
0012	3T	3_else	153	24	2	2400	2660	260	0.08	1.11	4	4	0
0012	3T	3_else	154	24	0	2400	0	-2400	0.00	0.00	4	0	-4
0012	3T	3_else	156	14	2	1400	2680	1280	0.14	1.91	2	4	2
0012	3T	3_else	162	16	0	1600	0	-1600	0.00	0.00	2	0	-2
0012	3T	3_else	163	16	1	1600	1540	-60	0.06	0.96	2	2	0
0012	3T	3_else	164	3	0	300	0	-300	0.00	0.00	0	0	0
0012	3T	3_else	165	4	1	400	4060	3660	0.25	10.15	0	7	7
0012	3T	3_else	213	10	0	1000	0	-1000	0.00	0.00	1	0	-1
0012	3T	3_else	214	7	0	700	0	-700	0.00	0.00	1	0	-1
0012	3T	3_else	215	2	0	200	0	-200	0.00	0.00	0	0	0
0012	3T	3_else	216	4	0	400	0	-400	0.00	0.00	0	0	0
0012	3T	3_else	231	3	0	300	0	-300	0.00	0.00	0	0	0
0012	3T	3_else	235	2	0	200	0	-200	0.00	0.00	0	0	0
0012	3T	3_else	243	2	0	200	0	-200	0.00	0.00	0	0	0
0012	3T	3_else	246	3	0	300	0	-300	0.00	0.00	0	0	0
0012	3T	3_else	251	4	0	400	0	-400	0.00	0.00	0	0	0
0012	3T	3_else	253	1	0	100	0	-100	0.00	0.00	0	0	0
0012	3T	3_else	254	1	0	100	0	-100	0.00	0.00	0	0	0
0012	3T	3_else	256	2	0	200	0	-200	0.00	0.00	0	0	0
0012	3T	3_else	264	1	0	100	0	-100	0.00	0.00	0	0	0
0012	3T	4_1	123	296	33	29600	28880	-720	0.11	0.98	52	51	-1
0012	3T	4_1	124	252	19	25200	25540	340	0.08	1.01	44	45	1
0012	3T	4_1	125	187	8	18700	6730	-11970	0.04	0.36	33	11	-22
0012	3T	4_1	126	143	4	14300	12230	-2070	0.03	0.86	25	21	-4
0012	3T	4_1	132	191	12	19100	11510	-7590	0.06	0.60	33	20	-13
0012	3T	4_1	134	176	12	17600	14760	-2840	0.07	0.84	31	26	-5
0012	3T	4_1	135	143	8	14300	7010	-7290	0.06	0.49	25	12	-13
0012	3T	4_1	136	130	10	13000	14820	1820	0.08	1.14	23	26	3
0012	3T	4_1	142	134	10	13400	9740	-3660	0.07	0.73	23	17	-6
0012	3T	4_1	143	138	4	13800	3800	-10000	0.03	0.28	24	6	-18
0012	3T	4_1	145	88	6	8800	12550	3750	0.07	1.43	15	22	7
0012	3T	4_1	146	57	4	5700	5380	-320	0.07	0.94	10	9	-1
0012	3T	4_1	152	69	3	6900	10120	3220	0.04	1.47	12	17	5
0012	3T	4_1	153	59	1	5900	900	-5000	0.02	0.15	10	1	-9
0012	3T	4_1	154	38	1	3800	2040	-1760	0.03	0.54	6	3	-3
0012	3T	4_1	156	33	2	3300	11830	8530	0.06	3.58	5	20	15
0012	3T	4_1	162	42	2	4200	4020	-180	0.05	0.96	7	7	0
0012	3T	4_1	163	20	0	2000	0	-2000	0.00	0.00	3	0	-3
0012	3T	4_1	164	20	0	2000	0	-2000	0.00	0.00	3	0	-3
0012	3T	4_1	165	13	1	1300	4570	3270	0.08	3.52	2	8	6
0012	3T	4_1	213	62	1	6200	750	-5450	0.02	0.12	10	1	-9
0012	3T	4_1	214	54	2	5400	7330	1930	0.04	1.36	9	12	3
0012	3T	4_1	215	50	5	5000	4880	-120	0.10	0.98	8	8	0
0012	3T	4_1	216	38	0	3800	0	-3800	0.00	0.00	6	0	-6
0012	3T	4_1	231	30	0	3000	0	-3000	0.00	0.00	5	0	-5
0012	3T	4_1	234	48	1	4800	1420	-3380	0.02	0.30	8	2	-6
0012	3T	4_1	235	43	1	4300	2640	-1660	0.02	0.61	7	4	-3
0012	3T	4_1	236	28	2	2800	6190	3390	0.07	2.21	4	10	6
0012	3T	4_1	241	13	1	1300	1940	640	0.08	1.49	2	3	1
0012	3T	4_1	243	29	0	2900	0	-2900	0.00	0.00	5	0	-5
0012	3T	4_1	245	14	0	1400	0	-1400	0.00	0.00	2	0	-2
0012	3T	4_1	246	24	0	2400	0	-2400	0.00	0.00	4	0	-4
0012	3T	4_1	251	13	0	1300	0	-1300	0.00	0.00	2	0	-2
0012	3T	4_1	253	24	1	2400	1880	-520	0.04	0.78	4	3	-1
0012	3T	4_1	254	24	2	2400	11740	9340	0.08	4.89	4	20	16
0012	3T	4_1	256	11	0	1100	0	-1100	0.00	0.00	1	0	-1
0012	3T	4_1	261	8	0	800	0	-800	0.00	0.00	1	0	-1
0012	3T	4_1	263	13	0	1300	0	-1300	0.00	0.00	2	0	-2
0012	3T	4_1	264	8	0	800	0	-800	0.00	0.00	1	0	-1
0012	3T	4_1	265	9	0	900	0	-900	0.00	0.00	1	0	-1
0012	3T	4_2	123	50	6	5000	8330	3330	0.12	1.67	8	14	6
0012	3T	4_2	124	47	3	4700	2140	-2560	0.06	0.46	8	3	-5
0012	3T	4_2	125	40	4	4000	5340	1340	0.10	1.34	7	9	2
0012	3T	4_2	126	34	0	3400	0	-3400	0.00	0.00	6	0	-6
0012	3T	4_2	132	36	3	3600	5560	1960	0.08	1.54	6	9	3
0012	3T	4_2	134	34	5	3400	4720	1320	0.15	1.39	6	8	2
0012	3T	4_2	135	24	1	2400	990	-1410	0.04	0.41	4	1	-3
0012	3T	4_2	136	24	2	2400	2520	120	0.08	1.05	4	4	0
0012	3T	4_2	142	20	3	2000	2630	630	0.15	1.32	3	4	1
0012	3T	4_2	143	22	0	2200	0	-2200	0.00	0.00	3	0	-3
0012	3T	4_2	145	8	1	800	790	-10	0.13	0.99	1	1	0
0012	3T	4_2	146	14	1	1400	1840	440	0.07	1.31	2	3	1
0012	3T	4_2	152	8	1	800	1520	720	0.13	1.90	1	2	1
0012	3T	4_2	153	8	0	800	0	-800	0.00	0.00	1	0	-1
0012	3T	4_2	154	1	0	100	0	-100	0.00	0.00	0	0	0
0012	3T	4_2	156	5	0	500	0	-500	0.00	0.00	0	0	0
0012	3T	4_2	162	2	0	200	0	-200	0.00	0.00	0	0	0
0012	3T	4_2	163	2	0	200	0	-200	0.00	0.00	0	0	0
0012	3T	4_2	164	4	0	400	0	-400	0.00	0.00	0	0	0
0012	3T	4_2	165	1	0	100	0	-100	0.00	0.00	0	0	0
0012	3T	4_2	213	2	0	200	0	-200	0.00	0.00	0	0	0
0012	3T	4_2	214	1	0	100	0	-100	0.00	0.00	0	0	0
0012	3T	4_2	215	1	0	100	0	-100	0.00	0.00	0	0	0
0012	3T	4_2	216	2	0	200	0	-200	0.00	0.00	0	0	0
0012	3T	4_2	236	2	0	200	0	-200	0.00	0.00	0	0	0
0012	3T	4_2	243	1	0	100	0	-100	0.00	0.00	0	0	0
0012	3T	4_2	245	1	0	100	0	-100	0.00	0.00	0	0	0
0012	3T	4_2	253	1	0	100	0	-100	0.00	0.00	0	0	0
0012	3T	4_2	254	1	0	100	0	-100	0.00	0.00	0	0	0
0012	3T	4_2	261	1	0	100	0	-100	0.00	0.00	0	0	0
0012	3T	4_3	123	146	16	14600	13280	-1320	0.11	0.91	25	23	-2
0012	3T	4_3	124	109	8	10900	9110	-1790	0.07	0.84	19	16	-3
0012	3T	4_3	125	94	6	9400	7480	-1920	0.06	0.80	16	13	-3
0012	3T	4_3	126	51	0	5100	0	-5100	0.00	0.00	9	0	-9
0012	3T	4_3	132	88	6	8800	14130	5330	0.07	1.61	15	25	10
0012	3T	4_3	134	95	7	9500	12850	3350	0.07	1.35	16	22	6
0012	3T	4_3	135	69	3	6900	2880	-4020	0.04	0.42	12	5	-7
0012	3T	4_3	136	49	3	4900	2710	-2190	0.06	0.55	8	4	-4
0012	3T	4_3	142	67	5	6700	6550	-150	0.07	0.98	11	11	0
0012	3T	4_3	143	51	2	5100	4970	-130	0.04	0.97	9	8	-1
0012	3T	4_3	145	46	1	4600	630	-3970	0.02	0.14	8	1	-7
0012	3T	4_3	146	30	1	3000	2270	-730	0.03	0.76	5	4	-1
0012	3T	4_3	152	28	2	2800	8460	5660	0.07	3.02	4	14	10
0012	3T	4_3	153	22	0	2200	0	-2200	0.00	0.00	3	0	-3
0012	3T	4_3	154	10	0	1000	0	-1000	0.00	0.00	1	0	-1
0012	3T	4_3	156	9	0	900	0	-900	0.00	0.00	1	0	-1
0012	3T	4_3	162	15	0	1500	0	-1500	0.00	0.00	2	0	-2
0012	3T	4_3	163	12	0	1200	0	-1200	0.00	0.00	2	0	-2
0012	3T	4_3	164	7	0	700	0	-700	0.00	0.00	1	0	-1
0012	3T	4_3	165	5	0	500	0	-500	0.00	0.00	0	0	0
0012	3T	4_3	213	8	1	800	4820	4020	0.13	6.03	1	8	7
0012	3T	4_3	214	14	0	1400	0	-1400	0.00	0.00	2	0	-2
0012	3T	4_3	215	6	0	600	0	-600	0.00	0.00	1	0	-1
0012	3T	4_3	216	15	1	1500	880	-620	0.07	0.59	2	1	-1
0012	3T	4_3	231	8	0	800	0	-800	0.00	0.00	1	0	-1
0012	3T	4_3	234	19	1	1900	3990	2090	0.05	2.10	3	7	4
0012	3T	4_3	235	15	2	1500	3670	2170	0.13	2.45	2	6	4
0012	3T	4_3	236	11	1	1100	720	-380	0.09	0.65	1	1	0
0012	3T	4_3	243	5	0	500	0	-500	0.00	0.00	0	0	0
0012	3T	4_3	245	8	0	800	0	-800	0.00	0.00	1	0	-1
0012	3T	4_3	246	7	0	700	0	-700	0.00	0.00	1	0	-1
0012	3T	4_3	251	5	0	500	0	-500	0.00	0.00	0	0	0
0012	3T	4_3	253	8	0	800	0	-800	0.00	0.00	1	0	-1
0012	3T	4_3	254	7	0	700	0	-700	0.00	0.00	1	0	-1
0012	3T	4_3	256	3	0	300	0	-300	0.00	0.00	0	0	0
0012	3T	4_3	261	1	0	100	0	-100	0.00	0.00	0	0	0
0012	3T	4_3	263	6	1	600	680	80	0.17	1.13	1	1	0
0012	3T	4_3	264	2	0	200	0	-200	0.00	0.00	0	0	0
0012	3T	4_3	265	5	0	500	0	-500	0.00	0.00	0	0	0
0012	3T	4_4	123	53	4	5300	2490	-2810	0.08	0.47	9	4	-5
0012	3T	4_4	124	41	4	4100	2610	-1490	0.10	0.64	7	4	-3
0012	3T	4_4	125	29	2	2900	2790	-110	0.07	0.96	5	4	-1
0012	3T	4_4	126	20	0	2000	0	-2000	0.00	0.00	3	0	-3
0012	3T	4_4	132	24	1	2400	710	-1690	0.04	0.30	4	1	-3
0012	3T	4_4	134	39	6	3900	8010	4110	0.15	2.05	6	14	8
0012	3T	4_4	135	21	1	2100	580	-1520	0.05	0.28	3	1	-2
0012	3T	4_4	136	12	3	1200	2870	1670	0.25	2.39	2	5	3
0012	3T	4_4	142	26	3	2600	3090	490	0.12	1.19	4	5	1
0012	3T	4_4	143	13	1	1300	2640	1340	0.08	2.03	2	4	2
0012	3T	4_4	145	10	1	1000	620	-380	0.10	0.62	1	1	0
0012	3T	4_4	146	9	0	900	0	-900	0.00	0.00	1	0	-1
0012	3T	4_4	152	11	0	1100	0	-1100	0.00	0.00	1	0	-1
0012	3T	4_4	153	5	0	500	0	-500	0.00	0.00	0	0	0
0012	3T	4_4	154	1	0	100	0	-100	0.00	0.00	0	0	0
0012	3T	4_4	156	5	1	500	2760	2260	0.20	5.52	0	4	4
0012	3T	4_4	162	1	0	100	0	-100	0.00	0.00	0	0	0
0012	3T	4_4	163	2	0	200	0	-200	0.00	0.00	0	0	0
0012	3T	4_4	164	2	0	200	0	-200	0.00	0.00	0	0	0
0012	3T	4_4	165	1	0	100	0	-100	0.00	0.00	0	0	0
0012	3T	4_4	214	2	1	200	4150	3950	0.50	20.75	0	7	7
0012	3T	4_4	256	1	0	100	0	-100	0.00	0.00	0	0	0
0012	3T	4_5	123	48	2	4800	2980	-1820	0.04	0.62	8	5	-3
0012	3T	4_5	124	47	3	4700	5260	560	0.06	1.12	8	9	1
0012	3T	4_5	125	35	1	3500	630	-2870	0.03	0.18	6	1	-5
0012	3T	4_5	126	26	2	2600	5850	3250	0.08	2.25	4	10	6
0012	3T	4_5	132	18	1	1800	560	-1240	0.06	0.31	3	0	-3
0012	3T	4_5	134	40	1	4000	780	-3220	0.03	0.20	7	1	-6
0012	3T	4_5	135	16	4	1600	7800	6200	0.25	4.88	2	13	11
0012	3T	4_5	136	16	1	1600	1150	-450	0.06	0.72	2	2	0
0012	3T	4_5	142	16	1	1600	950	-650	0.06	0.59	2	1	-1
0012	3T	4_5	143	9	1	900	910	10	0.11	1.01	1	1	0
0012	3T	4_5	145	4	1	400	1720	1320	0.25	4.30	0	3	3
0012	3T	4_5	146	5	1	500	1190	690	0.20	2.38	0	2	2
0012	3T	4_5	152	5	1	500	3490	2990	0.20	6.98	0	6	6
0012	3T	4_5	153	3	0	300	0	-300	0.00	0.00	0	0	0
0012	3T	4_5	154	4	0	400	0	-400	0.00	0.00	0	0	0
0012	3T	4_5	156	2	0	200	0	-200	0.00	0.00	0	0	0
0012	3T	4_5	163	2	0	200	0	-200	0.00	0.00	0	0	0
0012	3T	4_5	164	1	0	100	0	-100	0.00	0.00	0	0	0
0012	3T	4_5	213	3	0	300	0	-300	0.00	0.00	0	0	0
0012	3T	4_5	234	2	0	200	0	-200	0.00	0.00	0	0	0
0012	3T	4_5	236	1	0	100	0	-100	0.00	0.00	0	0	0
0012	3T	4_5	245	1	0	100	0	-100	0.00	0.00	0	0	0
0012	3T	4_5	251	1	0	100	0	-100	0.00	0.00	0	0	0
0012	3T	4_5	263	1	0	100	0	-100	0.00	0.00	0	0	0
0012	3T	4_6	123	84	14	8400	6630	-1770	0.17	0.79	14	11	-3
0012	3T	4_6	124	83	4	8300	2230	-6070	0.05	0.27	14	3	-11
0012	3T	4_6	125	42	3	4200	2330	-1870	0.07	0.55	7	4	-3
0012	3T	4_6	126	32	0	3200	0	-3200	0.00	0.00	5	0	-5
0012	3T	4_6	132	33	2	3300	1270	-2030	0.06	0.38	5	2	-3
0012	3T	4_6	134	52	8	5200	8250	3050	0.15	1.59	9	14	5
0012	3T	4_6	135	31	1	3100	1410	-1690	0.03	0.45	5	2	-3
0012	3T	4_6	136	29	3	2900	7330	4430	0.10	2.53	5	12	7
0012	3T	4_6	142	15	1	1500	1660	160	0.07	1.11	2	2	0
0012	3T	4_6	143	12	0	1200	0	-1200	0.00	0.00	2	0	-2
0012	3T	4_6	145	19	0	1900	0	-1900	0.00	0.00	3	0	-3
0012	3T	4_6	146	8	1	800	4740	3940	0.13	5.93	1	8	7
0012	3T	4_6	152	2	0	200	0	-200	0.00	0.00	0	0	0
0012	3T	4_6	153	12	1	1200	1850	650	0.08	1.54	2	3	1
0012	3T	4_6	154	4	0	400	0	-400	0.00	0.00	0	0	0
0012	3T	4_6	156	2	0	200	0	-200	0.00	0.00	0	0	0
0012	3T	4_6	163	1	0	100	0	-100	0.00	0.00	0	0	0
0012	3T	4_6	164	2	0	200	0	-200	0.00	0.00	0	0	0
0012	3T	4_6	165	2	0	200	0	-200	0.00	0.00	0	0	0
0012	3T	4_6	213	2	0	200	0	-200	0.00	0.00	0	0	0
0012	3T	4_6	214	2	0	200	0	-200	0.00	0.00	0	0	0
0012	3T	4_6	215	2	0	200	0	-200	0.00	0.00	0	0	0
0012	3T	4_6	216	1	0	100	0	-100	0.00	0.00	0	0	0
0012	3T	4_6	234	1	0	100	0	-100	0.00	0.00	0	0	0
0012	3T	4_6	236	1	0	100	0	-100	0.00	0.00	0	0	0
0012	3T	4_6	241	1	0	100	0	-100	0.00	0.00	0	0	0
0012	3T	4_6	245	1	0	100	0	-100	0.00	0.00	0	0	0
0012	3T	4_6	254	1	0	100	0	-100	0.00	0.00	0	0	0
0012	3T	4_6	256	1	0	100	0	-100	0.00	0.00	0	0	0
0012	3T	4_else	123	301	32	30100	23750	-6350	0.11	0.79	53	42	-11
0012	3T	4_else	124	214	17	21400	14880	-6520	0.08	0.70	37	26	-11
0012	3T	4_else	125	116	5	11600	9620	-1980	0.04	0.83	20	17	-3
0012	3T	4_else	126	80	9	8000	15360	7360	0.11	1.92	14	27	13
0012	3T	4_else	132	156	10	15600	8300	-7300	0.06	0.53	27	14	-13
0012	3T	4_else	134	114	3	11400	3080	-8320	0.03	0.27	20	5	-15
0012	3T	4_else	135	82	3	8200	3520	-4680	0.04	0.43	14	6	-8
0012	3T	4_else	136	48	1	4800	4400	-400	0.02	0.92	8	7	-1
0012	3T	4_else	142	87	3	8700	9210	510	0.03	1.06	15	16	1
0012	3T	4_else	143	97	10	9700	15810	6110	0.10	1.63	17	27	10
0012	3T	4_else	145	68	0	6800	0	-6800	0.00	0.00	12	0	-12
0012	3T	4_else	146	38	1	3800	2400	-1400	0.03	0.63	6	4	-2
0012	3T	4_else	152	20	2	2000	6070	4070	0.10	3.04	3	10	7
0012	3T	4_else	153	20	0	2000	0	-2000	0.00	0.00	3	0	-3
0012	3T	4_else	154	21	0	2100	0	-2100	0.00	0.00	3	0	-3
0012	3T	4_else	156	6	0	600	0	-600	0.00	0.00	1	0	-1
0012	3T	4_else	162	9	1	900	2180	1280	0.11	2.42	1	3	2
0012	3T	4_else	163	5	0	500	0	-500	0.00	0.00	0	0	0
0012	3T	4_else	164	2	0	200	0	-200	0.00	0.00	0	0	0
0012	3T	4_else	165	2	0	200	0	-200	0.00	0.00	0	0	0
0012	3T	4_else	213	6	1	600	10690	10090	0.17	17.82	1	18	17
0012	3T	4_else	214	3	0	300	0	-300	0.00	0.00	0	0	0
0012	3T	4_else	215	2	0	200	0	-200	0.00	0.00	0	0	0
0012	3T	4_else	216	2	0	200	0	-200	0.00	0.00	0	0	0
0012	3T	4_else	234	3	0	300	0	-300	0.00	0.00	0	0	0
0012	3T	4_else	236	1	0	100	0	-100	0.00	0.00	0	0	0
0012	3T	4_else	243	2	0	200	0	-200	0.00	0.00	0	0	0
0012	3T	4_else	251	1	0	100	0	-100	0.00	0.00	0	0	0
0012	3T	4_else	254	1	0	100	0	-100	0.00	0.00	0	0	0
0012	3T	5_1	123	8	1	800	770	-30	0.13	0.96	1	1	0
0012	3T	5_1	124	12	1	1200	580	-620	0.08	0.48	2	1	-1
0012	3T	5_1	125	7	2	700	3750	3050	0.29	5.36	1	6	5
0012	3T	5_1	126	5	0	500	0	-500	0.00	0.00	0	0	0
0012	3T	5_1	132	10	2	1000	4360	3360	0.20	4.36	1	7	6
0012	3T	5_1	134	10	0	1000	0	-1000	0.00	0.00	1	0	-1
0012	3T	5_1	135	11	1	1100	1170	70	0.09	1.06	1	2	1
0012	3T	5_1	136	6	0	600	0	-600	0.00	0.00	1	0	-1
0012	3T	5_1	142	4	1	400	2400	2000	0.25	6.00	0	4	4
0012	3T	5_1	143	5	0	500	0	-500	0.00	0.00	0	0	0
0012	3T	5_1	145	3	0	300	0	-300	0.00	0.00	0	0	0
0012	3T	5_1	146	2	0	200	0	-200	0.00	0.00	0	0	0
0012	3T	5_1	152	4	0	400	0	-400	0.00	0.00	0	0	0
0012	3T	5_1	153	1	0	100	0	-100	0.00	0.00	0	0	0
0012	3T	5_1	154	4	0	400	0	-400	0.00	0.00	0	0	0
0012	3T	5_1	156	1	0	100	0	-100	0.00	0.00	0	0	0
0012	3T	5_1	162	2	0	200	0	-200	0.00	0.00	0	0	0
0012	3T	5_1	163	3	0	300	0	-300	0.00	0.00	0	0	0
0012	3T	5_1	164	2	0	200	0	-200	0.00	0.00	0	0	0
0012	3T	5_1	165	2	0	200	0	-200	0.00	0.00	0	0	0
0012	3T	5_1	213	1	0	100	0	-100	0.00	0.00	0	0	0
0012	3T	5_1	215	1	1	100	3800	3700	1.00	38.00	0	6	6
0012	3T	5_1	231	2	0	200	0	-200	0.00	0.00	0	0	0
0012	3T	5_1	241	1	0	100	0	-100	0.00	0.00	0	0	0
0012	3T	5_1	243	1	0	100	0	-100	0.00	0.00	0	0	0
0012	3T	5_1	245	1	0	100	0	-100	0.00	0.00	0	0	0
0012	3T	5_1	253	2	0	200	0	-200	0.00	0.00	0	0	0
0012	3T	5_1	256	2	0	200	0	-200	0.00	0.00	0	0	0
0012	3T	5_1	263	1	0	100	0	-100	0.00	0.00	0	0	0
0012	3T	5_2	124	1	0	100	0	-100	0.00	0.00	0	0	0
0012	3T	5_2	125	1	0	100	0	-100	0.00	0.00	0	0	0
0012	3T	5_2	135	1	0	100	0	-100	0.00	0.00	0	0	0
0012	3T	5_2	136	1	1	100	1020	920	1.00	10.20	0	1	1
0012	3T	5_2	142	1	0	100	0	-100	0.00	0.00	0	0	0
0012	3T	5_2	143	1	0	100	0	-100	0.00	0.00	0	0	0
0012	3T	5_2	146	1	1	100	840	740	1.00	8.40	0	1	1
0012	3T	5_3	123	395	33	39500	36360	-3140	0.08	0.92	69	64	-5
0012	3T	5_3	124	366	34	36600	37590	990	0.09	1.03	64	66	2
0012	3T	5_3	125	214	9	21400	14060	-7340	0.04	0.66	37	24	-13
0012	3T	5_3	126	171	5	17100	18080	980	0.03	1.06	30	32	2
0012	3T	5_3	132	243	21	24300	19600	-4700	0.09	0.81	43	34	-9
0012	3T	5_3	134	231	17	23100	15190	-7910	0.07	0.66	40	26	-14
0012	3T	5_3	135	179	14	17900	13380	-4520	0.08	0.75	31	23	-8
0012	3T	5_3	136	133	7	13300	10820	-2480	0.05	0.81	23	19	-4
0012	3T	5_3	142	173	12	17300	14040	-3260	0.07	0.81	30	24	-6
0012	3T	5_3	143	143	11	14300	10540	-3760	0.08	0.74	25	18	-7
0012	3T	5_3	145	116	3	11600	4550	-7050	0.03	0.39	20	8	-12
0012	3T	5_3	146	71	4	7100	3250	-3850	0.06	0.46	12	5	-7
0012	3T	5_3	152	85	4	8500	3320	-5180	0.05	0.39	15	5	-10
0012	3T	5_3	153	67	3	6700	5940	-760	0.04	0.89	11	10	-1
0012	3T	5_3	154	42	0	4200	0	-4200	0.00	0.00	7	0	-7
0012	3T	5_3	156	36	3	3600	4210	610	0.08	1.17	6	7	1
0012	3T	5_3	162	36	4	3600	3890	290	0.11	1.08	6	6	0
0012	3T	5_3	163	46	1	4600	630	-3970	0.02	0.14	8	1	-7
0012	3T	5_3	164	36	1	3600	1960	-1640	0.03	0.54	6	3	-3
0012	3T	5_3	165	24	1	2400	2340	-60	0.04	0.98	4	4	0
0012	3T	5_3	213	28	2	2800	6840	4040	0.07	2.44	4	12	8
0012	3T	5_3	214	24	2	2400	3080	680	0.08	1.28	4	5	1
0012	3T	5_3	215	19	0	1900	0	-1900	0.00	0.00	3	0	-3
0012	3T	5_3	216	30	1	3000	2430	-570	0.03	0.81	5	4	-1
0012	3T	5_3	231	15	0	1500	0	-1500	0.00	0.00	2	0	-2
0012	3T	5_3	234	19	0	1900	0	-1900	0.00	0.00	3	0	-3
0012	3T	5_3	235	18	0	1800	0	-1800	0.00	0.00	3	0	-3
0012	3T	5_3	236	14	0	1400	0	-1400	0.00	0.00	2	0	-2
0012	3T	5_3	241	9	0	900	0	-900	0.00	0.00	1	0	-1
0012	3T	5_3	243	6	0	600	0	-600	0.00	0.00	1	0	-1
0012	3T	5_3	245	6	0	600	0	-600	0.00	0.00	1	0	-1
0012	3T	5_3	246	8	0	800	0	-800	0.00	0.00	1	0	-1
0012	3T	5_3	251	5	1	500	3930	3430	0.20	7.86	0	6	6
0012	3T	5_3	253	7	0	700	0	-700	0.00	0.00	1	0	-1
0012	3T	5_3	254	11	0	1100	0	-1100	0.00	0.00	1	0	-1
0012	3T	5_3	256	7	0	700	0	-700	0.00	0.00	1	0	-1
0012	3T	5_3	261	6	0	600	0	-600	0.00	0.00	1	0	-1
0012	3T	5_3	263	3	0	300	0	-300	0.00	0.00	0	0	0
0012	3T	5_3	264	2	0	200	0	-200	0.00	0.00	0	0	0
0012	3T	5_3	265	3	0	300	0	-300	0.00	0.00	0	0	0
0012	3T	5_4	123	3	1	300	550	250	0.33	1.83	0	0	0
0012	3T	5_4	124	2	0	200	0	-200	0.00	0.00	0	0	0
0012	3T	5_4	126	1	0	100	0	-100	0.00	0.00	0	0	0
0012	3T	5_4	134	1	0	100	0	-100	0.00	0.00	0	0	0
0012	3T	5_4	145	2	0	200	0	-200	0.00	0.00	0	0	0
0012	3T	5_4	153	1	0	100	0	-100	0.00	0.00	0	0	0
0012	3T	5_4	216	1	0	100	0	-100	0.00	0.00	0	0	0
0012	3T	5_4	235	2	0	200	0	-200	0.00	0.00	0	0	0
0012	3T	5_4	253	1	0	100	0	-100	0.00	0.00	0	0	0
0012	3T	5_5	132	1	0	100	0	-100	0.00	0.00	0	0	0
0012	3T	5_5	146	1	0	100	0	-100	0.00	0.00	0	0	0
0012	3T	5_5	153	1	0	100	0	-100	0.00	0.00	0	0	0
0012	3T	5_6	123	284	41	28400	21730	-6670	0.14	0.77	50	38	-12
0012	3T	5_6	124	264	34	26400	24850	-1550	0.13	0.94	46	43	-3
0012	3T	5_6	125	157	9	15700	14900	-800	0.06	0.95	27	26	-1
0012	3T	5_6	126	115	8	11500	18920	7420	0.07	1.65	20	33	13
0012	3T	5_6	132	116	11	11600	11420	-180	0.09	0.98	20	20	0
0012	3T	5_6	134	153	14	15300	16850	1550	0.09	1.10	27	29	2
0012	3T	5_6	135	87	3	8700	4380	-4320	0.03	0.50	15	7	-8
0012	3T	5_6	136	53	4	5300	9960	4660	0.08	1.88	9	17	8
0012	3T	5_6	142	46	1	4600	740	-3860	0.02	0.16	8	1	-7
0012	3T	5_6	143	43	4	4300	7410	3110	0.09	1.72	7	13	6
0012	3T	5_6	145	38	1	3800	1210	-2590	0.03	0.32	6	2	-4
0012	3T	5_6	146	27	0	2700	0	-2700	0.00	0.00	4	0	-4
0012	3T	5_6	152	8	0	800	0	-800	0.00	0.00	1	0	-1
0012	3T	5_6	153	7	0	700	0	-700	0.00	0.00	1	0	-1
0012	3T	5_6	154	22	1	2200	3310	1110	0.05	1.50	3	5	2
0012	3T	5_6	156	14	0	1400	0	-1400	0.00	0.00	2	0	-2
0012	3T	5_6	162	2	0	200	0	-200	0.00	0.00	0	0	0
0012	3T	5_6	163	1	0	100	0	-100	0.00	0.00	0	0	0
0012	3T	5_6	164	2	0	200	0	-200	0.00	0.00	0	0	0
0012	3T	5_6	165	3	0	300	0	-300	0.00	0.00	0	0	0
0012	3T	5_6	213	4	1	400	1060	660	0.25	2.65	0	1	1
0012	3T	5_6	214	4	0	400	0	-400	0.00	0.00	0	0	0
0012	3T	5_6	215	8	1	800	2310	1510	0.13	2.89	1	4	3
0012	3T	5_6	216	3	0	300	0	-300	0.00	0.00	0	0	0
0012	3T	5_6	234	3	0	300	0	-300	0.00	0.00	0	0	0
0012	3T	5_6	235	1	0	100	0	-100	0.00	0.00	0	0	0
0012	3T	5_6	236	3	0	300	0	-300	0.00	0.00	0	0	0
0012	3T	5_6	241	1	0	100	0	-100	0.00	0.00	0	0	0
0012	3T	5_6	246	1	0	100	0	-100	0.00	0.00	0	0	0
0012	3T	5_6	254	1	0	100	0	-100	0.00	0.00	0	0	0
0012	3T	5_6	264	1	0	100	0	-100	0.00	0.00	0	0	0
0012	3T	5_else	123	202	23	20200	17270	-2930	0.11	0.85	35	30	-5
0012	3T	5_else	124	155	16	15500	18150	2650	0.10	1.17	27	32	5
0012	3T	5_else	125	77	1	7700	490	-7210	0.01	0.06	13	0	-13
0012	3T	5_else	126	47	3	4700	5820	1120	0.06	1.24	8	10	2
0012	3T	5_else	132	92	9	9200	14440	5240	0.10	1.57	16	25	9
0012	3T	5_else	134	76	4	7600	3820	-3780	0.05	0.50	13	6	-7
0012	3T	5_else	135	51	4	5100	4080	-1020	0.08	0.80	9	7	-2
0012	3T	5_else	136	26	2	2600	1980	-620	0.08	0.76	4	3	-1
0012	3T	5_else	142	53	3	5300	4400	-900	0.06	0.83	9	7	-2
0012	3T	5_else	143	49	2	4900	1660	-3240	0.04	0.34	8	2	-6
0012	3T	5_else	145	20	0	2000	0	-2000	0.00	0.00	3	0	-3
0012	3T	5_else	146	17	1	1700	4280	2580	0.06	2.52	3	7	4
0012	3T	5_else	152	12	0	1200	0	-1200	0.00	0.00	2	0	-2
0012	3T	5_else	153	12	0	1200	0	-1200	0.00	0.00	2	0	-2
0012	3T	5_else	154	8	1	800	6340	5540	0.13	7.93	1	11	10
0012	3T	5_else	156	6	1	600	2300	1700	0.17	3.83	1	4	3
0012	3T	5_else	162	2	0	200	0	-200	0.00	0.00	0	0	0
0012	3T	5_else	163	3	0	300	0	-300	0.00	0.00	0	0	0
0012	3T	5_else	164	2	0	200	0	-200	0.00	0.00	0	0	0
0012	3T	5_else	165	1	0	100	0	-100	0.00	0.00	0	0	0
0012	3T	5_else	213	6	0	600	0	-600	0.00	0.00	1	0	-1
0012	3T	5_else	214	3	0	300	0	-300	0.00	0.00	0	0	0
0012	3T	5_else	234	1	0	100	0	-100	0.00	0.00	0	0	0
0012	3T	5_else	236	2	0	200	0	-200	0.00	0.00	0	0	0
0012	3T	5_else	241	1	0	100	0	-100	0.00	0.00	0	0	0
0012	3T	5_else	243	1	0	100	0	-100	0.00	0.00	0	0	0
0012	3T	5_else	246	1	0	100	0	-100	0.00	0.00	0	0	0
0012	3T	5_else	254	1	0	100	0	-100	0.00	0.00	0	0	0
0012	3T	6_3	123	31	0	3100	0	-3100	0.00	0.00	5	0	-5
0012	3T	6_3	124	28	2	2800	1090	-1710	0.07	0.39	4	1	-3
0012	3T	6_3	125	14	2	1400	4230	2830	0.14	3.02	2	7	5
0012	3T	6_3	126	9	0	900	0	-900	0.00	0.00	1	0	-1
0012	3T	6_3	132	15	1	1500	450	-1050	0.07	0.30	2	0	-2
0012	3T	6_3	134	22	1	2200	710	-1490	0.05	0.32	3	1	-2
0012	3T	6_3	135	7	0	700	0	-700	0.00	0.00	1	0	-1
0012	3T	6_3	136	20	1	2000	690	-1310	0.05	0.35	3	1	-2
0012	3T	6_3	142	15	0	1500	0	-1500	0.00	0.00	2	0	-2
0012	3T	6_3	143	9	0	900	0	-900	0.00	0.00	1	0	-1
0012	3T	6_3	145	12	2	1200	5600	4400	0.17	4.67	2	9	7
0012	3T	6_3	146	8	0	800	0	-800	0.00	0.00	1	0	-1
0012	3T	6_3	152	9	0	900	0	-900	0.00	0.00	1	0	-1
0012	3T	6_3	153	7	0	700	0	-700	0.00	0.00	1	0	-1
0012	3T	6_3	154	7	0	700	0	-700	0.00	0.00	1	0	-1
0012	3T	6_3	156	4	0	400	0	-400	0.00	0.00	0	0	0
0012	3T	6_3	162	2	1	200	6760	6560	0.50	33.80	0	11	11
0012	3T	6_3	163	6	1	600	3820	3220	0.17	6.37	1	6	5
0012	3T	6_3	164	7	0	700	0	-700	0.00	0.00	1	0	-1
0012	3T	6_3	165	4	0	400	0	-400	0.00	0.00	0	0	0
0012	3T	6_3	214	3	0	300	0	-300	0.00	0.00	0	0	0
0012	3T	6_3	215	2	0	200	0	-200	0.00	0.00	0	0	0
0012	3T	6_3	216	2	0	200	0	-200	0.00	0.00	0	0	0
0012	3T	6_3	231	1	0	100	0	-100	0.00	0.00	0	0	0
0012	3T	6_3	234	1	0	100	0	-100	0.00	0.00	0	0	0
0012	3T	6_3	236	1	0	100	0	-100	0.00	0.00	0	0	0
0012	3T	6_3	243	1	0	100	0	-100	0.00	0.00	0	0	0
0012	3T	6_3	253	1	0	100	0	-100	0.00	0.00	0	0	0
0012	3T	6_3	265	1	0	100	0	-100	0.00	0.00	0	0	0
0012	3T	6_4	123	3	0	300	0	-300	0.00	0.00	0	0	0
0012	3T	6_4	124	2	0	200	0	-200	0.00	0.00	0	0	0
0012	3T	6_4	134	1	0	100	0	-100	0.00	0.00	0	0	0
0012	3T	6_4	142	1	0	100	0	-100	0.00	0.00	0	0	0
0012	3T	6_4	145	1	0	100	0	-100	0.00	0.00	0	0	0
0012	3T	6_6	123	22	1	2200	560	-1640	0.05	0.25	3	0	-3
0012	3T	6_6	124	22	3	2200	2300	100	0.14	1.05	3	4	1
0012	3T	6_6	125	12	1	1200	3650	2450	0.08	3.04	2	6	4
0012	3T	6_6	126	11	0	1100	0	-1100	0.00	0.00	1	0	-1
0012	3T	6_6	132	6	0	600	0	-600	0.00	0.00	1	0	-1
0012	3T	6_6	134	17	0	1700	0	-1700	0.00	0.00	3	0	-3
0012	3T	6_6	135	4	0	400	0	-400	0.00	0.00	0	0	0
0012	3T	6_6	136	4	1	400	2830	2430	0.25	7.08	0	5	5
0012	3T	6_6	142	4	0	400	0	-400	0.00	0.00	0	0	0
0012	3T	6_6	143	6	0	600	0	-600	0.00	0.00	1	0	-1
0012	3T	6_6	145	4	0	400	0	-400	0.00	0.00	0	0	0
0012	3T	6_6	153	3	0	300	0	-300	0.00	0.00	0	0	0
0012	3T	6_6	156	2	0	200	0	-200	0.00	0.00	0	0	0
0012	3T	6_6	165	1	0	100	0	-100	0.00	0.00	0	0	0
0012	3T	6_6	213	1	0	100	0	-100	0.00	0.00	0	0	0
0012	3T	6_6	215	1	0	100	0	-100	0.00	0.00	0	0	0
0012	3T	6_6	246	1	0	100	0	-100	0.00	0.00	0	0	0
0012	3T	6_else	123	14	0	1400	0	-1400	0.00	0.00	2	0	-2
0012	3T	6_else	124	7	0	700	0	-700	0.00	0.00	1	0	-1
0012	3T	6_else	125	3	0	300	0	-300	0.00	0.00	0	0	0
0012	3T	6_else	126	1	1	100	1080	980	1.00	10.80	0	1	1
0012	3T	6_else	132	5	0	500	0	-500	0.00	0.00	0	0	0
0012	3T	6_else	134	6	1	600	680	80	0.17	1.13	1	1	0
0012	3T	6_else	135	5	1	500	320	-180	0.20	0.64	0	0	0
0012	3T	6_else	136	1	0	100	0	-100	0.00	0.00	0	0	0
0012	3T	6_else	143	1	0	100	0	-100	0.00	0.00	0	0	0
0012	3T	6_else	145	1	0	100	0	-100	0.00	0.00	0	0	0
0012	3T	6_else	154	3	0	300	0	-300	0.00	0.00	0	0	0
0012	3T	6_else	165	1	0	100	0	-100	0.00	0.00	0	0	0
0012	3T	7_3	123	703	71	70300	63940	-6360	0.10	0.91	124	113	-11
0012	3T	7_3	124	638	54	63800	56720	-7080	0.08	0.89	112	100	-12
0012	3T	7_3	125	411	20	41100	25910	-15190	0.05	0.63	72	45	-27
0012	3T	7_3	126	341	22	34100	36590	2490	0.06	1.07	60	64	4
0012	3T	7_3	132	381	35	38100	33490	-4610	0.09	0.88	67	59	-8
0012	3T	7_3	134	378	22	37800	29450	-8350	0.06	0.78	66	52	-14
0012	3T	7_3	135	277	18	27700	25130	-2570	0.06	0.91	49	44	-5
0012	3T	7_3	136	223	18	22300	27230	4930	0.08	1.22	39	48	9
0012	3T	7_3	142	257	17	25700	20310	-5390	0.07	0.79	45	35	-10
0012	3T	7_3	143	241	16	24100	25430	1330	0.07	1.06	42	45	3
0012	3T	7_3	145	170	7	17000	6540	-10460	0.04	0.38	30	11	-19
0012	3T	7_3	146	144	4	14400	6940	-7460	0.03	0.48	25	12	-13
0012	3T	7_3	152	101	2	10100	6920	-3180	0.02	0.69	17	12	-5
0012	3T	7_3	153	103	3	10300	5870	-4430	0.03	0.57	18	10	-8
0012	3T	7_3	154	69	4	6900	7070	170	0.06	1.02	12	12	0
0012	3T	7_3	156	59	3	5900	8140	2240	0.05	1.38	10	14	4
0012	3T	7_3	162	68	1	6800	1200	-5600	0.01	0.18	12	2	-10
0012	3T	7_3	163	70	2	7000	3250	-3750	0.03	0.46	12	5	-7
0012	3T	7_3	164	46	1	4600	4070	-530	0.02	0.88	8	7	-1
0012	3T	7_3	165	28	0	2800	0	-2800	0.00	0.00	4	0	-4
0012	3T	7_3	213	51	4	5100	6980	1880	0.08	1.37	9	12	3
0012	3T	7_3	214	49	5	4900	21320	16420	0.10	4.35	8	37	29
0012	3T	7_3	215	32	2	3200	3720	520	0.06	1.16	5	6	1
0012	3T	7_3	216	33	2	3300	7800	4500	0.06	2.36	5	13	8
0012	3T	7_3	231	23	1	2300	2230	-70	0.04	0.97	4	3	-1
0012	3T	7_3	234	29	1	2900	5470	2570	0.03	1.89	5	9	4
0012	3T	7_3	235	35	0	3500	0	-3500	0.00	0.00	6	0	-6
0012	3T	7_3	236	27	0	2700	0	-2700	0.00	0.00	4	0	-4
0012	3T	7_3	241	12	0	1200	0	-1200	0.00	0.00	2	0	-2
0012	3T	7_3	243	15	0	1500	0	-1500	0.00	0.00	2	0	-2
0012	3T	7_3	245	17	1	1700	1220	-480	0.06	0.72	3	2	-1
0012	3T	7_3	246	10	0	1000	0	-1000	0.00	0.00	1	0	-1
0012	3T	7_3	251	6	0	600	0	-600	0.00	0.00	1	0	-1
0012	3T	7_3	253	21	1	2100	4950	2850	0.05	2.36	3	8	5
0012	3T	7_3	254	7	0	700	0	-700	0.00	0.00	1	0	-1
0012	3T	7_3	256	14	0	1400	0	-1400	0.00	0.00	2	0	-2
0012	3T	7_3	261	13	1	1300	13600	12300	0.08	10.46	2	24	22
0012	3T	7_3	263	15	1	1500	1700	200	0.07	1.13	2	3	1
0012	3T	7_3	264	9	0	900	0	-900	0.00	0.00	1	0	-1
0012	3T	7_3	265	13	0	1300	0	-1300	0.00	0.00	2	0	-2
0012	3T	7_4	123	292	47	29200	32220	3020	0.16	1.10	51	57	6
0012	3T	7_4	124	272	23	27200	19240	-7960	0.08	0.71	48	34	-14
0012	3T	7_4	125	175	15	17500	24420	6920	0.09	1.40	30	43	13
0012	3T	7_4	126	116	6	11600	10990	-610	0.05	0.95	20	19	-1
0012	3T	7_4	132	125	8	12500	8000	-4500	0.06	0.64	22	14	-8
0012	3T	7_4	134	137	8	13700	11060	-2640	0.06	0.81	24	19	-5
0012	3T	7_4	135	88	4	8800	6550	-2250	0.05	0.74	15	11	-4
0012	3T	7_4	136	49	0	4900	0	-4900	0.00	0.00	8	0	-8
0012	3T	7_4	142	59	4	5900	6940	1040	0.07	1.18	10	12	2
0012	3T	7_4	143	62	3	6200	5430	-770	0.05	0.88	10	9	-1
0012	3T	7_4	145	63	3	6300	9680	3380	0.05	1.54	11	17	6
0012	3T	7_4	146	39	0	3900	0	-3900	0.00	0.00	6	0	-6
0012	3T	7_4	152	20	0	2000	0	-2000	0.00	0.00	3	0	-3
0012	3T	7_4	153	22	0	2200	0	-2200	0.00	0.00	3	0	-3
0012	3T	7_4	154	12	0	1200	0	-1200	0.00	0.00	2	0	-2
0012	3T	7_4	156	21	0	2100	0	-2100	0.00	0.00	3	0	-3
0012	3T	7_4	162	10	0	1000	0	-1000	0.00	0.00	1	0	-1
0012	3T	7_4	163	9	0	900	0	-900	0.00	0.00	1	0	-1
0012	3T	7_4	164	9	0	900	0	-900	0.00	0.00	1	0	-1
0012	3T	7_4	165	7	0	700	0	-700	0.00	0.00	1	0	-1
0012	3T	7_4	213	9	0	900	0	-900	0.00	0.00	1	0	-1
0012	3T	7_4	214	7	0	700	0	-700	0.00	0.00	1	0	-1
0012	3T	7_4	215	6	0	600	0	-600	0.00	0.00	1	0	-1
0012	3T	7_4	216	5	0	500	0	-500	0.00	0.00	0	0	0
0012	3T	7_4	231	3	0	300	0	-300	0.00	0.00	0	0	0
0012	3T	7_4	234	7	0	700	0	-700	0.00	0.00	1	0	-1
0012	3T	7_4	235	2	0	200	0	-200	0.00	0.00	0	0	0
0012	3T	7_4	236	3	0	300	0	-300	0.00	0.00	0	0	0
0012	3T	7_4	241	2	0	200	0	-200	0.00	0.00	0	0	0
0012	3T	7_4	243	1	0	100	0	-100	0.00	0.00	0	0	0
0012	3T	7_4	245	2	0	200	0	-200	0.00	0.00	0	0	0
0012	3T	7_4	251	2	0	200	0	-200	0.00	0.00	0	0	0
0012	3T	7_4	253	1	0	100	0	-100	0.00	0.00	0	0	0
0012	3T	7_5	123	1	0	100	0	-100	0.00	0.00	0	0	0
0012	3T	7_5	124	2	0	200	0	-200	0.00	0.00	0	0	0
0012	3T	7_5	125	1	0	100	0	-100	0.00	0.00	0	0	0
0012	3T	7_5	134	1	0	100	0	-100	0.00	0.00	0	0	0
0012	3T	7_5	142	1	0	100	0	-100	0.00	0.00	0	0	0
0012	3T	7_5	153	1	0	100	0	-100	0.00	0.00	0	0	0
0012	3T	7_5	163	1	0	100	0	-100	0.00	0.00	0	0	0
0012	3T	7_7	123	165	14	16500	10830	-5670	0.08	0.66	29	19	-10
0012	3T	7_7	124	150	16	15000	10840	-4160	0.11	0.72	26	19	-7
0012	3T	7_7	125	79	6	7900	9790	1890	0.08	1.24	13	17	4
0012	3T	7_7	126	83	1	8300	1850	-6450	0.01	0.22	14	3	-11
0012	3T	7_7	132	51	5	5100	6580	1480	0.10	1.29	9	11	2
0012	3T	7_7	134	67	2	6700	1490	-5210	0.03	0.22	11	2	-9
0012	3T	7_7	135	36	1	3600	2720	-880	0.03	0.76	6	4	-2
0012	3T	7_7	136	32	1	3200	2800	-400	0.03	0.88	5	4	-1
0012	3T	7_7	142	39	4	3900	4250	350	0.10	1.09	6	7	1
0012	3T	7_7	143	36	2	3600	3360	-240	0.06	0.93	6	5	-1
0012	3T	7_7	145	33	0	3300	0	-3300	0.00	0.00	5	0	-5
0012	3T	7_7	146	24	0	2400	0	-2400	0.00	0.00	4	0	-4
0012	3T	7_7	152	9	1	900	2350	1450	0.11	2.61	1	4	3
0012	3T	7_7	153	6	0	600	0	-600	0.00	0.00	1	0	-1
0012	3T	7_7	154	17	1	1700	5110	3410	0.06	3.01	3	9	6
0012	3T	7_7	156	10	1	1000	7210	6210	0.10	7.21	1	12	11
0012	3T	7_7	162	2	0	200	0	-200	0.00	0.00	0	0	0
0012	3T	7_7	163	1	0	100	0	-100	0.00	0.00	0	0	0
0012	3T	7_7	164	4	0	400	0	-400	0.00	0.00	0	0	0
0012	3T	7_7	213	3	0	300	0	-300	0.00	0.00	0	0	0
0012	3T	7_7	214	5	0	500	0	-500	0.00	0.00	0	0	0
0012	3T	7_7	215	3	0	300	0	-300	0.00	0.00	0	0	0
0012	3T	7_7	231	1	0	100	0	-100	0.00	0.00	0	0	0
0012	3T	7_7	234	1	0	100	0	-100	0.00	0.00	0	0	0
0012	3T	7_7	245	1	0	100	0	-100	0.00	0.00	0	0	0
0012	3T	7_else	123	258	32	25800	26110	310	0.12	1.01	45	46	1
0012	3T	7_else	124	185	15	18500	14290	-4210	0.08	0.77	32	25	-7
0012	3T	7_else	125	107	10	10700	12170	1470	0.09	1.14	18	21	3
0012	3T	7_else	126	53	1	5300	1800	-3500	0.02	0.34	9	3	-6
0012	3T	7_else	132	110	7	11000	5100	-5900	0.06	0.46	19	9	-10
0012	3T	7_else	134	114	9	11400	9950	-1450	0.08	0.87	20	17	-3
0012	3T	7_else	135	56	1	5600	940	-4660	0.02	0.17	9	1	-8
0012	3T	7_else	136	34	2	3400	16110	12710	0.06	4.74	6	28	22
0012	3T	7_else	142	75	5	7500	6160	-1340	0.07	0.82	13	10	-3
0012	3T	7_else	143	49	2	4900	4260	-640	0.04	0.87	8	7	-1
0012	3T	7_else	145	33	3	3300	6680	3380	0.09	2.02	5	11	6
0012	3T	7_else	146	19	0	1900	0	-1900	0.00	0.00	3	0	-3
0012	3T	7_else	152	17	0	1700	0	-1700	0.00	0.00	3	0	-3
0012	3T	7_else	153	10	1	1000	1040	40	0.10	1.04	1	1	0
0012	3T	7_else	154	7	1	700	7820	7120	0.14	11.17	1	13	12
0012	3T	7_else	156	9	0	900	0	-900	0.00	0.00	1	0	-1
0012	3T	7_else	162	3	0	300	0	-300	0.00	0.00	0	0	0
0012	3T	7_else	163	5	0	500	0	-500	0.00	0.00	0	0	0
0012	3T	7_else	164	3	0	300	0	-300	0.00	0.00	0	0	0
0012	3T	7_else	165	1	0	100	0	-100	0.00	0.00	0	0	0
0012	3T	7_else	213	6	2	600	7430	6830	0.33	12.38	1	13	12
0012	3T	7_else	214	4	0	400	0	-400	0.00	0.00	0	0	0
0012	3T	7_else	215	3	0	300	0	-300	0.00	0.00	0	0	0
0012	3T	7_else	216	1	1	100	4750	4650	1.00	47.50	0	8	8
0012	3T	7_else	231	1	0	100	0	-100	0.00	0.00	0	0	0
0012	3T	7_else	234	3	0	300	0	-300	0.00	0.00	0	0	0
0012	3T	7_else	243	2	0	200	0	-200	0.00	0.00	0	0	0
0012	3T	7_else	245	1	0	100	0	-100	0.00	0.00	0	0	0
0012	3T	7_else	253	1	0	100	0	-100	0.00	0.00	0	0	0
0012	3T	7_else	254	1	0	100	0	-100	0.00	0.00	0	0	0
0012	3T	7_else	261	1	0	100	0	-100	0.00	0.00	0	0	0
0025	3T	15	246	1	0	100	0	-100	0.00	0.00	0	0	0
0025	3T	15	256	1	0	100	0	-100	0.00	0.00	0	0	0
0025	3T	15	265	2	0	200	0	-200	0.00	0.00	0	0	0
0025	3T	16	123	381	60	38100	30940	-7160	0.16	0.81	67	54	-13
0025	3T	16	124	638	56	63800	50320	-13480	0.09	0.79	112	89	-23
0025	3T	16	125	247	15	24700	18120	-6580	0.06	0.73	43	32	-11
0025	3T	16	126	351	19	35100	26550	-8550	0.05	0.76	62	46	-16
0025	3T	16	132	1	0	100	0	-100	0.00	0.00	0	0	0
0025	3T	16	134	147	10	14700	6190	-8510	0.07	0.42	26	10	-16
0025	3T	16	135	107	4	10700	4860	-5840	0.04	0.45	18	8	-10
0025	3T	16	136	157	8	15700	9490	-6210	0.05	0.60	27	16	-11
0025	3T	16	142	1	0	100	0	-100	0.00	0.00	0	0	0
0025	3T	16	143	10	2	1000	1670	670	0.20	1.67	1	2	1
0025	3T	16	145	88	5	8800	4700	-4100	0.06	0.53	15	8	-7
0025	3T	16	146	58	3	5800	4180	-1620	0.05	0.72	10	7	-3
0025	3T	16	153	2	0	200	0	-200	0.00	0.00	0	0	0
0025	3T	16	154	1	0	100	0	-100	0.00	0.00	0	0	0
0025	3T	16	156	22	0	2200	0	-2200	0.00	0.00	3	0	-3
0025	3T	16	163	2	0	200	0	-200	0.00	0.00	0	0	0
0025	3T	16	165	1	0	100	0	-100	0.00	0.00	0	0	0
0025	3T	16	234	5	0	500	0	-500	0.00	0.00	0	0	0
0025	3T	16	235	4	0	400	0	-400	0.00	0.00	0	0	0
0025	3T	16	236	9	1	900	2810	1910	0.11	3.12	1	4	3
0025	3T	16	245	4	0	400	0	-400	0.00	0.00	0	0	0
0025	3T	16	246	1	0	100	0	-100	0.00	0.00	0	0	0
0025	3T	16	256	5	0	500	0	-500	0.00	0.00	0	0	0
0025	3T	17	123	399	64	39900	37540	-2360	0.16	0.94	70	66	-4
0025	3T	17	124	648	53	64800	49500	-15300	0.08	0.76	114	87	-27
0025	3T	17	125	275	19	27500	17680	-9820	0.07	0.64	48	31	-17
0025	3T	17	126	265	17	26500	26910	410	0.06	1.02	46	47	1
0025	3T	17	132	19	1	1900	1080	-820	0.05	0.57	3	1	-2
0025	3T	17	134	172	23	17200	14100	-3100	0.13	0.82	30	24	-6
0025	3T	17	135	154	13	15400	16800	1400	0.08	1.09	27	29	2
0025	3T	17	136	101	6	10100	5080	-5020	0.06	0.50	17	8	-9
0025	3T	17	142	2	0	200	0	-200	0.00	0.00	0	0	0
0025	3T	17	143	7	0	700	0	-700	0.00	0.00	1	0	-1
0025	3T	17	145	70	1	7000	870	-6130	0.01	0.12	12	1	-11
0025	3T	17	146	41	2	4100	3300	-800	0.05	0.80	7	5	-2
0025	3T	17	152	1	0	100	0	-100	0.00	0.00	0	0	0
0025	3T	17	153	1	0	100	0	-100	0.00	0.00	0	0	0
0025	3T	17	156	9	0	900	0	-900	0.00	0.00	1	0	-1
0025	3T	17	164	1	0	100	0	-100	0.00	0.00	0	0	0
0025	3T	17	215	1	0	100	0	-100	0.00	0.00	0	0	0
0025	3T	17	216	2	0	200	0	-200	0.00	0.00	0	0	0
0025	3T	17	234	6	0	600	0	-600	0.00	0.00	1	0	-1
0025	3T	17	235	4	1	400	870	470	0.25	2.18	0	1	1
0025	3T	17	236	1	0	100	0	-100	0.00	0.00	0	0	0
0025	3T	17	245	2	0	200	0	-200	0.00	0.00	0	0	0
0025	3T	17	246	1	0	100	0	-100	0.00	0.00	0	0	0
0025	3T	17	253	1	0	100	0	-100	0.00	0.00	0	0	0
0025	3T	17	256	2	0	200	0	-200	0.00	0.00	0	0	0
0025	3T	17	263	1	0	100	0	-100	0.00	0.00	0	0	0
0025	3T	18	123	275	34	27500	23350	-4150	0.12	0.85	48	41	-7
0025	3T	18	124	771	83	77100	62340	-14760	0.11	0.81	136	110	-26
0025	3T	18	125	392	41	39200	38500	-700	0.10	0.98	69	68	-1
0025	3T	18	126	224	15	22400	18080	-4320	0.07	0.81	39	32	-7
0025	3T	18	132	5	1	500	1260	760	0.20	2.52	0	2	2
0025	3T	18	134	209	19	20900	14520	-6380	0.09	0.69	36	25	-11
0025	3T	18	135	209	17	20900	14750	-6150	0.08	0.71	36	26	-10
0025	3T	18	136	130	10	13000	12390	-610	0.08	0.95	23	21	-2
0025	3T	18	143	5	0	500	0	-500	0.00	0.00	0	0	0
0025	3T	18	145	101	7	10100	5420	-4680	0.07	0.54	17	9	-8
0025	3T	18	146	47	2	4700	1040	-3660	0.04	0.22	8	1	-7
0025	3T	18	153	2	0	200	0	-200	0.00	0.00	0	0	0
0025	3T	18	154	1	0	100	0	-100	0.00	0.00	0	0	0
0025	3T	18	156	3	0	300	0	-300	0.00	0.00	0	0	0
0025	3T	18	214	1	1	100	890	790	1.00	8.90	0	1	1
0025	3T	18	234	3	0	300	0	-300	0.00	0.00	0	0	0
0025	3T	18	235	12	0	1200	0	-1200	0.00	0.00	2	0	-2
0025	3T	18	236	6	0	600	0	-600	0.00	0.00	1	0	-1
0025	3T	18	245	3	0	300	0	-300	0.00	0.00	0	0	0
0025	3T	18	246	4	0	400	0	-400	0.00	0.00	0	0	0
0025	3T	18	256	1	0	100	0	-100	0.00	0.00	0	0	0
0025	3T	19	123	203	26	20300	15720	-4580	0.13	0.77	35	27	-8
0025	3T	19	124	691	73	69100	59190	-9910	0.11	0.86	122	104	-18
0022	1T	1_1	1	969	660	96900	92670	-4230	0.68	0.96	171	164	-7
0022	1T	1_10	1	1120	650	112000	98050	-13950	0.58	0.88	198	173	-25
0022	1T	1_10	2	30	16	3000	5080	2080	0.53	1.69	5	8	3
0022	1T	1_11	1	1154	733	115400	104140	-11260	0.64	0.90	204	184	-20
0022	1T	1_11	2	1	0	100	0	-100	0.00	0.00	0	0	0
0022	1T	1_12	1	1154	791	115400	104080	-11320	0.69	0.90	204	184	-20
0022	1T	1_2	1	893	419	89300	80270	-9030	0.47	0.90	158	142	-16
0022	1T	1_2	2	57	23	5700	4780	-920	0.40	0.84	10	8	-2
0022	1T	1_3	1	965	420	96500	90640	-5860	0.44	0.94	170	160	-10
0022	1T	1_3	2	84	40	8400	7760	-640	0.48	0.92	14	13	-1
0022	1T	1_4	1	989	472	98900	89390	-9510	0.48	0.90	175	158	-17
0022	1T	1_4	2	93	36	9300	7650	-1650	0.39	0.82	16	13	-3
0022	1T	1_5	1	956	526	95600	87910	-7690	0.55	0.92	169	155	-14
0022	1T	1_5	2	157	68	15700	14150	-1550	0.43	0.90	27	25	-2
0022	1T	1_6	1	783	386	78300	83660	5360	0.49	1.07	138	148	10
0022	1T	1_6	2	238	96	23800	23990	190	0.40	1.01	42	42	0
0022	1T	1_7	1	803	410	80300	74040	-6260	0.51	0.92	142	131	-11
0022	1T	1_7	2	222	92	22200	19230	-2970	0.41	0.87	39	34	-5
0022	1T	1_8	1	803	441	80300	72460	-7840	0.55	0.90	142	128	-14
0022	1T	1_8	2	179	79	17900	14840	-3060	0.44	0.83	31	26	-5
0022	1T	1_9	1	984	562	98400	86300	-12100	0.57	0.88	174	152	-22
0022	1T	1_9	2	123	40	12300	9170	-3130	0.33	0.75	21	16	-5
0022	1T	2_1	1	1047	659	104700	90560	-14140	0.63	0.86	185	160	-25
0022	1T	2_1	2	43	15	4300	3370	-930	0.35	0.78	7	5	-2
0022	1T	2_10	1	1090	600	109000	101900	-7100	0.55	0.93	192	180	-12
0022	1T	2_10	2	42	21	4200	4490	290	0.50	1.07	7	7	0
0022	1T	2_11	1	1147	664	114700	96080	-18620	0.58	0.84	203	170	-33
0022	1T	2_11	2	5	2	500	420	-80	0.40	0.84	0	0	0
0022	1T	2_12	1	1157	817	115700	107870	-7830	0.71	0.93	204	190	-14
0022	1T	2_2	1	886	394	88600	83480	-5120	0.44	0.94	156	147	-9
0022	1T	2_2	2	110	41	11000	9680	-1320	0.37	0.88	19	17	-2
0022	1T	2_3	1	807	358	80700	70290	-10410	0.44	0.87	142	124	-18
0022	1T	2_3	2	197	83	19700	20340	640	0.42	1.03	34	36	2
0022	1T	2_4	1	845	421	84500	75710	-8790	0.50	0.90	149	134	-15
0022	1T	2_4	2	165	67	16500	14920	-1580	0.41	0.90	29	26	-3
0022	1T	2_5	1	907	508	90700	83150	-7550	0.56	0.92	160	147	-13
0022	1T	2_5	2	160	67	16000	13190	-2810	0.42	0.82	28	23	-5
0022	1T	2_6	1	777	356	77700	72870	-4830	0.46	0.94	137	128	-9
0022	1T	2_6	2	224	90	22400	18310	-4090	0.40	0.82	39	32	-7
0022	1T	2_7	1	850	428	85000	76840	-8160	0.50	0.90	150	136	-14
0022	1T	2_7	2	192	79	19200	17400	-1800	0.41	0.91	33	30	-3
0022	1T	2_8	1	842	438	84200	74990	-9210	0.52	0.89	149	132	-17
0022	1T	2_8	2	163	73	16300	18750	2450	0.45	1.15	28	33	5
0022	1T	2_9	1	966	503	96600	84130	-12470	0.52	0.87	170	148	-22
0022	1T	2_9	2	117	54	11700	13220	1520	0.46	1.13	20	23	3
0022	1T	3_1	1	1002	652	100200	91650	-8550	0.65	0.91	177	162	-15
0022	1T	3_1	2	46	15	4600	4540	-60	0.33	0.99	8	8	0
0022	1T	3_10	1	1041	599	104100	96840	-7260	0.58	0.93	184	171	-13
0022	1T	3_10	2	72	33	7200	7200	0	0.46	1.00	12	12	0
0022	1T	3_11	1	1153	771	115300	111390	-3910	0.67	0.97	204	197	-7
0022	1T	3_11	2	7	3	700	1080	380	0.43	1.54	1	1	0
0022	1T	3_12	1	1164	808	116400	100710	-15690	0.69	0.87	206	178	-28
0022	1T	3_12	2	2	1	200	330	130	0.50	1.65	0	0	0
0022	1T	3_2	1	876	408	87600	82280	-5320	0.47	0.94	155	145	-10
0022	1T	3_2	2	129	52	12900	13280	380	0.40	1.03	22	23	1
0022	1T	3_3	1	828	394	82800	75660	-7140	0.48	0.91	146	133	-13
0022	1T	3_3	2	183	68	18300	18390	90	0.37	1.00	32	32	0
0022	1T	3_4	1	745	380	74500	70710	-3790	0.51	0.95	131	125	-6
0022	1T	3_4	2	259	90	25900	28550	2650	0.35	1.10	45	50	5
0022	1T	3_5	1	824	501	82400	83190	790	0.61	1.01	145	147	2
0022	1T	3_5	2	195	72	19500	19380	-120	0.37	0.99	34	34	0
0022	1T	3_6	1	666	341	66600	64010	-2590	0.51	0.96	117	113	-4
0022	1T	3_6	2	307	119	30700	28620	-2080	0.39	0.93	54	50	-4
0022	1T	3_7	1	766	397	76600	72120	-4480	0.52	0.94	135	127	-8
0022	1T	3_7	2	238	96	23800	22110	-1690	0.40	0.93	42	39	-3
0022	1T	3_8	1	841	458	84100	80190	-3910	0.54	0.95	148	141	-7
0022	1T	3_8	2	170	72	17000	15040	-1960	0.42	0.88	30	26	-4
0022	1T	3_9	1	892	535	89200	87460	-1740	0.60	0.98	157	154	-3
0022	1T	3_9	2	163	51	16300	11110	-5190	0.31	0.68	28	19	-9
0022	1T	4_1	1	836	558	83600	76840	-6760	0.67	0.92	147	136	-11
0022	1T	4_1	2	47	14	4700	3820	-880	0.30	0.81	8	6	-2
0022	1T	4_10	1	892	536	89200	78580	-10620	0.60	0.88	157	139	-18
0022	1T	4_10	2	47	16	4700	4450	-250	0.34	0.95	8	7	-1
0022	1T	4_11	1	954	660	95400	87870	-7530	0.69	0.92	168	155	-13
0022	1T	4_11	2	1	1	100	280	180	1.00	2.80	0	0	0
0022	1T	4_12	1	951	702	95100	89140	-5960	0.74	0.94	168	157	-11
0022	1T	4_2	1	678	337	67800	62860	-4940	0.50	0.93	120	111	-9
0022	1T	4_2	2	152	56	15200	11940	-3260	0.37	0.79	26	21	-5
0022	1T	4_3	1	612	310	61200	60790	-410	0.51	0.99	108	107	-1
0022	1T	4_3	2	198	67	19800	15330	-4470	0.34	0.77	35	27	-8
0022	1T	4_4	1	663	335	66300	53620	-12680	0.51	0.81	117	94	-23
0022	1T	4_4	2	160	64	16000	16130	130	0.40	1.01	28	28	0
0022	1T	4_5	1	712	423	71200	64930	-6270	0.59	0.91	126	114	-12
0022	1T	4_5	2	151	60	15100	14400	-700	0.40	0.95	26	25	-1
0022	1T	4_6	1	619	315	61900	55850	-6050	0.51	0.90	109	98	-11
0022	1T	4_6	2	195	71	19500	15870	-3630	0.36	0.81	34	28	-6
0022	1T	4_7	1	682	369	68200	67270	-930	0.54	0.99	120	119	-1
0022	1T	4_7	2	158	75	15800	16340	540	0.47	1.03	27	28	1
0022	1T	4_8	1	716	408	71600	65240	-6360	0.57	0.91	126	115	-11
0022	1T	4_8	2	114	56	11400	17000	5600	0.49	1.49	20	30	10
0022	1T	4_9	1	780	490	78000	73800	-4200	0.63	0.95	138	130	-8
0022	1T	4_9	2	110	44	11000	10250	-750	0.40	0.93	19	18	-1
0022	1T	5_1	1	652	440	65200	56760	-8440	0.67	0.87	115	100	-15
0022	1T	5_1	2	22	4	2200	1280	-920	0.18	0.58	3	2	-1
0022	1T	5_10	1	705	486	70500	62610	-7890	0.69	0.89	124	110	-14
0022	1T	5_10	2	17	3	1700	1090	-610	0.18	0.64	3	1	-2
0022	1T	5_11	1	725	524	72500	64800	-7700	0.72	0.89	128	114	-14
0022	1T	5_11	2	8	0	800	0	-800	0.00	0.00	1	0	-1
0022	1T	5_12	1	725	535	72500	65500	-7000	0.74	0.90	128	115	-13
0022	1T	5_12	2	4	0	400	0	-400	0.00	0.00	0	0	0
0022	1T	5_2	1	586	321	58600	53200	-5400	0.55	0.91	103	94	-9
0022	1T	5_2	2	67	25	6700	7790	1090	0.37	1.16	11	13	2
0022	1T	5_3	1	543	313	54300	57840	3540	0.58	1.07	96	102	6
0022	1T	5_3	2	89	25	8900	7060	-1840	0.28	0.79	15	12	-3
0022	1T	5_4	1	549	306	54900	48380	-6520	0.56	0.88	97	85	-12
0022	1T	5_4	2	85	22	8500	7560	-940	0.26	0.89	15	13	-2
0022	1T	5_5	1	622	388	62200	57040	-5160	0.62	0.92	110	100	-10
0022	1T	5_5	2	62	19	6200	4200	-2000	0.31	0.68	10	7	-3
0022	1T	5_6	1	586	343	58600	54890	-3710	0.59	0.94	103	97	-6
0022	1T	5_6	2	65	22	6500	5380	-1120	0.34	0.83	11	9	-2
0022	1T	5_7	1	624	385	62400	59330	-3070	0.62	0.95	110	105	-5
0022	1T	5_7	2	44	21	4400	5780	1380	0.48	1.31	7	10	3
0022	1T	5_8	1	620	367	62000	56080	-5920	0.59	0.90	109	99	-10
0022	1T	5_8	2	45	13	4500	2470	-2030	0.29	0.55	7	4	-3
0022	1T	5_9	1	692	465	69200	64600	-4600	0.67	0.93	122	114	-8
0022	1T	5_9	2	24	5	2400	1070	-1330	0.21	0.45	4	1	-3
0022	1T	6_1	1	52	34	5200	4460	-740	0.65	0.86	9	7	-2
0022	1T	6_1	2	4	3	400	770	370	0.75	1.93	0	1	1
0022	1T	6_10	1	56	46	5600	6030	430	0.82	1.08	9	10	1
0022	1T	6_10	2	1	1	100	190	90	1.00	1.90	0	0	0
0022	1T	6_11	1	58	43	5800	4840	-960	0.74	0.83	10	8	-2
0022	1T	6_12	1	59	38	5900	4670	-1230	0.64	0.79	10	8	-2
0022	1T	6_2	1	46	23	4600	4010	-590	0.50	0.87	8	7	-1
0022	1T	6_2	2	4	1	400	220	-180	0.25	0.55	0	0	0
0022	1T	6_3	1	46	27	4600	4360	-240	0.59	0.95	8	7	-1
0022	1T	6_3	2	6	3	600	640	40	0.50	1.07	1	1	0
0022	1T	6_4	1	51	27	5100	4250	-850	0.53	0.83	9	7	-2
0022	1T	6_4	2	3	0	300	0	-300	0.00	0.00	0	0	0
0022	1T	6_5	1	53	27	5300	4710	-590	0.51	0.89	9	8	-1
0022	1T	6_5	2	1	1	100	340	240	1.00	3.40	0	0	0
0022	1T	6_6	1	49	28	4900	4060	-840	0.57	0.83	8	7	-1
0022	1T	6_6	2	4	1	400	110	-290	0.25	0.28	0	0	0
0022	1T	6_7	1	51	21	5100	4570	-530	0.41	0.90	9	8	-1
0022	1T	6_7	2	3	2	300	430	130	0.67	1.43	0	0	0
0022	1T	6_8	1	54	32	5400	5070	-330	0.59	0.94	9	8	-1
0022	1T	6_8	2	2	1	200	180	-20	0.50	0.90	0	0	0
0022	1T	6_9	1	55	32	5500	4270	-1230	0.58	0.78	9	7	-2
0022	1T	6_9	2	3	1	300	310	10	0.33	1.03	0	0	0
0022	1T	7_1	1	1078	685	107800	96220	-11580	0.64	0.89	190	170	-20
0022	1T	7_1	2	50	15	5000	4280	-720	0.30	0.86	8	7	-1
0022	1T	7_10	1	1114	694	111400	103490	-7910	0.62	0.93	197	183	-14
0022	1T	7_10	2	43	14	4300	3690	-610	0.33	0.86	7	6	-1
0022	1T	7_11	1	1139	766	113900	103280	-10620	0.67	0.91	201	182	-19
0022	1T	7_11	2	32	7	3200	1570	-1630	0.22	0.49	5	2	-3
0022	1T	7_12	1	1165	807	116500	102070	-14430	0.69	0.88	206	180	-26
0022	1T	7_12	2	11	1	1100	210	-890	0.09	0.19	1	0	-1
0022	1T	7_2	1	970	524	97000	90860	-6140	0.54	0.94	171	160	-11
0022	1T	7_2	2	108	34	10800	8210	-2590	0.31	0.76	19	14	-5
0022	1T	7_3	1	913	511	91300	84590	-6710	0.56	0.93	161	149	-12
0022	1T	7_3	2	163	43	16300	13700	-2600	0.26	0.84	28	24	-4
0022	1T	7_4	1	956	576	95600	92670	-2930	0.60	0.97	169	164	-5
0022	1T	7_4	2	117	39	11700	10120	-1580	0.33	0.86	20	17	-3
0022	1T	7_5	1	993	616	99300	92040	-7260	0.62	0.93	175	162	-13
0022	1T	7_5	2	96	29	9600	6390	-3210	0.30	0.67	16	11	-5
0022	1T	7_6	1	957	591	95700	91280	-4420	0.62	0.95	169	161	-8
0022	1T	7_6	2	129	49	12900	12320	-580	0.38	0.96	22	21	-1
0022	1T	7_7	1	1043	666	104300	97430	-6870	0.64	0.93	184	172	-12
0022	1T	7_7	2	73	28	7300	7040	-260	0.38	0.96	12	12	0
0022	1T	7_8	1	1068	699	106800	97410	-9390	0.65	0.91	189	172	-17
0022	1T	7_8	2	64	23	6400	5700	-700	0.36	0.89	11	10	-1
0022	1T	7_9	1	1103	698	110300	100630	-9670	0.63	0.91	195	178	-17
0022	1T	7_9	2	38	15	3800	4050	250	0.39	1.07	6	7	1
0022	2F	1_1	12	414	111	41400	30170	-11230	0.27	0.73	73	53	-20
0022	2F	1_1	13	248	62	24800	17050	-7750	0.25	0.69	43	30	-13
0022	2F	1_1	14	217	58	21700	14880	-6820	0.27	0.69	38	26	-12
0022	2F	1_1	15	61	10	6100	5470	-630	0.16	0.90	10	9	-1
0022	2F	1_10	12	688	213	68800	56070	-12730	0.31	0.81	121	99	-22
0022	2F	1_10	13	330	115	33000	30930	-2070	0.35	0.94	58	54	-4
0022	2F	1_10	14	82	20	8200	5900	-2300	0.24	0.72	14	10	-4
0022	2F	1_10	15	11	2	1100	620	-480	0.18	0.56	1	1	0
0022	2F	1_10	16	4	0	400	0	-400	0.00	0.00	0	0	0
0022	2F	1_10	23	1	0	100	0	-100	0.00	0.00	0	0	0
0022	2F	1_10	25	1	0	100	0	-100	0.00	0.00	0	0	0
0022	2F	1_10	26	1	0	100	0	-100	0.00	0.00	0	0	0
0022	2F	1_11	12	794	257	79400	72180	-7220	0.32	0.91	140	127	-13
0022	2F	1_11	13	271	81	27100	20800	-6300	0.30	0.77	47	36	-11
0022	2F	1_11	14	77	15	7700	4010	-3690	0.19	0.52	13	7	-6
0022	2F	1_11	15	8	1	800	220	-580	0.13	0.28	1	0	-1
0022	2F	1_12	12	1084	320	108400	88870	-19530	0.30	0.82	191	157	-34
0022	2F	1_12	13	25	7	2500	2070	-430	0.28	0.83	4	3	-1
0022	2F	1_12	14	3	1	300	240	-60	0.33	0.80	0	0	0
0022	2F	1_2	12	413	144	41300	35100	-6200	0.35	0.85	73	62	-11
0022	2F	1_2	13	202	44	20200	15660	-4540	0.22	0.78	35	27	-8
0022	2F	1_2	14	140	26	14000	12170	-1830	0.19	0.87	24	21	-3
0022	2F	1_2	15	45	13	4500	4230	-270	0.29	0.94	7	7	0
0022	2F	1_2	16	5	2	500	1810	1310	0.40	3.62	0	3	3
0022	2F	1_2	23	1	0	100	0	-100	0.00	0.00	0	0	0
0022	2F	1_2	24	3	0	300	0	-300	0.00	0.00	0	0	0
0022	2F	1_2	25	2	0	200	0	-200	0.00	0.00	0	0	0
0022	2F	1_3	12	450	110	45000	44920	-80	0.24	1.00	79	79	0
0022	2F	1_3	13	344	107	34400	27970	-6430	0.31	0.81	60	49	-11
0022	2F	1_3	14	134	35	13400	14440	1040	0.26	1.08	23	25	2
0022	2F	1_3	15	18	3	1800	1590	-210	0.17	0.88	3	2	-1
0022	2F	1_3	16	12	5	1200	1780	580	0.42	1.48	2	3	1
0022	2F	1_3	23	2	0	200	0	-200	0.00	0.00	0	0	0
0022	2F	1_3	24	5	0	500	0	-500	0.00	0.00	0	0	0
0022	2F	1_4	12	573	162	57300	49120	-8180	0.28	0.86	101	86	-15
0022	2F	1_4	13	250	57	25000	16590	-8410	0.23	0.66	44	29	-15
0022	2F	1_4	14	110	24	11000	10350	-650	0.22	0.94	19	18	-1
0022	2F	1_4	15	6	2	600	700	100	0.33	1.17	1	1	0
0022	2F	1_4	16	40	9	4000	2950	-1050	0.23	0.74	7	5	-2
0022	2F	1_4	23	8	2	800	640	-160	0.25	0.80	1	1	0
0022	2F	1_4	24	2	0	200	0	-200	0.00	0.00	0	0	0
0022	2F	1_4	26	2	0	200	0	-200	0.00	0.00	0	0	0
0022	2F	1_5	12	569	201	56900	47760	-9140	0.35	0.84	100	84	-16
0022	2F	1_5	13	215	75	21500	18800	-2700	0.35	0.87	38	33	-5
0022	2F	1_5	14	117	34	11700	8900	-2800	0.29	0.76	20	15	-5
0022	2F	1_5	15	14	2	1400	910	-490	0.14	0.65	2	1	-1
0022	2F	1_5	16	30	9	3000	3520	520	0.30	1.17	5	6	1
0022	2F	1_5	23	8	4	800	1360	560	0.50	1.70	1	2	1
0022	2F	1_5	24	9	1	900	460	-440	0.11	0.51	1	0	-1
0022	2F	1_5	25	1	0	100	0	-100	0.00	0.00	0	0	0
0022	2F	1_5	26	2	0	200	0	-200	0.00	0.00	0	0	0
0022	2F	1_6	12	391	122	39100	34730	-4370	0.31	0.89	69	61	-8
0022	2F	1_6	13	189	61	18900	16690	-2210	0.32	0.88	33	29	-4
0022	2F	1_6	14	100	29	10000	8520	-1480	0.29	0.85	17	15	-2
0022	2F	1_6	15	28	7	2800	1910	-890	0.25	0.68	4	3	-1
0022	2F	1_6	16	56	12	5600	5500	-100	0.21	0.98	9	9	0
0022	2F	1_6	23	19	3	1900	1250	-650	0.16	0.66	3	2	-1
0022	2F	1_6	24	14	3	1400	1440	40	0.21	1.03	2	2	0
0022	2F	1_6	25	14	2	1400	1040	-360	0.14	0.74	2	1	-1
0022	2F	1_6	26	20	6	2000	2410	410	0.30	1.21	3	4	1
0022	2F	1_7	12	330	89	33000	26240	-6760	0.27	0.80	58	46	-12
0022	2F	1_7	13	235	82	23500	18240	-5260	0.35	0.78	41	32	-9
0022	2F	1_7	14	125	48	12500	11380	-1120	0.38	0.91	22	20	-2
0022	2F	1_7	15	28	8	2800	3310	510	0.29	1.18	4	5	1
0022	2F	1_7	16	51	14	5100	4930	-170	0.27	0.97	9	8	-1
0022	2F	1_7	23	13	9	1300	3480	2180	0.69	2.68	2	6	4
0022	2F	1_7	24	18	6	1800	2350	550	0.33	1.31	3	4	1
0022	2F	1_7	25	6	0	600	0	-600	0.00	0.00	1	0	-1
0022	2F	1_7	26	17	4	1700	1550	-150	0.24	0.91	3	2	-1
0022	2F	1_8	12	396	131	39600	35580	-4020	0.33	0.90	70	62	-8
0022	2F	1_8	13	197	83	19700	16990	-2710	0.42	0.86	34	30	-4
0022	2F	1_8	14	119	40	11900	9750	-2150	0.34	0.82	21	17	-4
0022	2F	1_8	15	54	10	5400	1640	-3760	0.19	0.30	9	2	-7
0022	2F	1_8	16	32	6	3200	2110	-1090	0.19	0.66	5	3	-2
0022	2F	1_8	23	6	2	600	600	0	0.33	1.00	1	1	0
0022	2F	1_8	24	8	1	800	390	-410	0.13	0.49	1	0	-1
0022	2F	1_8	25	3	0	300	0	-300	0.00	0.00	0	0	0
0022	2F	1_8	26	6	0	600	0	-600	0.00	0.00	1	0	-1
0022	2F	1_9	12	527	168	52700	45090	-7610	0.32	0.86	93	79	-14
0022	2F	1_9	13	228	70	22800	16450	-6350	0.31	0.72	40	29	-11
0022	2F	1_9	14	169	47	16900	12820	-4080	0.28	0.76	29	22	-7
0022	2F	1_9	15	24	2	2400	1500	-900	0.08	0.63	4	2	-2
0022	2F	1_9	16	22	3	2200	950	-1250	0.14	0.43	3	1	-2
0022	2F	1_9	23	8	1	800	280	-520	0.13	0.35	1	0	-1
0022	2F	1_9	24	7	2	700	610	-90	0.29	0.87	1	1	0
0022	2F	1_9	25	3	0	300	0	-300	0.00	0.00	0	0	0
0022	2F	1_9	26	3	0	300	0	-300	0.00	0.00	0	0	0
0022	2F	2_1	12	524	175	52400	46140	-6260	0.33	0.88	92	81	-11
0022	2F	2_1	13	203	55	20300	12950	-7350	0.27	0.64	35	22	-13
0022	2F	2_1	14	160	53	16000	11090	-4910	0.33	0.69	28	19	-9
0022	2F	2_1	15	30	7	3000	2350	-650	0.23	0.78	5	4	-1
0022	2F	2_1	16	15	5	1500	2360	860	0.33	1.57	2	4	2
0022	2F	2_1	23	4	2	400	440	40	0.50	1.10	0	0	0
0022	2F	2_1	24	1	0	100	0	-100	0.00	0.00	0	0	0
0022	2F	2_1	25	1	0	100	0	-100	0.00	0.00	0	0	0
0022	2F	2_1	26	3	0	300	0	-300	0.00	0.00	0	0	0
0022	2F	2_10	12	618	194	61800	47350	-14450	0.31	0.77	109	83	-26
0022	2F	2_10	13	300	105	30000	25740	-4260	0.35	0.86	53	45	-8
0022	2F	2_10	14	110	39	11000	10790	-210	0.35	0.98	19	19	0
0022	2F	2_10	15	24	5	2400	1610	-790	0.21	0.67	4	2	-2
0022	2F	2_10	16	29	10	2900	5130	2230	0.34	1.77	5	9	4
0022	2F	2_10	23	1	1	100	240	140	1.00	2.40	0	0	0
0022	2F	2_10	24	2	1	200	190	-10	0.50	0.95	0	0	0
0022	2F	2_10	25	1	0	100	0	-100	0.00	0.00	0	0	0
0022	2F	2_10	26	3	0	300	0	-300	0.00	0.00	0	0	0
0022	2F	2_11	12	703	205	70300	55700	-14600	0.29	0.79	124	98	-26
0022	2F	2_11	13	287	106	28700	25140	-3560	0.37	0.88	50	44	-6
0022	2F	2_11	14	121	38	12100	8860	-3240	0.31	0.73	21	15	-6
0022	2F	2_11	15	17	4	1700	1090	-610	0.24	0.64	3	1	-2
0022	2F	2_11	16	5	0	500	0	-500	0.00	0.00	0	0	0
0022	2F	2_12	12	863	269	86300	73660	-12640	0.31	0.85	152	130	-22
0022	2F	2_12	13	200	67	20000	16920	-3080	0.34	0.85	35	29	-6
0022	2F	2_12	14	75	24	7500	6400	-1100	0.32	0.85	13	11	-2
0022	2F	2_12	15	8	5	800	1750	950	0.63	2.19	1	3	2
0022	2F	2_12	16	2	1	200	620	420	0.50	3.10	0	1	1
0022	2F	2_2	12	400	142	40000	39000	-1000	0.36	0.98	70	69	-1
0022	2F	2_2	13	182	48	18200	12930	-5270	0.26	0.71	32	22	-10
0022	2F	2_2	14	156	42	15600	9470	-6130	0.27	0.61	27	16	-11
0022	2F	2_2	15	53	9	5300	2230	-3070	0.17	0.42	9	3	-6
0022	2F	2_2	16	47	11	4700	4490	-210	0.23	0.96	8	7	-1
0022	2F	2_2	23	14	3	1400	720	-680	0.21	0.51	2	1	-1
0022	2F	2_2	24	3	2	300	590	290	0.67	1.97	0	1	1
0022	2F	2_2	25	3	1	300	180	-120	0.33	0.60	0	0	0
0022	2F	2_2	26	5	1	500	330	-170	0.20	0.66	0	0	0
0022	2F	2_3	12	306	94	30600	29090	-1510	0.31	0.95	54	51	-3
0022	2F	2_3	13	306	94	30600	24790	-5810	0.31	0.81	54	43	-11
0022	2F	2_3	14	75	20	7500	6830	-670	0.27	0.91	13	12	-1
0022	2F	2_3	15	57	11	5700	4580	-1120	0.19	0.80	10	8	-2
0022	2F	2_3	16	54	7	5400	3000	-2400	0.13	0.56	9	5	-4
0022	2F	2_3	23	12	3	1200	1000	-200	0.25	0.83	2	1	-1
0022	2F	2_3	24	14	1	1400	270	-1130	0.07	0.19	2	0	-2
0022	2F	2_3	25	8	1	800	220	-580	0.13	0.28	1	0	-1
0022	2F	2_3	26	16	0	1600	0	-1600	0.00	0.00	2	0	-2
0022	2F	2_4	12	426	138	42600	33660	-8940	0.32	0.79	75	59	-16
0022	2F	2_4	13	189	61	18900	17980	-920	0.32	0.95	33	31	-2
0022	2F	2_4	14	114	30	11400	9190	-2210	0.26	0.81	20	16	-4
0022	2F	2_4	15	54	8	5400	4330	-1070	0.15	0.80	9	7	-2
0022	2F	2_4	16	56	7	5600	6580	980	0.13	1.18	9	11	2
0022	2F	2_4	23	7	1	700	230	-470	0.14	0.33	1	0	-1
0022	2F	2_4	24	7	3	700	960	260	0.43	1.37	1	1	0
0022	2F	2_4	25	4	0	400	0	-400	0.00	0.00	0	0	0
0022	2F	2_4	26	10	1	1000	240	-760	0.10	0.24	1	0	-1
0022	2F	2_5	12	490	191	49000	45060	-3940	0.39	0.92	86	79	-7
0022	2F	2_5	13	200	64	20000	16020	-3980	0.32	0.80	35	28	-7
0022	2F	2_5	14	133	44	13300	10930	-2370	0.33	0.82	23	19	-4
0022	2F	2_5	15	35	8	3500	2630	-870	0.23	0.75	6	4	-2
0022	2F	2_5	16	39	10	3900	2680	-1220	0.26	0.69	6	4	-2
0022	2F	2_5	23	5	1	500	400	-100	0.20	0.80	0	0	0
0022	2F	2_5	24	6	3	600	960	360	0.50	1.60	1	1	0
0022	2F	2_5	25	3	2	300	690	390	0.67	2.30	0	1	1
0022	2F	2_5	26	17	2	1700	1050	-650	0.12	0.62	3	1	-2
0022	2F	2_6	12	359	95	35900	26220	-9680	0.26	0.73	63	46	-17
0022	2F	2_6	13	215	72	21500	18960	-2540	0.33	0.88	38	33	-5
0022	2F	2_6	14	88	21	8800	5830	-2970	0.24	0.66	15	10	-5
0022	2F	2_6	15	51	11	5100	3390	-1710	0.22	0.66	9	6	-3
0022	2F	2_6	16	59	12	5900	4180	-1720	0.20	0.71	10	7	-3
0022	2F	2_6	23	6	2	600	660	60	0.33	1.10	1	1	0
0022	2F	2_6	24	10	1	1000	290	-710	0.10	0.29	1	0	-1
0022	2F	2_6	25	11	2	1100	600	-500	0.18	0.55	1	1	0
0022	2F	2_6	26	32	5	3200	2640	-560	0.16	0.83	5	4	-1
0022	2F	2_7	12	382	117	38200	31400	-6800	0.31	0.82	67	55	-12
0022	2F	2_7	13	219	79	21900	18530	-3370	0.36	0.85	38	32	-6
0022	2F	2_7	14	130	49	13000	12460	-540	0.38	0.96	23	22	-1
0022	2F	2_7	15	47	10	4700	2750	-1950	0.21	0.59	8	4	-4
0022	2F	2_7	16	58	8	5800	2960	-2840	0.14	0.51	10	5	-5
0022	2F	2_7	23	11	3	1100	660	-440	0.27	0.60	1	1	0
0022	2F	2_7	24	10	2	1000	760	-240	0.20	0.76	1	1	0
0022	2F	2_7	25	11	4	1100	1030	-70	0.36	0.94	1	1	0
0022	2F	2_7	26	15	2	1500	810	-690	0.13	0.54	2	1	-1
0022	2F	2_8	12	345	117	34500	31220	-3280	0.34	0.90	61	55	-6
0022	2F	2_8	13	230	72	23000	16400	-6600	0.31	0.71	40	29	-11
0022	2F	2_8	14	143	58	14300	13610	-690	0.41	0.95	25	24	-1
0022	2F	2_8	15	75	31	7500	9070	1570	0.41	1.21	13	16	3
0022	2F	2_8	16	41	7	4100	2890	-1210	0.17	0.70	7	5	-2
0022	2F	2_8	23	7	3	700	760	60	0.43	1.09	1	1	0
0022	2F	2_8	24	3	0	300	0	-300	0.00	0.00	0	0	0
0022	2F	2_8	25	4	2	400	950	550	0.50	2.38	0	1	1
0022	2F	2_8	26	11	0	1100	0	-1100	0.00	0.00	1	0	-1
0022	2F	2_9	12	467	162	46700	38990	-7710	0.35	0.83	82	69	-13
0022	2F	2_9	13	254	76	25400	18300	-7100	0.30	0.72	44	32	-12
0022	2F	2_9	14	166	54	16600	12820	-3780	0.33	0.77	29	22	-7
0022	2F	2_9	15	36	12	3600	4190	590	0.33	1.16	6	7	1
0022	2F	2_9	16	27	6	2700	1300	-1400	0.22	0.48	4	2	-2
0022	2F	2_9	23	5	1	500	550	50	0.20	1.10	0	0	0
0022	2F	2_9	24	9	1	900	320	-580	0.11	0.36	1	0	-1
0022	2F	2_9	25	7	1	700	280	-420	0.14	0.40	1	0	-1
0022	2F	2_9	26	7	2	700	1060	360	0.29	1.51	1	1	0
0022	2F	3_1	12	458	163	45800	42350	-3450	0.36	0.92	81	74	-7
0022	2F	3_1	13	205	53	20500	14090	-6410	0.26	0.69	36	24	-12
0022	2F	3_1	14	178	40	17800	12330	-5470	0.22	0.69	31	21	-10
0022	2F	3_1	15	46	11	4600	5930	1330	0.24	1.29	8	10	2
0022	2F	3_1	16	17	3	1700	1050	-650	0.18	0.62	3	1	-2
0022	2F	3_1	23	2	0	200	0	-200	0.00	0.00	0	0	0
0022	2F	3_1	25	1	0	100	0	-100	0.00	0.00	0	0	0
0022	2F	3_10	12	555	170	55500	42030	-13470	0.31	0.76	98	74	-24
0022	2F	3_10	13	299	101	29900	25230	-4670	0.34	0.84	52	44	-8
0022	2F	3_10	14	103	36	10300	9430	-870	0.35	0.92	18	16	-2
0022	2F	3_10	15	37	7	3700	2320	-1380	0.19	0.63	6	4	-2
0022	2F	3_10	16	22	4	2200	2530	330	0.18	1.15	3	4	1
0022	2F	3_10	23	4	0	400	0	-400	0.00	0.00	0	0	0
0022	2F	3_10	24	1	0	100	0	-100	0.00	0.00	0	0	0
0022	2F	3_10	25	3	1	300	490	190	0.33	1.63	0	0	0
0022	2F	3_10	26	4	0	400	0	-400	0.00	0.00	0	0	0
0022	2F	3_11	12	754	250	75400	58930	-16470	0.33	0.78	133	104	-29
0022	2F	3_11	13	272	83	27200	20070	-7130	0.31	0.74	48	35	-13
0022	2F	3_11	14	84	24	8400	6020	-2380	0.29	0.72	14	10	-4
0022	2F	3_11	15	21	3	2100	1010	-1090	0.14	0.48	3	1	-2
0022	2F	3_11	16	4	0	400	0	-400	0.00	0.00	0	0	0
0022	2F	3_11	26	1	0	100	0	-100	0.00	0.00	0	0	0
0022	2F	3_12	12	894	281	89400	77050	-12350	0.31	0.86	158	136	-22
0022	2F	3_12	13	182	63	18200	14780	-3420	0.35	0.81	32	26	-6
0022	2F	3_12	14	69	20	6900	5180	-1720	0.29	0.75	12	9	-3
0022	2F	3_12	15	6	1	600	230	-370	0.17	0.38	1	0	-1
0022	2F	3_12	16	3	1	300	360	60	0.33	1.20	0	0	0
0022	2F	3_12	23	1	0	100	0	-100	0.00	0.00	0	0	0
0022	2F	3_2	12	434	128	43400	32800	-10600	0.29	0.76	76	58	-18
0022	2F	3_2	13	181	43	18100	13100	-5000	0.24	0.72	32	23	-9
0022	2F	3_2	14	169	38	16900	10760	-6140	0.22	0.64	29	19	-10
0022	2F	3_2	15	41	6	4100	2470	-1630	0.15	0.60	7	4	-3
0022	2F	3_2	16	19	5	1900	2380	480	0.26	1.25	3	4	1
0022	2F	3_2	23	5	1	500	550	50	0.20	1.10	0	0	0
0022	2F	3_2	24	3	0	300	0	-300	0.00	0.00	0	0	0
0022	2F	3_2	25	1	0	100	0	-100	0.00	0.00	0	0	0
0022	2F	3_2	26	4	1	400	1360	960	0.25	3.40	0	2	2
0022	2F	3_3	12	392	101	39200	36340	-2860	0.26	0.93	69	64	-5
0022	2F	3_3	13	265	86	26500	22010	-4490	0.32	0.83	46	38	-8
0022	2F	3_3	14	84	15	8400	6610	-1790	0.18	0.79	14	11	-3
0022	2F	3_3	15	41	7	4100	3020	-1080	0.17	0.74	7	5	-2
0022	2F	3_3	16	38	6	3800	4230	430	0.16	1.11	6	7	1
0022	2F	3_3	23	9	3	900	1040	140	0.33	1.16	1	1	0
0022	2F	3_3	24	9	2	900	1190	290	0.22	1.32	1	2	1
0022	2F	3_3	25	10	0	1000	0	-1000	0.00	0.00	1	0	-1
0022	2F	3_3	26	14	2	1400	720	-680	0.14	0.51	2	1	-1
0022	2F	3_4	12	386	130	38600	34170	-4430	0.34	0.89	68	60	-8
0022	2F	3_4	13	175	53	17500	14460	-3040	0.30	0.83	30	25	-5
0022	2F	3_4	14	86	14	8600	4940	-3660	0.16	0.57	15	8	-7
0022	2F	3_4	15	40	2	4000	2300	-1700	0.05	0.58	7	4	-3
0022	2F	3_4	16	40	6	4000	1470	-2530	0.15	0.37	7	2	-5
0022	2F	3_4	23	21	6	2100	4190	2090	0.29	2.00	3	7	4
0022	2F	3_4	24	24	4	2400	1910	-490	0.17	0.80	4	3	-1
0022	2F	3_4	25	10	0	1000	0	-1000	0.00	0.00	1	0	-1
0022	2F	3_4	26	26	6	2600	2300	-300	0.23	0.88	4	4	0
0022	2F	3_5	12	450	182	45000	42780	-2220	0.40	0.95	79	75	-4
0022	2F	3_5	13	161	57	16100	15240	-860	0.35	0.95	28	26	-2
0022	2F	3_5	14	125	39	12500	9740	-2760	0.31	0.78	22	17	-5
0022	2F	3_5	15	33	8	3300	2600	-700	0.24	0.79	5	4	-1
0022	2F	3_5	16	36	8	3600	2580	-1020	0.22	0.72	6	4	-2
0022	2F	3_5	23	17	3	1700	810	-890	0.18	0.48	3	1	-2
0022	2F	3_5	24	20	2	2000	1130	-870	0.10	0.57	3	2	-1
0022	2F	3_5	25	10	2	1000	600	-400	0.20	0.60	1	1	0
0022	2F	3_5	26	14	3	1400	810	-590	0.21	0.58	2	1	-1
0022	2F	3_6	12	312	111	31200	30090	-1110	0.36	0.96	55	53	-2
0022	2F	3_6	13	161	57	16100	12530	-3570	0.35	0.78	28	22	-6
0022	2F	3_6	14	98	21	9800	4880	-4920	0.21	0.50	17	8	-9
0022	2F	3_6	15	44	10	4400	3210	-1190	0.23	0.73	7	5	-2
0022	2F	3_6	16	41	8	4100	5510	1410	0.20	1.34	7	9	2
0022	2F	3_6	23	30	5	3000	1770	-1230	0.17	0.59	5	3	-2
0022	2F	3_6	24	12	3	1200	690	-510	0.25	0.58	2	1	-1
0022	2F	3_6	25	15	3	1500	930	-570	0.20	0.62	2	1	-1
0022	2F	3_6	26	31	6	3100	2850	-250	0.19	0.92	5	5	0
0022	2F	3_7	12	366	118	36600	30630	-5970	0.32	0.84	64	54	-10
0022	2F	3_7	13	166	57	16600	13480	-3120	0.34	0.81	29	23	-6
0022	2F	3_7	14	139	47	13900	12400	-1500	0.34	0.89	24	21	-3
0022	2F	3_7	15	38	7	3800	2070	-1730	0.18	0.54	6	3	-3
0022	2F	3_7	16	49	11	4900	5670	770	0.22	1.16	8	10	2
0022	2F	3_7	23	19	5	1900	1340	-560	0.26	0.71	3	2	-1
0022	2F	3_7	24	14	3	1400	4490	3090	0.21	3.21	2	7	5
0022	2F	3_7	25	13	2	1300	750	-550	0.15	0.58	2	1	-1
0022	2F	3_7	26	20	1	2000	350	-1650	0.05	0.18	3	0	-3
0022	2F	3_8	12	370	133	37000	37480	480	0.36	1.01	65	66	1
0022	2F	3_8	13	217	79	21700	19700	-2000	0.36	0.91	38	34	-4
0022	2F	3_8	14	141	39	14100	10100	-4000	0.28	0.72	24	17	-7
0022	2F	3_8	15	69	16	6900	4190	-2710	0.23	0.61	12	7	-5
0022	2F	3_8	16	37	6	3700	3010	-690	0.16	0.81	6	5	-1
0022	2F	3_8	23	13	4	1300	1030	-270	0.31	0.79	2	1	-1
0022	2F	3_8	24	10	3	1000	1570	570	0.30	1.57	1	2	1
0022	2F	3_8	25	11	2	1100	710	-390	0.18	0.65	1	1	0
0022	2F	3_8	26	20	5	2000	1730	-270	0.25	0.87	3	3	0
0022	2F	3_9	12	442	176	44200	39410	-4790	0.40	0.89	78	69	-9
0022	2F	3_9	13	220	75	22000	16420	-5580	0.34	0.75	38	29	-9
0022	2F	3_9	14	143	38	14300	8500	-5800	0.27	0.59	25	15	-10
0022	2F	3_9	15	46	15	4600	4590	-10	0.33	1.00	8	8	0
0022	2F	3_9	16	34	6	3400	1590	-1810	0.18	0.47	6	2	-4
0022	2F	3_9	23	11	3	1100	880	-220	0.27	0.80	1	1	0
0022	2F	3_9	24	12	2	1200	830	-370	0.17	0.69	2	1	-1
0022	2F	3_9	25	12	2	1200	840	-360	0.17	0.70	2	1	-1
0022	2F	3_9	26	11	3	1100	1190	90	0.27	1.08	1	2	1
0022	2F	4_1	12	460	150	46000	39430	-6570	0.33	0.86	81	69	-12
0022	2F	4_1	13	186	50	18600	12530	-6070	0.27	0.67	32	22	-10
0022	2F	4_1	14	120	45	12000	11420	-580	0.38	0.95	21	20	-1
0022	2F	4_1	15	25	8	2500	2590	90	0.32	1.04	4	4	0
0022	2F	4_1	16	9	3	900	1070	170	0.33	1.19	1	1	0
0022	2F	4_1	23	5	1	500	230	-270	0.20	0.46	0	0	0
0022	2F	4_1	24	4	0	400	0	-400	0.00	0.00	0	0	0
0022	2F	4_1	25	4	1	400	730	330	0.25	1.83	0	1	1
0022	2F	4_1	26	1	0	100	0	-100	0.00	0.00	0	0	0
0022	2F	4_10	12	514	169	51400	38910	-12490	0.33	0.76	90	68	-22
0022	2F	4_10	13	232	84	23200	24700	1500	0.36	1.06	41	43	2
0022	2F	4_10	14	120	25	12000	7330	-4670	0.21	0.61	21	12	-9
0022	2F	4_10	15	26	4	2600	1140	-1460	0.15	0.44	4	2	-2
0022	2F	4_11	12	623	221	62300	53460	-8840	0.35	0.86	110	94	-16
0022	2F	4_11	13	228	72	22800	18320	-4480	0.32	0.80	40	32	-8
0022	2F	4_11	14	85	34	8500	10420	1920	0.40	1.23	15	18	3
0022	2F	4_11	15	18	1	1800	430	-1370	0.06	0.24	3	0	-3
0022	2F	4_12	12	701	247	70100	60360	-9740	0.35	0.86	124	106	-18
0022	2F	4_12	13	164	56	16400	12770	-3630	0.34	0.78	29	22	-7
0022	2F	4_12	14	65	14	6500	4390	-2110	0.22	0.68	11	7	-4
0022	2F	4_12	15	5	2	500	900	400	0.40	1.80	0	1	1
0022	2F	4_2	12	338	113	33800	29900	-3900	0.33	0.88	59	52	-7
0022	2F	4_2	13	143	42	14300	12440	-1860	0.29	0.87	25	22	-3
0022	2F	4_2	14	110	30	11000	8930	-2070	0.27	0.81	19	15	-4
0022	2F	4_2	15	39	8	3900	3170	-730	0.21	0.81	6	5	-1
0022	2F	4_2	16	21	1	2100	170	-1930	0.05	0.08	3	0	-3
0022	2F	4_2	23	16	2	1600	600	-1000	0.13	0.38	2	1	-1
0022	2F	4_2	24	5	1	500	250	-250	0.20	0.50	0	0	0
0022	2F	4_2	25	11	1	1100	1510	410	0.09	1.37	1	2	1
0022	2F	4_2	26	6	0	600	0	-600	0.00	0.00	1	0	-1
0022	2F	4_3	12	268	79	26800	23950	-2850	0.29	0.89	47	42	-5
0022	2F	4_3	13	222	80	22200	16870	-5330	0.36	0.76	39	29	-10
0022	2F	4_3	14	64	11	6400	3270	-3130	0.17	0.51	11	5	-6
0022	2F	4_3	15	42	8	4200	5850	1650	0.19	1.39	7	10	3
0022	2F	4_3	16	16	6	1600	4070	2470	0.38	2.54	2	7	5
0022	2F	4_3	23	21	5	2100	1460	-640	0.24	0.70	3	2	-1
0022	2F	4_3	24	9	1	900	280	-620	0.11	0.31	1	0	-1
0022	2F	4_3	25	7	1	700	330	-370	0.14	0.47	1	0	-1
0022	2F	4_3	26	7	0	700	0	-700	0.00	0.00	1	0	-1
0022	2F	4_4	12	320	95	32000	21970	-10030	0.30	0.69	56	38	-18
0022	2F	4_4	13	187	58	18700	14020	-4680	0.31	0.75	33	24	-9
0022	2F	4_4	14	81	22	8100	6490	-1610	0.27	0.80	14	11	-3
0022	2F	4_4	15	40	7	4000	2120	-1880	0.18	0.53	7	3	-4
0022	2F	4_4	16	22	3	2200	2130	-70	0.14	0.97	3	3	0
0022	2F	4_4	23	20	4	2000	1630	-370	0.20	0.82	3	2	-1
0022	2F	4_4	24	13	1	1300	420	-880	0.08	0.32	2	0	-2
0022	2F	4_4	25	10	2	1000	2540	1540	0.20	2.54	1	4	3
0022	2F	4_4	26	7	3	700	1350	650	0.43	1.93	1	2	1
0022	2F	4_5	12	383	147	38300	35380	-2920	0.38	0.92	67	62	-5
0022	2F	4_5	13	169	59	16900	14230	-2670	0.35	0.84	29	25	-4
0022	2F	4_5	14	112	27	11200	8280	-2920	0.24	0.74	19	14	-5
0022	2F	4_5	15	29	6	2900	2010	-890	0.21	0.69	5	3	-2
0022	2F	4_5	16	10	2	1000	390	-610	0.20	0.39	1	0	-1
0022	2F	4_5	23	17	6	1700	1780	80	0.35	1.05	3	3	0
0022	2F	4_5	24	11	2	1100	920	-180	0.18	0.84	1	1	0
0022	2F	4_5	25	4	1	400	420	20	0.25	1.05	0	0	0
0022	2F	4_5	26	12	3	1200	1500	300	0.25	1.25	2	2	0
0022	2F	4_6	12	302	104	30200	25590	-4610	0.34	0.85	53	45	-8
0022	2F	4_6	13	163	56	16300	15140	-1160	0.34	0.93	28	26	-2
0022	2F	4_6	14	86	21	8600	5920	-2680	0.24	0.69	15	10	-5
0022	2F	4_6	15	45	10	4500	5230	730	0.22	1.16	7	9	2
0022	2F	4_6	16	25	4	2500	1160	-1340	0.16	0.46	4	2	-2
0022	2F	4_6	23	18	4	1800	1020	-780	0.22	0.57	3	1	-2
0022	2F	4_6	24	14	3	1400	1070	-330	0.21	0.76	2	1	-1
0022	2F	4_6	25	12	1	1200	290	-910	0.08	0.24	2	0	-2
0022	2F	4_6	26	10	2	1000	940	-60	0.20	0.94	1	1	0
0022	2F	4_7	12	296	86	29600	22180	-7420	0.29	0.75	52	39	-13
0022	2F	4_7	13	183	62	18300	15240	-3060	0.34	0.83	32	26	-6
0022	2F	4_7	14	129	45	12900	11090	-1810	0.35	0.86	22	19	-3
0022	2F	4_7	15	41	12	4100	3930	-170	0.29	0.96	7	6	-1
0022	2F	4_7	16	19	3	1900	1300	-600	0.16	0.68	3	2	-1
0022	2F	4_7	23	14	5	1400	860	-540	0.36	0.61	2	1	-1
0022	2F	4_7	24	11	4	1100	1010	-90	0.36	0.92	1	1	0
0022	2F	4_7	25	8	3	800	990	190	0.38	1.24	1	1	0
0022	2F	4_7	26	7	2	700	1060	360	0.29	1.51	1	1	0
0022	2F	4_8	12	331	111	33100	27650	-5450	0.34	0.84	58	48	-10
0022	2F	4_8	13	166	58	16600	13040	-3560	0.35	0.79	29	23	-6
0022	2F	4_8	14	134	55	13400	13160	-240	0.41	0.98	23	23	0
0022	2F	4_8	15	56	21	5600	5420	-180	0.38	0.97	9	9	0
0022	2F	4_8	16	21	6	2100	1760	-340	0.29	0.84	3	3	0
0022	2F	4_8	23	9	3	900	700	-200	0.33	0.78	1	1	0
0022	2F	4_8	24	10	3	1000	1290	290	0.30	1.29	1	2	1
0022	2F	4_8	25	6	1	600	350	-250	0.17	0.58	1	0	-1
0022	2F	4_8	26	1	0	100	0	-100	0.00	0.00	0	0	0
0022	2F	4_9	12	403	158	40300	37670	-2630	0.39	0.93	71	66	-5
0022	2F	4_9	13	206	72	20600	17420	-3180	0.35	0.85	36	30	-6
0022	2F	4_9	14	126	55	12600	13320	720	0.44	1.06	22	23	1
0022	2F	4_9	15	25	10	2500	3290	790	0.40	1.32	4	5	1
0022	2F	4_9	16	7	2	700	1800	1100	0.29	2.57	1	3	2
0022	2F	4_9	23	6	1	600	240	-360	0.17	0.40	1	0	-1
0022	2F	4_9	24	5	4	500	1520	1020	0.80	3.04	0	2	2
0022	2F	4_9	25	8	1	800	390	-410	0.13	0.49	1	0	-1
0022	2F	4_9	26	4	0	400	0	-400	0.00	0.00	0	0	0
0022	2F	5_1	12	367	136	36700	34250	-2450	0.37	0.93	64	60	-4
0022	2F	5_1	13	147	34	14700	8730	-5970	0.23	0.59	26	15	-11
0022	2F	5_1	14	78	23	7800	6030	-1770	0.29	0.77	13	10	-3
0022	2F	5_1	15	18	2	1800	990	-810	0.11	0.55	3	1	-2
0022	2F	5_1	16	8	2	800	1090	290	0.25	1.36	1	1	0
0022	2F	5_1	23	1	0	100	0	-100	0.00	0.00	0	0	0
0022	2F	5_1	24	1	0	100	0	-100	0.00	0.00	0	0	0
0022	2F	5_1	25	1	1	100	480	380	1.00	4.80	0	0	0
0022	2F	5_10	12	567	218	56700	44900	-11800	0.38	0.79	100	79	-21
0022	2F	5_10	13	81	13	8100	3420	-4680	0.16	0.42	14	6	-8
0022	2F	5_10	14	18	4	1800	1460	-340	0.22	0.81	3	2	-1
0022	2F	5_10	15	1	0	100	0	-100	0.00	0.00	0	0	0
0022	2F	5_10	16	3	1	300	1170	870	0.33	3.90	0	2	2
0022	2F	5_10	23	4	0	400	0	-400	0.00	0.00	0	0	0
0022	2F	5_11	12	592	229	59200	46000	-13200	0.39	0.78	104	81	-23
0022	2F	5_11	13	93	30	9300	7530	-1770	0.32	0.81	16	13	-3
0022	2F	5_11	14	17	5	1700	1800	100	0.29	1.06	3	3	0
0022	2F	5_11	15	1	0	100	0	-100	0.00	0.00	0	0	0
0022	2F	5_11	23	1	0	100	0	-100	0.00	0.00	0	0	0
0022	2F	5_11	25	1	0	100	0	-100	0.00	0.00	0	0	0
0022	2F	5_12	12	552	220	55200	46060	-9140	0.40	0.83	97	81	-16
0022	2F	5_12	13	126	28	12600	6110	-6490	0.22	0.48	22	10	-12
0022	2F	5_12	14	35	8	3500	2730	-770	0.23	0.78	6	4	-2
0022	2F	5_12	15	3	0	300	0	-300	0.00	0.00	0	0	0
0022	2F	5_12	16	1	1	100	610	510	1.00	6.10	0	1	1
0022	2F	5_12	24	1	0	100	0	-100	0.00	0.00	0	0	0
0022	2F	5_2	12	301	91	30100	23660	-6440	0.30	0.79	53	41	-12
0022	2F	5_2	13	117	24	11700	6540	-5160	0.21	0.56	20	11	-9
0022	2F	5_2	14	109	36	10900	9910	-990	0.33	0.91	19	17	-2
0022	2F	5_2	15	36	4	3600	1340	-2260	0.11	0.37	6	2	-4
0022	2F	5_2	16	13	3	1300	1080	-220	0.23	0.83	2	1	-1
0022	2F	5_2	23	5	2	500	1460	960	0.40	2.92	0	2	2
0022	2F	5_2	24	4	0	400	0	-400	0.00	0.00	0	0	0
0022	2F	5_2	25	4	0	400	0	-400	0.00	0.00	0	0	0
0022	2F	5_3	12	222	63	22200	19800	-2400	0.28	0.89	39	35	-4
0022	2F	5_3	13	164	53	16400	13150	-3250	0.32	0.80	29	23	-6
0022	2F	5_3	14	68	21	6800	6730	-70	0.31	0.99	12	11	-1
0022	2F	5_3	15	43	5	4300	1850	-2450	0.12	0.43	7	3	-4
0022	2F	5_3	16	26	2	2600	810	-1790	0.08	0.31	4	1	-3
0022	2F	5_3	23	7	3	700	1140	440	0.43	1.63	1	2	1
0022	2F	5_3	24	8	1	800	170	-630	0.13	0.21	1	0	-1
0022	2F	5_3	25	6	0	600	0	-600	0.00	0.00	1	0	-1
0022	2F	5_3	26	4	0	400	0	-400	0.00	0.00	0	0	0
0022	2F	5_4	12	265	88	26500	22530	-3970	0.33	0.85	46	39	-7
0022	2F	5_4	13	113	31	11300	7770	-3530	0.27	0.69	20	13	-7
0022	2F	5_4	14	92	22	9200	6260	-2940	0.24	0.68	16	11	-5
0022	2F	5_4	15	30	4	3000	2310	-690	0.13	0.77	5	4	-1
0022	2F	5_4	16	25	2	2500	730	-1770	0.08	0.29	4	1	-3
0022	2F	5_4	23	3	0	300	0	-300	0.00	0.00	0	0	0
0022	2F	5_4	24	7	1	700	340	-360	0.14	0.49	1	0	-1
0022	2F	5_4	25	6	0	600	0	-600	0.00	0.00	1	0	-1
0022	2F	5_4	26	12	0	1200	0	-1200	0.00	0.00	2	0	-2
0022	2F	5_5	12	316	122	31600	26310	-5290	0.39	0.83	55	46	-9
0022	2F	5_5	13	124	43	12400	10460	-1940	0.35	0.84	21	18	-3
0022	2F	5_5	14	115	33	11500	9730	-1770	0.29	0.85	20	17	-3
0022	2F	5_5	15	28	9	2800	3150	350	0.32	1.13	4	5	1
0022	2F	5_5	16	26	8	2600	3530	930	0.31	1.36	4	6	2
0022	2F	5_5	23	7	1	700	1220	520	0.14	1.74	1	2	1
0022	2F	5_5	24	5	0	500	0	-500	0.00	0.00	0	0	0
0022	2F	5_5	25	1	0	100	0	-100	0.00	0.00	0	0	0
0022	2F	5_5	26	2	0	200	0	-200	0.00	0.00	0	0	0
0022	2F	5_6	12	261	79	26100	22090	-4010	0.30	0.85	46	39	-7
0022	2F	5_6	13	159	61	15900	14320	-1580	0.38	0.90	28	25	-3
0022	2F	5_6	14	88	27	8800	6330	-2470	0.31	0.72	15	11	-4
0022	2F	5_6	15	33	6	3300	2520	-780	0.18	0.76	5	4	-1
0022	2F	5_6	16	27	8	2700	2440	-260	0.30	0.90	4	4	0
0022	2F	5_6	23	10	0	1000	0	-1000	0.00	0.00	1	0	-1
0022	2F	5_6	24	4	2	400	960	560	0.50	2.40	0	1	1
0022	2F	5_6	25	4	1	400	460	60	0.25	1.15	0	0	0
0022	2F	5_6	26	10	2	1000	1220	220	0.20	1.22	1	2	1
0022	2F	5_7	12	269	96	26900	25850	-1050	0.36	0.96	47	45	-2
0022	2F	5_7	13	162	67	16200	14560	-1640	0.41	0.90	28	25	-3
0022	2F	5_7	14	129	42	12900	9100	-3800	0.33	0.71	22	16	-6
0022	2F	5_7	15	31	7	3100	1890	-1210	0.23	0.61	5	3	-2
0022	2F	5_7	16	21	9	2100	2260	160	0.43	1.08	3	4	1
0022	2F	5_7	23	4	0	400	0	-400	0.00	0.00	0	0	0
0022	2F	5_7	24	4	1	400	770	370	0.25	1.93	0	1	1
0022	2F	5_7	26	6	0	600	0	-600	0.00	0.00	1	0	-1
0022	2F	5_8	12	249	90	24900	21710	-3190	0.36	0.87	44	38	-6
0022	2F	5_8	13	147	57	14700	12940	-1760	0.39	0.88	26	22	-4
0022	2F	5_8	14	135	44	13500	9340	-4160	0.33	0.69	23	16	-7
0022	2F	5_8	15	54	14	5400	3470	-1930	0.26	0.64	9	6	-3
0022	2F	5_8	16	27	5	2700	1410	-1290	0.19	0.52	4	2	-2
0022	2F	5_8	23	6	1	600	480	-120	0.17	0.80	1	0	-1
0022	2F	5_8	24	1	0	100	0	-100	0.00	0.00	0	0	0
0022	2F	5_8	25	4	0	400	0	-400	0.00	0.00	0	0	0
0022	2F	5_8	26	4	1	400	300	-100	0.25	0.75	0	0	0
0022	2F	5_9	12	385	144	38500	33920	-4580	0.37	0.88	68	60	-8
0022	2F	5_9	13	146	45	14600	11930	-2670	0.31	0.82	25	21	-4
0022	2F	5_9	14	100	37	10000	8960	-1040	0.37	0.90	17	15	-2
0022	2F	5_9	15	17	3	1700	1460	-240	0.18	0.86	3	2	-1
0022	2F	5_9	16	22	2	2200	770	-1430	0.09	0.35	3	1	-2
0022	2F	5_9	23	1	0	100	0	-100	0.00	0.00	0	0	0
0022	2F	5_9	24	2	0	200	0	-200	0.00	0.00	0	0	0
0022	2F	5_9	26	1	0	100	0	-100	0.00	0.00	0	0	0
0022	2F	6_1	12	26	11	2600	2510	-90	0.42	0.97	4	4	0
0022	2F	6_1	13	10	2	1000	760	-240	0.20	0.76	1	1	0
0022	2F	6_1	14	8	0	800	0	-800	0.00	0.00	1	0	-1
0022	2F	6_1	15	3	1	300	1100	800	0.33	3.67	0	1	1
0022	2F	6_1	16	1	0	100	0	-100	0.00	0.00	0	0	0
0022	2F	6_1	23	2	0	200	0	-200	0.00	0.00	0	0	0
0022	2F	6_10	12	47	21	4700	4450	-250	0.45	0.95	8	7	-1
0022	2F	6_10	13	6	3	600	690	90	0.50	1.15	1	1	0
0022	2F	6_10	14	1	0	100	0	-100	0.00	0.00	0	0	0
0022	2F	6_11	12	51	19	5100	3250	-1850	0.37	0.64	9	5	-4
0022	2F	6_11	13	6	1	600	120	-480	0.17	0.20	1	0	-1
0022	2F	6_12	12	44	16	4400	3320	-1080	0.36	0.75	7	5	-2
0022	2F	6_12	13	10	2	1000	410	-590	0.20	0.41	1	0	-1
0022	2F	6_12	14	4	2	400	480	80	0.50	1.20	0	0	0
0022	2F	6_2	12	20	9	2000	2180	180	0.45	1.09	3	3	0
0022	2F	6_2	13	7	1	700	200	-500	0.14	0.29	1	0	-1
0022	2F	6_2	14	11	1	1100	250	-850	0.09	0.23	1	0	-1
0022	2F	6_2	15	1	1	100	270	170	1.00	2.70	0	0	0
0022	2F	6_2	16	3	0	300	0	-300	0.00	0.00	0	0	0
0022	2F	6_3	12	14	5	1400	2030	630	0.36	1.45	2	3	1
0022	2F	6_3	13	18	5	1800	1180	-620	0.28	0.66	3	2	-1
0022	2F	6_3	14	9	1	900	340	-560	0.11	0.38	1	0	-1
0022	2F	6_3	15	2	0	200	0	-200	0.00	0.00	0	0	0
0022	2F	6_3	16	4	0	400	0	-400	0.00	0.00	0	0	0
0022	2F	6_3	23	1	0	100	0	-100	0.00	0.00	0	0	0
0022	2F	6_3	26	1	0	100	0	-100	0.00	0.00	0	0	0
0022	2F	6_4	12	23	8	2300	1840	-460	0.35	0.80	4	3	-1
0022	2F	6_4	13	10	1	1000	210	-790	0.10	0.21	1	0	-1
0022	2F	6_4	14	9	3	900	1690	790	0.33	1.88	1	2	1
0022	2F	6_4	15	6	1	600	310	-290	0.17	0.52	1	0	-1
0022	2F	6_4	16	2	1	200	310	110	0.50	1.55	0	0	0
0022	2F	6_5	12	25	9	2500	2960	460	0.36	1.18	4	5	1
0022	2F	6_5	13	12	8	1200	1680	480	0.67	1.40	2	2	0
0022	2F	6_5	14	12	4	1200	720	-480	0.33	0.60	2	1	-1
0022	2F	6_5	15	1	0	100	0	-100	0.00	0.00	0	0	0
0022	2F	6_5	16	2	0	200	0	-200	0.00	0.00	0	0	0
0022	2F	6_6	12	19	7	1900	1810	-90	0.37	0.95	3	3	0
0022	2F	6_6	13	11	7	1100	1760	660	0.64	1.60	1	3	2
0022	2F	6_6	14	11	1	1100	170	-930	0.09	0.15	1	0	-1
0022	2F	6_6	15	2	1	200	350	150	0.50	1.75	0	0	0
0022	2F	6_6	16	5	2	500	670	170	0.40	1.34	0	1	1
0022	2F	6_6	25	1	0	100	0	-100	0.00	0.00	0	0	0
0022	2F	6_7	12	21	4	2100	1660	-440	0.19	0.79	3	2	-1
0022	2F	6_7	13	12	3	1200	800	-400	0.25	0.67	2	1	-1
0022	2F	6_7	14	13	2	1300	300	-1000	0.15	0.23	2	0	-2
0022	2F	6_7	16	5	1	500	600	100	0.20	1.20	0	1	1
0022	2F	6_8	12	24	8	2400	3170	770	0.33	1.32	4	5	1
0022	2F	6_8	13	14	7	1400	1680	280	0.50	1.20	2	2	0
0022	2F	6_8	14	10	4	1000	950	-50	0.40	0.95	1	1	0
0022	2F	6_8	15	3	0	300	0	-300	0.00	0.00	0	0	0
0022	2F	6_8	16	3	1	300	530	230	0.33	1.77	0	0	0
0022	2F	6_9	12	32	10	3200	1910	-1290	0.31	0.60	5	3	-2
0022	2F	6_9	13	16	4	1600	930	-670	0.25	0.58	2	1	-1
0022	2F	6_9	14	7	2	700	710	10	0.29	1.01	1	1	0
0022	2F	6_9	15	1	0	100	0	-100	0.00	0.00	0	0	0
0022	2F	7_1	12	667	216	66700	55430	-11270	0.32	0.83	118	98	-20
0022	2F	7_1	13	215	62	21500	17870	-3630	0.29	0.83	38	31	-7
0022	2F	7_1	14	144	48	14400	14060	-340	0.33	0.98	25	24	-1
0022	2F	7_1	15	25	4	2500	1590	-910	0.16	0.64	4	2	-2
0022	2F	7_1	16	19	5	1900	3890	1990	0.26	2.05	3	6	3
0022	2F	7_1	23	9	2	900	810	-90	0.22	0.90	1	1	0
0022	2F	7_1	24	4	0	400	0	-400	0.00	0.00	0	0	0
0022	2F	7_1	25	2	0	200	0	-200	0.00	0.00	0	0	0
0022	2F	7_10	12	771	266	77100	62590	-14510	0.35	0.81	136	110	-26
0022	2F	7_10	13	212	57	21200	16080	-5120	0.27	0.76	37	28	-9
0022	2F	7_10	14	82	13	8200	3460	-4740	0.16	0.42	14	6	-8
0022	2F	7_10	15	18	3	1800	890	-910	0.17	0.49	3	1	-2
0022	2F	7_10	16	5	1	500	1770	1270	0.20	3.54	0	3	3
0022	2F	7_10	23	2	0	200	0	-200	0.00	0.00	0	0	0
0022	2F	7_10	24	3	1	300	650	350	0.33	2.17	0	1	1
0022	2F	7_10	25	1	0	100	0	-100	0.00	0.00	0	0	0
0022	2F	7_10	26	1	0	100	0	-100	0.00	0.00	0	0	0
0022	2F	7_11	12	750	280	75000	61610	-13390	0.37	0.82	132	109	-23
0022	2F	7_11	13	224	72	22400	19570	-2830	0.32	0.87	39	34	-5
0022	2F	7_11	14	58	7	5800	2010	-3790	0.12	0.35	10	3	-7
0022	2F	7_11	15	10	2	1000	1860	860	0.20	1.86	1	3	2
0022	2F	7_11	16	6	1	600	1900	1300	0.17	3.17	1	3	2
0022	2F	7_11	23	1	0	100	0	-100	0.00	0.00	0	0	0
0022	2F	7_11	24	2	0	200	0	-200	0.00	0.00	0	0	0
0022	2F	7_11	25	1	0	100	0	-100	0.00	0.00	0	0	0
0022	2F	7_12	12	976	309	97600	72020	-25580	0.32	0.74	172	127	-45
0022	2F	7_12	13	88	19	8800	5600	-3200	0.22	0.64	15	9	-6
0022	2F	7_12	14	1	0	100	0	-100	0.00	0.00	0	0	0
0022	2F	7_12	15	3	1	300	630	330	0.33	2.10	0	1	1
0022	2F	7_2	12	544	177	54400	45580	-8820	0.33	0.84	96	80	-16
0022	2F	7_2	13	185	47	18500	14680	-3820	0.25	0.79	32	25	-7
0022	2F	7_2	14	158	35	15800	10370	-5430	0.22	0.66	27	18	-9
0022	2F	7_2	15	39	7	3900	3230	-670	0.18	0.83	6	5	-1
0022	2F	7_2	16	19	3	1900	960	-940	0.16	0.51	3	1	-2
0022	2F	7_2	23	16	5	1600	2190	590	0.31	1.37	2	3	1
0022	2F	7_2	24	6	2	600	890	290	0.33	1.48	1	1	0
0022	2F	7_2	25	2	0	200	0	-200	0.00	0.00	0	0	0
0022	2F	7_2	26	3	1	300	600	300	0.33	2.00	0	1	1
0022	2F	7_3	12	419	131	41900	38010	-3890	0.31	0.91	74	67	-7
0022	2F	7_3	13	269	89	26900	22500	-4400	0.33	0.84	47	39	-8
0022	2F	7_3	14	142	36	14200	11890	-2310	0.25	0.84	25	21	-4
0022	2F	7_3	15	46	11	4600	4440	-160	0.24	0.97	8	7	-1
0022	2F	7_3	16	31	6	3100	2430	-670	0.19	0.78	5	4	-1
0022	2F	7_3	23	22	3	2200	1070	-1130	0.14	0.49	3	1	-2
0022	2F	7_3	24	15	1	1500	240	-1260	0.07	0.16	2	0	-2
0022	2F	7_3	25	6	0	600	0	-600	0.00	0.00	1	0	-1
0022	2F	7_3	26	5	0	500	0	-500	0.00	0.00	0	0	0
0022	2F	7_4	12	487	166	48700	41370	-7330	0.34	0.85	86	73	-13
0022	2F	7_4	13	203	54	20300	13990	-6310	0.27	0.69	35	24	-11
0022	2F	7_4	14	180	38	18000	12770	-5230	0.21	0.71	31	22	-9
0022	2F	7_4	15	46	10	4600	5000	400	0.22	1.09	8	8	0
0022	2F	7_4	16	32	8	3200	2410	-790	0.25	0.75	5	4	-1
0022	2F	7_4	23	14	2	1400	1490	90	0.14	1.06	2	2	0
0022	2F	7_4	24	14	3	1400	1080	-320	0.21	0.77	2	1	-1
0022	2F	7_4	25	7	1	700	550	-150	0.14	0.79	1	0	-1
0022	2F	7_4	26	11	4	1100	4100	3000	0.36	3.73	1	7	6
0022	2F	7_5	12	534	190	53400	43300	-10100	0.36	0.81	94	76	-18
0022	2F	7_5	13	203	64	20300	15120	-5180	0.32	0.74	35	26	-9
0022	2F	7_5	14	155	46	15500	12860	-2640	0.30	0.83	27	22	-5
0022	2F	7_5	15	49	8	4900	3410	-1490	0.16	0.70	8	6	-2
0022	2F	7_5	16	46	9	4600	2590	-2010	0.20	0.56	8	4	-4
0022	2F	7_5	23	5	1	500	730	230	0.20	1.46	0	1	1
0022	2F	7_5	24	7	2	700	1090	390	0.29	1.56	1	1	0
0022	2F	7_5	25	8	1	800	290	-510	0.13	0.36	1	0	-1
0022	2F	7_5	26	9	1	900	1090	190	0.11	1.21	1	1	0
0022	2F	7_6	12	412	145	41200	34790	-6410	0.35	0.84	72	61	-11
0022	2F	7_6	13	261	89	26100	21320	-4780	0.34	0.82	46	37	-9
0022	2F	7_6	14	172	51	17200	11410	-5790	0.30	0.66	30	20	-10
0022	2F	7_6	15	61	14	6100	5050	-1050	0.23	0.83	10	8	-2
0022	2F	7_6	16	44	6	4400	2600	-1800	0.14	0.59	7	4	-3
0022	2F	7_6	23	12	4	1200	1120	-80	0.33	0.93	2	1	-1
0022	2F	7_6	24	12	2	1200	880	-320	0.17	0.73	2	1	-1
0022	2F	7_6	25	9	0	900	0	-900	0.00	0.00	1	0	-1
0022	2F	7_6	26	13	1	1300	620	-680	0.08	0.48	2	1	-1
0022	2F	7_7	12	485	180	48500	44870	-3630	0.37	0.93	85	79	-6
0022	2F	7_7	13	249	88	24900	23210	-1690	0.35	0.93	44	41	-3
0022	2F	7_7	14	174	48	17400	10610	-6790	0.28	0.61	30	18	-12
0022	2F	7_7	15	70	11	7000	3570	-3430	0.16	0.51	12	6	-6
0022	2F	7_7	16	57	18	5700	5870	170	0.32	1.03	10	10	0
0022	2F	7_7	23	3	0	300	0	-300	0.00	0.00	0	0	0
0022	2F	7_7	24	3	0	300	0	-300	0.00	0.00	0	0	0
0022	2F	7_7	25	2	0	200	0	-200	0.00	0.00	0	0	0
0022	2F	7_7	26	9	2	900	920	20	0.22	1.02	1	1	0
0022	2F	7_8	12	565	199	56500	50740	-5760	0.35	0.90	100	89	-11
0022	2F	7_8	13	263	81	26300	20980	-5320	0.31	0.80	46	37	-9
0022	2F	7_8	14	155	38	15500	9100	-6400	0.25	0.59	27	16	-11
0022	2F	7_8	15	49	14	4900	3940	-960	0.29	0.80	8	6	-2
0022	2F	7_8	16	32	8	3200	4080	880	0.25	1.28	5	7	2
0022	2F	7_8	23	7	1	700	210	-490	0.14	0.30	1	0	-1
0022	2F	7_8	24	1	0	100	0	-100	0.00	0.00	0	0	0
0022	2F	7_8	25	4	1	400	250	-150	0.25	0.63	0	0	0
0022	2F	7_8	26	4	1	400	1230	830	0.25	3.08	0	2	2
0022	2F	7_9	12	557	180	55700	46840	-8860	0.32	0.84	98	82	-16
0022	2F	7_9	13	294	88	29400	23020	-6380	0.30	0.78	52	40	-12
0022	2F	7_9	14	158	29	15800	7690	-8110	0.18	0.49	27	13	-14
0022	2F	7_9	15	54	14	5400	6520	1120	0.26	1.21	9	11	2
0022	2F	7_9	16	25	2	2500	1650	-850	0.08	0.66	4	2	-2
0022	2F	7_9	23	3	1	300	570	270	0.33	1.90	0	1	1
0022	2F	7_9	24	1	0	100	0	-100	0.00	0.00	0	0	0
0022	2F	7_9	25	1	0	100	0	-100	0.00	0.00	0	0	0
0022	2F	7_9	26	2	0	200	0	-200	0.00	0.00	0	0	0
0022	2T	1_1	12	414	92	41400	31660	-9740	0.22	0.76	73	56	-17
0022	2T	1_1	13	248	44	24800	15810	-8990	0.18	0.64	43	27	-16
0022	2T	1_1	14	217	49	21700	17780	-3920	0.23	0.82	38	31	-7
0022	2T	1_1	15	61	7	6100	5320	-780	0.11	0.87	10	9	-1
0022	2T	1_10	12	688	158	68800	51880	-16920	0.23	0.75	121	91	-30
0022	2T	1_10	13	330	78	33000	25540	-7460	0.24	0.77	58	45	-13
0022	2T	1_10	14	82	14	8200	5500	-2700	0.17	0.67	14	9	-5
0022	2T	1_10	15	11	1	1100	460	-640	0.09	0.42	1	0	-1
0022	2T	1_10	16	4	0	400	0	-400	0.00	0.00	0	0	0
0022	2T	1_10	23	1	0	100	0	-100	0.00	0.00	0	0	0
0022	2T	1_10	25	1	0	100	0	-100	0.00	0.00	0	0	0
0022	2T	1_10	26	1	0	100	0	-100	0.00	0.00	0	0	0
0022	2T	1_11	12	794	198	79400	67100	-12300	0.25	0.85	140	118	-22
0022	2T	1_11	13	271	56	27100	18120	-8980	0.21	0.67	47	32	-15
0022	2T	1_11	14	77	11	7700	3830	-3870	0.14	0.50	13	6	-7
0022	2T	1_11	15	8	1	800	340	-460	0.13	0.43	1	0	-1
0022	2T	1_12	12	1084	271	108400	90300	-18100	0.25	0.83	191	159	-32
0022	2T	1_12	13	25	5	2500	1860	-640	0.20	0.74	4	3	-1
0022	2T	1_12	14	3	1	300	380	80	0.33	1.27	0	0	0
0022	2T	1_2	12	397	89	39700	34540	-5160	0.22	0.87	70	61	-9
0022	2T	1_2	13	202	34	20200	18100	-2100	0.17	0.90	35	32	-3
0022	2T	1_2	14	140	12	14000	8420	-5580	0.09	0.60	24	14	-10
0022	2T	1_2	15	45	9	4500	4000	-500	0.20	0.89	7	7	0
0022	2T	1_2	16	5	0	500	0	-500	0.00	0.00	0	0	0
0022	2T	1_2	21	16	4	1600	2170	570	0.25	1.36	2	3	1
0022	2T	1_2	23	1	0	100	0	-100	0.00	0.00	0	0	0
0022	2T	1_2	24	3	0	300	0	-300	0.00	0.00	0	0	0
0022	2T	1_2	25	2	0	200	0	-200	0.00	0.00	0	0	0
0022	2T	1_3	12	449	66	44900	36600	-8300	0.15	0.82	79	64	-15
0022	2T	1_3	13	344	67	34400	23690	-10710	0.19	0.69	60	41	-19
0022	2T	1_3	14	134	24	13400	15390	1990	0.18	1.15	23	27	4
0022	2T	1_3	15	18	2	1800	1110	-690	0.11	0.62	3	1	-2
0022	2T	1_3	16	12	4	1200	2770	1570	0.33	2.31	2	4	2
0022	2T	1_3	21	1	0	100	0	-100	0.00	0.00	0	0	0
0022	2T	1_3	23	2	0	200	0	-200	0.00	0.00	0	0	0
0022	2T	1_3	24	5	0	500	0	-500	0.00	0.00	0	0	0
0022	2T	1_4	12	573	110	57300	50150	-7150	0.19	0.88	101	88	-13
0022	2T	1_4	13	250	36	25000	14650	-10350	0.14	0.59	44	25	-19
0022	2T	1_4	14	110	19	11000	11550	550	0.17	1.05	19	20	1
0022	2T	1_4	15	6	2	600	830	230	0.33	1.38	1	1	0
0022	2T	1_4	16	40	5	4000	2020	-1980	0.13	0.51	7	3	-4
0022	2T	1_4	23	8	0	800	0	-800	0.00	0.00	1	0	-1
0022	2T	1_4	24	2	0	200	0	-200	0.00	0.00	0	0	0
0022	2T	1_4	26	2	0	200	0	-200	0.00	0.00	0	0	0
0022	2T	1_5	12	568	131	56800	45030	-11770	0.23	0.79	100	79	-21
0022	2T	1_5	13	215	57	21500	19240	-2260	0.27	0.89	38	34	-4
0022	2T	1_5	14	117	24	11700	9700	-2000	0.21	0.83	20	17	-3
0022	2T	1_5	15	14	1	1400	550	-850	0.07	0.39	2	0	-2
0022	2T	1_5	16	30	6	3000	4150	1150	0.20	1.38	5	7	2
0022	2T	1_5	21	1	0	100	0	-100	0.00	0.00	0	0	0
0022	2T	1_5	23	8	3	800	1340	540	0.38	1.68	1	2	1
0022	2T	1_5	24	9	0	900	0	-900	0.00	0.00	1	0	-1
0022	2T	1_5	25	1	0	100	0	-100	0.00	0.00	0	0	0
0022	2T	1_5	26	2	0	200	0	-200	0.00	0.00	0	0	0
0022	2T	1_6	12	385	87	38500	33710	-4790	0.23	0.88	68	59	-9
0022	2T	1_6	13	189	34	18900	14880	-4020	0.18	0.79	33	26	-7
0022	2T	1_6	14	100	24	10000	10820	820	0.24	1.08	17	19	2
0022	2T	1_6	15	28	5	2800	2030	-770	0.18	0.73	4	3	-1
0022	2T	1_6	16	56	3	5600	2280	-3320	0.05	0.41	9	4	-5
0022	2T	1_6	21	6	0	600	0	-600	0.00	0.00	1	0	-1
0022	2T	1_6	23	19	2	1900	2530	630	0.11	1.33	3	4	1
0022	2T	1_6	24	14	1	1400	1020	-380	0.07	0.73	2	1	-1
0022	2T	1_6	25	14	1	1400	370	-1030	0.07	0.26	2	0	-2
0022	2T	1_6	26	20	2	2000	1100	-900	0.10	0.55	3	1	-2
0022	2T	1_7	12	327	60	32700	24240	-8460	0.18	0.74	57	42	-15
0022	2T	1_7	13	235	53	23500	17230	-6270	0.23	0.73	41	30	-11
0022	2T	1_7	14	125	35	12500	10590	-1910	0.28	0.85	22	18	-4
0022	2T	1_7	15	28	5	2800	3010	210	0.18	1.08	4	5	1
0022	2T	1_7	16	51	11	5100	4750	-350	0.22	0.93	9	8	-1
0022	2T	1_7	21	3	0	300	0	-300	0.00	0.00	0	0	0
0022	2T	1_7	23	13	7	1300	4060	2760	0.54	3.12	2	7	5
0022	2T	1_7	24	18	3	1800	2250	450	0.17	1.25	3	3	0
0022	2T	1_7	25	6	0	600	0	-600	0.00	0.00	1	0	-1
0022	2T	1_7	26	17	3	1700	1680	-20	0.18	0.99	3	2	-1
0022	2T	1_8	12	382	94	38200	32860	-5340	0.25	0.86	67	58	-9
0022	2T	1_8	13	197	54	19700	16830	-2870	0.27	0.85	34	29	-5
0022	2T	1_8	14	119	28	11900	10640	-1260	0.24	0.89	21	18	-3
0022	2T	1_8	15	54	5	5400	1570	-3830	0.09	0.29	9	2	-7
0022	2T	1_8	16	32	5	3200	2970	-230	0.16	0.93	5	5	0
0022	2T	1_8	21	14	0	1400	0	-1400	0.00	0.00	2	0	-2
0022	2T	1_8	23	6	2	600	800	200	0.33	1.33	1	1	0
0022	2T	1_8	24	8	0	800	0	-800	0.00	0.00	1	0	-1
0022	2T	1_8	25	3	0	300	0	-300	0.00	0.00	0	0	0
0022	2T	1_8	26	6	0	600	0	-600	0.00	0.00	1	0	-1
0022	2T	1_9	12	511	115	51100	38810	-12290	0.23	0.76	90	68	-22
0022	2T	1_9	13	228	46	22800	14970	-7830	0.20	0.66	40	26	-14
0022	2T	1_9	14	169	37	16900	12690	-4210	0.22	0.75	29	22	-7
0022	2T	1_9	15	24	1	2400	260	-2140	0.04	0.11	4	0	-4
0022	2T	1_9	16	22	2	2200	720	-1480	0.09	0.33	3	1	-2
0022	2T	1_9	21	16	1	1600	730	-870	0.06	0.46	2	1	-1
0022	2T	1_9	23	8	1	800	570	-230	0.13	0.71	1	1	0
0022	2T	1_9	24	7	2	700	1070	370	0.29	1.53	1	1	0
0022	2T	1_9	25	3	0	300	0	-300	0.00	0.00	0	0	0
0022	2T	1_9	26	3	0	300	0	-300	0.00	0.00	0	0	0
0022	2T	2_1	12	523	142	52300	41660	-10640	0.27	0.80	92	73	-19
0022	2T	2_1	13	203	36	20300	9860	-10440	0.18	0.49	35	17	-18
0022	2T	2_1	14	160	37	16000	10780	-5220	0.23	0.67	28	19	-9
0022	2T	2_1	15	30	2	3000	870	-2130	0.07	0.29	5	1	-4
0022	2T	2_1	16	15	4	1500	3040	1540	0.27	2.03	2	5	3
0022	2T	2_1	21	1	0	100	0	-100	0.00	0.00	0	0	0
0022	2T	2_1	23	4	1	400	430	30	0.25	1.08	0	0	0
0022	2T	2_1	24	1	0	100	0	-100	0.00	0.00	0	0	0
0022	2T	2_1	25	1	0	100	0	-100	0.00	0.00	0	0	0
0022	2T	2_1	26	3	0	300	0	-300	0.00	0.00	0	0	0
0022	2T	2_10	12	614	130	61400	44660	-16740	0.21	0.73	108	79	-29
0022	2T	2_10	13	300	77	30000	26110	-3890	0.26	0.87	53	46	-7
0022	2T	2_10	14	110	31	11000	12510	1510	0.28	1.14	19	22	3
0022	2T	2_10	15	24	4	2400	1940	-460	0.17	0.81	4	3	-1
0022	2T	2_10	16	29	7	2900	5620	2720	0.24	1.94	5	9	4
0022	2T	2_10	21	4	0	400	0	-400	0.00	0.00	0	0	0
0022	2T	2_10	23	1	1	100	300	200	1.00	3.00	0	0	0
0022	2T	2_10	24	2	1	200	220	20	0.50	1.10	0	0	0
0022	2T	2_10	25	1	0	100	0	-100	0.00	0.00	0	0	0
0022	2T	2_10	26	3	0	300	0	-300	0.00	0.00	0	0	0
0022	2T	2_11	12	703	161	70300	56070	-14230	0.23	0.80	124	99	-25
0022	2T	2_11	13	287	68	28700	21610	-7090	0.24	0.75	50	38	-12
0022	2T	2_11	14	121	27	12100	8660	-3440	0.22	0.72	21	15	-6
0022	2T	2_11	15	17	3	1700	1230	-470	0.18	0.72	3	2	-1
0022	2T	2_11	16	5	0	500	0	-500	0.00	0.00	0	0	0
0022	2T	2_12	12	863	224	86300	72140	-14160	0.26	0.84	152	127	-25
0022	2T	2_12	13	200	52	20000	16870	-3130	0.26	0.84	35	29	-6
0022	2T	2_12	14	75	18	7500	6130	-1370	0.24	0.82	13	10	-3
0022	2T	2_12	15	8	4	800	1580	780	0.50	1.98	1	2	1
0022	2T	2_12	16	2	0	200	0	-200	0.00	0.00	0	0	0
0022	2T	2_2	12	398	82	39800	36240	-3560	0.21	0.91	70	64	-6
0022	2T	2_2	13	182	30	18200	12170	-6030	0.16	0.67	32	21	-11
0022	2T	2_2	14	156	22	15600	8510	-7090	0.14	0.55	27	15	-12
0022	2T	2_2	15	53	3	5300	800	-4500	0.06	0.15	9	1	-8
0022	2T	2_2	16	47	9	4700	4600	-100	0.19	0.98	8	8	0
0022	2T	2_2	21	2	1	200	900	700	0.50	4.50	0	1	1
0022	2T	2_2	23	14	2	1400	760	-640	0.14	0.54	2	1	-1
0022	2T	2_2	24	3	1	300	510	210	0.33	1.70	0	0	0
0022	2T	2_2	25	3	1	300	320	20	0.33	1.07	0	0	0
0022	2T	2_2	26	5	1	500	710	210	0.20	1.42	0	1	1
0022	2T	2_3	12	305	53	30500	21370	-9130	0.17	0.70	53	37	-16
0022	2T	2_3	13	306	67	30600	26310	-4290	0.22	0.86	54	46	-8
0022	2T	2_3	14	75	13	7500	6820	-680	0.17	0.91	13	12	-1
0022	2T	2_3	15	57	9	5700	4780	-920	0.16	0.84	10	8	-2
0022	2T	2_3	16	54	4	5400	3040	-2360	0.07	0.56	9	5	-4
0022	2T	2_3	21	1	0	100	0	-100	0.00	0.00	0	0	0
0022	2T	2_3	23	12	2	1200	850	-350	0.17	0.71	2	1	-1
0022	2T	2_3	24	14	1	1400	520	-880	0.07	0.37	2	0	-2
0022	2T	2_3	25	8	1	800	430	-370	0.13	0.54	1	0	-1
0022	2T	2_3	26	16	0	1600	0	-1600	0.00	0.00	2	0	-2
0022	2T	2_4	12	420	94	42000	27840	-14160	0.22	0.66	74	49	-25
0022	2T	2_4	13	189	50	18900	18860	-40	0.26	1.00	33	33	0
0022	2T	2_4	14	114	20	11400	8670	-2730	0.18	0.76	20	15	-5
0022	2T	2_4	15	54	6	5400	4190	-1210	0.11	0.78	9	7	-2
0022	2T	2_4	16	56	5	5600	5670	70	0.09	1.01	9	10	1
0022	2T	2_4	21	6	1	600	890	290	0.17	1.48	1	1	0
0022	2T	2_4	23	7	0	700	0	-700	0.00	0.00	1	0	-1
0022	2T	2_4	24	7	2	700	710	10	0.29	1.01	1	1	0
0022	2T	2_4	25	4	0	400	0	-400	0.00	0.00	0	0	0
0022	2T	2_4	26	10	1	1000	630	-370	0.10	0.63	1	1	0
0022	2T	2_5	12	485	142	48500	42570	-5930	0.29	0.88	85	75	-10
0022	2T	2_5	13	200	43	20000	16560	-3440	0.22	0.83	35	29	-6
0022	2T	2_5	14	133	32	13300	10150	-3150	0.24	0.76	23	17	-6
0022	2T	2_5	15	35	5	3500	2940	-560	0.14	0.84	6	5	-1
0022	2T	2_5	16	39	9	3900	3970	70	0.23	1.02	6	7	1
0022	2T	2_5	21	5	0	500	0	-500	0.00	0.00	0	0	0
0022	2T	2_5	23	5	1	500	530	30	0.20	1.06	0	0	0
0022	2T	2_5	24	6	2	600	1250	650	0.33	2.08	1	2	1
0022	2T	2_5	25	3	1	300	550	250	0.33	1.83	0	0	0
0022	2T	2_5	26	17	1	1700	740	-960	0.06	0.44	3	1	-2
0022	2T	2_6	12	352	56	35200	24090	-11110	0.16	0.68	62	42	-20
0022	2T	2_6	13	215	57	21500	21780	280	0.27	1.01	38	38	0
0022	2T	2_6	14	88	13	8800	5180	-3620	0.15	0.59	15	9	-6
0022	2T	2_6	15	51	7	5100	2790	-2310	0.14	0.55	9	4	-5
0022	2T	2_6	16	59	8	5900	3870	-2030	0.14	0.66	10	6	-4
0022	2T	2_6	21	7	3	700	2280	1580	0.43	3.26	1	4	3
0022	2T	2_6	23	6	1	600	220	-380	0.17	0.37	1	0	-1
0022	2T	2_6	24	10	1	1000	440	-560	0.10	0.44	1	0	-1
0022	2T	2_6	25	11	1	1100	360	-740	0.09	0.33	1	0	-1
0022	2T	2_6	26	32	3	3200	1660	-1540	0.09	0.52	5	2	-3
0022	2T	2_7	12	379	75	37900	30180	-7720	0.20	0.80	67	53	-14
0022	2T	2_7	13	219	52	21900	16460	-5440	0.24	0.75	38	29	-9
0022	2T	2_7	14	130	32	13000	11700	-1300	0.25	0.90	23	20	-3
0022	2T	2_7	15	47	7	4700	2540	-2160	0.15	0.54	8	4	-4
0022	2T	2_7	16	58	4	5800	1840	-3960	0.07	0.32	10	3	-7
0022	2T	2_7	21	3	0	300	0	-300	0.00	0.00	0	0	0
0022	2T	2_7	23	11	2	1100	960	-140	0.18	0.87	1	1	0
0022	2T	2_7	24	10	0	1000	0	-1000	0.00	0.00	1	0	-1
0022	2T	2_7	25	11	3	1100	1300	200	0.27	1.18	1	2	1
0022	2T	2_7	26	15	1	1500	450	-1050	0.07	0.30	2	0	-2
0022	2T	2_8	12	341	81	34100	27570	-6530	0.24	0.81	60	48	-12
0022	2T	2_8	13	230	49	23000	15740	-7260	0.21	0.68	40	27	-13
0022	2T	2_8	14	143	44	14300	15100	800	0.31	1.06	25	26	1
0022	2T	2_8	15	75	18	7500	5980	-1520	0.24	0.80	13	10	-3
0022	2T	2_8	16	41	6	4100	3580	-520	0.15	0.87	7	6	-1
0022	2T	2_8	21	4	0	400	0	-400	0.00	0.00	0	0	0
0022	2T	2_8	23	7	3	700	1160	460	0.43	1.66	1	2	1
0022	2T	2_8	24	3	0	300	0	-300	0.00	0.00	0	0	0
0022	2T	2_8	25	4	2	400	2040	1640	0.50	5.10	0	3	3
0022	2T	2_8	26	11	0	1100	0	-1100	0.00	0.00	1	0	-1
0022	2T	2_9	12	463	104	46300	35230	-11070	0.22	0.76	81	62	-19
0022	2T	2_9	13	254	58	25400	19230	-6170	0.23	0.76	44	34	-10
0022	2T	2_9	14	166	36	16600	11110	-5490	0.22	0.67	29	19	-10
0022	2T	2_9	15	36	10	3600	5190	1590	0.28	1.44	6	9	3
0022	2T	2_9	16	27	4	2700	1510	-1190	0.15	0.56	4	2	-2
0022	2T	2_9	21	4	1	400	460	60	0.25	1.15	0	0	0
0022	2T	2_9	23	5	0	500	0	-500	0.00	0.00	0	0	0
0022	2T	2_9	24	9	1	900	1020	120	0.11	1.13	1	1	0
0022	2T	2_9	25	7	0	700	0	-700	0.00	0.00	1	0	-1
0022	2T	2_9	26	7	2	700	1490	790	0.29	2.13	1	2	1
0022	2T	3_1	12	454	130	45400	40560	-4840	0.29	0.89	80	71	-9
0022	2T	3_1	13	205	37	20500	12530	-7970	0.18	0.61	36	22	-14
0022	2T	3_1	14	178	31	17800	14040	-3760	0.17	0.79	31	24	-7
0022	2T	3_1	15	46	8	4600	5620	1020	0.17	1.22	8	9	1
0022	2T	3_1	16	17	3	1700	1570	-130	0.18	0.92	3	2	-1
0022	2T	3_1	21	4	0	400	0	-400	0.00	0.00	0	0	0
0022	2T	3_1	23	2	0	200	0	-200	0.00	0.00	0	0	0
0022	2T	3_1	25	1	0	100	0	-100	0.00	0.00	0	0	0
0022	2T	3_10	12	547	127	54700	42580	-12120	0.23	0.78	96	75	-21
0022	2T	3_10	13	299	76	29900	27480	-2420	0.25	0.92	52	48	-4
0022	2T	3_10	14	103	25	10300	8670	-1630	0.24	0.84	18	15	-3
0022	2T	3_10	15	37	4	3700	1890	-1810	0.11	0.51	6	3	-3
0022	2T	3_10	16	22	4	2200	3660	1460	0.18	1.66	3	6	3
0022	2T	3_10	21	8	1	800	430	-370	0.13	0.54	1	0	-1
0022	2T	3_10	23	4	0	400	0	-400	0.00	0.00	0	0	0
0022	2T	3_10	24	1	0	100	0	-100	0.00	0.00	0	0	0
0022	2T	3_10	25	3	0	300	0	-300	0.00	0.00	0	0	0
0022	2T	3_10	26	4	0	400	0	-400	0.00	0.00	0	0	0
0022	2T	3_11	12	753	201	75300	59990	-15310	0.27	0.80	133	106	-27
0022	2T	3_11	13	272	56	27200	17390	-9810	0.21	0.64	48	30	-18
0022	2T	3_11	14	84	23	8400	7490	-910	0.27	0.89	14	13	-1
0022	2T	3_11	15	21	2	2100	1210	-890	0.10	0.58	3	2	-1
0022	2T	3_11	16	4	0	400	0	-400	0.00	0.00	0	0	0
0022	2T	3_11	21	1	0	100	0	-100	0.00	0.00	0	0	0
0022	2T	3_11	26	1	0	100	0	-100	0.00	0.00	0	0	0
0022	2T	3_12	12	894	235	89400	74650	-14750	0.26	0.84	158	132	-26
0022	2T	3_12	13	182	49	18200	13960	-4240	0.27	0.77	32	24	-8
0022	2T	3_12	14	69	16	6900	4740	-2160	0.23	0.69	12	8	-4
0022	2T	3_12	15	6	1	600	340	-260	0.17	0.57	1	0	-1
0022	2T	3_12	16	3	1	300	560	260	0.33	1.87	0	0	0
0022	2T	3_12	23	1	0	100	0	-100	0.00	0.00	0	0	0
0022	2T	3_2	12	432	89	43200	34760	-8440	0.21	0.80	76	61	-15
0022	2T	3_2	13	181	29	18100	12270	-5830	0.16	0.68	32	21	-11
0022	2T	3_2	14	169	26	16900	13320	-3580	0.15	0.79	29	23	-6
0022	2T	3_2	15	41	4	4100	2510	-1590	0.10	0.61	7	4	-3
0022	2T	3_2	16	19	3	1900	2160	260	0.16	1.14	3	3	0
0022	2T	3_2	21	2	0	200	0	-200	0.00	0.00	0	0	0
0022	2T	3_2	23	5	1	500	1130	630	0.20	2.26	0	2	2
0022	2T	3_2	24	3	0	300	0	-300	0.00	0.00	0	0	0
0022	2T	3_2	25	1	0	100	0	-100	0.00	0.00	0	0	0
0022	2T	3_2	26	4	1	400	1810	1410	0.25	4.53	0	3	3
0022	2T	3_3	12	392	75	39200	35080	-4120	0.19	0.89	69	62	-7
0022	2T	3_3	13	265	56	26500	19940	-6560	0.21	0.75	46	35	-11
0022	2T	3_3	14	84	6	8400	3970	-4430	0.07	0.47	14	7	-7
0022	2T	3_3	15	41	5	4100	3230	-870	0.12	0.79	7	5	-2
0022	2T	3_3	16	38	3	3800	2680	-1120	0.08	0.71	6	4	-2
0022	2T	3_3	23	9	3	900	1740	840	0.33	1.93	1	3	2
0022	2T	3_3	24	9	1	900	1640	740	0.11	1.82	1	2	1
0022	2T	3_3	25	10	0	1000	0	-1000	0.00	0.00	1	0	-1
0022	2T	3_3	26	14	0	1400	0	-1400	0.00	0.00	2	0	-2
0022	2T	3_4	12	377	96	37700	30190	-7510	0.25	0.80	66	53	-13
0022	2T	3_4	13	175	31	17500	10870	-6630	0.18	0.62	30	19	-11
0022	2T	3_4	14	86	8	8600	4790	-3810	0.09	0.56	15	8	-7
0022	2T	3_4	15	40	1	4000	720	-3280	0.03	0.18	7	1	-6
0022	2T	3_4	16	40	4	4000	1890	-2110	0.10	0.47	7	3	-4
0022	2T	3_4	21	9	1	900	650	-250	0.11	0.72	1	1	0
0022	2T	3_4	23	21	2	2100	1120	-980	0.10	0.53	3	1	-2
0022	2T	3_4	24	24	2	2400	830	-1570	0.08	0.35	4	1	-3
0022	2T	3_4	25	10	0	1000	0	-1000	0.00	0.00	1	0	-1
0022	2T	3_4	26	26	3	2600	1560	-1040	0.12	0.60	4	2	-2
0022	2T	3_5	12	440	139	44000	45800	1800	0.32	1.04	77	81	4
0022	2T	3_5	13	161	40	16100	13940	-2160	0.25	0.87	28	24	-4
0022	2T	3_5	14	125	26	12500	8120	-4380	0.21	0.65	22	14	-8
0022	2T	3_5	15	33	4	3300	1900	-1400	0.12	0.58	5	3	-2
0022	2T	3_5	16	36	5	3600	2700	-900	0.14	0.75	6	4	-2
0022	2T	3_5	21	10	0	1000	0	-1000	0.00	0.00	1	0	-1
0022	2T	3_5	23	17	1	1700	630	-1070	0.06	0.37	3	1	-2
0022	2T	3_5	24	20	0	2000	0	-2000	0.00	0.00	3	0	-3
0022	2T	3_5	25	10	1	1000	490	-510	0.10	0.49	1	0	-1
0022	2T	3_5	26	14	2	1400	1330	-70	0.14	0.95	2	2	0
0022	2T	3_6	12	289	70	28900	25930	-2970	0.24	0.90	51	45	-6
0022	2T	3_6	13	161	37	16100	11400	-4700	0.23	0.71	28	20	-8
0022	2T	3_6	14	98	15	9800	5150	-4650	0.15	0.53	17	9	-8
0022	2T	3_6	15	44	8	4400	5360	960	0.18	1.22	7	9	2
0022	2T	3_6	16	41	4	4100	6540	2440	0.10	1.60	7	11	4
0022	2T	3_6	21	23	2	2300	1570	-730	0.09	0.68	4	2	-2
0022	2T	3_6	23	30	4	3000	2550	-450	0.13	0.85	5	4	-1
0022	2T	3_6	24	12	1	1200	390	-810	0.08	0.33	2	0	-2
0022	2T	3_6	25	15	2	1500	1480	-20	0.13	0.99	2	2	0
0022	2T	3_6	26	31	4	3100	4410	1310	0.13	1.42	5	7	2
0022	2T	3_7	12	345	69	34500	24890	-9610	0.20	0.72	61	44	-17
0022	2T	3_7	13	166	34	16600	12030	-4570	0.20	0.72	29	21	-8
0022	2T	3_7	14	139	34	13900	13980	80	0.24	1.01	24	24	0
0022	2T	3_7	15	38	4	3800	1980	-1820	0.11	0.52	6	3	-3
0022	2T	3_7	16	49	6	4900	7570	2670	0.12	1.54	8	13	5
0022	2T	3_7	21	21	2	2100	1580	-520	0.10	0.75	3	2	-1
0022	2T	3_7	23	19	4	1900	2610	710	0.21	1.37	3	4	1
0022	2T	3_7	24	14	2	1400	3120	1720	0.14	2.23	2	5	3
0022	2T	3_7	25	13	1	1300	1200	-100	0.08	0.92	2	2	0
0022	2T	3_7	26	20	1	2000	640	-1360	0.05	0.32	3	1	-2
0022	2T	3_8	12	352	87	35200	35060	-140	0.25	1.00	62	62	0
0022	2T	3_8	13	217	61	21700	20550	-1150	0.28	0.95	38	36	-2
0022	2T	3_8	14	141	25	14100	9310	-4790	0.18	0.66	24	16	-8
0022	2T	3_8	15	69	11	6900	3920	-2980	0.16	0.57	12	6	-6
0022	2T	3_8	16	37	5	3700	3980	280	0.14	1.08	6	7	1
0022	2T	3_8	21	18	3	1800	1080	-720	0.17	0.60	3	1	-2
0022	2T	3_8	23	13	3	1300	2110	810	0.23	1.62	2	3	1
0022	2T	3_8	24	10	2	1000	1250	250	0.20	1.25	1	2	1
0022	2T	3_8	25	11	0	1100	0	-1100	0.00	0.00	1	0	-1
0022	2T	3_8	26	20	3	2000	2070	70	0.15	1.04	3	3	0
0022	2T	3_9	12	426	122	42600	36290	-6310	0.29	0.85	75	64	-11
0022	2T	3_9	13	220	47	22000	14410	-7590	0.21	0.66	38	25	-13
0022	2T	3_9	14	143	26	14300	8590	-5710	0.18	0.60	25	15	-10
0022	2T	3_9	15	46	14	4600	6770	2170	0.30	1.47	8	11	3
0022	2T	3_9	16	34	4	3400	1690	-1710	0.12	0.50	6	2	-4
0022	2T	3_9	21	16	2	1600	730	-870	0.13	0.46	2	1	-1
0022	2T	3_9	23	11	2	1100	790	-310	0.18	0.72	1	1	0
0022	2T	3_9	24	12	1	1200	1090	-110	0.08	0.91	2	1	-1
0022	2T	3_9	25	12	2	1200	1030	-170	0.17	0.86	2	1	-1
0022	2T	3_9	26	11	2	1100	1380	280	0.18	1.25	1	2	1
0022	2T	4_1	12	459	129	45900	40830	-5070	0.28	0.89	81	72	-9
0022	2T	4_1	13	186	38	18600	14040	-4560	0.20	0.75	32	24	-8
0022	2T	4_1	14	120	34	12000	13480	1480	0.28	1.12	21	23	2
0022	2T	4_1	15	25	7	2500	3960	1460	0.28	1.58	4	7	3
0022	2T	4_1	16	9	2	900	1220	320	0.22	1.36	1	2	1
0022	2T	4_1	21	1	0	100	0	-100	0.00	0.00	0	0	0
0022	2T	4_1	23	5	1	500	370	-130	0.20	0.74	0	0	0
0022	2T	4_1	24	4	0	400	0	-400	0.00	0.00	0	0	0
0022	2T	4_1	25	4	0	400	0	-400	0.00	0.00	0	0	0
0022	2T	4_1	26	1	0	100	0	-100	0.00	0.00	0	0	0
0022	2T	4_10	12	514	123	51400	35050	-16350	0.24	0.68	90	62	-28
0022	2T	4_10	13	232	57	23200	21350	-1850	0.25	0.92	41	37	-4
0022	2T	4_10	14	120	19	12000	6360	-5640	0.16	0.53	21	11	-10
0022	2T	4_10	15	26	4	2600	1770	-830	0.15	0.68	4	3	-1
0022	2T	4_11	12	623	177	62300	48680	-13620	0.28	0.78	110	86	-24
0022	2T	4_11	13	228	56	22800	16590	-6210	0.25	0.73	40	29	-11
0022	2T	4_11	14	85	31	8500	10650	2150	0.36	1.25	15	18	3
0022	2T	4_11	15	18	1	1800	670	-1130	0.06	0.37	3	1	-2
0022	2T	4_12	12	701	204	70100	57920	-12180	0.29	0.83	124	102	-22
0022	2T	4_12	13	164	50	16400	13010	-3390	0.30	0.79	29	23	-6
0022	2T	4_12	14	65	12	6500	4480	-2020	0.18	0.69	11	7	-4
0022	2T	4_12	15	5	1	500	630	130	0.20	1.26	0	1	1
0022	2T	4_2	12	336	82	33600	27880	-5720	0.24	0.83	59	49	-10
0022	2T	4_2	13	143	27	14300	10120	-4180	0.19	0.71	25	17	-8
0022	2T	4_2	14	110	21	11000	9690	-1310	0.19	0.88	19	17	-2
0022	2T	4_2	15	39	7	3900	4670	770	0.18	1.20	6	8	2
0022	2T	4_2	16	21	0	2100	0	-2100	0.00	0.00	3	0	-3
0022	2T	4_2	21	2	0	200	0	-200	0.00	0.00	0	0	0
0022	2T	4_2	23	16	1	1600	410	-1190	0.06	0.26	2	0	-2
0022	2T	4_2	24	5	1	500	550	50	0.20	1.10	0	0	0
0022	2T	4_2	25	11	1	1100	1530	430	0.09	1.39	1	2	1
0022	2T	4_2	26	6	0	600	0	-600	0.00	0.00	1	0	-1
0022	2T	4_3	12	260	58	26000	23830	-2170	0.22	0.92	46	42	-4
0022	2T	4_3	13	222	57	22200	17850	-4350	0.26	0.80	39	31	-8
0022	2T	4_3	14	64	10	6400	5640	-760	0.16	0.88	11	9	-2
0022	2T	4_3	15	42	6	4200	7190	2990	0.14	1.71	7	12	5
0022	2T	4_3	16	16	5	1600	5130	3530	0.31	3.21	2	9	7
0022	2T	4_3	21	8	1	800	830	30	0.13	1.04	1	1	0
0022	2T	4_3	23	21	3	2100	1400	-700	0.14	0.67	3	2	-1
0022	2T	4_3	24	9	1	900	490	-410	0.11	0.54	1	0	-1
0022	2T	4_3	25	7	1	700	560	-140	0.14	0.80	1	0	-1
0022	2T	4_3	26	7	0	700	0	-700	0.00	0.00	1	0	-1
0022	2T	4_4	12	315	64	31500	17660	-13840	0.20	0.56	55	31	-24
0022	2T	4_4	13	187	44	18700	13300	-5400	0.24	0.71	33	23	-10
0022	2T	4_4	14	81	14	8100	4820	-3280	0.17	0.60	14	8	-6
0022	2T	4_4	15	40	5	4000	3370	-630	0.13	0.84	7	5	-2
0022	2T	4_4	16	22	3	2200	3540	1340	0.14	1.61	3	6	3
0022	2T	4_4	21	5	0	500	0	-500	0.00	0.00	0	0	0
0022	2T	4_4	23	20	4	2000	2410	410	0.20	1.21	3	4	1
0022	2T	4_4	24	13	1	1300	710	-590	0.08	0.55	2	1	-1
0022	2T	4_4	25	10	2	1000	5330	4330	0.20	5.33	1	9	8
0022	2T	4_4	26	7	1	700	560	-140	0.14	0.80	1	0	-1
0022	2T	4_5	12	379	105	37900	33690	-4210	0.28	0.89	67	59	-8
0022	2T	4_5	13	169	45	16900	15620	-1280	0.27	0.92	29	27	-2
0022	2T	4_5	14	112	21	11200	7880	-3320	0.19	0.70	19	13	-6
0022	2T	4_5	15	29	4	2900	1770	-1130	0.14	0.61	5	3	-2
0022	2T	4_5	16	10	1	1000	200	-800	0.10	0.20	1	0	-1
0022	2T	4_5	21	4	1	400	1120	720	0.25	2.80	0	1	1
0022	2T	4_5	23	17	4	1700	1650	-50	0.24	0.97	3	2	-1
0022	2T	4_5	24	11	1	1100	690	-410	0.09	0.63	1	1	0
0022	2T	4_5	25	4	0	400	0	-400	0.00	0.00	0	0	0
0022	2T	4_5	26	12	2	1200	860	-340	0.17	0.72	2	1	-1
0022	2T	4_6	12	287	70	28700	23640	-5060	0.24	0.82	50	41	-9
0022	2T	4_6	13	163	42	16300	14700	-1600	0.26	0.90	28	26	-2
0022	2T	4_6	14	86	15	8600	5560	-3040	0.17	0.65	15	9	-6
0022	2T	4_6	15	45	5	4500	3650	-850	0.11	0.81	7	6	-1
0022	2T	4_6	16	25	3	2500	1590	-910	0.12	0.64	4	2	-2
0022	2T	4_6	21	15	1	1500	480	-1020	0.07	0.32	2	0	-2
0022	2T	4_6	23	18	2	1800	830	-970	0.11	0.46	3	1	-2
0022	2T	4_6	24	14	3	1400	1250	-150	0.21	0.89	2	2	0
0022	2T	4_6	25	12	1	1200	400	-800	0.08	0.33	2	0	-2
0022	2T	4_6	26	10	2	1000	1040	40	0.20	1.04	1	1	0
0022	2T	4_7	12	292	58	29200	19160	-10040	0.20	0.66	51	33	-18
0022	2T	4_7	13	183	43	18300	15550	-2750	0.23	0.85	32	27	-5
0022	2T	4_7	14	129	34	12900	11270	-1630	0.26	0.87	22	19	-3
0022	2T	4_7	15	41	8	4100	3690	-410	0.20	0.90	7	6	-1
0022	2T	4_7	16	19	1	1900	790	-1110	0.05	0.42	3	1	-2
0022	2T	4_7	21	4	0	400	0	-400	0.00	0.00	0	0	0
0022	2T	4_7	23	14	1	1400	250	-1150	0.07	0.18	2	0	-2
0022	2T	4_7	24	11	2	1100	690	-410	0.18	0.63	1	1	0
0022	2T	4_7	25	8	2	800	1260	460	0.25	1.58	1	2	1
0022	2T	4_7	26	7	2	700	1950	1250	0.29	2.79	1	3	2
0022	2T	4_8	12	326	82	32600	26060	-6540	0.25	0.80	57	46	-11
0022	2T	4_8	13	166	49	16600	15310	-1290	0.30	0.92	29	27	-2
0022	2T	4_8	14	134	38	13400	13570	170	0.28	1.01	23	24	1
0022	2T	4_8	15	56	13	5600	5030	-570	0.23	0.90	9	8	-1
0022	2T	4_8	16	21	5	2100	1940	-160	0.24	0.92	3	3	0
0022	2T	4_8	21	5	0	500	0	-500	0.00	0.00	0	0	0
0022	2T	4_8	23	9	2	900	720	-180	0.22	0.80	1	1	0
0022	2T	4_8	24	10	2	1000	2300	1300	0.20	2.30	1	4	3
0022	2T	4_8	25	6	0	600	0	-600	0.00	0.00	1	0	-1
0022	2T	4_8	26	1	0	100	0	-100	0.00	0.00	0	0	0
0022	2T	4_9	12	400	117	40000	35960	-4040	0.29	0.90	70	63	-7
0022	2T	4_9	13	206	52	20600	18320	-2280	0.25	0.89	36	32	-4
0022	2T	4_9	14	126	43	12600	15440	2840	0.34	1.23	22	27	5
0022	2T	4_9	15	25	8	2500	4280	1780	0.32	1.71	4	7	3
0022	2T	4_9	16	7	1	700	980	280	0.14	1.40	1	1	0
0022	2T	4_9	21	3	0	300	0	-300	0.00	0.00	0	0	0
0022	2T	4_9	23	6	1	600	1190	590	0.17	1.98	1	2	1
0022	2T	4_9	24	5	1	500	440	-60	0.20	0.88	0	0	0
0022	2T	4_9	25	8	0	800	0	-800	0.00	0.00	1	0	-1
0022	2T	4_9	26	4	0	400	0	-400	0.00	0.00	0	0	0
0022	2T	5_1	12	367	112	36700	31540	-5160	0.31	0.86	64	55	-9
0022	2T	5_1	13	147	25	14700	7080	-7620	0.17	0.48	26	12	-14
0022	2T	5_1	14	78	20	7800	6960	-840	0.26	0.89	13	12	-1
0022	2T	5_1	15	18	0	1800	0	-1800	0.00	0.00	3	0	-3
0022	2T	5_1	16	8	1	800	360	-440	0.13	0.45	1	0	-1
0022	2T	5_1	23	1	0	100	0	-100	0.00	0.00	0	0	0
0022	2T	5_1	24	1	0	100	0	-100	0.00	0.00	0	0	0
0022	2T	5_1	25	1	1	100	1120	1020	1.00	11.20	0	1	1
0022	2T	5_10	12	563	169	56300	41480	-14820	0.30	0.74	99	73	-26
0022	2T	5_10	13	81	9	8100	3190	-4910	0.11	0.39	14	5	-9
0022	2T	5_10	14	18	4	1800	1650	-150	0.22	0.92	3	2	-1
0022	2T	5_10	15	1	0	100	0	-100	0.00	0.00	0	0	0
0022	2T	5_10	16	3	1	300	1210	910	0.33	4.03	0	2	2
0022	2T	5_10	21	4	0	400	0	-400	0.00	0.00	0	0	0
0022	2T	5_10	23	4	0	400	0	-400	0.00	0.00	0	0	0
0022	2T	5_11	12	592	194	59200	46400	-12800	0.33	0.78	104	82	-22
0022	2T	5_11	13	93	23	9300	6700	-2600	0.25	0.72	16	11	-5
0022	2T	5_11	14	17	5	1700	1960	260	0.29	1.15	3	3	0
0022	2T	5_11	15	1	0	100	0	-100	0.00	0.00	0	0	0
0022	2T	5_11	23	1	0	100	0	-100	0.00	0.00	0	0	0
0022	2T	5_11	25	1	0	100	0	-100	0.00	0.00	0	0	0
0022	2T	5_12	12	552	179	55200	44490	-10710	0.32	0.81	97	78	-19
0022	2T	5_12	13	126	24	12600	6930	-5670	0.19	0.55	22	12	-10
0022	2T	5_12	14	35	8	3500	3490	-10	0.23	1.00	6	6	0
0022	2T	5_12	15	3	0	300	0	-300	0.00	0.00	0	0	0
0022	2T	5_12	16	1	1	100	780	680	1.00	7.80	0	1	1
0022	2T	5_12	24	1	0	100	0	-100	0.00	0.00	0	0	0
0022	2T	5_2	12	300	62	30000	21620	-8380	0.21	0.72	53	38	-15
0022	2T	5_2	13	117	16	11700	5600	-6100	0.14	0.48	20	9	-11
0022	2T	5_2	14	109	23	10900	8540	-2360	0.21	0.78	19	15	-4
0022	2T	5_2	15	36	2	3600	1130	-2470	0.06	0.31	6	2	-4
0022	2T	5_2	16	13	2	1300	1320	20	0.15	1.02	2	2	0
0022	2T	5_2	21	1	0	100	0	-100	0.00	0.00	0	0	0
0022	2T	5_2	23	5	1	500	310	-190	0.20	0.62	0	0	0
0022	2T	5_2	24	4	0	400	0	-400	0.00	0.00	0	0	0
0022	2T	5_2	25	4	0	400	0	-400	0.00	0.00	0	0	0
0022	2T	5_3	12	216	46	21600	20260	-1340	0.21	0.94	38	35	-3
0022	2T	5_3	13	164	44	16400	15590	-810	0.27	0.95	29	27	-2
0022	2T	5_3	14	68	15	6800	6590	-210	0.22	0.97	12	11	-1
0022	2T	5_3	15	43	4	4300	1730	-2570	0.09	0.40	7	3	-4
0022	2T	5_3	16	26	2	2600	1290	-1310	0.08	0.50	4	2	-2
0022	2T	5_3	21	6	1	600	950	350	0.17	1.58	1	1	0
0022	2T	5_3	23	7	0	700	0	-700	0.00	0.00	1	0	-1
0022	2T	5_3	24	8	0	800	0	-800	0.00	0.00	1	0	-1
0022	2T	5_3	25	6	0	600	0	-600	0.00	0.00	1	0	-1
0022	2T	5_3	26	4	0	400	0	-400	0.00	0.00	0	0	0
0022	2T	5_4	12	256	64	25600	20370	-5230	0.25	0.80	45	36	-9
0022	2T	5_4	13	113	26	11300	10030	-1270	0.23	0.89	20	17	-3
0022	2T	5_4	14	92	15	9200	6620	-2580	0.16	0.72	16	11	-5
0022	2T	5_4	15	30	4	3000	4080	1080	0.13	1.36	5	7	2
0022	2T	5_4	16	25	2	2500	1060	-1440	0.08	0.42	4	1	-3
0022	2T	5_4	21	9	1	900	2060	1160	0.11	2.29	1	3	2
0022	2T	5_4	23	3	0	300	0	-300	0.00	0.00	0	0	0
0022	2T	5_4	24	7	0	700	0	-700	0.00	0.00	1	0	-1
0022	2T	5_4	25	6	0	600	0	-600	0.00	0.00	1	0	-1
0022	2T	5_4	26	12	0	1200	0	-1200	0.00	0.00	2	0	-2
0022	2T	5_5	12	307	90	30700	24710	-5990	0.29	0.80	54	43	-11
0022	2T	5_5	13	124	28	12400	9420	-2980	0.23	0.76	21	16	-5
0022	2T	5_5	14	115	23	11500	8800	-2700	0.20	0.77	20	15	-5
0022	2T	5_5	15	28	5	2800	2200	-600	0.18	0.79	4	3	-1
0022	2T	5_5	16	26	7	2600	3760	1160	0.27	1.45	4	6	2
0022	2T	5_5	21	9	1	900	560	-340	0.11	0.62	1	0	-1
0022	2T	5_5	23	7	1	700	1490	790	0.14	2.13	1	2	1
0022	2T	5_5	24	5	0	500	0	-500	0.00	0.00	0	0	0
0022	2T	5_5	25	1	0	100	0	-100	0.00	0.00	0	0	0
0022	2T	5_5	26	2	0	200	0	-200	0.00	0.00	0	0	0
0022	2T	5_6	12	246	59	24600	19170	-5430	0.24	0.78	43	33	-10
0022	2T	5_6	13	159	39	15900	13070	-2830	0.25	0.82	28	23	-5
0022	2T	5_6	14	88	22	8800	7600	-1200	0.25	0.86	15	13	-2
0022	2T	5_6	15	33	2	3300	600	-2700	0.06	0.18	5	1	-4
0022	2T	5_6	16	27	6	2700	2910	210	0.22	1.08	4	5	1
0022	2T	5_6	21	15	1	1500	3300	1800	0.07	2.20	2	5	3
0022	2T	5_6	23	10	0	1000	0	-1000	0.00	0.00	1	0	-1
0022	2T	5_6	24	4	1	400	350	-50	0.25	0.88	0	0	0
0022	2T	5_6	25	4	0	400	0	-400	0.00	0.00	0	0	0
0022	2T	5_6	26	10	2	1000	1960	960	0.20	1.96	1	3	2
0022	2T	5_7	12	264	74	26400	23910	-2490	0.28	0.91	46	42	-4
0022	2T	5_7	13	162	45	16200	14090	-2110	0.28	0.87	28	24	-4
0022	2T	5_7	14	129	29	12900	8910	-3990	0.22	0.69	22	15	-7
0022	2T	5_7	15	31	6	3100	2230	-870	0.19	0.72	5	3	-2
0022	2T	5_7	16	21	7	2100	3010	910	0.33	1.43	3	5	2
0022	2T	5_7	21	5	1	500	360	-140	0.20	0.72	0	0	0
0022	2T	5_7	23	4	0	400	0	-400	0.00	0.00	0	0	0
0022	2T	5_7	24	4	0	400	0	-400	0.00	0.00	0	0	0
0022	2T	5_7	26	6	0	600	0	-600	0.00	0.00	1	0	-1
0022	2T	5_8	12	246	69	24600	21340	-3260	0.28	0.87	43	37	-6
0022	2T	5_8	13	147	37	14700	12260	-2440	0.25	0.83	26	21	-5
0022	2T	5_8	14	135	30	13500	9710	-3790	0.22	0.72	23	17	-6
0022	2T	5_8	15	54	9	5400	3380	-2020	0.17	0.63	9	5	-4
0022	2T	5_8	16	27	5	2700	2280	-420	0.19	0.84	4	4	0
0022	2T	5_8	21	3	0	300	0	-300	0.00	0.00	0	0	0
0022	2T	5_8	23	6	1	600	690	90	0.17	1.15	1	1	0
0022	2T	5_8	24	1	0	100	0	-100	0.00	0.00	0	0	0
0022	2T	5_8	25	4	0	400	0	-400	0.00	0.00	0	0	0
0022	2T	5_8	26	4	0	400	0	-400	0.00	0.00	0	0	0
0022	2T	5_9	12	381	109	38100	31740	-6360	0.29	0.83	67	56	-11
0022	2T	5_9	13	146	36	14600	11590	-3010	0.25	0.79	25	20	-5
0022	2T	5_9	14	100	26	10000	8600	-1400	0.26	0.86	17	15	-2
0022	2T	5_9	15	17	2	1700	1380	-320	0.12	0.81	3	2	-1
0022	2T	5_9	16	22	1	2200	700	-1500	0.05	0.32	3	1	-2
0022	2T	5_9	21	4	0	400	0	-400	0.00	0.00	0	0	0
0022	2T	5_9	23	1	0	100	0	-100	0.00	0.00	0	0	0
0022	2T	5_9	24	2	0	200	0	-200	0.00	0.00	0	0	0
0022	2T	5_9	26	1	0	100	0	-100	0.00	0.00	0	0	0
0022	2T	6_1	12	26	10	2600	2590	-10	0.38	1.00	4	4	0
0022	2T	6_1	13	10	2	1000	680	-320	0.20	0.68	1	1	0
0022	2T	6_1	14	8	0	800	0	-800	0.00	0.00	1	0	-1
0022	2T	6_1	15	3	1	300	1220	920	0.33	4.07	0	2	2
0022	2T	6_1	16	1	0	100	0	-100	0.00	0.00	0	0	0
0022	2T	6_1	23	2	0	200	0	-200	0.00	0.00	0	0	0
0022	2T	6_10	12	46	21	4600	5340	740	0.46	1.16	8	9	1
0022	2T	6_10	13	6	2	600	550	-50	0.33	0.92	1	0	-1
0022	2T	6_10	14	1	0	100	0	-100	0.00	0.00	0	0	0
0022	2T	6_10	21	1	0	100	0	-100	0.00	0.00	0	0	0
0022	2T	6_11	12	51	16	5100	3430	-1670	0.31	0.67	9	6	-3
0022	2T	6_11	13	6	1	600	190	-410	0.17	0.32	1	0	-1
0022	2T	6_12	12	44	11	4400	2600	-1800	0.25	0.59	7	4	-3
0022	2T	6_12	13	10	0	1000	0	-1000	0.00	0.00	1	0	-1
0022	2T	6_12	14	4	1	400	290	-110	0.25	0.73	0	0	0
0022	2T	6_2	12	20	6	2000	1470	-530	0.30	0.74	3	2	-1
0022	2T	6_2	13	7	1	700	450	-250	0.14	0.64	1	0	-1
0022	2T	6_2	14	11	0	1100	0	-1100	0.00	0.00	1	0	-1
0022	2T	6_2	15	1	0	100	0	-100	0.00	0.00	0	0	0
0022	2T	6_2	16	3	0	300	0	-300	0.00	0.00	0	0	0
0022	2T	6_3	12	13	3	1300	860	-440	0.23	0.66	2	1	-1
0022	2T	6_3	13	18	4	1800	1280	-520	0.22	0.71	3	2	-1
0022	2T	6_3	14	9	1	900	330	-570	0.11	0.37	1	0	-1
0022	2T	6_3	15	2	0	200	0	-200	0.00	0.00	0	0	0
0022	2T	6_3	16	4	0	400	0	-400	0.00	0.00	0	0	0
0022	2T	6_3	21	1	1	100	2000	1900	1.00	20.00	0	3	3
0022	2T	6_3	23	1	0	100	0	-100	0.00	0.00	0	0	0
0022	2T	6_3	26	1	0	100	0	-100	0.00	0.00	0	0	0
0022	2T	6_4	12	22	5	2200	1660	-540	0.23	0.75	3	2	-1
0022	2T	6_4	13	10	1	1000	260	-740	0.10	0.26	1	0	-1
0022	2T	6_4	14	9	2	900	930	30	0.22	1.03	1	1	0
0022	2T	6_4	15	6	0	600	0	-600	0.00	0.00	1	0	-1
0022	2T	6_4	16	2	1	200	610	410	0.50	3.05	0	1	1
0022	2T	6_4	21	1	0	100	0	-100	0.00	0.00	0	0	0
0022	2T	6_5	12	25	6	2500	2660	160	0.24	1.06	4	4	0
0022	2T	6_5	13	12	4	1200	1050	-150	0.33	0.88	2	1	-1
0022	2T	6_5	14	12	4	1200	1010	-190	0.33	0.84	2	1	-1
0022	2T	6_5	15	1	0	100	0	-100	0.00	0.00	0	0	0
0022	2T	6_5	16	2	0	200	0	-200	0.00	0.00	0	0	0
0022	2T	6_6	12	19	7	1900	2130	230	0.37	1.12	3	3	0
0022	2T	6_6	13	11	6	1100	2090	990	0.55	1.90	1	3	2
0022	2T	6_6	14	11	0	1100	0	-1100	0.00	0.00	1	0	-1
0022	2T	6_6	15	2	0	200	0	-200	0.00	0.00	0	0	0
0022	2T	6_6	16	5	1	500	600	100	0.20	1.20	0	1	1
0022	2T	6_6	25	1	0	100	0	-100	0.00	0.00	0	0	0
0022	2T	6_7	12	21	3	2100	1770	-330	0.14	0.84	3	3	0
0022	2T	6_7	13	12	3	1200	880	-320	0.25	0.73	2	1	-1
0022	2T	6_7	14	13	2	1300	410	-890	0.15	0.32	2	0	-2
0022	2T	6_7	16	5	1	500	940	440	0.20	1.88	0	1	1
0022	2T	6_8	12	24	5	2400	3950	1550	0.21	1.65	4	6	2
0022	2T	6_8	13	14	7	1400	1930	530	0.50	1.38	2	3	1
0022	2T	6_8	14	10	3	1000	1100	100	0.30	1.10	1	1	0
0022	2T	6_8	15	3	0	300	0	-300	0.00	0.00	0	0	0
0022	2T	6_8	16	3	1	300	550	250	0.33	1.83	0	0	0
0022	2T	6_9	12	31	5	3100	1440	-1660	0.16	0.46	5	2	-3
0022	2T	6_9	13	16	3	1600	1000	-600	0.19	0.63	2	1	-1
0022	2T	6_9	14	7	1	700	410	-290	0.14	0.59	1	0	-1
0022	2T	6_9	15	1	0	100	0	-100	0.00	0.00	0	0	0
0022	2T	6_9	21	1	0	100	0	-100	0.00	0.00	0	0	0
0022	2T	7_1	12	667	175	66700	51320	-15380	0.26	0.77	118	90	-28
0022	2T	7_1	13	215	54	21500	18930	-2570	0.25	0.88	38	33	-5
0022	2T	7_1	14	144	37	14400	12930	-1470	0.26	0.90	25	22	-3
0022	2T	7_1	15	25	3	2500	1730	-770	0.12	0.69	4	3	-1
0022	2T	7_1	16	19	3	1900	3330	1430	0.16	1.75	3	5	2
0022	2T	7_1	23	9	1	900	430	-470	0.11	0.48	1	0	-1
0022	2T	7_1	24	4	0	400	0	-400	0.00	0.00	0	0	0
0022	2T	7_1	25	2	0	200	0	-200	0.00	0.00	0	0	0
0022	2T	7_10	12	768	206	76800	61580	-15220	0.27	0.80	135	108	-27
0022	2T	7_10	13	212	43	21200	15660	-5540	0.20	0.74	37	27	-10
0022	2T	7_10	14	82	8	8200	3040	-5160	0.10	0.37	14	5	-9
0022	2T	7_10	15	18	1	1800	370	-1430	0.06	0.21	3	0	-3
0022	2T	7_10	16	5	1	500	1950	1450	0.20	3.90	0	3	3
0022	2T	7_10	21	3	1	300	790	490	0.33	2.63	0	1	1
0022	2T	7_10	23	2	0	200	0	-200	0.00	0.00	0	0	0
0022	2T	7_10	24	3	1	300	1140	840	0.33	3.80	0	2	2
0022	2T	7_10	25	1	0	100	0	-100	0.00	0.00	0	0	0
0022	2T	7_10	26	1	0	100	0	-100	0.00	0.00	0	0	0
0022	2T	7_11	12	740	220	74000	59640	-14360	0.30	0.81	130	105	-25
0022	2T	7_11	13	224	55	22400	17950	-4450	0.25	0.80	39	31	-8
0022	2T	7_11	14	58	6	5800	1940	-3860	0.10	0.33	10	3	-7
0022	2T	7_11	15	10	2	1000	3010	2010	0.20	3.01	1	5	4
0022	2T	7_11	16	6	0	600	0	-600	0.00	0.00	1	0	-1
0022	2T	7_11	21	10	1	1000	1000	0	0.10	1.00	1	1	0
0022	2T	7_11	23	1	0	100	0	-100	0.00	0.00	0	0	0
0022	2T	7_11	24	2	0	200	0	-200	0.00	0.00	0	0	0
0022	2T	7_11	25	1	0	100	0	-100	0.00	0.00	0	0	0
0022	2T	7_12	12	972	256	97200	73390	-23810	0.26	0.76	172	129	-43
0022	2T	7_12	13	88	15	8800	5810	-2990	0.17	0.66	15	10	-5
0022	2T	7_12	14	1	0	100	0	-100	0.00	0.00	0	0	0
0022	2T	7_12	15	3	1	300	750	450	0.33	2.50	0	1	1
0022	2T	7_12	21	4	0	400	0	-400	0.00	0.00	0	0	0
0022	2T	7_2	12	543	136	54300	45590	-8710	0.25	0.84	96	80	-16
0022	2T	7_2	13	185	37	18500	14510	-3990	0.20	0.78	32	25	-7
0022	2T	7_2	14	158	27	15800	13090	-2710	0.17	0.83	27	23	-4
0022	2T	7_2	15	39	5	3900	2740	-1160	0.13	0.70	6	4	-2
0022	2T	7_2	16	19	2	1900	990	-910	0.11	0.52	3	1	-2
0022	2T	7_2	21	1	0	100	0	-100	0.00	0.00	0	0	0
0022	2T	7_2	23	16	1	1600	440	-1160	0.06	0.28	2	0	-2
0022	2T	7_2	24	6	0	600	0	-600	0.00	0.00	1	0	-1
0022	2T	7_2	25	2	0	200	0	-200	0.00	0.00	0	0	0
0022	2T	7_2	26	3	0	300	0	-300	0.00	0.00	0	0	0
0022	2T	7_3	12	411	95	41100	35410	-5690	0.23	0.86	72	62	-10
0022	2T	7_3	13	269	63	26900	20690	-6210	0.23	0.77	47	36	-11
0022	2T	7_3	14	142	27	14200	11110	-3090	0.19	0.78	25	19	-6
0022	2T	7_3	15	46	7	4600	3970	-630	0.15	0.86	8	7	-1
0022	2T	7_3	16	31	5	3100	3000	-100	0.16	0.97	5	5	0
0022	2T	7_3	21	8	0	800	0	-800	0.00	0.00	1	0	-1
0022	2T	7_3	23	22	2	2200	1530	-670	0.09	0.70	3	2	-1
0022	2T	7_3	24	15	0	1500	0	-1500	0.00	0.00	2	0	-2
0022	2T	7_3	25	6	0	600	0	-600	0.00	0.00	1	0	-1
0022	2T	7_3	26	5	0	500	0	-500	0.00	0.00	0	0	0
0022	2T	7_4	12	482	129	48200	37410	-10790	0.27	0.78	85	66	-19
0022	2T	7_4	13	203	44	20300	15000	-5300	0.22	0.74	35	26	-9
0022	2T	7_4	14	180	27	18000	12170	-5830	0.15	0.68	31	21	-10
0022	2T	7_4	15	46	6	4600	3180	-1420	0.13	0.69	8	5	-3
0022	2T	7_4	16	32	7	3200	2420	-780	0.22	0.76	5	4	-1
0022	2T	7_4	21	5	1	500	550	50	0.20	1.10	0	0	0
0022	2T	7_4	23	14	1	1400	1170	-230	0.07	0.84	2	2	0
0022	2T	7_4	24	14	1	1400	1140	-260	0.07	0.81	2	2	0
0022	2T	7_4	25	7	1	700	700	0	0.14	1.00	1	1	0
0022	2T	7_4	26	11	2	1100	1810	710	0.18	1.65	1	3	2
0022	2T	7_5	12	529	146	52900	39780	-13120	0.28	0.75	93	70	-23
0022	2T	7_5	13	203	54	20300	17730	-2570	0.27	0.87	35	31	-4
0022	2T	7_5	14	155	33	15500	10810	-4690	0.21	0.70	27	19	-8
0022	2T	7_5	15	49	7	4900	4130	-770	0.14	0.84	8	7	-1
0022	2T	7_5	16	46	7	4600	3770	-830	0.15	0.82	8	6	-2
0022	2T	7_5	21	5	0	500	0	-500	0.00	0.00	0	0	0
0022	2T	7_5	23	5	0	500	0	-500	0.00	0.00	0	0	0
0022	2T	7_5	24	7	1	700	1510	810	0.14	2.16	1	2	1
0022	2T	7_5	25	8	1	800	420	-380	0.13	0.53	1	0	-1
0022	2T	7_5	26	9	1	900	2310	1410	0.11	2.57	1	4	3
0022	2T	7_6	12	405	106	40500	32990	-7510	0.26	0.81	71	58	-13
0022	2T	7_6	13	261	68	26100	20890	-5210	0.26	0.80	46	36	-10
0022	2T	7_6	14	172	37	17200	11350	-5850	0.22	0.66	30	20	-10
0022	2T	7_6	15	61	12	6100	5510	-590	0.20	0.90	10	9	-1
0022	2T	7_6	16	44	3	4400	2320	-2080	0.07	0.53	7	4	-3
0022	2T	7_6	21	7	0	700	0	-700	0.00	0.00	1	0	-1
0022	2T	7_6	23	12	2	1200	1100	-100	0.17	0.92	2	1	-1
0022	2T	7_6	24	12	2	1200	1440	240	0.17	1.20	2	2	0
0022	2T	7_6	25	9	0	900	0	-900	0.00	0.00	1	0	-1
0022	2T	7_6	26	13	1	1300	1020	-280	0.08	0.78	2	1	-1
0022	2T	7_7	12	481	134	48100	41440	-6660	0.28	0.86	85	73	-12
0022	2T	7_7	13	249	68	24900	22100	-2800	0.27	0.89	44	39	-5
0022	2T	7_7	14	174	33	17400	9910	-7490	0.19	0.57	30	17	-13
0022	2T	7_7	15	70	10	7000	4600	-2400	0.14	0.66	12	8	-4
0022	2T	7_7	16	57	15	5700	7330	1630	0.26	1.29	10	12	2
0022	2T	7_7	21	4	0	400	0	-400	0.00	0.00	0	0	0
0022	2T	7_7	23	3	0	300	0	-300	0.00	0.00	0	0	0
0022	2T	7_7	24	3	0	300	0	-300	0.00	0.00	0	0	0
0022	2T	7_7	25	2	0	200	0	-200	0.00	0.00	0	0	0
0022	2T	7_7	26	9	1	900	660	-240	0.11	0.73	1	1	0
0022	2T	7_8	12	564	153	56400	46170	-10230	0.27	0.82	99	81	-18
0022	2T	7_8	13	263	64	26300	19540	-6760	0.24	0.74	46	34	-12
0022	2T	7_8	14	155	29	15500	9510	-5990	0.19	0.61	27	16	-11
0022	2T	7_8	15	49	14	4900	5490	590	0.29	1.12	8	9	1
0022	2T	7_8	16	32	7	3200	4930	1730	0.22	1.54	5	8	3
0022	2T	7_8	21	1	0	100	0	-100	0.00	0.00	0	0	0
0022	2T	7_8	23	7	0	700	0	-700	0.00	0.00	1	0	-1
0022	2T	7_8	24	1	0	100	0	-100	0.00	0.00	0	0	0
0022	2T	7_8	25	4	1	400	910	510	0.25	2.28	0	1	1
0022	2T	7_8	26	4	1	400	2010	1610	0.25	5.03	0	3	3
0022	2T	7_9	12	555	147	55500	47210	-8290	0.26	0.85	98	83	-15
0022	2T	7_9	13	294	63	29400	19080	-10320	0.21	0.65	52	33	-19
0022	2T	7_9	14	158	23	15800	8010	-7790	0.15	0.51	27	14	-13
0022	2T	7_9	15	54	8	5400	4850	-550	0.15	0.90	9	8	-1
0022	2T	7_9	16	25	2	2500	1980	-520	0.08	0.79	4	3	-1
0022	2T	7_9	21	2	0	200	0	-200	0.00	0.00	0	0	0
0022	2T	7_9	23	3	1	300	870	570	0.33	2.90	0	1	1
0022	2T	7_9	24	1	0	100	0	-100	0.00	0.00	0	0	0
0022	2T	7_9	25	1	0	100	0	-100	0.00	0.00	0	0	0
0022	2T	7_9	26	2	0	200	0	-200	0.00	0.00	0	0	0
0022	3F	1_1	123	241	32	24100	13710	-10390	0.13	0.57	42	24	-18
0022	3F	1_1	124	113	23	11300	7610	-3690	0.20	0.67	20	13	-7
0022	3F	1_1	125	93	8	9300	4940	-4360	0.09	0.53	16	8	-8
0022	3F	1_1	126	12	3	1200	2370	1170	0.25	1.98	2	4	2
0022	3F	1_1	134	99	20	9900	10190	290	0.20	1.03	17	18	1
0022	3F	1_1	135	64	10	6400	5260	-1140	0.16	0.82	11	9	-2
0022	3F	1_1	136	1	0	100	0	-100	0.00	0.00	0	0	0
0022	3F	1_1	145	58	7	5800	5040	-760	0.12	0.87	10	8	-2
0022	3F	1_1	146	2	0	200	0	-200	0.00	0.00	0	0	0
0022	3F	1_10	123	126	42	12600	13320	720	0.33	1.06	22	23	1
0022	3F	1_10	124	316	60	31600	20940	-10660	0.19	0.66	55	37	-18
0022	3F	1_10	125	156	31	15600	14180	-1420	0.20	0.91	27	25	-2
0022	3F	1_10	126	89	12	8900	7620	-1280	0.13	0.86	15	13	-2
0022	3F	1_10	134	127	31	12700	12260	-440	0.24	0.97	22	21	-1
0022	3F	1_10	135	92	22	9200	9060	-140	0.24	0.98	16	16	0
0022	3F	1_10	136	46	4	4600	1650	-2950	0.09	0.36	8	2	-6
0022	3F	1_10	145	14	3	1400	1560	160	0.21	1.11	2	2	0
0022	3F	1_10	146	7	0	700	0	-700	0.00	0.00	1	0	-1
0022	3F	1_10	235	1	0	100	0	-100	0.00	0.00	0	0	0
0022	3F	1_11	123	137	37	13700	14900	1200	0.27	1.09	24	26	2
0022	3F	1_11	124	474	92	47400	35180	-12220	0.19	0.74	83	62	-21
0022	3F	1_11	125	123	14	12300	8390	-3910	0.11	0.68	21	14	-7
0022	3F	1_11	126	58	9	5800	11450	5650	0.16	1.97	10	20	10
0022	3F	1_11	134	115	18	11500	6650	-4850	0.16	0.58	20	11	-9
0022	3F	1_11	135	82	14	8200	6710	-1490	0.17	0.82	14	11	-3
0022	3F	1_11	136	21	4	2100	2740	640	0.19	1.30	3	4	1
0022	3F	1_11	145	8	2	800	820	20	0.25	1.03	1	1	0
0022	3F	1_11	146	10	1	1000	460	-540	0.10	0.46	1	0	-1
0022	3F	1_11	156	1	0	100	0	-100	0.00	0.00	0	0	0
0022	3F	1_12	123	56	10	5600	3760	-1840	0.18	0.67	9	6	-3
0022	3F	1_12	124	908	123	90800	59830	-30970	0.14	0.66	160	105	-55
0022	3F	1_12	125	7	0	700	0	-700	0.00	0.00	1	0	-1
0022	3F	1_12	126	104	10	10400	14220	3820	0.10	1.37	18	25	7
0022	3F	1_12	134	12	4	1200	3140	1940	0.33	2.62	2	5	3
0022	3F	1_12	135	4	1	400	220	-180	0.25	0.55	0	0	0
0022	3F	1_12	136	8	1	800	690	-110	0.13	0.86	1	1	0
0022	3F	1_2	123	248	67	24800	25950	1150	0.27	1.05	43	45	2
0022	3F	1_2	124	54	7	5400	4840	-560	0.13	0.90	9	8	-1
0022	3F	1_2	125	100	14	10000	9830	-170	0.14	0.98	17	17	0
0022	3F	1_2	126	5	1	500	2130	1630	0.20	4.26	0	3	3
0022	3F	1_2	134	51	14	5100	5540	440	0.27	1.09	9	9	0
0022	3F	1_2	135	33	5	3300	3800	500	0.15	1.15	5	6	1
0022	3F	1_2	136	6	0	600	0	-600	0.00	0.00	1	0	-1
0022	3F	1_2	145	35	2	3500	3020	-480	0.06	0.86	6	5	-1
0022	3F	1_2	146	1	0	100	0	-100	0.00	0.00	0	0	0
0022	3F	1_2	245	1	0	100	0	-100	0.00	0.00	0	0	0
0022	3F	1_3	123	281	40	28100	20820	-7280	0.14	0.74	49	36	-13
0022	3F	1_3	124	85	17	8500	7000	-1500	0.20	0.82	15	12	-3
0022	3F	1_3	125	52	15	5200	8330	3130	0.29	1.60	9	14	5
0022	3F	1_3	126	32	9	3200	3510	310	0.28	1.10	5	6	1
0022	3F	1_3	134	89	16	8900	7650	-1250	0.18	0.86	15	13	-2
0022	3F	1_3	135	27	3	2700	700	-2000	0.11	0.26	4	1	-3
0022	3F	1_3	136	7	2	700	740	40	0.29	1.06	1	1	0
0022	3F	1_3	145	25	1	2500	1210	-1290	0.04	0.48	4	2	-2
0022	3F	1_3	146	10	2	1000	960	-40	0.20	0.96	1	1	0
0022	3F	1_3	156	4	1	400	520	120	0.25	1.30	0	0	0
0022	3F	1_3	234	3	1	300	540	240	0.33	1.80	0	0	0
0022	3F	1_3	245	1	0	100	0	-100	0.00	0.00	0	0	0
0022	3F	1_4	123	197	31	19700	11810	-7890	0.16	0.60	34	20	-14
0022	3F	1_4	124	52	15	5200	6160	960	0.29	1.18	9	10	1
0022	3F	1_4	125	91	10	9100	4920	-4180	0.11	0.54	16	8	-8
0022	3F	1_4	126	212	27	21200	20600	-600	0.13	0.97	37	36	-1
0022	3F	1_4	134	48	8	4800	3080	-1720	0.17	0.64	8	5	-3
0022	3F	1_4	135	56	5	5600	1850	-3750	0.09	0.33	9	3	-6
0022	3F	1_4	136	93	13	9300	9990	690	0.14	1.07	16	17	1
0022	3F	1_4	145	20	1	2000	400	-1600	0.05	0.20	3	0	-3
0022	3F	1_4	146	36	7	3600	4220	620	0.19	1.17	6	7	1
0022	3F	1_4	156	3	0	300	0	-300	0.00	0.00	0	0	0
0022	3F	1_4	234	1	0	100	0	-100	0.00	0.00	0	0	0
0022	3F	1_4	235	3	0	300	0	-300	0.00	0.00	0	0	0
0022	3F	1_4	236	2	0	200	0	-200	0.00	0.00	0	0	0
0022	3F	1_4	245	1	0	100	0	-100	0.00	0.00	0	0	0
0022	3F	1_5	123	133	37	13300	12390	-910	0.28	0.93	23	21	-2
0022	3F	1_5	124	233	74	23300	21670	-1630	0.32	0.93	41	38	-3
0022	3F	1_5	125	79	22	7900	8090	190	0.28	1.02	13	14	1
0022	3F	1_5	126	112	13	11200	20450	9250	0.12	1.83	19	36	17
0022	3F	1_5	134	96	28	9600	9590	-10	0.29	1.00	16	16	0
0022	3F	1_5	135	32	5	3200	3430	230	0.16	1.07	5	6	1
0022	3F	1_5	136	48	8	4800	2980	-1820	0.17	0.62	8	5	-3
0022	3F	1_5	145	16	4	1600	1300	-300	0.25	0.81	2	2	0
0022	3F	1_5	146	15	2	1500	610	-890	0.13	0.41	2	1	-1
0022	3F	1_5	156	3	1	300	1150	850	0.33	3.83	0	2	2
0022	3F	1_5	234	4	0	400	0	-400	0.00	0.00	0	0	0
0022	3F	1_5	236	3	1	300	400	100	0.33	1.33	0	0	0
0022	3F	1_5	245	5	0	500	0	-500	0.00	0.00	0	0	0
0022	3F	1_6	123	61	17	6100	5730	-370	0.28	0.94	10	10	0
0022	3F	1_6	124	133	30	13300	12480	-820	0.23	0.94	23	22	-1
0022	3F	1_6	125	70	11	7000	7260	260	0.16	1.04	12	12	0
0022	3F	1_6	126	122	17	12200	7370	-4830	0.14	0.60	21	13	-8
0022	3F	1_6	134	69	14	6900	3400	-3500	0.20	0.49	12	6	-6
0022	3F	1_6	135	39	8	3900	1980	-1920	0.21	0.51	6	3	-3
0022	3F	1_6	136	61	7	6100	3200	-2900	0.11	0.52	10	5	-5
0022	3F	1_6	145	13	2	1300	1390	90	0.15	1.07	2	2	0
0022	3F	1_6	146	38	4	3800	3980	180	0.11	1.05	6	7	1
0022	3F	1_6	156	9	0	900	0	-900	0.00	0.00	1	0	-1
0022	3F	1_6	234	4	0	400	0	-400	0.00	0.00	0	0	0
0022	3F	1_6	235	4	1	400	230	-170	0.25	0.58	0	0	0
0022	3F	1_6	236	7	0	700	0	-700	0.00	0.00	1	0	-1
0022	3F	1_6	245	2	0	200	0	-200	0.00	0.00	0	0	0
0022	3F	1_6	246	6	0	600	0	-600	0.00	0.00	1	0	-1
0022	3F	1_6	256	4	1	400	600	200	0.25	1.50	0	1	1
0022	3F	1_7	123	46	10	4600	3990	-610	0.22	0.87	8	7	-1
0022	3F	1_7	124	120	28	12000	7540	-4460	0.23	0.63	21	13	-8
0022	3F	1_7	125	75	9	7500	3950	-3550	0.12	0.53	13	6	-7
0022	3F	1_7	126	87	13	8700	10950	2250	0.15	1.26	15	19	4
0022	3F	1_7	134	89	23	8900	6890	-2010	0.26	0.77	15	12	-3
0022	3F	1_7	135	58	12	5800	3990	-1810	0.21	0.69	10	7	-3
0022	3F	1_7	136	57	5	5700	2700	-3000	0.09	0.47	10	4	-6
0022	3F	1_7	145	31	6	3100	1820	-1280	0.19	0.59	5	3	-2
0022	3F	1_7	146	22	3	2200	1350	-850	0.14	0.61	3	2	-1
0022	3F	1_7	156	4	0	400	0	-400	0.00	0.00	0	0	0
0022	3F	1_7	234	4	2	400	800	400	0.50	2.00	0	1	1
0022	3F	1_7	235	4	3	400	1890	1490	0.75	4.73	0	3	3
0022	3F	1_7	236	2	0	200	0	-200	0.00	0.00	0	0	0
0022	3F	1_7	245	4	2	400	450	50	0.50	1.13	0	0	0
0022	3F	1_7	246	5	1	500	410	-90	0.20	0.82	0	0	0
0022	3F	1_7	256	1	1	100	280	180	1.00	2.80	0	0	0
0022	3F	1_8	123	47	13	4700	3560	-1140	0.28	0.76	8	6	-2
0022	3F	1_8	124	173	45	17300	15210	-2090	0.26	0.88	30	26	-4
0022	3F	1_8	125	93	22	9300	13720	4420	0.24	1.48	16	24	8
0022	3F	1_8	126	80	4	8000	5720	-2280	0.05	0.72	14	10	-4
0022	3F	1_8	134	65	16	6500	4310	-2190	0.25	0.66	11	7	-4
0022	3F	1_8	135	42	9	4200	3600	-600	0.21	0.86	7	6	-1
0022	3F	1_8	136	55	6	5500	2060	-3440	0.11	0.37	9	3	-6
0022	3F	1_8	145	12	4	1200	1890	690	0.33	1.58	2	3	1
0022	3F	1_8	146	19	2	1900	1020	-880	0.11	0.54	3	1	-2
0022	3F	1_8	156	14	3	1400	940	-460	0.21	0.67	2	1	-1
0022	3F	1_8	234	1	1	100	730	630	1.00	7.30	0	1	1
0022	3F	1_8	235	1	0	100	0	-100	0.00	0.00	0	0	0
0022	3F	1_8	236	2	0	200	0	-200	0.00	0.00	0	0	0
0022	3F	1_8	245	4	1	400	260	-140	0.25	0.65	0	0	0
0022	3F	1_8	246	2	0	200	0	-200	0.00	0.00	0	0	0
0022	3F	1_9	123	57	19	5700	5610	-90	0.33	0.98	10	9	-1
0022	3F	1_9	124	202	41	20200	15750	-4450	0.20	0.78	35	27	-8
0022	3F	1_9	125	136	21	13600	11090	-2510	0.15	0.82	24	19	-5
0022	3F	1_9	126	101	9	10100	7000	-3100	0.09	0.69	17	12	-5
0022	3F	1_9	134	84	18	8400	5600	-2800	0.21	0.67	14	9	-5
0022	3F	1_9	135	88	21	8800	7800	-1000	0.24	0.89	15	13	-2
0022	3F	1_9	136	31	5	3100	2690	-410	0.16	0.87	5	4	-1
0022	3F	1_9	145	26	5	2600	1880	-720	0.19	0.72	4	3	-1
0022	3F	1_9	146	28	0	2800	0	-2800	0.00	0.00	4	0	-4
0022	3F	1_9	156	9	1	900	220	-680	0.11	0.24	1	0	-1
0022	3F	1_9	234	4	2	400	880	480	0.50	2.20	0	1	1
0022	3F	1_9	235	1	0	100	0	-100	0.00	0.00	0	0	0
0022	3F	1_9	245	1	0	100	0	-100	0.00	0.00	0	0	0
0022	3F	1_9	246	2	0	200	0	-200	0.00	0.00	0	0	0
0022	3F	1_9	256	1	0	100	0	-100	0.00	0.00	0	0	0
0022	3F	2_1	123	112	21	11200	7150	-4050	0.19	0.64	19	12	-7
0022	3F	2_1	124	141	26	14100	8290	-5810	0.18	0.59	24	14	-10
0022	3F	2_1	125	83	13	8300	4690	-3610	0.16	0.57	14	8	-6
0022	3F	2_1	126	31	7	3100	3480	380	0.23	1.12	5	6	1
0022	3F	2_1	134	43	10	4300	3370	-930	0.23	0.78	7	5	-2
0022	3F	2_1	135	21	3	2100	1500	-600	0.14	0.71	3	2	-1
0022	3F	2_1	136	18	1	1800	710	-1090	0.06	0.39	3	1	-2
0022	3F	2_1	145	13	0	1300	0	-1300	0.00	0.00	2	0	-2
0022	3F	2_1	146	6	1	600	380	-220	0.17	0.63	1	0	-1
0022	3F	2_1	156	1	0	100	0	-100	0.00	0.00	0	0	0
0022	3F	2_10	123	109	27	10900	9100	-1800	0.25	0.83	19	16	-3
0022	3F	2_10	124	224	62	22400	19610	-2790	0.28	0.88	39	34	-5
0022	3F	2_10	125	144	32	14400	12950	-1450	0.22	0.90	25	22	-3
0022	3F	2_10	126	140	30	14000	11470	-2530	0.21	0.82	24	20	-4
0022	3F	2_10	134	85	19	8500	6390	-2110	0.22	0.75	15	11	-4
0022	3F	2_10	135	91	19	9100	6300	-2800	0.21	0.69	16	11	-5
0022	3F	2_10	136	92	11	9200	3710	-5490	0.12	0.40	16	6	-10
0022	3F	2_10	145	29	4	2900	2090	-810	0.14	0.72	5	3	-2
0022	3F	2_10	146	12	3	1200	1400	200	0.25	1.17	2	2	0
0022	3F	2_10	156	5	1	500	1100	600	0.20	2.20	0	1	1
0022	3F	2_10	236	1	1	100	360	260	1.00	3.60	0	0	0
0022	3F	2_10	246	1	0	100	0	-100	0.00	0.00	0	0	0
0022	3F	2_11	123	90	24	9000	7050	-1950	0.27	0.78	15	12	-3
0022	3F	2_11	124	346	66	34600	27100	-7500	0.19	0.78	61	47	-14
0022	3F	2_11	125	167	24	16700	14270	-2430	0.14	0.85	29	25	-4
0022	3F	2_11	126	99	8	9900	4160	-5740	0.08	0.42	17	7	-10
0022	3F	2_11	134	113	19	11300	6180	-5120	0.17	0.55	20	10	-10
0022	3F	2_11	135	97	15	9700	6170	-3530	0.15	0.64	17	10	-7
0022	3F	2_11	136	46	6	4600	2870	-1730	0.13	0.62	8	5	-3
0022	3F	2_11	145	23	6	2300	2890	590	0.26	1.26	4	5	1
0022	3F	2_11	146	14	2	1400	2100	700	0.14	1.50	2	3	1
0022	3F	2_11	156	2	0	200	0	-200	0.00	0.00	0	0	0
0022	3F	2_12	123	81	19	8100	5320	-2780	0.23	0.66	14	9	-5
0022	3F	2_12	124	555	104	55500	45140	-10360	0.19	0.81	98	79	-19
0022	3F	2_12	125	129	21	12900	11790	-1110	0.16	0.91	22	20	-2
0022	3F	2_12	126	98	4	9800	5080	-4720	0.04	0.52	17	8	-9
0022	3F	2_12	134	111	27	11100	12170	1070	0.24	1.10	19	21	2
0022	3F	2_12	135	48	10	4800	4710	-90	0.21	0.98	8	8	0
0022	3F	2_12	136	24	1	2400	330	-2070	0.04	0.14	4	0	-4
0022	3F	2_12	145	9	3	900	1680	780	0.33	1.87	1	2	1
0022	3F	2_12	146	6	2	600	760	160	0.33	1.27	1	1	0
0022	3F	2_12	156	1	0	100	0	-100	0.00	0.00	0	0	0
0022	3F	2_2	123	94	33	9400	8960	-440	0.35	0.95	16	15	-1
0022	3F	2_2	124	120	29	12000	11240	-760	0.24	0.94	21	19	-2
0022	3F	2_2	125	80	22	8000	10820	2820	0.28	1.35	14	19	5
0022	3F	2_2	126	72	17	7200	9140	1940	0.24	1.27	12	16	4
0022	3F	2_2	134	53	5	5300	2220	-3080	0.09	0.42	9	3	-6
0022	3F	2_2	135	38	4	3800	1500	-2300	0.11	0.39	6	2	-4
0022	3F	2_2	136	37	7	3700	2550	-1150	0.19	0.69	6	4	-2
0022	3F	2_2	145	21	2	2100	800	-1300	0.10	0.38	3	1	-2
0022	3F	2_2	146	13	1	1300	240	-1060	0.08	0.18	2	0	-2
0022	3F	2_2	156	4	1	400	360	-40	0.25	0.90	0	0	0
0022	3F	2_2	234	4	0	400	0	-400	0.00	0.00	0	0	0
0022	3F	2_2	235	2	1	200	430	230	0.50	2.15	0	0	0
0022	3F	2_2	236	2	0	200	0	-200	0.00	0.00	0	0	0
0022	3F	2_2	245	2	0	200	0	-200	0.00	0.00	0	0	0
0022	3F	2_3	123	36	11	3600	3150	-450	0.31	0.88	6	5	-1
0022	3F	2_3	124	67	18	6700	6980	280	0.27	1.04	11	12	1
0022	3F	2_3	125	94	18	9400	10770	1370	0.19	1.15	16	19	3
0022	3F	2_3	126	91	9	9100	4350	-4750	0.10	0.48	16	7	-9
0022	3F	2_3	134	50	8	5000	2220	-2780	0.16	0.44	8	3	-5
0022	3F	2_3	135	89	28	8900	9710	810	0.31	1.09	15	17	2
0022	3F	2_3	136	85	13	8500	5780	-2720	0.15	0.68	15	10	-5
0022	3F	2_3	145	17	0	1700	0	-1700	0.00	0.00	3	0	-3
0022	3F	2_3	146	17	3	1700	1700	0	0.18	1.00	3	3	0
0022	3F	2_3	156	9	1	900	330	-570	0.11	0.37	1	0	-1
0022	3F	2_3	234	3	1	300	560	260	0.33	1.87	0	0	0
0022	3F	2_3	235	5	1	500	270	-230	0.20	0.54	0	0	0
0022	3F	2_3	236	2	0	200	0	-200	0.00	0.00	0	0	0
0022	3F	2_3	245	4	0	400	0	-400	0.00	0.00	0	0	0
0022	3F	2_3	246	4	1	400	670	270	0.25	1.68	0	1	1
0022	3F	2_3	256	2	0	200	0	-200	0.00	0.00	0	0	0
0022	3F	2_4	123	69	22	6900	5400	-1500	0.32	0.78	12	9	-3
0022	3F	2_4	124	108	20	10800	7670	-3130	0.19	0.71	19	13	-6
0022	3F	2_4	125	91	17	9100	7870	-1230	0.19	0.86	16	13	-3
0022	3F	2_4	126	116	22	11600	11660	60	0.19	1.01	20	20	0
0022	3F	2_4	134	45	10	4500	2520	-1980	0.22	0.56	7	4	-3
0022	3F	2_4	135	45	7	4500	2170	-2330	0.16	0.48	7	3	-4
0022	3F	2_4	136	68	17	6800	6830	30	0.25	1.00	12	12	0
0022	3F	2_4	145	25	3	2500	2010	-490	0.12	0.80	4	3	-1
0022	3F	2_4	146	23	3	2300	2420	120	0.13	1.05	4	4	0
0022	3F	2_4	156	11	2	1100	1240	140	0.18	1.13	1	2	1
0022	3F	2_4	234	3	0	300	0	-300	0.00	0.00	0	0	0
0022	3F	2_4	235	2	0	200	0	-200	0.00	0.00	0	0	0
0022	3F	2_4	236	2	0	200	0	-200	0.00	0.00	0	0	0
0022	3F	2_4	245	2	0	200	0	-200	0.00	0.00	0	0	0
0022	3F	2_5	123	71	18	7100	5550	-1550	0.25	0.78	12	9	-3
0022	3F	2_5	124	178	50	17800	15520	-2280	0.28	0.87	31	27	-4
0022	3F	2_5	125	90	24	9000	7500	-1500	0.27	0.83	15	13	-2
0022	3F	2_5	126	119	18	11900	9450	-2450	0.15	0.79	21	16	-5
0022	3F	2_5	134	56	9	5600	3200	-2400	0.16	0.57	9	5	-4
0022	3F	2_5	135	48	7	4800	2040	-2760	0.15	0.43	8	3	-5
0022	3F	2_5	136	50	9	5000	3250	-1750	0.18	0.65	8	5	-3
0022	3F	2_5	145	16	0	1600	0	-1600	0.00	0.00	2	0	-2
0022	3F	2_5	146	18	2	1800	610	-1190	0.11	0.34	3	1	-2
0022	3F	2_5	156	7	1	700	580	-120	0.14	0.83	1	1	0
0022	3F	2_5	234	2	0	200	0	-200	0.00	0.00	0	0	0
0022	3F	2_5	236	3	0	300	0	-300	0.00	0.00	0	0	0
0022	3F	2_5	245	1	0	100	0	-100	0.00	0.00	0	0	0
0022	3F	2_5	246	2	0	200	0	-200	0.00	0.00	0	0	0
0022	3F	2_5	256	1	0	100	0	-100	0.00	0.00	0	0	0
0022	3F	2_6	123	61	24	6100	5770	-330	0.39	0.95	10	10	0
0022	3F	2_6	124	88	21	8800	7190	-1610	0.24	0.82	15	12	-3
0022	3F	2_6	125	83	15	8300	5800	-2500	0.18	0.70	14	10	-4
0022	3F	2_6	126	105	18	10500	9970	-530	0.17	0.95	18	17	-1
0022	3F	2_6	134	64	17	6400	5190	-1210	0.27	0.81	11	9	-2
0022	3F	2_6	135	42	11	4200	3120	-1080	0.26	0.74	7	5	-2
0022	3F	2_6	136	63	10	6300	3720	-2580	0.16	0.59	11	6	-5
0022	3F	2_6	145	14	6	1400	2070	670	0.43	1.48	2	3	1
0022	3F	2_6	146	18	6	1800	2330	530	0.33	1.29	3	4	1
0022	3F	2_6	156	20	2	2000	640	-1360	0.10	0.32	3	1	-2
0022	3F	2_6	234	1	1	100	280	180	1.00	2.80	0	0	0
0022	3F	2_6	235	2	1	200	180	-20	0.50	0.90	0	0	0
0022	3F	2_6	236	1	0	100	0	-100	0.00	0.00	0	0	0
0022	3F	2_6	245	1	0	100	0	-100	0.00	0.00	0	0	0
0022	3F	2_6	246	3	1	300	480	180	0.33	1.60	0	0	0
0022	3F	2_6	256	1	1	100	310	210	1.00	3.10	0	0	0
0022	3F	2_7	123	56	17	5600	4860	-740	0.30	0.87	9	8	-1
0022	3F	2_7	124	106	35	10600	11000	400	0.33	1.04	18	19	1
0022	3F	2_7	125	96	14	9600	5840	-3760	0.15	0.61	16	10	-6
0022	3F	2_7	126	103	24	10300	11160	860	0.23	1.08	18	19	1
0022	3F	2_7	134	74	24	7400	6430	-970	0.32	0.87	13	11	-2
0022	3F	2_7	135	50	11	5000	3550	-1450	0.22	0.71	8	6	-2
0022	3F	2_7	136	57	13	5700	5070	-630	0.23	0.89	10	8	-2
0022	3F	2_7	145	39	10	3900	2850	-1050	0.26	0.73	6	5	-1
0022	3F	2_7	146	23	4	2300	1460	-840	0.17	0.63	4	2	-2
0022	3F	2_7	156	6	0	600	0	-600	0.00	0.00	1	0	-1
0022	3F	2_7	234	2	0	200	0	-200	0.00	0.00	0	0	0
0022	3F	2_7	236	5	2	500	1070	570	0.40	2.14	0	1	1
0022	3F	2_7	245	4	0	400	0	-400	0.00	0.00	0	0	0
0022	3F	2_7	246	2	0	200	0	-200	0.00	0.00	0	0	0
0022	3F	2_7	256	2	0	200	0	-200	0.00	0.00	0	0	0
0022	3F	2_8	123	69	19	6900	4510	-2390	0.28	0.65	12	7	-5
0022	3F	2_8	124	121	33	12100	7850	-4250	0.27	0.65	21	13	-8
0022	3F	2_8	125	61	16	6100	5570	-530	0.26	0.91	10	9	-1
0022	3F	2_8	126	89	17	8900	8660	-240	0.19	0.97	15	15	0
0022	3F	2_8	134	57	14	5700	4370	-1330	0.25	0.77	10	7	-3
0022	3F	2_8	135	60	13	6000	3960	-2040	0.22	0.66	10	7	-3
0022	3F	2_8	136	64	9	6400	3810	-2590	0.14	0.60	11	6	-5
0022	3F	2_8	145	21	5	2100	1530	-570	0.24	0.73	3	2	-1
0022	3F	2_8	146	28	1	2800	250	-2550	0.04	0.09	4	0	-4
0022	3F	2_8	156	5	1	500	720	220	0.20	1.44	0	1	1
0022	3F	2_8	236	3	0	300	0	-300	0.00	0.00	0	0	0
0022	3F	2_8	256	1	0	100	0	-100	0.00	0.00	0	0	0
0022	3F	2_9	123	107	34	10700	8830	-1870	0.32	0.83	18	15	-3
0022	3F	2_9	124	131	32	13100	8900	-4200	0.24	0.68	23	15	-8
0022	3F	2_9	125	96	25	9600	7770	-1830	0.26	0.81	16	13	-3
0022	3F	2_9	126	112	21	11200	8320	-2880	0.19	0.74	19	14	-5
0022	3F	2_9	134	69	20	6900	7190	290	0.29	1.04	12	12	0
0022	3F	2_9	135	64	18	6400	5540	-860	0.28	0.87	11	9	-2
0022	3F	2_9	136	70	15	7000	5970	-1030	0.21	0.85	12	10	-2
0022	3F	2_9	145	31	8	3100	2830	-270	0.26	0.91	5	5	0
0022	3F	2_9	146	23	4	2300	1550	-750	0.17	0.67	4	2	-2
0022	3F	2_9	156	3	2	300	1240	940	0.67	4.13	0	2	2
0022	3F	2_9	234	1	0	100	0	-100	0.00	0.00	0	0	0
0022	3F	2_9	235	4	2	400	470	70	0.50	1.18	0	0	0
0022	3F	2_9	245	1	0	100	0	-100	0.00	0.00	0	0	0
0022	3F	2_9	246	1	0	100	0	-100	0.00	0.00	0	0	0
0022	3F	2_9	256	2	0	200	0	-200	0.00	0.00	0	0	0
0022	3F	3_1	123	224	48	22400	17590	-4810	0.21	0.79	39	31	-8
0022	3F	3_1	124	143	23	14300	9710	-4590	0.16	0.68	25	17	-8
0022	3F	3_1	125	37	3	3700	1110	-2590	0.08	0.30	6	1	-5
0022	3F	3_1	126	48	6	4800	3630	-1170	0.13	0.76	8	6	-2
0022	3F	3_1	134	123	21	12300	9710	-2590	0.17	0.79	21	17	-4
0022	3F	3_1	135	33	2	3300	570	-2730	0.06	0.17	5	1	-4
0022	3F	3_1	136	18	3	1800	2130	330	0.17	1.18	3	3	0
0022	3F	3_1	145	49	8	4900	3350	-1550	0.16	0.68	8	5	-3
0022	3F	3_1	146	16	3	1600	2020	420	0.19	1.26	2	3	1
0022	3F	3_1	156	2	1	200	680	480	0.50	3.40	0	1	1
0022	3F	3_1	234	1	1	100	510	410	1.00	5.10	0	0	0
0022	3F	3_10	123	75	22	7500	5800	-1700	0.29	0.77	13	10	-3
0022	3F	3_10	124	207	47	20700	14750	-5950	0.23	0.71	36	26	-10
0022	3F	3_10	125	147	16	14700	6780	-7920	0.11	0.46	26	12	-14
0022	3F	3_10	126	125	22	12500	12480	-20	0.18	1.00	22	22	0
0022	3F	3_10	134	93	18	9300	7700	-1600	0.19	0.83	16	13	-3
0022	3F	3_10	135	99	19	9900	8370	-1530	0.19	0.85	17	14	-3
0022	3F	3_10	136	86	3	8600	1290	-7310	0.03	0.15	15	2	-13
0022	3F	3_10	145	34	5	3400	2320	-1080	0.15	0.68	6	4	-2
0022	3F	3_10	146	15	2	1500	990	-510	0.13	0.66	2	1	-1
0022	3F	3_10	156	12	1	1200	1080	-120	0.08	0.90	2	1	-1
0022	3F	3_10	235	1	1	100	360	260	1.00	3.60	0	0	0
0022	3F	3_10	236	2	0	200	0	-200	0.00	0.00	0	0	0
0022	3F	3_10	256	2	0	200	0	-200	0.00	0.00	0	0	0
0022	3F	3_11	123	132	42	13200	12160	-1040	0.32	0.92	23	21	-2
0022	3F	3_11	124	361	82	36100	31210	-4890	0.23	0.86	63	55	-8
0022	3F	3_11	125	163	22	16300	10390	-5910	0.13	0.64	28	18	-10
0022	3F	3_11	126	98	12	9800	11880	2080	0.12	1.21	17	21	4
0022	3F	3_11	134	98	20	9800	7200	-2600	0.20	0.73	17	12	-5
0022	3F	3_11	135	107	26	10700	9350	-1350	0.24	0.87	18	16	-2
0022	3F	3_11	136	51	7	5100	5090	-10	0.14	1.00	9	9	0
0022	3F	3_11	145	25	7	2500	2900	400	0.28	1.16	4	5	1
0022	3F	3_11	146	12	1	1200	600	-600	0.08	0.50	2	1	-1
0022	3F	3_11	156	5	1	500	750	250	0.20	1.50	0	1	1
0022	3F	3_12	123	86	29	8600	9600	1000	0.34	1.12	15	16	1
0022	3F	3_12	124	544	85	54400	34710	-19690	0.16	0.64	96	61	-35
0022	3F	3_12	125	184	22	18400	13400	-5000	0.12	0.73	32	23	-9
0022	3F	3_12	126	78	2	7800	2280	-5520	0.03	0.29	13	4	-9
0022	3F	3_12	134	86	18	8600	5850	-2750	0.21	0.68	15	10	-5
0022	3F	3_12	135	58	11	5800	6430	630	0.19	1.11	10	11	1
0022	3F	3_12	136	20	4	2000	2880	880	0.20	1.44	3	5	2
0022	3F	3_12	145	15	2	1500	610	-890	0.13	0.41	2	1	-1
0022	3F	3_12	146	5	1	500	610	110	0.20	1.22	0	1	1
0022	3F	3_12	156	1	0	100	0	-100	0.00	0.00	0	0	0
0022	3F	3_12	236	1	0	100	0	-100	0.00	0.00	0	0	0
0022	3F	3_2	123	139	29	13900	11120	-2780	0.21	0.80	24	19	-5
0022	3F	3_2	124	76	20	7600	6730	-870	0.26	0.89	13	11	-2
0022	3F	3_2	125	94	15	9400	8080	-1320	0.16	0.86	16	14	-2
0022	3F	3_2	126	120	11	12000	10170	-1830	0.09	0.85	21	18	-3
0022	3F	3_2	134	66	17	6600	6870	270	0.26	1.04	11	12	1
0022	3F	3_2	135	43	6	4300	1990	-2310	0.14	0.46	7	3	-4
0022	3F	3_2	136	62	10	6200	7850	1650	0.16	1.27	10	13	3
0022	3F	3_2	145	39	5	3900	3590	-310	0.13	0.92	6	6	0
0022	3F	3_2	146	37	4	3700	1810	-1890	0.11	0.49	6	3	-3
0022	3F	3_2	156	9	0	900	0	-900	0.00	0.00	1	0	-1
0022	3F	3_2	234	3	0	300	0	-300	0.00	0.00	0	0	0
0022	3F	3_2	235	1	1	100	320	220	1.00	3.20	0	0	0
0022	3F	3_2	236	2	0	200	0	-200	0.00	0.00	0	0	0
0022	3F	3_2	246	2	0	200	0	-200	0.00	0.00	0	0	0
0022	3F	3_2	256	1	0	100	0	-100	0.00	0.00	0	0	0
0022	3F	3_3	123	83	19	8300	7480	-820	0.23	0.90	14	13	-1
0022	3F	3_3	124	93	17	9300	6750	-2550	0.18	0.73	16	11	-5
0022	3F	3_3	125	75	12	7500	3730	-3770	0.16	0.50	13	6	-7
0022	3F	3_3	126	132	20	13200	14630	1430	0.15	1.11	23	25	2
0022	3F	3_3	134	68	18	6800	5640	-1160	0.26	0.83	12	9	-3
0022	3F	3_3	135	60	14	6000	6900	900	0.23	1.15	10	12	2
0022	3F	3_3	136	70	9	7000	7970	970	0.13	1.14	12	14	2
0022	3F	3_3	145	15	2	1500	1720	220	0.13	1.15	2	3	1
0022	3F	3_3	146	35	4	3500	2410	-1090	0.11	0.69	6	4	-2
0022	3F	3_3	156	11	0	1100	0	-1100	0.00	0.00	1	0	-1
0022	3F	3_3	234	5	2	500	600	100	0.40	1.20	0	1	1
0022	3F	3_3	235	4	2	400	570	170	0.50	1.43	0	1	1
0022	3F	3_3	236	1	0	100	0	-100	0.00	0.00	0	0	0
0022	3F	3_3	245	5	1	500	450	-50	0.20	0.90	0	0	0
0022	3F	3_3	246	1	0	100	0	-100	0.00	0.00	0	0	0
0022	3F	3_3	256	5	0	500	0	-500	0.00	0.00	0	0	0
0022	3F	3_4	123	70	17	7000	4720	-2280	0.24	0.67	12	8	-4
0022	3F	3_4	124	134	26	13400	9140	-4260	0.19	0.68	23	16	-7
0022	3F	3_4	125	95	19	9500	7090	-2410	0.20	0.75	16	12	-4
0022	3F	3_4	126	82	14	8200	9000	800	0.17	1.10	14	15	1
0022	3F	3_4	134	47	10	4700	3540	-1160	0.21	0.75	8	6	-2
0022	3F	3_4	135	65	12	6500	5170	-1330	0.18	0.80	11	9	-2
0022	3F	3_4	136	44	3	4400	1670	-2730	0.07	0.38	7	2	-5
0022	3F	3_4	145	23	5	2300	1680	-620	0.22	0.73	4	2	-2
0022	3F	3_4	146	24	2	2400	890	-1510	0.08	0.37	4	1	-3
0022	3F	3_4	156	16	1	1600	2110	510	0.06	1.32	2	3	1
0022	3F	3_4	234	1	1	100	360	260	1.00	3.60	0	0	0
0022	3F	3_4	235	7	2	700	630	-70	0.29	0.90	1	1	0
0022	3F	3_4	236	9	2	900	2460	1560	0.22	2.73	1	4	3
0022	3F	3_4	245	3	0	300	0	-300	0.00	0.00	0	0	0
0022	3F	3_4	246	9	0	900	0	-900	0.00	0.00	1	0	-1
0022	3F	3_4	256	4	0	400	0	-400	0.00	0.00	0	0	0
0022	3F	3_5	123	85	26	8500	7700	-800	0.31	0.91	15	13	-2
0022	3F	3_5	124	188	47	18800	15290	-3510	0.25	0.81	33	27	-6
0022	3F	3_5	125	80	13	8000	4760	-3240	0.16	0.60	14	8	-6
0022	3F	3_5	126	90	13	9000	6360	-2640	0.14	0.71	15	11	-4
0022	3F	3_5	134	59	21	5900	5270	-630	0.36	0.89	10	9	-1
0022	3F	3_5	135	53	13	5300	4620	-680	0.25	0.87	9	8	-1
0022	3F	3_5	136	25	5	2500	2890	390	0.20	1.16	4	5	1
0022	3F	3_5	145	24	7	2400	2410	10	0.29	1.00	4	4	0
0022	3F	3_5	146	10	0	1000	0	-1000	0.00	0.00	1	0	-1
0022	3F	3_5	156	10	5	1000	2190	1190	0.50	2.19	1	3	2
0022	3F	3_5	234	1	0	100	0	-100	0.00	0.00	0	0	0
0022	3F	3_5	235	7	3	700	770	70	0.43	1.10	1	1	0
0022	3F	3_5	236	8	1	800	930	130	0.13	1.16	1	1	0
0022	3F	3_5	245	5	1	500	380	-120	0.20	0.76	0	0	0
0022	3F	3_5	246	5	2	500	740	240	0.40	1.48	0	1	1
0022	3F	3_5	256	1	0	100	0	-100	0.00	0.00	0	0	0
0022	3F	3_6	123	57	20	5700	5890	190	0.35	1.03	10	10	0
0022	3F	3_6	124	95	24	9500	7670	-1830	0.25	0.81	16	13	-3
0022	3F	3_6	125	75	15	7500	5230	-2270	0.20	0.70	13	9	-4
0022	3F	3_6	126	81	12	8100	5050	-3050	0.15	0.62	14	8	-6
0022	3F	3_6	134	51	13	5100	3930	-1170	0.25	0.77	9	6	-3
0022	3F	3_6	135	41	6	4100	1900	-2200	0.15	0.46	7	3	-4
0022	3F	3_6	136	37	6	3700	2740	-960	0.16	0.74	6	4	-2
0022	3F	3_6	145	20	2	2000	1060	-940	0.10	0.53	3	1	-2
0022	3F	3_6	146	19	3	1900	1410	-490	0.16	0.74	3	2	-1
0022	3F	3_6	156	14	3	1400	2280	880	0.21	1.63	2	4	2
0022	3F	3_6	234	6	1	600	240	-360	0.17	0.40	1	0	-1
0022	3F	3_6	235	10	1	1000	210	-790	0.10	0.21	1	0	-1
0022	3F	3_6	236	12	1	1200	300	-900	0.08	0.25	2	0	-2
0022	3F	3_6	245	3	0	300	0	-300	0.00	0.00	0	0	0
0022	3F	3_6	246	3	1	300	470	170	0.33	1.57	0	0	0
0022	3F	3_6	256	4	1	400	560	160	0.25	1.40	0	0	0
0022	3F	3_7	123	52	20	5200	4980	-220	0.38	0.96	9	8	-1
0022	3F	3_7	124	103	26	10300	6420	-3880	0.25	0.62	18	11	-7
0022	3F	3_7	125	102	21	10200	7690	-2510	0.21	0.75	18	13	-5
0022	3F	3_7	126	90	15	9000	6700	-2300	0.17	0.74	15	11	-4
0022	3F	3_7	134	44	8	4400	3140	-1260	0.18	0.71	7	5	-2
0022	3F	3_7	135	53	10	5300	4430	-870	0.19	0.84	9	7	-2
0022	3F	3_7	136	49	7	4900	2080	-2820	0.14	0.42	8	3	-5
0022	3F	3_7	145	51	9	5100	5550	450	0.18	1.09	9	9	0
0022	3F	3_7	146	18	1	1800	450	-1350	0.06	0.25	3	0	-3
0022	3F	3_7	156	17	4	1700	2340	640	0.24	1.38	3	4	1
0022	3F	3_7	234	3	3	300	1370	1070	1.00	4.57	0	2	2
0022	3F	3_7	235	4	1	400	520	120	0.25	1.30	0	0	0
0022	3F	3_7	236	9	2	900	810	-90	0.22	0.90	1	1	0
0022	3F	3_7	245	6	1	600	1040	440	0.17	1.73	1	1	0
0022	3F	3_7	246	3	0	300	0	-300	0.00	0.00	0	0	0
0022	3F	3_7	256	8	2	800	710	-90	0.25	0.89	1	1	0
0022	3F	3_8	123	53	17	5300	3610	-1690	0.32	0.68	9	6	-3
0022	3F	3_8	124	138	40	13800	10390	-3410	0.29	0.75	24	18	-6
0022	3F	3_8	125	90	22	9000	6830	-2170	0.24	0.76	15	12	-3
0022	3F	3_8	126	85	13	8500	7140	-1360	0.15	0.84	15	12	-3
0022	3F	3_8	134	51	14	5100	5620	520	0.27	1.10	9	9	0
0022	3F	3_8	135	54	6	5400	1790	-3610	0.11	0.33	9	3	-6
0022	3F	3_8	136	72	14	7200	8120	920	0.19	1.13	12	14	2
0022	3F	3_8	145	29	6	2900	2480	-420	0.21	0.86	5	4	-1
0022	3F	3_8	146	28	2	2800	530	-2270	0.07	0.19	4	0	-4
0022	3F	3_8	156	18	0	1800	0	-1800	0.00	0.00	3	0	-3
0022	3F	3_8	234	5	0	500	0	-500	0.00	0.00	0	0	0
0022	3F	3_8	235	4	2	400	660	260	0.50	1.65	0	1	1
0022	3F	3_8	245	3	0	300	0	-300	0.00	0.00	0	0	0
0022	3F	3_8	246	4	0	400	0	-400	0.00	0.00	0	0	0
0022	3F	3_8	256	8	2	800	2120	1320	0.25	2.65	1	3	2
0022	3F	3_9	123	68	23	6800	6650	-150	0.34	0.98	12	11	-1
0022	3F	3_9	124	141	20	14100	6380	-7720	0.14	0.45	24	11	-13
0022	3F	3_9	125	115	19	11500	6740	-4760	0.17	0.59	20	11	-9
0022	3F	3_9	126	102	15	10200	5550	-4650	0.15	0.54	18	9	-9
0022	3F	3_9	134	58	15	5800	4300	-1500	0.26	0.74	10	7	-3
0022	3F	3_9	135	57	11	5700	3570	-2130	0.19	0.63	10	6	-4
0022	3F	3_9	136	64	11	6400	4600	-1800	0.17	0.72	11	8	-3
0022	3F	3_9	145	34	13	3400	4470	1070	0.38	1.31	6	7	1
0022	3F	3_9	146	21	2	2100	750	-1350	0.10	0.36	3	1	-2
0022	3F	3_9	156	13	3	1300	1510	210	0.23	1.16	2	2	0
0022	3F	3_9	234	2	1	200	550	350	0.50	2.75	0	0	0
0022	3F	3_9	235	3	1	300	400	100	0.33	1.33	0	0	0
0022	3F	3_9	236	4	0	400	0	-400	0.00	0.00	0	0	0
0022	3F	3_9	245	4	0	400	0	-400	0.00	0.00	0	0	0
0022	3F	3_9	246	4	1	400	400	0	0.25	1.00	0	0	0
0022	3F	3_9	256	4	1	400	830	430	0.25	2.08	0	1	1
0022	3F	4_1	123	107	25	10700	8550	-2150	0.23	0.80	18	15	-3
0022	3F	4_1	124	159	38	15900	14360	-1540	0.24	0.90	28	25	-3
0022	3F	4_1	125	61	8	6100	3630	-2470	0.13	0.60	10	6	-4
0022	3F	4_1	126	27	3	2700	2640	-60	0.11	0.98	4	4	0
0022	3F	4_1	134	49	7	4900	3150	-1750	0.14	0.64	8	5	-3
0022	3F	4_1	135	22	1	2200	350	-1850	0.05	0.16	3	0	-3
0022	3F	4_1	136	7	1	700	780	80	0.14	1.11	1	1	0
0022	3F	4_1	145	10	4	1000	1650	650	0.40	1.65	1	2	1
0022	3F	4_1	146	10	0	1000	0	-1000	0.00	0.00	1	0	-1
0022	3F	4_1	156	2	0	200	0	-200	0.00	0.00	0	0	0
0022	3F	4_1	234	1	0	100	0	-100	0.00	0.00	0	0	0
0022	3F	4_1	236	2	0	200	0	-200	0.00	0.00	0	0	0
0022	3F	4_10	123	318	73	31800	25290	-6510	0.23	0.80	56	44	-12
0022	3F	4_10	124	125	34	12500	11660	-840	0.27	0.93	22	20	-2
0022	3F	4_10	125	63	10	6300	3570	-2730	0.16	0.57	11	6	-5
0022	3F	4_10	126	8	0	800	0	-800	0.00	0.00	1	0	-1
0022	3F	4_10	134	132	26	13200	12010	-1190	0.20	0.91	23	21	-2
0022	3F	4_10	135	38	6	3800	2180	-1620	0.16	0.57	6	3	-3
0022	3F	4_10	136	11	0	1100	0	-1100	0.00	0.00	1	0	-1
0022	3F	4_10	145	1	0	100	0	-100	0.00	0.00	0	0	0
0022	3F	4_10	156	1	0	100	0	-100	0.00	0.00	0	0	0
0022	3F	4_11	123	616	149	61600	49480	-12120	0.24	0.80	109	87	-22
0022	3F	4_11	126	7	1	700	650	-50	0.14	0.93	1	1	0
0022	3F	4_11	134	83	18	8300	13950	5650	0.22	1.68	14	24	10
0022	3F	4_11	135	18	2	1800	1070	-730	0.11	0.59	3	1	-2
0022	3F	4_11	136	9	1	900	390	-510	0.11	0.43	1	0	-1
0022	3F	4_11	146	2	0	200	0	-200	0.00	0.00	0	0	0
0022	3F	4_12	123	242	68	24200	26650	2450	0.28	1.10	42	47	5
0022	3F	4_12	124	383	73	38300	28220	-10080	0.19	0.74	67	49	-18
0022	3F	4_12	125	70	8	7000	4570	-2430	0.11	0.65	12	8	-4
0022	3F	4_12	126	6	0	600	0	-600	0.00	0.00	1	0	-1
0022	3F	4_12	134	113	27	11300	11940	640	0.24	1.06	20	21	1
0022	3F	4_12	135	12	2	1200	1630	430	0.17	1.36	2	2	0
0022	3F	4_12	136	3	0	300	0	-300	0.00	0.00	0	0	0
0022	3F	4_12	145	1	0	100	0	-100	0.00	0.00	0	0	0
0022	3F	4_12	146	2	0	200	0	-200	0.00	0.00	0	0	0
0022	3F	4_2	123	73	25	7300	6210	-1090	0.34	0.85	12	10	-2
0022	3F	4_2	124	119	23	11900	7300	-4600	0.19	0.61	21	12	-9
0022	3F	4_2	125	72	16	7200	6790	-410	0.22	0.94	12	12	0
0022	3F	4_2	126	41	6	4100	3960	-140	0.15	0.97	7	7	0
0022	3F	4_2	134	45	11	4500	4010	-490	0.24	0.89	7	7	0
0022	3F	4_2	135	33	8	3300	3210	-90	0.24	0.97	5	5	0
0022	3F	4_2	136	21	3	2100	1110	-990	0.14	0.53	3	1	-2
0022	3F	4_2	145	14	5	1400	3930	2530	0.36	2.81	2	6	4
0022	3F	4_2	146	10	2	1000	690	-310	0.20	0.69	1	1	0
0022	3F	4_2	156	5	2	500	820	320	0.40	1.64	0	1	1
0022	3F	4_2	234	2	0	200	0	-200	0.00	0.00	0	0	0
0022	3F	4_2	235	5	1	500	280	-220	0.20	0.56	0	0	0
0022	3F	4_2	236	2	1	200	850	650	0.50	4.25	0	1	1
0022	3F	4_2	245	3	0	300	0	-300	0.00	0.00	0	0	0
0022	3F	4_2	246	1	0	100	0	-100	0.00	0.00	0	0	0
0022	3F	4_3	123	44	14	4400	3980	-420	0.32	0.90	7	7	0
0022	3F	4_3	124	76	16	7600	4430	-3170	0.21	0.58	13	7	-6
0022	3F	4_3	125	81	20	8100	8730	630	0.25	1.08	14	15	1
0022	3F	4_3	126	59	7	5900	3280	-2620	0.12	0.56	10	5	-5
0022	3F	4_3	134	62	9	6200	2490	-3710	0.15	0.40	10	4	-6
0022	3F	4_3	135	72	23	7200	6280	-920	0.32	0.87	12	11	-1
0022	3F	4_3	136	25	4	2500	1160	-1340	0.16	0.46	4	2	-2
0022	3F	4_3	145	13	0	1300	0	-1300	0.00	0.00	2	0	-2
0022	3F	4_3	146	12	3	1200	4400	3200	0.25	3.67	2	7	5
0022	3F	4_3	156	8	1	800	320	-480	0.13	0.40	1	0	-1
0022	3F	4_3	234	6	0	600	0	-600	0.00	0.00	1	0	-1
0022	3F	4_3	235	3	0	300	0	-300	0.00	0.00	0	0	0
0022	3F	4_3	236	8	3	800	1460	660	0.38	1.83	1	2	1
0022	3F	4_3	245	2	0	200	0	-200	0.00	0.00	0	0	0
0022	3F	4_3	246	3	0	300	0	-300	0.00	0.00	0	0	0
0022	3F	4_3	256	1	0	100	0	-100	0.00	0.00	0	0	0
0022	3F	4_4	123	60	15	6000	3170	-2830	0.25	0.53	10	5	-5
0022	3F	4_4	124	106	26	10600	9570	-1030	0.25	0.90	18	16	-2
0022	3F	4_4	125	72	12	7200	7380	180	0.17	1.03	12	13	1
0022	3F	4_4	126	62	11	6200	7240	1040	0.18	1.17	10	12	2
0022	3F	4_4	134	65	14	6500	4080	-2420	0.22	0.63	11	7	-4
0022	3F	4_4	135	49	9	4900	3000	-1900	0.18	0.61	8	5	-3
0022	3F	4_4	136	41	5	4100	1770	-2330	0.12	0.43	7	3	-4
0022	3F	4_4	145	24	2	2400	900	-1500	0.08	0.38	4	1	-3
0022	3F	4_4	146	11	4	1100	5800	4700	0.36	5.27	1	10	9
0022	3F	4_4	156	5	0	500	0	-500	0.00	0.00	0	0	0
0022	3F	4_4	234	6	1	600	200	-400	0.17	0.33	1	0	-1
0022	3F	4_4	235	11	2	1100	520	-580	0.18	0.47	1	0	-1
0022	3F	4_4	236	2	0	200	0	-200	0.00	0.00	0	0	0
0022	3F	4_4	245	2	0	200	0	-200	0.00	0.00	0	0	0
0022	3F	4_4	246	3	0	300	0	-300	0.00	0.00	0	0	0
0022	3F	4_4	256	1	0	100	0	-100	0.00	0.00	0	0	0
0022	3F	4_5	123	67	24	6700	5940	-760	0.36	0.89	11	10	-1
0022	3F	4_5	124	138	41	13800	11890	-1910	0.30	0.86	24	21	-3
0022	3F	4_5	125	89	24	8900	7510	-1390	0.27	0.84	15	13	-2
0022	3F	4_5	126	69	9	6900	2800	-4100	0.13	0.41	12	4	-8
0022	3F	4_5	134	71	21	7100	4690	-2410	0.30	0.66	12	8	-4
0022	3F	4_5	135	40	8	4000	4090	90	0.20	1.02	7	7	0
0022	3F	4_5	136	31	9	3100	2910	-190	0.29	0.94	5	5	0
0022	3F	4_5	145	19	3	1900	890	-1010	0.16	0.47	3	1	-2
0022	3F	4_5	146	10	2	1000	840	-160	0.20	0.84	1	1	0
0022	3F	4_5	156	3	0	300	0	-300	0.00	0.00	0	0	0
0022	3F	4_5	234	5	1	500	170	-330	0.20	0.34	0	0	0
0022	3F	4_5	235	4	0	400	0	-400	0.00	0.00	0	0	0
0022	3F	4_5	236	5	1	500	230	-270	0.20	0.46	0	0	0
0022	3F	4_5	245	2	0	200	0	-200	0.00	0.00	0	0	0
0022	3F	4_5	246	3	0	300	0	-300	0.00	0.00	0	0	0
0022	3F	4_5	256	1	0	100	0	-100	0.00	0.00	0	0	0
0022	3F	4_6	123	61	18	6100	3830	-2270	0.30	0.63	10	6	-4
0022	3F	4_6	124	88	19	8800	6070	-2730	0.22	0.69	15	10	-5
0022	3F	4_6	125	72	19	7200	8060	860	0.26	1.12	12	14	2
0022	3F	4_6	126	61	10	6100	4500	-1600	0.16	0.74	10	7	-3
0022	3F	4_6	134	63	13	6300	4350	-1950	0.21	0.69	11	7	-4
0022	3F	4_6	135	43	7	4300	3000	-1300	0.16	0.70	7	5	-2
0022	3F	4_6	136	21	3	2100	820	-1280	0.14	0.39	3	1	-2
0022	3F	4_6	145	25	5	2500	1590	-910	0.20	0.64	4	2	-2
0022	3F	4_6	146	10	2	1000	740	-260	0.20	0.74	1	1	0
0022	3F	4_6	156	16	2	1600	1660	60	0.13	1.04	2	2	0
0022	3F	4_6	234	3	1	300	450	150	0.33	1.50	0	0	0
0022	3F	4_6	235	5	1	500	390	-110	0.20	0.78	0	0	0
0022	3F	4_6	236	6	1	600	440	-160	0.17	0.73	1	0	-1
0022	3F	4_6	245	7	3	700	1370	670	0.43	1.96	1	2	1
0022	3F	4_6	246	3	0	300	0	-300	0.00	0.00	0	0	0
0022	3F	4_6	256	2	0	200	0	-200	0.00	0.00	0	0	0
0022	3F	4_7	123	58	19	5800	5220	-580	0.33	0.90	10	9	-1
0022	3F	4_7	124	96	17	9600	4140	-5460	0.18	0.43	16	7	-9
0022	3F	4_7	125	85	17	8500	7750	-750	0.20	0.91	15	13	-2
0022	3F	4_7	126	43	3	4300	1830	-2470	0.07	0.43	7	3	-4
0022	3F	4_7	134	63	18	6300	4620	-1680	0.29	0.73	11	8	-3
0022	3F	4_7	135	52	9	5200	3320	-1880	0.17	0.64	9	5	-4
0022	3F	4_7	136	31	5	3100	1440	-1660	0.16	0.46	5	2	-3
0022	3F	4_7	145	37	7	3700	2860	-840	0.19	0.77	6	5	-1
0022	3F	4_7	146	19	2	1900	650	-1250	0.11	0.34	3	1	-2
0022	3F	4_7	156	4	1	400	470	70	0.25	1.18	0	0	0
0022	3F	4_7	234	4	1	400	250	-150	0.25	0.63	0	0	0
0022	3F	4_7	235	3	0	300	0	-300	0.00	0.00	0	0	0
0022	3F	4_7	236	5	0	500	0	-500	0.00	0.00	0	0	0
0022	3F	4_7	245	2	1	200	250	50	0.50	1.25	0	0	0
0022	3F	4_7	246	4	0	400	0	-400	0.00	0.00	0	0	0
0022	3F	4_7	256	1	0	100	0	-100	0.00	0.00	0	0	0
0022	3F	4_8	123	67	21	6700	4440	-2260	0.31	0.66	11	7	-4
0022	3F	4_8	124	109	31	10900	9340	-1560	0.28	0.86	19	16	-3
0022	3F	4_8	125	97	21	9700	7120	-2580	0.22	0.73	17	12	-5
0022	3F	4_8	126	51	7	5100	4630	-470	0.14	0.91	9	8	-1
0022	3F	4_8	134	42	9	4200	1850	-2350	0.21	0.44	7	3	-4
0022	3F	4_8	135	46	13	4600	5010	410	0.28	1.09	8	8	0
0022	3F	4_8	136	38	3	3800	800	-3000	0.08	0.21	6	1	-5
0022	3F	4_8	145	24	5	2400	1400	-1000	0.21	0.58	4	2	-2
0022	3F	4_8	146	16	2	1600	530	-1070	0.13	0.33	2	0	-2
0022	3F	4_8	156	4	0	400	0	-400	0.00	0.00	0	0	0
0022	3F	4_8	234	1	0	100	0	-100	0.00	0.00	0	0	0
0022	3F	4_8	235	3	0	300	0	-300	0.00	0.00	0	0	0
0022	3F	4_8	236	2	0	200	0	-200	0.00	0.00	0	0	0
0022	3F	4_8	245	3	0	300	0	-300	0.00	0.00	0	0	0
0022	3F	4_8	246	4	1	400	310	-90	0.25	0.78	0	0	0
0022	3F	4_9	123	86	30	8600	9570	970	0.35	1.11	15	16	1
0022	3F	4_9	124	159	32	15900	8930	-6970	0.20	0.56	28	15	-13
0022	3F	4_9	125	84	16	8400	6890	-1510	0.19	0.82	14	12	-2
0022	3F	4_9	126	50	6	5000	2450	-2550	0.12	0.49	8	4	-4
0022	3F	4_9	134	67	21	6700	8320	1620	0.31	1.24	11	14	3
0022	3F	4_9	135	48	10	4800	3620	-1180	0.21	0.75	8	6	-2
0022	3F	4_9	136	37	6	3700	3280	-420	0.16	0.89	6	5	-1
0022	3F	4_9	145	25	7	2500	2210	-290	0.28	0.88	4	3	-1
0022	3F	4_9	146	9	1	900	260	-640	0.11	0.29	1	0	-1
0022	3F	4_9	156	5	0	500	0	-500	0.00	0.00	0	0	0
0022	3F	4_9	234	2	2	200	610	410	1.00	3.05	0	1	1
0022	3F	4_9	235	2	0	200	0	-200	0.00	0.00	0	0	0
0022	3F	4_9	236	2	0	200	0	-200	0.00	0.00	0	0	0
0022	3F	4_9	246	1	0	100	0	-100	0.00	0.00	0	0	0
0022	3F	5_1	123	143	38	14300	11980	-2320	0.27	0.84	25	21	-4
0022	3F	5_1	124	157	35	15700	12980	-2720	0.22	0.83	27	22	-5
0022	3F	5_1	125	30	4	3000	2580	-420	0.13	0.86	5	4	-1
0022	3F	5_1	126	19	1	1900	300	-1600	0.05	0.16	3	0	-3
0022	3F	5_1	134	61	14	6100	5410	-690	0.23	0.89	10	9	-1
0022	3F	5_1	135	23	2	2300	600	-1700	0.09	0.26	4	1	-3
0022	3F	5_1	136	8	2	800	970	170	0.25	1.21	1	1	0
0022	3F	5_1	145	9	3	900	2430	1530	0.33	2.70	1	4	3
0022	3F	5_1	146	3	0	300	0	-300	0.00	0.00	0	0	0
0022	3F	5_1	156	1	0	100	0	-100	0.00	0.00	0	0	0
0022	3F	5_1	235	1	1	100	290	190	1.00	2.90	0	0	0
0022	3F	5_10	123	99	30	9900	7080	-2820	0.30	0.72	17	12	-5
0022	3F	5_10	124	346	75	34600	26050	-8550	0.22	0.75	61	46	-15
0022	3F	5_10	125	80	10	8000	5120	-2880	0.13	0.64	14	9	-5
0022	3F	5_10	126	41	5	4100	4560	460	0.12	1.11	7	8	1
0022	3F	5_10	134	42	9	4200	3500	-700	0.21	0.83	7	6	-1
0022	3F	5_10	135	23	0	2300	0	-2300	0.00	0.00	4	0	-4
0022	3F	5_10	136	5	0	500	0	-500	0.00	0.00	0	0	0
0022	3F	5_10	145	2	0	200	0	-200	0.00	0.00	0	0	0
0022	3F	5_10	146	1	0	100	0	-100	0.00	0.00	0	0	0
0022	3F	5_10	156	1	0	100	0	-100	0.00	0.00	0	0	0
0022	3F	5_10	234	2	0	200	0	-200	0.00	0.00	0	0	0
0022	3F	5_10	235	2	0	200	0	-200	0.00	0.00	0	0	0
0022	3F	5_11	123	158	49	15800	11610	-4190	0.31	0.73	27	20	-7
0022	3F	5_11	124	340	56	34000	20680	-13320	0.16	0.61	60	36	-24
0022	3F	5_11	125	73	9	7300	4500	-2800	0.12	0.62	12	7	-5
0022	3F	5_11	126	21	2	2100	1240	-860	0.10	0.59	3	2	-1
0022	3F	5_11	134	46	8	4600	3240	-1360	0.17	0.70	8	5	-3
0022	3F	5_11	135	26	5	2600	2720	120	0.19	1.05	4	4	0
0022	3F	5_11	136	7	1	700	780	80	0.14	1.11	1	1	0
0022	3F	5_11	145	3	0	300	0	-300	0.00	0.00	0	0	0
0022	3F	5_11	235	1	0	100	0	-100	0.00	0.00	0	0	0
0022	3F	5_12	123	125	35	12500	8030	-4470	0.28	0.64	22	14	-8
0022	3F	5_12	124	325	56	32500	22120	-10380	0.17	0.68	57	39	-18
0022	3F	5_12	125	69	14	6900	6970	70	0.20	1.01	12	12	0
0022	3F	5_12	126	26	5	2600	3450	850	0.19	1.33	4	6	2
0022	3F	5_12	134	44	8	4400	3620	-780	0.18	0.82	7	6	-1
0022	3F	5_12	135	39	6	3900	2430	-1470	0.15	0.62	6	4	-2
0022	3F	5_12	136	15	2	1500	860	-640	0.13	0.57	2	1	-1
0022	3F	5_12	145	4	0	400	0	-400	0.00	0.00	0	0	0
0022	3F	5_12	146	3	0	300	0	-300	0.00	0.00	0	0	0
0022	3F	5_12	246	1	0	100	0	-100	0.00	0.00	0	0	0
0022	3F	5_2	123	109	23	10900	7310	-3590	0.21	0.67	19	12	-7
0022	3F	5_2	124	102	26	10200	9030	-1170	0.25	0.89	18	15	-3
0022	3F	5_2	125	56	14	5600	5530	-70	0.25	0.99	9	9	0
0022	3F	5_2	126	29	2	2900	1030	-1870	0.07	0.36	5	1	-4
0022	3F	5_2	134	34	3	3400	990	-2410	0.09	0.29	6	1	-5
0022	3F	5_2	135	28	7	2800	2850	50	0.25	1.02	4	5	1
0022	3F	5_2	136	12	3	1200	800	-400	0.25	0.67	2	1	-1
0022	3F	5_2	145	21	5	2100	2010	-90	0.24	0.96	3	3	0
0022	3F	5_2	146	10	2	1000	880	-120	0.20	0.88	1	1	0
0022	3F	5_2	156	3	0	300	0	-300	0.00	0.00	0	0	0
0022	3F	5_2	234	3	1	300	380	80	0.33	1.27	0	0	0
0022	3F	5_2	235	2	0	200	0	-200	0.00	0.00	0	0	0
0022	3F	5_2	245	1	0	100	0	-100	0.00	0.00	0	0	0
0022	3F	5_2	256	1	1	100	430	330	1.00	4.30	0	0	0
0022	3F	5_3	123	40	13	4000	4730	730	0.33	1.18	7	8	1
0022	3F	5_3	124	74	14	7400	4000	-3400	0.19	0.54	13	7	-6
0022	3F	5_3	125	56	5	5600	2940	-2660	0.09	0.53	9	5	-4
0022	3F	5_3	126	53	16	5300	9200	3900	0.30	1.74	9	16	7
0022	3F	5_3	134	54	16	5400	5430	30	0.30	1.01	9	9	0
0022	3F	5_3	135	61	10	6100	2470	-3630	0.16	0.40	10	4	-6
0022	3F	5_3	136	18	3	1800	1420	-380	0.17	0.79	3	2	-1
0022	3F	5_3	145	15	3	1500	920	-580	0.20	0.61	2	1	-1
0022	3F	5_3	146	17	3	1700	1490	-210	0.18	0.88	3	2	-1
0022	3F	5_3	156	5	2	500	940	440	0.40	1.88	0	1	1
0022	3F	5_3	234	1	1	100	420	320	1.00	4.20	0	0	0
0022	3F	5_3	235	1	0	100	0	-100	0.00	0.00	0	0	0
0022	3F	5_3	236	4	1	400	480	80	0.25	1.20	0	0	0
0022	3F	5_3	246	3	0	300	0	-300	0.00	0.00	0	0	0
0022	3F	5_4	123	43	14	4300	3300	-1000	0.33	0.77	7	5	-2
0022	3F	5_4	124	123	23	12300	6520	-5780	0.19	0.53	21	11	-10
0022	3F	5_4	125	54	4	5400	1400	-4000	0.07	0.26	9	2	-7
0022	3F	5_4	126	38	6	3800	5010	1210	0.16	1.32	6	8	2
0022	3F	5_4	134	42	10	4200	2370	-1830	0.24	0.56	7	4	-3
0022	3F	5_4	135	40	7	4000	2080	-1920	0.18	0.52	7	3	-4
0022	3F	5_4	136	17	4	1700	1350	-350	0.24	0.79	3	2	-1
0022	3F	5_4	145	27	3	2700	760	-1940	0.11	0.28	4	1	-3
0022	3F	5_4	146	18	2	1800	510	-1290	0.11	0.28	3	0	-3
0022	3F	5_4	156	12	3	1200	1160	-40	0.25	0.97	2	2	0
0022	3F	5_4	235	1	0	100	0	-100	0.00	0.00	0	0	0
0022	3F	5_4	236	1	0	100	0	-100	0.00	0.00	0	0	0
0022	3F	5_4	245	4	1	400	240	-160	0.25	0.60	0	0	0
0022	3F	5_4	246	1	0	100	0	-100	0.00	0.00	0	0	0
0022	3F	5_4	256	2	0	200	0	-200	0.00	0.00	0	0	0
0022	3F	5_5	123	69	21	6900	5100	-1800	0.30	0.74	12	9	-3
0022	3F	5_5	124	109	31	10900	7380	-3520	0.28	0.68	19	13	-6
0022	3F	5_5	125	71	18	7100	6660	-440	0.25	0.94	12	11	-1
0022	3F	5_5	126	51	15	5100	6540	1440	0.29	1.28	9	11	2
0022	3F	5_5	134	45	12	4500	3910	-590	0.27	0.87	7	6	-1
0022	3F	5_5	135	35	6	3500	2650	-850	0.17	0.76	6	4	-2
0022	3F	5_5	136	22	2	2200	1060	-1140	0.09	0.48	3	1	-2
0022	3F	5_5	145	23	7	2300	2010	-290	0.30	0.87	4	3	-1
0022	3F	5_5	146	14	2	1400	3900	2500	0.14	2.79	2	6	4
0022	3F	5_5	156	7	0	700	0	-700	0.00	0.00	1	0	-1
0022	3F	5_5	234	4	0	400	0	-400	0.00	0.00	0	0	0
0022	3F	5_5	236	3	0	300	0	-300	0.00	0.00	0	0	0
0022	3F	5_5	246	1	0	100	0	-100	0.00	0.00	0	0	0
0022	3F	5_5	256	1	0	100	0	-100	0.00	0.00	0	0	0
0022	3F	5_6	123	42	14	4200	3270	-930	0.33	0.78	7	5	-2
0022	3F	5_6	124	97	22	9700	5840	-3860	0.23	0.60	17	10	-7
0022	3F	5_6	125	62	8	6200	4050	-2150	0.13	0.65	10	7	-3
0022	3F	5_6	126	47	7	4700	2960	-1740	0.15	0.63	8	5	-3
0022	3F	5_6	134	81	25	8100	6400	-1700	0.31	0.79	14	11	-3
0022	3F	5_6	135	32	5	3200	2010	-1190	0.16	0.63	5	3	-2
0022	3F	5_6	136	18	4	1800	3150	1350	0.22	1.75	3	5	2
0022	3F	5_6	145	21	5	2100	1630	-470	0.24	0.78	3	2	-1
0022	3F	5_6	146	15	2	1500	950	-550	0.13	0.63	2	1	-1
0022	3F	5_6	156	9	0	900	0	-900	0.00	0.00	1	0	-1
0022	3F	5_6	234	1	0	100	0	-100	0.00	0.00	0	0	0
0022	3F	5_6	235	5	0	500	0	-500	0.00	0.00	0	0	0
0022	3F	5_6	236	2	0	200	0	-200	0.00	0.00	0	0	0
0022	3F	5_6	245	1	0	100	0	-100	0.00	0.00	0	0	0
0022	3F	5_6	246	2	2	200	3060	2860	1.00	15.30	0	5	5
0022	3F	5_7	123	50	11	5000	3020	-1980	0.22	0.60	8	5	-3
0022	3F	5_7	124	83	22	8300	6630	-1670	0.27	0.80	14	11	-3
0022	3F	5_7	125	62	14	6200	5630	-570	0.23	0.91	10	9	-1
0022	3F	5_7	126	59	9	5900	4960	-940	0.15	0.84	10	8	-2
0022	3F	5_7	134	57	24	5700	5590	-110	0.42	0.98	10	9	-1
0022	3F	5_7	135	40	10	4000	6600	2600	0.25	1.65	7	11	4
0022	3F	5_7	136	32	8	3200	4480	1280	0.25	1.40	5	7	2
0022	3F	5_7	145	39	8	3900	2500	-1400	0.21	0.64	6	4	-2
0022	3F	5_7	146	13	3	1300	1170	-130	0.23	0.90	2	2	0
0022	3F	5_7	156	10	3	1000	1350	350	0.30	1.35	1	2	1
0022	3F	5_7	234	1	0	100	0	-100	0.00	0.00	0	0	0
0022	3F	5_7	235	1	0	100	0	-100	0.00	0.00	0	0	0
0022	3F	5_7	236	2	0	200	0	-200	0.00	0.00	0	0	0
0022	3F	5_7	245	1	0	100	0	-100	0.00	0.00	0	0	0
0022	3F	5_8	123	31	13	3100	3260	160	0.42	1.05	5	5	0
0022	3F	5_8	124	100	32	10000	8780	-1220	0.32	0.88	17	15	-2
0022	3F	5_8	125	56	14	5600	5170	-430	0.25	0.92	9	9	0
0022	3F	5_8	126	52	11	5200	5060	-140	0.21	0.97	9	8	-1
0022	3F	5_8	134	50	7	5000	2280	-2720	0.14	0.46	8	4	-4
0022	3F	5_8	135	28	7	2800	2730	-70	0.25	0.98	4	4	0
0022	3F	5_8	136	46	12	4600	4520	-80	0.26	0.98	8	8	0
0022	3F	5_8	145	25	3	2500	1370	-1130	0.12	0.55	4	2	-2
0022	3F	5_8	146	22	5	2200	2060	-140	0.23	0.94	3	3	0
0022	3F	5_8	156	9	0	900	0	-900	0.00	0.00	1	0	-1
0022	3F	5_8	234	1	0	100	0	-100	0.00	0.00	0	0	0
0022	3F	5_8	235	2	0	200	0	-200	0.00	0.00	0	0	0
0022	3F	5_8	236	3	0	300	0	-300	0.00	0.00	0	0	0
0022	3F	5_9	123	58	11	5800	3020	-2780	0.19	0.52	10	5	-5
0022	3F	5_9	124	168	40	16800	13700	-3100	0.24	0.82	29	24	-5
0022	3F	5_9	125	75	5	7500	1880	-5620	0.07	0.25	13	3	-10
0022	3F	5_9	126	71	14	7100	13670	6570	0.20	1.93	12	24	12
0022	3F	5_9	134	52	11	5200	4770	-430	0.21	0.92	9	8	-1
0022	3F	5_9	135	34	3	3400	1660	-1740	0.09	0.49	6	2	-4
0022	3F	5_9	136	33	3	3300	1190	-2110	0.09	0.36	5	2	-3
0022	3F	5_9	145	24	4	2400	1350	-1050	0.17	0.56	4	2	-2
0022	3F	5_9	146	12	3	1200	1210	10	0.25	1.01	2	2	0
0022	3F	5_9	156	5	0	500	0	-500	0.00	0.00	0	0	0
0022	3F	5_9	234	1	0	100	0	-100	0.00	0.00	0	0	0
0022	3F	5_9	245	1	0	100	0	-100	0.00	0.00	0	0	0
0022	3F	5_9	246	1	0	100	0	-100	0.00	0.00	0	0	0
0022	3F	6_1	123	2	1	200	310	110	0.50	1.55	0	0	0
0022	3F	6_1	124	9	3	900	830	-70	0.33	0.92	1	1	0
0022	3F	6_1	125	3	1	300	390	90	0.33	1.30	0	0	0
0022	3F	6_1	126	3	0	300	0	-300	0.00	0.00	0	0	0
0022	3F	6_1	134	3	1	300	350	50	0.33	1.17	0	0	0
0022	3F	6_1	145	1	0	100	0	-100	0.00	0.00	0	0	0
0022	3F	6_1	235	1	0	100	0	-100	0.00	0.00	0	0	0
0022	3F	6_10	123	6	1	600	310	-290	0.17	0.52	1	0	-1
0022	3F	6_10	124	32	6	3200	1870	-1330	0.19	0.58	5	3	-2
0022	3F	6_10	125	8	3	800	1580	780	0.38	1.98	1	2	1
0022	3F	6_10	126	1	0	100	0	-100	0.00	0.00	0	0	0
0022	3F	6_10	134	5	1	500	370	-130	0.20	0.74	0	0	0
0022	3F	6_10	135	1	1	100	570	470	1.00	5.70	0	1	1
0022	3F	6_11	123	10	3	1000	1020	20	0.30	1.02	1	1	0
0022	3F	6_11	124	36	3	3600	2040	-1560	0.08	0.57	6	3	-3
0022	3F	6_11	125	2	0	200	0	-200	0.00	0.00	0	0	0
0022	3F	6_11	126	3	0	300	0	-300	0.00	0.00	0	0	0
0022	3F	6_11	134	3	1	300	220	-80	0.33	0.73	0	0	0
0022	3F	6_11	135	3	0	300	0	-300	0.00	0.00	0	0	0
0022	3F	6_12	123	8	3	800	960	160	0.38	1.20	1	1	0
0022	3F	6_12	124	26	5	2600	1670	-930	0.19	0.64	4	2	-2
0022	3F	6_12	125	8	4	800	2500	1700	0.50	3.13	1	4	3
0022	3F	6_12	126	3	0	300	0	-300	0.00	0.00	0	0	0
0022	3F	6_12	134	3	0	300	0	-300	0.00	0.00	0	0	0
0022	3F	6_12	135	5	1	500	1130	630	0.20	2.26	0	2	2
0022	3F	6_12	136	1	1	100	670	570	1.00	6.70	0	1	1
0022	3F	6_12	145	1	0	100	0	-100	0.00	0.00	0	0	0
0022	3F	6_2	123	1	1	100	230	130	1.00	2.30	0	0	0
0022	3F	6_2	124	11	3	1100	950	-150	0.27	0.86	1	1	0
0022	3F	6_2	125	3	1	300	300	0	0.33	1.00	0	0	0
0022	3F	6_2	126	4	1	400	150	-250	0.25	0.38	0	0	0
0022	3F	6_2	134	4	0	400	0	-400	0.00	0.00	0	0	0
0022	3F	6_2	136	2	0	200	0	-200	0.00	0.00	0	0	0
0022	3F	6_3	123	1	0	100	0	-100	0.00	0.00	0	0	0
0022	3F	6_3	124	5	1	500	790	290	0.20	1.58	0	1	1
0022	3F	6_3	125	3	1	300	630	330	0.33	2.10	0	1	1
0022	3F	6_3	126	5	4	500	3680	3180	0.80	7.36	0	6	6
0022	3F	6_3	134	2	0	200	0	-200	0.00	0.00	0	0	0
0022	3F	6_3	135	7	0	700	0	-700	0.00	0.00	1	0	-1
0022	3F	6_3	136	5	0	500	0	-500	0.00	0.00	0	0	0
0022	3F	6_3	145	3	0	300	0	-300	0.00	0.00	0	0	0
0022	3F	6_3	146	2	0	200	0	-200	0.00	0.00	0	0	0
0022	3F	6_3	234	1	0	100	0	-100	0.00	0.00	0	0	0
0022	3F	6_4	123	4	0	400	0	-400	0.00	0.00	0	0	0
0022	3F	6_4	124	9	1	900	390	-510	0.11	0.43	1	0	-1
0022	3F	6_4	125	5	2	500	920	420	0.40	1.84	0	1	1
0022	3F	6_4	126	6	0	600	0	-600	0.00	0.00	1	0	-1
0022	3F	6_4	134	2	0	200	0	-200	0.00	0.00	0	0	0
0022	3F	6_4	135	1	1	100	400	300	1.00	4.00	0	0	0
0022	3F	6_4	136	3	0	300	0	-300	0.00	0.00	0	0	0
0022	3F	6_4	145	2	0	200	0	-200	0.00	0.00	0	0	0
0022	3F	6_4	146	2	1	200	3370	3170	0.50	16.85	0	5	5
0022	3F	6_4	156	1	0	100	0	-100	0.00	0.00	0	0	0
0022	3F	6_5	123	5	0	500	0	-500	0.00	0.00	0	0	0
0022	3F	6_5	124	8	3	800	1090	290	0.38	1.36	1	1	0
0022	3F	6_5	125	4	1	400	360	-40	0.25	0.90	0	0	0
0022	3F	6_5	126	8	1	800	280	-520	0.13	0.35	1	0	-1
0022	3F	6_5	134	7	4	700	1040	340	0.57	1.49	1	1	0
0022	3F	6_5	135	1	0	100	0	-100	0.00	0.00	0	0	0
0022	3F	6_5	136	1	0	100	0	-100	0.00	0.00	0	0	0
0022	3F	6_5	145	5	1	500	370	-130	0.20	0.74	0	0	0
0022	3F	6_5	146	1	1	100	280	180	1.00	2.80	0	0	0
0022	3F	6_6	123	3	1	300	240	-60	0.33	0.80	0	0	0
0022	3F	6_6	124	3	1	300	170	-130	0.33	0.57	0	0	0
0022	3F	6_6	125	5	0	500	0	-500	0.00	0.00	0	0	0
0022	3F	6_6	126	7	3	700	1280	580	0.43	1.83	1	2	1
0022	3F	6_6	134	1	1	100	240	140	1.00	2.40	0	0	0
0022	3F	6_6	135	4	1	400	250	-150	0.25	0.63	0	0	0
0022	3F	6_6	136	4	0	400	0	-400	0.00	0.00	0	0	0
0022	3F	6_6	145	1	0	100	0	-100	0.00	0.00	0	0	0
0022	3F	6_6	146	3	1	300	280	-20	0.33	0.93	0	0	0
0022	3F	6_6	156	1	0	100	0	-100	0.00	0.00	0	0	0
0022	3F	6_7	123	4	0	400	0	-400	0.00	0.00	0	0	0
0022	3F	6_7	124	4	1	400	300	-100	0.25	0.75	0	0	0
0022	3F	6_7	125	8	1	800	210	-590	0.13	0.26	1	0	-1
0022	3F	6_7	126	4	1	400	270	-130	0.25	0.68	0	0	0
0022	3F	6_7	134	3	1	300	430	130	0.33	1.43	0	0	0
0022	3F	6_7	135	7	3	700	560	-140	0.43	0.80	1	0	-1
0022	3F	6_7	136	1	0	100	0	-100	0.00	0.00	0	0	0
0022	3F	6_7	145	7	2	700	440	-260	0.29	0.63	1	0	-1
0022	3F	6_7	146	1	0	100	0	-100	0.00	0.00	0	0	0
0022	3F	6_8	123	6	0	600	0	-600	0.00	0.00	1	0	-1
0022	3F	6_8	124	11	2	1100	410	-690	0.18	0.37	1	0	-1
0022	3F	6_8	125	5	0	500	0	-500	0.00	0.00	0	0	0
0022	3F	6_8	126	2	0	200	0	-200	0.00	0.00	0	0	0
0022	3F	6_8	134	3	1	300	400	100	0.33	1.33	0	0	0
0022	3F	6_8	135	1	0	100	0	-100	0.00	0.00	0	0	0
0022	3F	6_8	136	5	0	500	0	-500	0.00	0.00	0	0	0
0022	3F	6_8	146	2	1	200	250	50	0.50	1.25	0	0	0
0022	3F	6_8	156	1	0	100	0	-100	0.00	0.00	0	0	0
0022	3F	6_9	123	6	2	600	680	80	0.33	1.13	1	1	0
0022	3F	6_9	124	14	5	1400	1370	-30	0.36	0.98	2	2	0
0022	3F	6_9	125	7	0	700	0	-700	0.00	0.00	1	0	-1
0022	3F	6_9	126	5	0	500	0	-500	0.00	0.00	0	0	0
0022	3F	6_9	134	6	1	600	270	-330	0.17	0.45	1	0	-1
0022	3F	6_9	135	4	0	400	0	-400	0.00	0.00	0	0	0
0022	3F	6_9	136	3	1	300	530	230	0.33	1.77	0	0	0
0022	3F	6_9	145	2	0	200	0	-200	0.00	0.00	0	0	0
0022	3F	7_1	123	271	75	27100	23320	-3780	0.28	0.86	47	41	-6
0022	3F	7_1	124	242	51	24200	18110	-6090	0.21	0.75	42	32	-10
0022	3F	7_1	125	67	13	6700	4700	-2000	0.19	0.70	11	8	-3
0022	3F	7_1	126	31	2	3100	1490	-1610	0.06	0.48	5	2	-3
0022	3F	7_1	134	70	21	7000	7670	670	0.30	1.10	12	13	1
0022	3F	7_1	135	28	6	2800	2190	-610	0.21	0.78	4	3	-1
0022	3F	7_1	136	13	3	1300	1910	610	0.23	1.47	2	3	1
0022	3F	7_1	145	10	1	1000	790	-210	0.10	0.79	1	1	0
0022	3F	7_1	146	6	0	600	0	-600	0.00	0.00	1	0	-1
0022	3F	7_1	234	3	0	300	0	-300	0.00	0.00	0	0	0
0022	3F	7_1	235	2	1	200	220	20	0.50	1.10	0	0	0
0022	3F	7_1	236	1	0	100	0	-100	0.00	0.00	0	0	0
0022	3F	7_1	245	1	0	100	0	-100	0.00	0.00	0	0	0
0022	3F	7_10	123	114	34	11400	9770	-1630	0.30	0.86	20	17	-3
0022	3F	7_10	124	370	71	37000	25990	-11010	0.19	0.70	65	46	-19
0022	3F	7_10	125	186	31	18600	17520	-1080	0.17	0.94	32	31	-1
0022	3F	7_10	126	98	7	9800	7950	-1850	0.07	0.81	17	14	-3
0022	3F	7_10	134	79	13	7900	5660	-2240	0.16	0.72	13	10	-3
0022	3F	7_10	135	73	7	7300	4090	-3210	0.10	0.56	12	7	-5
0022	3F	7_10	136	33	1	3300	940	-2360	0.03	0.28	5	1	-4
0022	3F	7_10	145	22	3	2200	2560	360	0.14	1.16	3	4	1
0022	3F	7_10	146	4	0	400	0	-400	0.00	0.00	0	0	0
0022	3F	7_10	156	3	1	300	430	130	0.33	1.43	0	0	0
0022	3F	7_10	235	2	0	200	0	-200	0.00	0.00	0	0	0
0022	3F	7_10	245	1	0	100	0	-100	0.00	0.00	0	0	0
0022	3F	7_10	246	1	0	100	0	-100	0.00	0.00	0	0	0
0022	3F	7_11	123	106	26	10600	6240	-4360	0.25	0.59	18	11	-7
0022	3F	7_11	124	354	78	35400	27900	-7500	0.22	0.79	62	49	-13
0022	3F	7_11	125	165	27	16500	17420	920	0.16	1.06	29	30	1
0022	3F	7_11	126	125	9	12500	7280	-5220	0.07	0.58	22	12	-10
0022	3F	7_11	134	105	16	10500	6030	-4470	0.15	0.57	18	10	-8
0022	3F	7_11	135	56	3	5600	1910	-3690	0.05	0.34	9	3	-6
0022	3F	7_11	136	48	4	4800	4130	-670	0.08	0.86	8	7	-1
0022	3F	7_11	145	14	0	1400	0	-1400	0.00	0.00	2	0	-2
0022	3F	7_11	146	13	2	1300	1860	560	0.15	1.43	2	3	1
0022	3F	7_11	156	2	1	200	800	600	0.50	4.00	0	1	1
0022	3F	7_11	235	1	0	100	0	-100	0.00	0.00	0	0	0
0022	3F	7_11	245	1	0	100	0	-100	0.00	0.00	0	0	0
0022	3F	7_11	256	1	0	100	0	-100	0.00	0.00	0	0	0
0022	3F	7_12	123	57	14	5700	4290	-1410	0.25	0.75	10	7	-3
0022	3F	7_12	124	799	131	79900	54230	-25670	0.16	0.68	141	95	-46
0022	3F	7_12	125	43	4	4300	1880	-2420	0.09	0.44	7	3	-4
0022	3F	7_12	126	77	6	7700	9290	1590	0.08	1.21	13	16	3
0022	3F	7_12	134	52	6	5200	2690	-2510	0.12	0.52	9	4	-5
0022	3F	7_12	135	13	1	1300	600	-700	0.08	0.46	2	1	-1
0022	3F	7_12	136	19	0	1900	0	-1900	0.00	0.00	3	0	-3
0022	3F	7_12	145	1	0	100	0	-100	0.00	0.00	0	0	0
0022	3F	7_2	123	171	44	17100	12620	-4480	0.26	0.74	30	22	-8
0022	3F	7_2	124	174	34	17400	15720	-1680	0.20	0.90	30	27	-3
0022	3F	7_2	125	91	17	9100	7090	-2010	0.19	0.78	16	12	-4
0022	3F	7_2	126	71	15	7100	9320	2220	0.21	1.31	12	16	4
0022	3F	7_2	134	70	7	7000	2800	-4200	0.10	0.40	12	4	-8
0022	3F	7_2	135	30	4	3000	1300	-1700	0.13	0.43	5	2	-3
0022	3F	7_2	136	24	1	2400	2010	-390	0.04	0.84	4	3	-1
0022	3F	7_2	145	15	1	1500	360	-1140	0.07	0.24	2	0	-2
0022	3F	7_2	146	15	2	1500	890	-610	0.13	0.59	2	1	-1
0022	3F	7_2	156	4	0	400	0	-400	0.00	0.00	0	0	0
0022	3F	7_2	234	5	1	500	340	-160	0.20	0.68	0	0	0
0022	3F	7_2	235	5	1	500	1100	600	0.20	2.20	0	1	1
0022	3F	7_2	245	2	0	200	0	-200	0.00	0.00	0	0	0
0022	3F	7_3	123	73	19	7300	6270	-1030	0.26	0.86	12	11	-1
0022	3F	7_3	124	127	19	12700	11070	-1630	0.15	0.87	22	19	-3
0022	3F	7_3	125	117	22	11700	12040	340	0.19	1.03	20	21	1
0022	3F	7_3	126	96	14	9600	8240	-1360	0.15	0.86	16	14	-2
0022	3F	7_3	134	73	14	7300	3910	-3390	0.19	0.54	12	6	-6
0022	3F	7_3	135	76	10	7600	3840	-3760	0.13	0.51	13	6	-7
0022	3F	7_3	136	42	4	4200	2160	-2040	0.10	0.51	7	3	-4
0022	3F	7_3	145	32	3	3200	1700	-1500	0.09	0.53	5	3	-2
0022	3F	7_3	146	37	5	3700	4920	1220	0.14	1.33	6	8	2
0022	3F	7_3	156	10	2	1000	1140	140	0.20	1.14	1	2	1
0022	3F	7_3	234	4	0	400	0	-400	0.00	0.00	0	0	0
0022	3F	7_3	235	7	1	700	490	-210	0.14	0.70	1	0	-1
0022	3F	7_3	236	5	2	500	1730	1230	0.40	3.46	0	3	3
0022	3F	7_3	245	3	0	300	0	-300	0.00	0.00	0	0	0
0022	3F	7_3	246	4	1	400	600	200	0.25	1.50	0	1	1
0022	3F	7_3	256	2	0	200	0	-200	0.00	0.00	0	0	0
0022	3F	7_4	123	96	34	9600	9080	-520	0.35	0.95	16	16	0
0022	3F	7_4	124	173	44	17300	18520	1220	0.25	1.07	30	32	2
0022	3F	7_4	125	93	14	9300	6340	-2960	0.15	0.68	16	11	-5
0022	3F	7_4	126	96	13	9600	6990	-2610	0.14	0.73	16	12	-4
0022	3F	7_4	134	74	13	7400	4160	-3240	0.18	0.56	13	7	-6
0022	3F	7_4	135	42	5	4200	1410	-2790	0.12	0.34	7	2	-5
0022	3F	7_4	136	49	7	4900	4320	-580	0.14	0.88	8	7	-1
0022	3F	7_4	145	40	7	4000	4670	670	0.18	1.17	7	8	1
0022	3F	7_4	146	38	5	3800	2250	-1550	0.13	0.59	6	3	-3
0022	3F	7_4	156	11	2	1100	1240	140	0.18	1.13	1	2	1
0022	3F	7_4	234	2	1	200	310	110	0.50	1.55	0	0	0
0022	3F	7_4	235	5	0	500	0	-500	0.00	0.00	0	0	0
0022	3F	7_4	236	5	1	500	1450	950	0.20	2.90	0	2	2
0022	3F	7_4	245	1	0	100	0	-100	0.00	0.00	0	0	0
0022	3F	7_4	246	7	1	700	390	-310	0.14	0.56	1	0	-1
0022	3F	7_4	256	1	0	100	0	-100	0.00	0.00	0	0	0
0022	3F	7_5	123	100	24	10000	5640	-4360	0.24	0.56	17	9	-8
0022	3F	7_5	124	205	48	20500	12930	-7570	0.23	0.63	36	22	-14
0022	3F	7_5	125	98	22	9800	6600	-3200	0.22	0.67	17	11	-6
0022	3F	7_5	126	101	18	10100	8630	-1470	0.18	0.85	17	15	-2
0022	3F	7_5	134	67	12	6700	3940	-2760	0.18	0.59	11	6	-5
0022	3F	7_5	135	50	6	5000	3090	-1910	0.12	0.62	8	5	-3
0022	3F	7_5	136	45	5	4500	1860	-2640	0.11	0.41	7	3	-4
0022	3F	7_5	145	29	5	2900	1730	-1170	0.17	0.60	5	3	-2
0022	3F	7_5	146	21	2	2100	1030	-1070	0.10	0.49	3	1	-2
0022	3F	7_5	156	15	1	1500	440	-1060	0.07	0.29	2	0	-2
0022	3F	7_5	235	2	0	200	0	-200	0.00	0.00	0	0	0
0022	3F	7_5	236	3	0	300	0	-300	0.00	0.00	0	0	0
0022	3F	7_5	245	2	0	200	0	-200	0.00	0.00	0	0	0
0022	3F	7_5	256	5	0	500	0	-500	0.00	0.00	0	0	0
0022	3F	7_6	123	91	31	9100	7350	-1750	0.34	0.81	16	13	-3
0022	3F	7_6	124	119	32	11900	9610	-2290	0.27	0.81	21	17	-4
0022	3F	7_6	125	75	17	7500	4730	-2770	0.23	0.63	13	8	-5
0022	3F	7_6	126	99	14	9900	6180	-3720	0.14	0.62	17	10	-7
0022	3F	7_6	134	75	20	7500	6220	-1280	0.27	0.83	13	11	-2
0022	3F	7_6	135	43	7	4300	1890	-2410	0.16	0.44	7	3	-4
0022	3F	7_6	136	76	16	7600	7990	390	0.21	1.05	13	14	1
0022	3F	7_6	145	32	3	3200	680	-2520	0.09	0.21	5	1	-4
0022	3F	7_6	146	29	2	2900	680	-2220	0.07	0.23	5	1	-4
0022	3F	7_6	156	13	2	1300	810	-490	0.15	0.62	2	1	-1
0022	3F	7_6	234	4	0	400	0	-400	0.00	0.00	0	0	0
0022	3F	7_6	235	2	0	200	0	-200	0.00	0.00	0	0	0
0022	3F	7_6	236	3	0	300	0	-300	0.00	0.00	0	0	0
0022	3F	7_6	245	1	0	100	0	-100	0.00	0.00	0	0	0
0022	3F	7_6	246	3	1	300	360	60	0.33	1.20	0	0	0
0022	3F	7_6	256	3	0	300	0	-300	0.00	0.00	0	0	0
0022	3F	7_7	123	80	19	8000	5460	-2540	0.24	0.68	14	9	-5
0022	3F	7_7	124	145	32	14500	9460	-5040	0.22	0.65	25	16	-9
0022	3F	7_7	125	107	17	10700	6960	-3740	0.16	0.65	18	12	-6
0022	3F	7_7	126	129	25	12900	13490	590	0.19	1.05	22	23	1
0022	3F	7_7	134	51	14	5100	4350	-750	0.27	0.85	9	7	-2
0022	3F	7_7	135	53	10	5300	4640	-660	0.19	0.88	9	8	-1
0022	3F	7_7	136	55	7	5500	2230	-3270	0.13	0.41	9	3	-6
0022	3F	7_7	145	25	4	2500	1580	-920	0.16	0.63	4	2	-2
0022	3F	7_7	146	32	5	3200	1570	-1630	0.16	0.49	5	2	-3
0022	3F	7_7	156	19	1	1900	480	-1420	0.05	0.25	3	0	-3
0022	3F	7_7	235	2	0	200	0	-200	0.00	0.00	0	0	0
0022	3F	7_8	123	92	31	9200	8880	-320	0.34	0.97	16	15	-1
0022	3F	7_8	124	193	57	19300	16830	-2470	0.30	0.87	34	29	-5
0022	3F	7_8	125	102	26	10200	8860	-1340	0.25	0.87	18	15	-3
0022	3F	7_8	126	122	22	12200	12190	-10	0.18	1.00	21	21	0
0022	3F	7_8	134	72	22	7200	8980	1780	0.31	1.25	12	15	3
0022	3F	7_8	135	54	7	5400	2490	-2910	0.13	0.46	9	4	-5
0022	3F	7_8	136	59	8	5900	3420	-2480	0.14	0.58	10	6	-4
0022	3F	7_8	145	19	6	1900	2180	280	0.32	1.15	3	3	0
0022	3F	7_8	146	19	2	1900	1240	-660	0.11	0.65	3	2	-1
0022	3F	7_8	156	5	1	500	260	-240	0.20	0.52	0	0	0
0022	3F	7_8	234	2	0	200	0	-200	0.00	0.00	0	0	0
0022	3F	7_8	235	2	0	200	0	-200	0.00	0.00	0	0	0
0022	3F	7_8	236	1	0	100	0	-100	0.00	0.00	0	0	0
0022	3F	7_9	123	86	28	8600	8130	-470	0.33	0.95	15	14	-1
0022	3F	7_9	124	221	41	22100	13110	-8990	0.19	0.59	39	23	-16
0022	3F	7_9	125	117	22	11700	11280	-420	0.19	0.96	20	19	-1
0022	3F	7_9	126	95	14	9500	7300	-2200	0.15	0.77	16	12	-4
0022	3F	7_9	134	93	27	9300	11280	1980	0.29	1.21	16	19	3
0022	3F	7_9	135	75	11	7500	4630	-2870	0.15	0.62	13	8	-5
0022	3F	7_9	136	56	4	5600	2260	-3340	0.07	0.40	9	4	-5
0022	3F	7_9	145	32	7	3200	3050	-150	0.22	0.95	5	5	0
0022	3F	7_9	146	21	0	2100	0	-2100	0.00	0.00	3	0	-3
0022	3F	7_9	156	7	1	700	1000	300	0.14	1.43	1	1	0
0022	3F	7_9	234	2	0	200	0	-200	0.00	0.00	0	0	0
0022	3F	7_9	236	1	0	100	0	-100	0.00	0.00	0	0	0
0022	3F	7_9	245	1	0	100	0	-100	0.00	0.00	0	0	0
0022	3T	1_1	123	186	8	18600	4920	-13680	0.04	0.26	32	8	-24
0022	3T	1_1	124	65	4	6500	1910	-4590	0.06	0.29	11	3	-8
0022	3T	1_1	125	70	3	7000	3850	-3150	0.04	0.55	12	6	-6
0022	3T	1_1	126	12	2	1200	2550	1350	0.17	2.13	2	4	2
0022	3T	1_1	132	55	1	5500	1130	-4370	0.02	0.21	9	2	-7
0022	3T	1_1	134	44	4	4400	4760	360	0.09	1.08	7	8	1
0022	3T	1_1	135	45	3	4500	4130	-370	0.07	0.92	7	7	0
0022	3T	1_1	136	1	0	100	0	-100	0.00	0.00	0	0	0
0022	3T	1_1	142	48	3	4800	2450	-2350	0.06	0.51	8	4	-4
0022	3T	1_1	143	55	3	5500	3410	-2090	0.05	0.62	9	6	-3
0022	3T	1_1	145	56	1	5600	1120	-4480	0.02	0.20	9	1	-8
0022	3T	1_1	146	2	0	200	0	-200	0.00	0.00	0	0	0
0022	3T	1_1	152	23	1	2300	1550	-750	0.04	0.67	4	2	-2
0022	3T	1_1	153	19	1	1900	2690	790	0.05	1.42	3	4	1
0022	3T	1_1	154	2	0	200	0	-200	0.00	0.00	0	0	0
0022	3T	1_10	123	126	20	12600	14200	1600	0.16	1.13	22	25	3
0022	3T	1_10	124	316	22	31600	16720	-14880	0.07	0.53	55	29	-26
0022	3T	1_10	125	156	9	15600	7950	-7650	0.06	0.51	27	14	-13
0022	3T	1_10	126	89	5	8900	5400	-3500	0.06	0.61	15	9	-6
0022	3T	1_10	134	127	12	12700	11250	-1450	0.09	0.89	22	19	-3
0022	3T	1_10	135	92	7	9200	8920	-280	0.08	0.97	16	15	-1
0022	3T	1_10	136	46	2	4600	1890	-2710	0.04	0.41	8	3	-5
0022	3T	1_10	145	13	2	1300	2720	1420	0.15	2.09	2	4	2
0022	3T	1_10	146	7	0	700	0	-700	0.00	0.00	1	0	-1
0022	3T	1_10	154	1	0	100	0	-100	0.00	0.00	0	0	0
0022	3T	1_10	235	1	0	100	0	-100	0.00	0.00	0	0	0
0022	3T	1_11	123	137	22	13700	21020	7320	0.16	1.53	24	37	13
0022	3T	1_11	124	473	38	47300	31540	-15760	0.08	0.67	83	55	-28
0022	3T	1_11	125	123	4	12300	3930	-8370	0.03	0.32	21	6	-15
0022	3T	1_11	126	58	6	5800	14530	8730	0.10	2.51	10	25	15
0022	3T	1_11	134	115	5	11500	4570	-6930	0.04	0.40	20	8	-12
0022	3T	1_11	135	82	5	8200	6240	-1960	0.06	0.76	14	11	-3
0022	3T	1_11	136	21	2	2100	2910	810	0.10	1.39	3	5	2
0022	3T	1_11	142	1	0	100	0	-100	0.00	0.00	0	0	0
0022	3T	1_11	145	7	1	700	970	270	0.14	1.39	1	1	0
0022	3T	1_11	146	10	0	1000	0	-1000	0.00	0.00	1	0	-1
0022	3T	1_11	154	1	0	100	0	-100	0.00	0.00	0	0	0
0022	3T	1_11	156	1	0	100	0	-100	0.00	0.00	0	0	0
0022	3T	1_12	123	56	5	5600	3920	-1680	0.09	0.70	9	6	-3
0022	3T	1_12	124	908	58	90800	60470	-30330	0.06	0.67	160	107	-53
0022	3T	1_12	125	7	0	700	0	-700	0.00	0.00	1	0	-1
0022	3T	1_12	126	104	4	10400	8510	-1890	0.04	0.82	18	15	-3
0022	3T	1_12	134	12	1	1200	900	-300	0.08	0.75	2	1	-1
0022	3T	1_12	135	4	0	400	0	-400	0.00	0.00	0	0	0
0022	3T	1_12	136	8	0	800	0	-800	0.00	0.00	1	0	-1
0022	3T	1_2	123	241	33	24100	28010	3910	0.14	1.16	42	49	7
0022	3T	1_2	124	37	2	3700	5360	1660	0.05	1.45	6	9	3
0022	3T	1_2	125	89	4	8900	12140	3240	0.04	1.36	15	21	6
0022	3T	1_2	126	3	0	300	0	-300	0.00	0.00	0	0	0
0022	3T	1_2	132	6	0	600	0	-600	0.00	0.00	1	0	-1
0022	3T	1_2	134	27	2	2700	1500	-1200	0.07	0.56	4	2	-2
0022	3T	1_2	135	29	2	2900	4390	1490	0.07	1.51	5	7	2
0022	3T	1_2	136	4	0	400	0	-400	0.00	0.00	0	0	0
0022	3T	1_2	142	16	0	1600	0	-1600	0.00	0.00	2	0	-2
0022	3T	1_2	143	24	2	2400	4410	2010	0.08	1.84	4	7	3
0022	3T	1_2	145	35	2	3500	7650	4150	0.06	2.19	6	13	7
0022	3T	1_2	146	1	0	100	0	-100	0.00	0.00	0	0	0
0022	3T	1_2	152	1	0	100	0	-100	0.00	0.00	0	0	0
0022	3T	1_2	153	4	1	400	2380	1980	0.25	5.95	0	4	4
0022	3T	1_2	162	2	0	200	0	-200	0.00	0.00	0	0	0
0022	3T	1_2	163	2	0	200	0	-200	0.00	0.00	0	0	0
0022	3T	1_2	213	1	0	100	0	-100	0.00	0.00	0	0	0
0022	3T	1_2	215	10	3	1000	6290	5290	0.30	6.29	1	11	10
0022	3T	1_2	241	1	0	100	0	-100	0.00	0.00	0	0	0
0022	3T	1_2	245	1	0	100	0	-100	0.00	0.00	0	0	0
0022	3T	1_3	123	279	12	27900	19150	-8750	0.04	0.69	49	33	-16
0022	3T	1_3	124	84	4	8400	4160	-4240	0.05	0.50	14	7	-7
0022	3T	1_3	125	52	6	5200	8800	3600	0.12	1.69	9	15	6
0022	3T	1_3	126	31	2	3100	5020	1920	0.06	1.62	5	8	3
0022	3T	1_3	132	2	0	200	0	-200	0.00	0.00	0	0	0
0022	3T	1_3	134	34	0	3400	0	-3400	0.00	0.00	6	0	-6
0022	3T	1_3	135	25	0	2500	0	-2500	0.00	0.00	4	0	-4
0022	3T	1_3	136	4	1	400	1240	840	0.25	3.10	0	2	2
0022	3T	1_3	142	1	0	100	0	-100	0.00	0.00	0	0	0
0022	3T	1_3	143	55	4	5500	10260	4760	0.07	1.87	9	18	9
0022	3T	1_3	145	24	0	2400	0	-2400	0.00	0.00	4	0	-4
0022	3T	1_3	146	8	1	800	700	-100	0.13	0.88	1	1	0
0022	3T	1_3	153	2	0	200	0	-200	0.00	0.00	0	0	0
0022	3T	1_3	154	1	0	100	0	-100	0.00	0.00	0	0	0
0022	3T	1_3	156	1	0	100	0	-100	0.00	0.00	0	0	0
0022	3T	1_3	163	3	1	300	840	540	0.33	2.80	0	1	1
0022	3T	1_3	164	2	0	200	0	-200	0.00	0.00	0	0	0
0022	3T	1_3	165	3	1	300	1930	1630	0.33	6.43	0	3	3
0022	3T	1_3	216	1	0	100	0	-100	0.00	0.00	0	0	0
0022	3T	1_3	243	3	0	300	0	-300	0.00	0.00	0	0	0
0022	3T	1_3	245	1	0	100	0	-100	0.00	0.00	0	0	0
0022	3T	1_4	123	197	11	19700	14400	-5300	0.06	0.73	34	25	-9
0022	3T	1_4	124	52	4	5200	4710	-490	0.08	0.91	9	8	-1
0022	3T	1_4	125	91	4	9100	3000	-6100	0.04	0.33	16	5	-11
0022	3T	1_4	126	212	10	21200	23460	2260	0.05	1.11	37	41	4
0022	3T	1_4	134	17	1	1700	440	-1260	0.06	0.26	3	0	-3
0022	3T	1_4	135	56	2	5600	1810	-3790	0.04	0.32	9	3	-6
0022	3T	1_4	136	90	5	9000	7920	-1080	0.06	0.88	15	14	-1
0022	3T	1_4	143	31	3	3100	3130	30	0.10	1.01	5	5	0
0022	3T	1_4	145	20	1	2000	1430	-570	0.05	0.72	3	2	-1
0022	3T	1_4	146	34	4	3400	6460	3060	0.12	1.90	6	11	5
0022	3T	1_4	156	3	0	300	0	-300	0.00	0.00	0	0	0
0022	3T	1_4	163	3	0	300	0	-300	0.00	0.00	0	0	0
0022	3T	1_4	164	2	1	200	1260	1060	0.50	6.30	0	2	2
0022	3T	1_4	234	1	0	100	0	-100	0.00	0.00	0	0	0
0022	3T	1_4	235	3	0	300	0	-300	0.00	0.00	0	0	0
0022	3T	1_4	236	2	0	200	0	-200	0.00	0.00	0	0	0
0022	3T	1_4	245	1	0	100	0	-100	0.00	0.00	0	0	0
0022	3T	1_5	123	133	15	13300	10800	-2500	0.11	0.81	23	19	-4
0022	3T	1_5	124	232	21	23200	16190	-7010	0.09	0.70	41	28	-13
0022	3T	1_5	125	78	9	7800	9010	1210	0.12	1.16	13	15	2
0022	3T	1_5	126	111	4	11100	29780	18680	0.04	2.68	19	52	33
0022	3T	1_5	134	92	13	9200	13050	3850	0.14	1.42	16	23	7
0022	3T	1_5	135	31	3	3100	6140	3040	0.10	1.98	5	10	5
0022	3T	1_5	136	45	4	4500	4680	180	0.09	1.04	7	8	1
0022	3T	1_5	142	1	0	100	0	-100	0.00	0.00	0	0	0
0022	3T	1_5	143	4	0	400	0	-400	0.00	0.00	0	0	0
0022	3T	1_5	145	15	3	1500	2490	990	0.20	1.66	2	4	2
0022	3T	1_5	146	11	1	1100	1180	80	0.09	1.07	1	2	1
0022	3T	1_5	152	1	0	100	0	-100	0.00	0.00	0	0	0
0022	3T	1_5	153	1	0	100	0	-100	0.00	0.00	0	0	0
0022	3T	1_5	154	1	0	100	0	-100	0.00	0.00	0	0	0
0022	3T	1_5	156	3	0	300	0	-300	0.00	0.00	0	0	0
0022	3T	1_5	163	3	1	300	1500	1200	0.33	5.00	0	2	2
0022	3T	1_5	164	4	1	400	690	290	0.25	1.73	0	1	1
0022	3T	1_5	216	1	0	100	0	-100	0.00	0.00	0	0	0
0022	3T	1_5	234	4	0	400	0	-400	0.00	0.00	0	0	0
0022	3T	1_5	236	3	1	300	1260	960	0.33	4.20	0	2	2
0022	3T	1_5	245	5	0	500	0	-500	0.00	0.00	0	0	0
0022	3T	1_6	123	61	6	6100	2270	-3830	0.10	0.37	10	4	-6
0022	3T	1_6	124	132	12	13200	10720	-2480	0.09	0.81	23	18	-5
0022	3T	1_6	125	69	3	6900	4180	-2720	0.04	0.61	12	7	-5
0022	3T	1_6	126	118	3	11800	3520	-8280	0.03	0.30	20	6	-14
0022	3T	1_6	134	69	2	6900	1080	-5820	0.03	0.16	12	1	-11
0022	3T	1_6	135	38	2	3800	2690	-1110	0.05	0.71	6	4	-2
0022	3T	1_6	136	57	1	5700	570	-5130	0.02	0.10	10	1	-9
0022	3T	1_6	145	13	0	1300	0	-1300	0.00	0.00	2	0	-2
0022	3T	1_6	146	34	0	3400	0	-3400	0.00	0.00	6	0	-6
0022	3T	1_6	153	1	0	100	0	-100	0.00	0.00	0	0	0
0022	3T	1_6	156	9	0	900	0	-900	0.00	0.00	1	0	-1
0022	3T	1_6	163	4	0	400	0	-400	0.00	0.00	0	0	0
0022	3T	1_6	164	4	0	400	0	-400	0.00	0.00	0	0	0
0022	3T	1_6	214	1	0	100	0	-100	0.00	0.00	0	0	0
0022	3T	1_6	215	1	0	100	0	-100	0.00	0.00	0	0	0
0022	3T	1_6	216	4	0	400	0	-400	0.00	0.00	0	0	0
0022	3T	1_6	234	4	0	400	0	-400	0.00	0.00	0	0	0
0022	3T	1_6	235	4	0	400	0	-400	0.00	0.00	0	0	0
0022	3T	1_6	236	7	0	700	0	-700	0.00	0.00	1	0	-1
0022	3T	1_6	245	2	0	200	0	-200	0.00	0.00	0	0	0
0022	3T	1_6	246	6	0	600	0	-600	0.00	0.00	1	0	-1
0022	3T	1_6	256	4	0	400	0	-400	0.00	0.00	0	0	0
0022	3T	1_7	123	44	3	4400	2950	-1450	0.07	0.67	7	5	-2
0022	3T	1_7	124	119	10	11900	7290	-4610	0.08	0.61	21	12	-9
0022	3T	1_7	125	75	4	7500	5580	-1920	0.05	0.74	13	9	-4
0022	3T	1_7	126	85	5	8500	8330	-170	0.06	0.98	15	14	-1
0022	3T	1_7	132	2	0	200	0	-200	0.00	0.00	0	0	0
0022	3T	1_7	134	89	11	8900	9160	260	0.12	1.03	15	16	1
0022	3T	1_7	135	55	6	5500	5770	270	0.11	1.05	9	10	1
0022	3T	1_7	136	55	4	5500	5370	-130	0.07	0.98	9	9	0
0022	3T	1_7	145	31	1	3100	940	-2160	0.03	0.30	5	1	-4
0022	3T	1_7	146	18	1	1800	1100	-700	0.06	0.61	3	1	-2
0022	3T	1_7	153	3	0	300	0	-300	0.00	0.00	0	0	0
0022	3T	1_7	156	2	0	200	0	-200	0.00	0.00	0	0	0
0022	3T	1_7	163	2	0	200	0	-200	0.00	0.00	0	0	0
0022	3T	1_7	164	4	0	400	0	-400	0.00	0.00	0	0	0
0022	3T	1_7	165	2	0	200	0	-200	0.00	0.00	0	0	0
0022	3T	1_7	214	1	0	100	0	-100	0.00	0.00	0	0	0
0022	3T	1_7	216	2	0	200	0	-200	0.00	0.00	0	0	0
0022	3T	1_7	234	4	1	400	1520	1120	0.25	3.80	0	2	2
0022	3T	1_7	235	4	3	400	5060	4660	0.75	12.65	0	8	8
0022	3T	1_7	236	2	0	200	0	-200	0.00	0.00	0	0	0
0022	3T	1_7	245	4	0	400	0	-400	0.00	0.00	0	0	0
0022	3T	1_7	246	5	0	500	0	-500	0.00	0.00	0	0	0
0022	3T	1_7	256	1	0	100	0	-100	0.00	0.00	0	0	0
0022	3T	1_8	123	46	3	4600	1380	-3220	0.07	0.30	8	2	-6
0022	3T	1_8	124	173	15	17300	9580	-7720	0.09	0.55	30	16	-14
0022	3T	1_8	125	88	11	8800	17180	8380	0.13	1.95	15	30	15
0022	3T	1_8	126	71	2	7100	7520	420	0.03	1.06	12	13	1
0022	3T	1_8	132	1	0	100	0	-100	0.00	0.00	0	0	0
0022	3T	1_8	134	65	6	6500	3900	-2600	0.09	0.60	11	6	-5
0022	3T	1_8	135	42	3	4200	4020	-180	0.07	0.96	7	7	0
0022	3T	1_8	136	54	2	5400	1470	-3930	0.04	0.27	9	2	-7
0022	3T	1_8	145	12	2	1200	3060	1860	0.17	2.55	2	5	3
0022	3T	1_8	146	18	1	1800	1790	-10	0.06	0.99	3	3	0
0022	3T	1_8	156	11	1	1100	730	-370	0.09	0.66	1	1	0
0022	3T	1_8	163	1	0	100	0	-100	0.00	0.00	0	0	0
0022	3T	1_8	164	1	0	100	0	-100	0.00	0.00	0	0	0
0022	3T	1_8	165	3	1	300	1080	780	0.33	3.60	0	1	1
0022	3T	1_8	215	5	0	500	0	-500	0.00	0.00	0	0	0
0022	3T	1_8	216	9	0	900	0	-900	0.00	0.00	1	0	-1
0022	3T	1_8	234	1	1	100	1980	1880	1.00	19.80	0	3	3
0022	3T	1_8	235	1	0	100	0	-100	0.00	0.00	0	0	0
0022	3T	1_8	236	2	0	200	0	-200	0.00	0.00	0	0	0
0022	3T	1_8	245	4	0	400	0	-400	0.00	0.00	0	0	0
0022	3T	1_8	246	2	0	200	0	-200	0.00	0.00	0	0	0
0022	3T	1_9	123	57	8	5700	4190	-1510	0.14	0.74	10	7	-3
0022	3T	1_9	124	199	10	19900	10880	-9020	0.05	0.55	35	19	-16
0022	3T	1_9	125	130	7	13000	8780	-4220	0.05	0.68	23	15	-8
0022	3T	1_9	126	94	4	9400	10040	640	0.04	1.07	16	17	1
0022	3T	1_9	134	84	8	8400	5590	-2810	0.10	0.67	14	9	-5
0022	3T	1_9	135	87	6	8700	5920	-2780	0.07	0.68	15	10	-5
0022	3T	1_9	136	31	1	3100	790	-2310	0.03	0.25	5	1	-4
0022	3T	1_9	145	26	2	2600	1480	-1120	0.08	0.57	4	2	-2
0022	3T	1_9	146	28	0	2800	0	-2800	0.00	0.00	4	0	-4
0022	3T	1_9	153	1	0	100	0	-100	0.00	0.00	0	0	0
0022	3T	1_9	156	9	0	900	0	-900	0.00	0.00	1	0	-1
0022	3T	1_9	214	3	0	300	0	-300	0.00	0.00	0	0	0
0022	3T	1_9	215	6	0	600	0	-600	0.00	0.00	1	0	-1
0022	3T	1_9	216	7	0	700	0	-700	0.00	0.00	1	0	-1
0022	3T	1_9	234	4	1	400	1280	880	0.25	3.20	0	2	2
0022	3T	1_9	235	1	0	100	0	-100	0.00	0.00	0	0	0
0022	3T	1_9	245	1	0	100	0	-100	0.00	0.00	0	0	0
0022	3T	1_9	246	2	0	200	0	-200	0.00	0.00	0	0	0
0022	3T	1_9	256	1	0	100	0	-100	0.00	0.00	0	0	0
0022	3T	2_1	123	105	8	10500	6200	-4300	0.08	0.59	18	10	-8
0022	3T	2_1	124	135	11	13500	7900	-5600	0.08	0.59	23	13	-10
0022	3T	2_1	125	81	6	8100	4890	-3210	0.07	0.60	14	8	-6
0022	3T	2_1	126	30	3	3000	3860	860	0.10	1.29	5	6	1
0022	3T	2_1	132	7	0	700	0	-700	0.00	0.00	1	0	-1
0022	3T	2_1	134	40	3	4000	1700	-2300	0.08	0.43	7	3	-4
0022	3T	2_1	135	19	1	1900	940	-960	0.05	0.49	3	1	-2
0022	3T	2_1	136	18	1	1800	900	-900	0.06	0.50	3	1	-2
0022	3T	2_1	142	6	0	600	0	-600	0.00	0.00	1	0	-1
0022	3T	2_1	143	3	1	300	900	600	0.33	3.00	0	1	1
0022	3T	2_1	145	12	0	1200	0	-1200	0.00	0.00	2	0	-2
0022	3T	2_1	146	6	1	600	680	80	0.17	1.13	1	1	0
0022	3T	2_1	152	2	0	200	0	-200	0.00	0.00	0	0	0
0022	3T	2_1	153	2	1	200	1170	970	0.50	5.85	0	2	2
0022	3T	2_1	154	1	0	100	0	-100	0.00	0.00	0	0	0
0022	3T	2_1	156	1	0	100	0	-100	0.00	0.00	0	0	0
0022	3T	2_1	162	1	0	100	0	-100	0.00	0.00	0	0	0
0022	3T	2_10	123	108	7	10800	5900	-4900	0.06	0.55	19	10	-9
0022	3T	2_10	124	222	20	22200	16350	-5850	0.09	0.74	39	28	-11
0022	3T	2_10	125	144	14	14400	14170	-230	0.10	0.98	25	25	0
0022	3T	2_10	126	139	17	13900	16490	2590	0.12	1.19	24	29	5
0022	3T	2_10	134	85	9	8500	8900	400	0.11	1.05	15	15	0
0022	3T	2_10	135	91	9	9100	7380	-1720	0.10	0.81	16	13	-3
0022	3T	2_10	136	92	4	9200	4140	-5060	0.04	0.45	16	7	-9
0022	3T	2_10	145	28	0	2800	0	-2800	0.00	0.00	4	0	-4
0022	3T	2_10	146	12	3	1200	3830	2630	0.25	3.19	2	6	4
0022	3T	2_10	154	1	0	100	0	-100	0.00	0.00	0	0	0
0022	3T	2_10	156	5	0	500	0	-500	0.00	0.00	0	0	0
0022	3T	2_10	213	1	0	100	0	-100	0.00	0.00	0	0	0
0022	3T	2_10	214	2	0	200	0	-200	0.00	0.00	0	0	0
0022	3T	2_10	216	1	0	100	0	-100	0.00	0.00	0	0	0
0022	3T	2_10	236	1	1	100	700	600	1.00	7.00	0	1	1
0022	3T	2_10	246	1	0	100	0	-100	0.00	0.00	0	0	0
0022	3T	2_11	123	90	16	9000	13290	4290	0.18	1.48	15	23	8
0022	3T	2_11	124	346	34	34600	36250	1650	0.10	1.05	61	64	3
0022	3T	2_11	125	167	7	16700	7800	-8900	0.04	0.47	29	13	-16
0022	3T	2_11	126	99	6	9900	6600	-3300	0.06	0.67	17	11	-6
0022	3T	2_11	134	113	6	11300	4660	-6640	0.05	0.41	20	8	-12
0022	3T	2_11	135	97	6	9700	7630	-2070	0.06	0.79	17	13	-4
0022	3T	2_11	136	46	0	4600	0	-4600	0.00	0.00	8	0	-8
0022	3T	2_11	145	22	0	2200	0	-2200	0.00	0.00	3	0	-3
0022	3T	2_11	146	14	0	1400	0	-1400	0.00	0.00	2	0	-2
0022	3T	2_11	154	1	0	100	0	-100	0.00	0.00	0	0	0
0022	3T	2_11	156	2	0	200	0	-200	0.00	0.00	0	0	0
0022	3T	2_12	123	81	9	8100	5590	-2510	0.11	0.69	14	9	-5
0022	3T	2_12	124	555	49	55500	47340	-8160	0.09	0.85	98	83	-15
0022	3T	2_12	125	129	7	12900	8280	-4620	0.05	0.64	22	14	-8
0022	3T	2_12	126	98	1	9800	2280	-7520	0.01	0.23	17	4	-13
0022	3T	2_12	134	111	11	11100	11340	240	0.10	1.02	19	20	1
0022	3T	2_12	135	48	4	4800	3730	-1070	0.08	0.78	8	6	-2
0022	3T	2_12	136	24	1	2400	890	-1510	0.04	0.37	4	1	-3
0022	3T	2_12	145	8	0	800	0	-800	0.00	0.00	1	0	-1
0022	3T	2_12	146	6	1	600	1280	680	0.17	2.13	1	2	1
0022	3T	2_12	154	1	0	100	0	-100	0.00	0.00	0	0	0
0022	3T	2_12	156	1	0	100	0	-100	0.00	0.00	0	0	0
0022	3T	2_2	123	93	8	9300	6990	-2310	0.09	0.75	16	12	-4
0022	3T	2_2	124	117	8	11700	9210	-2490	0.07	0.79	20	16	-4
0022	3T	2_2	125	78	9	7800	11910	4110	0.12	1.53	13	21	8
0022	3T	2_2	126	70	8	7000	15820	8820	0.11	2.26	12	28	16
0022	3T	2_2	132	1	0	100	0	-100	0.00	0.00	0	0	0
0022	3T	2_2	134	50	1	5000	440	-4560	0.02	0.09	8	0	-8
0022	3T	2_2	135	37	2	3700	1580	-2120	0.05	0.43	6	2	-4
0022	3T	2_2	136	36	2	3600	2560	-1040	0.06	0.71	6	4	-2
0022	3T	2_2	142	3	1	300	1910	1610	0.33	6.37	0	3	3
0022	3T	2_2	143	3	0	300	0	-300	0.00	0.00	0	0	0
0022	3T	2_2	145	20	1	2000	1080	-920	0.05	0.54	3	1	-2
0022	3T	2_2	146	13	0	1300	0	-1300	0.00	0.00	2	0	-2
0022	3T	2_2	152	2	0	200	0	-200	0.00	0.00	0	0	0
0022	3T	2_2	153	1	0	100	0	-100	0.00	0.00	0	0	0
0022	3T	2_2	154	1	0	100	0	-100	0.00	0.00	0	0	0
0022	3T	2_2	156	4	0	400	0	-400	0.00	0.00	0	0	0
0022	3T	2_2	162	1	0	100	0	-100	0.00	0.00	0	0	0
0022	3T	2_2	163	1	0	100	0	-100	0.00	0.00	0	0	0
0022	3T	2_2	216	1	0	100	0	-100	0.00	0.00	0	0	0
0022	3T	2_2	234	4	0	400	0	-400	0.00	0.00	0	0	0
0022	3T	2_2	235	2	1	200	850	650	0.50	4.25	0	1	1
0022	3T	2_2	236	2	0	200	0	-200	0.00	0.00	0	0	0
0022	3T	2_2	245	2	0	200	0	-200	0.00	0.00	0	0	0
0022	3T	2_3	123	36	3	3600	2420	-1180	0.08	0.67	6	4	-2
0022	3T	2_3	124	67	6	6700	6720	20	0.09	1.00	11	11	0
0022	3T	2_3	125	94	4	9400	4870	-4530	0.04	0.52	16	8	-8
0022	3T	2_3	126	90	4	9000	4530	-4470	0.04	0.50	15	8	-7
0022	3T	2_3	134	50	2	5000	1320	-3680	0.04	0.26	8	2	-6
0022	3T	2_3	135	89	12	8900	10140	1240	0.13	1.14	15	17	2
0022	3T	2_3	136	85	4	8500	7910	-590	0.05	0.93	15	14	-1
0022	3T	2_3	145	17	0	1700	0	-1700	0.00	0.00	3	0	-3
0022	3T	2_3	146	17	1	1700	2080	380	0.06	1.22	3	3	0
0022	3T	2_3	156	9	0	900	0	-900	0.00	0.00	1	0	-1
0022	3T	2_3	216	1	0	100	0	-100	0.00	0.00	0	0	0
0022	3T	2_3	234	3	1	300	1830	1530	0.33	6.10	0	3	3
0022	3T	2_3	235	5	0	500	0	-500	0.00	0.00	0	0	0
0022	3T	2_3	236	2	0	200	0	-200	0.00	0.00	0	0	0
0022	3T	2_3	245	4	0	400	0	-400	0.00	0.00	0	0	0
0022	3T	2_3	246	4	0	400	0	-400	0.00	0.00	0	0	0
0022	3T	2_3	256	2	0	200	0	-200	0.00	0.00	0	0	0
0022	3T	2_4	123	69	6	6900	3020	-3880	0.09	0.44	12	5	-7
0022	3T	2_4	124	107	6	10700	9480	-1220	0.06	0.89	18	16	-2
0022	3T	2_4	125	90	6	9000	6090	-2910	0.07	0.68	15	10	-5
0022	3T	2_4	126	111	8	11100	8980	-2120	0.07	0.81	19	15	-4
0022	3T	2_4	134	45	5	4500	3390	-1110	0.11	0.75	7	6	-1
0022	3T	2_4	135	45	3	4500	1730	-2770	0.07	0.38	7	3	-4
0022	3T	2_4	136	68	6	6800	9940	3140	0.09	1.46	12	17	5
0022	3T	2_4	142	1	0	100	0	-100	0.00	0.00	0	0	0
0022	3T	2_4	145	24	1	2400	1150	-1250	0.04	0.48	4	2	-2
0022	3T	2_4	146	23	1	2300	1860	-440	0.04	0.81	4	3	-1
0022	3T	2_4	154	1	0	100	0	-100	0.00	0.00	0	0	0
0022	3T	2_4	156	11	1	1100	2860	1760	0.09	2.60	1	5	4
0022	3T	2_4	215	1	0	100	0	-100	0.00	0.00	0	0	0
0022	3T	2_4	216	5	1	500	2990	2490	0.20	5.98	0	5	5
0022	3T	2_4	234	3	0	300	0	-300	0.00	0.00	0	0	0
0022	3T	2_4	235	2	0	200	0	-200	0.00	0.00	0	0	0
0022	3T	2_4	236	2	0	200	0	-200	0.00	0.00	0	0	0
0022	3T	2_4	245	2	0	200	0	-200	0.00	0.00	0	0	0
0022	3T	2_5	123	71	10	7100	6550	-550	0.14	0.92	12	11	-1
0022	3T	2_5	124	177	25	17700	15130	-2570	0.14	0.85	31	26	-5
0022	3T	2_5	125	89	10	8900	8610	-290	0.11	0.97	15	15	0
0022	3T	2_5	126	116	5	11600	5830	-5770	0.04	0.50	20	10	-10
0022	3T	2_5	134	56	5	5600	4110	-1490	0.09	0.73	9	7	-2
0022	3T	2_5	135	48	2	4800	1840	-2960	0.04	0.38	8	3	-5
0022	3T	2_5	136	50	5	5000	4040	-960	0.10	0.81	8	7	-1
0022	3T	2_5	145	16	0	1600	0	-1600	0.00	0.00	2	0	-2
0022	3T	2_5	146	18	0	1800	0	-1800	0.00	0.00	3	0	-3
0022	3T	2_5	156	7	0	700	0	-700	0.00	0.00	1	0	-1
0022	3T	2_5	214	1	0	100	0	-100	0.00	0.00	0	0	0
0022	3T	2_5	215	1	0	100	0	-100	0.00	0.00	0	0	0
0022	3T	2_5	216	3	0	300	0	-300	0.00	0.00	0	0	0
0022	3T	2_5	234	2	0	200	0	-200	0.00	0.00	0	0	0
0022	3T	2_5	236	3	0	300	0	-300	0.00	0.00	0	0	0
0022	3T	2_5	245	1	0	100	0	-100	0.00	0.00	0	0	0
0022	3T	2_5	246	2	0	200	0	-200	0.00	0.00	0	0	0
0022	3T	2_5	256	1	0	100	0	-100	0.00	0.00	0	0	0
0022	3T	2_6	123	61	8	6100	4790	-1310	0.13	0.79	10	8	-2
0022	3T	2_6	124	86	7	8600	6870	-1730	0.08	0.80	15	12	-3
0022	3T	2_6	125	82	6	8200	10090	1890	0.07	1.23	14	17	3
0022	3T	2_6	126	100	4	10000	8860	-1140	0.04	0.89	17	15	-2
0022	3T	2_6	134	64	7	6400	4900	-1500	0.11	0.77	11	8	-3
0022	3T	2_6	135	42	4	4200	3120	-1080	0.10	0.74	7	5	-2
0022	3T	2_6	136	63	8	6300	9640	3340	0.13	1.53	11	17	6
0022	3T	2_6	142	1	0	100	0	-100	0.00	0.00	0	0	0
0022	3T	2_6	145	14	0	1400	0	-1400	0.00	0.00	2	0	-2
0022	3T	2_6	146	18	1	1800	980	-820	0.06	0.54	3	1	-2
0022	3T	2_6	156	20	1	2000	1160	-840	0.05	0.58	3	2	-1
0022	3T	2_6	214	1	1	100	1510	1410	1.00	15.10	0	2	2
0022	3T	2_6	215	1	0	100	0	-100	0.00	0.00	0	0	0
0022	3T	2_6	216	5	1	500	2670	2170	0.20	5.34	0	4	4
0022	3T	2_6	234	1	0	100	0	-100	0.00	0.00	0	0	0
0022	3T	2_6	235	2	1	200	400	200	0.50	2.00	0	0	0
0022	3T	2_6	236	1	0	100	0	-100	0.00	0.00	0	0	0
0022	3T	2_6	245	1	0	100	0	-100	0.00	0.00	0	0	0
0022	3T	2_6	246	3	0	300	0	-300	0.00	0.00	0	0	0
0022	3T	2_6	256	1	0	100	0	-100	0.00	0.00	0	0	0
0022	3T	2_7	123	56	5	5600	5640	40	0.09	1.01	9	9	0
0022	3T	2_7	124	103	11	10300	10030	-270	0.11	0.97	18	17	-1
0022	3T	2_7	125	95	3	9500	3240	-6260	0.03	0.34	16	5	-11
0022	3T	2_7	126	103	8	10300	13020	2720	0.08	1.26	18	23	5
0022	3T	2_7	134	74	9	7400	5900	-1500	0.12	0.80	13	10	-3
0022	3T	2_7	135	50	2	5000	1510	-3490	0.04	0.30	8	2	-6
0022	3T	2_7	136	57	5	5700	5690	-10	0.09	1.00	10	10	0
0022	3T	2_7	142	1	0	100	0	-100	0.00	0.00	0	0	0
0022	3T	2_7	145	38	3	3800	2310	-1490	0.08	0.61	6	4	-2
0022	3T	2_7	146	23	1	2300	550	-1750	0.04	0.24	4	0	-4
0022	3T	2_7	154	1	0	100	0	-100	0.00	0.00	0	0	0
0022	3T	2_7	156	6	0	600	0	-600	0.00	0.00	1	0	-1
0022	3T	2_7	214	2	0	200	0	-200	0.00	0.00	0	0	0
0022	3T	2_7	215	1	0	100	0	-100	0.00	0.00	0	0	0
0022	3T	2_7	234	2	0	200	0	-200	0.00	0.00	0	0	0
0022	3T	2_7	236	5	2	500	2610	2110	0.40	5.22	0	4	4
0022	3T	2_7	245	4	0	400	0	-400	0.00	0.00	0	0	0
0022	3T	2_7	246	2	0	200	0	-200	0.00	0.00	0	0	0
0022	3T	2_7	256	2	0	200	0	-200	0.00	0.00	0	0	0
0022	3T	2_8	123	69	9	6900	4870	-2030	0.13	0.71	12	8	-4
0022	3T	2_8	124	119	13	11900	7620	-4280	0.11	0.64	21	13	-8
0022	3T	2_8	125	60	4	6000	8110	2110	0.07	1.35	10	14	4
0022	3T	2_8	126	88	8	8800	11650	2850	0.09	1.32	15	20	5
0022	3T	2_8	134	57	2	5700	800	-4900	0.04	0.14	10	1	-9
0022	3T	2_8	135	59	5	5900	3740	-2160	0.08	0.63	10	6	-4
0022	3T	2_8	136	64	5	6400	5670	-730	0.08	0.89	11	10	-1
0022	3T	2_8	145	21	3	2100	2440	340	0.14	1.16	3	4	1
0022	3T	2_8	146	28	0	2800	0	-2800	0.00	0.00	4	0	-4
0022	3T	2_8	153	1	0	100	0	-100	0.00	0.00	0	0	0
0022	3T	2_8	156	5	1	500	1270	770	0.20	2.54	0	2	2
0022	3T	2_8	214	2	0	200	0	-200	0.00	0.00	0	0	0
0022	3T	2_8	215	1	0	100	0	-100	0.00	0.00	0	0	0
0022	3T	2_8	216	1	0	100	0	-100	0.00	0.00	0	0	0
0022	3T	2_8	236	3	0	300	0	-300	0.00	0.00	0	0	0
0022	3T	2_8	256	1	0	100	0	-100	0.00	0.00	0	0	0
0022	3T	2_9	123	103	10	10300	5610	-4690	0.10	0.54	18	9	-9
0022	3T	2_9	124	129	12	12900	7860	-5040	0.09	0.61	22	13	-9
0022	3T	2_9	125	95	7	9500	8580	-920	0.07	0.90	16	15	-1
0022	3T	2_9	126	111	9	11100	11520	420	0.08	1.04	19	20	1
0022	3T	2_9	132	3	0	300	0	-300	0.00	0.00	0	0	0
0022	3T	2_9	134	69	14	6900	14340	7440	0.20	2.08	12	25	13
0022	3T	2_9	135	64	4	6400	5200	-1200	0.06	0.81	11	9	-2
0022	3T	2_9	136	70	6	7000	9490	2490	0.09	1.36	12	16	4
0022	3T	2_9	142	1	0	100	0	-100	0.00	0.00	0	0	0
0022	3T	2_9	145	31	3	3100	2710	-390	0.10	0.87	5	4	-1
0022	3T	2_9	146	23	1	2300	730	-1570	0.04	0.32	4	1	-3
0022	3T	2_9	156	3	1	300	1910	1610	0.33	6.37	0	3	3
0022	3T	2_9	213	1	0	100	0	-100	0.00	0.00	0	0	0
0022	3T	2_9	214	1	1	100	1060	960	1.00	10.60	0	1	1
0022	3T	2_9	215	1	0	100	0	-100	0.00	0.00	0	0	0
0022	3T	2_9	216	1	0	100	0	-100	0.00	0.00	0	0	0
0022	3T	2_9	234	1	0	100	0	-100	0.00	0.00	0	0	0
0022	3T	2_9	235	3	0	300	0	-300	0.00	0.00	0	0	0
0022	3T	2_9	245	1	0	100	0	-100	0.00	0.00	0	0	0
0022	3T	2_9	246	1	0	100	0	-100	0.00	0.00	0	0	0
0022	3T	2_9	253	1	0	100	0	-100	0.00	0.00	0	0	0
0022	3T	2_9	256	2	0	200	0	-200	0.00	0.00	0	0	0
0022	3T	3_1	123	216	19	21600	14670	-6930	0.09	0.68	38	25	-13
0022	3T	3_1	124	133	15	13300	12210	-1090	0.11	0.92	23	21	-2
0022	3T	3_1	125	36	0	3600	0	-3600	0.00	0.00	6	0	-6
0022	3T	3_1	126	47	4	4700	4890	190	0.09	1.04	8	8	0
0022	3T	3_1	132	6	0	600	0	-600	0.00	0.00	1	0	-1
0022	3T	3_1	134	53	0	5300	0	-5300	0.00	0.00	9	0	-9
0022	3T	3_1	135	20	2	2000	1610	-390	0.10	0.81	3	2	-1
0022	3T	3_1	136	12	1	1200	1410	210	0.08	1.18	2	2	0
0022	3T	3_1	142	9	0	900	0	-900	0.00	0.00	1	0	-1
0022	3T	3_1	143	70	5	7000	5660	-1340	0.07	0.81	12	10	-2
0022	3T	3_1	145	41	2	4100	1360	-2740	0.05	0.33	7	2	-5
0022	3T	3_1	146	13	1	1300	830	-470	0.08	0.64	2	1	-1
0022	3T	3_1	152	1	0	100	0	-100	0.00	0.00	0	0	0
0022	3T	3_1	153	13	0	1300	0	-1300	0.00	0.00	2	0	-2
0022	3T	3_1	154	8	0	800	0	-800	0.00	0.00	1	0	-1
0022	3T	3_1	156	2	1	200	1150	950	0.50	5.75	0	2	2
0022	3T	3_1	162	1	0	100	0	-100	0.00	0.00	0	0	0
0022	3T	3_1	163	6	0	600	0	-600	0.00	0.00	1	0	-1
0022	3T	3_1	164	3	0	300	0	-300	0.00	0.00	0	0	0
0022	3T	3_1	213	2	0	200	0	-200	0.00	0.00	0	0	0
0022	3T	3_1	214	1	0	100	0	-100	0.00	0.00	0	0	0
0022	3T	3_1	234	1	0	100	0	-100	0.00	0.00	0	0	0
0022	3T	3_10	123	75	7	7500	5580	-1920	0.09	0.74	13	9	-4
0022	3T	3_10	124	205	19	20500	15700	-4800	0.09	0.77	36	27	-9
0022	3T	3_10	125	145	8	14500	8160	-6340	0.06	0.56	25	14	-11
0022	3T	3_10	126	121	7	12100	8680	-3420	0.06	0.72	21	15	-6
0022	3T	3_10	134	93	8	9300	7640	-1660	0.09	0.82	16	13	-3
0022	3T	3_10	135	99	11	9900	11060	1160	0.11	1.12	17	19	2
0022	3T	3_10	136	86	0	8600	0	-8600	0.00	0.00	15	0	-15
0022	3T	3_10	145	34	1	3400	1030	-2370	0.03	0.30	6	1	-5
0022	3T	3_10	146	14	0	1400	0	-1400	0.00	0.00	2	0	-2
0022	3T	3_10	156	12	0	1200	0	-1200	0.00	0.00	2	0	-2
0022	3T	3_10	164	1	0	100	0	-100	0.00	0.00	0	0	0
0022	3T	3_10	214	2	0	200	0	-200	0.00	0.00	0	0	0
0022	3T	3_10	215	2	0	200	0	-200	0.00	0.00	0	0	0
0022	3T	3_10	216	4	0	400	0	-400	0.00	0.00	0	0	0
0022	3T	3_10	235	1	0	100	0	-100	0.00	0.00	0	0	0
0022	3T	3_10	236	2	0	200	0	-200	0.00	0.00	0	0	0
0022	3T	3_10	256	2	0	200	0	-200	0.00	0.00	0	0	0
0022	3T	3_11	123	132	23	13200	15830	2630	0.17	1.20	23	28	5
0022	3T	3_11	124	361	40	36100	36770	670	0.11	1.02	63	65	2
0022	3T	3_11	125	163	12	16300	10180	-6120	0.07	0.62	28	18	-10
0022	3T	3_11	126	97	6	9700	17380	7680	0.06	1.79	17	30	13
0022	3T	3_11	134	98	9	9800	8040	-1760	0.09	0.82	17	14	-3
0022	3T	3_11	135	106	9	10600	7140	-3460	0.08	0.67	18	12	-6
0022	3T	3_11	136	51	1	5100	930	-4170	0.02	0.18	9	1	-8
0022	3T	3_11	145	25	4	2500	3710	1210	0.16	1.48	4	6	2
0022	3T	3_11	146	11	1	1100	1480	380	0.09	1.35	1	2	1
0022	3T	3_11	153	1	0	100	0	-100	0.00	0.00	0	0	0
0022	3T	3_11	156	5	1	500	1820	1320	0.20	3.64	0	3	3
0022	3T	3_11	164	1	0	100	0	-100	0.00	0.00	0	0	0
0022	3T	3_11	216	1	0	100	0	-100	0.00	0.00	0	0	0
0022	3T	3_12	123	86	11	8600	5160	-3440	0.13	0.60	15	9	-6
0022	3T	3_12	124	544	39	54400	29960	-24440	0.07	0.55	96	53	-43
0022	3T	3_12	125	184	14	18400	16520	-1880	0.08	0.90	32	29	-3
0022	3T	3_12	126	78	1	7800	1030	-6770	0.01	0.13	13	1	-12
0022	3T	3_12	134	85	9	8500	6380	-2120	0.11	0.75	15	11	-4
0022	3T	3_12	135	58	6	5800	7250	1450	0.10	1.25	10	12	2
0022	3T	3_12	136	20	0	2000	0	-2000	0.00	0.00	3	0	-3
0022	3T	3_12	143	1	0	100	0	-100	0.00	0.00	0	0	0
0022	3T	3_12	145	14	0	1400	0	-1400	0.00	0.00	2	0	-2
0022	3T	3_12	146	4	0	400	0	-400	0.00	0.00	0	0	0
0022	3T	3_12	154	1	0	100	0	-100	0.00	0.00	0	0	0
0022	3T	3_12	156	1	0	100	0	-100	0.00	0.00	0	0	0
0022	3T	3_12	164	1	0	100	0	-100	0.00	0.00	0	0	0
0022	3T	3_12	236	1	0	100	0	-100	0.00	0.00	0	0	0
0022	3T	3_2	123	138	12	13800	11770	-2030	0.09	0.85	24	20	-4
0022	3T	3_2	124	75	12	7500	8690	1190	0.16	1.16	13	15	2
0022	3T	3_2	125	94	5	9400	7500	-1900	0.05	0.80	16	13	-3
0022	3T	3_2	126	119	7	11900	10260	-1640	0.06	0.86	21	18	-3
0022	3T	3_2	134	18	1	1800	1370	-430	0.06	0.76	3	2	-1
0022	3T	3_2	135	39	3	3900	2510	-1390	0.08	0.64	6	4	-2
0022	3T	3_2	136	61	2	6100	4570	-1530	0.03	0.75	10	8	-2
0022	3T	3_2	142	1	0	100	0	-100	0.00	0.00	0	0	0
0022	3T	3_2	143	48	2	4800	3430	-1370	0.04	0.71	8	6	-2
0022	3T	3_2	145	38	3	3800	6490	2690	0.08	1.71	6	11	5
0022	3T	3_2	146	36	0	3600	0	-3600	0.00	0.00	6	0	-6
0022	3T	3_2	153	4	0	400	0	-400	0.00	0.00	0	0	0
0022	3T	3_2	154	1	0	100	0	-100	0.00	0.00	0	0	0
0022	3T	3_2	156	9	0	900	0	-900	0.00	0.00	1	0	-1
0022	3T	3_2	163	1	0	100	0	-100	0.00	0.00	0	0	0
0022	3T	3_2	164	1	0	100	0	-100	0.00	0.00	0	0	0
0022	3T	3_2	213	1	0	100	0	-100	0.00	0.00	0	0	0
0022	3T	3_2	216	1	0	100	0	-100	0.00	0.00	0	0	0
0022	3T	3_2	234	2	0	200	0	-200	0.00	0.00	0	0	0
0022	3T	3_2	235	1	1	100	1820	1720	1.00	18.20	0	3	3
0022	3T	3_2	236	1	0	100	0	-100	0.00	0.00	0	0	0
0022	3T	3_2	243	1	0	100	0	-100	0.00	0.00	0	0	0
0022	3T	3_2	246	2	0	200	0	-200	0.00	0.00	0	0	0
0022	3T	3_2	256	1	0	100	0	-100	0.00	0.00	0	0	0
0022	3T	3_2	263	1	0	100	0	-100	0.00	0.00	0	0	0
0022	3T	3_3	123	83	6	8300	4520	-3780	0.07	0.54	14	8	-6
0022	3T	3_3	124	93	8	9300	10850	1550	0.09	1.17	16	19	3
0022	3T	3_3	125	75	5	7500	4950	-2550	0.07	0.66	13	8	-5
0022	3T	3_3	126	132	5	13200	9870	-3330	0.04	0.75	23	17	-6
0022	3T	3_3	134	67	8	6700	5960	-740	0.12	0.89	11	10	-1
0022	3T	3_3	135	57	3	5700	4470	-1230	0.05	0.78	10	7	-3
0022	3T	3_3	136	66	4	6600	10250	3650	0.06	1.55	11	18	7
0022	3T	3_3	143	1	0	100	0	-100	0.00	0.00	0	0	0
0022	3T	3_3	145	14	0	1400	0	-1400	0.00	0.00	2	0	-2
0022	3T	3_3	146	33	0	3300	0	-3300	0.00	0.00	5	0	-5
0022	3T	3_3	153	3	0	300	0	-300	0.00	0.00	0	0	0
0022	3T	3_3	154	1	0	100	0	-100	0.00	0.00	0	0	0
0022	3T	3_3	156	11	0	1100	0	-1100	0.00	0.00	1	0	-1
0022	3T	3_3	163	4	0	400	0	-400	0.00	0.00	0	0	0
0022	3T	3_3	164	2	0	200	0	-200	0.00	0.00	0	0	0
0022	3T	3_3	234	5	2	500	2900	2400	0.40	5.80	0	5	5
0022	3T	3_3	235	3	1	300	680	380	0.33	2.27	0	1	1
0022	3T	3_3	236	1	0	100	0	-100	0.00	0.00	0	0	0
0022	3T	3_3	245	5	0	500	0	-500	0.00	0.00	0	0	0
0022	3T	3_3	246	1	0	100	0	-100	0.00	0.00	0	0	0
0022	3T	3_3	253	1	0	100	0	-100	0.00	0.00	0	0	0
0022	3T	3_3	256	4	0	400	0	-400	0.00	0.00	0	0	0
0022	3T	3_3	265	1	0	100	0	-100	0.00	0.00	0	0	0
0022	3T	3_4	123	70	7	7000	5750	-1250	0.10	0.82	12	10	-2
0022	3T	3_4	124	134	12	13400	9870	-3530	0.09	0.74	23	17	-6
0022	3T	3_4	125	92	9	9200	6210	-2990	0.10	0.68	16	10	-6
0022	3T	3_4	126	76	8	7600	12030	4430	0.11	1.58	13	21	8
0022	3T	3_4	134	47	2	4700	1010	-3690	0.04	0.21	8	1	-7
0022	3T	3_4	135	63	3	6300	2820	-3480	0.05	0.45	11	4	-7
0022	3T	3_4	136	43	2	4300	2500	-1800	0.05	0.58	7	4	-3
0022	3T	3_4	145	23	1	2300	910	-1390	0.04	0.40	4	1	-3
0022	3T	3_4	146	23	0	2300	0	-2300	0.00	0.00	4	0	-4
0022	3T	3_4	153	2	0	200	0	-200	0.00	0.00	0	0	0
0022	3T	3_4	156	13	0	1300	0	-1300	0.00	0.00	2	0	-2
0022	3T	3_4	163	1	0	100	0	-100	0.00	0.00	0	0	0
0022	3T	3_4	164	1	0	100	0	-100	0.00	0.00	0	0	0
0022	3T	3_4	165	3	0	300	0	-300	0.00	0.00	0	0	0
0022	3T	3_4	215	3	0	300	0	-300	0.00	0.00	0	0	0
0022	3T	3_4	216	6	0	600	0	-600	0.00	0.00	1	0	-1
0022	3T	3_4	234	1	0	100	0	-100	0.00	0.00	0	0	0
0022	3T	3_4	235	7	0	700	0	-700	0.00	0.00	1	0	-1
0022	3T	3_4	236	9	0	900	0	-900	0.00	0.00	1	0	-1
0022	3T	3_4	245	3	0	300	0	-300	0.00	0.00	0	0	0
0022	3T	3_4	246	9	0	900	0	-900	0.00	0.00	1	0	-1
0022	3T	3_4	256	4	0	400	0	-400	0.00	0.00	0	0	0
0022	3T	3_5	123	84	14	8400	8680	280	0.17	1.03	14	15	1
0022	3T	3_5	124	187	22	18700	14570	-4130	0.12	0.78	33	25	-8
0022	3T	3_5	125	76	7	7600	4530	-3070	0.09	0.60	13	8	-5
0022	3T	3_5	126	85	7	8500	8970	470	0.08	1.06	15	15	0
0022	3T	3_5	132	1	0	100	0	-100	0.00	0.00	0	0	0
0022	3T	3_5	134	59	11	5900	6700	800	0.19	1.14	10	11	1
0022	3T	3_5	135	51	5	5100	3320	-1780	0.10	0.65	9	5	-4
0022	3T	3_5	136	25	0	2500	0	-2500	0.00	0.00	4	0	-4
0022	3T	3_5	145	24	4	2400	2740	340	0.17	1.14	4	4	0
0022	3T	3_5	146	9	0	900	0	-900	0.00	0.00	1	0	-1
0022	3T	3_5	153	2	0	200	0	-200	0.00	0.00	0	0	0
0022	3T	3_5	156	9	1	900	1350	450	0.11	1.50	1	2	1
0022	3T	3_5	164	1	0	100	0	-100	0.00	0.00	0	0	0
0022	3T	3_5	165	1	0	100	0	-100	0.00	0.00	0	0	0
0022	3T	3_5	214	1	0	100	0	-100	0.00	0.00	0	0	0
0022	3T	3_5	215	4	0	400	0	-400	0.00	0.00	0	0	0
0022	3T	3_5	216	5	0	500	0	-500	0.00	0.00	0	0	0
0022	3T	3_5	234	1	0	100	0	-100	0.00	0.00	0	0	0
0022	3T	3_5	235	7	0	700	0	-700	0.00	0.00	1	0	-1
0022	3T	3_5	236	8	0	800	0	-800	0.00	0.00	1	0	-1
0022	3T	3_5	245	5	0	500	0	-500	0.00	0.00	0	0	0
0022	3T	3_5	246	5	0	500	0	-500	0.00	0.00	0	0	0
0022	3T	3_5	256	1	0	100	0	-100	0.00	0.00	0	0	0
0022	3T	3_6	123	57	11	5700	7070	1370	0.19	1.24	10	12	2
0022	3T	3_6	124	90	5	9000	3990	-5010	0.06	0.44	15	7	-8
0022	3T	3_6	125	68	6	6800	8440	1640	0.09	1.24	12	14	2
0022	3T	3_6	126	70	3	7000	5490	-1510	0.04	0.78	12	9	-3
0022	3T	3_6	134	51	5	5100	4030	-1070	0.10	0.79	9	7	-2
0022	3T	3_6	135	38	2	3800	1490	-2310	0.05	0.39	6	2	-4
0022	3T	3_6	136	37	4	3700	4110	410	0.11	1.11	6	7	1
0022	3T	3_6	145	20	1	2000	1190	-810	0.05	0.60	3	2	-1
0022	3T	3_6	146	18	0	1800	0	-1800	0.00	0.00	3	0	-3
0022	3T	3_6	153	3	0	300	0	-300	0.00	0.00	0	0	0
0022	3T	3_6	156	12	1	1200	3520	2320	0.08	2.93	2	6	4
0022	3T	3_6	164	1	0	100	0	-100	0.00	0.00	0	0	0
0022	3T	3_6	165	2	0	200	0	-200	0.00	0.00	0	0	0
0022	3T	3_6	214	5	0	500	0	-500	0.00	0.00	0	0	0
0022	3T	3_6	215	7	0	700	0	-700	0.00	0.00	1	0	-1
0022	3T	3_6	216	11	0	1100	0	-1100	0.00	0.00	1	0	-1
0022	3T	3_6	234	6	0	600	0	-600	0.00	0.00	1	0	-1
0022	3T	3_6	235	10	0	1000	0	-1000	0.00	0.00	1	0	-1
0022	3T	3_6	236	12	0	1200	0	-1200	0.00	0.00	2	0	-2
0022	3T	3_6	245	3	0	300	0	-300	0.00	0.00	0	0	0
0022	3T	3_6	246	3	0	300	0	-300	0.00	0.00	0	0	0
0022	3T	3_6	256	4	0	400	0	-400	0.00	0.00	0	0	0
0022	3T	3_7	123	52	6	5200	4650	-550	0.12	0.89	9	8	-1
0022	3T	3_7	124	97	11	9700	8690	-1010	0.11	0.90	17	15	-2
0022	3T	3_7	125	94	4	9400	3790	-5610	0.04	0.40	16	6	-10
0022	3T	3_7	126	83	9	8300	11220	2920	0.11	1.35	14	19	5
0022	3T	3_7	134	44	4	4400	3540	-860	0.09	0.80	7	6	-1
0022	3T	3_7	135	53	2	5300	970	-4330	0.04	0.18	9	1	-8
0022	3T	3_7	136	49	2	4900	1340	-3560	0.04	0.27	8	2	-6
0022	3T	3_7	145	50	4	5000	5320	320	0.08	1.06	8	9	1
0022	3T	3_7	146	17	1	1700	1520	-180	0.06	0.89	3	2	-1
0022	3T	3_7	154	1	0	100	0	-100	0.00	0.00	0	0	0
0022	3T	3_7	156	15	0	1500	0	-1500	0.00	0.00	2	0	-2
0022	3T	3_7	164	1	0	100	0	-100	0.00	0.00	0	0	0
0022	3T	3_7	165	2	0	200	0	-200	0.00	0.00	0	0	0
0022	3T	3_7	214	6	0	600	0	-600	0.00	0.00	1	0	-1
0022	3T	3_7	215	8	0	800	0	-800	0.00	0.00	1	0	-1
0022	3T	3_7	216	7	0	700	0	-700	0.00	0.00	1	0	-1
0022	3T	3_7	234	3	2	300	3510	3210	0.67	11.70	0	6	6
0022	3T	3_7	235	4	0	400	0	-400	0.00	0.00	0	0	0
0022	3T	3_7	236	9	2	900	1750	850	0.22	1.94	1	3	2
0022	3T	3_7	245	6	1	600	2720	2120	0.17	4.53	1	4	3
0022	3T	3_7	246	3	0	300	0	-300	0.00	0.00	0	0	0
0022	3T	3_7	256	8	0	800	0	-800	0.00	0.00	1	0	-1
0022	3T	3_8	123	53	10	5300	5710	410	0.19	1.08	9	10	1
0022	3T	3_8	124	131	15	13100	8530	-4570	0.11	0.65	23	15	-8
0022	3T	3_8	125	85	10	8500	12040	3540	0.12	1.42	15	21	6
0022	3T	3_8	126	78	7	7800	11700	3900	0.09	1.50	13	20	7
0022	3T	3_8	134	51	8	5100	7350	2250	0.16	1.44	9	13	4
0022	3T	3_8	135	52	2	5200	1040	-4160	0.04	0.20	9	1	-8
0022	3T	3_8	136	72	5	7200	7120	-80	0.07	0.99	12	12	0
0022	3T	3_8	142	1	0	100	0	-100	0.00	0.00	0	0	0
0022	3T	3_8	145	29	2	2900	2250	-650	0.07	0.78	5	3	-2
0022	3T	3_8	146	27	0	2700	0	-2700	0.00	0.00	4	0	-4
0022	3T	3_8	153	2	0	200	0	-200	0.00	0.00	0	0	0
0022	3T	3_8	156	17	0	1700	0	-1700	0.00	0.00	3	0	-3
0022	3T	3_8	164	1	1	100	1120	1020	1.00	11.20	0	1	1
0022	3T	3_8	165	1	0	100	0	-100	0.00	0.00	0	0	0
0022	3T	3_8	214	6	1	600	1280	680	0.17	2.13	1	2	1
0022	3T	3_8	215	5	0	500	0	-500	0.00	0.00	0	0	0
0022	3T	3_8	216	7	0	700	0	-700	0.00	0.00	1	0	-1
0022	3T	3_8	234	5	0	500	0	-500	0.00	0.00	0	0	0
0022	3T	3_8	235	4	1	400	2580	2180	0.25	6.45	0	4	4
0022	3T	3_8	245	3	0	300	0	-300	0.00	0.00	0	0	0
0022	3T	3_8	246	4	0	400	0	-400	0.00	0.00	0	0	0
0022	3T	3_8	256	8	0	800	0	-800	0.00	0.00	1	0	-1
0022	3T	3_9	123	68	10	6800	6400	-400	0.15	0.94	12	11	-1
0022	3T	3_9	124	139	5	13900	3670	-10230	0.04	0.26	24	6	-18
0022	3T	3_9	125	108	8	10800	6690	-4110	0.07	0.62	19	11	-8
0022	3T	3_9	126	95	10	9500	9410	-90	0.11	0.99	16	16	0
0022	3T	3_9	134	58	6	5800	3980	-1820	0.10	0.69	10	7	-3
0022	3T	3_9	135	57	4	5700	3410	-2290	0.07	0.60	10	6	-4
0022	3T	3_9	136	64	1	6400	1080	-5320	0.02	0.17	11	1	-10
0022	3T	3_9	145	34	5	3400	3420	20	0.15	1.01	6	6	0
0022	3T	3_9	146	21	0	2100	0	-2100	0.00	0.00	3	0	-3
0022	3T	3_9	156	12	2	1200	3700	2500	0.17	3.08	2	6	4
0022	3T	3_9	165	1	0	100	0	-100	0.00	0.00	0	0	0
0022	3T	3_9	214	2	0	200	0	-200	0.00	0.00	0	0	0
0022	3T	3_9	215	7	0	700	0	-700	0.00	0.00	1	0	-1
0022	3T	3_9	216	7	0	700	0	-700	0.00	0.00	1	0	-1
0022	3T	3_9	234	2	0	200	0	-200	0.00	0.00	0	0	0
0022	3T	3_9	235	3	1	300	950	650	0.33	3.17	0	1	1
0022	3T	3_9	236	4	0	400	0	-400	0.00	0.00	0	0	0
0022	3T	3_9	245	4	0	400	0	-400	0.00	0.00	0	0	0
0022	3T	3_9	246	4	1	400	1730	1330	0.25	4.33	0	3	3
0022	3T	3_9	256	4	1	400	1730	1330	0.25	4.33	0	3	3
0022	3T	4_1	123	105	14	10500	11260	760	0.13	1.07	18	19	1
0022	3T	4_1	124	157	17	15700	13990	-1710	0.11	0.89	27	24	-3
0022	3T	4_1	125	61	3	6100	1980	-4120	0.05	0.32	10	3	-7
0022	3T	4_1	126	27	2	2700	4570	1870	0.07	1.69	4	8	4
0022	3T	4_1	132	2	0	200	0	-200	0.00	0.00	0	0	0
0022	3T	4_1	134	49	2	4900	1690	-3210	0.04	0.34	8	2	-6
0022	3T	4_1	135	21	0	2100	0	-2100	0.00	0.00	3	0	-3
0022	3T	4_1	136	7	1	700	1590	890	0.14	2.27	1	2	1
0022	3T	4_1	142	1	0	100	0	-100	0.00	0.00	0	0	0
0022	3T	4_1	145	10	3	1000	3790	2790	0.30	3.79	1	6	5
0022	3T	4_1	146	10	0	1000	0	-1000	0.00	0.00	1	0	-1
0022	3T	4_1	153	1	0	100	0	-100	0.00	0.00	0	0	0
0022	3T	4_1	156	2	0	200	0	-200	0.00	0.00	0	0	0
0022	3T	4_1	214	1	0	100	0	-100	0.00	0.00	0	0	0
0022	3T	4_1	234	1	0	100	0	-100	0.00	0.00	0	0	0
0022	3T	4_1	236	2	0	200	0	-200	0.00	0.00	0	0	0
0022	3T	4_10	123	318	32	31800	23870	-7930	0.10	0.75	56	42	-14
0022	3T	4_10	124	125	11	12500	9490	-3010	0.09	0.76	22	16	-6
0022	3T	4_10	125	63	5	6300	4620	-1680	0.08	0.73	11	8	-3
0022	3T	4_10	126	8	0	800	0	-800	0.00	0.00	1	0	-1
0022	3T	4_10	134	57	5	5700	3460	-2240	0.09	0.61	10	6	-4
0022	3T	4_10	135	23	3	2300	3120	820	0.13	1.36	4	5	1
0022	3T	4_10	136	11	0	1100	0	-1100	0.00	0.00	1	0	-1
0022	3T	4_10	143	75	6	7500	5640	-1860	0.08	0.75	13	9	-4
0022	3T	4_10	153	15	1	1500	1480	-20	0.07	0.99	2	2	0
0022	3T	4_10	154	1	0	100	0	-100	0.00	0.00	0	0	0
0022	3T	4_10	156	1	0	100	0	-100	0.00	0.00	0	0	0
0022	3T	4_11	123	616	79	61600	55870	-5730	0.13	0.91	109	98	-11
0022	3T	4_11	126	7	0	700	0	-700	0.00	0.00	1	0	-1
0022	3T	4_11	136	9	0	900	0	-900	0.00	0.00	1	0	-1
0022	3T	4_11	143	83	11	8300	18620	10320	0.13	2.24	14	32	18
0022	3T	4_11	146	2	0	200	0	-200	0.00	0.00	0	0	0
0022	3T	4_11	153	18	1	1800	2510	710	0.06	1.39	3	4	1
0022	3T	4_12	123	242	34	24200	28030	3830	0.14	1.16	42	49	7
0022	3T	4_12	124	383	43	38300	33370	-4930	0.11	0.87	67	59	-8
0022	3T	4_12	125	70	5	7000	4510	-2490	0.07	0.64	12	7	-5
0022	3T	4_12	126	6	0	600	0	-600	0.00	0.00	1	0	-1
0022	3T	4_12	134	99	15	9900	11510	1610	0.15	1.16	17	20	3
0022	3T	4_12	135	8	1	800	590	-210	0.13	0.74	1	1	0
0022	3T	4_12	136	3	0	300	0	-300	0.00	0.00	0	0	0
0022	3T	4_12	143	14	0	1400	0	-1400	0.00	0.00	2	0	-2
0022	3T	4_12	145	1	0	100	0	-100	0.00	0.00	0	0	0
0022	3T	4_12	146	2	0	200	0	-200	0.00	0.00	0	0	0
0022	3T	4_12	153	4	1	400	3620	3220	0.25	9.05	0	6	6
0022	3T	4_2	123	71	11	7100	7930	830	0.15	1.12	12	14	2
0022	3T	4_2	124	117	7	11700	8500	-3200	0.06	0.73	20	15	-5
0022	3T	4_2	125	70	5	7000	3930	-3070	0.07	0.56	12	6	-6
0022	3T	4_2	126	41	3	4100	4840	740	0.07	1.18	7	8	1
0022	3T	4_2	132	2	0	200	0	-200	0.00	0.00	0	0	0
0022	3T	4_2	134	43	5	4300	5360	1060	0.12	1.25	7	9	2
0022	3T	4_2	135	33	2	3300	1530	-1770	0.06	0.46	5	2	-3
0022	3T	4_2	136	21	0	2100	0	-2100	0.00	0.00	3	0	-3
0022	3T	4_2	142	2	0	200	0	-200	0.00	0.00	0	0	0
0022	3T	4_2	143	2	0	200	0	-200	0.00	0.00	0	0	0
0022	3T	4_2	145	14	3	1400	10260	8860	0.21	7.33	2	18	16
0022	3T	4_2	146	10	1	1000	880	-120	0.10	0.88	1	1	0
0022	3T	4_2	156	5	1	500	1320	820	0.20	2.64	0	2	2
0022	3T	4_2	215	2	0	200	0	-200	0.00	0.00	0	0	0
0022	3T	4_2	234	2	0	200	0	-200	0.00	0.00	0	0	0
0022	3T	4_2	235	5	0	500	0	-500	0.00	0.00	0	0	0
0022	3T	4_2	236	2	0	200	0	-200	0.00	0.00	0	0	0
0022	3T	4_2	245	3	0	300	0	-300	0.00	0.00	0	0	0
0022	3T	4_2	246	1	0	100	0	-100	0.00	0.00	0	0	0
0022	3T	4_3	123	41	7	4100	4900	800	0.17	1.20	7	8	1
0022	3T	4_3	124	72	7	7200	6530	-670	0.10	0.91	12	11	-1
0022	3T	4_3	125	81	8	8100	9240	1140	0.10	1.14	14	16	2
0022	3T	4_3	126	57	5	5700	7140	1440	0.09	1.25	10	12	2
0022	3T	4_3	132	1	0	100	0	-100	0.00	0.00	0	0	0
0022	3T	4_3	134	62	3	6200	1850	-4350	0.05	0.30	10	3	-7
0022	3T	4_3	135	72	12	7200	9730	2530	0.17	1.35	12	17	5
0022	3T	4_3	136	25	2	2500	1460	-1040	0.08	0.58	4	2	-2
0022	3T	4_3	145	13	0	1300	0	-1300	0.00	0.00	2	0	-2
0022	3T	4_3	146	12	1	1200	2140	940	0.08	1.78	2	3	1
0022	3T	4_3	156	8	0	800	0	-800	0.00	0.00	1	0	-1
0022	3T	4_3	213	2	1	200	1740	1540	0.50	8.70	0	3	3
0022	3T	4_3	214	4	0	400	0	-400	0.00	0.00	0	0	0
0022	3T	4_3	216	2	0	200	0	-200	0.00	0.00	0	0	0
0022	3T	4_3	234	6	0	600	0	-600	0.00	0.00	1	0	-1
0022	3T	4_3	235	3	0	300	0	-300	0.00	0.00	0	0	0
0022	3T	4_3	236	8	2	800	2690	1890	0.25	3.36	1	4	3
0022	3T	4_3	245	2	0	200	0	-200	0.00	0.00	0	0	0
0022	3T	4_3	246	3	0	300	0	-300	0.00	0.00	0	0	0
0022	3T	4_3	256	1	0	100	0	-100	0.00	0.00	0	0	0
0022	3T	4_4	123	59	6	5900	1880	-4020	0.10	0.32	10	3	-7
0022	3T	4_4	124	103	11	10300	9630	-670	0.11	0.93	18	17	-1
0022	3T	4_4	125	71	4	7100	4760	-2340	0.06	0.67	12	8	-4
0022	3T	4_4	126	61	3	6100	3630	-2470	0.05	0.60	10	6	-4
0022	3T	4_4	132	1	0	100	0	-100	0.00	0.00	0	0	0
0022	3T	4_4	134	64	7	6400	4530	-1870	0.11	0.71	11	8	-3
0022	3T	4_4	135	49	6	4900	3340	-1560	0.12	0.68	8	5	-3
0022	3T	4_4	136	41	3	4100	1710	-2390	0.07	0.42	7	3	-4
0022	3T	4_4	143	1	0	100	0	-100	0.00	0.00	0	0	0
0022	3T	4_4	145	24	1	2400	990	-1410	0.04	0.41	4	1	-3
0022	3T	4_4	146	11	2	1100	3910	2810	0.18	3.55	1	6	5
0022	3T	4_4	156	5	0	500	0	-500	0.00	0.00	0	0	0
0022	3T	4_4	214	3	0	300	0	-300	0.00	0.00	0	0	0
0022	3T	4_4	215	1	0	100	0	-100	0.00	0.00	0	0	0
0022	3T	4_4	216	1	0	100	0	-100	0.00	0.00	0	0	0
0022	3T	4_4	234	6	0	600	0	-600	0.00	0.00	1	0	-1
0022	3T	4_4	235	11	1	1100	870	-230	0.09	0.79	1	1	0
0022	3T	4_4	236	2	0	200	0	-200	0.00	0.00	0	0	0
0022	3T	4_4	245	2	0	200	0	-200	0.00	0.00	0	0	0
0022	3T	4_4	246	3	0	300	0	-300	0.00	0.00	0	0	0
0022	3T	4_4	256	1	0	100	0	-100	0.00	0.00	0	0	0
0022	3T	4_5	123	67	10	6700	5840	-860	0.15	0.87	11	10	-1
0022	3T	4_5	124	135	17	13500	13870	370	0.13	1.03	23	24	1
0022	3T	4_5	125	89	10	8900	10690	1790	0.11	1.20	15	18	3
0022	3T	4_5	126	68	3	6800	2580	-4220	0.04	0.38	12	4	-8
0022	3T	4_5	134	70	12	7000	6500	-500	0.17	0.93	12	11	-1
0022	3T	4_5	135	40	4	4000	4550	550	0.10	1.14	7	8	1
0022	3T	4_5	136	31	6	3100	4700	1600	0.19	1.52	5	8	3
0022	3T	4_5	143	1	0	100	0	-100	0.00	0.00	0	0	0
0022	3T	4_5	145	18	0	1800	0	-1800	0.00	0.00	3	0	-3
0022	3T	4_5	146	10	1	1000	870	-130	0.10	0.87	1	1	0
0022	3T	4_5	154	1	0	100	0	-100	0.00	0.00	0	0	0
0022	3T	4_5	156	3	0	300	0	-300	0.00	0.00	0	0	0
0022	3T	4_5	214	3	1	300	3350	3050	0.33	11.17	0	5	5
0022	3T	4_5	216	1	0	100	0	-100	0.00	0.00	0	0	0
0022	3T	4_5	234	5	0	500	0	-500	0.00	0.00	0	0	0
0022	3T	4_5	235	4	0	400	0	-400	0.00	0.00	0	0	0
0022	3T	4_5	236	5	1	500	590	90	0.20	1.18	0	1	1
0022	3T	4_5	245	2	0	200	0	-200	0.00	0.00	0	0	0
0022	3T	4_5	246	3	0	300	0	-300	0.00	0.00	0	0	0
0022	3T	4_5	256	1	0	100	0	-100	0.00	0.00	0	0	0
0022	3T	4_6	123	60	7	6000	2650	-3350	0.12	0.44	10	4	-6
0022	3T	4_6	124	85	6	8500	4220	-4280	0.07	0.50	15	7	-8
0022	3T	4_6	125	71	8	7100	6700	-400	0.11	0.94	12	11	-1
0022	3T	4_6	126	51	2	5100	3170	-1930	0.04	0.62	9	5	-4
0022	3T	4_6	134	63	9	6300	11920	5620	0.14	1.89	11	21	10
0022	3T	4_6	135	43	1	4300	850	-3450	0.02	0.20	7	1	-6
0022	3T	4_6	136	21	2	2100	1300	-800	0.10	0.62	3	2	-1
0022	3T	4_6	145	25	2	2500	2950	450	0.08	1.18	4	5	1
0022	3T	4_6	146	10	0	1000	0	-1000	0.00	0.00	1	0	-1
0022	3T	4_6	156	16	1	1600	2080	480	0.06	1.30	2	3	1
0022	3T	4_6	213	1	0	100	0	-100	0.00	0.00	0	0	0
0022	3T	4_6	214	3	0	300	0	-300	0.00	0.00	0	0	0
0022	3T	4_6	215	1	0	100	0	-100	0.00	0.00	0	0	0
0022	3T	4_6	216	10	0	1000	0	-1000	0.00	0.00	1	0	-1
0022	3T	4_6	234	3	0	300	0	-300	0.00	0.00	0	0	0
0022	3T	4_6	235	5	0	500	0	-500	0.00	0.00	0	0	0
0022	3T	4_6	236	6	1	600	1660	1060	0.17	2.77	1	2	1
0022	3T	4_6	245	7	0	700	0	-700	0.00	0.00	1	0	-1
0022	3T	4_6	246	3	0	300	0	-300	0.00	0.00	0	0	0
0022	3T	4_6	256	2	0	200	0	-200	0.00	0.00	0	0	0
0022	3T	4_7	123	58	11	5800	7630	1830	0.19	1.32	10	13	3
0022	3T	4_7	124	95	8	9500	6670	-2830	0.08	0.70	16	11	-5
0022	3T	4_7	125	84	5	8400	5130	-3270	0.06	0.61	14	9	-5
0022	3T	4_7	126	41	1	4100	2300	-1800	0.02	0.56	7	4	-3
0022	3T	4_7	134	63	6	6300	4040	-2260	0.10	0.64	11	7	-4
0022	3T	4_7	135	52	5	5200	4090	-1110	0.10	0.79	9	7	-2
0022	3T	4_7	136	31	3	3100	2610	-490	0.10	0.84	5	4	-1
0022	3T	4_7	145	37	4	3700	4490	790	0.11	1.21	6	7	1
0022	3T	4_7	146	19	1	1900	730	-1170	0.05	0.38	3	1	-2
0022	3T	4_7	156	4	0	400	0	-400	0.00	0.00	0	0	0
0022	3T	4_7	214	1	0	100	0	-100	0.00	0.00	0	0	0
0022	3T	4_7	215	1	0	100	0	-100	0.00	0.00	0	0	0
0022	3T	4_7	216	2	0	200	0	-200	0.00	0.00	0	0	0
0022	3T	4_7	234	4	0	400	0	-400	0.00	0.00	0	0	0
0022	3T	4_7	235	3	0	300	0	-300	0.00	0.00	0	0	0
0022	3T	4_7	236	5	0	500	0	-500	0.00	0.00	0	0	0
0022	3T	4_7	245	2	1	200	1140	940	0.50	5.70	0	2	2
0022	3T	4_7	246	4	0	400	0	-400	0.00	0.00	0	0	0
0022	3T	4_7	256	1	0	100	0	-100	0.00	0.00	0	0	0
0022	3T	4_8	123	66	10	6600	6130	-470	0.15	0.93	11	10	-1
0022	3T	4_8	124	108	11	10800	6550	-4250	0.10	0.61	19	11	-8
0022	3T	4_8	125	96	7	9600	10090	490	0.07	1.05	16	17	1
0022	3T	4_8	126	48	4	4800	6760	1960	0.08	1.41	8	11	3
0022	3T	4_8	132	1	0	100	0	-100	0.00	0.00	0	0	0
0022	3T	4_8	134	41	4	4100	3490	-610	0.10	0.85	7	6	-1
0022	3T	4_8	135	46	8	4600	6870	2270	0.17	1.49	8	12	4
0022	3T	4_8	136	38	2	3800	1380	-2420	0.05	0.36	6	2	-4
0022	3T	4_8	143	1	0	100	0	-100	0.00	0.00	0	0	0
0022	3T	4_8	145	24	4	2400	4120	1720	0.17	1.72	4	7	3
0022	3T	4_8	146	16	0	1600	0	-1600	0.00	0.00	2	0	-2
0022	3T	4_8	156	4	0	400	0	-400	0.00	0.00	0	0	0
0022	3T	4_8	214	1	0	100	0	-100	0.00	0.00	0	0	0
0022	3T	4_8	215	1	0	100	0	-100	0.00	0.00	0	0	0
0022	3T	4_8	216	3	0	300	0	-300	0.00	0.00	0	0	0
0022	3T	4_8	234	1	0	100	0	-100	0.00	0.00	0	0	0
0022	3T	4_8	235	3	0	300	0	-300	0.00	0.00	0	0	0
0022	3T	4_8	236	2	0	200	0	-200	0.00	0.00	0	0	0
0022	3T	4_8	245	3	0	300	0	-300	0.00	0.00	0	0	0
0022	3T	4_8	246	4	0	400	0	-400	0.00	0.00	0	0	0
0022	3T	4_9	123	86	10	8600	5350	-3250	0.12	0.62	15	9	-6
0022	3T	4_9	124	158	10	15800	8110	-7690	0.06	0.51	27	14	-13
0022	3T	4_9	125	82	6	8200	6590	-1610	0.07	0.80	14	11	-3
0022	3T	4_9	126	50	3	5000	3510	-1490	0.06	0.70	8	6	-2
0022	3T	4_9	134	66	9	6600	11940	5340	0.14	1.81	11	21	10
0022	3T	4_9	135	48	5	4800	4140	-660	0.10	0.86	8	7	-1
0022	3T	4_9	136	37	2	3700	1960	-1740	0.05	0.53	6	3	-3
0022	3T	4_9	143	1	0	100	0	-100	0.00	0.00	0	0	0
0022	3T	4_9	145	24	1	2400	500	-1900	0.04	0.21	4	0	-4
0022	3T	4_9	146	9	1	900	470	-430	0.11	0.52	1	0	-1
0022	3T	4_9	154	1	0	100	0	-100	0.00	0.00	0	0	0
0022	3T	4_9	156	5	0	500	0	-500	0.00	0.00	0	0	0
0022	3T	4_9	214	1	0	100	0	-100	0.00	0.00	0	0	0
0022	3T	4_9	215	2	0	200	0	-200	0.00	0.00	0	0	0
0022	3T	4_9	234	2	1	200	2050	1850	0.50	10.25	0	3	3
0022	3T	4_9	235	2	0	200	0	-200	0.00	0.00	0	0	0
0022	3T	4_9	236	2	0	200	0	-200	0.00	0.00	0	0	0
0022	3T	4_9	246	1	0	100	0	-100	0.00	0.00	0	0	0
0022	3T	5_1	123	142	19	14200	13470	-730	0.13	0.95	25	23	-2
0022	3T	5_1	124	157	12	15700	10490	-5210	0.08	0.67	27	18	-9
0022	3T	5_1	125	29	2	2900	2240	-660	0.07	0.77	5	3	-2
0022	3T	5_1	126	19	1	1900	780	-1120	0.05	0.41	3	1	-2
0022	3T	5_1	132	1	0	100	0	-100	0.00	0.00	0	0	0
0022	3T	5_1	134	54	1	5400	990	-4410	0.02	0.18	9	1	-8
0022	3T	5_1	135	20	1	2000	1120	-880	0.05	0.56	3	1	-2
0022	3T	5_1	136	6	0	600	0	-600	0.00	0.00	1	0	-1
0022	3T	5_1	143	7	1	700	1180	480	0.14	1.69	1	2	1
0022	3T	5_1	145	6	1	600	3100	2500	0.17	5.17	1	5	4
0022	3T	5_1	146	3	0	300	0	-300	0.00	0.00	0	0	0
0022	3T	5_1	152	1	0	100	0	-100	0.00	0.00	0	0	0
0022	3T	5_1	153	3	0	300	0	-300	0.00	0.00	0	0	0
0022	3T	5_1	154	3	0	300	0	-300	0.00	0.00	0	0	0
0022	3T	5_1	156	1	0	100	0	-100	0.00	0.00	0	0	0
0022	3T	5_1	163	2	0	200	0	-200	0.00	0.00	0	0	0
0022	3T	5_1	253	1	1	100	1720	1620	1.00	17.20	0	3	3
0022	3T	5_10	123	99	13	9900	6700	-3200	0.13	0.68	17	11	-6
0022	3T	5_10	124	346	35	34600	23600	-11000	0.10	0.68	61	41	-20
0022	3T	5_10	125	79	2	7900	2310	-5590	0.03	0.29	13	4	-9
0022	3T	5_10	126	38	3	3800	4470	670	0.08	1.18	6	7	1
0022	3T	5_10	134	42	2	4200	1720	-2480	0.05	0.41	7	3	-4
0022	3T	5_10	135	23	0	2300	0	-2300	0.00	0.00	4	0	-4
0022	3T	5_10	136	5	0	500	0	-500	0.00	0.00	0	0	0
0022	3T	5_10	145	2	0	200	0	-200	0.00	0.00	0	0	0
0022	3T	5_10	146	1	0	100	0	-100	0.00	0.00	0	0	0
0022	3T	5_10	156	1	0	100	0	-100	0.00	0.00	0	0	0
0022	3T	5_10	215	1	0	100	0	-100	0.00	0.00	0	0	0
0022	3T	5_10	216	3	0	300	0	-300	0.00	0.00	0	0	0
0022	3T	5_10	234	2	0	200	0	-200	0.00	0.00	0	0	0
0022	3T	5_10	235	2	0	200	0	-200	0.00	0.00	0	0	0
0022	3T	5_11	123	158	29	15800	12490	-3310	0.18	0.79	27	22	-5
0022	3T	5_11	124	340	32	34000	21100	-12900	0.09	0.62	60	37	-23
0022	3T	5_11	125	73	6	7300	4700	-2600	0.08	0.64	12	8	-4
0022	3T	5_11	126	21	1	2100	1370	-730	0.05	0.65	3	2	-1
0022	3T	5_11	134	45	4	4500	3600	-900	0.09	0.80	7	6	-1
0022	3T	5_11	135	26	3	2600	2510	-90	0.12	0.97	4	4	0
0022	3T	5_11	136	7	0	700	0	-700	0.00	0.00	1	0	-1
0022	3T	5_11	143	1	0	100	0	-100	0.00	0.00	0	0	0
0022	3T	5_11	145	3	0	300	0	-300	0.00	0.00	0	0	0
0022	3T	5_11	235	1	0	100	0	-100	0.00	0.00	0	0	0
0022	3T	5_12	123	125	16	12500	7510	-4990	0.13	0.60	22	13	-9
0022	3T	5_12	124	325	26	32500	18070	-14430	0.08	0.56	57	31	-26
0022	3T	5_12	125	69	7	6900	6800	-100	0.10	0.99	12	12	0
0022	3T	5_12	126	26	2	2600	2680	80	0.08	1.03	4	4	0
0022	3T	5_12	134	44	1	4400	670	-3730	0.02	0.15	7	1	-6
0022	3T	5_12	135	39	3	3900	1990	-1910	0.08	0.51	6	3	-3
0022	3T	5_12	136	15	1	1500	1140	-360	0.07	0.76	2	2	0
0022	3T	5_12	145	4	0	400	0	-400	0.00	0.00	0	0	0
0022	3T	5_12	146	3	0	300	0	-300	0.00	0.00	0	0	0
0022	3T	5_12	246	1	0	100	0	-100	0.00	0.00	0	0	0
0022	3T	5_2	123	109	9	10900	6970	-3930	0.08	0.64	19	12	-7
0022	3T	5_2	124	102	7	10200	5320	-4880	0.07	0.52	18	9	-9
0022	3T	5_2	125	56	6	5600	7580	1980	0.11	1.35	9	13	4
0022	3T	5_2	126	28	1	2800	710	-2090	0.04	0.25	4	1	-3
0022	3T	5_2	134	29	2	2900	2030	-870	0.07	0.70	5	3	-2
0022	3T	5_2	135	21	2	2100	1730	-370	0.10	0.82	3	3	0
0022	3T	5_2	136	11	1	1100	770	-330	0.09	0.70	1	1	0
0022	3T	5_2	143	5	0	500	0	-500	0.00	0.00	0	0	0
0022	3T	5_2	145	18	2	1800	1210	-590	0.11	0.67	3	2	-1
0022	3T	5_2	146	10	0	1000	0	-1000	0.00	0.00	1	0	-1
0022	3T	5_2	153	7	1	700	1100	400	0.14	1.57	1	1	0
0022	3T	5_2	154	3	0	300	0	-300	0.00	0.00	0	0	0
0022	3T	5_2	156	3	0	300	0	-300	0.00	0.00	0	0	0
0022	3T	5_2	163	1	1	100	600	500	1.00	6.00	0	1	1
0022	3T	5_2	216	1	0	100	0	-100	0.00	0.00	0	0	0
0022	3T	5_2	234	3	1	300	820	520	0.33	2.73	0	1	1
0022	3T	5_2	235	2	0	200	0	-200	0.00	0.00	0	0	0
0022	3T	5_2	245	1	0	100	0	-100	0.00	0.00	0	0	0
0022	3T	5_2	256	1	0	100	0	-100	0.00	0.00	0	0	0
0022	3T	5_3	123	37	5	3700	5390	1690	0.14	1.46	6	9	3
0022	3T	5_3	124	74	6	7400	5080	-2320	0.08	0.69	13	8	-5
0022	3T	5_3	125	54	4	5400	5120	-280	0.07	0.95	9	9	0
0022	3T	5_3	126	49	8	4900	17440	12540	0.16	3.56	8	30	22
0022	3T	5_3	132	3	0	300	0	-300	0.00	0.00	0	0	0
0022	3T	5_3	134	54	5	5400	5510	110	0.09	1.02	9	9	0
0022	3T	5_3	135	60	3	6000	2080	-3920	0.05	0.35	10	3	-7
0022	3T	5_3	136	18	2	1800	3000	1200	0.11	1.67	3	5	2
0022	3T	5_3	145	15	1	1500	800	-700	0.07	0.53	2	1	-1
0022	3T	5_3	146	14	1	1400	1150	-250	0.07	0.82	2	2	0
0022	3T	5_3	153	1	0	100	0	-100	0.00	0.00	0	0	0
0022	3T	5_3	156	5	0	500	0	-500	0.00	0.00	0	0	0
0022	3T	5_3	164	3	0	300	0	-300	0.00	0.00	0	0	0
0022	3T	5_3	215	2	0	200	0	-200	0.00	0.00	0	0	0
0022	3T	5_3	216	4	0	400	0	-400	0.00	0.00	0	0	0
0022	3T	5_3	234	1	0	100	0	-100	0.00	0.00	0	0	0
0022	3T	5_3	235	1	0	100	0	-100	0.00	0.00	0	0	0
0022	3T	5_3	236	4	0	400	0	-400	0.00	0.00	0	0	0
0022	3T	5_3	246	3	0	300	0	-300	0.00	0.00	0	0	0
0022	3T	5_4	123	43	3	4300	1090	-3210	0.07	0.25	7	1	-6
0022	3T	5_4	124	120	7	12000	4290	-7710	0.06	0.36	21	7	-14
0022	3T	5_4	125	53	1	5300	800	-4500	0.02	0.15	9	1	-8
0022	3T	5_4	126	33	3	3300	8980	5680	0.09	2.72	5	15	10
0022	3T	5_4	134	42	5	4200	3460	-740	0.12	0.82	7	6	-1
0022	3T	5_4	135	40	3	4000	2990	-1010	0.08	0.75	7	5	-2
0022	3T	5_4	136	17	2	1700	2000	300	0.12	1.18	3	3	0
0022	3T	5_4	145	27	0	2700	0	-2700	0.00	0.00	4	0	-4
0022	3T	5_4	146	16	1	1600	830	-770	0.06	0.52	2	1	-1
0022	3T	5_4	156	10	1	1000	990	-10	0.10	0.99	1	1	0
0022	3T	5_4	164	2	0	200	0	-200	0.00	0.00	0	0	0
0022	3T	5_4	165	2	0	200	0	-200	0.00	0.00	0	0	0
0022	3T	5_4	214	3	0	300	0	-300	0.00	0.00	0	0	0
0022	3T	5_4	215	1	0	100	0	-100	0.00	0.00	0	0	0
0022	3T	5_4	216	5	0	500	0	-500	0.00	0.00	0	0	0
0022	3T	5_4	235	1	0	100	0	-100	0.00	0.00	0	0	0
0022	3T	5_4	236	1	0	100	0	-100	0.00	0.00	0	0	0
0022	3T	5_4	245	4	0	400	0	-400	0.00	0.00	0	0	0
0022	3T	5_4	246	1	0	100	0	-100	0.00	0.00	0	0	0
0022	3T	5_4	256	2	0	200	0	-200	0.00	0.00	0	0	0
0022	3T	5_5	123	69	9	6900	5020	-1880	0.13	0.73	12	8	-4
0022	3T	5_5	124	107	20	10700	10610	-90	0.19	0.99	18	18	0
0022	3T	5_5	125	68	9	6800	8230	1430	0.13	1.21	12	14	2
0022	3T	5_5	126	47	5	4700	3970	-730	0.11	0.84	8	7	-1
0022	3T	5_5	134	45	5	4500	4250	-250	0.11	0.94	7	7	0
0022	3T	5_5	135	34	3	3400	3440	40	0.09	1.01	6	6	0
0022	3T	5_5	136	22	1	2200	1080	-1120	0.05	0.49	3	1	-2
0022	3T	5_5	145	23	2	2300	1500	-800	0.09	0.65	4	2	-2
0022	3T	5_5	146	12	1	1200	2090	890	0.08	1.74	2	3	1
0022	3T	5_5	153	1	0	100	0	-100	0.00	0.00	0	0	0
0022	3T	5_5	156	5	0	500	0	-500	0.00	0.00	0	0	0
0022	3T	5_5	164	2	0	200	0	-200	0.00	0.00	0	0	0
0022	3T	5_5	165	2	0	200	0	-200	0.00	0.00	0	0	0
0022	3T	5_5	214	2	0	200	0	-200	0.00	0.00	0	0	0
0022	3T	5_5	215	3	0	300	0	-300	0.00	0.00	0	0	0
0022	3T	5_5	216	4	0	400	0	-400	0.00	0.00	0	0	0
0022	3T	5_5	234	4	0	400	0	-400	0.00	0.00	0	0	0
0022	3T	5_5	236	3	0	300	0	-300	0.00	0.00	0	0	0
0022	3T	5_5	246	1	0	100	0	-100	0.00	0.00	0	0	0
0022	3T	5_5	256	1	0	100	0	-100	0.00	0.00	0	0	0
0022	3T	5_6	123	42	4	4200	2580	-1620	0.10	0.61	7	4	-3
0022	3T	5_6	124	93	12	9300	7140	-2160	0.13	0.77	16	12	-4
0022	3T	5_6	125	57	2	5700	3350	-2350	0.04	0.59	10	5	-5
0022	3T	5_6	126	41	1	4100	780	-3320	0.02	0.19	7	1	-6
0022	3T	5_6	134	80	9	8000	5040	-2960	0.11	0.63	14	8	-6
0022	3T	5_6	135	32	1	3200	680	-2520	0.03	0.21	5	1	-4
0022	3T	5_6	136	18	3	1800	6370	4570	0.17	3.54	3	11	8
0022	3T	5_6	143	1	0	100	0	-100	0.00	0.00	0	0	0
0022	3T	5_6	145	20	1	2000	1080	-920	0.05	0.54	3	1	-2
0022	3T	5_6	146	13	0	1300	0	-1300	0.00	0.00	2	0	-2
0022	3T	5_6	154	1	0	100	0	-100	0.00	0.00	0	0	0
0022	3T	5_6	156	8	0	800	0	-800	0.00	0.00	1	0	-1
0022	3T	5_6	164	2	0	200	0	-200	0.00	0.00	0	0	0
0022	3T	5_6	165	1	0	100	0	-100	0.00	0.00	0	0	0
0022	3T	5_6	214	4	0	400	0	-400	0.00	0.00	0	0	0
0022	3T	5_6	215	5	0	500	0	-500	0.00	0.00	0	0	0
0022	3T	5_6	216	6	0	600	0	-600	0.00	0.00	1	0	-1
0022	3T	5_6	234	1	0	100	0	-100	0.00	0.00	0	0	0
0022	3T	5_6	235	5	0	500	0	-500	0.00	0.00	0	0	0
0022	3T	5_6	236	2	0	200	0	-200	0.00	0.00	0	0	0
0022	3T	5_6	245	1	0	100	0	-100	0.00	0.00	0	0	0
0022	3T	5_6	246	1	0	100	0	-100	0.00	0.00	0	0	0
0022	3T	5_6	264	1	0	100	0	-100	0.00	0.00	0	0	0
0022	3T	5_7	123	50	5	5000	3430	-1570	0.10	0.69	8	6	-2
0022	3T	5_7	124	81	10	8100	7620	-480	0.12	0.94	14	13	-1
0022	3T	5_7	125	61	8	6100	6850	750	0.13	1.12	10	12	2
0022	3T	5_7	126	57	5	5700	8830	3130	0.09	1.55	10	15	5
0022	3T	5_7	134	56	8	5600	4820	-780	0.14	0.86	9	8	-1
0022	3T	5_7	135	40	3	4000	6490	2490	0.08	1.62	7	11	4
0022	3T	5_7	136	32	7	3200	9760	6560	0.22	3.05	5	17	12
0022	3T	5_7	143	1	0	100	0	-100	0.00	0.00	0	0	0
0022	3T	5_7	145	38	1	3800	1000	-2800	0.03	0.26	6	1	-5
0022	3T	5_7	146	11	0	1100	0	-1100	0.00	0.00	1	0	-1
0022	3T	5_7	154	1	0	100	0	-100	0.00	0.00	0	0	0
0022	3T	5_7	156	8	1	800	1370	570	0.13	1.71	1	2	1
0022	3T	5_7	164	2	1	200	980	780	0.50	4.90	0	1	1
0022	3T	5_7	165	2	0	200	0	-200	0.00	0.00	0	0	0
0022	3T	5_7	214	2	0	200	0	-200	0.00	0.00	0	0	0
0022	3T	5_7	215	1	0	100	0	-100	0.00	0.00	0	0	0
0022	3T	5_7	216	2	0	200	0	-200	0.00	0.00	0	0	0
0022	3T	5_7	234	1	0	100	0	-100	0.00	0.00	0	0	0
0022	3T	5_7	235	1	0	100	0	-100	0.00	0.00	0	0	0
0022	3T	5_7	236	2	0	200	0	-200	0.00	0.00	0	0	0
0022	3T	5_7	245	1	0	100	0	-100	0.00	0.00	0	0	0
0022	3T	5_8	123	30	9	3000	4980	1980	0.30	1.66	5	8	3
0022	3T	5_8	124	98	14	9800	7520	-2280	0.14	0.77	17	13	-4
0022	3T	5_8	125	56	6	5600	5560	-40	0.11	0.99	9	9	0
0022	3T	5_8	126	50	3	5000	3800	-1200	0.06	0.76	8	6	-2
0022	3T	5_8	132	1	0	100	0	-100	0.00	0.00	0	0	0
0022	3T	5_8	134	50	2	5000	1370	-3630	0.04	0.27	8	2	-6
0022	3T	5_8	135	27	2	2700	2280	-420	0.07	0.84	4	4	0
0022	3T	5_8	136	46	8	4600	7970	3370	0.17	1.73	8	14	6
0022	3T	5_8	142	1	0	100	0	-100	0.00	0.00	0	0	0
0022	3T	5_8	145	24	0	2400	0	-2400	0.00	0.00	4	0	-4
0022	3T	5_8	146	21	2	2100	2930	830	0.10	1.40	3	5	2
0022	3T	5_8	153	1	0	100	0	-100	0.00	0.00	0	0	0
0022	3T	5_8	154	1	0	100	0	-100	0.00	0.00	0	0	0
0022	3T	5_8	156	6	0	600	0	-600	0.00	0.00	1	0	-1
0022	3T	5_8	164	1	0	100	0	-100	0.00	0.00	0	0	0
0022	3T	5_8	165	3	0	300	0	-300	0.00	0.00	0	0	0
0022	3T	5_8	214	1	0	100	0	-100	0.00	0.00	0	0	0
0022	3T	5_8	216	2	0	200	0	-200	0.00	0.00	0	0	0
0022	3T	5_8	234	1	0	100	0	-100	0.00	0.00	0	0	0
0022	3T	5_8	235	2	0	200	0	-200	0.00	0.00	0	0	0
0022	3T	5_8	236	3	0	300	0	-300	0.00	0.00	0	0	0
0022	3T	5_9	123	58	6	5800	3830	-1970	0.10	0.66	10	6	-4
0022	3T	5_9	124	165	21	16500	15890	-610	0.13	0.96	29	28	-1
0022	3T	5_9	125	74	2	7400	1940	-5460	0.03	0.26	13	3	-10
0022	3T	5_9	126	70	7	7000	8880	1880	0.10	1.27	12	15	3
0022	3T	5_9	134	51	4	5100	4220	-880	0.08	0.83	9	7	-2
0022	3T	5_9	135	34	2	3400	2700	-700	0.06	0.79	6	4	-2
0022	3T	5_9	136	33	2	3300	1990	-1310	0.06	0.60	5	3	-2
0022	3T	5_9	142	1	0	100	0	-100	0.00	0.00	0	0	0
0022	3T	5_9	143	1	0	100	0	-100	0.00	0.00	0	0	0
0022	3T	5_9	145	24	2	2400	1550	-850	0.08	0.65	4	2	-2
0022	3T	5_9	146	10	1	1000	690	-310	0.10	0.69	1	1	0
0022	3T	5_9	156	5	0	500	0	-500	0.00	0.00	0	0	0
0022	3T	5_9	164	2	0	200	0	-200	0.00	0.00	0	0	0
0022	3T	5_9	214	2	0	200	0	-200	0.00	0.00	0	0	0
0022	3T	5_9	215	1	0	100	0	-100	0.00	0.00	0	0	0
0022	3T	5_9	216	1	0	100	0	-100	0.00	0.00	0	0	0
0022	3T	5_9	234	1	0	100	0	-100	0.00	0.00	0	0	0
0022	3T	5_9	245	1	0	100	0	-100	0.00	0.00	0	0	0
0022	3T	5_9	246	1	0	100	0	-100	0.00	0.00	0	0	0
0022	3T	6_1	123	1	0	100	0	-100	0.00	0.00	0	0	0
0022	3T	6_1	124	9	1	900	480	-420	0.11	0.53	1	0	-1
0022	3T	6_1	125	3	1	300	940	640	0.33	3.13	0	1	1
0022	3T	6_1	126	3	0	300	0	-300	0.00	0.00	0	0	0
0022	3T	6_1	132	1	1	100	840	740	1.00	8.40	0	1	1
0022	3T	6_1	134	2	0	200	0	-200	0.00	0.00	0	0	0
0022	3T	6_1	143	1	0	100	0	-100	0.00	0.00	0	0	0
0022	3T	6_1	145	1	0	100	0	-100	0.00	0.00	0	0	0
0022	3T	6_1	235	1	0	100	0	-100	0.00	0.00	0	0	0
0022	3T	6_10	123	6	1	600	530	-70	0.17	0.88	1	0	-1
0022	3T	6_10	124	31	3	3100	1440	-1660	0.10	0.46	5	2	-3
0022	3T	6_10	125	8	1	800	1810	1010	0.13	2.26	1	3	2
0022	3T	6_10	126	1	0	100	0	-100	0.00	0.00	0	0	0
0022	3T	6_10	134	4	1	400	660	260	0.25	1.65	0	1	1
0022	3T	6_10	135	1	1	100	1150	1050	1.00	11.50	0	2	2
0022	3T	6_10	143	1	0	100	0	-100	0.00	0.00	0	0	0
0022	3T	6_10	214	1	0	100	0	-100	0.00	0.00	0	0	0
0022	3T	6_11	123	10	2	1000	1210	210	0.20	1.21	1	2	1
0022	3T	6_11	124	36	1	3600	580	-3020	0.03	0.16	6	1	-5
0022	3T	6_11	125	2	0	200	0	-200	0.00	0.00	0	0	0
0022	3T	6_11	126	3	0	300	0	-300	0.00	0.00	0	0	0
0022	3T	6_11	134	3	1	300	430	130	0.33	1.43	0	0	0
0022	3T	6_11	135	3	0	300	0	-300	0.00	0.00	0	0	0
0022	3T	6_12	123	8	2	800	1030	230	0.25	1.29	1	1	0
0022	3T	6_12	124	25	1	2500	690	-1810	0.04	0.28	4	1	-3
0022	3T	6_12	125	8	2	800	2350	1550	0.25	2.94	1	4	3
0022	3T	6_12	126	3	0	300	0	-300	0.00	0.00	0	0	0
0022	3T	6_12	134	3	0	300	0	-300	0.00	0.00	0	0	0
0022	3T	6_12	135	5	0	500	0	-500	0.00	0.00	0	0	0
0022	3T	6_12	136	1	0	100	0	-100	0.00	0.00	0	0	0
0022	3T	6_12	142	1	0	100	0	-100	0.00	0.00	0	0	0
0022	3T	6_12	145	1	0	100	0	-100	0.00	0.00	0	0	0
0022	3T	6_2	123	1	0	100	0	-100	0.00	0.00	0	0	0
0022	3T	6_2	124	11	1	1100	280	-820	0.09	0.25	1	0	-1
0022	3T	6_2	125	3	1	300	670	370	0.33	2.23	0	1	1
0022	3T	6_2	126	4	0	400	0	-400	0.00	0.00	0	0	0
0022	3T	6_2	134	2	0	200	0	-200	0.00	0.00	0	0	0
0022	3T	6_2	136	2	0	200	0	-200	0.00	0.00	0	0	0
0022	3T	6_2	143	2	0	200	0	-200	0.00	0.00	0	0	0
0022	3T	6_3	123	1	0	100	0	-100	0.00	0.00	0	0	0
0022	3T	6_3	124	5	0	500	0	-500	0.00	0.00	0	0	0
0022	3T	6_3	125	3	1	300	1370	1070	0.33	4.57	0	2	2
0022	3T	6_3	126	4	1	400	980	580	0.25	2.45	0	1	1
0022	3T	6_3	134	2	0	200	0	-200	0.00	0.00	0	0	0
0022	3T	6_3	135	7	0	700	0	-700	0.00	0.00	1	0	-1
0022	3T	6_3	136	5	0	500	0	-500	0.00	0.00	0	0	0
0022	3T	6_3	145	3	0	300	0	-300	0.00	0.00	0	0	0
0022	3T	6_3	146	2	0	200	0	-200	0.00	0.00	0	0	0
0022	3T	6_3	216	1	1	100	8510	8410	1.00	85.10	0	15	15
0022	3T	6_3	234	1	0	100	0	-100	0.00	0.00	0	0	0
0022	3T	6_4	123	3	0	300	0	-300	0.00	0.00	0	0	0
0022	3T	6_4	124	8	1	800	600	-200	0.13	0.75	1	1	0
0022	3T	6_4	125	5	2	500	2180	1680	0.40	4.36	0	3	3
0022	3T	6_4	126	6	0	600	0	-600	0.00	0.00	1	0	-1
0022	3T	6_4	132	1	0	100	0	-100	0.00	0.00	0	0	0
0022	3T	6_4	134	2	0	200	0	-200	0.00	0.00	0	0	0
0022	3T	6_4	135	1	1	100	690	590	1.00	6.90	0	1	1
0022	3T	6_4	136	3	0	300	0	-300	0.00	0.00	0	0	0
0022	3T	6_4	145	2	0	200	0	-200	0.00	0.00	0	0	0
0022	3T	6_4	146	2	0	200	0	-200	0.00	0.00	0	0	0
0022	3T	6_4	156	1	0	100	0	-100	0.00	0.00	0	0	0
0022	3T	6_4	214	1	0	100	0	-100	0.00	0.00	0	0	0
0022	3T	6_5	123	5	0	500	0	-500	0.00	0.00	0	0	0
0022	3T	6_5	124	8	2	800	1950	1150	0.25	2.44	1	3	2
0022	3T	6_5	125	4	1	400	2330	1930	0.25	5.83	0	4	4
0022	3T	6_5	126	8	0	800	0	-800	0.00	0.00	1	0	-1
0022	3T	6_5	134	7	0	700	0	-700	0.00	0.00	1	0	-1
0022	3T	6_5	135	1	0	100	0	-100	0.00	0.00	0	0	0
0022	3T	6_5	136	1	0	100	0	-100	0.00	0.00	0	0	0
0022	3T	6_5	145	5	1	500	820	320	0.20	1.64	0	1	1
0022	3T	6_5	146	1	1	100	640	540	1.00	6.40	0	1	1
0022	3T	6_6	123	3	1	300	520	220	0.33	1.73	0	0	0
0022	3T	6_6	124	3	0	300	0	-300	0.00	0.00	0	0	0
0022	3T	6_6	125	5	0	500	0	-500	0.00	0.00	0	0	0
0022	3T	6_6	126	7	3	700	3240	2540	0.43	4.63	1	5	4
0022	3T	6_6	134	1	1	100	710	610	1.00	7.10	0	1	1
0022	3T	6_6	135	4	1	400	660	260	0.25	1.65	0	1	1
0022	3T	6_6	136	4	0	400	0	-400	0.00	0.00	0	0	0
0022	3T	6_6	145	1	0	100	0	-100	0.00	0.00	0	0	0
0022	3T	6_6	146	3	0	300	0	-300	0.00	0.00	0	0	0
0022	3T	6_6	156	1	0	100	0	-100	0.00	0.00	0	0	0
0022	3T	6_7	123	4	0	400	0	-400	0.00	0.00	0	0	0
0022	3T	6_7	124	4	1	400	590	190	0.25	1.48	0	1	1
0022	3T	6_7	125	8	0	800	0	-800	0.00	0.00	1	0	-1
0022	3T	6_7	126	4	0	400	0	-400	0.00	0.00	0	0	0
0022	3T	6_7	134	3	1	300	650	350	0.33	2.17	0	1	1
0022	3T	6_7	135	7	1	700	320	-380	0.14	0.46	1	0	-1
0022	3T	6_7	136	1	0	100	0	-100	0.00	0.00	0	0	0
0022	3T	6_7	145	7	0	700	0	-700	0.00	0.00	1	0	-1
0022	3T	6_7	146	1	0	100	0	-100	0.00	0.00	0	0	0
0022	3T	6_8	123	6	0	600	0	-600	0.00	0.00	1	0	-1
0022	3T	6_8	124	11	0	1100	0	-1100	0.00	0.00	1	0	-1
0022	3T	6_8	125	5	0	500	0	-500	0.00	0.00	0	0	0
0022	3T	6_8	126	2	0	200	0	-200	0.00	0.00	0	0	0
0022	3T	6_8	134	3	1	300	780	480	0.33	2.60	0	1	1
0022	3T	6_8	135	1	0	100	0	-100	0.00	0.00	0	0	0
0022	3T	6_8	136	5	0	500	0	-500	0.00	0.00	0	0	0
0022	3T	6_8	146	2	0	200	0	-200	0.00	0.00	0	0	0
0022	3T	6_8	156	1	0	100	0	-100	0.00	0.00	0	0	0
0022	3T	6_9	123	6	1	600	680	80	0.17	1.13	1	1	0
0022	3T	6_9	124	14	2	1400	1330	-70	0.14	0.95	2	2	0
0022	3T	6_9	125	7	0	700	0	-700	0.00	0.00	1	0	-1
0022	3T	6_9	126	4	0	400	0	-400	0.00	0.00	0	0	0
0022	3T	6_9	134	6	1	600	650	50	0.17	1.08	1	1	0
0022	3T	6_9	135	4	0	400	0	-400	0.00	0.00	0	0	0
0022	3T	6_9	136	3	0	300	0	-300	0.00	0.00	0	0	0
0022	3T	6_9	145	2	0	200	0	-200	0.00	0.00	0	0	0
0022	3T	6_9	216	1	0	100	0	-100	0.00	0.00	0	0	0
0022	3T	7_1	123	271	33	27100	20300	-6800	0.12	0.75	47	35	-12
0022	3T	7_1	124	242	24	24200	18970	-5230	0.10	0.78	42	33	-9
0022	3T	7_1	125	66	7	6600	6440	-160	0.11	0.98	11	11	0
0022	3T	7_1	126	31	1	3100	2590	-510	0.03	0.84	5	4	-1
0022	3T	7_1	134	64	9	6400	8020	1620	0.14	1.25	11	14	3
0022	3T	7_1	135	25	2	2500	1240	-1260	0.08	0.50	4	2	-2
0022	3T	7_1	136	10	2	1000	2940	1940	0.20	2.94	1	5	4
0022	3T	7_1	143	6	1	600	2280	1680	0.17	3.80	1	4	3
0022	3T	7_1	145	9	0	900	0	-900	0.00	0.00	1	0	-1
0022	3T	7_1	146	6	0	600	0	-600	0.00	0.00	1	0	-1
0022	3T	7_1	152	1	0	100	0	-100	0.00	0.00	0	0	0
0022	3T	7_1	153	3	1	300	1500	1200	0.33	5.00	0	2	2
0022	3T	7_1	154	1	0	100	0	-100	0.00	0.00	0	0	0
0022	3T	7_1	163	3	0	300	0	-300	0.00	0.00	0	0	0
0022	3T	7_1	234	3	0	300	0	-300	0.00	0.00	0	0	0
0022	3T	7_1	235	2	0	200	0	-200	0.00	0.00	0	0	0
0022	3T	7_1	236	1	0	100	0	-100	0.00	0.00	0	0	0
0022	3T	7_1	245	1	0	100	0	-100	0.00	0.00	0	0	0
0022	3T	7_10	123	114	14	11400	9200	-2200	0.12	0.81	20	16	-4
0022	3T	7_10	124	369	29	36900	22220	-14680	0.08	0.60	65	39	-26
0022	3T	7_10	125	185	13	18500	15330	-3170	0.07	0.83	32	27	-5
0022	3T	7_10	126	97	3	9700	7400	-2300	0.03	0.76	17	13	-4
0022	3T	7_10	134	79	6	7900	5700	-2200	0.08	0.72	13	10	-3
0022	3T	7_10	135	73	6	7300	7330	30	0.08	1.00	12	12	0
0022	3T	7_10	136	33	0	3300	0	-3300	0.00	0.00	5	0	-5
0022	3T	7_10	145	21	0	2100	0	-2100	0.00	0.00	3	0	-3
0022	3T	7_10	146	4	0	400	0	-400	0.00	0.00	0	0	0
0022	3T	7_10	154	1	0	100	0	-100	0.00	0.00	0	0	0
0022	3T	7_10	156	3	1	300	1050	750	0.33	3.50	0	1	1
0022	3T	7_10	214	1	0	100	0	-100	0.00	0.00	0	0	0
0022	3T	7_10	215	1	0	100	0	-100	0.00	0.00	0	0	0
0022	3T	7_10	216	1	0	100	0	-100	0.00	0.00	0	0	0
0022	3T	7_10	235	2	0	200	0	-200	0.00	0.00	0	0	0
0022	3T	7_10	245	1	0	100	0	-100	0.00	0.00	0	0	0
0022	3T	7_10	246	1	0	100	0	-100	0.00	0.00	0	0	0
0022	3T	7_11	123	104	15	10400	7280	-3120	0.14	0.70	18	12	-6
0022	3T	7_11	124	353	36	35300	26110	-9190	0.10	0.74	62	46	-16
0022	3T	7_11	125	164	13	16400	17300	900	0.08	1.05	29	30	1
0022	3T	7_11	126	119	5	11900	6410	-5490	0.04	0.54	21	11	-10
0022	3T	7_11	134	105	9	10500	6420	-4080	0.09	0.61	18	11	-7
0022	3T	7_11	135	56	3	5600	3370	-2230	0.05	0.60	9	5	-4
0022	3T	7_11	136	48	0	4800	0	-4800	0.00	0.00	8	0	-8
0022	3T	7_11	145	14	0	1400	0	-1400	0.00	0.00	2	0	-2
0022	3T	7_11	146	11	1	1100	830	-270	0.09	0.75	1	1	0
0022	3T	7_11	156	2	0	200	0	-200	0.00	0.00	0	0	0
0022	3T	7_11	164	2	0	200	0	-200	0.00	0.00	0	0	0
0022	3T	7_11	213	2	0	200	0	-200	0.00	0.00	0	0	0
0022	3T	7_11	214	1	0	100	0	-100	0.00	0.00	0	0	0
0022	3T	7_11	215	1	0	100	0	-100	0.00	0.00	0	0	0
0022	3T	7_11	216	6	0	600	0	-600	0.00	0.00	1	0	-1
0022	3T	7_11	235	1	0	100	0	-100	0.00	0.00	0	0	0
0022	3T	7_11	245	1	0	100	0	-100	0.00	0.00	0	0	0
0022	3T	7_11	256	1	0	100	0	-100	0.00	0.00	0	0	0
0022	3T	7_12	123	57	7	5700	5180	-520	0.12	0.91	10	9	-1
0022	3T	7_12	124	799	64	79900	55000	-24900	0.08	0.69	141	97	-44
0022	3T	7_12	125	43	0	4300	0	-4300	0.00	0.00	7	0	-7
0022	3T	7_12	126	73	5	7300	11040	3740	0.07	1.51	12	19	7
0022	3T	7_12	134	52	2	5200	1590	-3610	0.04	0.31	9	2	-7
0022	3T	7_12	135	13	0	1300	0	-1300	0.00	0.00	2	0	-2
0022	3T	7_12	136	19	0	1900	0	-1900	0.00	0.00	3	0	-3
0022	3T	7_12	145	1	0	100	0	-100	0.00	0.00	0	0	0
0022	3T	7_12	216	4	0	400	0	-400	0.00	0.00	0	0	0
0022	3T	7_2	123	169	18	16900	11500	-5400	0.11	0.68	29	20	-9
0022	3T	7_2	124	174	12	17400	10020	-7380	0.07	0.58	30	17	-13
0022	3T	7_2	125	91	9	9100	10720	1620	0.10	1.18	16	18	2
0022	3T	7_2	126	70	5	7000	9190	2190	0.07	1.31	12	16	4
0022	3T	7_2	132	2	0	200	0	-200	0.00	0.00	0	0	0
0022	3T	7_2	134	68	5	6800	3950	-2850	0.07	0.58	12	6	-6
0022	3T	7_2	135	29	1	2900	1000	-1900	0.03	0.34	5	1	-4
0022	3T	7_2	136	23	1	2300	3800	1500	0.04	1.65	4	6	2
0022	3T	7_2	143	2	0	200	0	-200	0.00	0.00	0	0	0
0022	3T	7_2	145	13	0	1300	0	-1300	0.00	0.00	2	0	-2
0022	3T	7_2	146	15	2	1500	2080	580	0.13	1.39	2	3	1
0022	3T	7_2	153	1	0	100	0	-100	0.00	0.00	0	0	0
0022	3T	7_2	154	2	0	200	0	-200	0.00	0.00	0	0	0
0022	3T	7_2	156	4	0	400	0	-400	0.00	0.00	0	0	0
0022	3T	7_2	163	1	0	100	0	-100	0.00	0.00	0	0	0
0022	3T	7_2	216	1	0	100	0	-100	0.00	0.00	0	0	0
0022	3T	7_2	234	5	0	500	0	-500	0.00	0.00	0	0	0
0022	3T	7_2	235	5	0	500	0	-500	0.00	0.00	0	0	0
0022	3T	7_2	245	2	0	200	0	-200	0.00	0.00	0	0	0
0022	3T	7_3	123	72	10	7200	7230	30	0.14	1.00	12	12	0
0022	3T	7_3	124	125	7	12500	15350	2850	0.06	1.23	22	27	5
0022	3T	7_3	125	112	6	11200	9320	-1880	0.05	0.83	19	16	-3
0022	3T	7_3	126	93	6	9300	8330	-970	0.06	0.90	16	14	-2
0022	3T	7_3	132	1	0	100	0	-100	0.00	0.00	0	0	0
0022	3T	7_3	134	72	4	7200	3330	-3870	0.06	0.46	12	5	-7
0022	3T	7_3	135	76	4	7600	3070	-4530	0.05	0.40	13	5	-8
0022	3T	7_3	136	42	1	4200	820	-3380	0.02	0.20	7	1	-6
0022	3T	7_3	142	1	0	100	0	-100	0.00	0.00	0	0	0
0022	3T	7_3	143	1	0	100	0	-100	0.00	0.00	0	0	0
0022	3T	7_3	145	32	1	3200	1560	-1640	0.03	0.49	5	2	-3
0022	3T	7_3	146	37	3	3700	7180	3480	0.08	1.94	6	12	6
0022	3T	7_3	152	1	0	100	0	-100	0.00	0.00	0	0	0
0022	3T	7_3	156	10	0	1000	0	-1000	0.00	0.00	1	0	-1
0022	3T	7_3	214	1	0	100	0	-100	0.00	0.00	0	0	0
0022	3T	7_3	215	4	0	400	0	-400	0.00	0.00	0	0	0
0022	3T	7_3	216	3	0	300	0	-300	0.00	0.00	0	0	0
0022	3T	7_3	234	4	0	400	0	-400	0.00	0.00	0	0	0
0022	3T	7_3	235	7	1	700	1290	590	0.14	1.84	1	2	1
0022	3T	7_3	236	5	1	500	5030	4530	0.20	10.06	0	8	8
0022	3T	7_3	245	3	0	300	0	-300	0.00	0.00	0	0	0
0022	3T	7_3	246	4	0	400	0	-400	0.00	0.00	0	0	0
0022	3T	7_3	256	2	0	200	0	-200	0.00	0.00	0	0	0
0022	3T	7_4	123	96	14	9600	7760	-1840	0.15	0.81	16	13	-3
0022	3T	7_4	124	171	14	17100	12220	-4880	0.08	0.71	30	21	-9
0022	3T	7_4	125	91	6	9100	5880	-3220	0.07	0.65	16	10	-6
0022	3T	7_4	126	94	4	9400	3680	-5720	0.04	0.39	16	6	-10
0022	3T	7_4	134	74	5	7400	3520	-3880	0.07	0.48	13	6	-7
0022	3T	7_4	135	42	1	4200	670	-3530	0.02	0.16	7	1	-6
0022	3T	7_4	136	49	5	4900	9390	4490	0.10	1.92	8	16	8
0022	3T	7_4	142	1	1	100	670	570	1.00	6.70	0	1	1
0022	3T	7_4	145	40	3	4000	7100	3100	0.08	1.78	7	12	5
0022	3T	7_4	146	38	1	3800	2300	-1500	0.03	0.61	6	4	-2
0022	3T	7_4	156	11	2	1100	3790	2690	0.18	3.45	1	6	5
0022	3T	7_4	214	1	0	100	0	-100	0.00	0.00	0	0	0
0022	3T	7_4	215	2	0	200	0	-200	0.00	0.00	0	0	0
0022	3T	7_4	216	2	1	200	1350	1150	0.50	6.75	0	2	2
0022	3T	7_4	234	2	0	200	0	-200	0.00	0.00	0	0	0
0022	3T	7_4	235	5	0	500	0	-500	0.00	0.00	0	0	0
0022	3T	7_4	236	5	0	500	0	-500	0.00	0.00	0	0	0
0022	3T	7_4	245	1	0	100	0	-100	0.00	0.00	0	0	0
0022	3T	7_4	246	7	1	700	2150	1450	0.14	3.07	1	3	2
0022	3T	7_4	256	1	0	100	0	-100	0.00	0.00	0	0	0
0022	3T	7_5	123	100	9	10000	4370	-5630	0.09	0.44	17	7	-10
0022	3T	7_5	124	204	22	20400	13870	-6530	0.11	0.68	36	24	-12
0022	3T	7_5	125	94	9	9400	6340	-3060	0.10	0.67	16	11	-5
0022	3T	7_5	126	99	8	9900	8860	-1040	0.08	0.89	17	15	-2
0022	3T	7_5	134	66	5	6600	2920	-3680	0.08	0.44	11	5	-6
0022	3T	7_5	135	50	4	5000	4160	-840	0.08	0.83	8	7	-1
0022	3T	7_5	136	45	3	4500	2460	-2040	0.07	0.55	7	4	-3
0022	3T	7_5	143	1	0	100	0	-100	0.00	0.00	0	0	0
0022	3T	7_5	145	28	1	2800	710	-2090	0.04	0.25	4	1	-3
0022	3T	7_5	146	21	1	2100	850	-1250	0.05	0.40	3	1	-2
0022	3T	7_5	152	2	0	200	0	-200	0.00	0.00	0	0	0
0022	3T	7_5	154	1	0	100	0	-100	0.00	0.00	0	0	0
0022	3T	7_5	156	15	0	1500	0	-1500	0.00	0.00	2	0	-2
0022	3T	7_5	214	1	0	100	0	-100	0.00	0.00	0	0	0
0022	3T	7_5	215	2	0	200	0	-200	0.00	0.00	0	0	0
0022	3T	7_5	216	2	0	200	0	-200	0.00	0.00	0	0	0
0022	3T	7_5	235	2	0	200	0	-200	0.00	0.00	0	0	0
0022	3T	7_5	236	3	0	300	0	-300	0.00	0.00	0	0	0
0022	3T	7_5	245	2	0	200	0	-200	0.00	0.00	0	0	0
0022	3T	7_5	256	5	0	500	0	-500	0.00	0.00	0	0	0
0022	3T	7_6	123	89	12	8900	6080	-2820	0.13	0.68	15	10	-5
0022	3T	7_6	124	116	8	11600	5120	-6480	0.07	0.44	20	9	-11
0022	3T	7_6	125	72	10	7200	7700	500	0.14	1.07	12	13	1
0022	3T	7_6	126	98	6	9800	7290	-2510	0.06	0.74	17	12	-5
0022	3T	7_6	132	1	0	100	0	-100	0.00	0.00	0	0	0
0022	3T	7_6	134	74	8	7400	4910	-2490	0.11	0.66	13	8	-5
0022	3T	7_6	135	42	4	4200	2610	-1590	0.10	0.62	7	4	-3
0022	3T	7_6	136	75	6	7500	6080	-1420	0.08	0.81	13	10	-3
0022	3T	7_6	142	1	0	100	0	-100	0.00	0.00	0	0	0
0022	3T	7_6	143	1	0	100	0	-100	0.00	0.00	0	0	0
0022	3T	7_6	145	32	1	3200	740	-2460	0.03	0.23	5	1	-4
0022	3T	7_6	146	28	2	2800	1440	-1360	0.07	0.51	4	2	-2
0022	3T	7_6	153	1	1	100	850	750	1.00	8.50	0	1	1
0022	3T	7_6	156	13	0	1300	0	-1300	0.00	0.00	2	0	-2
0022	3T	7_6	163	1	0	100	0	-100	0.00	0.00	0	0	0
0022	3T	7_6	164	1	0	100	0	-100	0.00	0.00	0	0	0
0022	3T	7_6	213	1	0	100	0	-100	0.00	0.00	0	0	0
0022	3T	7_6	214	2	0	200	0	-200	0.00	0.00	0	0	0
0022	3T	7_6	215	3	0	300	0	-300	0.00	0.00	0	0	0
0022	3T	7_6	216	1	0	100	0	-100	0.00	0.00	0	0	0
0022	3T	7_6	234	4	0	400	0	-400	0.00	0.00	0	0	0
0022	3T	7_6	235	2	0	200	0	-200	0.00	0.00	0	0	0
0022	3T	7_6	236	3	0	300	0	-300	0.00	0.00	0	0	0
0022	3T	7_6	245	1	0	100	0	-100	0.00	0.00	0	0	0
0022	3T	7_6	246	3	1	300	1210	910	0.33	4.03	0	2	2
0022	3T	7_6	256	3	0	300	0	-300	0.00	0.00	0	0	0
0022	3T	7_7	123	78	10	7800	5390	-2410	0.13	0.69	13	9	-4
0022	3T	7_7	124	143	16	14300	10720	-3580	0.11	0.75	25	18	-7
0022	3T	7_7	125	107	7	10700	5050	-5650	0.07	0.47	18	8	-10
0022	3T	7_7	126	127	7	12700	5400	-7300	0.06	0.43	22	9	-13
0022	3T	7_7	132	1	0	100	0	-100	0.00	0.00	0	0	0
0022	3T	7_7	134	51	6	5100	3730	-1370	0.12	0.73	9	6	-3
0022	3T	7_7	135	53	4	5300	5210	-90	0.08	0.98	9	9	0
0022	3T	7_7	136	55	2	5500	1380	-4120	0.04	0.25	9	2	-7
0022	3T	7_7	142	1	0	100	0	-100	0.00	0.00	0	0	0
0022	3T	7_7	145	24	1	2400	570	-1830	0.04	0.24	4	1	-3
0022	3T	7_7	146	29	1	2900	850	-2050	0.03	0.29	5	1	-4
0022	3T	7_7	154	1	0	100	0	-100	0.00	0.00	0	0	0
0022	3T	7_7	156	17	0	1700	0	-1700	0.00	0.00	3	0	-3
0022	3T	7_7	164	3	0	300	0	-300	0.00	0.00	0	0	0
0022	3T	7_7	165	2	0	200	0	-200	0.00	0.00	0	0	0
0022	3T	7_7	213	1	0	100	0	-100	0.00	0.00	0	0	0
0022	3T	7_7	214	1	0	100	0	-100	0.00	0.00	0	0	0
0022	3T	7_7	216	2	0	200	0	-200	0.00	0.00	0	0	0
0022	3T	7_7	235	2	0	200	0	-200	0.00	0.00	0	0	0
0022	3T	7_8	123	91	13	9100	8530	-570	0.14	0.94	16	15	-1
0022	3T	7_8	124	192	28	19200	17660	-1540	0.15	0.92	33	31	-2
0022	3T	7_8	125	100	13	10000	8960	-1040	0.13	0.90	17	15	-2
0022	3T	7_8	126	122	9	12200	11510	-690	0.07	0.94	21	20	-1
0022	3T	7_8	132	1	0	100	0	-100	0.00	0.00	0	0	0
0022	3T	7_8	134	70	9	7000	8720	1720	0.13	1.25	12	15	3
0022	3T	7_8	135	52	4	5200	3380	-1820	0.08	0.65	9	5	-4
0022	3T	7_8	136	59	5	5900	4780	-1120	0.08	0.81	10	8	-2
0022	3T	7_8	142	1	0	100	0	-100	0.00	0.00	0	0	0
0022	3T	7_8	143	2	0	200	0	-200	0.00	0.00	0	0	0
0022	3T	7_8	145	19	4	1900	4140	2240	0.21	2.18	3	7	4
0022	3T	7_8	146	17	1	1700	930	-770	0.06	0.55	3	1	-2
0022	3T	7_8	152	1	0	100	0	-100	0.00	0.00	0	0	0
0022	3T	7_8	153	2	0	200	0	-200	0.00	0.00	0	0	0
0022	3T	7_8	156	5	1	500	530	30	0.20	1.06	0	0	0
0022	3T	7_8	164	2	0	200	0	-200	0.00	0.00	0	0	0
0022	3T	7_8	215	1	0	100	0	-100	0.00	0.00	0	0	0
0022	3T	7_8	234	2	0	200	0	-200	0.00	0.00	0	0	0
0022	3T	7_8	235	2	0	200	0	-200	0.00	0.00	0	0	0
0022	3T	7_8	236	1	0	100	0	-100	0.00	0.00	0	0	0
0022	3T	7_9	123	85	15	8500	9420	920	0.18	1.11	15	16	1
0022	3T	7_9	124	221	16	22100	12660	-9440	0.07	0.57	39	22	-17
0022	3T	7_9	125	114	8	11400	9670	-1730	0.07	0.85	20	17	-3
0022	3T	7_9	126	95	7	9500	8930	-570	0.07	0.94	16	15	-1
0022	3T	7_9	132	1	0	100	0	-100	0.00	0.00	0	0	0
0022	3T	7_9	134	93	14	9300	12540	3240	0.15	1.35	16	22	6
0022	3T	7_9	135	75	3	7500	2220	-5280	0.04	0.30	13	3	-10
0022	3T	7_9	136	56	2	5600	2570	-3030	0.04	0.46	9	4	-5
0022	3T	7_9	145	32	1	3200	1720	-1480	0.03	0.54	5	3	-2
0022	3T	7_9	146	20	0	2000	0	-2000	0.00	0.00	3	0	-3
0022	3T	7_9	152	1	0	100	0	-100	0.00	0.00	0	0	0
0022	3T	7_9	156	7	1	700	2970	2270	0.14	4.24	1	5	4
0022	3T	7_9	164	1	0	100	0	-100	0.00	0.00	0	0	0
0022	3T	7_9	215	2	0	200	0	-200	0.00	0.00	0	0	0
0022	3T	7_9	234	2	0	200	0	-200	0.00	0.00	0	0	0
0022	3T	7_9	236	1	0	100	0	-100	0.00	0.00	0	0	0
0022	3T	7_9	245	1	0	100	0	-100	0.00	0.00	0	0	0
0025	3T	19	125	178	10	17800	15780	-2020	0.06	0.89	31	27	-4
0025	3T	19	126	206	7	20600	10650	-9950	0.03	0.52	36	18	-18
0025	3T	19	132	5	0	500	0	-500	0.00	0.00	0	0	0
0025	3T	19	134	178	21	17800	16810	-990	0.12	0.94	31	29	-2
0025	3T	19	135	143	15	14300	9300	-5000	0.10	0.65	25	16	-9
0025	3T	19	136	154	11	15400	9230	-6170	0.07	0.60	27	16	-11
0025	3T	19	142	1	0	100	0	-100	0.00	0.00	0	0	0
0025	3T	19	143	4	1	400	950	550	0.25	2.38	0	1	1
0025	3T	19	145	63	6	6300	6710	410	0.10	1.07	11	11	0
0025	3T	19	146	27	1	2700	880	-1820	0.04	0.33	4	1	-3
0025	3T	19	153	1	0	100	0	-100	0.00	0.00	0	0	0
0025	3T	19	154	1	0	100	0	-100	0.00	0.00	0	0	0
0025	3T	19	156	5	0	500	0	-500	0.00	0.00	0	0	0
0025	3T	19	164	1	0	100	0	-100	0.00	0.00	0	0	0
0025	3T	19	215	1	0	100	0	-100	0.00	0.00	0	0	0
0025	3T	19	216	4	1	400	8510	8110	0.25	21.28	0	15	15
0025	3T	19	234	3	0	300	0	-300	0.00	0.00	0	0	0
0025	3T	19	235	6	1	600	880	280	0.17	1.47	1	1	0
0025	3T	19	236	2	0	200	0	-200	0.00	0.00	0	0	0
0025	3T	19	245	2	0	200	0	-200	0.00	0.00	0	0	0
0025	3T	19	246	4	0	400	0	-400	0.00	0.00	0	0	0
0025	3T	19	263	1	0	100	0	-100	0.00	0.00	0	0	0
0025	3T	20	123	358	52	35800	33830	-1970	0.15	0.94	63	59	-4
0025	3T	20	124	787	70	78700	50640	-28060	0.09	0.64	139	89	-50
0025	3T	20	125	240	18	24000	17050	-6950	0.08	0.71	42	30	-12
0025	3T	20	126	202	12	20200	19020	-1180	0.06	0.94	35	33	-2
0025	3T	20	132	3	1	300	380	80	0.33	1.27	0	0	0
0025	3T	20	134	220	23	22000	18250	-3750	0.10	0.83	38	32	-6
0025	3T	20	135	147	18	14700	19000	4300	0.12	1.29	26	33	7
0025	3T	20	136	142	11	14200	12240	-1960	0.08	0.86	25	21	-4
0025	3T	20	142	1	0	100	0	-100	0.00	0.00	0	0	0
0025	3T	20	143	2	0	200	0	-200	0.00	0.00	0	0	0
0025	3T	20	145	79	2	7900	1550	-6350	0.03	0.20	13	2	-11
0025	3T	20	146	60	5	6000	3830	-2170	0.08	0.64	10	6	-4
0025	3T	20	153	3	1	300	1420	1120	0.33	4.73	0	2	2
0025	3T	20	156	19	1	1900	1320	-580	0.05	0.69	3	2	-1
0025	3T	20	163	1	0	100	0	-100	0.00	0.00	0	0	0
0025	3T	20	164	1	0	100	0	-100	0.00	0.00	0	0	0
0025	3T	20	234	1	0	100	0	-100	0.00	0.00	0	0	0
0017	1T	1_-1	1	17	10	1700	1690	-10	0.59	0.99	3	2	-1
0017	1T	1_-1	2	3	2	300	260	-40	0.67	0.87	0	0	0
0017	1T	1_0	1	713	377	71300	66170	-5130	0.53	0.93	126	117	-9
0017	1T	1_0	2	6	3	600	1040	440	0.50	1.73	1	1	0
0017	1T	1_1	1	1302	887	130200	118370	-11830	0.68	0.91	230	209	-21
0017	1T	1_1	2	87	35	8700	8180	-520	0.40	0.94	15	14	-1
0017	1T	1_2	1	1540	882	154000	142590	-11410	0.57	0.93	272	252	-20
0017	1T	1_2	2	459	209	45900	44830	-1070	0.46	0.98	81	79	-2
0017	1T	1_3	1	2732	1472	273200	261730	-11470	0.54	0.96	483	463	-20
0017	1T	1_3	2	1175	421	117500	96040	-21460	0.36	0.82	207	169	-38
0017	1T	1_4	1	1948	1141	194800	170050	-24750	0.59	0.87	344	300	-44
0017	1T	1_4	2	320	98	32000	25700	-6300	0.31	0.80	56	45	-11
0017	1T	1_5	1	420	265	42000	37350	-4650	0.63	0.89	74	66	-8
0017	1T	1_5	2	16	7	1600	2030	430	0.44	1.27	2	3	1
0017	1T	1_6	1	1282	880	128200	118470	-9730	0.69	0.92	226	209	-17
0017	1T	1_6	2	2	0	200	0	-200	0.00	0.00	0	0	0
0017	1T	2_-1	1	22	12	2200	1690	-510	0.55	0.77	3	2	-1
0017	1T	2_-1	2	1	0	100	0	-100	0.00	0.00	0	0	0
0017	1T	2_0	1	568	283	56800	47440	-9360	0.50	0.84	100	83	-17
0017	1T	2_0	2	69	20	6900	6180	-720	0.29	0.90	12	10	-2
0017	1T	2_1	1	1392	898	139200	127630	-11570	0.65	0.92	246	225	-21
0017	1T	2_1	2	79	38	7900	9070	1170	0.48	1.15	13	16	3
0017	1T	2_2	1	1985	1013	198500	182690	-15810	0.51	0.92	351	323	-28
0017	1T	2_2	2	343	139	34300	29620	-4680	0.41	0.86	60	52	-8
0017	1T	2_3	1	3559	1725	355900	326420	-29480	0.48	0.92	629	577	-52
0017	1T	2_3	2	736	299	73600	68850	-4750	0.41	0.94	130	121	-9
0017	1T	2_4	1	2654	1448	265400	232520	-32880	0.55	0.88	469	411	-58
0017	1T	2_4	2	174	86	17400	19180	1780	0.49	1.10	30	33	3
0017	1T	2_5	1	710	461	71000	64690	-6310	0.65	0.91	125	114	-11
0017	1T	2_5	2	2	1	200	260	60	0.50	1.30	0	0	0
0017	1T	2_6	1	500	346	50000	45770	-4230	0.69	0.92	88	81	-7
0017	1T	3_-1	1	48	33	4800	6350	1550	0.69	1.32	8	11	3
0017	1T	3_-1	2	5	2	500	280	-220	0.40	0.56	0	0	0
0017	1T	3_0	1	574	296	57400	53660	-3740	0.52	0.93	101	94	-7
0017	1T	3_0	2	34	10	3400	3210	-190	0.29	0.94	6	5	-1
0017	1T	3_1	1	1316	875	131600	117660	-13940	0.66	0.89	232	208	-24
0017	1T	3_1	2	120	53	12000	14010	2010	0.44	1.17	21	24	3
0017	1T	3_2	1	1592	907	159200	149430	-9770	0.57	0.94	281	264	-17
0017	1T	3_2	2	475	183	47500	42230	-5270	0.39	0.89	84	74	-10
0017	1T	3_3	1	2813	1563	281300	283090	1790	0.56	1.01	497	501	4
0017	1T	3_3	2	1103	391	110300	102310	-7990	0.35	0.93	195	181	-14
0017	1T	3_4	1	2734	1584	273400	248820	-24580	0.58	0.91	483	440	-43
0017	1T	3_4	2	255	87	25500	21050	-4450	0.34	0.83	45	37	-8
0017	1T	3_5	1	811	573	81100	77410	-3690	0.71	0.95	143	137	-6
0017	1T	3_5	2	9	3	900	1070	170	0.33	1.19	1	1	0
0017	1T	3_6	1	292	195	29200	25040	-4160	0.67	0.86	51	44	-7
0017	1T	3_6	2	1	1	100	300	200	1.00	3.00	0	0	0
0017	1T	4_-1	1	24	10	2400	1750	-650	0.42	0.73	4	3	-1
0017	1T	4_0	1	413	209	41300	36470	-4830	0.51	0.88	73	64	-9
0017	1T	4_0	2	58	15	5800	4240	-1560	0.26	0.73	10	7	-3
0017	1T	4_1	1	1171	786	117100	107520	-9580	0.67	0.92	207	190	-17
0017	1T	4_1	2	104	38	10400	7690	-2710	0.37	0.74	18	13	-5
0017	1T	4_2	1	1617	932	161700	148940	-12760	0.58	0.92	286	263	-23
0017	1T	4_2	2	363	150	36300	30380	-5920	0.41	0.84	64	53	-11
0017	1T	4_3	1	2683	1464	268300	253150	-15150	0.55	0.94	474	448	-26
0017	1T	4_3	2	680	268	68000	70280	2280	0.39	1.03	120	124	4
0017	1T	4_4	1	2080	1284	208000	190820	-17180	0.62	0.92	368	337	-31
0017	1T	4_4	2	132	45	13200	11410	-1790	0.34	0.86	23	20	-3
0017	1T	4_5	1	811	558	81100	73400	-7700	0.69	0.91	143	129	-14
0017	1T	4_5	2	4	3	400	970	570	0.75	2.43	0	1	1
0017	1T	4_6	1	307	224	30700	29220	-1480	0.73	0.95	54	51	-3
0017	1T	5_-1	1	20	11	2000	1420	-580	0.55	0.71	3	2	-1
0017	1T	5_-1	2	2	1	200	110	-90	0.50	0.55	0	0	0
0017	1T	5_0	1	480	266	48000	47570	-430	0.55	0.99	84	84	0
0017	1T	5_0	2	30	10	3000	4150	1150	0.33	1.38	5	7	2
0017	1T	5_1	1	992	661	99200	91890	-7310	0.67	0.93	175	162	-13
0017	1T	5_1	2	32	14	3200	3590	390	0.44	1.12	5	6	1
0017	1T	5_2	1	1363	851	136300	131170	-5130	0.62	0.96	241	232	-9
0017	1T	5_2	2	118	51	11800	10480	-1320	0.43	0.89	20	18	-2
0017	1T	5_3	1	2258	1358	225800	207920	-17880	0.60	0.92	399	368	-31
0017	1T	5_3	2	190	53	19000	14590	-4410	0.28	0.77	33	25	-8
0017	1T	5_4	1	1491	966	149100	135290	-13810	0.65	0.91	263	239	-24
0017	1T	5_4	2	69	15	6900	4280	-2620	0.22	0.62	12	7	-5
0017	1T	5_5	1	898	625	89800	78860	-10940	0.70	0.88	158	139	-19
0017	1T	5_5	2	5	1	500	130	-370	0.20	0.26	0	0	0
0017	1T	5_6	1	296	212	29600	27530	-2070	0.72	0.93	52	48	-4
0017	1T	5_6	2	1	0	100	0	-100	0.00	0.00	0	0	0
0017	1T	6_0	1	42	25	4200	4900	700	0.60	1.17	7	8	1
0017	1T	6_0	2	5	2	500	660	160	0.40	1.32	0	1	1
0017	1T	6_1	1	72	44	7200	6050	-1150	0.61	0.84	12	10	-2
0017	1T	6_1	2	6	3	600	680	80	0.50	1.13	1	1	0
0017	1T	6_2	1	84	43	8400	6590	-1810	0.51	0.78	14	11	-3
0017	1T	6_2	2	9	5	900	1040	140	0.56	1.16	1	1	0
0017	1T	6_3	1	187	97	18700	15720	-2980	0.52	0.84	33	27	-6
0017	1T	6_3	2	6	1	600	110	-490	0.17	0.18	1	0	-1
0017	1T	6_4	1	147	94	14700	12830	-1870	0.64	0.87	26	22	-4
0017	1T	6_4	2	4	3	400	830	430	0.75	2.08	0	1	1
0017	1T	6_5	1	70	52	7000	6260	-740	0.74	0.89	12	11	-1
0017	1T	6_5	2	3	1	300	190	-110	0.33	0.63	0	0	0
0017	1T	6_6	1	30	23	3000	2980	-20	0.77	0.99	5	5	0
0017	1T	7_-1	1	22	11	2200	1680	-520	0.50	0.76	3	2	-1
0017	1T	7_0	1	961	497	96100	90040	-6060	0.52	0.94	170	159	-11
0017	1T	7_0	2	96	33	9600	10250	650	0.34	1.07	16	18	2
0017	1T	7_1	1	2225	1455	222500	203870	-18630	0.65	0.92	393	360	-33
0017	1T	7_1	2	144	49	14400	12620	-1780	0.34	0.88	25	22	-3
0017	1T	7_2	1	3027	1829	302700	276420	-26280	0.60	0.91	535	489	-46
0017	1T	7_2	2	329	121	32900	30330	-2570	0.37	0.92	58	53	-5
0017	1T	7_3	1	3196	1999	319600	302410	-17190	0.63	0.95	565	535	-30
0017	1T	7_3	2	199	63	19900	16800	-3100	0.32	0.84	35	29	-6
0017	1T	7_4	1	1511	940	151100	140940	-10160	0.62	0.93	267	249	-18
0017	1T	7_4	2	59	15	5900	4360	-1540	0.25	0.74	10	7	-3
0017	1T	7_5	1	1033	698	103300	93240	-10060	0.68	0.90	182	165	-17
0017	1T	7_5	2	9	2	900	390	-510	0.22	0.43	1	0	-1
0017	1T	7_6	1	725	497	72500	65090	-7410	0.69	0.90	128	115	-13
0017	1T	7_6	2	1	0	100	0	-100	0.00	0.00	0	0	0
0017	2F	1_-1	12	12	4	1200	930	-270	0.33	0.78	2	1	-1
0017	2F	1_-1	13	4	1	400	420	20	0.25	1.05	0	0	0
0017	2F	1_-1	15	1	0	100	0	-100	0.00	0.00	0	0	0
0017	2F	1_0	12	682	167	68200	55480	-12720	0.24	0.81	120	98	-22
0017	2F	1_0	13	20	3	2000	980	-1020	0.15	0.49	3	1	-2
0017	2F	1_0	15	11	0	1100	0	-1100	0.00	0.00	1	0	-1
0017	2F	1_1	12	733	216	73300	51660	-21640	0.29	0.70	129	91	-38
0017	2F	1_1	13	302	98	30200	27640	-2560	0.32	0.92	53	48	-5
0017	2F	1_1	14	143	31	14300	9790	-4510	0.22	0.68	25	17	-8
0017	2F	1_1	15	97	23	9700	9540	-160	0.24	0.98	17	16	-1
0017	2F	1_1	16	2	0	200	0	-200	0.00	0.00	0	0	0
0017	2F	1_1	23	14	1	1400	400	-1000	0.07	0.29	2	0	-2
0017	2F	1_2	12	694	245	69400	60190	-9210	0.35	0.87	122	106	-16
0017	2F	1_2	13	297	107	29700	24640	-5060	0.36	0.83	52	43	-9
0017	2F	1_2	14	432	130	43200	33090	-10110	0.30	0.77	76	58	-18
0017	2F	1_2	15	36	8	3600	1980	-1620	0.22	0.55	6	3	-3
0017	2F	1_2	16	58	13	5800	5190	-610	0.22	0.89	10	9	-1
0017	2F	1_2	23	24	6	2400	2480	80	0.25	1.03	4	4	0
0017	2F	1_2	24	85	21	8500	8040	-460	0.25	0.95	15	14	-1
0017	2F	1_2	25	1	0	100	0	-100	0.00	0.00	0	0	0
0017	2F	1_2	26	38	8	3800	4760	960	0.21	1.25	6	8	2
0017	2F	1_3	12	1264	412	126400	117920	-8480	0.33	0.93	223	208	-15
0017	2F	1_3	13	717	259	71700	58730	-12970	0.36	0.82	126	103	-23
0017	2F	1_3	14	440	116	44000	31800	-12200	0.26	0.72	77	56	-21
0017	2F	1_3	15	149	36	14900	12870	-2030	0.24	0.86	26	22	-4
0017	2F	1_3	16	317	49	31700	23090	-8610	0.15	0.73	56	40	-16
0017	2F	1_3	23	61	10	6100	3590	-2510	0.16	0.59	10	6	-4
0017	2F	1_3	24	83	8	8300	3470	-4830	0.10	0.42	14	6	-8
0017	2F	1_3	25	33	3	3300	1150	-2150	0.09	0.35	5	2	-3
0017	2F	1_3	26	114	15	11400	8460	-2940	0.13	0.74	20	14	-6
0017	2F	1_4	12	1107	335	110700	99310	-11390	0.30	0.90	195	175	-20
0017	2F	1_4	13	466	146	46600	38220	-8380	0.31	0.82	82	67	-15
0017	2F	1_4	14	258	56	25800	17640	-8160	0.22	0.68	45	31	-14
0017	2F	1_4	15	17	1	1700	280	-1420	0.06	0.16	3	0	-3
0017	2F	1_4	16	59	12	5900	9290	3390	0.20	1.57	10	16	6
0017	2F	1_4	23	3	2	300	1030	730	0.67	3.43	0	1	1
0017	2F	1_4	24	9	1	900	530	-370	0.11	0.59	1	0	-1
0017	2F	1_4	26	14	0	1400	0	-1400	0.00	0.00	2	0	-2
0017	2F	1_5	12	205	58	20500	15190	-5310	0.28	0.74	36	26	-10
0017	2F	1_5	13	93	20	9300	6100	-3200	0.22	0.66	16	10	-6
0017	2F	1_5	14	47	11	4700	3810	-890	0.23	0.81	8	6	-2
0017	2F	1_5	26	1	0	100	0	-100	0.00	0.00	0	0	0
0017	2F	1_6	12	725	204	72500	55010	-17490	0.28	0.76	128	97	-31
0017	2F	1_6	13	388	88	38800	29100	-9700	0.23	0.75	68	51	-17
0017	2F	1_6	14	9	6	900	2060	1160	0.67	2.29	1	3	2
0017	2F	2_-1	12	14	4	1400	1080	-320	0.29	0.77	2	1	-1
0017	2F	2_-1	13	2	2	200	330	130	1.00	1.65	0	0	0
0017	2F	2_-1	14	4	2	400	380	-20	0.50	0.95	0	0	0
0017	2F	2_-1	16	1	0	100	0	-100	0.00	0.00	0	0	0
0017	2F	2_0	12	191	70	19100	21080	1980	0.37	1.10	33	37	4
0017	2F	2_0	13	112	27	11200	7460	-3740	0.24	0.67	19	13	-6
0017	2F	2_0	14	32	7	3200	1710	-1490	0.22	0.53	5	3	-2
0017	2F	2_0	15	24	3	2400	930	-1470	0.13	0.39	4	1	-3
0017	2F	2_0	16	17	2	1700	1220	-480	0.12	0.72	3	2	-1
0017	2F	2_0	23	5	1	500	240	-260	0.20	0.48	0	0	0
0017	2F	2_0	24	2	1	200	290	90	0.50	1.45	0	0	0
0017	2F	2_0	25	3	1	300	780	480	0.33	2.60	0	1	1
0017	2F	2_0	26	1	0	100	0	-100	0.00	0.00	0	0	0
0017	2F	2_1	12	774	270	77400	70830	-6570	0.35	0.92	136	125	-11
0017	2F	2_1	13	275	89	27500	21150	-6350	0.32	0.77	48	37	-11
0017	2F	2_1	14	186	59	18600	14880	-3720	0.32	0.80	32	26	-6
0017	2F	2_1	15	62	19	6200	5530	-670	0.31	0.89	10	9	-1
0017	2F	2_1	16	54	11	5400	3760	-1640	0.20	0.70	9	6	-3
0017	2F	2_1	23	2	1	200	200	0	0.50	1.00	0	0	0
0017	2F	2_1	24	1	0	100	0	-100	0.00	0.00	0	0	0
0017	2F	2_1	25	1	0	100	0	-100	0.00	0.00	0	0	0
0017	2F	2_1	26	3	1	300	240	-60	0.33	0.80	0	0	0
0017	2F	2_2	12	889	311	88900	71970	-16930	0.35	0.81	157	127	-30
0017	2F	2_2	13	436	154	43600	36030	-7570	0.35	0.83	77	63	-14
0017	2F	2_2	14	405	144	40500	30880	-9620	0.36	0.76	71	54	-17
0017	2F	2_2	15	124	39	12400	11880	-520	0.31	0.96	21	21	0
0017	2F	2_2	16	118	21	11800	12970	1170	0.18	1.10	20	22	2
0017	2F	2_2	23	14	3	1400	870	-530	0.21	0.62	2	1	-1
0017	2F	2_2	24	12	4	1200	1380	180	0.33	1.15	2	2	0
0017	2F	2_2	25	7	1	700	240	-460	0.14	0.34	1	0	-1
0017	2F	2_2	26	25	2	2500	760	-1740	0.08	0.30	4	1	-3
0017	2F	2_3	12	1711	547	171100	146610	-24490	0.32	0.86	302	259	-43
0017	2F	2_3	13	995	326	99500	86270	-13230	0.33	0.87	176	152	-24
0017	2F	2_3	14	484	139	48400	36580	-11820	0.29	0.76	85	64	-21
0017	2F	2_3	15	164	40	16400	15750	-650	0.24	0.96	29	27	-2
0017	2F	2_3	16	180	35	18000	13410	-4590	0.19	0.75	31	23	-8
0017	2F	2_3	23	45	13	4500	3900	-600	0.29	0.87	7	6	-1
0017	2F	2_3	24	29	8	2900	2650	-250	0.28	0.91	5	4	-1
0017	2F	2_3	25	16	5	1600	1230	-370	0.31	0.77	2	2	0
0017	2F	2_3	26	65	7	6500	3820	-2680	0.11	0.59	11	6	-5
0017	2F	2_4	12	1559	475	155900	130940	-24960	0.30	0.84	275	231	-44
0017	2F	2_4	13	683	224	68300	55160	-13140	0.33	0.81	120	97	-23
0017	2F	2_4	14	280	88	28000	23830	-4170	0.31	0.85	49	42	-7
0017	2F	2_4	15	50	15	5000	4640	-360	0.30	0.93	8	8	0
0017	2F	2_4	16	46	7	4600	3160	-1440	0.15	0.69	8	5	-3
0017	2F	2_4	23	5	2	500	1050	550	0.40	2.10	0	1	1
0017	2F	2_4	24	5	0	500	0	-500	0.00	0.00	0	0	0
0017	2F	2_4	25	5	1	500	350	-150	0.20	0.70	0	0	0
0017	2F	2_4	26	10	2	1000	560	-440	0.20	0.56	1	0	-1
0017	2F	2_5	12	545	172	54500	45760	-8740	0.32	0.84	96	80	-16
0017	2F	2_5	13	115	35	11500	8190	-3310	0.30	0.71	20	14	-6
0017	2F	2_5	14	39	13	3900	4240	340	0.33	1.09	6	7	1
0017	2F	2_5	15	1	0	100	0	-100	0.00	0.00	0	0	0
0017	2F	2_6	12	432	114	43200	32410	-10790	0.26	0.75	76	57	-19
0017	2F	2_6	13	50	14	5000	3670	-1330	0.28	0.73	8	6	-2
0017	2F	2_6	14	9	4	900	1040	140	0.44	1.16	1	1	0
0017	2F	3_-1	12	21	5	2100	1350	-750	0.24	0.64	3	2	-1
0017	2F	3_-1	13	15	6	1500	1280	-220	0.40	0.85	2	2	0
0017	2F	3_-1	14	8	4	800	1020	220	0.50	1.28	1	1	0
0017	2F	3_-1	15	1	0	100	0	-100	0.00	0.00	0	0	0
0017	2F	3_-1	16	1	0	100	0	-100	0.00	0.00	0	0	0
0017	2F	3_-1	24	2	0	200	0	-200	0.00	0.00	0	0	0
0017	2F	3_0	12	294	92	29400	28280	-1120	0.31	0.96	52	50	-2
0017	2F	3_0	13	157	33	15700	11200	-4500	0.21	0.71	27	19	-8
0017	2F	3_0	14	51	16	5100	6830	1730	0.31	1.34	9	12	3
0017	2F	3_0	15	46	8	4600	4690	90	0.17	1.02	8	8	0
0017	2F	3_0	16	13	2	1300	1400	100	0.15	1.08	2	2	0
0017	2F	3_0	23	3	0	300	0	-300	0.00	0.00	0	0	0
0017	2F	3_0	24	2	0	200	0	-200	0.00	0.00	0	0	0
0017	2F	3_0	26	1	0	100	0	-100	0.00	0.00	0	0	0
0017	2F	3_1	12	772	253	77200	64570	-12630	0.33	0.84	136	114	-22
0017	2F	3_1	13	268	85	26800	20400	-6400	0.32	0.76	47	36	-11
0017	2F	3_1	14	148	32	14800	8570	-6230	0.22	0.58	26	15	-11
0017	2F	3_1	15	72	15	7200	5210	-1990	0.21	0.72	12	9	-3
0017	2F	3_1	16	53	13	5300	4800	-500	0.25	0.91	9	8	-1
0017	2F	3_1	23	1	1	100	310	210	1.00	3.10	0	0	0
0017	2F	3_1	24	9	0	900	0	-900	0.00	0.00	1	0	-1
0017	2F	3_1	25	3	0	300	0	-300	0.00	0.00	0	0	0
0017	2F	3_1	26	3	0	300	0	-300	0.00	0.00	0	0	0
0017	2F	3_2	12	680	257	68000	62540	-5460	0.38	0.92	120	110	-10
0017	2F	3_2	13	316	117	31600	25550	-6050	0.37	0.81	55	45	-10
0017	2F	3_2	14	379	108	37900	24340	-13560	0.28	0.64	67	43	-24
0017	2F	3_2	15	126	37	12600	10150	-2450	0.29	0.81	22	17	-5
0017	2F	3_2	16	86	19	8600	6550	-2050	0.22	0.76	15	11	-4
0017	2F	3_2	23	32	7	3200	2020	-1180	0.22	0.63	5	3	-2
0017	2F	3_2	24	25	4	2500	1570	-930	0.16	0.63	4	2	-2
0017	2F	3_2	25	18	1	1800	360	-1440	0.06	0.20	3	0	-3
0017	2F	3_2	26	30	6	3000	2040	-960	0.20	0.68	5	3	-2
0017	2F	3_3	12	1240	450	124000	113600	-10400	0.36	0.92	219	201	-18
0017	2F	3_3	13	754	276	75400	65860	-9540	0.37	0.87	133	116	-17
0017	2F	3_3	14	476	126	47600	34260	-13340	0.26	0.72	84	60	-24
0017	2F	3_3	15	213	44	21300	14190	-7110	0.21	0.67	37	25	-12
0017	2F	3_3	16	205	31	20500	14510	-5990	0.15	0.71	36	25	-11
0017	2F	3_3	23	78	15	7800	4960	-2840	0.19	0.64	13	8	-5
0017	2F	3_3	24	78	20	7800	11410	3610	0.26	1.46	13	20	7
0017	2F	3_3	25	69	10	6900	3810	-3090	0.14	0.55	12	6	-6
0017	2F	3_3	26	108	18	10800	8900	-1900	0.17	0.82	19	15	-4
0017	2F	3_4	12	1410	475	141000	122900	-18100	0.34	0.87	249	217	-32
0017	2F	3_4	13	809	229	80900	61110	-19790	0.28	0.76	143	108	-35
0017	2F	3_4	14	286	72	28600	20080	-8520	0.25	0.70	50	35	-15
0017	2F	3_4	15	69	16	6900	5000	-1900	0.23	0.72	12	8	-4
0017	2F	3_4	16	48	11	4800	7250	2450	0.23	1.51	8	12	4
0017	2F	3_4	23	30	5	3000	2400	-600	0.17	0.80	5	4	-1
0017	2F	3_4	24	23	3	2300	1710	-590	0.13	0.74	4	3	-1
0017	2F	3_4	25	9	0	900	0	-900	0.00	0.00	1	0	-1
0017	2F	3_4	26	9	1	900	460	-440	0.11	0.51	1	0	-1
0017	2F	3_5	12	482	142	48200	35290	-12910	0.29	0.73	85	62	-23
0017	2F	3_5	13	236	69	23600	16790	-6810	0.29	0.71	41	29	-12
0017	2F	3_5	14	48	19	4800	6360	1560	0.40	1.33	8	11	3
0017	2F	3_5	15	6	1	600	520	-80	0.17	0.87	1	0	-1
0017	2F	3_5	16	2	0	200	0	-200	0.00	0.00	0	0	0
0017	2F	3_5	24	1	0	100	0	-100	0.00	0.00	0	0	0
0017	2F	3_6	12	197	65	19700	18060	-1640	0.33	0.92	34	31	-3
0017	2F	3_6	13	68	21	6800	5420	-1380	0.31	0.80	12	9	-3
0017	2F	3_6	14	5	1	500	310	-190	0.20	0.62	0	0	0
0017	2F	4_0	12	155	42	15500	13270	-2230	0.27	0.86	27	23	-4
0017	2F	4_0	13	82	25	8200	9170	970	0.30	1.12	14	16	2
0017	2F	4_0	14	42	8	4200	3100	-1100	0.19	0.74	7	5	-2
0017	2F	4_0	15	22	3	2200	1290	-910	0.14	0.59	3	2	-1
0017	2F	4_0	16	9	1	900	230	-670	0.11	0.26	1	0	-1
0017	2F	4_0	23	9	0	900	0	-900	0.00	0.00	1	0	-1
0017	2F	4_0	24	2	1	200	840	640	0.50	4.20	0	1	1
0017	2F	4_0	25	2	1	200	770	570	0.50	3.85	0	1	1
0017	2F	4_0	26	2	0	200	0	-200	0.00	0.00	0	0	0
0017	2F	4_1	12	655	212	65500	51640	-13860	0.32	0.79	115	91	-24
0017	2F	4_1	13	288	84	28800	20200	-8600	0.29	0.70	50	35	-15
0017	2F	4_1	14	132	40	13200	12330	-870	0.30	0.93	23	21	-2
0017	2F	4_1	15	47	11	4700	3390	-1310	0.23	0.72	8	6	-2
0017	2F	4_1	16	22	5	2200	2360	160	0.23	1.07	3	4	1
0017	2F	4_1	23	5	0	500	0	-500	0.00	0.00	0	0	0
0017	2F	4_1	24	4	1	400	520	120	0.25	1.30	0	0	0
0017	2F	4_1	25	5	1	500	1510	1010	0.20	3.02	0	2	2
0017	2F	4_1	26	3	0	300	0	-300	0.00	0.00	0	0	0
0017	2F	4_2	12	736	276	73600	67810	-5790	0.38	0.92	130	120	-10
0017	2F	4_2	13	390	127	39000	27740	-11260	0.33	0.71	69	49	-20
0017	2F	4_2	14	330	120	33000	24970	-8030	0.36	0.76	58	44	-14
0017	2F	4_2	15	117	36	11700	13490	1790	0.31	1.15	20	23	3
0017	2F	4_2	16	37	9	3700	5040	1340	0.24	1.36	6	8	2
0017	2F	4_2	23	29	6	2900	1600	-1300	0.21	0.55	5	2	-3
0017	2F	4_2	24	15	3	1500	890	-610	0.20	0.59	2	1	-1
0017	2F	4_2	25	18	1	1800	330	-1470	0.06	0.18	3	0	-3
0017	2F	4_2	26	14	4	1400	1460	60	0.29	1.04	2	2	0
0017	2F	4_3	12	1273	438	127300	106090	-21210	0.34	0.83	225	187	-38
0017	2F	4_3	13	796	297	79600	70710	-8890	0.37	0.89	140	125	-15
0017	2F	4_3	14	395	127	39500	35710	-3790	0.32	0.90	69	63	-6
0017	2F	4_3	15	140	38	14000	15450	1450	0.27	1.10	24	27	3
0017	2F	4_3	16	58	11	5800	4200	-1600	0.19	0.72	10	7	-3
0017	2F	4_3	23	85	26	8500	6990	-1510	0.31	0.82	15	12	-3
0017	2F	4_3	24	46	13	4600	4620	20	0.28	1.00	8	8	0
0017	2F	4_3	25	41	10	4100	4010	-90	0.24	0.98	7	7	0
0017	2F	4_3	26	24	1	2400	560	-1840	0.04	0.23	4	0	-4
0017	2F	4_4	12	1289	441	128900	107840	-21060	0.34	0.84	228	190	-38
0017	2F	4_4	13	494	176	49400	45750	-3650	0.36	0.93	87	80	-7
0017	2F	4_4	14	210	66	21000	19190	-1810	0.31	0.91	37	33	-4
0017	2F	4_4	15	42	6	4200	2820	-1380	0.14	0.67	7	4	-3
0017	2F	4_4	16	15	1	1500	790	-710	0.07	0.53	2	1	-1
0017	2F	4_4	23	13	2	1300	620	-680	0.15	0.48	2	1	-1
0017	2F	4_4	24	14	3	1400	1460	60	0.21	1.04	2	2	0
0017	2F	4_4	25	5	1	500	390	-110	0.20	0.78	0	0	0
0017	2F	4_4	26	5	1	500	530	30	0.20	1.06	0	0	0
0017	2F	4_5	12	627	208	62700	50980	-11720	0.33	0.81	110	90	-20
0017	2F	4_5	13	137	41	13700	11090	-2610	0.30	0.81	24	19	-5
0017	2F	4_5	14	32	6	3200	1440	-1760	0.19	0.45	5	2	-3
0017	2F	4_5	15	1	0	100	0	-100	0.00	0.00	0	0	0
0017	2F	4_5	23	1	0	100	0	-100	0.00	0.00	0	0	0
0017	2F	4_6	12	271	90	27100	22160	-4940	0.33	0.82	47	39	-8
0017	2F	4_6	13	27	5	2700	1300	-1400	0.19	0.48	4	2	-2
0017	2F	4_6	14	6	2	600	1110	510	0.33	1.85	1	1	0
0017	2F	5_-1	12	9	4	900	1010	110	0.44	1.12	1	1	0
0017	2F	5_-1	13	5	3	500	570	70	0.60	1.14	0	1	1
0017	2F	5_-1	14	4	2	400	570	170	0.50	1.43	0	1	1
0017	2F	5_-1	15	2	0	200	0	-200	0.00	0.00	0	0	0
0017	2F	5_0	12	276	88	27600	23980	-3620	0.32	0.87	48	42	-6
0017	2F	5_0	13	115	28	11500	9130	-2370	0.24	0.79	20	16	-4
0017	2F	5_0	14	45	12	4500	3710	-790	0.27	0.82	7	6	-1
0017	2F	5_0	15	25	3	2500	1190	-1310	0.12	0.48	4	2	-2
0017	2F	5_0	16	4	0	400	0	-400	0.00	0.00	0	0	0
0017	2F	5_0	23	3	0	300	0	-300	0.00	0.00	0	0	0
0017	2F	5_0	25	1	0	100	0	-100	0.00	0.00	0	0	0
0017	2F	5_1	12	605	213	60500	53450	-7050	0.35	0.88	107	94	-13
0017	2F	5_1	13	200	60	20000	14500	-5500	0.30	0.73	35	25	-10
0017	2F	5_1	14	123	38	12300	9500	-2800	0.31	0.77	21	16	-5
0017	2F	5_1	15	25	3	2500	1480	-1020	0.12	0.59	4	2	-2
0017	2F	5_1	16	27	6	2700	2570	-130	0.22	0.95	4	4	0
0017	2F	5_1	23	3	0	300	0	-300	0.00	0.00	0	0	0
0017	2F	5_1	25	2	0	200	0	-200	0.00	0.00	0	0	0
0017	2F	5_1	26	1	0	100	0	-100	0.00	0.00	0	0	0
0017	2F	5_2	12	568	217	56800	54410	-2390	0.38	0.96	100	96	-4
0017	2F	5_2	13	343	115	34300	27900	-6400	0.34	0.81	60	49	-11
0017	2F	5_2	14	329	113	32900	26510	-6390	0.34	0.81	58	46	-12
0017	2F	5_2	15	66	14	6600	3830	-2770	0.21	0.58	11	6	-5
0017	2F	5_2	16	48	15	4800	3940	-860	0.31	0.82	8	6	-2
0017	2F	5_2	23	11	1	1100	300	-800	0.09	0.27	1	0	-1
0017	2F	5_2	24	11	2	1100	420	-680	0.18	0.38	1	0	-1
0017	2F	5_2	25	2	0	200	0	-200	0.00	0.00	0	0	0
0017	2F	5_2	26	2	0	200	0	-200	0.00	0.00	0	0	0
0017	2F	5_3	12	1010	367	101000	89530	-11470	0.36	0.89	178	158	-20
0017	2F	5_3	13	596	208	59600	50810	-8790	0.35	0.85	105	89	-16
0017	2F	5_3	14	413	124	41300	29850	-11450	0.30	0.72	73	52	-21
0017	2F	5_3	15	135	32	13500	10230	-3270	0.24	0.76	23	18	-5
0017	2F	5_3	16	67	12	6700	4970	-1730	0.18	0.74	11	8	-3
0017	2F	5_3	23	22	4	2200	1630	-570	0.18	0.74	3	2	-1
0017	2F	5_3	24	13	2	1300	910	-390	0.15	0.70	2	1	-1
0017	2F	5_3	25	7	1	700	460	-240	0.14	0.66	1	0	-1
0017	2F	5_3	26	14	0	1400	0	-1400	0.00	0.00	2	0	-2
0017	2F	5_4	12	931	336	93100	71940	-21160	0.36	0.77	164	127	-37
0017	2F	5_4	13	323	95	32300	25250	-7050	0.29	0.78	57	44	-13
0017	2F	5_4	14	137	42	13700	12700	-1000	0.31	0.93	24	22	-2
0017	2F	5_4	15	29	5	2900	2370	-530	0.17	0.82	5	4	-1
0017	2F	5_4	16	14	3	1400	1610	210	0.21	1.15	2	2	0
0017	2F	5_4	23	11	2	1100	1710	610	0.18	1.55	1	3	2
0017	2F	5_4	24	3	1	300	240	-60	0.33	0.80	0	0	0
0017	2F	5_4	25	2	0	200	0	-200	0.00	0.00	0	0	0
0017	2F	5_4	26	6	0	600	0	-600	0.00	0.00	1	0	-1
0017	2F	5_5	12	739	274	73900	57110	-16790	0.37	0.77	130	101	-29
0017	2F	5_5	13	94	19	9400	4920	-4480	0.20	0.52	16	8	-8
0017	2F	5_5	14	19	5	1900	2050	150	0.26	1.08	3	3	0
0017	2F	5_5	16	1	1	100	1170	1070	1.00	11.70	0	2	2
0017	2F	5_6	12	261	95	26100	20400	-5700	0.36	0.78	46	36	-10
0017	2F	5_6	13	21	4	2100	1160	-940	0.19	0.55	3	2	-1
0017	2F	6_0	12	13	2	1300	440	-860	0.15	0.34	2	0	-2
0017	2F	6_0	13	14	5	1400	1250	-150	0.36	0.89	2	2	0
0017	2F	6_0	14	5	1	500	310	-190	0.20	0.62	0	0	0
0017	2F	6_0	15	3	1	300	1100	800	0.33	3.67	0	1	1
0017	2F	6_0	23	2	0	200	0	-200	0.00	0.00	0	0	0
0017	2F	6_0	25	1	0	100	0	-100	0.00	0.00	0	0	0
0017	2F	6_1	12	37	16	3700	3970	270	0.43	1.07	6	7	1
0017	2F	6_1	13	14	4	1400	1020	-380	0.29	0.73	2	1	-1
0017	2F	6_1	14	14	3	1400	640	-760	0.21	0.46	2	1	-1
0017	2F	6_1	15	2	1	200	230	30	0.50	1.15	0	0	0
0017	2F	6_1	16	2	1	200	400	200	0.50	2.00	0	0	0
0017	2F	6_1	25	1	0	100	0	-100	0.00	0.00	0	0	0
0017	2F	6_1	26	1	0	100	0	-100	0.00	0.00	0	0	0
0017	2F	6_2	12	32	11	3200	2300	-900	0.34	0.72	5	4	-1
0017	2F	6_2	13	20	6	2000	1170	-830	0.30	0.59	3	2	-1
0017	2F	6_2	14	24	4	2400	810	-1590	0.17	0.34	4	1	-3
0017	2F	6_2	15	3	0	300	0	-300	0.00	0.00	0	0	0
0017	2F	6_2	16	4	0	400	0	-400	0.00	0.00	0	0	0
0017	2F	6_2	25	1	0	100	0	-100	0.00	0.00	0	0	0
0017	2F	6_3	12	85	27	8500	8370	-130	0.32	0.98	15	14	-1
0017	2F	6_3	13	51	18	5100	4100	-1000	0.35	0.80	9	7	-2
0017	2F	6_3	14	31	8	3100	2020	-1080	0.26	0.65	5	3	-2
0017	2F	6_3	15	10	3	1000	840	-160	0.30	0.84	1	1	0
0017	2F	6_3	16	9	4	900	1710	810	0.44	1.90	1	3	2
0017	2F	6_3	23	1	0	100	0	-100	0.00	0.00	0	0	0
0017	2F	6_4	12	85	23	8500	5280	-3220	0.27	0.62	15	9	-6
0017	2F	6_4	13	35	10	3500	2480	-1020	0.29	0.71	6	4	-2
0017	2F	6_4	14	17	5	1700	2080	380	0.29	1.22	3	3	0
0017	2F	6_4	15	5	1	500	350	-150	0.20	0.70	0	0	0
0017	2F	6_4	16	4	1	400	600	200	0.25	1.50	0	1	1
0017	2F	6_4	23	2	0	200	0	-200	0.00	0.00	0	0	0
0017	2F	6_5	12	64	28	6400	5590	-810	0.44	0.87	11	9	-2
0017	2F	6_5	13	6	0	600	0	-600	0.00	0.00	1	0	-1
0017	2F	6_5	14	1	1	100	330	230	1.00	3.30	0	0	0
0017	2F	6_6	12	26	14	2600	2820	220	0.54	1.08	4	4	0
0017	2F	6_6	13	2	0	200	0	-200	0.00	0.00	0	0	0
0017	2F	6_6	14	1	0	100	0	-100	0.00	0.00	0	0	0
0017	2F	7_-1	12	16	7	1600	1510	-90	0.44	0.94	2	2	0
0017	2F	7_-1	13	3	0	300	0	-300	0.00	0.00	0	0	0
0017	2F	7_-1	14	1	0	100	0	-100	0.00	0.00	0	0	0
0017	2F	7_-1	15	1	0	100	0	-100	0.00	0.00	0	0	0
0017	2F	7_-1	16	1	0	100	0	-100	0.00	0.00	0	0	0
0017	2F	7_0	12	601	163	60100	47200	-12900	0.27	0.79	106	83	-23
0017	2F	7_0	13	208	49	20800	16390	-4410	0.24	0.79	36	29	-7
0017	2F	7_0	14	78	16	7800	6180	-1620	0.21	0.79	13	10	-3
0017	2F	7_0	15	21	5	2100	3100	1000	0.24	1.48	3	5	2
0017	2F	7_0	16	18	3	1800	2180	380	0.17	1.21	3	3	0
0017	2F	7_0	23	17	3	1700	1140	-560	0.18	0.67	3	2	-1
0017	2F	7_0	25	1	0	100	0	-100	0.00	0.00	0	0	0
0017	2F	7_0	26	1	0	100	0	-100	0.00	0.00	0	0	0
0017	2F	7_1	12	1365	473	136500	120250	-16250	0.35	0.88	241	212	-29
0017	2F	7_1	13	452	155	45200	43120	-2080	0.34	0.95	80	76	-4
0017	2F	7_1	14	270	76	27000	24790	-2210	0.28	0.92	47	43	-4
0017	2F	7_1	15	63	14	6300	5940	-360	0.22	0.94	11	10	-1
0017	2F	7_1	16	47	8	4700	3470	-1230	0.17	0.74	8	6	-2
0017	2F	7_1	23	13	2	1300	650	-650	0.15	0.50	2	1	-1
0017	2F	7_1	24	6	1	600	360	-240	0.17	0.60	1	0	-1
0017	2F	7_1	25	2	0	200	0	-200	0.00	0.00	0	0	0
0017	2F	7_1	26	5	0	500	0	-500	0.00	0.00	0	0	0
0017	2F	7_2	12	1529	567	152900	141520	-11380	0.37	0.93	270	250	-20
0017	2F	7_2	13	731	228	73100	57940	-15160	0.31	0.79	129	102	-27
0017	2F	7_2	14	524	169	52400	40660	-11740	0.32	0.78	92	71	-21
0017	2F	7_2	15	130	27	13000	9020	-3980	0.21	0.69	23	15	-8
0017	2F	7_2	16	98	28	9800	9440	-360	0.29	0.96	17	16	-1
0017	2F	7_2	23	34	9	3400	2570	-830	0.26	0.76	6	4	-2
0017	2F	7_2	24	19	4	1900	1230	-670	0.21	0.65	3	2	-1
0017	2F	7_2	25	7	0	700	0	-700	0.00	0.00	1	0	-1
0017	2F	7_2	26	18	4	1800	3840	2040	0.22	2.13	3	6	3
0017	2F	7_3	12	1738	581	173800	148950	-24850	0.33	0.86	307	263	-44
0017	2F	7_3	13	842	255	84200	61280	-22920	0.30	0.73	149	108	-41
0017	2F	7_3	14	420	103	42000	27420	-14580	0.25	0.65	74	48	-26
0017	2F	7_3	15	100	25	10000	11490	1490	0.25	1.15	17	20	3
0017	2F	7_3	16	78	14	7800	6580	-1220	0.18	0.84	13	11	-2
0017	2F	7_3	23	28	12	2800	5080	2280	0.43	1.81	4	8	4
0017	2F	7_3	24	10	2	1000	1150	150	0.20	1.15	1	2	1
0017	2F	7_3	25	6	0	600	0	-600	0.00	0.00	1	0	-1
0017	2F	7_3	26	13	3	1300	2330	1030	0.23	1.79	2	4	2
0017	2F	7_4	12	1022	371	102200	91190	-11010	0.36	0.89	180	161	-19
0017	2F	7_4	13	323	100	32300	26590	-5710	0.31	0.82	57	47	-10
0017	2F	7_4	14	105	14	10500	4060	-6440	0.13	0.39	18	7	-11
0017	2F	7_4	15	20	4	2000	1350	-650	0.20	0.68	3	2	-1
0017	2F	7_4	16	15	3	1500	2390	890	0.20	1.59	2	4	2
0017	2F	7_4	23	5	0	500	0	-500	0.00	0.00	0	0	0
0017	2F	7_4	24	5	1	500	520	20	0.20	1.04	0	0	0
0017	2F	7_4	26	2	0	200	0	-200	0.00	0.00	0	0	0
0017	2F	7_5	12	862	275	86200	63150	-23050	0.32	0.73	152	111	-41
0017	2F	7_5	13	102	25	10200	7830	-2370	0.25	0.77	18	13	-5
0017	2F	7_5	14	27	7	2700	2190	-510	0.26	0.81	4	3	-1
0017	2F	7_5	15	2	0	200	0	-200	0.00	0.00	0	0	0
0017	2F	7_5	16	1	0	100	0	-100	0.00	0.00	0	0	0
0017	2F	7_5	23	1	0	100	0	-100	0.00	0.00	0	0	0
0017	2F	7_6	12	673	208	67300	50340	-16960	0.31	0.75	119	89	-30
0017	2F	7_6	13	29	7	2900	2750	-150	0.24	0.95	5	4	-1
0017	2F	7_6	14	5	0	500	0	-500	0.00	0.00	0	0	0
0017	2T	1_-1	12	12	4	1200	1200	0	0.33	1.00	2	2	0
0017	2T	1_-1	13	4	1	400	360	-40	0.25	0.90	0	0	0
0017	2T	1_-1	15	1	0	100	0	-100	0.00	0.00	0	0	0
0017	2T	1_0	12	682	126	68200	55810	-12390	0.18	0.82	120	98	-22
0017	2T	1_0	13	20	2	2000	760	-1240	0.10	0.38	3	1	-2
0017	2T	1_0	15	11	0	1100	0	-1100	0.00	0.00	1	0	-1
0017	2T	1_1	12	729	184	72900	51190	-21710	0.25	0.70	129	90	-39
0017	2T	1_1	13	302	70	30200	23160	-7040	0.23	0.77	53	40	-13
0017	2T	1_1	14	143	24	14300	8450	-5850	0.17	0.59	25	14	-11
0017	2T	1_1	15	97	17	9700	8650	-1050	0.18	0.89	17	15	-2
0017	2T	1_1	16	2	0	200	0	-200	0.00	0.00	0	0	0
0017	2T	1_1	21	4	1	400	740	340	0.25	1.85	0	1	1
0017	2T	1_1	23	14	0	1400	0	-1400	0.00	0.00	2	0	-2
0017	2T	1_2	12	610	153	61000	47370	-13630	0.25	0.78	107	83	-24
0017	2T	1_2	13	297	72	29700	21690	-8010	0.24	0.73	52	38	-14
0017	2T	1_2	14	432	98	43200	34190	-9010	0.23	0.79	76	60	-16
0017	2T	1_2	15	36	4	3600	1420	-2180	0.11	0.39	6	2	-4
0017	2T	1_2	16	58	11	5800	7600	1800	0.19	1.31	10	13	3
0017	2T	1_2	21	84	19	8400	18900	10500	0.23	2.25	14	33	19
0017	2T	1_2	23	24	3	2400	830	-1570	0.13	0.35	4	1	-3
0017	2T	1_2	24	85	14	8500	8670	170	0.16	1.02	15	15	0
0017	2T	1_2	25	1	0	100	0	-100	0.00	0.00	0	0	0
0017	2T	1_2	26	38	5	3800	6230	2430	0.13	1.64	6	11	5
0017	2T	1_3	12	942	222	94200	78830	-15370	0.24	0.84	166	139	-27
0017	2T	1_3	13	717	163	71700	51770	-19930	0.23	0.72	126	91	-35
0017	2T	1_3	14	440	91	44000	33570	-10430	0.21	0.76	77	59	-18
0017	2T	1_3	15	149	26	14900	12070	-2830	0.17	0.81	26	21	-5
0017	2T	1_3	16	317	30	31700	22230	-9470	0.09	0.70	56	39	-17
0017	2T	1_3	21	322	55	32200	36130	3930	0.17	1.12	56	63	7
0017	2T	1_3	23	61	6	6100	2900	-3200	0.10	0.48	10	5	-5
0017	2T	1_3	24	83	3	8300	1390	-6910	0.04	0.17	14	2	-12
0017	2T	1_3	25	33	1	3300	420	-2880	0.03	0.13	5	0	-5
0017	2T	1_3	26	114	10	11400	9040	-2360	0.09	0.79	20	16	-4
0017	2T	1_4	12	950	232	95000	82920	-12080	0.24	0.87	168	146	-22
0017	2T	1_4	13	466	111	46600	37600	-9000	0.24	0.81	82	66	-16
0017	2T	1_4	14	258	45	25800	19060	-6740	0.17	0.74	45	33	-12
0017	2T	1_4	15	17	1	1700	370	-1330	0.06	0.22	3	0	-3
0017	2T	1_4	16	59	6	5900	5140	-760	0.10	0.87	10	9	-1
0017	2T	1_4	21	157	16	15700	14770	-930	0.10	0.94	27	26	-1
0017	2T	1_4	23	3	1	300	1120	820	0.33	3.73	0	1	1
0017	2T	1_4	24	9	0	900	0	-900	0.00	0.00	1	0	-1
0017	2T	1_4	26	14	0	1400	0	-1400	0.00	0.00	2	0	-2
0017	2T	1_5	12	195	46	19500	14740	-4760	0.24	0.76	34	26	-8
0017	2T	1_5	13	93	14	9300	5580	-3720	0.15	0.60	16	9	-7
0017	2T	1_5	14	47	9	4700	3840	-860	0.19	0.82	8	6	-2
0017	2T	1_5	21	10	2	1000	1390	390	0.20	1.39	1	2	1
0017	2T	1_5	26	1	0	100	0	-100	0.00	0.00	0	0	0
0017	2T	1_6	12	723	175	72300	57260	-15040	0.24	0.79	127	101	-26
0017	2T	1_6	13	388	59	38800	22510	-16290	0.15	0.58	68	39	-29
0017	2T	1_6	14	9	6	900	2510	1610	0.67	2.79	1	4	3
0017	2T	1_6	21	2	0	200	0	-200	0.00	0.00	0	0	0
0017	2T	2_-1	12	14	3	1400	1070	-330	0.21	0.76	2	1	-1
0017	2T	2_-1	13	2	1	200	280	80	0.50	1.40	0	0	0
0017	2T	2_-1	14	4	2	400	720	320	0.50	1.80	0	1	1
0017	2T	2_-1	16	1	0	100	0	-100	0.00	0.00	0	0	0
0017	2T	2_0	12	188	49	18800	18420	-380	0.26	0.98	33	32	-1
0017	2T	2_0	13	112	14	11200	5520	-5680	0.13	0.49	19	9	-10
0017	2T	2_0	14	32	3	3200	1050	-2150	0.09	0.33	5	1	-4
0017	2T	2_0	15	24	2	2400	950	-1450	0.08	0.40	4	1	-3
0017	2T	2_0	16	17	1	1700	630	-1070	0.06	0.37	3	1	-2
0017	2T	2_0	21	3	1	300	900	600	0.33	3.00	0	1	1
0017	2T	2_0	23	5	1	500	430	-70	0.20	0.86	0	0	0
0017	2T	2_0	24	2	0	200	0	-200	0.00	0.00	0	0	0
0017	2T	2_0	25	3	0	300	0	-300	0.00	0.00	0	0	0
0017	2T	2_0	26	1	0	100	0	-100	0.00	0.00	0	0	0
0017	2T	2_1	12	774	220	77400	67430	-9970	0.28	0.87	136	119	-17
0017	2T	2_1	13	275	61	27500	16780	-10720	0.22	0.61	48	29	-19
0017	2T	2_1	14	186	44	18600	16290	-2310	0.24	0.88	32	28	-4
0017	2T	2_1	15	62	7	6200	2320	-3880	0.11	0.37	10	4	-6
0017	2T	2_1	16	54	7	5400	3780	-1620	0.13	0.70	9	6	-3
0017	2T	2_1	23	2	0	200	0	-200	0.00	0.00	0	0	0
0017	2T	2_1	24	1	0	100	0	-100	0.00	0.00	0	0	0
0017	2T	2_1	25	1	0	100	0	-100	0.00	0.00	0	0	0
0017	2T	2_1	26	3	1	300	630	330	0.33	2.10	0	1	1
0017	2T	2_2	12	888	197	88800	63950	-24850	0.22	0.72	157	113	-44
0017	2T	2_2	13	436	118	43600	41550	-2050	0.27	0.95	77	73	-4
0017	2T	2_2	14	405	101	40500	32580	-7920	0.25	0.80	71	57	-14
0017	2T	2_2	15	124	29	12400	13570	1170	0.23	1.09	21	24	3
0017	2T	2_2	16	118	15	11800	12440	640	0.13	1.05	20	22	2
0017	2T	2_2	21	1	0	100	0	-100	0.00	0.00	0	0	0
0017	2T	2_2	23	14	2	1400	940	-460	0.14	0.67	2	1	-1
0017	2T	2_2	24	12	2	1200	910	-290	0.17	0.76	2	1	-1
0017	2T	2_2	25	7	1	700	370	-330	0.14	0.53	1	0	-1
0017	2T	2_2	26	25	1	2500	540	-1960	0.04	0.22	4	0	-4
0017	2T	2_3	12	1700	352	170000	131580	-38420	0.21	0.77	300	232	-68
0017	2T	2_3	13	995	237	99500	91780	-7720	0.24	0.92	176	162	-14
0017	2T	2_3	14	484	94	48400	34070	-14330	0.19	0.70	85	60	-25
0017	2T	2_3	15	164	23	16400	12730	-3670	0.14	0.78	29	22	-7
0017	2T	2_3	16	180	27	18000	13990	-4010	0.15	0.78	31	24	-7
0017	2T	2_3	21	11	0	1100	0	-1100	0.00	0.00	1	0	-1
0017	2T	2_3	23	45	8	4500	2770	-1730	0.18	0.62	7	4	-3
0017	2T	2_3	24	29	5	2900	3060	160	0.17	1.06	5	5	0
0017	2T	2_3	25	16	2	1600	610	-990	0.13	0.38	2	1	-1
0017	2T	2_3	26	65	4	6500	3450	-3050	0.06	0.53	11	6	-5
0017	2T	2_4	12	1546	346	154600	125080	-29520	0.22	0.81	273	221	-52
0017	2T	2_4	13	683	148	68300	50200	-18100	0.22	0.73	120	88	-32
0017	2T	2_4	14	280	62	28000	23010	-4990	0.22	0.82	49	40	-9
0017	2T	2_4	15	50	14	5000	6370	1370	0.28	1.27	8	11	3
0017	2T	2_4	16	46	5	4600	3650	-950	0.11	0.79	8	6	-2
0017	2T	2_4	21	13	3	1300	2570	1270	0.23	1.98	2	4	2
0017	2T	2_4	23	5	2	500	1710	1210	0.40	3.42	0	3	3
0017	2T	2_4	24	5	0	500	0	-500	0.00	0.00	0	0	0
0017	2T	2_4	25	5	1	500	640	140	0.20	1.28	0	1	1
0017	2T	2_4	26	10	2	1000	890	-110	0.20	0.89	1	1	0
0017	2T	2_5	12	545	140	54500	45500	-9000	0.26	0.83	96	80	-16
0017	2T	2_5	13	115	28	11500	8320	-3180	0.24	0.72	20	14	-6
0017	2T	2_5	14	39	12	3900	4520	620	0.31	1.16	6	8	2
0017	2T	2_5	15	1	0	100	0	-100	0.00	0.00	0	0	0
0017	2T	2_6	12	432	96	43200	31600	-11600	0.22	0.73	76	55	-21
0017	2T	2_6	13	50	11	5000	3610	-1390	0.22	0.72	8	6	-2
0017	2T	2_6	14	9	4	900	1350	450	0.44	1.50	1	2	1
0017	2T	3_-1	12	21	3	2100	900	-1200	0.14	0.43	3	1	-2
0017	2T	3_-1	13	15	5	1500	1530	30	0.33	1.02	2	2	0
0017	2T	3_-1	14	8	4	800	1800	1000	0.50	2.25	1	3	2
0017	2T	3_-1	15	1	0	100	0	-100	0.00	0.00	0	0	0
0017	2T	3_-1	16	1	0	100	0	-100	0.00	0.00	0	0	0
0017	2T	3_-1	24	2	0	200	0	-200	0.00	0.00	0	0	0
0017	2T	3_0	12	293	66	29300	28250	-1050	0.23	0.96	51	50	-1
0017	2T	3_0	13	157	23	15700	10560	-5140	0.15	0.67	27	18	-9
0017	2T	3_0	14	51	11	5100	6080	980	0.22	1.19	9	10	1
0017	2T	3_0	15	46	6	4600	4160	-440	0.13	0.90	8	7	-1
0017	2T	3_0	16	13	2	1300	2040	740	0.15	1.57	2	3	1
0017	2T	3_0	21	1	0	100	0	-100	0.00	0.00	0	0	0
0017	2T	3_0	23	3	0	300	0	-300	0.00	0.00	0	0	0
0017	2T	3_0	24	2	0	200	0	-200	0.00	0.00	0	0	0
0017	2T	3_0	26	1	0	100	0	-100	0.00	0.00	0	0	0
0017	2T	3_1	12	766	207	76600	61280	-15320	0.27	0.80	135	108	-27
0017	2T	3_1	13	268	64	26800	19370	-7430	0.24	0.72	47	34	-13
0017	2T	3_1	14	148	26	14800	9410	-5390	0.18	0.64	26	16	-10
0017	2T	3_1	15	72	10	7200	4330	-2870	0.14	0.60	12	7	-5
0017	2T	3_1	16	53	5	5300	2600	-2700	0.09	0.49	9	4	-5
0017	2T	3_1	21	6	1	600	360	-240	0.17	0.60	1	0	-1
0017	2T	3_1	23	1	1	100	860	760	1.00	8.60	0	1	1
0017	2T	3_1	24	9	0	900	0	-900	0.00	0.00	1	0	-1
0017	2T	3_1	25	3	0	300	0	-300	0.00	0.00	0	0	0
0017	2T	3_1	26	3	0	300	0	-300	0.00	0.00	0	0	0
0017	2T	3_2	12	660	188	66000	61470	-4530	0.28	0.93	116	108	-8
0017	2T	3_2	13	316	84	31600	26770	-4830	0.27	0.85	55	47	-8
0017	2T	3_2	14	379	73	37900	22130	-15770	0.19	0.58	67	39	-28
0017	2T	3_2	15	126	28	12600	13880	1280	0.22	1.10	22	24	2
0017	2T	3_2	16	86	12	8600	6590	-2010	0.14	0.77	15	11	-4
0017	2T	3_2	21	20	1	2000	2290	290	0.05	1.15	3	4	1
0017	2T	3_2	23	32	6	3200	3170	-30	0.19	0.99	5	5	0
0017	2T	3_2	24	25	1	2500	840	-1660	0.04	0.34	4	1	-3
0017	2T	3_2	25	18	1	1800	490	-1310	0.06	0.27	3	0	-3
0017	2T	3_2	26	30	3	3000	1850	-1150	0.10	0.62	5	3	-2
0017	2T	3_3	12	1051	286	105100	96950	-8150	0.27	0.92	186	171	-15
0017	2T	3_3	13	754	183	75400	62240	-13160	0.24	0.83	133	110	-23
0017	2T	3_3	14	476	89	47600	35110	-12490	0.19	0.74	84	62	-22
0017	2T	3_3	15	213	34	21300	16450	-4850	0.16	0.77	37	29	-8
0017	2T	3_3	16	205	25	20500	18150	-2350	0.12	0.89	36	32	-4
0017	2T	3_3	21	189	21	18900	15610	-3290	0.11	0.83	33	27	-6
0017	2T	3_3	23	78	7	7800	3150	-4650	0.09	0.40	13	5	-8
0017	2T	3_3	24	78	11	7800	7180	-620	0.14	0.92	13	12	-1
0017	2T	3_3	25	69	4	6900	3110	-3790	0.06	0.45	12	5	-7
0017	2T	3_3	26	108	11	10800	9800	-1000	0.10	0.91	19	17	-2
0017	2T	3_4	12	1361	347	136100	116610	-19490	0.25	0.86	240	206	-34
0017	2T	3_4	13	809	165	80900	56740	-24160	0.20	0.70	143	100	-43
0017	2T	3_4	14	286	57	28600	19740	-8860	0.20	0.69	50	34	-16
0017	2T	3_4	15	69	15	6900	7140	240	0.22	1.03	12	12	0
0017	2T	3_4	16	48	9	4800	8560	3760	0.19	1.78	8	15	7
0017	2T	3_4	21	49	8	4900	6380	1480	0.16	1.30	8	11	3
0017	2T	3_4	23	30	3	3000	2360	-640	0.10	0.79	5	4	-1
0017	2T	3_4	24	23	1	2300	520	-1780	0.04	0.23	4	0	-4
0017	2T	3_4	25	9	0	900	0	-900	0.00	0.00	1	0	-1
0017	2T	3_4	26	9	0	900	0	-900	0.00	0.00	1	0	-1
0017	2T	3_5	12	478	115	47800	31970	-15830	0.24	0.67	84	56	-28
0017	2T	3_5	13	236	52	23600	15450	-8150	0.22	0.65	41	27	-14
0017	2T	3_5	14	48	17	4800	6400	1600	0.35	1.33	8	11	3
0017	2T	3_5	15	6	1	600	590	-10	0.17	0.98	1	1	0
0017	2T	3_5	16	2	0	200	0	-200	0.00	0.00	0	0	0
0017	2T	3_5	21	4	1	400	1340	940	0.25	3.35	0	2	2
0017	2T	3_5	24	1	0	100	0	-100	0.00	0.00	0	0	0
0017	2T	3_6	12	197	55	19700	17960	-1740	0.28	0.91	34	31	-3
0017	2T	3_6	13	68	18	6800	6040	-760	0.26	0.89	12	10	-2
0017	2T	3_6	14	5	1	500	350	-150	0.20	0.70	0	0	0
0017	2T	4_0	12	155	27	15500	11160	-4340	0.17	0.72	27	19	-8
0017	2T	4_0	13	82	21	8200	10490	2290	0.26	1.28	14	18	4
0017	2T	4_0	14	42	7	4200	4220	20	0.17	1.00	7	7	0
0017	2T	4_0	15	22	3	2200	1930	-270	0.14	0.88	3	3	0
0017	2T	4_0	16	9	0	900	0	-900	0.00	0.00	1	0	-1
0017	2T	4_0	23	9	0	900	0	-900	0.00	0.00	1	0	-1
0017	2T	4_0	24	2	1	200	1660	1460	0.50	8.30	0	2	2
0017	2T	4_0	25	2	0	200	0	-200	0.00	0.00	0	0	0
0017	2T	4_0	26	2	0	200	0	-200	0.00	0.00	0	0	0
0017	2T	4_1	12	655	174	65500	51780	-13720	0.27	0.79	115	91	-24
0017	2T	4_1	13	288	69	28800	21250	-7550	0.24	0.74	50	37	-13
0017	2T	4_1	14	132	27	13200	11930	-1270	0.20	0.90	23	21	-2
0017	2T	4_1	15	47	9	4700	4450	-250	0.19	0.95	8	7	-1
0017	2T	4_1	16	22	3	2200	2400	200	0.14	1.09	3	4	1
0017	2T	4_1	23	5	0	500	0	-500	0.00	0.00	0	0	0
0017	2T	4_1	24	4	0	400	0	-400	0.00	0.00	0	0	0
0017	2T	4_1	25	5	1	500	1530	1030	0.20	3.06	0	2	2
0017	2T	4_1	26	3	0	300	0	-300	0.00	0.00	0	0	0
0017	2T	4_2	12	733	205	73300	63390	-9910	0.28	0.86	129	112	-17
0017	2T	4_2	13	390	84	39000	27110	-11890	0.22	0.70	69	47	-22
0017	2T	4_2	14	330	88	33000	27180	-5820	0.27	0.82	58	48	-10
0017	2T	4_2	15	117	25	11700	16060	4360	0.21	1.37	20	28	8
0017	2T	4_2	16	37	7	3700	7200	3500	0.19	1.95	6	12	6
0017	2T	4_2	21	3	0	300	0	-300	0.00	0.00	0	0	0
0017	2T	4_2	23	29	4	2900	1570	-1330	0.14	0.54	5	2	-3
0017	2T	4_2	24	15	2	1500	790	-710	0.13	0.53	2	1	-1
0017	2T	4_2	25	18	1	1800	560	-1240	0.06	0.31	3	0	-3
0017	2T	4_2	26	14	4	1400	1970	570	0.29	1.41	2	3	1
0017	2T	4_3	12	1256	300	125600	96650	-28950	0.24	0.77	222	171	-51
0017	2T	4_3	13	796	211	79600	69750	-9850	0.27	0.88	140	123	-17
0017	2T	4_3	14	395	93	39500	34780	-4720	0.24	0.88	69	61	-8
0017	2T	4_3	15	140	25	14000	14550	550	0.18	1.04	24	25	1
0017	2T	4_3	16	58	7	5800	4560	-1240	0.12	0.79	10	8	-2
0017	2T	4_3	21	17	1	1700	480	-1220	0.06	0.28	3	0	-3
0017	2T	4_3	23	85	15	8500	7370	-1130	0.18	0.87	15	13	-2
0017	2T	4_3	24	46	9	4600	4500	-100	0.20	0.98	8	7	-1
0017	2T	4_3	25	41	5	4100	4640	540	0.12	1.13	7	8	1
0017	2T	4_3	26	24	0	2400	0	-2400	0.00	0.00	4	0	-4
0017	2T	4_4	12	1280	334	128000	104820	-23180	0.26	0.82	226	185	-41
0017	2T	4_4	13	494	137	49400	44090	-5310	0.28	0.89	87	78	-9
0017	2T	4_4	14	210	46	21000	17740	-3260	0.22	0.84	37	31	-6
0017	2T	4_4	15	42	4	4200	3070	-1130	0.10	0.73	7	5	-2
0017	2T	4_4	16	15	1	1500	1240	-260	0.07	0.83	2	2	0
0017	2T	4_4	21	9	1	900	580	-320	0.11	0.64	1	1	0
0017	2T	4_4	23	13	0	1300	0	-1300	0.00	0.00	2	0	-2
0017	2T	4_4	24	14	2	1400	840	-560	0.14	0.60	2	1	-1
0017	2T	4_4	25	5	0	500	0	-500	0.00	0.00	0	0	0
0017	2T	4_4	26	5	0	500	0	-500	0.00	0.00	0	0	0
0017	2T	4_5	12	627	168	62700	46030	-16670	0.27	0.73	110	81	-29
0017	2T	4_5	13	137	33	13700	10720	-2980	0.24	0.78	24	18	-6
0017	2T	4_5	14	32	5	3200	1540	-1660	0.16	0.48	5	2	-3
0017	2T	4_5	15	1	0	100	0	-100	0.00	0.00	0	0	0
0017	2T	4_5	23	1	0	100	0	-100	0.00	0.00	0	0	0
0017	2T	4_6	12	271	75	27100	20920	-6180	0.28	0.77	47	37	-10
0017	2T	4_6	13	27	3	2700	970	-1730	0.11	0.36	4	1	-3
0017	2T	4_6	14	6	2	600	930	330	0.33	1.55	1	1	0
0017	2T	5_-1	12	9	4	900	990	90	0.44	1.10	1	1	0
0017	2T	5_-1	13	5	1	500	230	-270	0.20	0.46	0	0	0
0017	2T	5_-1	14	4	2	400	730	330	0.50	1.83	0	1	1
0017	2T	5_-1	15	2	0	200	0	-200	0.00	0.00	0	0	0
0017	2T	5_0	12	276	71	27600	25530	-2070	0.26	0.93	48	45	-3
0017	2T	5_0	13	115	21	11500	9940	-1560	0.18	0.86	20	17	-3
0017	2T	5_0	14	45	10	4500	4540	40	0.22	1.01	7	8	1
0017	2T	5_0	15	25	3	2500	1800	-700	0.12	0.72	4	3	-1
0017	2T	5_0	16	4	0	400	0	-400	0.00	0.00	0	0	0
0017	2T	5_0	23	3	0	300	0	-300	0.00	0.00	0	0	0
0017	2T	5_0	25	1	0	100	0	-100	0.00	0.00	0	0	0
0017	2T	5_1	12	605	174	60500	49600	-10900	0.29	0.82	107	87	-20
0017	2T	5_1	13	200	45	20000	13880	-6120	0.23	0.69	35	24	-11
0017	2T	5_1	14	123	28	12300	10570	-1730	0.23	0.86	21	18	-3
0017	2T	5_1	15	25	1	2500	410	-2090	0.04	0.16	4	0	-4
0017	2T	5_1	16	27	4	2700	1640	-1060	0.15	0.61	4	2	-2
0017	2T	5_1	23	3	0	300	0	-300	0.00	0.00	0	0	0
0017	2T	5_1	25	2	0	200	0	-200	0.00	0.00	0	0	0
0017	2T	5_1	26	1	0	100	0	-100	0.00	0.00	0	0	0
0017	2T	5_2	12	563	158	56300	52710	-3590	0.28	0.94	99	93	-6
0017	2T	5_2	13	343	83	34300	27720	-6580	0.24	0.81	60	49	-11
0017	2T	5_2	14	329	85	32900	29650	-3250	0.26	0.90	58	52	-6
0017	2T	5_2	15	66	9	6600	3820	-2780	0.14	0.58	11	6	-5
0017	2T	5_2	16	48	10	4800	4240	-560	0.21	0.88	8	7	-1
0017	2T	5_2	21	5	1	500	250	-250	0.20	0.50	0	0	0
0017	2T	5_2	23	11	0	1100	0	-1100	0.00	0.00	1	0	-1
0017	2T	5_2	24	11	1	1100	350	-750	0.09	0.32	1	0	-1
0017	2T	5_2	25	2	0	200	0	-200	0.00	0.00	0	0	0
0017	2T	5_2	26	2	0	200	0	-200	0.00	0.00	0	0	0
0017	2T	5_3	12	997	273	99700	82320	-17380	0.27	0.83	176	145	-31
0017	2T	5_3	13	596	138	59600	45280	-14320	0.23	0.76	105	80	-25
0017	2T	5_3	14	413	85	41300	28060	-13240	0.21	0.68	73	49	-24
0017	2T	5_3	15	135	22	13500	9640	-3860	0.16	0.71	23	17	-6
0017	2T	5_3	16	67	10	6700	6500	-200	0.15	0.97	11	11	0
0017	2T	5_3	21	13	3	1300	3390	2090	0.23	2.61	2	6	4
0017	2T	5_3	23	22	1	2200	610	-1590	0.05	0.28	3	1	-2
0017	2T	5_3	24	13	1	1300	550	-750	0.08	0.42	2	0	-2
0017	2T	5_3	25	7	0	700	0	-700	0.00	0.00	1	0	-1
0017	2T	5_3	26	14	0	1400	0	-1400	0.00	0.00	2	0	-2
0017	2T	5_4	12	915	265	91500	68060	-23440	0.29	0.74	161	120	-41
0017	2T	5_4	13	323	73	32300	24280	-8020	0.23	0.75	57	42	-15
0017	2T	5_4	14	137	29	13700	11050	-2650	0.21	0.81	24	19	-5
0017	2T	5_4	15	29	4	2900	3000	100	0.14	1.03	5	5	0
0017	2T	5_4	16	14	2	1400	1280	-120	0.14	0.91	2	2	0
0017	2T	5_4	21	16	1	1600	360	-1240	0.06	0.23	2	0	-2
0017	2T	5_4	23	11	1	1100	1490	390	0.09	1.35	1	2	1
0017	2T	5_4	24	3	0	300	0	-300	0.00	0.00	0	0	0
0017	2T	5_4	25	2	0	200	0	-200	0.00	0.00	0	0	0
0017	2T	5_4	26	6	0	600	0	-600	0.00	0.00	1	0	-1
0017	2T	5_5	12	737	222	73700	54880	-18820	0.30	0.74	130	97	-33
0017	2T	5_5	13	94	17	9400	5230	-4170	0.18	0.56	16	9	-7
0017	2T	5_5	14	19	4	1900	1870	-30	0.21	0.98	3	3	0
0017	2T	5_5	16	1	1	100	1210	1110	1.00	12.10	0	2	2
0017	2T	5_5	21	2	0	200	0	-200	0.00	0.00	0	0	0
0017	2T	5_6	12	261	76	26100	20190	-5910	0.29	0.77	46	35	-11
0017	2T	5_6	13	21	3	2100	1090	-1010	0.14	0.52	3	1	-2
0017	2T	6_0	12	13	1	1300	320	-980	0.08	0.25	2	0	-2
0017	2T	6_0	13	14	5	1400	1940	540	0.36	1.39	2	3	1
0017	2T	6_0	14	5	1	500	490	-10	0.20	0.98	0	0	0
0017	2T	6_0	15	3	1	300	1220	920	0.33	4.07	0	2	2
0017	2T	6_0	23	2	0	200	0	-200	0.00	0.00	0	0	0
0017	2T	6_0	25	1	0	100	0	-100	0.00	0.00	0	0	0
0017	2T	6_1	12	37	14	3700	3560	-140	0.38	0.96	6	6	0
0017	2T	6_1	13	14	3	1400	910	-490	0.21	0.65	2	1	-1
0017	2T	6_1	14	14	3	1400	980	-420	0.21	0.70	2	1	-1
0017	2T	6_1	15	2	0	200	0	-200	0.00	0.00	0	0	0
0017	2T	6_1	16	2	1	200	600	400	0.50	3.00	0	1	1
0017	2T	6_1	25	1	0	100	0	-100	0.00	0.00	0	0	0
0017	2T	6_1	26	1	0	100	0	-100	0.00	0.00	0	0	0
0017	2T	6_2	12	32	8	3200	2270	-930	0.25	0.71	5	4	-1
0017	2T	6_2	13	20	3	2000	750	-1250	0.15	0.38	3	1	-2
0017	2T	6_2	14	24	3	2400	770	-1630	0.13	0.32	4	1	-3
0017	2T	6_2	15	3	0	300	0	-300	0.00	0.00	0	0	0
0017	2T	6_2	16	4	0	400	0	-400	0.00	0.00	0	0	0
0017	2T	6_2	25	1	0	100	0	-100	0.00	0.00	0	0	0
0017	2T	6_3	12	85	16	8500	7740	-760	0.19	0.91	15	13	-2
0017	2T	6_3	13	51	14	5100	3880	-1220	0.27	0.76	9	6	-3
0017	2T	6_3	14	31	5	3100	1480	-1620	0.16	0.48	5	2	-3
0017	2T	6_3	15	10	0	1000	0	-1000	0.00	0.00	1	0	-1
0017	2T	6_3	16	9	4	900	2380	1480	0.44	2.64	1	4	3
0017	2T	6_3	23	1	0	100	0	-100	0.00	0.00	0	0	0
0017	2T	6_4	12	85	20	8500	5520	-2980	0.24	0.65	15	9	-6
0017	2T	6_4	13	35	9	3500	3060	-440	0.26	0.87	6	5	-1
0017	2T	6_4	14	17	3	1700	1210	-490	0.18	0.71	3	2	-1
0017	2T	6_4	15	5	0	500	0	-500	0.00	0.00	0	0	0
0017	2T	6_4	16	4	1	400	940	540	0.25	2.35	0	1	1
0017	2T	6_4	23	2	0	200	0	-200	0.00	0.00	0	0	0
0017	2T	6_5	12	63	23	6300	5580	-720	0.37	0.89	11	9	-2
0017	2T	6_5	13	6	0	600	0	-600	0.00	0.00	1	0	-1
0017	2T	6_5	14	1	1	100	410	310	1.00	4.10	0	0	0
0017	2T	6_5	21	1	0	100	0	-100	0.00	0.00	0	0	0
0017	2T	6_6	12	26	12	2600	3270	670	0.46	1.26	4	5	1
0017	2T	6_6	13	2	0	200	0	-200	0.00	0.00	0	0	0
0017	2T	6_6	14	1	0	100	0	-100	0.00	0.00	0	0	0
0017	2T	7_-1	12	16	5	1600	1660	60	0.31	1.04	2	2	0
0017	2T	7_-1	13	3	0	300	0	-300	0.00	0.00	0	0	0
0017	2T	7_-1	14	1	0	100	0	-100	0.00	0.00	0	0	0
0017	2T	7_-1	15	1	0	100	0	-100	0.00	0.00	0	0	0
0017	2T	7_-1	16	1	0	100	0	-100	0.00	0.00	0	0	0
0017	2T	7_0	12	601	117	60100	42890	-17210	0.19	0.71	106	75	-31
0017	2T	7_0	13	208	37	20800	17230	-3570	0.18	0.83	36	30	-6
0017	2T	7_0	14	78	13	7800	6890	-910	0.17	0.88	13	12	-1
0017	2T	7_0	15	21	4	2100	2200	100	0.19	1.05	3	3	0
0017	2T	7_0	16	18	2	1800	2060	260	0.11	1.14	3	3	0
0017	2T	7_0	23	17	1	1700	860	-840	0.06	0.51	3	1	-2
0017	2T	7_0	25	1	0	100	0	-100	0.00	0.00	0	0	0
0017	2T	7_0	26	1	0	100	0	-100	0.00	0.00	0	0	0
0017	2T	7_1	12	1365	400	136500	120220	-16280	0.29	0.88	241	212	-29
0017	2T	7_1	13	452	126	45200	41120	-4080	0.28	0.91	80	72	-8
0017	2T	7_1	14	270	57	27000	24760	-2240	0.21	0.92	47	43	-4
0017	2T	7_1	15	63	13	6300	8410	2110	0.21	1.33	11	14	3
0017	2T	7_1	16	47	5	4700	3380	-1320	0.11	0.72	8	5	-3
0017	2T	7_1	23	13	1	1300	690	-610	0.08	0.53	2	1	-1
0017	2T	7_1	24	6	1	600	460	-140	0.17	0.77	1	0	-1
0017	2T	7_1	25	2	0	200	0	-200	0.00	0.00	0	0	0
0017	2T	7_1	26	5	0	500	0	-500	0.00	0.00	0	0	0
0017	2T	7_2	12	1529	421	152900	130070	-22830	0.28	0.85	270	230	-40
0017	2T	7_2	13	731	170	73100	54670	-18430	0.23	0.75	129	96	-33
0017	2T	7_2	14	524	122	52400	36880	-15520	0.23	0.70	92	65	-27
0017	2T	7_2	15	130	21	13000	9440	-3560	0.16	0.73	23	16	-7
0017	2T	7_2	16	98	20	9800	10880	1080	0.20	1.11	17	19	2
0017	2T	7_2	23	34	3	3400	2050	-1350	0.09	0.60	6	3	-3
0017	2T	7_2	24	19	0	1900	0	-1900	0.00	0.00	3	0	-3
0017	2T	7_2	25	7	0	700	0	-700	0.00	0.00	1	0	-1
0017	2T	7_2	26	18	0	1800	0	-1800	0.00	0.00	3	0	-3
0017	2T	7_3	12	1735	455	173500	145060	-28440	0.26	0.84	307	256	-51
0017	2T	7_3	13	842	193	84200	60850	-23350	0.23	0.72	149	107	-42
0017	2T	7_3	14	420	76	42000	27250	-14750	0.18	0.65	74	48	-26
0017	2T	7_3	15	100	20	10000	11610	1610	0.20	1.16	17	20	3
0017	2T	7_3	16	78	13	7800	7680	-120	0.17	0.98	13	13	0
0017	2T	7_3	21	3	0	300	0	-300	0.00	0.00	0	0	0
0017	2T	7_3	23	28	6	2800	3600	800	0.21	1.29	4	6	2
0017	2T	7_3	24	10	2	1000	1990	990	0.20	1.99	1	3	2
0017	2T	7_3	25	6	0	600	0	-600	0.00	0.00	1	0	-1
0017	2T	7_3	26	13	3	1300	3980	2680	0.23	3.06	2	7	5
0017	2T	7_4	12	1018	277	101800	86750	-15050	0.27	0.85	180	153	-27
0017	2T	7_4	13	323	75	32300	25700	-6600	0.23	0.80	57	45	-12
0017	2T	7_4	14	105	10	10500	5020	-5480	0.10	0.48	18	8	-10
0017	2T	7_4	15	20	3	2000	1560	-440	0.15	0.78	3	2	-1
0017	2T	7_4	16	15	3	1500	2990	1490	0.20	1.99	2	5	3
0017	2T	7_4	21	4	0	400	0	-400	0.00	0.00	0	0	0
0017	2T	7_4	23	5	0	500	0	-500	0.00	0.00	0	0	0
0017	2T	7_4	24	5	0	500	0	-500	0.00	0.00	0	0	0
0017	2T	7_4	26	2	0	200	0	-200	0.00	0.00	0	0	0
0017	2T	7_5	12	861	229	86100	66190	-19910	0.27	0.77	152	117	-35
0017	2T	7_5	13	102	20	10200	7280	-2920	0.20	0.71	18	12	-6
0017	2T	7_5	14	27	6	2700	2380	-320	0.22	0.88	4	4	0
0017	2T	7_5	15	2	0	200	0	-200	0.00	0.00	0	0	0
0017	2T	7_5	16	1	0	100	0	-100	0.00	0.00	0	0	0
0017	2T	7_5	21	1	0	100	0	-100	0.00	0.00	0	0	0
0017	2T	7_5	23	1	0	100	0	-100	0.00	0.00	0	0	0
0017	2T	7_6	12	672	171	67200	51080	-16120	0.25	0.76	118	90	-28
0017	2T	7_6	13	29	4	2900	2000	-900	0.14	0.69	5	3	-2
0017	2T	7_6	14	5	0	500	0	-500	0.00	0.00	0	0	0
0017	2T	7_6	21	1	0	100	0	-100	0.00	0.00	0	0	0
0017	3F	1_-1	123	3	1	300	740	440	0.33	2.47	0	1	1
0017	3F	1_-1	124	5	2	500	460	-40	0.40	0.92	0	0	0
0017	3F	1_-1	125	4	2	400	530	130	0.50	1.33	0	0	0
0017	3F	1_-1	134	1	0	100	0	-100	0.00	0.00	0	0	0
0017	3F	1_-1	135	1	1	100	390	290	1.00	3.90	0	0	0
0017	3F	1_-1	136	2	0	200	0	-200	0.00	0.00	0	0	0
0017	3F	1_0	123	53	7	5300	2370	-2930	0.13	0.45	9	4	-5
0017	3F	1_0	124	158	24	15800	11880	-3920	0.15	0.75	27	21	-6
0017	3F	1_0	125	73	10	7300	8110	810	0.14	1.11	12	14	2
0017	3F	1_0	126	316	26	31600	29240	-2360	0.08	0.93	55	51	-4
0017	3F	1_0	134	13	3	1300	860	-440	0.23	0.66	2	1	-1
0017	3F	1_0	135	7	2	700	3380	2680	0.29	4.83	1	5	4
0017	3F	1_0	145	4	0	400	0	-400	0.00	0.00	0	0	0
0017	3F	1_1	123	66	17	6600	5030	-1570	0.26	0.76	11	8	-3
0017	3F	1_1	124	290	57	29000	20410	-8590	0.20	0.70	51	36	-15
0017	3F	1_1	125	98	10	9800	5130	-4670	0.10	0.52	17	9	-8
0017	3F	1_1	126	245	29	24500	26050	1550	0.12	1.06	43	46	3
0017	3F	1_1	134	65	13	6500	4530	-1970	0.20	0.70	11	8	-3
0017	3F	1_1	135	77	11	7700	4840	-2860	0.14	0.63	13	8	-5
0017	3F	1_1	136	110	13	11000	8200	-2800	0.12	0.75	19	14	-5
0017	3F	1_1	145	73	10	7300	6890	-410	0.14	0.94	12	12	0
0017	3F	1_1	146	27	3	2700	1710	-990	0.11	0.63	4	3	-1
0017	3F	1_1	156	22	1	2200	580	-1620	0.05	0.26	3	1	-2
0017	3F	1_1	235	7	0	700	0	-700	0.00	0.00	1	0	-1
0017	3F	1_1	236	7	1	700	990	290	0.14	1.41	1	1	0
0017	3F	1_2	123	100	26	10000	9620	-380	0.26	0.96	17	17	0
0017	3F	1_2	124	241	45	24100	17200	-6900	0.19	0.71	42	30	-12
0017	3F	1_2	125	167	27	16700	9810	-6890	0.16	0.59	29	17	-12
0017	3F	1_2	126	243	36	24300	22530	-1770	0.15	0.93	43	39	-4
0017	3F	1_2	134	48	11	4800	8440	3640	0.23	1.76	8	14	6
0017	3F	1_2	135	96	17	9600	6760	-2840	0.18	0.70	16	11	-5
0017	3F	1_2	136	69	9	6900	3640	-3260	0.13	0.53	12	6	-6
0017	3F	1_2	145	118	20	11800	13850	2050	0.17	1.17	20	24	4
0017	3F	1_2	146	86	9	8600	5520	-3080	0.10	0.64	15	9	-6
0017	3F	1_2	156	10	1	1000	580	-420	0.10	0.58	1	1	0
0017	3F	1_2	234	8	4	800	1280	480	0.50	1.60	1	2	1
0017	3F	1_2	235	12	1	1200	620	-580	0.08	0.52	2	1	-1
0017	3F	1_2	236	5	0	500	0	-500	0.00	0.00	0	0	0
0017	3F	1_2	245	33	7	3300	3980	680	0.21	1.21	5	7	2
0017	3F	1_2	246	26	0	2600	0	-2600	0.00	0.00	4	0	-4
0017	3F	1_3	123	66	22	6600	5020	-1580	0.33	0.76	11	8	-3
0017	3F	1_3	124	370	93	37000	30430	-6570	0.25	0.82	65	53	-12
0017	3F	1_3	125	316	41	31600	21450	-10150	0.13	0.68	55	37	-18
0017	3F	1_3	126	516	73	51600	44600	-7000	0.14	0.86	91	78	-13
0017	3F	1_3	134	216	65	21600	17990	-3610	0.30	0.83	38	31	-7
0017	3F	1_3	135	192	39	19200	14210	-4990	0.20	0.74	33	25	-8
0017	3F	1_3	136	261	45	26100	22010	-4090	0.17	0.84	46	38	-8
0017	3F	1_3	145	65	12	6500	3590	-2910	0.18	0.55	11	6	-5
0017	3F	1_3	146	172	22	17200	11770	-5430	0.13	0.68	30	20	-10
0017	3F	1_3	156	62	12	6200	7030	830	0.19	1.13	10	12	2
0017	3F	1_3	234	19	4	1900	1530	-370	0.21	0.81	3	2	-1
0017	3F	1_3	235	14	4	1400	1710	310	0.29	1.22	2	3	1
0017	3F	1_3	236	23	3	2300	1240	-1060	0.13	0.54	4	2	-2
0017	3F	1_3	245	27	2	2700	820	-1880	0.07	0.30	4	1	-3
0017	3F	1_3	246	23	3	2300	1860	-440	0.13	0.81	4	3	-1
0017	3F	1_3	256	14	1	1400	490	-910	0.07	0.35	2	0	-2
0017	3F	1_4	123	9	0	900	0	-900	0.00	0.00	1	0	-1
0017	3F	1_4	124	274	59	27400	25290	-2110	0.22	0.92	48	44	-4
0017	3F	1_4	125	327	50	32700	32630	-70	0.15	1.00	57	57	0
0017	3F	1_4	126	491	40	49100	38450	-10650	0.08	0.78	86	68	-18
0017	3F	1_4	134	110	25	11000	8280	-2720	0.23	0.75	19	14	-5
0017	3F	1_4	135	133	22	13300	9330	-3970	0.17	0.70	23	16	-7
0017	3F	1_4	136	214	24	21400	23040	1640	0.11	1.08	37	40	3
0017	3F	1_4	145	58	8	5800	5170	-630	0.14	0.89	10	9	-1
0017	3F	1_4	146	91	11	9100	7740	-1360	0.12	0.85	16	13	-3
0017	3F	1_4	156	5	0	500	0	-500	0.00	0.00	0	0	0
0017	3F	1_4	234	1	1	100	3420	3320	1.00	34.20	0	6	6
0017	3F	1_4	236	1	0	100	0	-100	0.00	0.00	0	0	0
0017	3F	1_4	245	3	0	300	0	-300	0.00	0.00	0	0	0
0017	3F	1_4	246	4	0	400	0	-400	0.00	0.00	0	0	0
0017	3F	1_5	123	1	1	100	350	250	1.00	3.50	0	0	0
0017	3F	1_5	124	42	3	4200	700	-3500	0.07	0.17	7	1	-6
0017	3F	1_5	125	64	6	6400	2490	-3910	0.09	0.39	11	4	-7
0017	3F	1_5	126	98	6	9800	4890	-4910	0.06	0.50	17	8	-9
0017	3F	1_5	134	23	4	2300	2020	-280	0.17	0.88	4	3	-1
0017	3F	1_5	135	32	5	3200	3460	260	0.16	1.08	5	6	1
0017	3F	1_5	136	38	5	3800	4830	1030	0.13	1.27	6	8	2
0017	3F	1_5	145	14	0	1400	0	-1400	0.00	0.00	2	0	-2
0017	3F	1_5	146	19	1	1900	1140	-760	0.05	0.60	3	2	-1
0017	3F	1_6	123	11	1	1100	450	-650	0.09	0.41	1	0	-1
0017	3F	1_6	124	143	19	14300	8740	-5560	0.13	0.61	25	15	-10
0017	3F	1_6	125	26	1	2600	420	-2180	0.04	0.16	4	0	-4
0017	3F	1_6	126	545	39	54500	49180	-5320	0.07	0.90	96	87	-9
0017	3F	1_6	134	24	2	2400	1000	-1400	0.08	0.42	4	1	-3
0017	3F	1_6	135	20	1	2000	390	-1610	0.05	0.20	3	0	-3
0017	3F	1_6	136	340	15	34000	21880	-12120	0.04	0.64	60	38	-22
0017	3F	1_6	145	3	1	300	690	390	0.33	2.30	0	1	1
0017	3F	1_6	146	4	0	400	0	-400	0.00	0.00	0	0	0
0017	3F	2_-1	123	3	2	300	420	120	0.67	1.40	0	0	0
0017	3F	2_-1	124	4	3	400	720	320	0.75	1.80	0	1	1
0017	3F	2_-1	125	2	0	200	0	-200	0.00	0.00	0	0	0
0017	3F	2_-1	126	3	0	300	0	-300	0.00	0.00	0	0	0
0017	3F	2_-1	134	1	0	100	0	-100	0.00	0.00	0	0	0
0017	3F	2_-1	136	1	0	100	0	-100	0.00	0.00	0	0	0
0017	3F	2_-1	145	1	1	100	500	400	1.00	5.00	0	0	0
0017	3F	2_-1	146	1	0	100	0	-100	0.00	0.00	0	0	0
0017	3F	2_0	123	46	11	4600	3550	-1050	0.24	0.77	8	6	-2
0017	3F	2_0	124	48	10	4800	4490	-310	0.21	0.94	8	7	-1
0017	3F	2_0	125	38	8	3800	3920	120	0.21	1.03	6	6	0
0017	3F	2_0	126	20	1	2000	470	-1530	0.05	0.24	3	0	-3
0017	3F	2_0	134	30	5	3000	2330	-670	0.17	0.78	5	4	-1
0017	3F	2_0	135	15	3	1500	1280	-220	0.20	0.85	2	2	0
0017	3F	2_0	136	11	4	1100	2250	1150	0.36	2.05	1	3	2
0017	3F	2_0	145	5	0	500	0	-500	0.00	0.00	0	0	0
0017	3F	2_0	146	2	1	200	510	310	0.50	2.55	0	0	0
0017	3F	2_0	156	1	0	100	0	-100	0.00	0.00	0	0	0
0017	3F	2_0	234	1	0	100	0	-100	0.00	0.00	0	0	0
0017	3F	2_1	123	155	45	15500	14790	-710	0.29	0.95	27	26	-1
0017	3F	2_1	124	204	42	20400	16550	-3850	0.21	0.81	36	29	-7
0017	3F	2_1	125	134	25	13400	10510	-2890	0.19	0.78	23	18	-5
0017	3F	2_1	126	46	8	4600	3440	-1160	0.17	0.75	8	6	-2
0017	3F	2_1	134	62	11	6200	3290	-2910	0.18	0.53	10	5	-5
0017	3F	2_1	135	37	8	3700	3980	280	0.22	1.08	6	7	1
0017	3F	2_1	136	26	6	2600	1960	-640	0.23	0.75	4	3	-1
0017	3F	2_1	145	12	2	1200	1070	-130	0.17	0.89	2	1	-1
0017	3F	2_1	146	13	4	1300	1940	640	0.31	1.49	2	3	1
0017	3F	2_1	156	4	0	400	0	-400	0.00	0.00	0	0	0
0017	3F	2_2	123	196	62	19600	16650	-2950	0.32	0.85	34	29	-5
0017	3F	2_2	124	283	74	28300	21160	-7140	0.26	0.75	50	37	-13
0017	3F	2_2	125	189	41	18900	17000	-1900	0.22	0.90	33	30	-3
0017	3F	2_2	126	172	31	17200	16260	-940	0.18	0.95	30	28	-2
0017	3F	2_2	134	119	23	11900	6170	-5730	0.19	0.52	21	10	-11
0017	3F	2_2	135	90	11	9000	3470	-5530	0.12	0.39	15	6	-9
0017	3F	2_2	136	89	15	8900	4210	-4690	0.17	0.47	15	7	-8
0017	3F	2_2	145	60	8	6000	2410	-3590	0.13	0.40	10	4	-6
0017	3F	2_2	146	26	4	2600	1740	-860	0.15	0.67	4	3	-1
0017	3F	2_2	156	24	5	2400	2060	-340	0.21	0.86	4	3	-1
0017	3F	2_2	234	2	0	200	0	-200	0.00	0.00	0	0	0
0017	3F	2_2	235	1	0	100	0	-100	0.00	0.00	0	0	0
0017	3F	2_2	236	2	0	200	0	-200	0.00	0.00	0	0	0
0017	3F	2_2	245	5	0	500	0	-500	0.00	0.00	0	0	0
0017	3F	2_2	246	1	0	100	0	-100	0.00	0.00	0	0	0
0017	3F	2_2	256	1	1	100	230	130	1.00	2.30	0	0	0
0017	3F	2_3	123	268	89	26800	21770	-5030	0.33	0.81	47	38	-9
0017	3F	2_3	124	559	143	55900	45430	-10470	0.26	0.81	98	80	-18
0017	3F	2_3	125	393	81	39300	32000	-7300	0.21	0.81	69	56	-13
0017	3F	2_3	126	489	87	48900	42410	-6490	0.18	0.87	86	75	-11
0017	3F	2_3	134	303	72	30300	22450	-7850	0.24	0.74	53	39	-14
0017	3F	2_3	135	272	70	27200	22130	-5070	0.26	0.81	48	39	-9
0017	3F	2_3	136	309	58	30900	23420	-7480	0.19	0.76	54	41	-13
0017	3F	2_3	145	108	26	10800	10070	-730	0.24	0.93	19	17	-2
0017	3F	2_3	146	98	14	9800	4780	-5020	0.14	0.49	17	8	-9
0017	3F	2_3	156	53	10	5300	5250	-50	0.19	0.99	9	9	0
0017	3F	2_3	234	5	0	500	0	-500	0.00	0.00	0	0	0
0017	3F	2_3	235	17	7	1700	1960	260	0.41	1.15	3	3	0
0017	3F	2_3	236	14	1	1400	360	-1040	0.07	0.26	2	0	-2
0017	3F	2_3	245	9	1	900	260	-640	0.11	0.29	1	0	-1
0017	3F	2_3	246	9	1	900	670	-230	0.11	0.74	1	1	0
0017	3F	2_3	256	5	1	500	310	-190	0.20	0.62	0	0	0
0017	3F	2_4	123	259	64	25900	18620	-7280	0.25	0.72	45	32	-13
0017	3F	2_4	124	597	141	59700	50020	-9680	0.24	0.84	105	88	-17
0017	3F	2_4	125	348	61	34800	27140	-7660	0.18	0.78	61	48	-13
0017	3F	2_4	126	355	54	35500	25440	-10060	0.15	0.72	62	45	-17
0017	3F	2_4	134	269	56	26900	17710	-9190	0.21	0.66	47	31	-16
0017	3F	2_4	135	189	46	18900	15660	-3240	0.24	0.83	33	27	-6
0017	3F	2_4	136	168	21	16800	9450	-7350	0.13	0.56	29	16	-13
0017	3F	2_4	145	51	10	5100	4430	-670	0.20	0.87	9	7	-2
0017	3F	2_4	146	65	6	6500	3730	-2770	0.09	0.57	11	6	-5
0017	3F	2_4	156	18	5	1800	3280	1480	0.28	1.82	3	5	2
0017	3F	2_4	234	1	0	100	0	-100	0.00	0.00	0	0	0
0017	3F	2_4	235	2	1	200	810	610	0.50	4.05	0	1	1
0017	3F	2_4	236	2	0	200	0	-200	0.00	0.00	0	0	0
0017	3F	2_4	245	4	0	400	0	-400	0.00	0.00	0	0	0
0017	3F	2_4	246	2	0	200	0	-200	0.00	0.00	0	0	0
0017	3F	2_4	256	2	0	200	0	-200	0.00	0.00	0	0	0
0017	3F	2_5	123	52	15	5200	4260	-940	0.29	0.82	9	7	-2
0017	3F	2_5	124	343	58	34300	24720	-9580	0.17	0.72	60	43	-17
0017	3F	2_5	125	84	19	8400	12420	4020	0.23	1.48	14	21	7
0017	3F	2_5	126	66	2	6600	2190	-4410	0.03	0.33	11	3	-8
0017	3F	2_5	134	60	7	6000	3230	-2770	0.12	0.54	10	5	-5
0017	3F	2_5	135	30	5	3000	1780	-1220	0.17	0.59	5	3	-2
0017	3F	2_5	136	19	2	1900	3130	1230	0.11	1.65	3	5	2
0017	3F	2_5	145	8	0	800	0	-800	0.00	0.00	1	0	-1
0017	3F	2_5	146	6	2	600	1770	1170	0.33	2.95	1	3	2
0017	3F	2_5	156	1	0	100	0	-100	0.00	0.00	0	0	0
0017	3F	2_6	123	22	2	2200	460	-1740	0.09	0.21	3	0	-3
0017	3F	2_6	124	319	62	31900	28750	-3150	0.19	0.90	56	50	-6
0017	3F	2_6	125	21	2	2100	1200	-900	0.10	0.57	3	2	-1
0017	3F	2_6	126	63	2	6300	2720	-3580	0.03	0.43	11	4	-7
0017	3F	2_6	134	28	9	2800	4690	1890	0.32	1.68	4	8	4
0017	3F	2_6	135	13	2	1300	1200	-100	0.15	0.92	2	2	0
0017	3F	2_6	136	9	1	900	410	-490	0.11	0.46	1	0	-1
0017	3F	2_6	146	2	0	200	0	-200	0.00	0.00	0	0	0
0017	3F	3_-1	123	2	0	200	0	-200	0.00	0.00	0	0	0
0017	3F	3_-1	124	4	2	400	550	150	0.50	1.38	0	0	0
0017	3F	3_-1	125	7	0	700	0	-700	0.00	0.00	1	0	-1
0017	3F	3_-1	126	5	2	500	710	210	0.40	1.42	0	1	1
0017	3F	3_-1	135	2	1	200	530	330	0.50	2.65	0	0	0
0017	3F	3_-1	136	10	1	1000	300	-700	0.10	0.30	1	0	-1
0017	3F	3_-1	145	3	0	300	0	-300	0.00	0.00	0	0	0
0017	3F	3_-1	146	1	0	100	0	-100	0.00	0.00	0	0	0
0017	3F	3_-1	156	1	0	100	0	-100	0.00	0.00	0	0	0
0017	3F	3_-1	245	2	0	200	0	-200	0.00	0.00	0	0	0
0017	3F	3_0	123	40	9	4000	2440	-1560	0.23	0.61	7	4	-3
0017	3F	3_0	124	130	19	13000	10030	-2970	0.15	0.77	23	17	-6
0017	3F	3_0	125	47	11	4700	7480	2780	0.23	1.59	8	13	5
0017	3F	3_0	126	76	7	7600	5850	-1750	0.09	0.77	13	10	-3
0017	3F	3_0	134	68	10	6800	5450	-1350	0.15	0.80	12	9	-3
0017	3F	3_0	135	37	4	3700	2010	-1690	0.11	0.54	6	3	-3
0017	3F	3_0	136	41	4	4100	3240	-860	0.10	0.79	7	5	-2
0017	3F	3_0	145	11	4	1100	2080	980	0.36	1.89	1	3	2
0017	3F	3_0	146	8	1	800	730	-70	0.13	0.91	1	1	0
0017	3F	3_0	156	10	1	1000	680	-320	0.10	0.68	1	1	0
0017	3F	3_0	234	1	0	100	0	-100	0.00	0.00	0	0	0
0017	3F	3_0	236	2	0	200	0	-200	0.00	0.00	0	0	0
0017	3F	3_1	123	247	71	24700	24360	-340	0.29	0.99	43	43	0
0017	3F	3_1	124	232	51	23200	18660	-4540	0.22	0.80	41	33	-8
0017	3F	3_1	125	128	20	12800	8390	-4410	0.16	0.66	22	14	-8
0017	3F	3_1	126	138	22	13800	15320	1520	0.16	1.11	24	27	3
0017	3F	3_1	134	71	14	7100	6400	-700	0.20	0.90	12	11	-1
0017	3F	3_1	135	39	9	3900	2810	-1090	0.23	0.72	6	4	-2
0017	3F	3_1	136	57	8	5700	4240	-1460	0.14	0.74	10	7	-3
0017	3F	3_1	145	13	1	1300	440	-860	0.08	0.34	2	0	-2
0017	3F	3_1	146	27	3	2700	1040	-1660	0.11	0.39	4	1	-3
0017	3F	3_1	156	8	2	800	1360	560	0.25	1.70	1	2	1
0017	3F	3_1	236	1	1	100	490	390	1.00	4.90	0	0	0
0017	3F	3_1	245	1	1	100	440	340	1.00	4.40	0	0	0
0017	3F	3_1	246	1	0	100	0	-100	0.00	0.00	0	0	0
0017	3F	3_1	256	2	0	200	0	-200	0.00	0.00	0	0	0
0017	3F	3_2	123	129	44	12900	12140	-760	0.34	0.94	22	21	-1
0017	3F	3_2	124	221	46	22100	15060	-7040	0.21	0.68	39	26	-13
0017	3F	3_2	125	166	39	16600	13950	-2650	0.23	0.84	29	24	-5
0017	3F	3_2	126	148	28	14800	12570	-2230	0.19	0.85	26	22	-4
0017	3F	3_2	134	110	30	11000	8900	-2100	0.27	0.81	19	15	-4
0017	3F	3_2	135	73	17	7300	5040	-2260	0.23	0.69	12	8	-4
0017	3F	3_2	136	63	8	6300	2780	-3520	0.13	0.44	11	4	-7
0017	3F	3_2	145	66	8	6600	3050	-3550	0.12	0.46	11	5	-6
0017	3F	3_2	146	53	3	5300	1100	-4200	0.06	0.21	9	1	-8
0017	3F	3_2	156	12	3	1200	3040	1840	0.25	2.53	2	5	3
0017	3F	3_2	234	8	2	800	520	-280	0.25	0.65	1	0	-1
0017	3F	3_2	235	8	2	800	460	-340	0.25	0.58	1	0	-1
0017	3F	3_2	236	7	1	700	310	-390	0.14	0.44	1	0	-1
0017	3F	3_2	245	6	2	600	800	200	0.33	1.33	1	1	0
0017	3F	3_2	246	7	1	700	440	-260	0.14	0.63	1	0	-1
0017	3F	3_2	256	4	0	400	0	-400	0.00	0.00	0	0	0
0017	3F	3_3	123	111	44	11100	10390	-710	0.40	0.94	19	18	-1
0017	3F	3_3	124	378	111	37800	31590	-6210	0.29	0.84	66	55	-11
0017	3F	3_3	125	349	73	34900	25330	-9570	0.21	0.73	61	44	-17
0017	3F	3_3	126	398	63	39800	38210	-1590	0.16	0.96	70	67	-3
0017	3F	3_3	134	234	62	23400	18260	-5140	0.26	0.78	41	32	-9
0017	3F	3_3	135	237	50	23700	17580	-6120	0.21	0.74	41	31	-10
0017	3F	3_3	136	192	31	19200	11250	-7950	0.16	0.59	33	19	-14
0017	3F	3_3	145	132	31	13200	11320	-1880	0.23	0.86	23	20	-3
0017	3F	3_3	146	108	18	10800	9030	-1770	0.17	0.84	19	15	-4
0017	3F	3_3	156	55	10	5500	5550	50	0.18	1.01	9	9	0
0017	3F	3_3	234	14	4	1400	1120	-280	0.29	0.80	2	1	-1
0017	3F	3_3	235	32	4	3200	1900	-1300	0.13	0.59	5	3	-2
0017	3F	3_3	236	22	4	2200	2800	600	0.18	1.27	3	4	1
0017	3F	3_3	245	24	6	2400	3350	950	0.25	1.40	4	5	1
0017	3F	3_3	246	16	6	1600	3590	1990	0.38	2.24	2	6	4
0017	3F	3_3	256	21	2	2100	720	-1380	0.10	0.34	3	1	-2
0017	3F	3_4	123	61	19	6100	4750	-1350	0.31	0.78	10	8	-2
0017	3F	3_4	124	372	77	37200	26660	-10540	0.21	0.72	65	47	-18
0017	3F	3_4	125	394	53	39400	21880	-17520	0.13	0.56	69	38	-31
0017	3F	3_4	126	583	66	58300	50930	-7370	0.11	0.87	103	90	-13
0017	3F	3_4	134	177	44	17700	15240	-2460	0.25	0.86	31	26	-5
0017	3F	3_4	135	245	42	24500	18740	-5760	0.17	0.76	43	33	-10
0017	3F	3_4	136	361	46	36100	27160	-8940	0.13	0.75	63	48	-15
0017	3F	3_4	145	91	13	9100	5800	-3300	0.14	0.64	16	10	-6
0017	3F	3_4	146	97	6	9700	2630	-7070	0.06	0.27	17	4	-13
0017	3F	3_4	156	31	4	3100	3020	-80	0.13	0.97	5	5	0
0017	3F	3_4	234	4	1	400	320	-80	0.25	0.80	0	0	0
0017	3F	3_4	235	8	1	800	320	-480	0.13	0.40	1	0	-1
0017	3F	3_4	236	18	1	1800	920	-880	0.06	0.51	3	1	-2
0017	3F	3_4	245	12	3	1200	1500	300	0.25	1.25	2	2	0
0017	3F	3_4	246	6	0	600	0	-600	0.00	0.00	1	0	-1
0017	3F	3_4	256	1	0	100	0	-100	0.00	0.00	0	0	0
0017	3F	3_5	123	15	5	1500	1690	190	0.33	1.13	2	2	0
0017	3F	3_5	124	147	30	14700	10310	-4390	0.20	0.70	26	18	-8
0017	3F	3_5	125	138	13	13800	6720	-7080	0.09	0.49	24	11	-13
0017	3F	3_5	126	182	14	18200	15060	-3140	0.08	0.83	32	26	-6
0017	3F	3_5	134	68	6	6800	1720	-5080	0.09	0.25	12	3	-9
0017	3F	3_5	135	68	9	6800	6120	-680	0.13	0.90	12	10	-2
0017	3F	3_5	136	99	9	9900	5970	-3930	0.09	0.60	17	10	-7
0017	3F	3_5	145	15	2	1500	860	-640	0.13	0.57	2	1	-1
0017	3F	3_5	146	17	2	1700	1950	250	0.12	1.15	3	3	0
0017	3F	3_5	156	2	0	200	0	-200	0.00	0.00	0	0	0
0017	3F	3_5	246	1	0	100	0	-100	0.00	0.00	0	0	0
0017	3F	3_6	123	3	2	300	390	90	0.67	1.30	0	0	0
0017	3F	3_6	124	35	5	3500	1980	-1520	0.14	0.57	6	3	-3
0017	3F	3_6	125	28	3	2800	2760	-40	0.11	0.99	4	4	0
0017	3F	3_6	126	131	8	13100	12670	-430	0.06	0.97	23	22	-1
0017	3F	3_6	134	8	2	800	550	-250	0.25	0.69	1	0	-1
0017	3F	3_6	135	14	2	1400	570	-830	0.14	0.41	2	1	-1
0017	3F	3_6	136	46	8	4600	9400	4800	0.17	2.04	8	16	8
0017	3F	3_6	145	2	0	200	0	-200	0.00	0.00	0	0	0
0017	3F	4_0	123	38	7	3800	2780	-1020	0.18	0.73	6	4	-2
0017	3F	4_0	124	56	8	5600	3080	-2520	0.14	0.55	9	5	-4
0017	3F	4_0	125	23	4	2300	1610	-690	0.17	0.70	4	2	-2
0017	3F	4_0	126	18	1	1800	1580	-220	0.06	0.88	3	2	-1
0017	3F	4_0	134	30	3	3000	910	-2090	0.10	0.30	5	1	-4
0017	3F	4_0	135	9	0	900	0	-900	0.00	0.00	1	0	-1
0017	3F	4_0	136	3	1	300	1370	1070	0.33	4.57	0	2	2
0017	3F	4_0	145	6	1	600	570	-30	0.17	0.95	1	1	0
0017	3F	4_0	146	4	1	400	280	-120	0.25	0.70	0	0	0
0017	3F	4_0	156	4	0	400	0	-400	0.00	0.00	0	0	0
0017	3F	4_0	234	1	0	100	0	-100	0.00	0.00	0	0	0
0017	3F	4_0	236	4	0	400	0	-400	0.00	0.00	0	0	0
0017	3F	4_1	123	136	33	13600	10970	-2630	0.24	0.81	24	19	-5
0017	3F	4_1	124	219	45	21900	16830	-5070	0.21	0.77	38	29	-9
0017	3F	4_1	125	119	22	11900	9070	-2830	0.18	0.76	21	16	-5
0017	3F	4_1	126	45	10	4500	5630	1130	0.22	1.25	7	9	2
0017	3F	4_1	134	99	18	9900	6530	-3370	0.18	0.66	17	11	-6
0017	3F	4_1	135	39	5	3900	2420	-1480	0.13	0.62	6	4	-2
0017	3F	4_1	136	17	2	1700	750	-950	0.12	0.44	3	1	-2
0017	3F	4_1	145	12	0	1200	0	-1200	0.00	0.00	2	0	-2
0017	3F	4_1	146	8	1	800	460	-340	0.13	0.58	1	0	-1
0017	3F	4_1	156	3	1	300	420	120	0.33	1.40	0	0	0
0017	3F	4_1	236	1	0	100	0	-100	0.00	0.00	0	0	0
0017	3F	4_2	123	150	58	15000	14840	-160	0.39	0.99	26	26	0
0017	3F	4_2	124	231	48	23100	13410	-9690	0.21	0.58	40	23	-17
0017	3F	4_2	125	207	52	20700	17990	-2710	0.25	0.87	36	31	-5
0017	3F	4_2	126	95	18	9500	11010	1510	0.19	1.16	16	19	3
0017	3F	4_2	134	127	28	12700	9080	-3620	0.22	0.71	22	16	-6
0017	3F	4_2	135	72	8	7200	2390	-4810	0.11	0.33	12	4	-8
0017	3F	4_2	136	51	14	5100	5230	130	0.27	1.03	9	9	0
0017	3F	4_2	145	41	6	4100	1780	-2320	0.15	0.43	7	3	-4
0017	3F	4_2	146	19	2	1900	810	-1090	0.11	0.43	3	1	-2
0017	3F	4_2	156	17	3	1700	1080	-620	0.18	0.64	3	1	-2
0017	3F	4_2	234	8	2	800	680	-120	0.25	0.85	1	1	0
0017	3F	4_2	235	9	2	900	610	-290	0.22	0.68	1	1	0
0017	3F	4_2	236	2	1	200	850	650	0.50	4.25	0	1	1
0017	3F	4_2	245	1	1	100	230	130	1.00	2.30	0	0	0
0017	3F	4_2	246	5	0	500	0	-500	0.00	0.00	0	0	0
0017	3F	4_2	256	1	0	100	0	-100	0.00	0.00	0	0	0
0017	3F	4_3	123	268	84	26800	20620	-6180	0.31	0.77	47	36	-11
0017	3F	4_3	124	443	102	44300	27450	-16850	0.23	0.62	78	48	-30
0017	3F	4_3	125	329	66	32900	27220	-5680	0.20	0.83	58	48	-10
0017	3F	4_3	126	231	29	23100	12860	-10240	0.13	0.56	40	22	-18
0017	3F	4_3	134	278	84	27800	24120	-3680	0.30	0.87	49	42	-7
0017	3F	4_3	135	254	59	25400	18630	-6770	0.23	0.73	44	32	-12
0017	3F	4_3	136	154	23	15400	8950	-6450	0.15	0.58	27	15	-12
0017	3F	4_3	145	119	23	11900	9880	-2020	0.19	0.83	21	17	-4
0017	3F	4_3	146	64	11	6400	8490	2090	0.17	1.33	11	15	4
0017	3F	4_3	156	36	6	3600	4280	680	0.17	1.19	6	7	1
0017	3F	4_3	234	20	6	2000	1750	-250	0.30	0.88	3	3	0
0017	3F	4_3	235	29	5	2900	1290	-1610	0.17	0.44	5	2	-3
0017	3F	4_3	236	24	4	2400	1440	-960	0.17	0.60	4	2	-2
0017	3F	4_3	245	14	2	1400	880	-520	0.14	0.63	2	1	-1
0017	3F	4_3	246	8	0	800	0	-800	0.00	0.00	1	0	-1
0017	3F	4_3	256	9	2	900	920	20	0.22	1.02	1	1	0
0017	3F	4_4	123	266	73	26600	20810	-5790	0.27	0.78	47	36	-11
0017	3F	4_4	124	581	118	58100	39020	-19080	0.20	0.67	102	69	-33
0017	3F	4_4	125	298	52	29800	24970	-4830	0.17	0.84	52	44	-8
0017	3F	4_4	126	144	11	14400	11400	-3000	0.08	0.79	25	20	-5
0017	3F	4_4	134	179	44	17900	15520	-2380	0.25	0.87	31	27	-4
0017	3F	4_4	135	167	44	16700	20310	3610	0.26	1.22	29	35	6
0017	3F	4_4	136	89	11	8900	7130	-1770	0.12	0.80	15	12	-3
0017	3F	4_4	145	45	8	4500	3940	-560	0.18	0.88	7	6	-1
0017	3F	4_4	146	35	4	3500	1690	-1810	0.11	0.48	6	2	-4
0017	3F	4_4	156	15	0	1500	0	-1500	0.00	0.00	2	0	-2
0017	3F	4_4	234	5	0	500	0	-500	0.00	0.00	0	0	0
0017	3F	4_4	235	4	0	400	0	-400	0.00	0.00	0	0	0
0017	3F	4_4	236	3	1	300	480	180	0.33	1.60	0	0	0
0017	3F	4_4	245	7	1	700	640	-60	0.14	0.91	1	1	0
0017	3F	4_4	246	4	1	400	380	-20	0.25	0.95	0	0	0
0017	3F	4_5	123	102	35	10200	10920	720	0.34	1.07	18	19	1
0017	3F	4_5	124	400	74	40000	28220	-11780	0.19	0.71	70	49	-21
0017	3F	4_5	125	81	9	8100	6340	-1760	0.11	0.78	14	11	-3
0017	3F	4_5	126	41	2	4100	730	-3370	0.05	0.18	7	1	-6
0017	3F	4_5	134	73	21	7300	9740	2440	0.29	1.33	12	17	5
0017	3F	4_5	135	40	4	4000	1930	-2070	0.10	0.48	7	3	-4
0017	3F	4_5	136	16	3	1600	1490	-110	0.19	0.93	2	2	0
0017	3F	4_5	145	9	3	900	1590	690	0.33	1.77	1	2	1
0017	3F	4_5	146	5	0	500	0	-500	0.00	0.00	0	0	0
0017	3F	4_5	236	1	0	100	0	-100	0.00	0.00	0	0	0
0017	3F	4_6	123	29	7	2900	1790	-1110	0.24	0.62	5	3	-2
0017	3F	4_6	124	199	29	19900	12020	-7880	0.15	0.60	35	21	-14
0017	3F	4_6	125	4	1	400	370	-30	0.25	0.93	0	0	0
0017	3F	4_6	126	32	7	3200	8540	5340	0.22	2.67	5	15	10
0017	3F	4_6	134	18	2	1800	510	-1290	0.11	0.28	3	0	-3
0017	3F	4_6	135	3	0	300	0	-300	0.00	0.00	0	0	0
0017	3F	4_6	136	4	0	400	0	-400	0.00	0.00	0	0	0
0017	3F	4_6	146	3	0	300	0	-300	0.00	0.00	0	0	0
0017	3F	5_-1	123	1	0	100	0	-100	0.00	0.00	0	0	0
0017	3F	5_-1	124	6	0	600	0	-600	0.00	0.00	1	0	-1
0017	3F	5_-1	125	1	0	100	0	-100	0.00	0.00	0	0	0
0017	3F	5_-1	134	1	0	100	0	-100	0.00	0.00	0	0	0
0017	3F	5_-1	135	2	0	200	0	-200	0.00	0.00	0	0	0
0017	3F	5_-1	145	1	0	100	0	-100	0.00	0.00	0	0	0
0017	3F	5_-1	156	1	0	100	0	-100	0.00	0.00	0	0	0
0017	3F	5_0	123	122	27	12200	9030	-3170	0.22	0.74	21	15	-6
0017	3F	5_0	124	70	13	7000	5350	-1650	0.19	0.76	12	9	-3
0017	3F	5_0	125	57	9	5700	4380	-1320	0.16	0.77	10	7	-3
0017	3F	5_0	126	15	1	1500	890	-610	0.07	0.59	2	1	-1
0017	3F	5_0	134	23	6	2300	1740	-560	0.26	0.76	4	3	-1
0017	3F	5_0	135	28	5	2800	4440	1640	0.18	1.59	4	7	3
0017	3F	5_0	136	5	0	500	0	-500	0.00	0.00	0	0	0
0017	3F	5_0	145	5	0	500	0	-500	0.00	0.00	0	0	0
0017	3F	5_0	146	2	1	200	1250	1050	0.50	6.25	0	2	2
0017	3F	5_0	235	2	0	200	0	-200	0.00	0.00	0	0	0
0017	3F	5_1	123	145	33	14500	10010	-4490	0.23	0.69	25	17	-8
0017	3F	5_1	124	191	48	19100	16260	-2840	0.25	0.85	33	28	-5
0017	3F	5_1	125	103	19	10300	8530	-1770	0.18	0.83	18	15	-3
0017	3F	5_1	126	54	11	5400	5390	-10	0.20	1.00	9	9	0
0017	3F	5_1	134	57	11	5700	3750	-1950	0.19	0.66	10	6	-4
0017	3F	5_1	135	21	5	2100	2040	-60	0.24	0.97	3	3	0
0017	3F	5_1	136	16	4	1600	1570	-30	0.25	0.98	2	2	0
0017	3F	5_1	145	13	2	1300	1100	-200	0.15	0.85	2	1	-1
0017	3F	5_1	146	5	0	500	0	-500	0.00	0.00	0	0	0
0017	3F	5_1	234	1	0	100	0	-100	0.00	0.00	0	0	0
0017	3F	5_1	235	1	0	100	0	-100	0.00	0.00	0	0	0
0017	3F	5_1	236	1	0	100	0	-100	0.00	0.00	0	0	0
0017	3F	5_2	123	94	23	9400	4890	-4510	0.24	0.52	16	8	-8
0017	3F	5_2	124	229	60	22900	16850	-6050	0.26	0.74	40	29	-11
0017	3F	5_2	125	123	25	12300	8370	-3930	0.20	0.68	21	14	-7
0017	3F	5_2	126	97	22	9700	9210	-490	0.23	0.95	17	16	-1
0017	3F	5_2	134	127	38	12700	11980	-720	0.30	0.94	22	21	-1
0017	3F	5_2	135	74	16	7400	5630	-1770	0.22	0.76	13	9	-4
0017	3F	5_2	136	47	13	4700	4540	-160	0.28	0.97	8	8	0
0017	3F	5_2	145	33	5	3300	1770	-1530	0.15	0.54	5	3	-2
0017	3F	5_2	146	34	6	3400	2350	-1050	0.18	0.69	6	4	-2
0017	3F	5_2	156	12	0	1200	0	-1200	0.00	0.00	2	0	-2
0017	3F	5_2	234	4	0	400	0	-400	0.00	0.00	0	0	0
0017	3F	5_2	235	2	0	200	0	-200	0.00	0.00	0	0	0
0017	3F	5_2	236	4	0	400	0	-400	0.00	0.00	0	0	0
0017	3F	5_2	245	2	0	200	0	-200	0.00	0.00	0	0	0
0017	3F	5_3	123	104	42	10400	8870	-1530	0.40	0.85	18	15	-3
0017	3F	5_3	124	415	102	41500	30910	-10590	0.25	0.74	73	54	-19
0017	3F	5_3	125	268	51	26800	20100	-6700	0.19	0.75	47	35	-12
0017	3F	5_3	126	224	43	22400	23570	1170	0.19	1.05	39	41	2
0017	3F	5_3	134	227	60	22700	18910	-3790	0.26	0.83	40	33	-7
0017	3F	5_3	135	167	39	16700	16970	270	0.23	1.02	29	30	1
0017	3F	5_3	136	150	30	15000	18900	3900	0.20	1.26	26	33	7
0017	3F	5_3	145	140	29	14000	9560	-4440	0.21	0.68	24	16	-8
0017	3F	5_3	146	67	15	6700	6070	-630	0.22	0.91	11	10	-1
0017	3F	5_3	156	42	9	4200	6560	2360	0.21	1.56	7	11	4
0017	3F	5_3	234	7	0	700	0	-700	0.00	0.00	1	0	-1
0017	3F	5_3	235	6	1	600	620	20	0.17	1.03	1	1	0
0017	3F	5_3	236	7	2	700	770	70	0.29	1.10	1	1	0
0017	3F	5_3	246	5	1	500	2560	2060	0.20	5.12	0	4	4
0017	3F	5_4	123	89	27	8900	5900	-3000	0.30	0.66	15	10	-5
0017	3F	5_4	124	410	82	41000	27570	-13430	0.20	0.67	72	48	-24
0017	3F	5_4	125	247	32	24700	17420	-7280	0.13	0.71	43	30	-13
0017	3F	5_4	126	184	21	18400	20780	2380	0.11	1.13	32	36	4
0017	3F	5_4	134	106	24	10600	8300	-2300	0.23	0.78	18	14	-4
0017	3F	5_4	135	107	14	10700	8060	-2640	0.13	0.75	18	14	-4
0017	3F	5_4	136	85	7	8500	6120	-2380	0.08	0.72	15	10	-5
0017	3F	5_4	145	45	12	4500	4470	-30	0.27	0.99	7	7	0
0017	3F	5_4	146	36	5	3600	5640	2040	0.14	1.57	6	9	3
0017	3F	5_4	156	16	2	1600	1040	-560	0.13	0.65	2	1	-1
0017	3F	5_4	234	1	0	100	0	-100	0.00	0.00	0	0	0
0017	3F	5_4	235	4	0	400	0	-400	0.00	0.00	0	0	0
0017	3F	5_4	236	6	2	600	1510	910	0.33	2.52	1	2	1
0017	3F	5_4	246	3	1	300	430	130	0.33	1.43	0	0	0
0017	3F	5_4	256	1	0	100	0	-100	0.00	0.00	0	0	0
0017	3F	5_5	123	142	42	14200	11890	-2310	0.30	0.84	25	21	-4
0017	3F	5_5	124	355	59	35500	21330	-14170	0.17	0.60	62	37	-25
0017	3F	5_5	125	124	16	12400	8940	-3460	0.13	0.72	21	15	-6
0017	3F	5_5	126	118	15	11800	16150	4350	0.13	1.37	20	28	8
0017	3F	5_5	134	30	2	3000	1080	-1920	0.07	0.36	5	1	-4
0017	3F	5_5	135	32	3	3200	2600	-600	0.09	0.81	5	4	-1
0017	3F	5_5	136	28	5	2800	4460	1660	0.18	1.59	4	7	3
0017	3F	5_5	145	6	0	600	0	-600	0.00	0.00	1	0	-1
0017	3F	5_5	146	5	0	500	0	-500	0.00	0.00	0	0	0
0017	3F	5_6	123	18	9	1800	2490	690	0.50	1.38	3	4	1
0017	3F	5_6	124	172	30	17200	12540	-4660	0.17	0.73	30	22	-8
0017	3F	5_6	125	31	2	3100	1470	-1630	0.06	0.47	5	2	-3
0017	3F	5_6	126	40	2	4000	3230	-770	0.05	0.81	7	5	-2
0017	3F	5_6	134	7	0	700	0	-700	0.00	0.00	1	0	-1
0017	3F	5_6	135	3	0	300	0	-300	0.00	0.00	0	0	0
0017	3F	5_6	136	11	0	1100	0	-1100	0.00	0.00	1	0	-1
0017	3F	6_0	123	6	2	600	480	-120	0.33	0.80	1	0	-1
0017	3F	6_0	124	4	2	400	800	400	0.50	2.00	0	1	1
0017	3F	6_0	125	2	1	200	420	220	0.50	2.10	0	0	0
0017	3F	6_0	126	1	0	100	0	-100	0.00	0.00	0	0	0
0017	3F	6_0	134	3	1	300	290	-10	0.33	0.97	0	0	0
0017	3F	6_0	135	2	0	200	0	-200	0.00	0.00	0	0	0
0017	3F	6_0	236	1	0	100	0	-100	0.00	0.00	0	0	0
0017	3F	6_1	123	5	1	500	630	130	0.20	1.26	0	1	1
0017	3F	6_1	124	10	1	1000	240	-760	0.10	0.24	1	0	-1
0017	3F	6_1	125	9	1	900	630	-270	0.11	0.70	1	1	0
0017	3F	6_1	126	3	1	300	490	190	0.33	1.63	0	0	0
0017	3F	6_1	134	5	1	500	280	-220	0.20	0.56	0	0	0
0017	3F	6_1	135	2	0	200	0	-200	0.00	0.00	0	0	0
0017	3F	6_1	136	3	1	300	400	100	0.33	1.33	0	0	0
0017	3F	6_1	145	3	1	300	420	120	0.33	1.40	0	0	0
0017	3F	6_1	146	2	0	200	0	-200	0.00	0.00	0	0	0
0017	3F	6_2	123	9	2	900	590	-310	0.22	0.66	1	1	0
0017	3F	6_2	124	12	3	1200	640	-560	0.25	0.53	2	1	-1
0017	3F	6_2	125	8	1	800	300	-500	0.13	0.38	1	0	-1
0017	3F	6_2	126	4	0	400	0	-400	0.00	0.00	0	0	0
0017	3F	6_2	134	2	1	200	290	90	0.50	1.45	0	0	0
0017	3F	6_2	135	5	0	500	0	-500	0.00	0.00	0	0	0
0017	3F	6_2	136	3	1	300	670	370	0.33	2.23	0	1	1
0017	3F	6_2	145	1	0	100	0	-100	0.00	0.00	0	0	0
0017	3F	6_2	146	1	0	100	0	-100	0.00	0.00	0	0	0
0017	3F	6_2	156	2	0	200	0	-200	0.00	0.00	0	0	0
0017	3F	6_3	123	23	2	2300	720	-1580	0.09	0.31	4	1	-3
0017	3F	6_3	124	25	4	2500	870	-1630	0.16	0.35	4	1	-3
0017	3F	6_3	125	17	5	1700	1890	190	0.29	1.11	3	3	0
0017	3F	6_3	126	20	7	2000	2880	880	0.35	1.44	3	5	2
0017	3F	6_3	134	12	5	1200	1310	110	0.42	1.09	2	2	0
0017	3F	6_3	135	15	4	1500	820	-680	0.27	0.55	2	1	-1
0017	3F	6_3	136	13	0	1300	0	-1300	0.00	0.00	2	0	-2
0017	3F	6_3	145	11	2	1100	440	-660	0.18	0.40	1	0	-1
0017	3F	6_3	146	5	2	500	530	30	0.40	1.06	0	0	0
0017	3F	6_3	156	3	1	300	250	-50	0.33	0.83	0	0	0
0017	3F	6_4	123	20	9	2000	2420	420	0.45	1.21	3	4	1
0017	3F	6_4	124	39	7	3900	2220	-1680	0.18	0.57	6	3	-3
0017	3F	6_4	125	17	4	1700	1880	180	0.24	1.11	3	3	0
0017	3F	6_4	126	9	1	900	650	-250	0.11	0.72	1	1	0
0017	3F	6_4	134	11	2	1100	600	-500	0.18	0.55	1	1	0
0017	3F	6_4	135	13	3	1300	1950	650	0.23	1.50	2	3	1
0017	3F	6_4	136	7	0	700	0	-700	0.00	0.00	1	0	-1
0017	3F	6_4	145	4	1	400	370	-30	0.25	0.93	0	0	0
0017	3F	6_4	146	3	2	300	3650	3350	0.67	12.17	0	6	6
0017	3F	6_4	156	2	0	200	0	-200	0.00	0.00	0	0	0
0017	3F	6_4	236	2	0	200	0	-200	0.00	0.00	0	0	0
0017	3F	6_5	123	10	2	1000	610	-390	0.20	0.61	1	1	0
0017	3F	6_5	124	44	10	4400	4670	270	0.23	1.06	7	8	1
0017	3F	6_5	125	2	1	200	400	200	0.50	2.00	0	0	0
0017	3F	6_5	126	7	0	700	0	-700	0.00	0.00	1	0	-1
0017	3F	6_5	134	2	0	200	0	-200	0.00	0.00	0	0	0
0017	3F	6_5	135	3	0	300	0	-300	0.00	0.00	0	0	0
0017	3F	6_6	123	9	4	900	1270	370	0.44	1.41	1	2	1
0017	3F	6_6	124	16	3	1600	1480	-120	0.19	0.93	2	2	0
0017	3F	6_6	126	1	0	100	0	-100	0.00	0.00	0	0	0
0017	3F	6_6	134	2	0	200	0	-200	0.00	0.00	0	0	0
0017	3F	7_-1	123	3	2	300	350	50	0.67	1.17	0	0	0
0017	3F	7_-1	124	5	0	500	0	-500	0.00	0.00	0	0	0
0017	3F	7_-1	126	5	0	500	0	-500	0.00	0.00	0	0	0
0017	3F	7_-1	135	1	0	100	0	-100	0.00	0.00	0	0	0
0017	3F	7_-1	136	2	0	200	0	-200	0.00	0.00	0	0	0
0017	3F	7_-1	146	1	0	100	0	-100	0.00	0.00	0	0	0
0017	3F	7_-1	156	1	0	100	0	-100	0.00	0.00	0	0	0
0017	3F	7_0	123	195	48	19500	16710	-2790	0.25	0.86	34	29	-5
0017	3F	7_0	124	154	33	15400	13960	-1440	0.21	0.91	27	24	-3
0017	3F	7_0	125	110	20	11000	9480	-1520	0.18	0.86	19	16	-3
0017	3F	7_0	126	63	10	6300	6160	-140	0.16	0.98	11	10	-1
0017	3F	7_0	134	52	13	5200	4810	-390	0.25	0.93	9	8	-1
0017	3F	7_0	135	35	2	3500	1390	-2110	0.06	0.40	6	2	-4
0017	3F	7_0	136	15	4	1500	2310	810	0.27	1.54	2	4	2
0017	3F	7_0	145	15	3	1500	1340	-160	0.20	0.89	2	2	0
0017	3F	7_0	146	3	1	300	630	330	0.33	2.10	0	1	1
0017	3F	7_0	156	2	0	200	0	-200	0.00	0.00	0	0	0
0017	3F	7_0	234	2	1	200	450	250	0.50	2.25	0	0	0
0017	3F	7_0	235	3	1	300	1100	800	0.33	3.67	0	1	1
0017	3F	7_0	236	2	0	200	0	-200	0.00	0.00	0	0	0
0017	3F	7_1	123	458	127	45800	38350	-7450	0.28	0.84	81	67	-14
0017	3F	7_1	124	478	104	47800	40690	-7110	0.22	0.85	84	72	-12
0017	3F	7_1	125	153	34	15300	12620	-2680	0.22	0.82	27	22	-5
0017	3F	7_1	126	118	26	11800	14950	3150	0.22	1.27	20	26	6
0017	3F	7_1	134	152	29	15200	10080	-5120	0.19	0.66	26	17	-9
0017	3F	7_1	135	93	21	9300	8670	-630	0.23	0.93	16	15	-1
0017	3F	7_1	136	29	1	2900	260	-2640	0.03	0.09	5	0	-5
0017	3F	7_1	145	26	7	2600	3660	1060	0.27	1.41	4	6	2
0017	3F	7_1	146	17	1	1700	910	-790	0.06	0.54	3	1	-2
0017	3F	7_1	156	2	1	200	460	260	0.50	2.30	0	0	0
0017	3F	7_1	234	6	2	600	1150	550	0.33	1.92	1	2	1
0017	3F	7_1	235	4	1	400	220	-180	0.25	0.55	0	0	0
0017	3F	7_1	236	2	1	200	410	210	0.50	2.05	0	0	0
0017	3F	7_1	245	3	0	300	0	-300	0.00	0.00	0	0	0
0017	3F	7_2	123	335	102	33500	29920	-3580	0.30	0.89	59	52	-7
0017	3F	7_2	124	499	123	49900	42440	-7460	0.25	0.85	88	75	-13
0017	3F	7_2	125	341	70	34100	30370	-3730	0.21	0.89	60	53	-7
0017	3F	7_2	126	289	49	28900	24510	-4390	0.17	0.85	51	43	-8
0017	3F	7_2	134	197	37	19700	11800	-7900	0.19	0.60	34	20	-14
0017	3F	7_2	135	155	24	15500	9810	-5690	0.15	0.63	27	17	-10
0017	3F	7_2	136	133	14	13300	6420	-6880	0.11	0.48	23	11	-12
0017	3F	7_2	145	67	8	6700	3170	-3530	0.12	0.47	11	5	-6
0017	3F	7_2	146	57	9	5700	6820	1120	0.16	1.20	10	12	2
0017	3F	7_2	156	21	5	2100	2150	50	0.24	1.02	3	3	0
0017	3F	7_2	234	9	0	900	0	-900	0.00	0.00	1	0	-1
0017	3F	7_2	235	11	0	1100	0	-1100	0.00	0.00	1	0	-1
0017	3F	7_2	236	4	1	400	1320	920	0.25	3.30	0	2	2
0017	3F	7_2	245	4	1	400	440	40	0.25	1.10	0	0	0
0017	3F	7_2	246	1	0	100	0	-100	0.00	0.00	0	0	0
0017	3F	7_2	256	1	0	100	0	-100	0.00	0.00	0	0	0
0017	3F	7_3	123	287	101	28700	24580	-4120	0.35	0.86	50	43	-7
0017	3F	7_3	124	598	138	59800	42080	-17720	0.23	0.70	105	74	-31
0017	3F	7_3	125	413	77	41300	34200	-7100	0.19	0.83	73	60	-13
0017	3F	7_3	126	432	61	43200	35270	-7930	0.14	0.82	76	62	-14
0017	3F	7_3	134	245	67	24500	22610	-1890	0.27	0.92	43	40	-3
0017	3F	7_3	135	229	26	22900	9270	-13630	0.11	0.40	40	16	-24
0017	3F	7_3	136	225	37	22500	16800	-5700	0.16	0.75	39	29	-10
0017	3F	7_3	145	95	18	9500	7860	-1640	0.19	0.83	16	13	-3
0017	3F	7_3	146	87	13	8700	5050	-3650	0.15	0.58	15	8	-7
0017	3F	7_3	156	35	5	3500	2610	-890	0.14	0.75	6	4	-2
0017	3F	7_3	234	7	1	700	190	-510	0.14	0.27	1	0	-1
0017	3F	7_3	235	7	1	700	250	-450	0.14	0.36	1	0	-1
0017	3F	7_3	236	10	2	1000	2870	1870	0.20	2.87	1	5	4
0017	3F	7_3	245	1	0	100	0	-100	0.00	0.00	0	0	0
0017	3F	7_3	246	3	1	300	600	300	0.33	2.00	0	1	1
0017	3F	7_3	256	1	0	100	0	-100	0.00	0.00	0	0	0
0017	3F	7_4	123	161	45	16100	13380	-2720	0.28	0.83	28	23	-5
0017	3F	7_4	124	418	94	41800	36290	-5510	0.22	0.87	73	64	-9
0017	3F	7_4	125	266	42	26600	22360	-4240	0.16	0.84	47	39	-8
0017	3F	7_4	126	177	21	17700	19790	2090	0.12	1.12	31	35	4
0017	3F	7_4	134	121	16	12100	6090	-6010	0.13	0.50	21	10	-11
0017	3F	7_4	135	113	11	11300	4950	-6350	0.10	0.44	20	8	-12
0017	3F	7_4	136	66	8	6600	8450	1850	0.12	1.28	11	14	3
0017	3F	7_4	145	32	3	3200	1050	-2150	0.09	0.33	5	1	-4
0017	3F	7_4	146	20	3	2000	2270	270	0.15	1.14	3	4	1
0017	3F	7_4	156	8	0	800	0	-800	0.00	0.00	1	0	-1
0017	3F	7_4	234	2	0	200	0	-200	0.00	0.00	0	0	0
0017	3F	7_4	235	1	0	100	0	-100	0.00	0.00	0	0	0
0017	3F	7_4	236	2	0	200	0	-200	0.00	0.00	0	0	0
0017	3F	7_4	245	1	0	100	0	-100	0.00	0.00	0	0	0
0017	3F	7_4	246	2	0	200	0	-200	0.00	0.00	0	0	0
0017	3F	7_5	123	163	48	16300	16280	-20	0.29	1.00	28	28	0
0017	3F	7_5	124	467	78	46700	30940	-15760	0.17	0.66	82	54	-28
0017	3F	7_5	125	121	16	12100	8480	-3620	0.13	0.70	21	15	-6
0017	3F	7_5	126	111	5	11100	5880	-5220	0.05	0.53	19	10	-9
0017	3F	7_5	134	49	10	4900	4030	-870	0.20	0.82	8	7	-1
0017	3F	7_5	135	31	0	3100	0	-3100	0.00	0.00	5	0	-5
0017	3F	7_5	136	22	0	2200	0	-2200	0.00	0.00	3	0	-3
0017	3F	7_5	145	5	1	500	960	460	0.20	1.92	0	1	1
0017	3F	7_5	146	5	1	500	3250	2750	0.20	6.50	0	5	5
0017	3F	7_5	235	1	0	100	0	-100	0.00	0.00	0	0	0
0017	3F	7_6	123	118	26	11800	8820	-2980	0.22	0.75	20	15	-5
0017	3F	7_6	124	450	73	45000	32350	-12650	0.16	0.72	79	57	-22
0017	3F	7_6	125	30	1	3000	780	-2220	0.03	0.26	5	1	-4
0017	3F	7_6	126	75	0	7500	0	-7500	0.00	0.00	13	0	-13
0017	3F	7_6	134	17	4	1700	2660	960	0.24	1.56	3	4	1
0017	3F	7_6	135	6	0	600	0	-600	0.00	0.00	1	0	-1
0017	3F	7_6	136	6	1	600	860	260	0.17	1.43	1	1	0
0017	3F	7_6	146	3	1	300	1050	750	0.33	3.50	0	1	1
0017	3T	1_-1	123	3	0	300	0	-300	0.00	0.00	0	0	0
0017	3T	1_-1	124	5	1	500	860	360	0.20	1.72	0	1	1
0017	3T	1_-1	125	4	2	400	1670	1270	0.50	4.18	0	2	2
0017	3T	1_-1	134	1	0	100	0	-100	0.00	0.00	0	0	0
0017	3T	1_-1	135	1	1	100	1040	940	1.00	10.40	0	1	1
0017	3T	1_-1	136	2	0	200	0	-200	0.00	0.00	0	0	0
0017	3T	1_0	123	53	3	5300	2950	-2350	0.06	0.56	9	5	-4
0017	3T	1_0	124	158	10	15800	11550	-4250	0.06	0.73	27	20	-7
0017	3T	1_0	125	73	4	7300	7010	-290	0.05	0.96	12	12	0
0017	3T	1_0	126	316	12	31600	27430	-4170	0.04	0.87	55	48	-7
0017	3T	1_0	134	13	0	1300	0	-1300	0.00	0.00	2	0	-2
0017	3T	1_0	135	7	1	700	2200	1500	0.14	3.14	1	3	2
0017	3T	1_0	154	4	0	400	0	-400	0.00	0.00	0	0	0
0017	3T	1_1	123	22	3	2200	1250	-950	0.14	0.57	3	2	-1
0017	3T	1_1	124	259	25	25900	17070	-8830	0.10	0.66	45	30	-15
0017	3T	1_1	125	81	3	8100	2600	-5500	0.04	0.32	14	4	-10
0017	3T	1_1	126	243	12	24300	23270	-1030	0.05	0.96	43	41	-2
0017	3T	1_1	132	44	2	4400	1580	-2820	0.05	0.36	7	2	-5
0017	3T	1_1	134	65	6	6500	4380	-2120	0.09	0.67	11	7	-4
0017	3T	1_1	135	73	4	7300	4700	-2600	0.05	0.64	12	8	-4
0017	3T	1_1	136	110	7	11000	6370	-4630	0.06	0.58	19	11	-8
0017	3T	1_1	142	31	1	3100	1390	-1710	0.03	0.45	5	2	-3
0017	3T	1_1	145	47	3	4700	3400	-1300	0.06	0.72	8	6	-2
0017	3T	1_1	146	27	0	2700	0	-2700	0.00	0.00	4	0	-4
0017	3T	1_1	152	15	1	1500	1780	280	0.07	1.19	2	3	1
0017	3T	1_1	153	4	0	400	0	-400	0.00	0.00	0	0	0
0017	3T	1_1	154	26	1	2600	2230	-370	0.04	0.86	4	3	-1
0017	3T	1_1	156	22	0	2200	0	-2200	0.00	0.00	3	0	-3
0017	3T	1_1	215	2	0	200	0	-200	0.00	0.00	0	0	0
0017	3T	1_1	216	2	0	200	0	-200	0.00	0.00	0	0	0
0017	3T	1_1	235	7	0	700	0	-700	0.00	0.00	1	0	-1
0017	3T	1_1	236	7	0	700	0	-700	0.00	0.00	1	0	-1
0017	3T	1_2	123	10	1	1000	420	-580	0.10	0.42	1	0	-1
0017	3T	1_2	124	95	6	9500	3740	-5760	0.06	0.39	16	6	-10
0017	3T	1_2	125	150	10	15000	7980	-7020	0.07	0.53	26	14	-12
0017	3T	1_2	126	171	11	17100	23440	6340	0.06	1.37	30	41	11
0017	3T	1_2	132	89	12	8900	11430	2530	0.13	1.28	15	20	5
0017	3T	1_2	134	39	8	3900	7100	3200	0.21	1.82	6	12	6
0017	3T	1_2	135	96	5	9600	5310	-4290	0.05	0.55	16	9	-7
0017	3T	1_2	136	69	3	6900	2150	-4750	0.04	0.31	12	3	-9
0017	3T	1_2	142	141	13	14100	12570	-1530	0.09	0.89	24	22	-2
0017	3T	1_2	143	9	0	900	0	-900	0.00	0.00	1	0	-1
0017	3T	1_2	145	117	7	11700	8800	-2900	0.06	0.75	20	15	-5
0017	3T	1_2	146	86	4	8600	7810	-790	0.05	0.91	15	13	-2
0017	3T	1_2	152	5	0	500	0	-500	0.00	0.00	0	0	0
0017	3T	1_2	154	1	0	100	0	-100	0.00	0.00	0	0	0
0017	3T	1_2	156	10	0	1000	0	-1000	0.00	0.00	1	0	-1
0017	3T	1_2	162	3	1	300	740	440	0.33	2.47	0	1	1
0017	3T	1_2	213	1	1	100	1150	1050	1.00	11.50	0	2	2
0017	3T	1_2	214	2	0	200	0	-200	0.00	0.00	0	0	0
0017	3T	1_2	215	12	2	1200	4000	2800	0.17	3.33	2	7	5
0017	3T	1_2	216	69	5	6900	7360	460	0.07	1.07	12	13	1
0017	3T	1_2	234	6	3	600	1840	1240	0.50	3.07	1	3	2
0017	3T	1_2	235	12	0	1200	0	-1200	0.00	0.00	2	0	-2
0017	3T	1_2	236	5	0	500	0	-500	0.00	0.00	0	0	0
0017	3T	1_2	241	3	0	300	0	-300	0.00	0.00	0	0	0
0017	3T	1_2	243	2	0	200	0	-200	0.00	0.00	0	0	0
0017	3T	1_2	245	33	3	3300	7860	4560	0.09	2.38	5	13	8
0017	3T	1_2	246	26	0	2600	0	-2600	0.00	0.00	4	0	-4
0017	3T	1_3	123	39	5	3900	2710	-1190	0.13	0.69	6	4	-2
0017	3T	1_3	124	324	35	32400	26760	-5640	0.11	0.83	57	47	-10
0017	3T	1_3	125	232	11	23200	13120	-10080	0.05	0.57	41	23	-18
0017	3T	1_3	126	330	22	33000	25320	-7680	0.07	0.77	58	44	-14
0017	3T	1_3	132	21	2	2100	1440	-660	0.10	0.69	3	2	-1
0017	3T	1_3	134	216	24	21600	14520	-7080	0.11	0.67	38	25	-13
0017	3T	1_3	135	192	11	19200	10420	-8780	0.06	0.54	33	18	-15
0017	3T	1_3	136	261	16	26100	19600	-6500	0.06	0.75	46	34	-12
0017	3T	1_3	145	65	5	6500	3530	-2970	0.08	0.54	11	6	-5
0017	3T	1_3	146	165	8	16500	8740	-7760	0.05	0.53	29	15	-14
0017	3T	1_3	156	54	3	5400	3770	-1630	0.06	0.70	9	6	-3
0017	3T	1_3	164	7	1	700	1550	850	0.14	2.21	1	2	1
0017	3T	1_3	165	8	1	800	1080	280	0.13	1.35	1	1	0
0017	3T	1_3	213	6	0	600	0	-600	0.00	0.00	1	0	-1
0017	3T	1_3	214	46	2	4600	4640	40	0.04	1.01	8	8	0
0017	3T	1_3	215	84	1	8400	920	-7480	0.01	0.11	14	1	-13
0017	3T	1_3	216	186	11	18600	27390	8790	0.06	1.47	32	48	16
0017	3T	1_3	234	19	1	1900	1520	-380	0.05	0.80	3	2	-1
0017	3T	1_3	235	14	2	1400	2540	1140	0.14	1.81	2	4	2
0017	3T	1_3	236	23	2	2300	2600	300	0.09	1.13	4	4	0
0017	3T	1_3	245	27	0	2700	0	-2700	0.00	0.00	4	0	-4
0017	3T	1_3	246	22	2	2200	3020	820	0.09	1.37	3	5	2
0017	3T	1_3	256	12	0	1200	0	-1200	0.00	0.00	2	0	-2
0017	3T	1_3	264	1	0	100	0	-100	0.00	0.00	0	0	0
0017	3T	1_3	265	2	0	200	0	-200	0.00	0.00	0	0	0
0017	3T	1_4	123	7	0	700	0	-700	0.00	0.00	1	0	-1
0017	3T	1_4	124	257	30	25700	26760	1060	0.12	1.04	45	47	2
0017	3T	1_4	125	278	21	27800	34920	7120	0.08	1.26	49	61	12
0017	3T	1_4	126	402	15	40200	33080	-7120	0.04	0.82	71	58	-13
0017	3T	1_4	132	2	0	200	0	-200	0.00	0.00	0	0	0
0017	3T	1_4	134	110	12	11000	10010	-990	0.11	0.91	19	17	-2
0017	3T	1_4	135	133	6	13300	7070	-6230	0.05	0.53	23	12	-11
0017	3T	1_4	136	214	11	21400	22280	880	0.05	1.04	37	39	2
0017	3T	1_4	145	58	4	5800	7490	1690	0.07	1.29	10	13	3
0017	3T	1_4	146	90	5	9000	6250	-2750	0.06	0.69	15	11	-4
0017	3T	1_4	156	5	0	500	0	-500	0.00	0.00	0	0	0
0017	3T	1_4	164	1	0	100	0	-100	0.00	0.00	0	0	0
0017	3T	1_4	214	17	0	1700	0	-1700	0.00	0.00	3	0	-3
0017	3T	1_4	215	49	0	4900	0	-4900	0.00	0.00	8	0	-8
0017	3T	1_4	216	89	0	8900	0	-8900	0.00	0.00	15	0	-15
0017	3T	1_4	234	1	1	100	10150	10050	1.00	101.50	0	17	17
0017	3T	1_4	236	1	0	100	0	-100	0.00	0.00	0	0	0
0017	3T	1_4	245	3	0	300	0	-300	0.00	0.00	0	0	0
0017	3T	1_4	246	4	0	400	0	-400	0.00	0.00	0	0	0
0017	3T	1_5	123	1	0	100	0	-100	0.00	0.00	0	0	0
0017	3T	1_5	124	40	1	4000	270	-3730	0.03	0.07	7	0	-7
0017	3T	1_5	125	62	0	6200	0	-6200	0.00	0.00	10	0	-10
0017	3T	1_5	126	92	4	9200	5920	-3280	0.04	0.64	16	10	-6
0017	3T	1_5	134	23	2	2300	1340	-960	0.09	0.58	4	2	-2
0017	3T	1_5	135	32	1	3200	3680	480	0.03	1.15	5	6	1
0017	3T	1_5	136	38	0	3800	0	-3800	0.00	0.00	6	0	-6
0017	3T	1_5	145	14	0	1400	0	-1400	0.00	0.00	2	0	-2
0017	3T	1_5	146	19	0	1900	0	-1900	0.00	0.00	3	0	-3
0017	3T	1_5	214	2	0	200	0	-200	0.00	0.00	0	0	0
0017	3T	1_5	215	2	0	200	0	-200	0.00	0.00	0	0	0
0017	3T	1_5	216	6	0	600	0	-600	0.00	0.00	1	0	-1
0017	3T	1_6	123	11	0	1100	0	-1100	0.00	0.00	1	0	-1
0017	3T	1_6	124	143	8	14300	8650	-5650	0.06	0.60	25	15	-10
0017	3T	1_6	125	25	1	2500	1010	-1490	0.04	0.40	4	1	-3
0017	3T	1_6	126	544	25	54400	56160	1760	0.05	1.03	96	99	3
0017	3T	1_6	134	24	1	2400	690	-1710	0.04	0.29	4	1	-3
0017	3T	1_6	135	20	0	2000	0	-2000	0.00	0.00	3	0	-3
0017	3T	1_6	136	340	4	34000	14530	-19470	0.01	0.43	60	25	-35
0017	3T	1_6	145	3	1	300	2270	1970	0.33	7.57	0	4	4
0017	3T	1_6	146	4	0	400	0	-400	0.00	0.00	0	0	0
0017	3T	1_6	215	1	0	100	0	-100	0.00	0.00	0	0	0
0017	3T	1_6	216	1	0	100	0	-100	0.00	0.00	0	0	0
0017	3T	2_-1	123	3	1	300	710	410	0.33	2.37	0	1	1
0017	3T	2_-1	124	4	2	400	1410	1010	0.50	3.53	0	2	2
0017	3T	2_-1	125	2	0	200	0	-200	0.00	0.00	0	0	0
0017	3T	2_-1	126	3	0	300	0	-300	0.00	0.00	0	0	0
0017	3T	2_-1	134	1	0	100	0	-100	0.00	0.00	0	0	0
0017	3T	2_-1	136	1	0	100	0	-100	0.00	0.00	0	0	0
0017	3T	2_-1	145	1	0	100	0	-100	0.00	0.00	0	0	0
0017	3T	2_-1	146	1	0	100	0	-100	0.00	0.00	0	0	0
0017	3T	2_0	123	41	6	4100	5630	1530	0.15	1.37	7	9	2
0017	3T	2_0	124	46	7	4600	8250	3650	0.15	1.79	8	14	6
0017	3T	2_0	125	38	2	3800	1990	-1810	0.05	0.52	6	3	-3
0017	3T	2_0	126	19	0	1900	0	-1900	0.00	0.00	3	0	-3
0017	3T	2_0	132	4	0	400	0	-400	0.00	0.00	0	0	0
0017	3T	2_0	134	29	0	2900	0	-2900	0.00	0.00	5	0	-5
0017	3T	2_0	135	13	1	1300	1000	-300	0.08	0.77	2	1	-1
0017	3T	2_0	136	10	2	1000	2960	1960	0.20	2.96	1	5	4
0017	3T	2_0	142	2	0	200	0	-200	0.00	0.00	0	0	0
0017	3T	2_0	143	1	0	100	0	-100	0.00	0.00	0	0	0
0017	3T	2_0	145	2	0	200	0	-200	0.00	0.00	0	0	0
0017	3T	2_0	146	2	0	200	0	-200	0.00	0.00	0	0	0
0017	3T	2_0	153	2	1	200	1360	1160	0.50	6.80	0	2	2
0017	3T	2_0	154	3	0	300	0	-300	0.00	0.00	0	0	0
0017	3T	2_0	156	1	0	100	0	-100	0.00	0.00	0	0	0
0017	3T	2_0	162	1	0	100	0	-100	0.00	0.00	0	0	0
0017	3T	2_0	163	1	0	100	0	-100	0.00	0.00	0	0	0
0017	3T	2_0	213	1	0	100	0	-100	0.00	0.00	0	0	0
0017	3T	2_0	234	1	0	100	0	-100	0.00	0.00	0	0	0
0017	3T	2_1	123	151	17	15100	13080	-2020	0.11	0.87	26	23	-3
0017	3T	2_1	124	202	20	20200	15970	-4230	0.10	0.79	35	28	-7
0017	3T	2_1	125	134	10	13400	9100	-4300	0.07	0.68	23	16	-7
0017	3T	2_1	126	46	5	4600	10040	5440	0.11	2.18	8	17	9
0017	3T	2_1	132	4	1	400	1440	1040	0.25	3.60	0	2	2
0017	3T	2_1	134	60	4	6000	2140	-3860	0.07	0.36	10	3	-7
0017	3T	2_1	135	36	3	3600	2470	-1130	0.08	0.69	6	4	-2
0017	3T	2_1	136	26	0	2600	0	-2600	0.00	0.00	4	0	-4
0017	3T	2_1	142	2	0	200	0	-200	0.00	0.00	0	0	0
0017	3T	2_1	143	2	0	200	0	-200	0.00	0.00	0	0	0
0017	3T	2_1	145	11	1	1100	1100	0	0.09	1.00	1	1	0
0017	3T	2_1	146	13	2	1300	2760	1460	0.15	2.12	2	4	2
0017	3T	2_1	153	1	0	100	0	-100	0.00	0.00	0	0	0
0017	3T	2_1	154	1	0	100	0	-100	0.00	0.00	0	0	0
0017	3T	2_1	156	4	0	400	0	-400	0.00	0.00	0	0	0
0017	3T	2_2	123	194	23	19400	16600	-2800	0.12	0.86	34	29	-5
0017	3T	2_2	124	274	24	27400	17650	-9750	0.09	0.64	48	31	-17
0017	3T	2_2	125	189	19	18900	19980	1080	0.10	1.06	33	35	2
0017	3T	2_2	126	172	11	17200	10200	-7000	0.06	0.59	30	18	-12
0017	3T	2_2	132	2	0	200	0	-200	0.00	0.00	0	0	0
0017	3T	2_2	134	118	10	11800	6260	-5540	0.08	0.53	20	11	-9
0017	3T	2_2	135	89	5	8900	4010	-4890	0.06	0.45	15	7	-8
0017	3T	2_2	136	89	6	8900	4840	-4060	0.07	0.54	15	8	-7
0017	3T	2_2	142	8	1	800	1010	210	0.13	1.26	1	1	0
0017	3T	2_2	143	1	0	100	0	-100	0.00	0.00	0	0	0
0017	3T	2_2	145	60	2	6000	1760	-4240	0.03	0.29	10	3	-7
0017	3T	2_2	146	25	2	2500	2340	-160	0.08	0.94	4	4	0
0017	3T	2_2	153	1	0	100	0	-100	0.00	0.00	0	0	0
0017	3T	2_2	156	24	1	2400	1270	-1130	0.04	0.53	4	2	-2
0017	3T	2_2	164	1	0	100	0	-100	0.00	0.00	0	0	0
0017	3T	2_2	214	1	0	100	0	-100	0.00	0.00	0	0	0
0017	3T	2_2	234	2	0	200	0	-200	0.00	0.00	0	0	0
0017	3T	2_2	235	1	0	100	0	-100	0.00	0.00	0	0	0
0017	3T	2_2	236	2	0	200	0	-200	0.00	0.00	0	0	0
0017	3T	2_2	245	5	0	500	0	-500	0.00	0.00	0	0	0
0017	3T	2_2	246	1	0	100	0	-100	0.00	0.00	0	0	0
0017	3T	2_2	256	1	1	100	1030	930	1.00	10.30	0	1	1
0017	3T	2_3	123	268	35	26800	21380	-5420	0.13	0.80	47	37	-10
0017	3T	2_3	124	549	54	54900	46470	-8430	0.10	0.85	97	82	-15
0017	3T	2_3	125	392	24	39200	27680	-11520	0.06	0.71	69	48	-21
0017	3T	2_3	126	482	29	48200	40220	-7980	0.06	0.83	85	71	-14
0017	3T	2_3	134	303	30	30300	23430	-6870	0.10	0.77	53	41	-12
0017	3T	2_3	135	272	29	27200	27580	380	0.11	1.01	48	48	0
0017	3T	2_3	136	309	29	30900	38400	7500	0.09	1.24	54	67	13
0017	3T	2_3	142	7	0	700	0	-700	0.00	0.00	1	0	-1
0017	3T	2_3	145	103	7	10300	5550	-4750	0.07	0.54	18	9	-9
0017	3T	2_3	146	96	5	9600	3590	-6010	0.05	0.37	16	6	-10
0017	3T	2_3	154	5	1	500	1200	700	0.20	2.40	0	2	2
0017	3T	2_3	156	53	3	5300	4420	-880	0.06	0.83	9	7	-2
0017	3T	2_3	164	2	0	200	0	-200	0.00	0.00	0	0	0
0017	3T	2_3	214	3	0	300	0	-300	0.00	0.00	0	0	0
0017	3T	2_3	215	1	0	100	0	-100	0.00	0.00	0	0	0
0017	3T	2_3	216	7	0	700	0	-700	0.00	0.00	1	0	-1
0017	3T	2_3	234	5	0	500	0	-500	0.00	0.00	0	0	0
0017	3T	2_3	235	17	2	1700	1250	-450	0.12	0.74	3	2	-1
0017	3T	2_3	236	14	1	1400	700	-700	0.07	0.50	2	1	-1
0017	3T	2_3	245	9	0	900	0	-900	0.00	0.00	1	0	-1
0017	3T	2_3	246	9	0	900	0	-900	0.00	0.00	1	0	-1
0017	3T	2_3	256	5	0	500	0	-500	0.00	0.00	0	0	0
0017	3T	2_4	123	259	27	25900	20480	-5420	0.10	0.79	45	36	-9
0017	3T	2_4	124	596	59	59600	53360	-6240	0.10	0.90	105	94	-11
0017	3T	2_4	125	348	19	34800	22350	-12450	0.05	0.64	61	39	-22
0017	3T	2_4	126	342	26	34200	32530	-1670	0.08	0.95	60	57	-3
0017	3T	2_4	134	269	22	26900	16280	-10620	0.08	0.61	47	28	-19
0017	3T	2_4	135	189	15	18900	12230	-6670	0.08	0.65	33	21	-12
0017	3T	2_4	136	168	5	16800	5260	-11540	0.03	0.31	29	9	-20
0017	3T	2_4	142	1	0	100	0	-100	0.00	0.00	0	0	0
0017	3T	2_4	145	46	4	4600	3880	-720	0.09	0.84	8	6	-2
0017	3T	2_4	146	64	3	6400	4560	-1840	0.05	0.71	11	8	-3
0017	3T	2_4	154	5	0	500	0	-500	0.00	0.00	0	0	0
0017	3T	2_4	156	18	4	1800	6540	4740	0.22	3.63	3	11	8
0017	3T	2_4	164	1	0	100	0	-100	0.00	0.00	0	0	0
0017	3T	2_4	216	13	2	1300	7170	5870	0.15	5.52	2	12	10
0017	3T	2_4	234	1	0	100	0	-100	0.00	0.00	0	0	0
0017	3T	2_4	235	2	1	200	3090	2890	0.50	15.45	0	5	5
0017	3T	2_4	236	2	0	200	0	-200	0.00	0.00	0	0	0
0017	3T	2_4	245	3	0	300	0	-300	0.00	0.00	0	0	0
0017	3T	2_4	246	2	0	200	0	-200	0.00	0.00	0	0	0
0017	3T	2_4	254	1	0	100	0	-100	0.00	0.00	0	0	0
0017	3T	2_4	256	2	0	200	0	-200	0.00	0.00	0	0	0
0017	3T	2_5	123	52	6	5200	3990	-1210	0.12	0.77	9	7	-2
0017	3T	2_5	124	339	27	33900	23550	-10350	0.08	0.69	60	41	-19
0017	3T	2_5	125	84	7	8400	7490	-910	0.08	0.89	14	13	-1
0017	3T	2_5	126	66	1	6600	1450	-5150	0.02	0.22	11	2	-9
0017	3T	2_5	134	60	4	6000	4380	-1620	0.07	0.73	10	7	-3
0017	3T	2_5	135	30	2	3000	1720	-1280	0.07	0.57	5	3	-2
0017	3T	2_5	136	19	0	1900	0	-1900	0.00	0.00	3	0	-3
0017	3T	2_5	142	4	0	400	0	-400	0.00	0.00	0	0	0
0017	3T	2_5	145	8	0	800	0	-800	0.00	0.00	1	0	-1
0017	3T	2_5	146	6	2	600	4190	3590	0.33	6.98	1	7	6
0017	3T	2_5	156	1	0	100	0	-100	0.00	0.00	0	0	0
0017	3T	2_6	123	22	1	2200	470	-1730	0.05	0.21	3	0	-3
0017	3T	2_6	124	319	27	31900	26910	-4990	0.08	0.84	56	47	-9
0017	3T	2_6	125	21	1	2100	1330	-770	0.05	0.63	3	2	-1
0017	3T	2_6	126	63	1	6300	2280	-4020	0.02	0.36	11	4	-7
0017	3T	2_6	134	28	2	2800	2790	-10	0.07	1.00	4	4	0
0017	3T	2_6	135	13	1	1300	1390	90	0.08	1.07	2	2	0
0017	3T	2_6	136	9	1	900	700	-200	0.11	0.78	1	1	0
0017	3T	2_6	146	2	0	200	0	-200	0.00	0.00	0	0	0
0017	3T	3_-1	123	2	0	200	0	-200	0.00	0.00	0	0	0
0017	3T	3_-1	124	4	1	400	580	180	0.25	1.45	0	1	1
0017	3T	3_-1	125	7	0	700	0	-700	0.00	0.00	1	0	-1
0017	3T	3_-1	126	5	1	500	1030	530	0.20	2.06	0	1	1
0017	3T	3_-1	135	2	1	200	890	690	0.50	4.45	0	1	1
0017	3T	3_-1	136	10	0	1000	0	-1000	0.00	0.00	1	0	-1
0017	3T	3_-1	145	3	0	300	0	-300	0.00	0.00	0	0	0
0017	3T	3_-1	146	1	0	100	0	-100	0.00	0.00	0	0	0
0017	3T	3_-1	156	1	0	100	0	-100	0.00	0.00	0	0	0
0017	3T	3_-1	245	2	0	200	0	-200	0.00	0.00	0	0	0
0017	3T	3_0	123	39	5	3900	4290	390	0.13	1.10	6	7	1
0017	3T	3_0	124	127	10	12700	15080	2380	0.08	1.19	22	26	4
0017	3T	3_0	125	47	1	4700	970	-3730	0.02	0.21	8	1	-7
0017	3T	3_0	126	75	3	7500	6080	-1420	0.04	0.81	13	10	-3
0017	3T	3_0	132	1	0	100	0	-100	0.00	0.00	0	0	0
0017	3T	3_0	134	64	4	6400	8610	2210	0.06	1.35	11	15	4
0017	3T	3_0	135	36	1	3600	840	-2760	0.03	0.23	6	1	-5
0017	3T	3_0	136	40	1	4000	1850	-2150	0.03	0.46	7	3	-4
0017	3T	3_0	142	3	0	300	0	-300	0.00	0.00	0	0	0
0017	3T	3_0	143	4	1	400	1060	660	0.25	2.65	0	1	1
0017	3T	3_0	145	11	2	1100	2870	1770	0.18	2.61	1	5	4
0017	3T	3_0	146	8	0	800	0	-800	0.00	0.00	1	0	-1
0017	3T	3_0	153	1	0	100	0	-100	0.00	0.00	0	0	0
0017	3T	3_0	156	10	0	1000	0	-1000	0.00	0.00	1	0	-1
0017	3T	3_0	163	1	0	100	0	-100	0.00	0.00	0	0	0
0017	3T	3_0	216	1	0	100	0	-100	0.00	0.00	0	0	0
0017	3T	3_0	234	1	0	100	0	-100	0.00	0.00	0	0	0
0017	3T	3_0	236	2	0	200	0	-200	0.00	0.00	0	0	0
0017	3T	3_1	123	232	28	23200	20810	-2390	0.12	0.90	41	36	-5
0017	3T	3_1	124	230	23	23000	16850	-6150	0.10	0.73	40	29	-11
0017	3T	3_1	125	123	11	12300	9180	-3120	0.09	0.75	21	16	-5
0017	3T	3_1	126	136	10	13600	9200	-4400	0.07	0.68	24	16	-8
0017	3T	3_1	132	14	1	1400	1480	80	0.07	1.06	2	2	0
0017	3T	3_1	134	71	8	7100	8280	1180	0.11	1.17	12	14	2
0017	3T	3_1	135	29	4	2900	3870	970	0.14	1.33	5	6	1
0017	3T	3_1	136	56	3	5600	2980	-2620	0.05	0.53	9	5	-4
0017	3T	3_1	142	1	0	100	0	-100	0.00	0.00	0	0	0
0017	3T	3_1	145	10	0	1000	0	-1000	0.00	0.00	1	0	-1
0017	3T	3_1	146	27	1	2700	830	-1870	0.04	0.31	4	1	-3
0017	3T	3_1	152	3	0	300	0	-300	0.00	0.00	0	0	0
0017	3T	3_1	153	10	0	1000	0	-1000	0.00	0.00	1	0	-1
0017	3T	3_1	154	3	0	300	0	-300	0.00	0.00	0	0	0
0017	3T	3_1	156	7	2	700	2580	1880	0.29	3.69	1	4	3
0017	3T	3_1	163	1	0	100	0	-100	0.00	0.00	0	0	0
0017	3T	3_1	165	1	0	100	0	-100	0.00	0.00	0	0	0
0017	3T	3_1	213	1	0	100	0	-100	0.00	0.00	0	0	0
0017	3T	3_1	214	1	0	100	0	-100	0.00	0.00	0	0	0
0017	3T	3_1	215	2	0	200	0	-200	0.00	0.00	0	0	0
0017	3T	3_1	216	2	0	200	0	-200	0.00	0.00	0	0	0
0017	3T	3_1	236	1	1	100	2300	2200	1.00	23.00	0	4	4
0017	3T	3_1	245	1	0	100	0	-100	0.00	0.00	0	0	0
0017	3T	3_1	246	1	0	100	0	-100	0.00	0.00	0	0	0
0017	3T	3_1	256	2	0	200	0	-200	0.00	0.00	0	0	0
0017	3T	3_2	123	116	20	11600	12540	940	0.17	1.08	20	22	2
0017	3T	3_2	124	217	20	21700	14630	-7070	0.09	0.67	38	25	-13
0017	3T	3_2	125	161	19	16100	20990	4890	0.12	1.30	28	37	9
0017	3T	3_2	126	138	13	13800	12140	-1660	0.09	0.88	24	21	-3
0017	3T	3_2	132	12	3	1200	1770	570	0.25	1.48	2	3	1
0017	3T	3_2	134	110	13	11000	10920	-80	0.12	0.99	19	19	0
0017	3T	3_2	135	72	8	7200	5850	-1350	0.11	0.81	12	10	-2
0017	3T	3_2	136	63	1	6300	1080	-5220	0.02	0.17	11	1	-10
0017	3T	3_2	145	66	2	6600	2880	-3720	0.03	0.44	11	5	-6
0017	3T	3_2	146	53	1	5300	1520	-3780	0.02	0.29	9	2	-7
0017	3T	3_2	153	1	0	100	0	-100	0.00	0.00	0	0	0
0017	3T	3_2	156	12	1	1200	5450	4250	0.08	4.54	2	9	7
0017	3T	3_2	213	1	0	100	0	-100	0.00	0.00	0	0	0
0017	3T	3_2	214	4	0	400	0	-400	0.00	0.00	0	0	0
0017	3T	3_2	215	5	0	500	0	-500	0.00	0.00	0	0	0
0017	3T	3_2	216	10	0	1000	0	-1000	0.00	0.00	1	0	-1
0017	3T	3_2	234	8	1	800	740	-60	0.13	0.93	1	1	0
0017	3T	3_2	235	8	1	800	680	-120	0.13	0.85	1	1	0
0017	3T	3_2	236	7	1	700	780	80	0.14	1.11	1	1	0
0017	3T	3_2	245	6	0	600	0	-600	0.00	0.00	1	0	-1
0017	3T	3_2	246	7	0	700	0	-700	0.00	0.00	1	0	-1
0017	3T	3_2	256	4	0	400	0	-400	0.00	0.00	0	0	0
0017	3T	3_3	123	105	19	10500	11420	920	0.18	1.09	18	20	2
0017	3T	3_3	124	328	42	32800	28070	-4730	0.13	0.86	58	49	-9
0017	3T	3_3	125	292	31	29200	28160	-1040	0.11	0.96	51	49	-2
0017	3T	3_3	126	316	24	31600	31860	260	0.08	1.01	55	56	1
0017	3T	3_3	132	5	0	500	0	-500	0.00	0.00	0	0	0
0017	3T	3_3	134	232	30	23200	19230	-3970	0.13	0.83	41	34	-7
0017	3T	3_3	135	237	16	23700	14670	-9030	0.07	0.62	41	25	-16
0017	3T	3_3	136	192	11	19200	11620	-7580	0.06	0.61	33	20	-13
0017	3T	3_3	142	1	1	100	580	480	1.00	5.80	0	1	1
0017	3T	3_3	143	2	0	200	0	-200	0.00	0.00	0	0	0
0017	3T	3_3	145	132	13	13200	10160	-3040	0.10	0.77	23	17	-6
0017	3T	3_3	146	108	5	10800	4450	-6350	0.05	0.41	19	7	-12
0017	3T	3_3	156	55	4	5500	6430	930	0.07	1.17	9	11	2
0017	3T	3_3	213	1	0	100	0	-100	0.00	0.00	0	0	0
0017	3T	3_3	214	49	0	4900	0	-4900	0.00	0.00	8	0	-8
0017	3T	3_3	215	57	3	5700	5540	-160	0.05	0.97	10	9	-1
0017	3T	3_3	216	82	2	8200	10400	2200	0.02	1.27	14	18	4
0017	3T	3_3	234	14	1	1400	1210	-190	0.07	0.86	2	2	0
0017	3T	3_3	235	32	0	3200	0	-3200	0.00	0.00	5	0	-5
0017	3T	3_3	236	22	0	2200	0	-2200	0.00	0.00	3	0	-3
0017	3T	3_3	245	24	3	2400	5150	2750	0.13	2.15	4	9	5
0017	3T	3_3	246	16	0	1600	0	-1600	0.00	0.00	2	0	-2
0017	3T	3_3	256	21	0	2100	0	-2100	0.00	0.00	3	0	-3
0017	3T	3_4	123	61	9	6100	5490	-610	0.15	0.90	10	9	-1
0017	3T	3_4	124	369	31	36900	25420	-11480	0.08	0.69	65	44	-21
0017	3T	3_4	125	378	21	37800	18430	-19370	0.06	0.49	66	32	-34
0017	3T	3_4	126	553	38	55300	60500	5200	0.07	1.09	97	107	10
0017	3T	3_4	134	177	19	17700	16050	-1650	0.11	0.91	31	28	-3
0017	3T	3_4	135	245	19	24500	23710	-790	0.08	0.97	43	41	-2
0017	3T	3_4	136	361	17	36100	17120	-18980	0.05	0.47	63	30	-33
0017	3T	3_4	145	89	4	8900	3680	-5220	0.04	0.41	15	6	-9
0017	3T	3_4	146	95	2	9500	2770	-6730	0.02	0.29	16	4	-12
0017	3T	3_4	154	2	0	200	0	-200	0.00	0.00	0	0	0
0017	3T	3_4	156	29	3	2900	5550	2650	0.10	1.91	5	9	4
0017	3T	3_4	164	2	0	200	0	-200	0.00	0.00	0	0	0
0017	3T	3_4	165	2	0	200	0	-200	0.00	0.00	0	0	0
0017	3T	3_4	214	3	0	300	0	-300	0.00	0.00	0	0	0
0017	3T	3_4	215	16	0	1600	0	-1600	0.00	0.00	2	0	-2
0017	3T	3_4	216	30	1	3000	2690	-310	0.03	0.90	5	4	-1
0017	3T	3_4	234	4	1	400	2160	1760	0.25	5.40	0	3	3
0017	3T	3_4	235	8	0	800	0	-800	0.00	0.00	1	0	-1
0017	3T	3_4	236	18	0	1800	0	-1800	0.00	0.00	3	0	-3
0017	3T	3_4	245	12	0	1200	0	-1200	0.00	0.00	2	0	-2
0017	3T	3_4	246	6	0	600	0	-600	0.00	0.00	1	0	-1
0017	3T	3_4	256	1	0	100	0	-100	0.00	0.00	0	0	0
0017	3T	3_5	123	15	2	1500	1000	-500	0.13	0.67	2	1	-1
0017	3T	3_5	124	147	14	14700	9240	-5460	0.10	0.63	26	16	-10
0017	3T	3_5	125	137	6	13700	5240	-8460	0.04	0.38	24	9	-15
0017	3T	3_5	126	179	6	17900	11830	-6070	0.03	0.66	31	20	-11
0017	3T	3_5	134	68	3	6800	1840	-4960	0.04	0.27	12	3	-9
0017	3T	3_5	135	68	6	6800	7130	330	0.09	1.05	12	12	0
0017	3T	3_5	136	99	6	9900	8230	-1670	0.06	0.83	17	14	-3
0017	3T	3_5	145	14	0	1400	0	-1400	0.00	0.00	2	0	-2
0017	3T	3_5	146	17	2	1700	2640	940	0.12	1.55	3	4	1
0017	3T	3_5	154	1	0	100	0	-100	0.00	0.00	0	0	0
0017	3T	3_5	156	2	0	200	0	-200	0.00	0.00	0	0	0
0017	3T	3_5	215	1	0	100	0	-100	0.00	0.00	0	0	0
0017	3T	3_5	216	3	0	300	0	-300	0.00	0.00	0	0	0
0017	3T	3_5	246	1	0	100	0	-100	0.00	0.00	0	0	0
0017	3T	3_6	123	3	0	300	0	-300	0.00	0.00	0	0	0
0017	3T	3_6	124	35	4	3500	3310	-190	0.11	0.95	6	5	-1
0017	3T	3_6	125	28	2	2800	3450	650	0.07	1.23	4	6	2
0017	3T	3_6	126	131	6	13100	16040	2940	0.05	1.22	23	28	5
0017	3T	3_6	134	8	2	800	1160	360	0.25	1.45	1	2	1
0017	3T	3_6	135	14	0	1400	0	-1400	0.00	0.00	2	0	-2
0017	3T	3_6	136	46	7	4600	14490	9890	0.15	3.15	8	25	17
0017	3T	3_6	145	2	0	200	0	-200	0.00	0.00	0	0	0
0017	3T	4_0	123	38	4	3800	3960	160	0.11	1.04	6	7	1
0017	3T	4_0	124	53	1	5300	740	-4560	0.02	0.14	9	1	-8
0017	3T	4_0	125	23	0	2300	0	-2300	0.00	0.00	4	0	-4
0017	3T	4_0	126	18	1	1800	4370	2570	0.06	2.43	3	7	4
0017	3T	4_0	134	27	3	2700	3490	790	0.11	1.29	4	6	2
0017	3T	4_0	135	8	0	800	0	-800	0.00	0.00	1	0	-1
0017	3T	4_0	136	3	0	300	0	-300	0.00	0.00	0	0	0
0017	3T	4_0	142	3	0	300	0	-300	0.00	0.00	0	0	0
0017	3T	4_0	143	3	0	300	0	-300	0.00	0.00	0	0	0
0017	3T	4_0	145	6	1	600	1530	930	0.17	2.55	1	2	1
0017	3T	4_0	146	4	0	400	0	-400	0.00	0.00	0	0	0
0017	3T	4_0	153	1	0	100	0	-100	0.00	0.00	0	0	0
0017	3T	4_0	156	4	0	400	0	-400	0.00	0.00	0	0	0
0017	3T	4_0	234	1	0	100	0	-100	0.00	0.00	0	0	0
0017	3T	4_0	236	4	0	400	0	-400	0.00	0.00	0	0	0
0017	3T	4_1	123	133	11	13300	6740	-6560	0.08	0.51	23	11	-12
0017	3T	4_1	124	215	19	21500	15060	-6440	0.09	0.70	38	26	-12
0017	3T	4_1	125	119	13	11900	11360	-540	0.11	0.95	21	20	-1
0017	3T	4_1	126	45	4	4500	6510	2010	0.09	1.45	7	11	4
0017	3T	4_1	132	3	0	300	0	-300	0.00	0.00	0	0	0
0017	3T	4_1	134	99	3	9900	2080	-7820	0.03	0.21	17	3	-14
0017	3T	4_1	135	37	1	3700	680	-3020	0.03	0.18	6	1	-5
0017	3T	4_1	136	17	1	1700	650	-1050	0.06	0.38	3	1	-2
0017	3T	4_1	142	4	2	400	2680	2280	0.50	6.70	0	4	4
0017	3T	4_1	145	12	0	1200	0	-1200	0.00	0.00	2	0	-2
0017	3T	4_1	146	8	1	800	870	70	0.13	1.09	1	1	0
0017	3T	4_1	153	2	0	200	0	-200	0.00	0.00	0	0	0
0017	3T	4_1	156	3	1	300	1200	900	0.33	4.00	0	2	2
0017	3T	4_1	236	1	0	100	0	-100	0.00	0.00	0	0	0
0017	3T	4_2	123	148	23	14800	12950	-1850	0.16	0.88	26	22	-4
0017	3T	4_2	124	229	20	22900	15300	-7600	0.09	0.67	40	27	-13
0017	3T	4_2	125	205	17	20500	15940	-4560	0.08	0.78	36	28	-8
0017	3T	4_2	126	95	11	9500	17490	7990	0.12	1.84	16	30	14
0017	3T	4_2	132	1	1	100	600	500	1.00	6.00	0	1	1
0017	3T	4_2	134	126	10	12600	6970	-5630	0.08	0.55	22	12	-10
0017	3T	4_2	135	71	1	7100	1800	-5300	0.01	0.25	12	3	-9
0017	3T	4_2	136	51	6	5100	6040	940	0.12	1.18	9	10	1
0017	3T	4_2	142	2	1	200	450	250	0.50	2.25	0	0	0
0017	3T	4_2	143	1	0	100	0	-100	0.00	0.00	0	0	0
0017	3T	4_2	145	40	3	4000	2910	-1090	0.08	0.73	7	5	-2
0017	3T	4_2	146	19	2	1900	1650	-250	0.11	0.87	3	2	-1
0017	3T	4_2	153	1	0	100	0	-100	0.00	0.00	0	0	0
0017	3T	4_2	154	1	0	100	0	-100	0.00	0.00	0	0	0
0017	3T	4_2	156	17	0	1700	0	-1700	0.00	0.00	3	0	-3
0017	3T	4_2	213	1	0	100	0	-100	0.00	0.00	0	0	0
0017	3T	4_2	215	2	0	200	0	-200	0.00	0.00	0	0	0
0017	3T	4_2	234	8	0	800	0	-800	0.00	0.00	1	0	-1
0017	3T	4_2	235	9	1	900	570	-330	0.11	0.63	1	1	0
0017	3T	4_2	236	2	0	200	0	-200	0.00	0.00	0	0	0
0017	3T	4_2	245	1	0	100	0	-100	0.00	0.00	0	0	0
0017	3T	4_2	246	5	0	500	0	-500	0.00	0.00	0	0	0
0017	3T	4_2	256	1	0	100	0	-100	0.00	0.00	0	0	0
0017	3T	4_3	123	266	34	26600	17830	-8770	0.13	0.67	47	31	-16
0017	3T	4_3	124	436	39	43600	30710	-12890	0.09	0.70	77	54	-23
0017	3T	4_3	125	326	20	32600	20580	-12020	0.06	0.63	57	36	-21
0017	3T	4_3	126	225	9	22500	11730	-10770	0.04	0.52	39	20	-19
0017	3T	4_3	134	277	46	27700	34530	6830	0.17	1.25	49	61	12
0017	3T	4_3	135	254	31	25400	22310	-3090	0.12	0.88	44	39	-5
0017	3T	4_3	136	154	15	15400	12030	-3370	0.10	0.78	27	21	-6
0017	3T	4_3	142	1	0	100	0	-100	0.00	0.00	0	0	0
0017	3T	4_3	143	1	0	100	0	-100	0.00	0.00	0	0	0
0017	3T	4_3	145	118	11	11800	17660	5860	0.09	1.50	20	31	11
0017	3T	4_3	146	64	3	6400	3950	-2450	0.05	0.62	11	6	-5
0017	3T	4_3	154	1	0	100	0	-100	0.00	0.00	0	0	0
0017	3T	4_3	156	36	1	3600	2080	-1520	0.03	0.58	6	3	-3
0017	3T	4_3	213	2	0	200	0	-200	0.00	0.00	0	0	0
0017	3T	4_3	214	6	0	600	0	-600	0.00	0.00	1	0	-1
0017	3T	4_3	215	3	0	300	0	-300	0.00	0.00	0	0	0
0017	3T	4_3	216	6	0	600	0	-600	0.00	0.00	1	0	-1
0017	3T	4_3	234	20	1	2000	2050	50	0.05	1.03	3	3	0
0017	3T	4_3	235	28	2	2800	2210	-590	0.07	0.79	4	3	-1
0017	3T	4_3	236	24	4	2400	4940	2540	0.17	2.06	4	8	4
0017	3T	4_3	245	14	0	1400	0	-1400	0.00	0.00	2	0	-2
0017	3T	4_3	246	8	0	800	0	-800	0.00	0.00	1	0	-1
0017	3T	4_3	253	1	0	100	0	-100	0.00	0.00	0	0	0
0017	3T	4_3	256	9	0	900	0	-900	0.00	0.00	1	0	-1
0017	3T	4_4	123	265	33	26500	19340	-7160	0.12	0.73	46	34	-12
0017	3T	4_4	124	572	59	57200	51940	-5260	0.10	0.91	101	91	-10
0017	3T	4_4	125	297	19	29700	21720	-7980	0.06	0.73	52	38	-14
0017	3T	4_4	126	140	3	14000	6590	-7410	0.02	0.47	24	11	-13
0017	3T	4_4	132	1	0	100	0	-100	0.00	0.00	0	0	0
0017	3T	4_4	134	179	21	17900	15940	-1960	0.12	0.89	31	28	-3
0017	3T	4_4	135	167	20	16700	20790	4090	0.12	1.24	29	36	7
0017	3T	4_4	136	89	7	8900	12840	3940	0.08	1.44	15	22	7
0017	3T	4_4	142	5	0	500	0	-500	0.00	0.00	0	0	0
0017	3T	4_4	145	44	4	4400	6290	1890	0.09	1.43	7	11	4
0017	3T	4_4	146	35	2	3500	2870	-630	0.06	0.82	6	5	-1
0017	3T	4_4	154	1	0	100	0	-100	0.00	0.00	0	0	0
0017	3T	4_4	156	15	0	1500	0	-1500	0.00	0.00	2	0	-2
0017	3T	4_4	214	4	0	400	0	-400	0.00	0.00	0	0	0
0017	3T	4_4	215	1	0	100	0	-100	0.00	0.00	0	0	0
0017	3T	4_4	216	4	0	400	0	-400	0.00	0.00	0	0	0
0017	3T	4_4	234	5	0	500	0	-500	0.00	0.00	0	0	0
0017	3T	4_4	235	4	0	400	0	-400	0.00	0.00	0	0	0
0017	3T	4_4	236	3	0	300	0	-300	0.00	0.00	0	0	0
0017	3T	4_4	245	7	0	700	0	-700	0.00	0.00	1	0	-1
0017	3T	4_4	246	4	1	400	1100	700	0.25	2.75	0	1	1
0017	3T	4_5	123	101	18	10100	12540	2440	0.18	1.24	17	22	5
0017	3T	4_5	124	399	32	39900	25780	-14120	0.08	0.65	70	45	-25
0017	3T	4_5	125	81	4	8100	6540	-1560	0.05	0.81	14	11	-3
0017	3T	4_5	126	41	0	4100	0	-4100	0.00	0.00	7	0	-7
0017	3T	4_5	132	1	0	100	0	-100	0.00	0.00	0	0	0
0017	3T	4_5	134	73	9	7300	12390	5090	0.12	1.70	12	21	9
0017	3T	4_5	135	40	3	4000	2920	-1080	0.08	0.73	7	5	-2
0017	3T	4_5	136	16	3	1600	2400	800	0.19	1.50	2	4	2
0017	3T	4_5	142	1	0	100	0	-100	0.00	0.00	0	0	0
0017	3T	4_5	145	9	1	900	1020	120	0.11	1.13	1	1	0
0017	3T	4_5	146	5	0	500	0	-500	0.00	0.00	0	0	0
0017	3T	4_5	236	1	0	100	0	-100	0.00	0.00	0	0	0
0017	3T	4_6	123	29	2	2900	1310	-1590	0.07	0.45	5	2	-3
0017	3T	4_6	124	199	14	19900	11860	-8040	0.07	0.60	35	20	-15
0017	3T	4_6	125	4	1	400	820	420	0.25	2.05	0	1	1
0017	3T	4_6	126	32	4	3200	9160	5960	0.13	2.86	5	16	11
0017	3T	4_6	134	18	0	1800	0	-1800	0.00	0.00	3	0	-3
0017	3T	4_6	135	3	0	300	0	-300	0.00	0.00	0	0	0
0017	3T	4_6	136	4	0	400	0	-400	0.00	0.00	0	0	0
0017	3T	4_6	146	3	0	300	0	-300	0.00	0.00	0	0	0
0017	3T	5_-1	123	1	0	100	0	-100	0.00	0.00	0	0	0
0017	3T	5_-1	124	6	0	600	0	-600	0.00	0.00	1	0	-1
0017	3T	5_-1	125	1	0	100	0	-100	0.00	0.00	0	0	0
0017	3T	5_-1	135	2	0	200	0	-200	0.00	0.00	0	0	0
0017	3T	5_-1	143	1	0	100	0	-100	0.00	0.00	0	0	0
0017	3T	5_-1	145	1	0	100	0	-100	0.00	0.00	0	0	0
0017	3T	5_-1	156	1	0	100	0	-100	0.00	0.00	0	0	0
0017	3T	5_0	123	122	15	12200	12600	400	0.12	1.03	21	22	1
0017	3T	5_0	124	70	5	7000	3570	-3430	0.07	0.51	12	6	-6
0017	3T	5_0	125	56	4	5600	4940	-660	0.07	0.88	9	8	-1
0017	3T	5_0	126	15	1	1500	1490	-10	0.07	0.99	2	2	0
0017	3T	5_0	134	23	4	2300	3060	760	0.17	1.33	4	5	1
0017	3T	5_0	135	26	3	2600	5360	2760	0.12	2.06	4	9	5
0017	3T	5_0	136	4	0	400	0	-400	0.00	0.00	0	0	0
0017	3T	5_0	145	3	0	300	0	-300	0.00	0.00	0	0	0
0017	3T	5_0	146	2	0	200	0	-200	0.00	0.00	0	0	0
0017	3T	5_0	152	1	0	100	0	-100	0.00	0.00	0	0	0
0017	3T	5_0	153	2	0	200	0	-200	0.00	0.00	0	0	0
0017	3T	5_0	154	2	0	200	0	-200	0.00	0.00	0	0	0
0017	3T	5_0	163	1	0	100	0	-100	0.00	0.00	0	0	0
0017	3T	5_0	235	2	0	200	0	-200	0.00	0.00	0	0	0
0017	3T	5_1	123	145	16	14500	11440	-3060	0.11	0.79	25	20	-5
0017	3T	5_1	124	191	25	19100	18620	-480	0.13	0.97	33	32	-1
0017	3T	5_1	125	103	8	10300	8960	-1340	0.08	0.87	18	15	-3
0017	3T	5_1	126	54	5	5400	5050	-350	0.09	0.94	9	8	-1
0017	3T	5_1	134	55	6	5500	4070	-1430	0.11	0.74	9	7	-2
0017	3T	5_1	135	21	1	2100	820	-1280	0.05	0.39	3	1	-2
0017	3T	5_1	136	16	0	1600	0	-1600	0.00	0.00	2	0	-2
0017	3T	5_1	143	2	0	200	0	-200	0.00	0.00	0	0	0
0017	3T	5_1	145	12	0	1200	0	-1200	0.00	0.00	2	0	-2
0017	3T	5_1	146	5	0	500	0	-500	0.00	0.00	0	0	0
0017	3T	5_1	154	1	0	100	0	-100	0.00	0.00	0	0	0
0017	3T	5_1	234	1	0	100	0	-100	0.00	0.00	0	0	0
0017	3T	5_1	235	1	0	100	0	-100	0.00	0.00	0	0	0
0017	3T	5_1	236	1	0	100	0	-100	0.00	0.00	0	0	0
0017	3T	5_2	123	93	10	9300	4880	-4420	0.11	0.52	16	8	-8
0017	3T	5_2	124	229	26	22900	14820	-8080	0.11	0.65	40	26	-14
0017	3T	5_2	125	122	7	12200	5780	-6420	0.06	0.47	21	10	-11
0017	3T	5_2	126	93	11	9300	18200	8900	0.12	1.96	16	32	16
0017	3T	5_2	132	1	0	100	0	-100	0.00	0.00	0	0	0
0017	3T	5_2	134	127	14	12700	12320	-380	0.11	0.97	22	21	-1
0017	3T	5_2	135	74	5	7400	3850	-3550	0.07	0.52	13	6	-7
0017	3T	5_2	136	47	8	4700	9120	4420	0.17	1.94	8	16	8
0017	3T	5_2	145	33	3	3300	3060	-240	0.09	0.93	5	5	0
0017	3T	5_2	146	33	1	3300	830	-2470	0.03	0.25	5	1	-4
0017	3T	5_2	156	12	0	1200	0	-1200	0.00	0.00	2	0	-2
0017	3T	5_2	164	1	0	100	0	-100	0.00	0.00	0	0	0
0017	3T	5_2	215	1	0	100	0	-100	0.00	0.00	0	0	0
0017	3T	5_2	216	4	0	400	0	-400	0.00	0.00	0	0	0
0017	3T	5_2	234	4	0	400	0	-400	0.00	0.00	0	0	0
0017	3T	5_2	235	2	0	200	0	-200	0.00	0.00	0	0	0
0017	3T	5_2	236	4	0	400	0	-400	0.00	0.00	0	0	0
0017	3T	5_2	245	2	0	200	0	-200	0.00	0.00	0	0	0
0017	3T	5_3	123	104	15	10400	6690	-3710	0.14	0.64	18	11	-7
0017	3T	5_3	124	410	41	41000	28310	-12690	0.10	0.69	72	50	-22
0017	3T	5_3	125	263	25	26300	22620	-3680	0.10	0.86	46	40	-6
0017	3T	5_3	126	219	15	21900	22390	490	0.07	1.02	38	39	1
0017	3T	5_3	134	227	16	22700	10720	-11980	0.07	0.47	40	18	-22
0017	3T	5_3	135	167	15	16700	13180	-3520	0.09	0.79	29	23	-6
0017	3T	5_3	136	150	16	15000	22580	7580	0.11	1.51	26	39	13
0017	3T	5_3	142	2	0	200	0	-200	0.00	0.00	0	0	0
0017	3T	5_3	145	140	8	14000	6430	-7570	0.06	0.46	24	11	-13
0017	3T	5_3	146	62	5	6200	5830	-370	0.08	0.94	10	10	0
0017	3T	5_3	156	41	5	4100	6540	2440	0.12	1.60	7	11	4
0017	3T	5_3	164	5	1	500	980	480	0.20	1.96	0	1	1
0017	3T	5_3	165	1	0	100	0	-100	0.00	0.00	0	0	0
0017	3T	5_3	214	3	0	300	0	-300	0.00	0.00	0	0	0
0017	3T	5_3	215	5	0	500	0	-500	0.00	0.00	0	0	0
0017	3T	5_3	216	5	1	500	1470	970	0.20	2.94	0	2	2
0017	3T	5_3	234	7	0	700	0	-700	0.00	0.00	1	0	-1
0017	3T	5_3	235	6	1	600	2810	2210	0.17	4.68	1	4	3
0017	3T	5_3	236	7	0	700	0	-700	0.00	0.00	1	0	-1
0017	3T	5_3	246	5	0	500	0	-500	0.00	0.00	0	0	0
0017	3T	5_4	123	89	12	8900	5630	-3270	0.13	0.63	15	9	-6
0017	3T	5_4	124	409	43	40900	27430	-13470	0.11	0.67	72	48	-24
0017	3T	5_4	125	244	14	24400	15050	-9350	0.06	0.62	43	26	-17
0017	3T	5_4	126	172	7	17200	9930	-7270	0.04	0.58	30	17	-13
0017	3T	5_4	134	106	9	10600	7130	-3470	0.08	0.67	18	12	-6
0017	3T	5_4	135	107	7	10700	9990	-710	0.07	0.93	18	17	-1
0017	3T	5_4	136	85	6	8500	11290	2790	0.07	1.33	15	19	4
0017	3T	5_4	145	44	4	4400	3660	-740	0.09	0.83	7	6	-1
0017	3T	5_4	146	36	1	3600	930	-2670	0.03	0.26	6	1	-5
0017	3T	5_4	154	1	0	100	0	-100	0.00	0.00	0	0	0
0017	3T	5_4	156	16	2	1600	1820	220	0.13	1.14	2	3	1
0017	3T	5_4	214	1	0	100	0	-100	0.00	0.00	0	0	0
0017	3T	5_4	215	3	0	300	0	-300	0.00	0.00	0	0	0
0017	3T	5_4	216	12	0	1200	0	-1200	0.00	0.00	2	0	-2
0017	3T	5_4	234	1	0	100	0	-100	0.00	0.00	0	0	0
0017	3T	5_4	235	4	0	400	0	-400	0.00	0.00	0	0	0
0017	3T	5_4	236	6	0	600	0	-600	0.00	0.00	1	0	-1
0017	3T	5_4	246	3	0	300	0	-300	0.00	0.00	0	0	0
0017	3T	5_4	256	1	0	100	0	-100	0.00	0.00	0	0	0
0017	3T	5_5	123	142	27	14200	15180	980	0.19	1.07	25	26	1
0017	3T	5_5	124	355	28	35500	17970	-17530	0.08	0.51	62	31	-31
0017	3T	5_5	125	122	9	12200	8400	-3800	0.07	0.69	21	14	-7
0017	3T	5_5	126	118	11	11800	22940	11140	0.09	1.94	20	40	20
0017	3T	5_5	134	30	2	3000	2080	-920	0.07	0.69	5	3	-2
0017	3T	5_5	135	32	2	3200	3250	50	0.06	1.02	5	5	0
0017	3T	5_5	136	28	1	2800	2440	-360	0.04	0.87	4	4	0
0017	3T	5_5	145	6	0	600	0	-600	0.00	0.00	1	0	-1
0017	3T	5_5	146	5	0	500	0	-500	0.00	0.00	0	0	0
0017	3T	5_5	215	2	0	200	0	-200	0.00	0.00	0	0	0
0017	3T	5_6	123	18	5	1800	2710	910	0.28	1.51	3	4	1
0017	3T	5_6	124	172	21	17200	17100	-100	0.12	0.99	30	30	0
0017	3T	5_6	125	31	0	3100	0	-3100	0.00	0.00	5	0	-5
0017	3T	5_6	126	40	0	4000	0	-4000	0.00	0.00	7	0	-7
0017	3T	5_6	134	7	0	700	0	-700	0.00	0.00	1	0	-1
0017	3T	5_6	135	3	0	300	0	-300	0.00	0.00	0	0	0
0017	3T	5_6	136	11	0	1100	0	-1100	0.00	0.00	1	0	-1
0017	3T	6_0	123	4	0	400	0	-400	0.00	0.00	0	0	0
0017	3T	6_0	124	4	1	400	590	190	0.25	1.48	0	1	1
0017	3T	6_0	125	2	0	200	0	-200	0.00	0.00	0	0	0
0017	3T	6_0	126	1	0	100	0	-100	0.00	0.00	0	0	0
0017	3T	6_0	132	2	2	200	1670	1470	1.00	8.35	0	2	2
0017	3T	6_0	134	3	1	300	680	380	0.33	2.27	0	1	1
0017	3T	6_0	135	2	0	200	0	-200	0.00	0.00	0	0	0
0017	3T	6_0	236	1	0	100	0	-100	0.00	0.00	0	0	0
0017	3T	6_1	123	5	1	500	1000	500	0.20	2.00	0	1	1
0017	3T	6_1	124	10	1	1000	560	-440	0.10	0.56	1	0	-1
0017	3T	6_1	125	9	1	900	1370	470	0.11	1.52	1	2	1
0017	3T	6_1	126	3	1	300	980	680	0.33	3.27	0	1	1
0017	3T	6_1	134	4	0	400	0	-400	0.00	0.00	0	0	0
0017	3T	6_1	135	2	0	200	0	-200	0.00	0.00	0	0	0
0017	3T	6_1	136	3	1	300	870	570	0.33	2.90	0	1	1
0017	3T	6_1	143	1	0	100	0	-100	0.00	0.00	0	0	0
0017	3T	6_1	145	3	1	300	770	470	0.33	2.57	0	1	1
0017	3T	6_1	146	2	0	200	0	-200	0.00	0.00	0	0	0
0017	3T	6_2	123	8	0	800	0	-800	0.00	0.00	1	0	-1
0017	3T	6_2	124	12	2	1200	760	-440	0.17	0.63	2	1	-1
0017	3T	6_2	125	8	1	800	670	-130	0.13	0.84	1	1	0
0017	3T	6_2	126	4	0	400	0	-400	0.00	0.00	0	0	0
0017	3T	6_2	132	1	0	100	0	-100	0.00	0.00	0	0	0
0017	3T	6_2	134	2	0	200	0	-200	0.00	0.00	0	0	0
0017	3T	6_2	135	5	0	500	0	-500	0.00	0.00	0	0	0
0017	3T	6_2	136	3	0	300	0	-300	0.00	0.00	0	0	0
0017	3T	6_2	145	1	0	100	0	-100	0.00	0.00	0	0	0
0017	3T	6_2	146	1	0	100	0	-100	0.00	0.00	0	0	0
0017	3T	6_2	156	2	0	200	0	-200	0.00	0.00	0	0	0
0017	3T	6_3	123	23	1	2300	610	-1690	0.04	0.27	4	1	-3
0017	3T	6_3	124	25	1	2500	440	-2060	0.04	0.18	4	0	-4
0017	3T	6_3	125	17	3	1700	4510	2810	0.18	2.65	3	7	4
0017	3T	6_3	126	20	2	2000	10250	8250	0.10	5.13	3	18	15
0017	3T	6_3	134	12	3	1200	2010	810	0.25	1.68	2	3	1
0017	3T	6_3	135	15	1	1500	320	-1180	0.07	0.21	2	0	-2
0017	3T	6_3	136	13	0	1300	0	-1300	0.00	0.00	2	0	-2
0017	3T	6_3	145	11	0	1100	0	-1100	0.00	0.00	1	0	-1
0017	3T	6_3	146	5	1	500	640	140	0.20	1.28	0	1	1
0017	3T	6_3	156	3	0	300	0	-300	0.00	0.00	0	0	0
0017	3T	6_4	123	20	5	2000	2570	570	0.25	1.29	3	4	1
0017	3T	6_4	124	39	2	3900	850	-3050	0.05	0.22	6	1	-5
0017	3T	6_4	125	17	2	1700	2630	930	0.12	1.55	3	4	1
0017	3T	6_4	126	9	1	900	1560	660	0.11	1.73	1	2	1
0017	3T	6_4	134	11	2	1100	1420	320	0.18	1.29	1	2	1
0017	3T	6_4	135	13	2	1300	1810	510	0.15	1.39	2	3	1
0017	3T	6_4	136	7	0	700	0	-700	0.00	0.00	1	0	-1
0017	3T	6_4	145	4	1	400	820	420	0.25	2.05	0	1	1
0017	3T	6_4	146	3	0	300	0	-300	0.00	0.00	0	0	0
0017	3T	6_4	156	2	0	200	0	-200	0.00	0.00	0	0	0
0017	3T	6_4	236	2	0	200	0	-200	0.00	0.00	0	0	0
0017	3T	6_5	123	10	1	1000	680	-320	0.10	0.68	1	1	0
0017	3T	6_5	124	43	5	4300	3460	-840	0.12	0.80	7	6	-1
0017	3T	6_5	125	2	0	200	0	-200	0.00	0.00	0	0	0
0017	3T	6_5	126	7	0	700	0	-700	0.00	0.00	1	0	-1
0017	3T	6_5	134	2	0	200	0	-200	0.00	0.00	0	0	0
0017	3T	6_5	135	3	0	300	0	-300	0.00	0.00	0	0	0
0017	3T	6_5	214	1	0	100	0	-100	0.00	0.00	0	0	0
0017	3T	6_6	123	9	3	900	1400	500	0.33	1.56	1	2	1
0017	3T	6_6	124	16	2	1600	2380	780	0.13	1.49	2	4	2
0017	3T	6_6	126	1	0	100	0	-100	0.00	0.00	0	0	0
0017	3T	6_6	134	2	0	200	0	-200	0.00	0.00	0	0	0
0017	3T	7_-1	123	3	1	300	590	290	0.33	1.97	0	1	1
0017	3T	7_-1	124	5	0	500	0	-500	0.00	0.00	0	0	0
0017	3T	7_-1	126	5	0	500	0	-500	0.00	0.00	0	0	0
0017	3T	7_-1	135	1	0	100	0	-100	0.00	0.00	0	0	0
0017	3T	7_-1	136	2	0	200	0	-200	0.00	0.00	0	0	0
0017	3T	7_-1	146	1	0	100	0	-100	0.00	0.00	0	0	0
0017	3T	7_-1	156	1	0	100	0	-100	0.00	0.00	0	0	0
0017	3T	7_0	123	194	20	19400	13910	-5490	0.10	0.72	34	24	-10
0017	3T	7_0	124	153	7	15300	8820	-6480	0.05	0.58	27	15	-12
0017	3T	7_0	125	110	12	11000	13860	2860	0.11	1.26	19	24	5
0017	3T	7_0	126	63	3	6300	5680	-620	0.05	0.90	11	10	-1
0017	3T	7_0	132	1	0	100	0	-100	0.00	0.00	0	0	0
0017	3T	7_0	134	51	3	5100	2740	-2360	0.06	0.54	9	4	-5
0017	3T	7_0	135	34	1	3400	2440	-960	0.03	0.72	6	4	-2
0017	3T	7_0	136	15	3	1500	5290	3790	0.20	3.53	2	9	7
0017	3T	7_0	142	1	0	100	0	-100	0.00	0.00	0	0	0
0017	3T	7_0	143	1	0	100	0	-100	0.00	0.00	0	0	0
0017	3T	7_0	145	15	2	1500	2280	780	0.13	1.52	2	4	2
0017	3T	7_0	146	3	1	300	1600	1300	0.33	5.33	0	2	2
0017	3T	7_0	153	1	0	100	0	-100	0.00	0.00	0	0	0
0017	3T	7_0	156	2	0	200	0	-200	0.00	0.00	0	0	0
0017	3T	7_0	234	2	0	200	0	-200	0.00	0.00	0	0	0
0017	3T	7_0	235	3	0	300	0	-300	0.00	0.00	0	0	0
0017	3T	7_0	236	2	0	200	0	-200	0.00	0.00	0	0	0
0017	3T	7_1	123	456	59	45600	37020	-8580	0.13	0.81	80	65	-15
0017	3T	7_1	124	475	43	47500	35810	-11690	0.09	0.75	84	63	-21
0017	3T	7_1	125	153	20	15300	16620	1320	0.13	1.09	27	29	2
0017	3T	7_1	126	118	12	11800	16090	4290	0.10	1.36	20	28	8
0017	3T	7_1	132	2	0	200	0	-200	0.00	0.00	0	0	0
0017	3T	7_1	134	151	15	15100	12620	-2480	0.10	0.84	26	22	-4
0017	3T	7_1	135	90	9	9000	9960	960	0.10	1.11	15	17	2
0017	3T	7_1	136	29	1	2900	510	-2390	0.03	0.18	5	0	-5
0017	3T	7_1	142	3	1	300	670	370	0.33	2.23	0	1	1
0017	3T	7_1	143	1	0	100	0	-100	0.00	0.00	0	0	0
0017	3T	7_1	145	26	2	2600	3520	920	0.08	1.35	4	6	2
0017	3T	7_1	146	17	1	1700	2300	600	0.06	1.35	3	4	1
0017	3T	7_1	153	3	1	300	1500	1200	0.33	5.00	0	2	2
0017	3T	7_1	156	2	1	200	1910	1710	0.50	9.55	0	3	3
0017	3T	7_1	234	6	1	600	2290	1690	0.17	3.82	1	4	3
0017	3T	7_1	235	4	0	400	0	-400	0.00	0.00	0	0	0
0017	3T	7_1	236	2	0	200	0	-200	0.00	0.00	0	0	0
0017	3T	7_1	245	3	0	300	0	-300	0.00	0.00	0	0	0
0017	3T	7_2	123	335	53	33500	35920	2420	0.16	1.07	59	63	4
0017	3T	7_2	124	497	45	49700	39080	-10620	0.09	0.79	87	69	-18
0017	3T	7_2	125	341	26	34100	25190	-8910	0.08	0.74	60	44	-16
0017	3T	7_2	126	289	17	28900	19570	-9330	0.06	0.68	51	34	-17
0017	3T	7_2	134	194	19	19400	18040	-1360	0.10	0.93	34	31	-3
0017	3T	7_2	135	154	9	15400	8750	-6650	0.06	0.57	27	15	-12
0017	3T	7_2	136	133	9	13300	10020	-3280	0.07	0.75	23	17	-6
0017	3T	7_2	142	2	1	200	660	460	0.50	3.30	0	1	1
0017	3T	7_2	143	3	0	300	0	-300	0.00	0.00	0	0	0
0017	3T	7_2	145	67	2	6700	2430	-4270	0.03	0.36	11	4	-7
0017	3T	7_2	146	57	5	5700	12450	6750	0.09	2.18	10	22	12
0017	3T	7_2	153	1	0	100	0	-100	0.00	0.00	0	0	0
0017	3T	7_2	156	19	0	1900	0	-1900	0.00	0.00	3	0	-3
0017	3T	7_2	165	2	0	200	0	-200	0.00	0.00	0	0	0
0017	3T	7_2	234	9	0	900	0	-900	0.00	0.00	1	0	-1
0017	3T	7_2	235	11	0	1100	0	-1100	0.00	0.00	1	0	-1
0017	3T	7_2	236	4	1	400	5030	4630	0.25	12.58	0	8	8
0017	3T	7_2	245	4	0	400	0	-400	0.00	0.00	0	0	0
0017	3T	7_2	246	1	0	100	0	-100	0.00	0.00	0	0	0
0017	3T	7_2	256	1	0	100	0	-100	0.00	0.00	0	0	0
0017	3T	7_3	123	287	40	28700	19330	-9370	0.14	0.67	50	34	-16
0017	3T	7_3	124	597	56	59700	40520	-19180	0.09	0.68	105	71	-34
0017	3T	7_3	125	413	37	41300	37390	-3910	0.09	0.91	73	66	-7
0017	3T	7_3	126	430	24	43000	32080	-10920	0.06	0.75	76	56	-20
0017	3T	7_3	134	244	25	24400	16850	-7550	0.10	0.69	43	29	-14
0017	3T	7_3	135	229	15	22900	13150	-9750	0.07	0.57	40	23	-17
0017	3T	7_3	136	225	17	22500	18640	-3860	0.08	0.83	39	32	-7
0017	3T	7_3	143	1	0	100	0	-100	0.00	0.00	0	0	0
0017	3T	7_3	145	93	8	9300	11810	2510	0.09	1.27	16	20	4
0017	3T	7_3	146	81	4	8100	2970	-5130	0.05	0.37	14	5	-9
0017	3T	7_3	154	2	0	200	0	-200	0.00	0.00	0	0	0
0017	3T	7_3	156	34	3	3400	3090	-310	0.09	0.91	6	5	-1
0017	3T	7_3	164	6	0	600	0	-600	0.00	0.00	1	0	-1
0017	3T	7_3	165	1	0	100	0	-100	0.00	0.00	0	0	0
0017	3T	7_3	214	1	0	100	0	-100	0.00	0.00	0	0	0
0017	3T	7_3	216	2	0	200	0	-200	0.00	0.00	0	0	0
0017	3T	7_3	234	7	0	700	0	-700	0.00	0.00	1	0	-1
0017	3T	7_3	235	7	0	700	0	-700	0.00	0.00	1	0	-1
0017	3T	7_3	236	10	0	1000	0	-1000	0.00	0.00	1	0	-1
0017	3T	7_3	245	1	0	100	0	-100	0.00	0.00	0	0	0
0017	3T	7_3	246	3	0	300	0	-300	0.00	0.00	0	0	0
0017	3T	7_3	256	1	0	100	0	-100	0.00	0.00	0	0	0
0017	3T	7_4	123	161	20	16100	13380	-2720	0.12	0.83	28	23	-5
0017	3T	7_4	124	418	46	41800	37400	-4400	0.11	0.89	73	66	-7
0017	3T	7_4	125	265	19	26500	21910	-4590	0.07	0.83	46	38	-8
0017	3T	7_4	126	174	9	17400	18400	1000	0.05	1.06	30	32	2
0017	3T	7_4	134	121	7	12100	5490	-6610	0.06	0.45	21	9	-12
0017	3T	7_4	135	113	8	11300	7250	-4050	0.07	0.64	20	12	-8
0017	3T	7_4	136	66	2	6600	5350	-1250	0.03	0.81	11	9	-2
0017	3T	7_4	145	32	0	3200	0	-3200	0.00	0.00	5	0	-5
0017	3T	7_4	146	20	2	2000	3440	1440	0.10	1.72	3	6	3
0017	3T	7_4	156	8	0	800	0	-800	0.00	0.00	1	0	-1
0017	3T	7_4	215	1	0	100	0	-100	0.00	0.00	0	0	0
0017	3T	7_4	216	3	0	300	0	-300	0.00	0.00	0	0	0
0017	3T	7_4	234	2	0	200	0	-200	0.00	0.00	0	0	0
0017	3T	7_4	235	1	0	100	0	-100	0.00	0.00	0	0	0
0017	3T	7_4	236	2	0	200	0	-200	0.00	0.00	0	0	0
0017	3T	7_4	245	1	0	100	0	-100	0.00	0.00	0	0	0
0017	3T	7_4	246	2	0	200	0	-200	0.00	0.00	0	0	0
0017	3T	7_5	123	163	30	16300	19850	3550	0.18	1.22	28	35	7
0017	3T	7_5	124	467	38	46700	29770	-16930	0.08	0.64	82	52	-30
0017	3T	7_5	125	121	5	12100	4880	-7220	0.04	0.40	21	8	-13
0017	3T	7_5	126	110	4	11000	7980	-3020	0.04	0.73	19	14	-5
0017	3T	7_5	134	49	3	4900	2480	-2420	0.06	0.51	8	4	-4
0017	3T	7_5	135	31	0	3100	0	-3100	0.00	0.00	5	0	-5
0017	3T	7_5	136	22	0	2200	0	-2200	0.00	0.00	3	0	-3
0017	3T	7_5	145	4	0	400	0	-400	0.00	0.00	0	0	0
0017	3T	7_5	146	5	0	500	0	-500	0.00	0.00	0	0	0
0017	3T	7_5	154	1	0	100	0	-100	0.00	0.00	0	0	0
0017	3T	7_5	216	1	0	100	0	-100	0.00	0.00	0	0	0
0017	3T	7_5	235	1	0	100	0	-100	0.00	0.00	0	0	0
0017	3T	7_6	123	118	13	11800	9240	-2560	0.11	0.78	20	16	-4
0017	3T	7_6	124	450	31	45000	29140	-15860	0.07	0.65	79	51	-28
0017	3T	7_6	125	30	1	3000	1230	-1770	0.03	0.41	5	2	-3
0017	3T	7_6	126	74	0	7400	0	-7400	0.00	0.00	13	0	-13
0017	3T	7_6	134	17	3	1700	4650	2950	0.18	2.74	3	8	5
0017	3T	7_6	135	6	0	600	0	-600	0.00	0.00	1	0	-1
0017	3T	7_6	136	6	0	600	0	-600	0.00	0.00	1	0	-1
0017	3T	7_6	146	3	0	300	0	-300	0.00	0.00	0	0	0
0017	3T	7_6	216	1	0	100	0	-100	0.00	0.00	0	0	0
0025	3T	20	236	2	0	200	0	-200	0.00	0.00	0	0	0
0025	3T	20	245	3	0	300	0	-300	0.00	0.00	0	0	0
0025	3T	20	246	1	0	100	0	-100	0.00	0.00	0	0	0
0025	3T	20	253	1	0	100	0	-100	0.00	0.00	0	0	0
0025	3T	20	256	1	0	100	0	-100	0.00	0.00	0	0	0
0025	3T	21	123	338	40	33800	24990	-8810	0.12	0.74	59	44	-15
0025	3T	21	124	786	69	78600	53940	-24660	0.09	0.69	139	95	-44
0025	3T	21	125	332	31	33200	28420	-4780	0.09	0.86	58	50	-8
0025	3T	21	126	210	15	21000	15880	-5120	0.07	0.76	37	28	-9
0025	3T	21	132	3	0	300	0	-300	0.00	0.00	0	0	0
0025	3T	21	134	234	39	23400	37420	14020	0.17	1.60	41	66	25
0025	3T	21	135	249	29	24900	19980	-4920	0.12	0.80	44	35	-9
0025	3T	21	136	92	5	9200	5610	-3590	0.05	0.61	16	9	-7
0025	3T	21	142	1	0	100	0	-100	0.00	0.00	0	0	0
0025	3T	21	143	5	0	500	0	-500	0.00	0.00	0	0	0
0025	3T	21	145	49	4	4900	3470	-1430	0.08	0.71	8	6	-2
0025	3T	21	146	29	3	2900	3340	440	0.10	1.15	5	5	0
0025	3T	21	152	1	0	100	0	-100	0.00	0.00	0	0	0
0025	3T	21	153	3	0	300	0	-300	0.00	0.00	0	0	0
0025	3T	21	154	1	0	100	0	-100	0.00	0.00	0	0	0
0025	3T	21	156	5	1	500	2480	1980	0.20	4.96	0	4	4
0025	3T	21	215	1	0	100	0	-100	0.00	0.00	0	0	0
0025	3T	21	234	3	0	300	0	-300	0.00	0.00	0	0	0
0025	3T	21	235	1	0	100	0	-100	0.00	0.00	0	0	0
0025	3T	21	236	1	0	100	0	-100	0.00	0.00	0	0	0
0025	3T	21	246	1	0	100	0	-100	0.00	0.00	0	0	0
0025	3T	22	123	163	23	16300	15990	-310	0.14	0.98	28	28	0
0025	3T	22	124	969	79	96900	72600	-24300	0.08	0.75	171	128	-43
0025	3T	22	125	121	6	12100	7230	-4870	0.05	0.60	21	12	-9
0025	3T	22	126	181	13	18100	31470	13370	0.07	1.74	32	55	23
0025	3T	22	134	271	22	27100	18070	-9030	0.08	0.67	47	31	-16
0025	3T	22	135	51	4	5100	3590	-1510	0.08	0.70	9	6	-3
0025	3T	22	136	63	6	6300	9560	3260	0.10	1.52	11	16	5
0025	3T	22	143	6	1	600	1070	470	0.17	1.78	1	1	0
0025	3T	22	145	9	1	900	780	-120	0.11	0.87	1	1	0
0025	3T	22	146	17	0	1700	0	-1700	0.00	0.00	3	0	-3
0025	3T	22	153	4	0	400	0	-400	0.00	0.00	0	0	0
0025	3T	22	154	6	0	600	0	-600	0.00	0.00	1	0	-1
0025	3T	22	156	1	0	100	0	-100	0.00	0.00	0	0	0
0025	3T	22	163	1	0	100	0	-100	0.00	0.00	0	0	0
0025	3T	22	164	1	0	100	0	-100	0.00	0.00	0	0	0
0025	3T	22	165	2	0	200	0	-200	0.00	0.00	0	0	0
0025	3T	22	213	1	0	100	0	-100	0.00	0.00	0	0	0
0025	3T	22	214	2	0	200	0	-200	0.00	0.00	0	0	0
0025	3T	22	216	1	0	100	0	-100	0.00	0.00	0	0	0
0025	3T	22	234	12	0	1200	0	-1200	0.00	0.00	2	0	-2
0025	3T	22	235	7	0	700	0	-700	0.00	0.00	1	0	-1
0025	3T	22	236	6	1	600	1310	710	0.17	2.18	1	2	1
0025	3T	22	246	3	0	300	0	-300	0.00	0.00	0	0	0
0025	3T	23	123	318	36	31800	20580	-11220	0.11	0.65	56	36	-20
0025	3T	23	124	909	57	90900	62210	-28690	0.06	0.68	160	110	-50
0025	3T	23	125	172	9	17200	8390	-8810	0.05	0.49	30	14	-16
0025	3T	23	126	157	5	15700	8260	-7440	0.03	0.53	27	14	-13
0025	3T	23	132	40	5	4000	3230	-770	0.13	0.81	7	5	-2
0025	3T	23	134	169	13	16900	13580	-3320	0.08	0.80	29	24	-5
0025	3T	23	135	123	10	12300	7340	-4960	0.08	0.60	21	12	-9
0025	3T	23	136	97	5	9700	7600	-2100	0.05	0.78	17	13	-4
0025	3T	23	142	12	0	1200	0	-1200	0.00	0.00	2	0	-2
0025	3T	23	143	3	0	300	0	-300	0.00	0.00	0	0	0
0025	3T	23	145	89	9	8900	8630	-270	0.10	0.97	15	15	0
0025	3T	23	146	52	2	5200	1750	-3450	0.04	0.34	9	3	-6
0025	3T	23	152	4	0	400	0	-400	0.00	0.00	0	0	0
0025	3T	23	153	2	0	200	0	-200	0.00	0.00	0	0	0
0025	3T	23	154	3	0	300	0	-300	0.00	0.00	0	0	0
0025	3T	23	156	13	0	1300	0	-1300	0.00	0.00	2	0	-2
0025	3T	23	234	18	0	1800	0	-1800	0.00	0.00	3	0	-3
0025	3T	23	235	3	0	300	0	-300	0.00	0.00	0	0	0
0025	3T	23	236	2	0	200	0	-200	0.00	0.00	0	0	0
0025	3T	23	245	5	0	500	0	-500	0.00	0.00	0	0	0
0025	3T	23	246	1	0	100	0	-100	0.00	0.00	0	0	0
0025	3T	23	253	3	0	300	0	-300	0.00	0.00	0	0	0
0025	3T	23	256	2	1	200	730	530	0.50	3.65	0	1	1
0025	3T	24	123	436	77	43600	43010	-590	0.18	0.99	77	76	-1
0025	3T	24	124	692	57	69200	41250	-27950	0.08	0.60	122	73	-49
0025	3T	24	125	250	21	25000	17750	-7250	0.08	0.71	44	31	-13
0025	3T	24	126	244	10	24400	8490	-15910	0.04	0.35	43	15	-28
0025	3T	24	132	4	0	400	0	-400	0.00	0.00	0	0	0
0025	3T	24	134	181	26	18100	19810	1710	0.14	1.09	32	35	3
0025	3T	24	135	135	15	13500	11890	-1610	0.11	0.88	23	21	-2
0023	1T	01_1	1	111	36	11100	8530	-2570	0.32	0.77	19	15	-4
0023	1T	01_1	2	8	0	800	0	-800	0.00	0.00	1	0	-1
0023	1T	01_10	1	270	152	27000	23250	-3750	0.56	0.86	47	41	-6
0023	1T	01_10	2	5	1	500	460	-40	0.20	0.92	0	0	0
0023	1T	01_11	1	281	195	28100	27270	-830	0.69	0.97	49	48	-1
0023	1T	01_12	1	281	197	28100	25830	-2270	0.70	0.92	49	45	-4
0023	1T	01_2	1	156	62	15600	14540	-1060	0.40	0.93	27	25	-2
0023	1T	01_2	2	60	19	6000	5120	-880	0.32	0.85	10	9	-1
0023	1T	01_3	1	173	69	17300	16340	-960	0.40	0.94	30	28	-2
0023	1T	01_3	2	54	17	5400	3890	-1510	0.31	0.72	9	6	-3
0023	1T	01_4	1	196	74	19600	16010	-3590	0.38	0.82	34	28	-6
0023	1T	01_4	2	38	18	3800	4900	1100	0.47	1.29	6	8	2
0023	1T	01_5	1	217	98	21700	20260	-1440	0.45	0.93	38	35	-3
0023	1T	01_5	2	35	10	3500	2410	-1090	0.29	0.69	6	4	-2
0023	1T	01_6	1	278	232	27800	26790	-1010	0.83	0.96	49	47	-2
0023	1T	01_6	2	1	0	100	0	-100	0.00	0.00	0	0	0
0023	1T	01_7	1	211	111	21100	19010	-2090	0.53	0.90	37	33	-4
0023	1T	01_7	2	45	28	4500	5370	870	0.62	1.19	7	9	2
0023	1T	01_8	1	270	163	27000	23950	-3050	0.60	0.89	47	42	-5
0023	1T	01_8	2	1	1	100	400	300	1.00	4.00	0	0	0
0023	1T	01_9	1	253	141	25300	22790	-2510	0.56	0.90	44	40	-4
0023	1T	01_9	2	16	10	1600	2170	570	0.63	1.36	2	3	1
0023	1T	02_1	1	218	88	21800	18710	-3090	0.40	0.86	38	33	-5
0023	1T	02_1	2	30	12	3000	4160	1160	0.40	1.39	5	7	2
0023	1T	02_10	1	259	129	25900	23660	-2240	0.50	0.91	45	41	-4
0023	1T	02_10	2	11	4	1100	880	-220	0.36	0.80	1	1	0
0023	1T	02_11	1	270	146	27000	24300	-2700	0.54	0.90	47	43	-4
0023	1T	02_11	2	2	1	200	180	-20	0.50	0.90	0	0	0
0023	1T	02_12	1	269	179	26900	24500	-2400	0.67	0.91	47	43	-4
0023	1T	02_12	2	2	0	200	0	-200	0.00	0.00	0	0	0
0023	1T	02_2	1	146	43	14600	12140	-2460	0.29	0.83	25	21	-4
0023	1T	02_2	2	9	2	900	620	-280	0.22	0.69	1	1	0
0023	1T	02_3	1	190	69	19000	18100	-900	0.36	0.95	33	32	-1
0023	1T	02_3	2	60	22	6000	4990	-1010	0.37	0.83	10	8	-2
0023	1T	02_4	1	202	67	20200	14980	-5220	0.33	0.74	35	26	-9
0023	1T	02_4	2	57	24	5700	5300	-400	0.42	0.93	10	9	-1
0023	1T	02_5	1	201	84	20100	16560	-3540	0.42	0.82	35	29	-6
0023	1T	02_5	2	43	15	4300	3030	-1270	0.35	0.70	7	5	-2
0023	1T	02_6	1	189	72	18900	15830	-3070	0.38	0.84	33	28	-5
0023	1T	02_6	2	53	23	5300	4650	-650	0.43	0.88	9	8	-1
0023	1T	02_7	1	271	185	27100	22800	-4300	0.68	0.84	47	40	-7
0023	1T	02_7	2	4	1	400	120	-280	0.25	0.30	0	0	0
0023	1T	02_8	1	208	94	20800	19650	-1150	0.45	0.94	36	34	-2
0023	1T	02_8	2	50	20	5000	3820	-1180	0.40	0.76	8	6	-2
0023	1T	02_9	1	250	124	25000	22390	-2610	0.50	0.90	44	39	-5
0023	1T	02_9	2	16	4	1600	850	-750	0.25	0.53	2	1	-1
0023	1T	03_1	1	146	74	14600	14200	-400	0.51	0.97	25	25	0
0023	1T	03_1	2	29	10	2900	3410	510	0.34	1.18	5	6	1
0023	1T	03_10	1	190	110	19000	17120	-1880	0.58	0.90	33	30	-3
0023	1T	03_10	2	6	3	600	1020	420	0.50	1.70	1	1	0
0023	1T	03_11	1	192	115	19200	17510	-1690	0.60	0.91	33	30	-3
0023	1T	03_11	2	3	1	300	110	-190	0.33	0.37	0	0	0
0023	1T	03_12	1	190	112	19000	16250	-2750	0.59	0.86	33	28	-5
0023	1T	03_12	2	1	0	100	0	-100	0.00	0.00	0	0	0
0023	1T	03_2	1	149	60	14900	13540	-1360	0.40	0.91	26	23	-3
0023	1T	03_2	2	37	11	3700	2370	-1330	0.30	0.64	6	4	-2
0023	1T	03_3	1	131	55	13100	12480	-620	0.42	0.95	23	22	-1
0023	1T	03_3	2	47	17	4700	3780	-920	0.36	0.80	8	6	-2
0023	1T	03_4	1	140	63	14000	13930	-70	0.45	1.00	24	24	0
0023	1T	03_4	2	40	10	4000	2110	-1890	0.25	0.53	7	3	-4
0023	1T	03_5	1	136	56	13600	12920	-680	0.41	0.95	24	22	-2
0023	1T	03_5	2	40	13	4000	3380	-620	0.33	0.85	7	5	-2
0023	1T	03_6	1	147	64	14700	16300	1600	0.44	1.11	26	28	2
0023	1T	03_6	2	34	12	3400	2340	-1060	0.35	0.69	6	4	-2
0023	1T	03_7	1	158	92	15800	17700	1900	0.58	1.12	27	31	4
0023	1T	03_7	2	23	12	2300	3980	1680	0.52	1.73	4	7	3
0023	1T	03_8	1	169	79	16900	14750	-2150	0.47	0.87	29	26	-3
0023	1T	03_8	2	30	7	3000	1370	-1630	0.23	0.46	5	2	-3
0023	1T	03_9	1	187	96	18700	16920	-1780	0.51	0.90	33	29	-4
0023	1T	03_9	2	8	3	800	1370	570	0.38	1.71	1	2	1
0023	1T	04_1	1	163	62	16300	13140	-3160	0.38	0.81	28	23	-5
0023	1T	04_1	2	22	8	2200	2420	220	0.36	1.10	3	4	1
0023	1T	04_10	1	229	120	22900	19420	-3480	0.52	0.85	40	34	-6
0023	1T	04_10	2	10	3	1000	830	-170	0.30	0.83	1	1	0
0023	1T	04_11	1	239	122	23900	18440	-5460	0.51	0.77	42	32	-10
0023	1T	04_11	2	4	1	400	160	-240	0.25	0.40	0	0	0
0023	1T	04_12	1	241	168	24100	22060	-2040	0.70	0.92	42	39	-3
0023	1T	04_12	2	2	2	200	510	310	1.00	2.55	0	0	0
0023	1T	04_2	1	162	58	16200	19200	3000	0.36	1.19	28	33	5
0023	1T	04_2	2	27	6	2700	1020	-1680	0.22	0.38	4	1	-3
0023	1T	04_3	1	171	88	17100	16860	-240	0.51	0.99	30	29	-1
0023	1T	04_3	2	43	18	4300	4010	-290	0.42	0.93	7	7	0
0023	1T	04_4	1	160	54	16000	14060	-1940	0.34	0.88	28	24	-4
0023	1T	04_4	2	39	13	3900	3450	-450	0.33	0.88	6	6	0
0023	1T	04_5	1	187	106	18700	16230	-2470	0.57	0.87	33	28	-5
0023	1T	04_5	2	29	8	2900	1830	-1070	0.28	0.63	5	3	-2
0023	1T	04_6	1	142	64	14200	13800	-400	0.45	0.97	25	24	-1
0023	1T	04_6	2	56	22	5600	5100	-500	0.39	0.91	9	9	0
0023	1T	04_7	1	176	82	17600	15140	-2460	0.47	0.86	31	26	-5
0023	1T	04_7	2	37	15	3700	3840	140	0.41	1.04	6	6	0
0023	1T	04_8	1	206	109	20600	20040	-560	0.53	0.97	36	35	-1
0023	1T	04_8	2	13	2	1300	550	-750	0.15	0.42	2	0	-2
0023	1T	04_9	1	222	118	22200	20220	-1980	0.53	0.91	39	35	-4
0023	1T	04_9	2	11	6	1100	1450	350	0.55	1.32	1	2	1
0023	1T	05_1	1	261	175	26100	25560	-540	0.67	0.98	46	45	-1
0023	1T	05_1	2	3	0	300	0	-300	0.00	0.00	0	0	0
0023	1T	05_10	1	248	143	24800	22540	-2260	0.58	0.91	43	39	-4
0023	1T	05_10	2	15	6	1500	1940	440	0.40	1.29	2	3	1
0023	1T	05_11	1	263	176	26300	25570	-730	0.67	0.97	46	45	-1
0023	1T	05_11	2	4	1	400	180	-220	0.25	0.45	0	0	0
0023	1T	05_12	1	269	190	26900	25180	-1720	0.71	0.94	47	44	-3
0023	1T	05_12	2	2	1	200	260	60	0.50	1.30	0	0	0
0023	1T	05_2	1	165	71	16500	15390	-1110	0.43	0.93	29	27	-2
0023	1T	05_2	2	53	19	5300	3960	-1340	0.36	0.75	9	7	-2
0023	1T	05_3	1	160	68	16000	14070	-1930	0.43	0.88	28	24	-4
0023	1T	05_3	2	60	17	6000	5110	-890	0.28	0.85	10	9	-1
0023	1T	05_4	1	149	79	14900	17300	2400	0.53	1.16	26	30	4
0023	1T	05_4	2	70	31	7000	7950	950	0.44	1.14	12	14	2
0023	1T	05_5	1	159	72	15900	17280	1380	0.45	1.09	28	30	2
0023	1T	05_5	2	62	25	6200	5370	-830	0.40	0.87	10	9	-1
0023	1T	05_6	1	168	82	16800	16280	-520	0.49	0.97	29	28	-1
0023	1T	05_6	2	69	17	6900	3990	-2910	0.25	0.58	12	7	-5
0023	1T	05_7	1	209	109	20900	21080	180	0.52	1.01	36	37	1
0023	1T	05_7	2	43	19	4300	5650	1350	0.44	1.31	7	10	3
0023	1T	05_8	1	206	114	20600	20040	-560	0.55	0.97	36	35	-1
0023	1T	05_8	2	40	14	4000	3270	-730	0.35	0.82	7	5	-2
0023	1T	05_9	1	269	190	26900	22640	-4260	0.71	0.84	47	40	-7
0023	1T	06_1	1	225	119	22500	22970	470	0.53	1.02	39	40	1
0023	1T	06_1	2	43	11	4300	3670	-630	0.26	0.85	7	6	-1
0023	1T	06_10	1	269	150	26900	24110	-2790	0.56	0.90	47	42	-5
0023	1T	06_10	2	12	4	1200	1020	-180	0.33	0.85	2	1	-1
0023	1T	06_11	1	281	188	28100	25300	-2800	0.67	0.90	49	44	-5
0023	1T	06_11	2	1	0	100	0	-100	0.00	0.00	0	0	0
0023	1T	06_12	1	285	182	28500	22930	-5570	0.64	0.80	50	40	-10
0023	1T	06_2	1	165	69	16500	18130	1630	0.42	1.10	29	32	3
0023	1T	06_2	2	77	34	7700	8690	990	0.44	1.13	13	15	2
0023	1T	06_3	1	135	62	13500	13170	-330	0.46	0.98	23	23	0
0023	1T	06_3	2	101	41	10100	9920	-180	0.41	0.98	17	17	0
0023	1T	06_4	1	283	204	28300	24700	-3600	0.72	0.87	50	43	-7
0023	1T	06_5	1	147	57	14700	11370	-3330	0.39	0.77	26	20	-6
0023	1T	06_5	2	92	30	9200	7300	-1900	0.33	0.79	16	12	-4
0023	1T	06_6	1	156	70	15600	13670	-1930	0.45	0.88	27	24	-3
0023	1T	06_6	2	82	33	8200	7510	-690	0.40	0.92	14	13	-1
0023	1T	06_7	1	255	119	25500	21690	-3810	0.47	0.85	45	38	-7
0023	1T	06_7	2	20	6	2000	1960	-40	0.30	0.98	3	3	0
0023	1T	06_8	1	251	122	25100	21580	-3520	0.49	0.86	44	38	-6
0023	1T	06_8	2	23	9	2300	1970	-330	0.39	0.86	4	3	-1
0023	1T	06_9	1	237	125	23700	20810	-2890	0.53	0.88	41	36	-5
0023	1T	06_9	2	31	12	3100	4570	1470	0.39	1.47	5	8	3
0023	1T	07_1	1	230	130	23000	22580	-420	0.57	0.98	40	39	-1
0023	1T	07_1	2	29	10	2900	3290	390	0.34	1.13	5	5	0
0023	1T	07_10	1	274	185	27400	25000	-2400	0.68	0.91	48	44	-4
0023	1T	07_10	2	3	1	300	220	-80	0.33	0.73	0	0	0
0023	1T	07_11	1	283	183	28300	23080	-5220	0.65	0.82	50	40	-10
0023	1T	07_11	2	2	1	200	120	-80	0.50	0.60	0	0	0
0023	1T	07_12	1	285	199	28500	25650	-2850	0.70	0.90	50	45	-5
0023	1T	07_12	2	1	0	100	0	-100	0.00	0.00	0	0	0
0023	1T	07_2	1	192	98	19200	18660	-540	0.51	0.97	33	33	0
0023	1T	07_2	2	54	15	5400	4700	-700	0.28	0.87	9	8	-1
0023	1T	07_3	1	185	93	18500	21570	3070	0.50	1.17	32	38	6
0023	1T	07_3	2	65	21	6500	5860	-640	0.32	0.90	11	10	-1
0023	1T	07_4	1	206	95	20600	18390	-2210	0.46	0.89	36	32	-4
0023	1T	07_4	2	54	20	5400	5370	-30	0.37	0.99	9	9	0
0023	1T	07_5	1	181	92	18100	17080	-1020	0.51	0.94	32	30	-2
0023	1T	07_5	2	66	26	6600	5390	-1210	0.39	0.82	11	9	-2
0023	1T	07_6	1	209	114	20900	22130	1230	0.55	1.06	36	39	3
0023	1T	07_6	2	38	15	3800	2850	-950	0.39	0.75	6	5	-1
0023	1T	07_7	1	280	195	28000	29020	1020	0.70	1.04	49	51	2
0023	1T	07_8	1	243	146	24300	24170	-130	0.60	0.99	43	42	-1
0023	1T	07_8	2	32	14	3200	2450	-750	0.44	0.77	5	4	-1
0023	1T	07_9	1	265	163	26500	22820	-3680	0.62	0.86	46	40	-6
0023	1T	07_9	2	12	5	1200	1010	-190	0.42	0.84	2	1	-1
0023	1T	08_1	1	224	110	22400	20490	-1910	0.49	0.91	39	36	-3
0023	1T	08_1	2	32	11	3200	2700	-500	0.34	0.84	5	4	-1
0023	1T	08_10	1	274	177	27400	24920	-2480	0.65	0.91	48	44	-4
0023	1T	08_10	2	5	3	500	470	-30	0.60	0.94	0	0	0
0023	1T	08_11	1	274	201	27400	25190	-2210	0.73	0.92	48	44	-4
0023	1T	08_11	2	2	0	200	0	-200	0.00	0.00	0	0	0
0023	1T	08_12	1	277	204	27700	24570	-3130	0.74	0.89	49	43	-6
0023	1T	08_2	1	205	89	20500	18440	-2060	0.43	0.90	36	32	-4
0023	1T	08_2	2	39	13	3900	2250	-1650	0.33	0.58	6	3	-3
0023	1T	08_3	1	207	103	20700	19770	-930	0.50	0.96	36	34	-2
0023	1T	08_3	2	43	12	4300	3340	-960	0.28	0.78	7	5	-2
0023	1T	08_4	1	241	136	24100	21180	-2920	0.56	0.88	42	37	-5
0023	1T	08_4	2	24	9	2400	1830	-570	0.38	0.76	4	3	-1
0023	1T	08_5	1	243	156	24300	23960	-340	0.64	0.99	43	42	-1
0023	1T	08_5	2	22	8	2200	1860	-340	0.36	0.85	3	3	0
0023	1T	08_6	1	218	125	21800	21300	-500	0.57	0.98	38	37	-1
0023	1T	08_6	2	30	11	3000	2590	-410	0.37	0.86	5	4	-1
0023	1T	08_7	1	222	117	22200	21610	-590	0.53	0.97	39	38	-1
0023	1T	08_7	2	31	11	3100	3190	90	0.35	1.03	5	5	0
0023	1T	08_8	1	153	85	15300	13840	-1460	0.56	0.90	27	24	-3
0023	1T	08_8	2	10	4	1000	880	-120	0.40	0.88	1	1	0
0023	1T	08_9	1	271	191	27100	28780	1680	0.70	1.06	47	50	3
0023	1T	08_9	2	3	1	300	160	-140	0.33	0.53	0	0	0
0023	1T	09_1	1	285	237	28500	27240	-1260	0.83	0.96	50	48	-2
0023	1T	09_10	1	271	162	27100	26570	-530	0.60	0.98	47	47	0
0023	1T	09_10	2	7	3	700	1030	330	0.43	1.47	1	1	0
0023	1T	09_11	1	275	168	27500	25890	-1610	0.61	0.94	48	45	-3
0023	1T	09_11	2	6	0	600	0	-600	0.00	0.00	1	0	-1
0023	1T	09_12	1	282	200	28200	24630	-3570	0.71	0.87	49	43	-6
0023	1T	09_12	2	1	0	100	0	-100	0.00	0.00	0	0	0
0023	1T	09_2	1	233	134	23300	24360	1060	0.58	1.05	41	43	2
0023	1T	09_2	2	23	6	2300	2290	-10	0.26	1.00	4	4	0
0023	1T	09_3	1	202	96	20200	19470	-730	0.48	0.96	35	34	-1
0023	1T	09_3	2	50	8	5000	1670	-3330	0.16	0.33	8	2	-6
0023	1T	09_4	1	190	85	19000	19900	900	0.45	1.05	33	35	2
0023	1T	09_4	2	59	20	5900	5690	-210	0.34	0.96	10	10	0
0023	1T	09_5	1	282	234	28200	27190	-1010	0.83	0.96	49	48	-1
0023	1T	09_5	2	4	1	400	130	-270	0.25	0.33	0	0	0
0023	1T	09_6	1	189	96	18900	17250	-1650	0.51	0.91	33	30	-3
0023	1T	09_6	2	50	28	5000	7840	2840	0.56	1.57	8	13	5
0023	1T	09_7	1	208	103	20800	18410	-2390	0.50	0.89	36	32	-4
0023	1T	09_7	2	45	22	4500	3500	-1000	0.49	0.78	7	6	-1
0023	1T	09_8	1	187	97	18700	15840	-2860	0.52	0.85	33	28	-5
0023	1T	09_8	2	74	41	7400	7570	170	0.55	1.02	13	13	0
0023	1T	09_9	1	252	157	25200	26980	1780	0.62	1.07	44	47	3
0023	1T	09_9	2	17	6	1700	1130	-570	0.35	0.66	3	2	-1
0023	1T	10_1	1	264	217	26400	25370	-1030	0.82	0.96	46	44	-2
0023	1T	10_1	2	1	0	100	0	-100	0.00	0.00	0	0	0
0023	1T	10_10	1	233	119	23300	18880	-4420	0.51	0.81	41	33	-8
0023	1T	10_10	2	21	11	2100	2370	270	0.52	1.13	3	4	1
0023	1T	10_11	1	261	167	26100	22400	-3700	0.64	0.86	46	39	-7
0023	1T	10_11	2	1	0	100	0	-100	0.00	0.00	0	0	0
0023	1T	10_12	1	261	185	26100	23460	-2640	0.71	0.90	46	41	-5
0023	1T	10_12	2	1	0	100	0	-100	0.00	0.00	0	0	0
0023	1T	10_2	1	239	146	23900	22720	-1180	0.61	0.95	42	40	-2
0023	1T	10_2	2	27	14	2700	2990	290	0.52	1.11	4	5	1
0023	1T	10_3	1	232	133	23200	19410	-3790	0.57	0.84	41	34	-7
0023	1T	10_3	2	16	6	1600	1390	-210	0.38	0.87	2	2	0
0023	1T	10_4	1	230	119	23000	17660	-5340	0.52	0.77	40	31	-9
0023	1T	10_4	2	27	4	2700	1730	-970	0.15	0.64	4	3	-1
0023	1T	10_5	1	123	72	12300	12430	130	0.59	1.01	21	22	1
0023	1T	10_5	2	93	34	9300	8570	-730	0.37	0.92	16	15	-1
0023	1T	10_6	1	71	42	7100	6770	-330	0.59	0.95	12	11	-1
0023	1T	10_6	2	111	40	11100	11330	230	0.36	1.02	19	20	1
0023	1T	10_7	1	81	48	8100	7430	-670	0.59	0.92	14	13	-1
0023	1T	10_7	2	76	28	7600	5760	-1840	0.37	0.76	13	10	-3
0023	1T	10_8	1	127	63	12700	11120	-1580	0.50	0.88	22	19	-3
0023	1T	10_8	2	74	25	7400	6200	-1200	0.34	0.84	13	10	-3
0023	1T	10_9	1	158	94	15800	16400	600	0.59	1.04	27	29	2
0023	1T	10_9	2	60	20	6000	4590	-1410	0.33	0.77	10	8	-2
0023	1T	11_1	1	252	177	25200	23370	-1830	0.70	0.93	44	41	-3
0023	1T	11_1	2	1	0	100	0	-100	0.00	0.00	0	0	0
0023	1T	11_10	1	221	114	22100	18400	-3700	0.52	0.83	39	32	-7
0023	1T	11_10	2	23	6	2300	1310	-990	0.26	0.57	4	2	-2
0023	1T	11_11	1	242	144	24200	20500	-3700	0.60	0.85	42	36	-6
0023	1T	11_11	2	3	0	300	0	-300	0.00	0.00	0	0	0
0023	1T	11_12	1	247	143	24700	18830	-5870	0.58	0.76	43	33	-10
0023	1T	11_12	2	1	0	100	0	-100	0.00	0.00	0	0	0
0023	1T	11_2	1	172	67	17200	14160	-3040	0.39	0.82	30	25	-5
0023	1T	11_2	2	40	18	4000	4540	540	0.45	1.14	7	8	1
0023	1T	11_3	1	166	66	16600	15370	-1230	0.40	0.93	29	27	-2
0023	1T	11_3	2	53	11	5300	3150	-2150	0.21	0.59	9	5	-4
0023	1T	11_4	1	163	77	16300	17270	970	0.47	1.06	28	30	2
0023	1T	11_4	2	43	17	4300	3950	-350	0.40	0.92	7	6	-1
0023	1T	11_5	1	252	168	25200	21120	-4080	0.67	0.84	44	37	-7
0023	1T	11_5	2	1	0	100	0	-100	0.00	0.00	0	0	0
0023	1T	11_6	1	238	121	23800	20750	-3050	0.51	0.87	42	36	-6
0023	1T	11_6	2	6	3	600	550	-50	0.50	0.92	1	0	-1
0023	1T	11_7	1	175	83	17500	15710	-1790	0.47	0.90	30	27	-3
0023	1T	11_7	2	53	24	5300	4760	-540	0.45	0.90	9	8	-1
0023	1T	11_8	1	166	69	16600	13360	-3240	0.42	0.80	29	23	-6
0023	1T	11_8	2	57	27	5700	5310	-390	0.47	0.93	10	9	-1
0023	1T	11_9	1	189	85	18900	15870	-3030	0.45	0.84	33	28	-5
0023	1T	11_9	2	42	16	4200	4710	510	0.38	1.12	7	8	1
0023	1T	12_1	1	192	107	19200	17830	-1370	0.56	0.93	33	31	-2
0023	1T	12_1	2	34	13	3400	4440	1040	0.38	1.31	6	7	1
0023	1T	12_10	1	247	157	24700	22240	-2460	0.64	0.90	43	39	-4
0023	1T	12_10	2	7	0	700	0	-700	0.00	0.00	1	0	-1
0023	1T	12_11	1	256	189	25600	23620	-1980	0.74	0.92	45	41	-4
0023	1T	12_11	2	3	1	300	360	60	0.33	1.20	0	0	0
0023	1T	12_12	1	256	185	25600	23380	-2220	0.72	0.91	45	41	-4
0023	1T	12_12	2	1	1	100	330	230	1.00	3.30	0	0	0
0023	1T	12_2	1	191	97	19100	16810	-2290	0.51	0.88	33	29	-4
0023	1T	12_2	2	35	18	3500	3750	250	0.51	1.07	6	6	0
0023	1T	12_3	1	177	80	17700	15470	-2230	0.45	0.87	31	27	-4
0023	1T	12_3	2	48	20	4800	3730	-1070	0.42	0.78	8	6	-2
0023	1T	12_4	1	183	96	18300	18090	-210	0.52	0.99	32	32	0
0023	1T	12_4	2	43	14	4300	4450	150	0.33	1.03	7	7	0
0023	1T	12_5	1	248	188	24800	23020	-1780	0.76	0.93	43	40	-3
0023	1T	12_5	2	3	0	300	0	-300	0.00	0.00	0	0	0
0023	1T	12_6	1	180	94	18000	18060	60	0.52	1.00	31	31	0
0023	1T	12_6	2	40	18	4000	3930	-70	0.45	0.98	7	6	-1
0023	1T	12_7	1	207	113	20700	18310	-2390	0.55	0.88	36	32	-4
0023	1T	12_7	2	36	16	3600	3310	-290	0.44	0.92	6	5	-1
0023	1T	12_8	1	233	121	23300	17980	-5320	0.52	0.77	41	31	-10
0023	1T	12_8	2	14	8	1400	1730	330	0.57	1.24	2	3	1
0023	1T	12_9	1	248	142	24800	20860	-3940	0.57	0.84	43	36	-7
0023	1T	12_9	2	9	5	900	1200	300	0.56	1.33	1	2	1
0023	1T	13_1	1	184	111	18400	19700	1300	0.60	1.07	32	34	2
0023	1T	13_1	2	32	7	3200	1830	-1370	0.22	0.57	5	3	-2
0023	1T	13_10	1	251	175	25100	24340	-760	0.70	0.97	44	43	-1
0023	1T	13_10	2	2	0	200	0	-200	0.00	0.00	0	0	0
0023	1T	13_11	1	256	183	25600	24220	-1380	0.71	0.95	45	42	-3
0023	1T	13_11	2	2	0	200	0	-200	0.00	0.00	0	0	0
0023	1T	13_12	1	257	209	25700	25750	50	0.81	1.00	45	45	0
0023	1T	13_12	2	2	0	200	0	-200	0.00	0.00	0	0	0
0023	1T	13_2	1	172	89	17200	16570	-630	0.52	0.96	30	29	-1
0023	1T	13_2	2	40	14	4000	2660	-1340	0.35	0.67	7	4	-3
0023	1T	13_3	1	172	76	17200	13290	-3910	0.44	0.77	30	23	-7
0023	1T	13_3	2	51	13	5100	2890	-2210	0.25	0.57	9	5	-4
0023	1T	13_4	1	183	80	18300	14050	-4250	0.44	0.77	32	24	-8
0023	1T	13_4	2	43	16	4300	3540	-760	0.37	0.82	7	6	-1
0023	1T	13_5	1	184	100	18400	20230	1830	0.54	1.10	32	35	3
0023	1T	13_5	2	41	16	4100	3590	-510	0.39	0.88	7	6	-1
0023	1T	13_6	1	212	115	21200	18520	-2680	0.54	0.87	37	32	-5
0023	1T	13_6	2	26	12	2600	2720	120	0.46	1.05	4	4	0
0023	1T	13_7	1	217	124	21700	18590	-3110	0.57	0.86	38	32	-6
0023	1T	13_7	2	25	11	2500	2010	-490	0.44	0.80	4	3	-1
0023	1T	13_8	1	226	137	22600	20330	-2270	0.61	0.90	40	35	-5
0023	1T	13_8	2	18	12	1800	2410	610	0.67	1.34	3	4	1
0023	1T	13_9	1	238	154	23800	22400	-1400	0.65	0.94	42	39	-3
0023	1T	13_9	2	15	4	1500	1180	-320	0.27	0.79	2	2	0
0023	1T	14_1	1	248	156	24800	20410	-4390	0.63	0.82	43	36	-7
0023	1T	14_1	2	1	0	100	0	-100	0.00	0.00	0	0	0
0023	1T	14_10	1	191	87	19100	18750	-350	0.46	0.98	33	33	0
0023	1T	14_10	2	39	14	3900	2850	-1050	0.36	0.73	6	5	-1
0023	1T	14_11	1	242	142	24200	24130	-70	0.59	1.00	42	42	0
0023	1T	14_11	2	4	3	400	720	320	0.75	1.80	0	1	1
0023	1T	14_12	1	246	154	24600	20690	-3910	0.63	0.84	43	36	-7
0023	1T	14_12	2	2	1	200	190	-10	0.50	0.95	0	0	0
0023	1T	14_2	1	199	94	19900	16350	-3550	0.47	0.82	35	28	-7
0023	1T	14_2	2	32	11	3200	2470	-730	0.34	0.77	5	4	-1
0023	1T	14_3	1	244	150	24400	19600	-4800	0.61	0.80	43	34	-9
0023	1T	14_3	2	2	0	200	0	-200	0.00	0.00	0	0	0
0023	1T	14_4	1	197	95	19700	16240	-3460	0.48	0.82	34	28	-6
0023	1T	14_4	2	27	8	2700	2270	-430	0.30	0.84	4	4	0
0023	1T	14_5	1	234	158	23400	21280	-2120	0.68	0.91	41	37	-4
0023	1T	14_5	2	6	3	600	1350	750	0.50	2.25	1	2	1
0023	1T	14_6	1	143	53	14300	12610	-1690	0.37	0.88	25	22	-3
0023	1T	14_6	2	60	25	6000	5730	-270	0.42	0.96	10	10	0
0023	1T	14_7	1	146	55	14600	11730	-2870	0.38	0.80	25	20	-5
0023	1T	14_7	2	52	22	5200	4820	-380	0.42	0.93	9	8	-1
0023	1T	14_8	1	146	56	14600	13610	-990	0.38	0.93	25	24	-1
0023	1T	14_8	2	51	17	5100	4120	-980	0.33	0.81	9	7	-2
0023	1T	14_9	1	153	72	15300	13790	-1510	0.47	0.90	27	24	-3
0023	1T	14_9	2	49	22	4900	5650	750	0.45	1.15	8	10	2
0023	1T	15_1	1	283	187	28300	23770	-4530	0.66	0.84	50	42	-8
0023	1T	15_1	2	2	2	200	640	440	1.00	3.20	0	1	1
0023	1T	15_10	1	281	176	28100	24400	-3700	0.63	0.87	49	43	-6
0023	1T	15_10	2	5	2	500	950	450	0.40	1.90	0	1	1
0023	1T	15_11	1	282	192	28200	24790	-3410	0.68	0.88	49	43	-6
0023	1T	15_11	2	1	1	100	330	230	1.00	3.30	0	0	0
0023	1T	15_12	1	282	195	28200	24940	-3260	0.69	0.88	49	44	-5
0023	1T	15_2	1	235	114	23500	22080	-1420	0.49	0.94	41	39	-2
0023	1T	15_2	2	23	6	2300	1670	-630	0.26	0.73	4	2	-2
0023	1T	15_3	1	202	81	20200	19300	-900	0.40	0.96	35	34	-1
0023	1T	15_3	2	33	12	3300	3970	670	0.36	1.20	5	7	2
0023	1T	15_4	1	195	78	19500	18580	-920	0.40	0.95	34	32	-2
0023	1T	15_4	2	33	8	3300	1980	-1320	0.24	0.60	5	3	-2
0023	1T	15_5	1	281	155	28100	25120	-2980	0.55	0.89	49	44	-5
0023	1T	15_5	2	1	1	100	140	40	1.00	1.40	0	0	0
0023	1T	15_6	1	172	75	17200	14480	-2720	0.44	0.84	30	25	-5
0023	1T	15_6	2	102	36	10200	9430	-770	0.35	0.92	18	16	-2
0023	1T	15_7	1	198	93	19800	18490	-1310	0.47	0.93	35	32	-3
0023	1T	15_7	2	60	23	6000	4350	-1650	0.38	0.73	10	7	-3
0023	1T	15_8	1	283	183	28300	23990	-4310	0.65	0.85	50	42	-8
0023	1T	15_8	2	3	1	300	520	220	0.33	1.73	0	0	0
0023	1T	15_9	1	244	126	24400	19940	-4460	0.52	0.82	43	35	-8
0023	1T	15_9	2	29	11	2900	2350	-550	0.38	0.81	5	4	-1
0023	1T	16_1	1	288	231	28800	26580	-2220	0.80	0.92	50	47	-3
0023	1T	16_1	2	2	1	200	160	-40	0.50	0.80	0	0	0
0023	1T	16_10	1	279	162	27900	22980	-4920	0.58	0.82	49	40	-9
0023	1T	16_10	2	7	2	700	310	-390	0.29	0.44	1	0	-1
0023	1T	16_11	1	290	198	29000	25140	-3860	0.68	0.87	51	44	-7
0023	1T	16_12	1	289	211	28900	26120	-2780	0.73	0.90	51	46	-5
0023	1T	16_2	1	245	136	24500	25020	520	0.56	1.02	43	44	1
0023	1T	16_2	2	24	7	2400	1700	-700	0.29	0.71	4	3	-1
0023	1T	16_3	1	199	84	19900	15890	-4010	0.42	0.80	35	28	-7
0023	1T	16_3	2	47	15	4700	3740	-960	0.32	0.80	8	6	-2
0023	1T	16_4	1	203	92	20300	22930	2630	0.45	1.13	35	40	5
0023	1T	16_4	2	60	18	6000	4280	-1720	0.30	0.71	10	7	-3
0023	1T	16_5	1	212	114	21200	19790	-1410	0.54	0.93	37	35	-2
0023	1T	16_5	2	57	22	5700	6750	1050	0.39	1.18	10	11	1
0023	1T	16_6	1	289	176	28900	27250	-1650	0.61	0.94	51	48	-3
0023	1T	16_6	2	2	1	200	230	30	0.50	1.15	0	0	0
0023	1T	16_7	1	174	86	17400	15120	-2280	0.49	0.87	30	26	-4
0023	1T	16_7	2	76	28	7600	6420	-1180	0.37	0.84	13	11	-2
0023	1T	16_8	1	207	110	20700	19880	-820	0.53	0.96	36	35	-1
0023	1T	16_8	2	62	26	6200	4670	-1530	0.42	0.75	10	8	-2
0023	1T	16_9	1	283	183	28300	25910	-2390	0.65	0.92	50	45	-5
0023	1T	17_1	1	284	195	28400	23790	-4610	0.69	0.84	50	42	-8
0023	1T	17_10	1	268	186	26800	25890	-910	0.69	0.97	47	45	-2
0023	1T	17_10	2	6	2	600	1350	750	0.33	2.25	1	2	1
0023	1T	17_11	1	272	192	27200	25970	-1230	0.71	0.95	48	45	-3
0023	1T	17_11	2	7	1	700	370	-330	0.14	0.53	1	0	-1
0023	1T	17_12	1	278	199	27800	25920	-1880	0.72	0.93	49	45	-4
0023	1T	17_12	2	3	0	300	0	-300	0.00	0.00	0	0	0
0023	1T	17_2	1	226	112	22600	18550	-4050	0.50	0.82	40	32	-8
0023	1T	17_2	2	33	9	3300	3660	360	0.27	1.11	5	6	1
0023	1T	17_3	1	164	72	16400	16570	170	0.44	1.01	29	29	0
0023	1T	17_3	2	69	32	6900	8530	1630	0.46	1.24	12	15	3
0023	1T	17_4	1	208	122	20800	21010	210	0.59	1.01	36	37	1
0023	1T	17_4	2	49	20	4900	4260	-640	0.41	0.87	8	7	-1
0023	1T	17_5	1	215	129	21500	21790	290	0.60	1.01	38	38	0
0023	1T	17_5	2	41	14	4100	2690	-1410	0.34	0.66	7	4	-3
0023	1T	17_6	1	186	88	18600	20310	1710	0.47	1.09	32	35	3
0023	1T	17_6	2	63	26	6300	6390	90	0.41	1.01	11	11	0
0023	1T	17_7	1	199	102	19900	17820	-2080	0.51	0.90	35	31	-4
0023	1T	17_7	2	56	23	5600	5490	-110	0.41	0.98	9	9	0
0023	1T	17_8	1	214	121	21400	20590	-810	0.57	0.96	37	36	-1
0023	1T	17_8	2	39	19	3900	3400	-500	0.49	0.87	6	6	0
0023	1T	17_9	1	271	188	27100	25470	-1630	0.69	0.94	47	45	-2
0023	1T	17_9	2	4	2	400	400	0	0.50	1.00	0	0	0
0023	1T	18_1	1	295	252	29500	27700	-1800	0.85	0.94	52	49	-3
0023	1T	18_10	1	224	144	22400	22730	330	0.64	1.01	39	40	1
0023	1T	18_10	2	37	19	3700	3700	0	0.51	1.00	6	6	0
0023	1T	18_11	1	286	190	28600	27580	-1020	0.66	0.96	50	48	-2
0023	1T	18_11	2	1	0	100	0	-100	0.00	0.00	0	0	0
0023	1T	18_12	1	294	239	29400	28350	-1050	0.81	0.96	52	50	-2
0023	1T	18_12	2	1	0	100	0	-100	0.00	0.00	0	0	0
0023	1T	18_2	1	297	204	29700	25850	-3850	0.69	0.87	52	45	-7
0023	1T	18_3	1	292	227	29200	28940	-260	0.78	0.99	51	51	0
0023	1T	18_4	1	297	234	29700	25840	-3860	0.79	0.87	52	45	-7
0023	1T	18_5	1	171	107	17100	15270	-1830	0.63	0.89	30	27	-3
0023	1T	18_5	2	107	57	10700	9060	-1640	0.53	0.85	18	16	-2
0023	1T	18_6	1	175	87	17500	16510	-990	0.50	0.94	30	29	-1
0023	1T	18_6	2	81	34	8100	8150	50	0.42	1.01	14	14	0
0023	1T	18_7	1	224	127	22400	24310	1910	0.57	1.09	39	43	4
0023	1T	18_7	2	48	13	4800	3440	-1360	0.27	0.72	8	6	-2
0023	1T	18_8	1	194	121	19400	19590	190	0.62	1.01	34	34	0
0023	1T	18_8	2	74	28	7400	6130	-1270	0.38	0.83	13	10	-3
0023	1T	18_9	1	203	132	20300	20540	240	0.65	1.01	35	36	1
0023	1T	18_9	2	61	23	6100	6170	70	0.38	1.01	10	10	0
0023	1T	19_1	1	253	183	25300	21920	-3380	0.72	0.87	44	38	-6
0023	1T	19_10	1	250	147	25000	20540	-4460	0.59	0.82	44	36	-8
0023	1T	19_10	2	2	1	200	160	-40	0.50	0.80	0	0	0
0023	1T	19_11	1	253	175	25300	22150	-3150	0.69	0.88	44	39	-5
0023	1T	19_11	2	1	0	100	0	-100	0.00	0.00	0	0	0
0023	1T	19_12	1	253	176	25300	23060	-2240	0.70	0.91	44	40	-4
0023	1T	19_2	1	194	90	19400	18540	-860	0.46	0.96	34	32	-2
0023	1T	19_2	2	35	15	3500	4810	1310	0.43	1.37	6	8	2
0023	1T	19_3	1	141	63	14100	13570	-530	0.45	0.96	24	24	0
0023	1T	19_3	2	60	26	6000	6330	330	0.43	1.06	10	11	1
0023	1T	19_4	1	139	53	13900	13050	-850	0.38	0.94	24	23	-1
0023	1T	19_4	2	65	25	6500	6410	-90	0.38	0.99	11	11	0
0023	1T	19_5	1	251	186	25100	25730	630	0.74	1.03	44	45	1
0023	1T	19_5	2	1	0	100	0	-100	0.00	0.00	0	0	0
0023	1T	19_6	1	131	63	13100	11990	-1110	0.48	0.92	23	21	-2
0023	1T	19_6	2	77	33	7700	7020	-680	0.43	0.91	13	12	-1
0023	1T	19_7	1	245	142	24500	21890	-2610	0.58	0.89	43	38	-5
0023	1T	19_7	2	2	1	200	230	30	0.50	1.15	0	0	0
0023	1T	19_8	1	228	147	22800	23840	1040	0.64	1.05	40	42	2
0023	1T	19_8	2	8	2	800	1240	440	0.25	1.55	1	2	1
0023	1T	19_9	1	245	167	24500	22080	-2420	0.68	0.90	43	39	-4
0023	1T	19_9	2	5	0	500	0	-500	0.00	0.00	0	0	0
0023	1T	20_1	1	249	116	24900	21240	-3660	0.47	0.85	44	37	-7
0023	1T	20_1	2	16	3	1600	570	-1030	0.19	0.36	2	1	-1
0023	1T	20_10	1	265	171	26500	22170	-4330	0.65	0.84	46	39	-7
0023	1T	20_11	1	270	199	27000	24450	-2550	0.74	0.91	47	43	-4
0023	1T	20_12	1	268	192	26800	23700	-3100	0.72	0.88	47	41	-6
0023	1T	20_2	1	201	95	20100	19510	-590	0.47	0.97	35	34	-1
0023	1T	20_2	2	36	17	3600	5000	1400	0.47	1.39	6	8	2
0023	1T	20_3	1	187	98	18700	24550	5850	0.52	1.31	33	43	10
0023	1T	20_3	2	39	16	3900	3960	60	0.41	1.02	6	7	1
0023	1T	20_4	1	182	62	18200	15770	-2430	0.34	0.87	32	27	-5
0023	1T	20_4	2	39	12	3900	3970	70	0.31	1.02	6	7	1
0023	1T	20_5	1	236	126	23600	20830	-2770	0.53	0.88	41	36	-5
0023	1T	20_5	2	37	17	3700	4020	320	0.46	1.09	6	7	1
0023	1T	20_6	1	255	133	25500	21930	-3570	0.52	0.86	45	38	-7
0023	1T	20_6	2	7	4	700	910	210	0.57	1.30	1	1	0
0023	1T	20_7	1	260	134	26000	23490	-2510	0.52	0.90	46	41	-5
0023	1T	20_7	2	7	4	700	780	80	0.57	1.11	1	1	0
0023	1T	20_8	1	267	182	26700	24790	-1910	0.68	0.93	47	43	-4
0023	1T	20_8	2	5	2	500	330	-170	0.40	0.66	0	0	0
0023	1T	20_9	1	267	173	26700	22940	-3760	0.65	0.86	47	40	-7
0023	1T	20_9	2	1	0	100	0	-100	0.00	0.00	0	0	0
0023	1T	21_1	1	272	209	27200	23250	-3950	0.77	0.85	48	41	-7
0023	1T	21_10	1	264	170	26400	25940	-460	0.64	0.98	46	45	-1
0023	1T	21_10	2	3	0	300	0	-300	0.00	0.00	0	0	0
0023	1T	21_11	1	269	178	26900	23550	-3350	0.66	0.88	47	41	-6
0023	1T	21_11	2	1	0	100	0	-100	0.00	0.00	0	0	0
0023	1T	21_12	1	271	200	27100	25060	-2040	0.74	0.92	47	44	-3
0023	1T	21_2	1	266	146	26600	22090	-4510	0.55	0.83	47	39	-8
0023	1T	21_2	2	1	0	100	0	-100	0.00	0.00	0	0	0
0023	1T	21_3	1	263	155	26300	23990	-2310	0.59	0.91	46	42	-4
0023	1T	21_4	1	274	225	27400	27000	-400	0.82	0.99	48	47	-1
0023	1T	21_5	1	234	141	23400	22070	-1330	0.60	0.94	41	39	-2
0023	1T	21_5	2	38	18	3800	3360	-440	0.47	0.88	6	5	-1
0023	1T	21_6	1	181	85	18100	15150	-2950	0.47	0.84	32	26	-6
0023	1T	21_6	2	69	27	6900	6320	-580	0.39	0.92	12	11	-1
0023	1T	21_7	1	250	166	25000	24130	-870	0.66	0.97	44	42	-2
0023	1T	21_7	2	20	11	2000	4560	2560	0.55	2.28	3	8	5
0023	1T	21_8	1	253	143	25300	20680	-4620	0.57	0.82	44	36	-8
0023	1T	21_8	2	9	3	900	1430	530	0.33	1.59	1	2	1
0023	1T	21_9	1	193	112	19300	19090	-210	0.58	0.99	34	33	-1
0023	1T	21_9	2	61	22	6100	4240	-1860	0.36	0.70	10	7	-3
0023	1T	22_1	1	244	160	24400	20910	-3490	0.66	0.86	43	37	-6
0023	1T	22_1	2	4	1	400	140	-260	0.25	0.35	0	0	0
0023	1T	22_10	1	237	138	23700	22250	-1450	0.58	0.94	41	39	-2
0023	1T	22_10	2	11	5	1100	830	-270	0.45	0.75	1	1	0
0023	1T	22_11	1	249	142	24900	20340	-4560	0.57	0.82	44	36	-8
0023	1T	22_11	2	1	0	100	0	-100	0.00	0.00	0	0	0
0023	1T	22_12	1	249	167	24900	23500	-1400	0.67	0.94	44	41	-3
0023	1T	22_12	2	2	0	200	0	-200	0.00	0.00	0	0	0
0023	1T	22_2	1	158	77	15800	15730	-70	0.49	1.00	27	27	0
0023	1T	22_2	2	50	18	5000	4650	-350	0.36	0.93	8	8	0
0023	1T	22_3	1	165	77	16500	15650	-850	0.47	0.95	29	27	-2
0023	1T	22_3	2	46	13	4600	3410	-1190	0.28	0.74	8	6	-2
0023	1T	22_4	1	168	70	16800	13470	-3330	0.42	0.80	29	23	-6
0023	1T	22_4	2	49	16	4900	3400	-1500	0.33	0.69	8	6	-2
0023	1T	22_5	1	170	86	17000	14980	-2020	0.51	0.88	30	26	-4
0023	1T	22_5	2	42	15	4200	3260	-940	0.36	0.78	7	5	-2
0023	1T	22_6	1	165	80	16500	15550	-950	0.48	0.94	29	27	-2
0023	1T	22_6	2	50	19	5000	4970	-30	0.38	0.99	8	8	0
0023	1T	22_7	1	170	98	17000	16540	-460	0.58	0.97	30	29	-1
0023	1T	22_7	2	55	28	5500	6160	660	0.51	1.12	9	10	1
0023	1T	22_8	1	233	176	23300	22560	-740	0.76	0.97	41	39	-2
0023	1T	22_8	2	5	4	500	540	40	0.80	1.08	0	0	0
0023	1T	22_9	1	192	109	19200	20680	1480	0.57	1.08	33	36	3
0023	1T	22_9	2	42	14	4200	3270	-930	0.33	0.78	7	5	-2
0023	1T	23_1	1	274	217	27400	24750	-2650	0.79	0.90	48	43	-5
0023	1T	23_10	1	251	134	25100	22110	-2990	0.53	0.88	44	39	-5
0023	1T	23_10	2	15	6	1500	1390	-110	0.40	0.93	2	2	0
0023	1T	23_11	1	266	165	26600	23820	-2780	0.62	0.90	47	42	-5
0023	1T	23_11	2	4	2	400	980	580	0.50	2.45	0	1	1
0023	1T	23_12	1	270	196	27000	23520	-3480	0.73	0.87	47	41	-6
0023	1T	23_12	2	1	0	100	0	-100	0.00	0.00	0	0	0
0023	1T	23_2	1	263	153	26300	22350	-3950	0.58	0.85	46	39	-7
0023	1T	23_2	2	11	7	1100	1040	-60	0.64	0.95	1	1	0
0023	1T	23_3	1	262	158	26200	24900	-1300	0.60	0.95	46	44	-2
0023	1T	23_3	2	1	0	100	0	-100	0.00	0.00	0	0	0
0023	1T	23_4	1	268	163	26800	22840	-3960	0.61	0.85	47	40	-7
0023	1T	23_4	2	1	0	100	0	-100	0.00	0.00	0	0	0
0023	1T	23_5	1	184	92	18400	19310	910	0.50	1.05	32	34	2
0023	1T	23_5	2	47	14	4700	2900	-1800	0.30	0.62	8	5	-3
0023	1T	23_6	1	168	72	16800	26350	9550	0.43	1.57	29	46	17
0023	1T	23_6	2	47	17	4700	3260	-1440	0.36	0.69	8	5	-3
0023	1T	23_7	1	169	76	16900	16380	-520	0.45	0.97	29	28	-1
0023	1T	23_7	2	42	14	4200	2890	-1310	0.33	0.69	7	5	-2
0023	1T	23_8	1	139	60	13900	10320	-3580	0.43	0.74	24	18	-6
0023	1T	23_8	2	21	9	2100	1660	-440	0.43	0.79	3	2	-1
0023	1T	23_9	1	204	86	20400	15310	-5090	0.42	0.75	36	27	-9
0023	1T	23_9	2	52	17	5200	4300	-900	0.33	0.83	9	7	-2
0023	1T	24_1	1	261	199	26100	25310	-790	0.76	0.97	46	44	-2
0023	1T	24_1	2	9	0	900	0	-900	0.00	0.00	1	0	-1
0023	1T	24_10	1	272	205	27200	26940	-260	0.75	0.99	48	47	-1
0023	1T	24_10	2	3	0	300	0	-300	0.00	0.00	0	0	0
0023	1T	24_11	1	276	210	27600	26080	-1520	0.76	0.94	48	46	-2
0023	1T	24_11	2	1	0	100	0	-100	0.00	0.00	0	0	0
0023	1T	24_12	1	272	214	27200	25820	-1380	0.79	0.95	48	45	-3
0023	1T	24_2	1	231	134	23100	19390	-3710	0.58	0.84	40	34	-6
0023	1T	24_2	2	26	8	2600	2070	-530	0.31	0.80	4	3	-1
0023	1T	24_3	1	196	108	19600	20280	680	0.55	1.03	34	35	1
0023	1T	24_3	2	39	19	3900	4200	300	0.49	1.08	6	7	1
0023	1T	24_4	1	201	123	20100	18590	-1510	0.61	0.92	35	32	-3
0023	1T	24_4	2	45	28	4500	8990	4490	0.62	2.00	7	15	8
0023	1T	24_5	1	267	203	26700	27320	620	0.76	1.02	47	48	1
0023	1T	24_5	2	1	0	100	0	-100	0.00	0.00	0	0	0
0023	1T	24_6	1	250	179	25000	23870	-1130	0.72	0.95	44	42	-2
0023	1T	24_6	2	15	6	1500	1510	10	0.40	1.01	2	2	0
0023	1T	24_7	1	215	152	21500	25910	4410	0.71	1.21	38	45	7
0023	1T	24_7	2	12	6	1200	1000	-200	0.50	0.83	2	1	-1
0023	1T	24_8	1	230	167	23000	23020	20	0.73	1.00	40	40	0
0023	1T	24_8	2	21	13	2100	4120	2020	0.62	1.96	3	7	4
0023	1T	24_9	1	253	181	25300	22510	-2790	0.72	0.89	44	39	-5
0023	1T	24_9	2	10	7	1000	1540	540	0.70	1.54	1	2	1
0023	2F	01_1	12	18	2	1800	820	-980	0.11	0.46	3	1	-2
0023	2F	01_1	13	3	0	300	0	-300	0.00	0.00	0	0	0
0023	2F	01_1	14	89	23	8900	4950	-3950	0.26	0.56	15	8	-7
0023	2F	01_1	24	2	0	200	0	-200	0.00	0.00	0	0	0
0023	2F	01_10	12	184	57	18400	13690	-4710	0.31	0.74	32	24	-8
0023	2F	01_10	13	61	20	6100	5260	-840	0.33	0.86	10	9	-1
0023	2F	01_10	14	17	5	1700	1460	-240	0.29	0.86	3	2	-1
0023	2F	01_10	15	2	0	200	0	-200	0.00	0.00	0	0	0
0023	2F	01_10	16	1	0	100	0	-100	0.00	0.00	0	0	0
0023	2F	01_10	23	1	0	100	0	-100	0.00	0.00	0	0	0
0023	2F	01_11	12	221	73	22100	17180	-4920	0.33	0.78	39	30	-9
0023	2F	01_11	13	46	15	4600	3780	-820	0.33	0.82	8	6	-2
0023	2F	01_11	14	12	4	1200	1340	140	0.33	1.12	2	2	0
0023	2F	01_12	12	245	68	24500	17360	-7140	0.28	0.71	43	30	-13
0023	2F	01_12	13	25	5	2500	1320	-1180	0.20	0.53	4	2	-2
0023	2F	01_12	14	3	0	300	0	-300	0.00	0.00	0	0	0
0023	2F	01_2	12	66	23	6600	7420	820	0.35	1.12	11	13	2
0023	2F	01_2	13	44	15	4400	6280	1880	0.34	1.43	7	11	4
0023	2F	01_2	14	25	3	2500	1200	-1300	0.12	0.48	4	2	-2
0023	2F	01_2	15	10	2	1000	690	-310	0.20	0.69	1	1	0
0023	2F	01_2	16	5	0	500	0	-500	0.00	0.00	0	0	0
0023	2F	01_2	23	4	0	400	0	-400	0.00	0.00	0	0	0
0023	2F	01_2	24	4	1	400	320	-80	0.25	0.80	0	0	0
0023	2F	01_2	25	4	0	400	0	-400	0.00	0.00	0	0	0
0023	2F	01_2	26	6	3	600	1750	1150	0.50	2.92	1	3	2
0023	2F	01_3	12	75	15	7500	4910	-2590	0.20	0.65	13	8	-5
0023	2F	01_3	13	59	18	5900	6550	650	0.31	1.11	10	11	1
0023	2F	01_3	14	17	5	1700	1510	-190	0.29	0.89	3	2	-1
0023	2F	01_3	15	10	0	1000	0	-1000	0.00	0.00	1	0	-1
0023	2F	01_3	16	8	0	800	0	-800	0.00	0.00	1	0	-1
0023	2F	01_3	23	7	2	700	470	-230	0.29	0.67	1	0	-1
0023	2F	01_3	24	1	0	100	0	-100	0.00	0.00	0	0	0
0023	2F	01_3	25	2	0	200	0	-200	0.00	0.00	0	0	0
0023	2F	01_3	26	6	2	600	880	280	0.33	1.47	1	1	0
0023	2F	01_4	12	81	13	8100	3280	-4820	0.16	0.40	14	5	-9
0023	2F	01_4	13	62	11	6200	3350	-2850	0.18	0.54	10	5	-5
0023	2F	01_4	14	27	9	2700	2510	-190	0.33	0.93	4	4	0
0023	2F	01_4	15	10	1	1000	200	-800	0.10	0.20	1	0	-1
0023	2F	01_4	16	13	0	1300	0	-1300	0.00	0.00	2	0	-2
0023	2F	01_4	23	4	0	400	0	-400	0.00	0.00	0	0	0
0023	2F	01_4	24	4	1	400	370	-30	0.25	0.93	0	0	0
0023	2F	01_4	25	1	0	100	0	-100	0.00	0.00	0	0	0
0023	2F	01_4	26	2	0	200	0	-200	0.00	0.00	0	0	0
0023	2F	01_5	12	103	30	10300	8530	-1770	0.29	0.83	18	15	-3
0023	2F	01_5	13	71	18	7100	4890	-2210	0.25	0.69	12	8	-4
0023	2F	01_5	14	19	5	1900	1310	-590	0.26	0.69	3	2	-1
0023	2F	01_5	15	7	0	700	0	-700	0.00	0.00	1	0	-1
0023	2F	01_5	16	11	1	1100	280	-820	0.09	0.25	1	0	-1
0023	2F	01_5	23	6	0	600	0	-600	0.00	0.00	1	0	-1
0023	2F	01_5	24	3	0	300	0	-300	0.00	0.00	0	0	0
0023	2F	01_5	25	2	0	200	0	-200	0.00	0.00	0	0	0
0023	2F	01_5	26	1	0	100	0	-100	0.00	0.00	0	0	0
0023	2F	01_6	12	182	57	18200	13130	-5070	0.31	0.72	32	23	-9
0023	2F	01_6	13	59	30	5900	6620	720	0.51	1.12	10	11	1
0023	2F	01_6	14	27	7	2700	1420	-1280	0.26	0.53	4	2	-2
0023	2F	01_6	15	3	1	300	380	80	0.33	1.27	0	0	0
0023	2F	01_7	12	129	52	12900	12700	-200	0.40	0.98	22	22	0
0023	2F	01_7	13	39	14	3900	3460	-440	0.36	0.89	6	6	0
0023	2F	01_7	14	27	5	2700	1450	-1250	0.19	0.54	4	2	-2
0023	2F	01_7	15	9	2	900	300	-600	0.22	0.33	1	0	-1
0023	2F	01_7	16	7	1	700	230	-470	0.14	0.33	1	0	-1
0023	2F	01_7	23	1	1	100	150	50	1.00	1.50	0	0	0
0023	2F	01_7	24	1	0	100	0	-100	0.00	0.00	0	0	0
0023	2F	01_7	26	2	0	200	0	-200	0.00	0.00	0	0	0
0023	2F	01_8	12	86	26	8600	10200	1600	0.30	1.19	15	18	3
0023	2F	01_8	13	28	7	2800	2470	-330	0.25	0.88	4	4	0
0023	2F	01_8	14	11	2	1100	740	-360	0.18	0.67	1	1	0
0023	2F	01_8	15	143	59	14300	13070	-1230	0.41	0.91	25	23	-2
0023	2F	01_9	12	180	63	18000	14200	-3800	0.35	0.79	31	25	-6
0023	2F	01_9	13	49	16	4900	4460	-440	0.33	0.91	8	7	-1
0023	2F	01_9	14	9	2	900	490	-410	0.22	0.54	1	0	-1
0023	2F	01_9	15	5	1	500	290	-210	0.20	0.58	0	0	0
0023	2F	01_9	16	3	0	300	0	-300	0.00	0.00	0	0	0
0023	2F	01_9	24	2	0	200	0	-200	0.00	0.00	0	0	0
0023	2F	02_1	12	89	22	8900	7230	-1670	0.25	0.81	15	12	-3
0023	2F	02_1	13	50	9	5000	3010	-1990	0.18	0.60	8	5	-3
0023	2F	02_1	14	15	3	1500	1040	-460	0.20	0.69	2	1	-1
0023	2F	02_1	15	13	2	1300	1950	650	0.15	1.50	2	3	1
0023	2F	02_1	16	10	4	1000	2090	1090	0.40	2.09	1	3	2
0023	2F	02_1	23	5	1	500	380	-120	0.20	0.76	0	0	0
0023	2F	02_1	25	1	0	100	0	-100	0.00	0.00	0	0	0
0023	2F	02_10	12	160	42	16000	11520	-4480	0.26	0.72	28	20	-8
0023	2F	02_10	13	71	20	7100	5970	-1130	0.28	0.84	12	10	-2
0023	2F	02_10	14	15	2	1500	710	-790	0.13	0.47	2	1	-1
0023	2F	02_10	15	4	1	400	280	-120	0.25	0.70	0	0	0
0023	2F	02_10	16	5	1	500	1170	670	0.20	2.34	0	2	2
0023	2F	02_10	23	2	1	200	490	290	0.50	2.45	0	0	0
0023	2F	02_10	25	1	0	100	0	-100	0.00	0.00	0	0	0
0023	2F	02_11	12	172	46	17200	12040	-5160	0.27	0.70	30	21	-9
0023	2F	02_11	13	67	22	6700	6300	-400	0.33	0.94	11	11	0
0023	2F	02_11	14	22	3	2200	1030	-1170	0.14	0.47	3	1	-2
0023	2F	02_11	15	3	1	300	500	200	0.33	1.67	0	0	0
0023	2F	02_11	16	1	0	100	0	-100	0.00	0.00	0	0	0
0023	2F	02_12	12	206	67	20600	19350	-1250	0.33	0.94	36	34	-2
0023	2F	02_12	13	45	14	4500	3910	-590	0.31	0.87	7	6	-1
0023	2F	02_12	14	13	5	1300	1850	550	0.38	1.42	2	3	1
0023	2F	02_12	15	1	1	100	500	400	1.00	5.00	0	0	0
0023	2F	02_12	24	1	0	100	0	-100	0.00	0.00	0	0	0
0023	2F	02_2	12	35	10	3500	3640	140	0.29	1.04	6	6	0
0023	2F	02_2	13	9	1	900	1450	550	0.11	1.61	1	2	1
0023	2F	02_2	14	98	27	9800	6800	-3000	0.28	0.69	17	12	-5
0023	2F	02_2	15	1	0	100	0	-100	0.00	0.00	0	0	0
0023	2F	02_2	16	2	0	200	0	-200	0.00	0.00	0	0	0
0023	2F	02_2	23	2	0	200	0	-200	0.00	0.00	0	0	0
0023	2F	02_2	24	2	0	200	0	-200	0.00	0.00	0	0	0
0023	2F	02_2	26	1	0	100	0	-100	0.00	0.00	0	0	0
0023	2F	02_3	12	95	22	9500	10390	890	0.23	1.09	16	18	2
0023	2F	02_3	13	53	12	5300	4240	-1060	0.23	0.80	9	7	-2
0023	2F	02_3	14	18	1	1800	390	-1410	0.06	0.22	3	0	-3
0023	2F	02_3	15	7	2	700	1810	1110	0.29	2.59	1	3	2
0023	2F	02_3	16	9	0	900	0	-900	0.00	0.00	1	0	-1
0023	2F	02_3	23	4	2	400	690	290	0.50	1.73	0	1	1
0023	2F	02_3	24	5	1	500	240	-260	0.20	0.48	0	0	0
0023	2F	02_3	25	3	1	300	220	-80	0.33	0.73	0	0	0
0023	2F	02_3	26	2	0	200	0	-200	0.00	0.00	0	0	0
0023	2F	02_4	12	105	26	10500	8840	-1660	0.25	0.84	18	15	-3
0023	2F	02_4	13	57	14	5700	4190	-1510	0.25	0.74	10	7	-3
0023	2F	02_4	14	22	6	2200	1790	-410	0.27	0.81	3	3	0
0023	2F	02_4	15	7	1	700	590	-110	0.14	0.84	1	1	0
0023	2F	02_4	16	10	1	1000	690	-310	0.10	0.69	1	1	0
0023	2F	02_4	23	3	1	300	350	50	0.33	1.17	0	0	0
0023	2F	02_4	24	6	1	600	520	-80	0.17	0.87	1	0	-1
0023	2F	02_4	25	3	0	300	0	-300	0.00	0.00	0	0	0
0023	2F	02_5	12	115	37	11500	10520	-980	0.32	0.91	20	18	-2
0023	2F	02_5	13	41	8	4100	2430	-1670	0.20	0.59	7	4	-3
0023	2F	02_5	14	17	6	1700	1480	-220	0.35	0.87	3	2	-1
0023	2F	02_5	15	14	5	1400	2350	950	0.36	1.68	2	4	2
0023	2F	02_5	16	8	1	800	390	-410	0.13	0.49	1	0	-1
0023	2F	02_5	23	2	0	200	0	-200	0.00	0.00	0	0	0
0023	2F	02_5	25	2	0	200	0	-200	0.00	0.00	0	0	0
0023	2F	02_6	12	95	24	9500	8190	-1310	0.25	0.86	16	14	-2
0023	2F	02_6	13	47	7	4700	1910	-2790	0.15	0.41	8	3	-5
0023	2F	02_6	14	22	3	2200	980	-1220	0.14	0.45	3	1	-2
0023	2F	02_6	15	12	3	1200	1300	100	0.25	1.08	2	2	0
0023	2F	02_6	16	13	1	1300	320	-980	0.08	0.25	2	0	-2
0023	2F	02_6	23	3	0	300	0	-300	0.00	0.00	0	0	0
0023	2F	02_6	24	1	0	100	0	-100	0.00	0.00	0	0	0
0023	2F	02_6	25	4	1	400	380	-20	0.25	0.95	0	0	0
0023	2F	02_6	26	2	0	200	0	-200	0.00	0.00	0	0	0
0023	2F	02_7	12	176	47	17600	13420	-4180	0.27	0.76	31	23	-8
0023	2F	02_7	13	58	18	5800	5160	-640	0.31	0.89	10	9	-1
0023	2F	02_7	14	19	7	1900	2010	110	0.37	1.06	3	3	0
0023	2F	02_7	15	4	0	400	0	-400	0.00	0.00	0	0	0
0023	2F	02_8	12	105	28	10500	7850	-2650	0.27	0.75	18	13	-5
0023	2F	02_8	13	63	16	6300	5210	-1090	0.25	0.83	11	9	-2
0023	2F	02_8	14	22	8	2200	2480	280	0.36	1.13	3	4	1
0023	2F	02_8	15	10	0	1000	0	-1000	0.00	0.00	1	0	-1
0023	2F	02_8	16	6	1	600	310	-290	0.17	0.52	1	0	-1
0023	2F	02_8	23	3	0	300	0	-300	0.00	0.00	0	0	0
0023	2F	02_8	24	1	0	100	0	-100	0.00	0.00	0	0	0
0023	2F	02_8	26	3	0	300	0	-300	0.00	0.00	0	0	0
0023	2F	02_9	12	143	41	14300	12110	-2190	0.29	0.85	25	21	-4
0023	2F	02_9	13	69	18	6900	6340	-560	0.26	0.92	12	11	-1
0023	2F	02_9	14	20	4	2000	1900	-100	0.20	0.95	3	3	0
0023	2F	02_9	15	8	4	800	1870	1070	0.50	2.34	1	3	2
0023	2F	02_9	16	8	1	800	510	-290	0.13	0.64	1	0	-1
0023	2F	02_9	24	1	1	100	370	270	1.00	3.70	0	0	0
0023	2F	02_9	25	1	1	100	340	240	1.00	3.40	0	0	0
0023	2F	03_1	12	63	18	6300	5230	-1070	0.29	0.83	11	9	-2
0023	2F	03_1	13	39	10	3900	3290	-610	0.26	0.84	6	5	-1
0023	2F	03_1	14	11	4	1100	1320	220	0.36	1.20	1	2	1
0023	2F	03_1	15	6	1	600	460	-140	0.17	0.77	1	0	-1
0023	2F	03_1	16	4	0	400	0	-400	0.00	0.00	0	0	0
0023	2F	03_1	23	5	1	500	460	-40	0.20	0.92	0	0	0
0023	2F	03_1	26	2	1	200	650	450	0.50	3.25	0	1	1
0023	2F	03_10	12	111	39	11100	8790	-2310	0.35	0.79	19	15	-4
0023	2F	03_10	13	42	17	4200	5230	1030	0.40	1.25	7	9	2
0023	2F	03_10	14	22	4	2200	910	-1290	0.18	0.41	3	1	-2
0023	2F	03_10	15	8	1	800	230	-570	0.13	0.29	1	0	-1
0023	2F	03_10	16	5	2	500	1560	1060	0.40	3.12	0	2	2
0023	2F	03_11	12	120	39	12000	9460	-2540	0.33	0.79	21	16	-5
0023	2F	03_11	13	55	16	5500	4510	-990	0.29	0.82	9	7	-2
0023	2F	03_11	14	12	3	1200	670	-530	0.25	0.56	2	1	-1
0023	2F	03_11	15	3	1	300	310	10	0.33	1.03	0	0	0
0023	2F	03_11	16	1	0	100	0	-100	0.00	0.00	0	0	0
0023	2F	03_12	12	148	54	14800	14530	-270	0.36	0.98	26	25	-1
0023	2F	03_12	13	28	7	2800	1920	-880	0.25	0.69	4	3	-1
0023	2F	03_12	14	8	2	800	740	-60	0.25	0.93	1	1	0
0023	2F	03_12	15	3	0	300	0	-300	0.00	0.00	0	0	0
0023	2F	03_12	24	1	0	100	0	-100	0.00	0.00	0	0	0
0023	2F	03_2	12	61	18	6100	5190	-910	0.30	0.85	10	9	-1
0023	2F	03_2	13	44	15	4400	5870	1470	0.34	1.33	7	10	3
0023	2F	03_2	14	23	1	2300	250	-2050	0.04	0.11	4	0	-4
0023	2F	03_2	15	8	2	800	960	160	0.25	1.20	1	1	0
0023	2F	03_2	16	7	1	700	830	130	0.14	1.19	1	1	0
0023	2F	03_2	24	2	0	200	0	-200	0.00	0.00	0	0	0
0023	2F	03_2	26	1	0	100	0	-100	0.00	0.00	0	0	0
0023	2F	03_3	12	51	14	5100	4130	-970	0.27	0.81	9	7	-2
0023	2F	03_3	13	37	11	3700	3310	-390	0.30	0.89	6	5	-1
0023	2F	03_3	14	20	2	2000	380	-1620	0.10	0.19	3	0	-3
0023	2F	03_3	15	14	2	1400	2430	1030	0.14	1.74	2	4	2
0023	2F	03_3	16	8	2	800	1030	230	0.25	1.29	1	1	0
0023	2F	03_3	23	6	2	600	740	140	0.33	1.23	1	1	0
0023	2F	03_3	24	3	0	300	0	-300	0.00	0.00	0	0	0
0023	2F	03_3	25	2	1	200	300	100	0.50	1.50	0	0	0
0023	2F	03_3	26	2	0	200	0	-200	0.00	0.00	0	0	0
0023	2F	03_4	12	51	16	5100	4660	-440	0.31	0.91	9	8	-1
0023	2F	03_4	13	35	9	3500	3790	290	0.26	1.08	6	6	0
0023	2F	03_4	14	27	5	2700	1640	-1060	0.19	0.61	4	2	-2
0023	2F	03_4	15	16	6	1600	3810	2210	0.38	2.38	2	6	4
0023	2F	03_4	16	10	2	1000	4640	3640	0.20	4.64	1	8	7
0023	2F	03_4	23	3	0	300	0	-300	0.00	0.00	0	0	0
0023	2F	03_4	24	4	1	400	490	90	0.25	1.23	0	0	0
0023	2F	03_5	12	50	13	5000	3960	-1040	0.26	0.79	8	7	-1
0023	2F	03_5	13	43	15	4300	4480	180	0.35	1.04	7	7	0
0023	2F	03_5	14	21	5	2100	2070	-30	0.24	0.99	3	3	0
0023	2F	03_5	15	8	1	800	870	70	0.13	1.09	1	1	0
0023	2F	03_5	16	11	1	1100	690	-410	0.09	0.63	1	1	0
0023	2F	03_5	23	1	0	100	0	-100	0.00	0.00	0	0	0
0023	2F	03_5	24	4	0	400	0	-400	0.00	0.00	0	0	0
0023	2F	03_5	25	1	0	100	0	-100	0.00	0.00	0	0	0
0023	2F	03_5	26	3	0	300	0	-300	0.00	0.00	0	0	0
0023	2F	03_6	12	52	22	5200	6040	840	0.42	1.16	9	10	1
0023	2F	03_6	13	44	13	4400	3960	-440	0.30	0.90	7	7	0
0023	2F	03_6	14	25	5	2500	1740	-760	0.20	0.70	4	3	-1
0023	2F	03_6	15	13	2	1300	860	-440	0.15	0.66	2	1	-1
0023	2F	03_6	16	9	0	900	0	-900	0.00	0.00	1	0	-1
0023	2F	03_6	23	6	1	600	350	-250	0.17	0.58	1	0	-1
0023	2F	03_6	24	1	0	100	0	-100	0.00	0.00	0	0	0
0023	2F	03_6	25	1	1	100	300	200	1.00	3.00	0	0	0
0023	2F	03_7	12	69	25	6900	5710	-1190	0.36	0.83	12	10	-2
0023	2F	03_7	13	37	12	3700	3200	-500	0.32	0.86	6	5	-1
0023	2F	03_7	14	26	4	2600	1010	-1590	0.15	0.39	4	1	-3
0023	2F	03_7	15	19	6	1900	2160	260	0.32	1.14	3	3	0
0023	2F	03_7	16	4	1	400	220	-180	0.25	0.55	0	0	0
0023	2F	03_7	23	1	0	100	0	-100	0.00	0.00	0	0	0
0023	2F	03_7	25	2	1	200	340	140	0.50	1.70	0	0	0
0023	2F	03_7	26	2	1	200	530	330	0.50	2.65	0	0	0
0023	2F	03_8	12	67	24	6700	5720	-980	0.36	0.85	11	10	-1
0023	2F	03_8	13	45	11	4500	3140	-1360	0.24	0.70	7	5	-2
0023	2F	03_8	14	38	11	3800	4160	360	0.29	1.09	6	7	1
0023	2F	03_8	15	11	2	1100	640	-460	0.18	0.58	1	1	0
0023	2F	03_8	16	8	1	800	410	-390	0.13	0.51	1	0	-1
0023	2F	03_8	23	2	0	200	0	-200	0.00	0.00	0	0	0
0023	2F	03_8	24	2	0	200	0	-200	0.00	0.00	0	0	0
0023	2F	03_9	12	86	37	8600	8900	300	0.43	1.03	15	15	0
0023	2F	03_9	13	57	13	5700	3540	-2160	0.23	0.62	10	6	-4
0023	2F	03_9	14	19	6	1900	1850	-50	0.32	0.97	3	3	0
0023	2F	03_9	15	12	4	1200	1190	-10	0.33	0.99	2	2	0
0023	2F	03_9	16	5	0	500	0	-500	0.00	0.00	0	0	0
0023	2F	04_1	12	45	14	4500	4570	70	0.31	1.02	7	8	1
0023	2F	04_1	13	58	15	5800	4090	-1710	0.26	0.71	10	7	-3
0023	2F	04_1	14	35	6	3500	1750	-1750	0.17	0.50	6	3	-3
0023	2F	04_1	15	17	5	1700	1290	-410	0.29	0.76	3	2	-1
0023	2F	04_1	16	5	2	500	680	180	0.40	1.36	0	1	1
0023	2F	04_1	23	4	1	400	200	-200	0.25	0.50	0	0	0
0023	2F	04_1	25	1	1	100	480	380	1.00	4.80	0	0	0
0023	2F	04_10	12	117	37	11700	9930	-1770	0.32	0.85	20	17	-3
0023	2F	04_10	13	69	11	6900	3160	-3740	0.16	0.46	12	5	-7
0023	2F	04_10	14	29	10	2900	3410	510	0.34	1.18	5	6	1
0023	2F	04_10	15	4	1	400	530	130	0.25	1.33	0	0	0
0023	2F	04_10	16	1	1	100	620	520	1.00	6.20	0	1	1
0023	2F	04_10	24	1	0	100	0	-100	0.00	0.00	0	0	0
0023	2F	04_11	12	126	35	12600	10390	-2210	0.28	0.82	22	18	-4
0023	2F	04_11	13	66	21	6600	5460	-1140	0.32	0.83	11	9	-2
0023	2F	04_11	14	36	8	3600	3340	-260	0.22	0.93	6	5	-1
0023	2F	04_11	15	4	0	400	0	-400	0.00	0.00	0	0	0
0023	2F	04_11	16	1	0	100	0	-100	0.00	0.00	0	0	0
0023	2F	04_12	12	160	50	16000	14090	-1910	0.31	0.88	28	24	-4
0023	2F	04_12	13	51	11	5100	3270	-1830	0.22	0.64	9	5	-4
0023	2F	04_12	14	22	5	2200	1570	-630	0.23	0.71	3	2	-1
0023	2F	04_12	15	2	0	200	0	-200	0.00	0.00	0	0	0
0023	2F	04_2	12	44	13	4400	4410	10	0.30	1.00	7	7	0
0023	2F	04_2	13	40	7	4000	2460	-1540	0.18	0.62	7	4	-3
0023	2F	04_2	14	52	11	5200	5540	340	0.21	1.07	9	9	0
0023	2F	04_2	15	10	2	1000	920	-80	0.20	0.92	1	1	0
0023	2F	04_2	16	10	3	1000	930	-70	0.30	0.93	1	1	0
0023	2F	04_2	23	3	0	300	0	-300	0.00	0.00	0	0	0
0023	2F	04_2	24	1	1	100	360	260	1.00	3.60	0	0	0
0023	2F	04_2	25	2	0	200	0	-200	0.00	0.00	0	0	0
0023	2F	04_2	26	1	1	100	310	210	1.00	3.10	0	0	0
0023	2F	04_3	12	76	29	7600	9630	2030	0.38	1.27	13	17	4
0023	2F	04_3	13	39	13	3900	3840	-60	0.33	0.98	6	6	0
0023	2F	04_3	14	21	4	2100	1440	-660	0.19	0.69	3	2	-1
0023	2F	04_3	15	15	3	1500	2320	820	0.20	1.55	2	4	2
0023	2F	04_3	16	14	2	1400	990	-410	0.14	0.71	2	1	-1
0023	2F	04_3	23	1	0	100	0	-100	0.00	0.00	0	0	0
0023	2F	04_3	24	5	0	500	0	-500	0.00	0.00	0	0	0
0023	2F	04_3	25	1	0	100	0	-100	0.00	0.00	0	0	0
0023	2F	04_3	26	2	0	200	0	-200	0.00	0.00	0	0	0
0023	2F	04_4	12	65	16	6500	6050	-450	0.25	0.93	11	10	-1
0023	2F	04_4	13	37	7	3700	3210	-490	0.19	0.87	6	5	-1
0023	2F	04_4	14	35	6	3500	2750	-750	0.17	0.79	6	4	-2
0023	2F	04_4	15	15	0	1500	0	-1500	0.00	0.00	2	0	-2
0023	2F	04_4	16	7	0	700	0	-700	0.00	0.00	1	0	-1
0023	2F	04_4	23	2	0	200	0	-200	0.00	0.00	0	0	0
0023	2F	04_4	24	3	1	300	320	20	0.33	1.07	0	0	0
0023	2F	04_4	25	1	0	100	0	-100	0.00	0.00	0	0	0
0023	2F	04_4	26	2	1	200	2260	2060	0.50	11.30	0	4	4
0023	2F	04_5	12	98	36	9800	12320	2520	0.37	1.26	17	21	4
0023	2F	04_5	13	45	19	4500	5730	1230	0.42	1.27	7	10	3
0023	2F	04_5	14	25	8	2500	2450	-50	0.32	0.98	4	4	0
0023	2F	04_5	15	9	3	900	2110	1210	0.33	2.34	1	3	2
0023	2F	04_5	16	8	1	800	230	-570	0.13	0.29	1	0	-1
0023	2F	04_5	23	4	2	400	1430	1030	0.50	3.58	0	2	2
0023	2F	04_5	24	3	0	300	0	-300	0.00	0.00	0	0	0
0023	2F	04_5	25	2	1	200	590	390	0.50	2.95	0	1	1
0023	2F	04_5	26	2	0	200	0	-200	0.00	0.00	0	0	0
0023	2F	04_6	12	53	22	5300	7380	2080	0.42	1.39	9	13	4
0023	2F	04_6	13	38	11	3800	2200	-1600	0.29	0.58	6	3	-3
0023	2F	04_6	14	36	3	3600	700	-2900	0.08	0.19	6	1	-5
0023	2F	04_6	15	7	1	700	410	-290	0.14	0.59	1	0	-1
0023	2F	04_6	16	9	0	900	0	-900	0.00	0.00	1	0	-1
0023	2F	04_6	23	4	2	400	480	80	0.50	1.20	0	0	0
0023	2F	04_6	24	3	0	300	0	-300	0.00	0.00	0	0	0
0023	2F	04_6	25	3	0	300	0	-300	0.00	0.00	0	0	0
0023	2F	04_6	26	4	0	400	0	-400	0.00	0.00	0	0	0
0023	2F	04_7	12	74	23	7400	5890	-1510	0.31	0.80	13	10	-3
0023	2F	04_7	13	40	13	4000	4430	430	0.33	1.11	7	7	0
0023	2F	04_7	14	29	8	2900	1920	-980	0.28	0.66	5	3	-2
0023	2F	04_7	15	13	1	1300	430	-870	0.08	0.33	2	0	-2
0023	2F	04_7	16	15	1	1500	180	-1320	0.07	0.12	2	0	-2
0023	2F	04_7	23	1	0	100	0	-100	0.00	0.00	0	0	0
0023	2F	04_7	24	3	0	300	0	-300	0.00	0.00	0	0	0
0023	2F	04_7	26	1	0	100	0	-100	0.00	0.00	0	0	0
0023	2F	04_8	12	86	26	8600	9440	840	0.30	1.10	15	16	1
0023	2F	04_8	13	60	22	6000	6310	310	0.37	1.05	10	11	1
0023	2F	04_8	14	32	8	3200	2150	-1050	0.25	0.67	5	3	-2
0023	2F	04_8	15	7	2	700	700	0	0.29	1.00	1	1	0
0023	2F	04_8	16	20	5	2000	2130	130	0.25	1.07	3	3	0
0023	2F	04_8	24	2	0	200	0	-200	0.00	0.00	0	0	0
0023	2F	04_8	26	2	0	200	0	-200	0.00	0.00	0	0	0
0023	2F	04_9	12	95	29	9500	11000	1500	0.31	1.16	16	19	3
0023	2F	04_9	13	75	20	7500	5500	-2000	0.27	0.73	13	9	-4
0023	2F	04_9	14	32	10	3200	2910	-290	0.31	0.91	5	5	0
0023	2F	04_9	15	9	2	900	970	70	0.22	1.08	1	1	0
0023	2F	04_9	16	11	4	1100	1170	70	0.36	1.06	1	2	1
0023	2F	04_9	26	1	0	100	0	-100	0.00	0.00	0	0	0
0023	2F	05_1	12	80	24	8000	8860	860	0.30	1.11	14	15	1
0023	2F	05_1	13	35	9	3500	2590	-910	0.26	0.74	6	4	-2
0023	2F	05_1	14	143	63	14300	13010	-1290	0.44	0.91	25	23	-2
0023	2F	05_1	16	1	0	100	0	-100	0.00	0.00	0	0	0
0023	2F	05_10	12	132	44	13200	11280	-1920	0.33	0.85	23	19	-4
0023	2F	05_10	13	73	24	7300	6520	-780	0.33	0.89	12	11	-1
0023	2F	05_10	14	15	5	1500	1510	10	0.33	1.01	2	2	0
0023	2F	05_10	15	1	0	100	0	-100	0.00	0.00	0	0	0
0023	2F	05_10	16	1	0	100	0	-100	0.00	0.00	0	0	0
0023	2F	05_10	23	1	0	100	0	-100	0.00	0.00	0	0	0
0023	2F	05_10	24	1	0	100	0	-100	0.00	0.00	0	0	0
0023	2F	05_11	12	140	46	14000	10950	-3050	0.33	0.78	24	19	-5
0023	2F	05_11	13	78	25	7800	7140	-660	0.32	0.92	13	12	-1
0023	2F	05_11	14	23	6	2300	1440	-860	0.26	0.63	4	2	-2
0023	2F	05_11	15	1	0	100	0	-100	0.00	0.00	0	0	0
0023	2F	05_12	12	145	55	14500	14010	-490	0.38	0.97	25	24	-1
0023	2F	05_12	13	90	22	9000	6560	-2440	0.24	0.73	15	11	-4
0023	2F	05_12	14	11	3	1100	850	-250	0.27	0.77	1	1	0
0023	2F	05_12	16	1	0	100	0	-100	0.00	0.00	0	0	0
0023	2F	05_2	12	58	16	5800	4260	-1540	0.28	0.73	10	7	-3
0023	2F	05_2	13	61	13	6100	5360	-740	0.21	0.88	10	9	-1
0023	2F	05_2	14	21	6	2100	2920	820	0.29	1.39	3	5	2
0023	2F	05_2	15	12	1	1200	760	-440	0.08	0.63	2	1	-1
0023	2F	05_2	16	8	1	800	610	-190	0.13	0.76	1	1	0
0023	2F	05_2	23	2	0	200	0	-200	0.00	0.00	0	0	0
0023	2F	05_2	24	3	1	300	300	0	0.33	1.00	0	0	0
0023	2F	05_3	12	70	20	7000	6170	-830	0.29	0.88	12	10	-2
0023	2F	05_3	13	36	11	3600	3560	-40	0.31	0.99	6	6	0
0023	2F	05_3	14	23	8	2300	3900	1600	0.35	1.70	4	6	2
0023	2F	05_3	15	18	0	1800	0	-1800	0.00	0.00	3	0	-3
0023	2F	05_3	16	3	1	300	890	590	0.33	2.97	0	1	1
0023	2F	05_3	23	9	2	900	410	-490	0.22	0.46	1	0	-1
0023	2F	05_3	24	7	3	700	880	180	0.43	1.26	1	1	0
0023	2F	05_3	25	1	0	100	0	-100	0.00	0.00	0	0	0
0023	2F	05_3	26	2	0	200	0	-200	0.00	0.00	0	0	0
0023	2F	05_4	12	61	13	6100	4020	-2080	0.21	0.66	10	7	-3
0023	2F	05_4	13	41	15	4100	4070	-30	0.37	0.99	7	7	0
0023	2F	05_4	14	26	6	2600	1850	-750	0.23	0.71	4	3	-1
0023	2F	05_4	15	17	4	1700	1570	-130	0.24	0.92	3	2	-1
0023	2F	05_4	16	5	0	500	0	-500	0.00	0.00	0	0	0
0023	2F	05_4	23	4	0	400	0	-400	0.00	0.00	0	0	0
0023	2F	05_4	24	6	3	600	870	270	0.50	1.45	1	1	0
0023	2F	05_4	25	6	0	600	0	-600	0.00	0.00	1	0	-1
0023	2F	05_4	26	4	1	400	350	-50	0.25	0.88	0	0	0
0023	2F	05_5	12	74	21	7400	8610	1210	0.28	1.16	13	15	2
0023	2F	05_5	13	37	10	3700	2840	-860	0.27	0.77	6	5	-1
0023	2F	05_5	14	26	4	2600	1560	-1040	0.15	0.60	4	2	-2
0023	2F	05_5	15	15	5	1500	1550	50	0.33	1.03	2	2	0
0023	2F	05_5	16	8	3	800	1970	1170	0.38	2.46	1	3	2
0023	2F	05_5	23	1	0	100	0	-100	0.00	0.00	0	0	0
0023	2F	05_5	24	2	1	200	220	20	0.50	1.10	0	0	0
0023	2F	05_5	25	4	1	400	290	-110	0.25	0.73	0	0	0
0023	2F	05_5	26	2	0	200	0	-200	0.00	0.00	0	0	0
0023	2F	05_6	12	77	22	7700	6550	-1150	0.29	0.85	13	11	-2
0023	2F	05_6	13	41	10	4100	3840	-260	0.24	0.94	7	6	-1
0023	2F	05_6	14	28	10	2800	2820	20	0.36	1.01	4	4	0
0023	2F	05_6	15	12	4	1200	900	-300	0.33	0.75	2	1	-1
0023	2F	05_6	16	8	1	800	630	-170	0.13	0.79	1	1	0
0023	2F	05_6	23	8	2	800	1240	440	0.25	1.55	1	2	1
0023	2F	05_6	24	2	1	200	290	90	0.50	1.45	0	0	0
0023	2F	05_6	25	4	0	400	0	-400	0.00	0.00	0	0	0
0023	2F	05_6	26	3	0	300	0	-300	0.00	0.00	0	0	0
0023	2F	05_7	12	117	34	11700	11330	-370	0.29	0.97	20	20	0
0023	2F	05_7	13	57	14	5700	3560	-2140	0.25	0.62	10	6	-4
0023	2F	05_7	14	19	1	1900	200	-1700	0.05	0.11	3	0	-3
0023	2F	05_7	15	10	1	1000	330	-670	0.10	0.33	1	0	-1
0023	2F	05_7	16	5	1	500	680	180	0.20	1.36	0	1	1
0023	2F	05_7	23	2	1	200	270	70	0.50	1.35	0	0	0
0023	2F	05_7	24	3	0	300	0	-300	0.00	0.00	0	0	0
0023	2F	05_7	26	1	0	100	0	-100	0.00	0.00	0	0	0
0023	2F	05_8	12	113	39	11300	10700	-600	0.35	0.95	20	18	-2
0023	2F	05_8	13	61	18	6100	4540	-1560	0.30	0.74	10	8	-2
0023	2F	05_8	14	25	9	2500	2470	-30	0.36	0.99	4	4	0
0023	2F	05_8	15	5	1	500	310	-190	0.20	0.62	0	0	0
0023	2F	05_8	16	7	1	700	340	-360	0.14	0.49	1	0	-1
0023	2F	05_8	23	7	2	700	500	-200	0.29	0.71	1	0	-1
0023	2F	05_8	24	1	0	100	0	-100	0.00	0.00	0	0	0
0023	2F	05_8	26	2	0	200	0	-200	0.00	0.00	0	0	0
0023	2F	05_9	12	181	59	18100	14700	-3400	0.33	0.81	32	26	-6
0023	2F	05_9	13	49	14	4900	3520	-1380	0.29	0.72	8	6	-2
0023	2F	05_9	14	22	5	2200	1760	-440	0.23	0.80	3	3	0
0023	2F	05_9	15	3	2	300	500	200	0.67	1.67	0	0	0
0023	2F	06_1	12	131	46	13100	13640	540	0.35	1.04	23	24	1
0023	2F	06_1	13	53	10	5300	2900	-2400	0.19	0.55	9	5	-4
0023	2F	06_1	14	20	7	2000	2340	340	0.35	1.17	3	4	1
0023	2F	06_1	15	7	0	700	0	-700	0.00	0.00	1	0	-1
0023	2F	06_1	16	5	1	500	1010	510	0.20	2.02	0	1	1
0023	2F	06_1	23	5	0	500	0	-500	0.00	0.00	0	0	0
0023	2F	06_1	24	6	0	600	0	-600	0.00	0.00	1	0	-1
0023	2F	06_1	25	3	0	300	0	-300	0.00	0.00	0	0	0
0023	2F	06_1	26	2	0	200	0	-200	0.00	0.00	0	0	0
0023	2F	06_10	12	143	46	14300	10750	-3550	0.32	0.75	25	19	-6
0023	2F	06_10	13	89	18	8900	4490	-4410	0.20	0.50	15	7	-8
0023	2F	06_10	14	23	8	2300	2390	90	0.35	1.04	4	4	0
0023	2F	06_10	15	1	0	100	0	-100	0.00	0.00	0	0	0
0023	2F	06_10	16	3	0	300	0	-300	0.00	0.00	0	0	0
0023	2F	06_10	23	1	0	100	0	-100	0.00	0.00	0	0	0
0023	2F	06_10	25	1	0	100	0	-100	0.00	0.00	0	0	0
0023	2F	06_11	12	140	56	14000	13890	-110	0.40	0.99	24	24	0
0023	2F	06_11	13	103	34	10300	9130	-1170	0.33	0.89	18	16	-2
0023	2F	06_11	14	29	10	2900	2470	-430	0.34	0.85	5	4	-1
0023	2F	06_11	15	2	0	200	0	-200	0.00	0.00	0	0	0
0023	2F	06_12	12	162	45	16200	12900	-3300	0.28	0.80	28	22	-6
0023	2F	06_12	13	99	33	9900	7930	-1970	0.33	0.80	17	14	-3
0023	2F	06_12	14	15	2	1500	540	-960	0.13	0.36	2	0	-2
0023	2F	06_2	12	77	22	7700	6910	-790	0.29	0.90	13	12	-1
0023	2F	06_2	13	45	7	4500	1500	-3000	0.16	0.33	7	2	-5
0023	2F	06_2	14	21	4	2100	1250	-850	0.19	0.60	3	2	-1
0023	2F	06_2	15	9	3	900	720	-180	0.33	0.80	1	1	0
0023	2F	06_2	16	8	1	800	420	-380	0.13	0.53	1	0	-1
0023	2F	06_2	23	9	3	900	600	-300	0.33	0.67	1	1	0
0023	2F	06_2	24	3	0	300	0	-300	0.00	0.00	0	0	0
0023	2F	06_2	25	2	0	200	0	-200	0.00	0.00	0	0	0
0023	2F	06_2	26	1	0	100	0	-100	0.00	0.00	0	0	0
0023	2F	06_3	12	65	19	6500	8880	2380	0.29	1.37	11	15	4
0023	2F	06_3	13	46	9	4600	3990	-610	0.20	0.87	8	7	-1
0023	2F	06_3	14	17	5	1700	2770	1070	0.29	1.63	3	4	1
0023	2F	06_3	15	4	0	400	0	-400	0.00	0.00	0	0	0
0023	2F	06_3	16	2	0	200	0	-200	0.00	0.00	0	0	0
0023	2F	06_3	23	6	0	600	0	-600	0.00	0.00	1	0	-1
0023	2F	06_3	24	10	1	1000	360	-640	0.10	0.36	1	0	-1
0023	2F	06_3	25	4	0	400	0	-400	0.00	0.00	0	0	0
0023	2F	06_3	26	3	1	300	1140	840	0.33	3.80	0	2	2
0023	2F	06_4	12	177	60	17700	16770	-930	0.34	0.95	31	29	-2
0023	2F	06_4	13	80	29	8000	7130	-870	0.36	0.89	14	12	-2
0023	2F	06_4	14	16	3	1600	770	-830	0.19	0.48	2	1	-1
0023	2F	06_4	15	6	1	600	350	-250	0.17	0.58	1	0	-1
0023	2F	06_5	12	62	15	6200	5170	-1030	0.24	0.83	10	9	-1
0023	2F	06_5	13	52	13	5200	5450	250	0.25	1.05	9	9	0
0023	2F	06_5	14	21	6	2100	2410	310	0.29	1.15	3	4	1
0023	2F	06_5	15	4	1	400	460	60	0.25	1.15	0	0	0
0023	2F	06_5	16	4	0	400	0	-400	0.00	0.00	0	0	0
0023	2F	06_5	23	6	0	600	0	-600	0.00	0.00	1	0	-1
0023	2F	06_5	24	6	0	600	0	-600	0.00	0.00	1	0	-1
0023	2F	06_5	25	2	1	200	300	100	0.50	1.50	0	0	0
0023	2F	06_5	26	8	3	800	1270	470	0.38	1.59	1	2	1
0023	2F	06_6	12	73	25	7300	8190	890	0.34	1.12	12	14	2
0023	2F	06_6	13	46	13	4600	4730	130	0.28	1.03	8	8	0
0023	2F	06_6	14	24	5	2400	1310	-1090	0.21	0.55	4	2	-2
0023	2F	06_6	15	8	5	800	1210	410	0.63	1.51	1	2	1
0023	2F	06_6	16	3	1	300	280	-20	0.33	0.93	0	0	0
0023	2F	06_6	23	5	1	500	500	0	0.20	1.00	0	0	0
0023	2F	06_6	24	3	0	300	0	-300	0.00	0.00	0	0	0
0023	2F	06_6	25	1	1	100	290	190	1.00	2.90	0	0	0
0023	2F	06_6	26	6	0	600	0	-600	0.00	0.00	1	0	-1
0023	2F	06_7	12	112	28	11200	7010	-4190	0.25	0.63	19	12	-7
0023	2F	06_7	13	81	22	8100	5320	-2780	0.27	0.66	14	9	-5
0023	2F	06_7	14	41	10	4100	3770	-330	0.24	0.92	7	6	-1
0023	2F	06_7	15	9	1	900	200	-700	0.11	0.22	1	0	-1
0023	2F	06_7	16	8	4	800	900	100	0.50	1.13	1	1	0
0023	2F	06_7	23	1	0	100	0	-100	0.00	0.00	0	0	0
0023	2F	06_7	24	3	2	300	710	410	0.67	2.37	0	1	1
0023	2F	06_8	12	92	21	9200	7170	-2030	0.23	0.78	16	12	-4
0023	2F	06_8	13	87	27	8700	6710	-1990	0.31	0.77	15	11	-4
0023	2F	06_8	14	44	16	4400	4110	-290	0.36	0.93	7	7	0
0023	2F	06_8	15	13	5	1300	1240	-60	0.38	0.95	2	2	0
0023	2F	06_8	16	7	1	700	490	-210	0.14	0.70	1	0	-1
0023	2F	06_8	23	1	0	100	0	-100	0.00	0.00	0	0	0
0023	2F	06_8	25	1	1	100	270	170	1.00	2.70	0	0	0
0023	2F	06_8	26	1	1	100	1360	1260	1.00	13.60	0	2	2
0023	2F	06_9	12	118	46	11800	10450	-1350	0.39	0.89	20	18	-2
0023	2F	06_9	13	66	19	6600	4270	-2330	0.29	0.65	11	7	-4
0023	2F	06_9	14	46	11	4600	3140	-1460	0.24	0.68	8	5	-3
0023	2F	06_9	15	2	0	200	0	-200	0.00	0.00	0	0	0
0023	2F	06_9	16	1	0	100	0	-100	0.00	0.00	0	0	0
0023	2F	06_9	23	2	1	200	1320	1120	0.50	6.60	0	2	2
0023	2F	07_1	12	82	20	8200	6360	-1840	0.24	0.78	14	11	-3
0023	2F	07_1	13	54	12	5400	3490	-1910	0.22	0.65	9	6	-3
0023	2F	07_1	14	14	1	1400	310	-1090	0.07	0.22	2	0	-2
0023	2F	07_1	15	9	1	900	250	-650	0.11	0.28	1	0	-1
0023	2F	07_1	16	8	2	800	600	-200	0.25	0.75	1	1	0
0023	2F	07_1	23	1	0	100	0	-100	0.00	0.00	0	0	0
0023	2F	07_1	24	1	0	100	0	-100	0.00	0.00	0	0	0
0023	2F	07_1	25	1	0	100	0	-100	0.00	0.00	0	0	0
0023	2F	07_1	26	1	0	100	0	-100	0.00	0.00	0	0	0
0023	2F	07_10	12	175	63	17500	17980	480	0.36	1.03	30	31	1
0023	2F	07_10	13	69	21	6900	5910	-990	0.30	0.86	12	10	-2
0023	2F	07_10	14	23	9	2300	2120	-180	0.39	0.92	4	3	-1
0023	2F	07_10	15	4	1	400	370	-30	0.25	0.93	0	0	0
0023	2F	07_10	16	2	2	200	650	450	1.00	3.25	0	1	1
0023	2F	07_10	23	1	0	100	0	-100	0.00	0.00	0	0	0
0023	2F	07_11	12	164	54	16400	13660	-2740	0.33	0.83	29	24	-5
0023	2F	07_11	13	95	34	9500	9010	-490	0.36	0.95	16	15	-1
0023	2F	07_11	14	17	6	1700	1670	-30	0.35	0.98	3	2	-1
0023	2F	07_11	15	3	0	300	0	-300	0.00	0.00	0	0	0
0023	2F	07_11	16	1	0	100	0	-100	0.00	0.00	0	0	0
0023	2F	07_11	24	1	0	100	0	-100	0.00	0.00	0	0	0
0023	2F	07_12	12	181	56	18100	14720	-3380	0.31	0.81	32	26	-6
0023	2F	07_12	13	59	18	5900	4340	-1560	0.31	0.74	10	7	-3
0023	2F	07_12	14	32	13	3200	3660	460	0.41	1.14	5	6	1
0023	2F	07_12	26	1	0	100	0	-100	0.00	0.00	0	0	0
0023	2F	07_2	12	86	21	8600	7680	-920	0.24	0.89	15	13	-2
0023	2F	07_2	13	40	13	4000	4410	410	0.33	1.10	7	7	0
0023	2F	07_2	14	19	2	1900	440	-1460	0.11	0.23	3	0	-3
0023	2F	07_2	15	18	3	1800	990	-810	0.17	0.55	3	1	-2
0023	2F	07_2	16	4	0	400	0	-400	0.00	0.00	0	0	0
0023	2F	07_2	23	4	1	400	530	130	0.25	1.33	0	0	0
0023	2F	07_2	24	2	0	200	0	-200	0.00	0.00	0	0	0
0023	2F	07_2	25	3	0	300	0	-300	0.00	0.00	0	0	0
0023	2F	07_2	26	2	0	200	0	-200	0.00	0.00	0	0	0
0023	2F	07_3	12	85	22	8500	6700	-1800	0.26	0.79	15	11	-4
0023	2F	07_3	13	50	10	5000	3550	-1450	0.20	0.71	8	6	-2
0023	2F	07_3	14	21	6	2100	2010	-90	0.29	0.96	3	3	0
0023	2F	07_3	15	18	3	1800	1330	-470	0.17	0.74	3	2	-1
0023	2F	07_3	16	7	1	700	1090	390	0.14	1.56	1	1	0
0023	2F	07_3	23	5	0	500	0	-500	0.00	0.00	0	0	0
0023	2F	07_3	24	2	0	200	0	-200	0.00	0.00	0	0	0
0023	2F	07_3	25	1	0	100	0	-100	0.00	0.00	0	0	0
0023	2F	07_3	26	2	0	200	0	-200	0.00	0.00	0	0	0
0023	2F	07_4	12	102	25	10200	7590	-2610	0.25	0.74	18	13	-5
0023	2F	07_4	13	57	15	5700	4270	-1430	0.26	0.75	10	7	-3
0023	2F	07_4	14	19	1	1900	400	-1500	0.05	0.21	3	0	-3
0023	2F	07_4	15	14	1	1400	360	-1040	0.07	0.26	2	0	-2
0023	2F	07_4	16	7	2	700	1470	770	0.29	2.10	1	2	1
0023	2F	07_4	23	3	1	300	610	310	0.33	2.03	0	1	1
0023	2F	07_4	24	2	0	200	0	-200	0.00	0.00	0	0	0
0023	2F	07_4	25	3	0	300	0	-300	0.00	0.00	0	0	0
0023	2F	07_4	26	4	0	400	0	-400	0.00	0.00	0	0	0
0023	2F	07_5	12	93	27	9300	7390	-1910	0.29	0.79	16	13	-3
0023	2F	07_5	13	37	10	3700	2500	-1200	0.27	0.68	6	4	-2
0023	2F	07_5	14	19	6	1900	2040	140	0.32	1.07	3	3	0
0023	2F	07_5	15	17	6	1700	2250	550	0.35	1.32	3	3	0
0023	2F	07_5	16	15	5	1500	1420	-80	0.33	0.95	2	2	0
0023	2F	07_5	23	9	2	900	600	-300	0.22	0.67	1	1	0
0023	2F	07_5	25	6	2	600	780	180	0.33	1.30	1	1	0
0023	2F	07_5	26	4	3	400	1380	980	0.75	3.45	0	2	2
0023	2F	07_6	12	108	37	10800	9760	-1040	0.34	0.90	19	17	-2
0023	2F	07_6	13	50	20	5000	6140	1140	0.40	1.23	8	10	2
0023	2F	07_6	14	19	6	1900	1330	-570	0.32	0.70	3	2	-1
0023	2F	07_6	15	15	6	1500	2190	690	0.40	1.46	2	3	1
0023	2F	07_6	16	14	4	1400	1450	50	0.29	1.04	2	2	0
0023	2F	07_6	23	4	0	400	0	-400	0.00	0.00	0	0	0
0023	2F	07_6	24	3	0	300	0	-300	0.00	0.00	0	0	0
0023	2F	07_6	25	4	0	400	0	-400	0.00	0.00	0	0	0
0023	2F	07_6	26	7	0	700	0	-700	0.00	0.00	1	0	-1
0023	2F	07_7	12	49	14	4900	4560	-340	0.29	0.93	8	8	0
0023	2F	07_7	13	107	51	10700	10020	-680	0.48	0.94	18	17	-1
0023	2F	07_7	14	118	44	11800	9650	-2150	0.37	0.82	20	17	-3
0023	2F	07_7	15	6	1	600	660	60	0.17	1.10	1	1	0
0023	2F	07_8	12	126	37	12600	9120	-3480	0.29	0.72	22	16	-6
0023	2F	07_8	13	61	22	6100	5780	-320	0.36	0.95	10	10	0
0023	2F	07_8	14	33	7	3300	1790	-1510	0.21	0.54	5	3	-2
0023	2F	07_8	15	8	0	800	0	-800	0.00	0.00	1	0	-1
0023	2F	07_8	16	4	3	400	1600	1200	0.75	4.00	0	2	2
0023	2F	07_8	24	2	0	200	0	-200	0.00	0.00	0	0	0
0023	2F	07_9	12	135	48	13500	11810	-1690	0.36	0.87	23	20	-3
0023	2F	07_9	13	78	24	7800	5140	-2660	0.31	0.66	13	9	-4
0023	2F	07_9	14	28	7	2800	1730	-1070	0.25	0.62	4	3	-1
0023	2F	07_9	15	5	1	500	240	-260	0.20	0.48	0	0	0
0023	2F	07_9	16	2	1	200	150	-50	0.50	0.75	0	0	0
0023	2F	07_9	26	2	0	200	0	-200	0.00	0.00	0	0	0
0023	2F	08_1	12	83	25	8300	7690	-610	0.30	0.93	14	13	-1
0023	2F	08_1	13	54	6	5400	1440	-3960	0.11	0.27	9	2	-7
0023	2F	08_1	14	26	7	2600	2240	-360	0.27	0.86	4	3	-1
0023	2F	08_1	15	19	7	1900	3490	1590	0.37	1.84	3	6	3
0023	2F	08_1	16	4	0	400	0	-400	0.00	0.00	0	0	0
0023	2F	08_1	23	1	0	100	0	-100	0.00	0.00	0	0	0
0023	2F	08_1	24	2	0	200	0	-200	0.00	0.00	0	0	0
0023	2F	08_1	25	3	2	300	1050	750	0.67	3.50	0	1	1
0023	2F	08_1	26	1	0	100	0	-100	0.00	0.00	0	0	0
0023	2F	08_10	12	190	64	19000	15020	-3980	0.34	0.79	33	26	-7
0023	2F	08_10	13	58	20	5800	5050	-750	0.34	0.87	10	8	-2
0023	2F	08_10	14	23	6	2300	1550	-750	0.26	0.67	4	2	-2
0023	2F	08_10	15	3	1	300	270	-30	0.33	0.90	0	0	0
0023	2F	08_10	23	1	1	100	240	140	1.00	2.40	0	0	0
0023	2F	08_10	25	1	0	100	0	-100	0.00	0.00	0	0	0
0023	2F	08_11	12	191	65	19100	15310	-3790	0.34	0.80	33	27	-6
0023	2F	08_11	13	49	14	4900	3770	-1130	0.29	0.77	8	6	-2
0023	2F	08_11	14	33	11	3300	2410	-890	0.33	0.73	5	4	-1
0023	2F	08_11	15	1	0	100	0	-100	0.00	0.00	0	0	0
0023	2F	08_12	12	238	89	23800	21090	-2710	0.37	0.89	42	37	-5
0023	2F	08_12	13	26	3	2600	750	-1850	0.12	0.29	4	1	-3
0023	2F	08_12	14	12	3	1200	720	-480	0.25	0.60	2	1	-1
0023	2F	08_2	12	94	29	9400	7600	-1800	0.31	0.81	16	13	-3
0023	2F	08_2	13	60	12	6000	3250	-2750	0.20	0.54	10	5	-5
0023	2F	08_2	14	28	5	2800	2350	-450	0.18	0.84	4	4	0
0023	2F	08_2	15	10	4	1000	1630	630	0.40	1.63	1	2	1
0023	2F	08_2	16	5	1	500	420	-80	0.20	0.84	0	0	0
0023	2F	08_2	23	2	1	200	240	40	0.50	1.20	0	0	0
0023	2F	08_2	24	1	0	100	0	-100	0.00	0.00	0	0	0
0023	2F	08_2	25	1	0	100	0	-100	0.00	0.00	0	0	0
0023	2F	08_2	26	1	0	100	0	-100	0.00	0.00	0	0	0
0023	2F	08_3	12	95	33	9500	9420	-80	0.35	0.99	16	16	0
0023	2F	08_3	13	53	16	5300	4780	-520	0.30	0.90	9	8	-1
0023	2F	08_3	14	29	7	2900	3030	130	0.24	1.04	5	5	0
0023	2F	08_3	15	12	2	1200	1450	250	0.17	1.21	2	2	0
0023	2F	08_3	16	13	1	1300	230	-1070	0.08	0.18	2	0	-2
0023	2F	08_3	23	3	0	300	0	-300	0.00	0.00	0	0	0
0023	2F	08_3	24	3	1	300	360	60	0.33	1.20	0	0	0
0023	2F	08_3	25	2	0	200	0	-200	0.00	0.00	0	0	0
0023	2F	08_3	26	2	0	200	0	-200	0.00	0.00	0	0	0
0023	2F	08_4	12	113	36	11300	9740	-1560	0.32	0.86	20	17	-3
0023	2F	08_4	13	69	14	6900	3460	-3440	0.20	0.50	12	6	-6
0023	2F	08_4	14	33	4	3300	950	-2350	0.12	0.29	5	1	-4
0023	2F	08_4	15	13	2	1300	460	-840	0.15	0.35	2	0	-2
0023	2F	08_4	16	11	4	1100	1010	-90	0.36	0.92	1	1	0
0023	2F	08_4	24	2	0	200	0	-200	0.00	0.00	0	0	0
0023	2F	08_4	26	3	0	300	0	-300	0.00	0.00	0	0	0
0023	2F	08_5	12	112	34	11200	10240	-960	0.30	0.91	19	18	-1
0023	2F	08_5	13	74	25	7400	6550	-850	0.34	0.89	13	11	-2
0023	2F	08_5	14	36	9	3600	1830	-1770	0.25	0.51	6	3	-3
0023	2F	08_5	15	6	0	600	0	-600	0.00	0.00	1	0	-1
0023	2F	08_5	16	12	3	1200	940	-260	0.25	0.78	2	1	-1
0023	2F	08_5	24	2	0	200	0	-200	0.00	0.00	0	0	0
0023	2F	08_5	26	2	1	200	390	190	0.50	1.95	0	0	0
0023	2F	08_6	12	83	21	8300	6810	-1490	0.25	0.82	14	12	-2
0023	2F	08_6	13	53	18	5300	4510	-790	0.34	0.85	9	7	-2
0023	2F	08_6	14	30	6	3000	1380	-1620	0.20	0.46	5	2	-3
0023	2F	08_6	15	15	3	1500	760	-740	0.20	0.51	2	1	-1
0023	2F	08_6	16	34	12	3400	3920	520	0.35	1.15	6	6	0
0023	2F	08_6	23	2	0	200	0	-200	0.00	0.00	0	0	0
0023	2F	08_6	24	3	1	300	240	-60	0.33	0.80	0	0	0
0023	2F	08_6	26	3	0	300	0	-300	0.00	0.00	0	0	0
0023	2F	08_7	12	91	23	9100	7290	-1810	0.25	0.80	16	12	-4
0023	2F	08_7	13	63	19	6300	5530	-770	0.30	0.88	11	9	-2
0023	2F	08_7	14	29	12	2900	2990	90	0.41	1.03	5	5	0
0023	2F	08_7	15	12	0	1200	0	-1200	0.00	0.00	2	0	-2
0023	2F	08_7	16	25	6	2500	3080	580	0.24	1.23	4	5	1
0023	2F	08_7	23	2	1	200	330	130	0.50	1.65	0	0	0
0023	2F	08_7	25	1	0	100	0	-100	0.00	0.00	0	0	0
0023	2F	08_7	26	1	0	100	0	-100	0.00	0.00	0	0	0
0023	2F	08_8	12	51	18	5100	4890	-210	0.35	0.96	9	8	-1
0023	2F	08_8	13	49	23	4900	5160	260	0.47	1.05	8	9	1
0023	2F	08_8	14	35	16	3500	3200	-300	0.46	0.91	6	5	-1
0023	2F	08_8	15	8	4	800	950	150	0.50	1.19	1	1	0
0023	2F	08_8	16	6	1	600	630	30	0.17	1.05	1	1	0
0023	2F	08_8	23	2	0	200	0	-200	0.00	0.00	0	0	0
0023	2F	08_9	12	144	50	14400	12860	-1540	0.35	0.89	25	22	-3
0023	2F	08_9	13	63	20	6300	5750	-550	0.32	0.91	11	10	-1
0023	2F	08_9	14	41	11	4100	2480	-1620	0.27	0.60	7	4	-3
0023	2F	08_9	15	11	2	1100	550	-550	0.18	0.50	1	0	-1
0023	2F	08_9	16	4	1	400	270	-130	0.25	0.68	0	0	0
0023	2F	08_9	23	1	0	100	0	-100	0.00	0.00	0	0	0
0023	2F	09_1	12	221	82	22100	18170	-3930	0.37	0.82	39	32	-7
0023	2F	09_1	13	42	14	4200	2860	-1340	0.33	0.68	7	5	-2
0023	2F	09_1	14	15	5	1500	1340	-160	0.33	0.89	2	2	0
0023	2F	09_1	15	3	1	300	300	0	0.33	1.00	0	0	0
0023	2F	09_1	16	2	0	200	0	-200	0.00	0.00	0	0	0
0023	2F	09_10	12	162	67	16200	15850	-350	0.41	0.98	28	28	0
0023	2F	09_10	13	64	17	6400	4080	-2320	0.27	0.64	11	7	-4
0023	2F	09_10	14	33	6	3300	1630	-1670	0.18	0.49	5	2	-3
0023	2F	09_10	15	4	0	400	0	-400	0.00	0.00	0	0	0
0023	2F	09_10	16	1	0	100	0	-100	0.00	0.00	0	0	0
0023	2F	09_10	23	2	0	200	0	-200	0.00	0.00	0	0	0
0023	2F	09_11	12	195	66	19500	15090	-4410	0.34	0.77	34	26	-8
0023	2F	09_11	13	56	22	5600	5520	-80	0.39	0.99	9	9	0
0023	2F	09_11	14	15	6	1500	1590	90	0.40	1.06	2	2	0
0023	2F	09_11	24	2	0	200	0	-200	0.00	0.00	0	0	0
0023	2F	09_12	12	238	89	23800	20260	-3540	0.37	0.85	42	35	-7
0023	2F	09_12	13	28	8	2800	1970	-830	0.29	0.70	4	3	-1
0023	2F	09_12	14	11	1	1100	580	-520	0.09	0.53	1	1	0
0023	2F	09_12	15	1	0	100	0	-100	0.00	0.00	0	0	0
0023	2F	09_2	12	113	43	11300	10700	-600	0.38	0.95	20	18	-2
0023	2F	09_2	13	52	17	5200	5900	700	0.33	1.13	9	10	1
0023	2F	09_2	14	20	4	2000	2720	720	0.20	1.36	3	4	1
0023	2F	09_2	15	7	1	700	320	-380	0.14	0.46	1	0	-1
0023	2F	09_2	16	10	1	1000	390	-610	0.10	0.39	1	0	-1
0023	2F	09_2	23	3	0	300	0	-300	0.00	0.00	0	0	0
0023	2F	09_2	24	1	1	100	410	310	1.00	4.10	0	0	0
0023	2F	09_2	26	3	0	300	0	-300	0.00	0.00	0	0	0
0023	2F	09_3	12	101	25	10100	8910	-1190	0.25	0.88	17	15	-2
0023	2F	09_3	13	42	10	4200	2800	-1400	0.24	0.67	7	4	-3
0023	2F	09_3	14	32	7	3200	2560	-640	0.22	0.80	5	4	-1
0023	2F	09_3	15	14	3	1400	1760	360	0.21	1.26	2	3	1
0023	2F	09_3	16	9	2	900	770	-130	0.22	0.86	1	1	0
0023	2F	09_3	23	5	1	500	250	-250	0.20	0.50	0	0	0
0023	2F	09_3	24	3	2	300	550	250	0.67	1.83	0	0	0
0023	2F	09_3	25	2	0	200	0	-200	0.00	0.00	0	0	0
0023	2F	09_3	26	8	0	800	0	-800	0.00	0.00	1	0	-1
0023	2F	09_4	12	84	25	8400	7390	-1010	0.30	0.88	14	13	-1
0023	2F	09_4	13	47	15	4700	5410	710	0.32	1.15	8	9	1
0023	2F	09_4	14	24	3	2400	960	-1440	0.13	0.40	4	1	-3
0023	2F	09_4	15	13	3	1300	890	-410	0.23	0.68	2	1	-1
0023	2F	09_4	16	16	3	1600	1720	120	0.19	1.08	2	3	1
0023	2F	09_4	23	4	0	400	0	-400	0.00	0.00	0	0	0
0023	2F	09_4	24	2	0	200	0	-200	0.00	0.00	0	0	0
0023	2F	09_4	25	2	0	200	0	-200	0.00	0.00	0	0	0
0023	2F	09_4	26	15	1	1500	570	-930	0.07	0.38	2	1	-1
0023	2F	09_5	12	193	72	19300	15370	-3930	0.37	0.80	34	27	-7
0023	2F	09_5	13	67	18	6700	4330	-2370	0.27	0.65	11	7	-4
0023	2F	09_5	14	19	2	1900	580	-1320	0.11	0.31	3	1	-2
0023	2F	09_5	15	3	0	300	0	-300	0.00	0.00	0	0	0
0023	2F	09_5	23	1	0	100	0	-100	0.00	0.00	0	0	0
0023	2F	09_5	26	1	1	100	380	280	1.00	3.80	0	0	0
0023	2F	09_6	12	73	26	7300	6640	-660	0.36	0.91	12	11	-1
0023	2F	09_6	13	48	21	4800	6270	1470	0.44	1.31	8	11	3
0023	2F	09_6	14	34	6	3400	1430	-1970	0.18	0.42	6	2	-4
0023	2F	09_6	15	18	2	1800	900	-900	0.11	0.50	3	1	-2
0023	2F	09_6	16	16	3	1600	770	-830	0.19	0.48	2	1	-1
0023	2F	09_6	23	2	1	200	330	130	0.50	1.65	0	0	0
0023	2F	09_6	25	2	0	200	0	-200	0.00	0.00	0	0	0
0023	2F	09_6	26	6	2	600	1130	530	0.33	1.88	1	2	1
0023	2F	09_7	12	94	38	9400	8610	-790	0.40	0.92	16	15	-1
0023	2F	09_7	13	63	15	6300	3320	-2980	0.24	0.53	11	5	-6
0023	2F	09_7	14	31	8	3100	1810	-1290	0.26	0.58	5	3	-2
0023	2F	09_7	15	11	1	1100	320	-780	0.09	0.29	1	0	-1
0023	2F	09_7	16	7	1	700	260	-440	0.14	0.37	1	0	-1
0023	2F	09_7	23	6	2	600	340	-260	0.33	0.57	1	0	-1
0023	2F	09_7	24	2	1	200	300	100	0.50	1.50	0	0	0
0023	2F	09_7	25	1	0	100	0	-100	0.00	0.00	0	0	0
0023	2F	09_7	26	2	0	200	0	-200	0.00	0.00	0	0	0
0023	2F	09_8	12	103	38	10300	9100	-1200	0.37	0.88	18	16	-2
0023	2F	09_8	13	63	23	6300	5160	-1140	0.37	0.82	11	9	-2
0023	2F	09_8	14	13	4	1300	1020	-280	0.31	0.78	2	1	-1
0023	2F	09_8	15	5	1	500	290	-210	0.20	0.58	0	0	0
0023	2F	09_8	16	4	0	400	0	-400	0.00	0.00	0	0	0
0023	2F	09_8	23	3	1	300	210	-90	0.33	0.70	0	0	0
0023	2F	09_8	26	1	0	100	0	-100	0.00	0.00	0	0	0
0023	2F	09_9	12	130	49	13000	12230	-770	0.38	0.94	23	21	-2
0023	2F	09_9	13	71	26	7100	5870	-1230	0.37	0.83	12	10	-2
0023	2F	09_9	14	29	7	2900	1430	-1470	0.24	0.49	5	2	-3
0023	2F	09_9	15	8	1	800	180	-620	0.13	0.23	1	0	-1
0023	2F	09_9	16	11	2	1100	490	-610	0.18	0.45	1	0	-1
0023	2F	10_1	12	199	70	19900	15070	-4830	0.35	0.76	35	26	-9
0023	2F	10_1	13	56	13	5600	2880	-2720	0.23	0.51	9	5	-4
0023	2F	10_1	14	8	1	800	380	-420	0.13	0.48	1	0	-1
0023	2F	10_1	16	1	0	100	0	-100	0.00	0.00	0	0	0
0023	2F	10_1	24	1	0	100	0	-100	0.00	0.00	0	0	0
0023	2F	10_10	12	135	47	13500	9630	-3870	0.35	0.71	23	17	-6
0023	2F	10_10	13	44	22	4400	5800	1400	0.50	1.32	7	10	3
0023	2F	10_10	14	36	11	3600	2840	-760	0.31	0.79	6	5	-1
0023	2F	10_10	15	10	3	1000	750	-250	0.30	0.75	1	1	0
0023	2F	10_10	16	5	0	500	0	-500	0.00	0.00	0	0	0
0023	2F	10_10	24	1	1	100	190	90	1.00	1.90	0	0	0
0023	2F	10_11	12	151	55	15100	11980	-3120	0.36	0.79	26	21	-5
0023	2F	10_11	13	68	15	6800	3170	-3630	0.22	0.47	12	5	-7
0023	2F	10_11	14	34	8	3400	2080	-1320	0.24	0.61	6	3	-3
0023	2F	10_11	15	2	0	200	0	-200	0.00	0.00	0	0	0
0023	2F	10_12	12	179	71	17900	16290	-1610	0.40	0.91	31	28	-3
0023	2F	10_12	13	53	17	5300	4320	-980	0.32	0.82	9	7	-2
0023	2F	10_12	14	22	5	2200	1490	-710	0.23	0.68	3	2	-1
0023	2F	10_2	12	194	101	19400	14840	-4560	0.52	0.76	34	26	-8
0023	2F	10_2	13	36	9	3600	2700	-900	0.25	0.75	6	4	-2
0023	2F	10_2	14	8	3	800	740	-60	0.38	0.93	1	1	0
0023	2F	10_3	12	31	12	3100	3600	500	0.39	1.16	5	6	1
0023	2F	10_3	13	187	61	18700	11030	-7670	0.33	0.59	33	19	-14
0023	2F	10_3	14	3	0	300	0	-300	0.00	0.00	0	0	0
0023	2F	10_3	15	1	0	100	0	-100	0.00	0.00	0	0	0
0023	2F	10_3	16	3	0	300	0	-300	0.00	0.00	0	0	0
0023	2F	10_3	23	4	0	400	0	-400	0.00	0.00	0	0	0
0023	2F	10_3	24	5	0	500	0	-500	0.00	0.00	0	0	0
0023	2F	10_3	26	1	0	100	0	-100	0.00	0.00	0	0	0
0023	2F	10_4	12	161	70	16100	14850	-1250	0.43	0.92	28	26	-2
0023	2F	10_4	13	57	18	5700	4280	-1420	0.32	0.75	10	7	-3
0023	2F	10_4	14	6	1	600	220	-380	0.17	0.37	1	0	-1
0023	2F	10_4	16	3	0	300	0	-300	0.00	0.00	0	0	0
0023	2F	10_4	23	8	1	800	420	-380	0.13	0.53	1	0	-1
0023	2F	10_4	24	4	0	400	0	-400	0.00	0.00	0	0	0
0023	2F	10_4	26	3	0	300	0	-300	0.00	0.00	0	0	0
0023	2F	10_5	12	33	5	3300	1310	-1990	0.15	0.40	5	2	-3
0023	2F	10_5	13	60	28	6000	5140	-860	0.47	0.86	10	9	-1
0023	2F	10_5	14	11	3	1100	840	-260	0.27	0.76	1	1	0
0023	2F	10_5	15	8	1	800	1170	370	0.13	1.46	1	2	1
0023	2F	10_5	16	5	0	500	0	-500	0.00	0.00	0	0	0
0023	2F	10_5	23	12	4	1200	1480	280	0.33	1.23	2	2	0
0023	2F	10_5	24	33	9	3300	3970	670	0.27	1.20	5	7	2
0023	2F	10_5	26	18	2	1800	1080	-720	0.11	0.60	3	1	-2
0023	2F	10_6	12	29	3	2900	490	-2410	0.10	0.17	5	0	-5
0023	2F	10_6	13	10	2	1000	590	-410	0.20	0.59	1	1	0
0023	2F	10_6	14	22	7	2200	2720	520	0.32	1.24	3	4	1
0023	2F	10_6	16	9	1	900	820	-80	0.11	0.91	1	1	0
0023	2F	10_6	23	25	3	2500	2050	-450	0.12	0.82	4	3	-1
0023	2F	10_6	24	21	3	2100	3020	920	0.14	1.44	3	5	2
0023	2F	10_6	25	3	0	300	0	-300	0.00	0.00	0	0	0
0023	2F	10_6	26	30	0	3000	0	-3000	0.00	0.00	5	0	-5
0023	2F	10_7	12	70	21	7000	7170	170	0.30	1.02	12	12	0
0023	2F	10_7	14	5	3	500	1880	1380	0.60	3.76	0	3	3
0023	2F	10_7	24	12	2	1200	510	-690	0.17	0.43	2	0	-2
0023	2F	10_8	12	58	17	5800	5630	-170	0.29	0.97	10	9	-1
0023	2F	10_8	13	42	11	4200	3160	-1040	0.26	0.75	7	5	-2
0023	2F	10_8	14	25	5	2500	1120	-1380	0.20	0.45	4	1	-3
0023	2F	10_8	15	5	2	500	910	410	0.40	1.82	0	1	1
0023	2F	10_8	16	1	0	100	0	-100	0.00	0.00	0	0	0
0023	2F	10_8	23	8	1	800	290	-510	0.13	0.36	1	0	-1
0023	2F	10_8	24	13	2	1300	460	-840	0.15	0.35	2	0	-2
0023	2F	10_8	25	1	0	100	0	-100	0.00	0.00	0	0	0
0023	2F	10_8	26	7	1	700	410	-290	0.14	0.59	1	0	-1
0023	2F	10_9	12	71	23	7100	6070	-1030	0.32	0.85	12	10	-2
0023	2F	10_9	13	39	8	3900	2010	-1890	0.21	0.52	6	3	-3
0023	2F	10_9	14	34	6	3400	3390	-10	0.18	1.00	6	6	0
0023	2F	10_9	15	6	1	600	480	-120	0.17	0.80	1	0	-1
0023	2F	10_9	16	2	0	200	0	-200	0.00	0.00	0	0	0
0023	2F	10_9	23	7	0	700	0	-700	0.00	0.00	1	0	-1
0023	2F	10_9	24	7	3	700	1600	900	0.43	2.29	1	2	1
0023	2F	10_9	25	3	0	300	0	-300	0.00	0.00	0	0	0
0023	2F	10_9	26	6	2	600	1030	430	0.33	1.72	1	1	0
0023	2F	11_1	12	153	52	15300	13580	-1720	0.34	0.89	27	24	-3
0023	2F	11_1	13	52	13	5200	3270	-1930	0.25	0.63	9	5	-4
0023	2F	11_1	14	24	6	2400	1890	-510	0.25	0.79	4	3	-1
0023	2F	11_1	15	8	2	800	560	-240	0.25	0.70	1	0	-1
0023	2F	11_1	16	3	1	300	230	-70	0.33	0.77	0	0	0
0023	2F	11_1	25	1	0	100	0	-100	0.00	0.00	0	0	0
0023	2F	11_10	12	104	27	10400	6630	-3770	0.26	0.64	18	11	-7
0023	2F	11_10	13	76	19	7600	4480	-3120	0.25	0.59	13	7	-6
0023	2F	11_10	14	26	11	2600	3140	540	0.42	1.21	4	5	1
0023	2F	11_10	15	3	0	300	0	-300	0.00	0.00	0	0	0
0023	2F	11_10	16	3	1	300	930	630	0.33	3.10	0	1	1
0023	2F	11_10	23	2	0	200	0	-200	0.00	0.00	0	0	0
0023	2F	11_10	24	2	2	200	700	500	1.00	3.50	0	1	1
0023	2F	11_11	12	155	64	15500	17010	1510	0.41	1.10	27	30	3
0023	2F	11_11	13	64	20	6400	5210	-1190	0.31	0.81	11	9	-2
0023	2F	11_11	14	16	1	1600	250	-1350	0.06	0.16	2	0	-2
0023	2F	11_11	15	2	0	200	0	-200	0.00	0.00	0	0	0
0023	2F	11_12	12	169	60	16900	15090	-1810	0.36	0.89	29	26	-3
0023	2F	11_12	13	56	11	5600	2810	-2790	0.20	0.50	9	4	-5
0023	2F	11_12	14	12	2	1200	710	-490	0.17	0.59	2	1	-1
0023	2F	11_12	15	1	0	100	0	-100	0.00	0.00	0	0	0
0023	2F	11_2	12	68	18	6800	7830	1030	0.26	1.15	12	13	1
0023	2F	11_2	13	44	11	4400	4390	-10	0.25	1.00	7	7	0
0023	2F	11_2	14	27	5	2700	1700	-1000	0.19	0.63	4	3	-1
0023	2F	11_2	15	15	3	1500	1200	-300	0.20	0.80	2	2	0
0023	2F	11_2	16	8	0	800	0	-800	0.00	0.00	1	0	-1
0023	2F	11_2	23	5	1	500	270	-230	0.20	0.54	0	0	0
0023	2F	11_2	24	1	0	100	0	-100	0.00	0.00	0	0	0
0023	2F	11_2	25	4	1	400	180	-220	0.25	0.45	0	0	0
0023	2F	11_2	26	1	0	100	0	-100	0.00	0.00	0	0	0
0023	2F	11_3	12	71	19	7100	7710	610	0.27	1.09	12	13	1
0023	2F	11_3	13	43	10	4300	2840	-1460	0.23	0.66	7	5	-2
0023	2F	11_3	14	25	7	2500	2480	-20	0.28	0.99	4	4	0
0023	2F	11_3	15	10	1	1000	340	-660	0.10	0.34	1	0	-1
0023	2F	11_3	16	12	1	1200	990	-210	0.08	0.83	2	1	-1
0023	2F	11_3	23	3	0	300	0	-300	0.00	0.00	0	0	0
0023	2F	11_3	24	2	0	200	0	-200	0.00	0.00	0	0	0
0023	2F	11_3	25	3	0	300	0	-300	0.00	0.00	0	0	0
0023	2F	11_3	26	6	1	600	420	-180	0.17	0.70	1	0	-1
0023	2F	11_4	12	64	15	6400	5300	-1100	0.23	0.83	11	9	-2
0023	2F	11_4	13	52	16	5200	5560	360	0.31	1.07	9	9	0
0023	2F	11_4	14	16	3	1600	880	-720	0.19	0.55	2	1	-1
0023	2F	11_4	15	15	1	1500	930	-570	0.07	0.62	2	1	-1
0023	2F	11_4	16	14	2	1400	1200	-200	0.14	0.86	2	2	0
0023	2F	11_4	23	3	2	300	430	130	0.67	1.43	0	0	0
0023	2F	11_4	24	1	0	100	0	-100	0.00	0.00	0	0	0
0023	2F	11_4	25	4	0	400	0	-400	0.00	0.00	0	0	0
0023	2F	11_4	26	3	1	300	560	260	0.33	1.87	0	0	0
0023	2F	11_5	12	241	130	24100	19220	-4880	0.54	0.80	42	34	-8
0023	2F	11_5	13	6	2	600	630	30	0.33	1.05	1	1	0
0023	2F	11_5	14	3	0	300	0	-300	0.00	0.00	0	0	0
0023	2F	11_5	15	2	0	200	0	-200	0.00	0.00	0	0	0
0023	2F	11_5	26	1	0	100	0	-100	0.00	0.00	0	0	0
0023	2F	11_6	12	33	12	3300	3670	370	0.36	1.11	5	6	1
0023	2F	11_6	13	144	59	14400	12360	-2040	0.41	0.86	25	21	-4
0023	2F	11_6	14	55	13	5500	3600	-1900	0.24	0.65	9	6	-3
0023	2F	11_6	16	6	1	600	570	-30	0.17	0.95	1	1	0
0023	2F	11_6	23	1	0	100	0	-100	0.00	0.00	0	0	0
0023	2F	11_6	26	2	0	200	0	-200	0.00	0.00	0	0	0
0023	2F	11_7	12	89	38	8900	11040	2140	0.43	1.24	15	19	4
0023	2F	11_7	13	43	14	4300	4120	-180	0.33	0.96	7	7	0
0023	2F	11_7	14	24	11	2400	2500	100	0.46	1.04	4	4	0
0023	2F	11_7	15	7	2	700	540	-160	0.29	0.77	1	0	-1
0023	2F	11_7	16	12	1	1200	290	-910	0.08	0.24	2	0	-2
0023	2F	11_7	23	2	0	200	0	-200	0.00	0.00	0	0	0
0023	2F	11_7	24	1	0	100	0	-100	0.00	0.00	0	0	0
0023	2F	11_7	25	2	0	200	0	-200	0.00	0.00	0	0	0
0023	2F	11_7	26	1	0	100	0	-100	0.00	0.00	0	0	0
0023	2F	11_8	12	68	23	6800	7930	1130	0.34	1.17	12	14	2
0023	2F	11_8	13	50	16	5000	4100	-900	0.32	0.82	8	7	-1
0023	2F	11_8	14	28	7	2800	1550	-1250	0.25	0.55	4	2	-2
0023	2F	11_8	15	12	1	1200	390	-810	0.08	0.33	2	0	-2
0023	2F	11_8	16	4	1	400	600	200	0.25	1.50	0	1	1
0023	2F	11_8	23	4	3	400	770	370	0.75	1.93	0	1	1
0023	2F	11_8	24	3	0	300	0	-300	0.00	0.00	0	0	0
0023	2F	11_8	25	2	0	200	0	-200	0.00	0.00	0	0	0
0023	2F	11_8	26	3	1	300	250	-50	0.33	0.83	0	0	0
0023	2F	11_9	12	94	31	9400	9730	330	0.33	1.04	16	17	1
0023	2F	11_9	13	57	17	5700	4640	-1060	0.30	0.81	10	8	-2
0023	2F	11_9	14	28	7	2800	2040	-760	0.25	0.73	4	3	-1
0023	2F	11_9	15	2	0	200	0	-200	0.00	0.00	0	0	0
0023	2F	11_9	16	7	0	700	0	-700	0.00	0.00	1	0	-1
0023	2F	11_9	23	3	0	300	0	-300	0.00	0.00	0	0	0
0023	2F	11_9	24	2	0	200	0	-200	0.00	0.00	0	0	0
0023	2F	11_9	25	2	0	200	0	-200	0.00	0.00	0	0	0
0023	2F	11_9	26	3	1	300	220	-80	0.33	0.73	0	0	0
0023	2F	12_1	12	94	31	9400	7580	-1820	0.33	0.81	16	13	-3
0023	2F	12_1	13	45	6	4500	1670	-2830	0.13	0.37	7	2	-5
0023	2F	12_1	14	29	5	2900	1510	-1390	0.17	0.52	5	2	-3
0023	2F	12_1	15	8	1	800	280	-520	0.13	0.35	1	0	-1
0023	2F	12_1	16	4	0	400	0	-400	0.00	0.00	0	0	0
0023	2F	12_1	23	4	1	400	230	-170	0.25	0.58	0	0	0
0023	2F	12_1	24	3	0	300	0	-300	0.00	0.00	0	0	0
0023	2F	12_1	25	1	0	100	0	-100	0.00	0.00	0	0	0
0023	2F	12_1	26	1	0	100	0	-100	0.00	0.00	0	0	0
0023	2F	12_10	12	146	51	14600	12090	-2510	0.35	0.83	25	21	-4
0023	2F	12_10	13	72	28	7200	7930	730	0.39	1.10	12	14	2
0023	2F	12_10	14	17	1	1700	200	-1500	0.06	0.12	3	0	-3
0023	2F	12_10	15	1	0	100	0	-100	0.00	0.00	0	0	0
0023	2F	12_10	24	1	0	100	0	-100	0.00	0.00	0	0	0
0023	2F	12_10	25	1	0	100	0	-100	0.00	0.00	0	0	0
0023	2F	12_11	12	134	46	13400	10770	-2630	0.34	0.80	23	19	-4
0023	2F	12_11	13	99	25	9900	6400	-3500	0.25	0.65	17	11	-6
0023	2F	12_11	14	10	4	1000	890	-110	0.40	0.89	1	1	0
0023	2F	12_11	15	1	0	100	0	-100	0.00	0.00	0	0	0
0023	2F	12_12	12	133	43	13300	10450	-2850	0.32	0.79	23	18	-5
0023	2F	12_12	13	94	27	9400	7740	-1660	0.29	0.82	16	13	-3
0023	2F	12_12	14	13	2	1300	370	-930	0.15	0.28	2	0	-2
0023	2F	12_12	15	3	0	300	0	-300	0.00	0.00	0	0	0
0023	2F	12_12	16	1	1	100	610	510	1.00	6.10	0	1	1
0023	2F	12_12	24	1	1	100	660	560	1.00	6.60	0	1	1
0023	2F	12_2	12	81	17	8100	4510	-3590	0.21	0.56	14	7	-7
0023	2F	12_2	13	56	19	5600	4470	-1130	0.34	0.80	9	7	-2
0023	2F	12_2	14	26	4	2600	1100	-1500	0.15	0.42	4	1	-3
0023	2F	12_2	15	13	0	1300	0	-1300	0.00	0.00	2	0	-2
0023	2F	12_2	16	7	1	700	720	20	0.14	1.03	1	1	0
0023	2F	12_2	23	5	2	500	890	390	0.40	1.78	0	1	1
0023	2F	12_2	25	1	0	100	0	-100	0.00	0.00	0	0	0
0023	2F	12_2	26	2	0	200	0	-200	0.00	0.00	0	0	0
0023	2F	12_3	12	84	21	8400	5310	-3090	0.25	0.63	14	9	-5
0023	2F	12_3	13	49	8	4900	2590	-2310	0.16	0.53	8	4	-4
0023	2F	12_3	14	24	2	2400	870	-1530	0.08	0.36	4	1	-3
0023	2F	12_3	15	14	5	1400	2120	720	0.36	1.51	2	3	1
0023	2F	12_3	16	4	0	400	0	-400	0.00	0.00	0	0	0
0023	2F	12_3	23	5	3	500	880	380	0.60	1.76	0	1	1
0023	2F	12_3	24	2	1	200	170	-30	0.50	0.85	0	0	0
0023	2F	12_3	26	3	1	300	200	-100	0.33	0.67	0	0	0
0023	2F	12_4	12	83	30	8300	7250	-1050	0.36	0.87	14	12	-2
0023	2F	12_4	13	45	7	4500	1960	-2540	0.16	0.44	7	3	-4
0023	2F	12_4	14	28	6	2800	1990	-810	0.21	0.71	4	3	-1
0023	2F	12_4	15	18	2	1800	750	-1050	0.11	0.42	3	1	-2
0023	2F	12_4	16	4	0	400	0	-400	0.00	0.00	0	0	0
0023	2F	12_4	23	3	1	300	280	-20	0.33	0.93	0	0	0
0023	2F	12_4	24	5	1	500	260	-240	0.20	0.52	0	0	0
0023	2F	12_4	25	7	1	700	540	-160	0.14	0.77	1	0	-1
0023	2F	12_4	26	5	0	500	0	-500	0.00	0.00	0	0	0
0023	2F	12_5	12	157	49	15700	15770	70	0.31	1.00	27	27	0
0023	2F	12_5	13	34	10	3400	3000	-400	0.29	0.88	6	5	-1
0023	2F	12_5	14	15	2	1500	730	-770	0.13	0.49	2	1	-1
0023	2F	12_5	15	1	0	100	0	-100	0.00	0.00	0	0	0
0023	2F	12_5	16	39	13	3900	2400	-1500	0.33	0.62	6	4	-2
0023	2F	12_5	23	1	0	100	0	-100	0.00	0.00	0	0	0
0023	2F	12_5	25	1	0	100	0	-100	0.00	0.00	0	0	0
0023	2F	12_6	12	92	24	9200	5410	-3790	0.26	0.59	16	9	-7
0023	2F	12_6	13	49	15	4900	3740	-1160	0.31	0.76	8	6	-2
0023	2F	12_6	14	19	3	1900	640	-1260	0.16	0.34	3	1	-2
0023	2F	12_6	15	11	2	1100	820	-280	0.18	0.75	1	1	0
0023	2F	12_6	16	4	1	400	340	-60	0.25	0.85	0	0	0
0023	2F	12_6	23	2	0	200	0	-200	0.00	0.00	0	0	0
0023	2F	12_6	24	3	2	300	1060	760	0.67	3.53	0	1	1
0023	2F	12_6	25	3	0	300	0	-300	0.00	0.00	0	0	0
0023	2F	12_6	26	2	0	200	0	-200	0.00	0.00	0	0	0
0023	2F	12_7	12	113	52	11300	12000	700	0.46	1.06	20	21	1
0023	2F	12_7	13	50	22	5000	5060	60	0.44	1.01	8	8	0
0023	2F	12_7	14	30	9	3000	2210	-790	0.30	0.74	5	3	-2
0023	2F	12_7	15	10	3	1000	1060	60	0.30	1.06	1	1	0
0023	2F	12_7	16	4	0	400	0	-400	0.00	0.00	0	0	0
0023	2F	12_7	23	1	1	100	170	70	1.00	1.70	0	0	0
0023	2F	12_7	24	2	0	200	0	-200	0.00	0.00	0	0	0
0023	2F	12_7	25	3	2	300	640	340	0.67	2.13	0	1	1
0023	2F	12_7	26	2	1	200	180	-20	0.50	0.90	0	0	0
0023	2F	12_8	12	103	45	10300	12410	2110	0.44	1.20	18	21	3
0023	2F	12_8	13	60	17	6000	3220	-2780	0.28	0.54	10	5	-5
0023	2F	12_8	14	55	16	5500	3370	-2130	0.29	0.61	9	5	-4
0023	2F	12_8	15	6	3	600	750	150	0.50	1.25	1	1	0
0023	2F	12_8	16	8	1	800	300	-500	0.13	0.38	1	0	-1
0023	2F	12_9	12	157	53	15700	12600	-3100	0.34	0.80	27	22	-5
0023	2F	12_9	13	56	18	5600	4180	-1420	0.32	0.75	9	7	-2
0023	2F	12_9	14	23	7	2300	2040	-260	0.30	0.89	4	3	-1
0023	2F	12_9	15	6	3	600	1070	470	0.50	1.78	1	1	0
0023	2F	12_9	16	6	0	600	0	-600	0.00	0.00	1	0	-1
0023	2F	13_1	12	63	24	6300	6190	-110	0.38	0.98	11	10	-1
0023	2F	13_1	13	55	20	5500	4680	-820	0.36	0.85	9	8	-1
0023	2F	13_1	14	35	14	3500	4120	620	0.40	1.18	6	7	1
0023	2F	13_1	15	14	1	1400	250	-1150	0.07	0.18	2	0	-2
0023	2F	13_1	16	5	0	500	0	-500	0.00	0.00	0	0	0
0023	2F	13_1	23	1	1	100	360	260	1.00	3.60	0	0	0
0023	2F	13_1	25	4	0	400	0	-400	0.00	0.00	0	0	0
0023	2F	13_1	26	3	0	300	0	-300	0.00	0.00	0	0	0
0023	2F	13_10	12	161	56	16100	12140	-3960	0.35	0.75	28	21	-7
0023	2F	13_10	13	56	21	5600	5150	-450	0.38	0.92	9	9	0
0023	2F	13_10	14	23	4	2300	780	-1520	0.17	0.34	4	1	-3
0023	2F	13_10	15	6	2	600	660	60	0.33	1.10	1	1	0
0023	2F	13_10	16	1	0	100	0	-100	0.00	0.00	0	0	0
0023	2F	13_10	23	1	0	100	0	-100	0.00	0.00	0	0	0
0023	2F	13_11	12	196	75	19600	17270	-2330	0.38	0.88	34	30	-4
0023	2F	13_11	13	38	11	3800	2290	-1510	0.29	0.60	6	4	-2
0023	2F	13_11	14	17	7	1700	1600	-100	0.41	0.94	3	2	-1
0023	2F	13_11	15	2	1	200	400	200	0.50	2.00	0	0	0
0023	2F	13_11	23	1	0	100	0	-100	0.00	0.00	0	0	0
0023	2F	13_12	12	196	69	19600	16590	-3010	0.35	0.85	34	29	-5
0023	2F	13_12	13	38	7	3800	1620	-2180	0.18	0.43	6	2	-4
0023	2F	13_12	14	8	3	800	890	90	0.38	1.11	1	1	0
0023	2F	13_12	15	3	0	300	0	-300	0.00	0.00	0	0	0
0023	2F	13_12	16	1	0	100	0	-100	0.00	0.00	0	0	0
0023	2F	13_12	23	1	0	100	0	-100	0.00	0.00	0	0	0
0023	2F	13_2	12	67	25	6700	6710	10	0.37	1.00	11	11	0
0023	2F	13_2	13	46	12	4600	2480	-2120	0.26	0.54	8	4	-4
0023	2F	13_2	14	23	7	2300	2030	-270	0.30	0.88	4	3	-1
0023	2F	13_2	15	17	4	1700	1150	-550	0.24	0.68	3	2	-1
0023	2F	13_2	16	12	7	1200	3480	2280	0.58	2.90	2	6	4
0023	2F	13_2	23	2	0	200	0	-200	0.00	0.00	0	0	0
0023	2F	13_2	24	2	0	200	0	-200	0.00	0.00	0	0	0
0023	2F	13_2	25	5	0	500	0	-500	0.00	0.00	0	0	0
0023	2F	13_2	26	3	0	300	0	-300	0.00	0.00	0	0	0
0023	2F	13_3	12	66	22	6600	6660	60	0.33	1.01	11	11	0
0023	2F	13_3	13	41	15	4100	4040	-60	0.37	0.99	7	7	0
0023	2F	13_3	14	35	5	3500	2430	-1070	0.14	0.69	6	4	-2
0023	2F	13_3	15	11	0	1100	0	-1100	0.00	0.00	1	0	-1
0023	2F	13_3	16	16	1	1600	200	-1400	0.06	0.13	2	0	-2
0023	2F	13_3	23	5	2	500	650	150	0.40	1.30	0	1	1
0023	2F	13_3	24	2	0	200	0	-200	0.00	0.00	0	0	0
0023	2F	13_3	25	1	0	100	0	-100	0.00	0.00	0	0	0
0023	2F	13_3	26	2	1	200	300	100	0.50	1.50	0	0	0
0023	2F	13_4	12	71	22	7100	6690	-410	0.31	0.94	12	11	-1
0023	2F	13_4	13	48	10	4800	2800	-2000	0.21	0.58	8	4	-4
0023	2F	13_4	14	35	5	3500	1300	-2200	0.14	0.37	6	2	-4
0023	2F	13_4	15	10	2	1000	500	-500	0.20	0.50	1	0	-1
0023	2F	13_4	16	13	1	1300	280	-1020	0.08	0.22	2	0	-2
0023	2F	13_4	23	2	0	200	0	-200	0.00	0.00	0	0	0
0023	2F	13_4	24	4	1	400	260	-140	0.25	0.65	0	0	0
0023	2F	13_4	25	4	0	400	0	-400	0.00	0.00	0	0	0
0023	2F	13_4	26	1	0	100	0	-100	0.00	0.00	0	0	0
0023	2F	13_5	12	79	25	7900	5850	-2050	0.32	0.74	13	10	-3
0023	2F	13_5	13	42	16	4200	3810	-390	0.38	0.91	7	6	-1
0023	2F	13_5	14	33	7	3300	2310	-990	0.21	0.70	5	4	-1
0023	2F	13_5	15	16	3	1600	1490	-110	0.19	0.93	2	2	0
0023	2F	13_5	16	14	5	1400	1350	-50	0.36	0.96	2	2	0
0023	2F	13_5	23	3	0	300	0	-300	0.00	0.00	0	0	0
0023	2F	13_5	24	1	1	100	520	420	1.00	5.20	0	0	0
0023	2F	13_5	25	1	0	100	0	-100	0.00	0.00	0	0	0
0023	2F	13_5	26	1	0	100	0	-100	0.00	0.00	0	0	0
0023	2F	13_6	12	70	16	7000	4140	-2860	0.23	0.59	12	7	-5
0023	2F	13_6	13	56	24	5600	5080	-520	0.43	0.91	9	8	-1
0023	2F	13_6	14	63	28	6300	5620	-680	0.44	0.89	11	9	-2
0023	2F	13_6	15	12	2	1200	670	-530	0.17	0.56	2	1	-1
0023	2F	13_6	16	9	3	900	990	90	0.33	1.10	1	1	0
0023	2F	13_6	23	1	0	100	0	-100	0.00	0.00	0	0	0
0023	2F	13_6	24	1	0	100	0	-100	0.00	0.00	0	0	0
0023	2F	13_6	25	1	0	100	0	-100	0.00	0.00	0	0	0
0023	2F	13_7	12	96	29	9600	7540	-2060	0.30	0.79	16	13	-3
0023	2F	13_7	13	57	20	5700	4580	-1120	0.35	0.80	10	8	-2
0023	2F	13_7	14	48	22	4800	4350	-450	0.46	0.91	8	7	-1
0023	2F	13_7	15	6	1	600	240	-360	0.17	0.40	1	0	-1
0023	2F	13_7	16	8	2	800	270	-530	0.25	0.34	1	0	-1
0023	2F	13_7	23	2	1	200	220	20	0.50	1.10	0	0	0
0023	2F	13_7	24	1	0	100	0	-100	0.00	0.00	0	0	0
0023	2F	13_7	25	3	1	300	270	-30	0.33	0.90	0	0	0
0023	2F	13_7	26	1	0	100	0	-100	0.00	0.00	0	0	0
0023	2F	13_8	12	83	32	8300	6930	-1370	0.39	0.83	14	12	-2
0023	2F	13_8	13	74	25	7400	5860	-1540	0.34	0.79	13	10	-3
0023	2F	13_8	14	54	20	5400	4050	-1350	0.37	0.75	9	7	-2
0023	2F	13_8	15	7	3	700	570	-130	0.43	0.81	1	1	0
0023	2F	13_8	16	5	1	500	220	-280	0.20	0.44	0	0	0
0023	2F	13_8	23	1	0	100	0	-100	0.00	0.00	0	0	0
0023	2F	13_8	25	1	0	100	0	-100	0.00	0.00	0	0	0
0023	2F	13_9	12	113	31	11300	6500	-4800	0.27	0.58	20	11	-9
0023	2F	13_9	13	82	28	8200	6970	-1230	0.34	0.85	14	12	-2
0023	2F	13_9	14	28	9	2800	2220	-580	0.32	0.79	4	3	-1
0023	2F	13_9	15	9	3	900	910	10	0.33	1.01	1	1	0
0023	2F	13_9	16	4	0	400	0	-400	0.00	0.00	0	0	0
0023	2F	13_9	24	1	0	100	0	-100	0.00	0.00	0	0	0
0023	2F	14_1	12	91	30	9100	8430	-670	0.33	0.93	16	14	-2
0023	2F	14_1	13	26	6	2600	1440	-1160	0.23	0.55	4	2	-2
0023	2F	14_1	14	126	43	12600	8400	-4200	0.34	0.67	22	14	-8
0023	2F	14_1	16	1	0	100	0	-100	0.00	0.00	0	0	0
0023	2F	14_10	12	112	40	11200	10270	-930	0.36	0.92	19	18	-1
0023	2F	14_10	13	47	12	4700	3780	-920	0.26	0.80	8	6	-2
0023	2F	14_10	14	22	3	2200	1080	-1120	0.14	0.49	3	1	-2
0023	2F	14_10	15	6	0	600	0	-600	0.00	0.00	1	0	-1
0023	2F	14_10	16	2	0	200	0	-200	0.00	0.00	0	0	0
0023	2F	14_10	23	2	0	200	0	-200	0.00	0.00	0	0	0
0023	2F	14_10	24	3	1	300	190	-110	0.33	0.63	0	0	0
0023	2F	14_10	25	2	0	200	0	-200	0.00	0.00	0	0	0
0023	2F	14_10	26	5	0	500	0	-500	0.00	0.00	0	0	0
0023	2F	14_11	12	177	60	17700	15460	-2240	0.34	0.87	31	27	-4
0023	2F	14_11	13	44	12	4400	3210	-1190	0.27	0.73	7	5	-2
0023	2F	14_11	14	7	1	700	280	-420	0.14	0.40	1	0	-1
0023	2F	14_11	15	2	0	200	0	-200	0.00	0.00	0	0	0
0023	2F	14_11	16	1	0	100	0	-100	0.00	0.00	0	0	0
0023	2F	14_12	12	219	63	21900	16170	-5730	0.29	0.74	38	28	-10
0023	2F	14_12	13	22	4	2200	1380	-820	0.18	0.63	3	2	-1
0023	2F	14_12	14	4	0	400	0	-400	0.00	0.00	0	0	0
0023	2F	14_2	12	100	35	10000	9230	-770	0.35	0.92	17	16	-1
0023	2F	14_2	13	47	4	4700	1160	-3540	0.09	0.25	8	2	-6
0023	2F	14_2	14	26	4	2600	1630	-970	0.15	0.63	4	2	-2
0023	2F	14_2	15	15	2	1500	740	-760	0.13	0.49	2	1	-1
0023	2F	14_2	16	9	3	900	700	-200	0.33	0.78	1	1	0
0023	2F	14_2	23	3	2	300	2450	2150	0.67	8.17	0	4	4
0023	2F	14_2	24	2	1	200	520	320	0.50	2.60	0	0	0
0023	2F	14_2	25	1	0	100	0	-100	0.00	0.00	0	0	0
0023	2F	14_2	26	2	0	200	0	-200	0.00	0.00	0	0	0
0023	2F	14_3	12	132	45	13200	10490	-2710	0.34	0.79	23	18	-5
0023	2F	14_3	13	68	28	6800	5980	-820	0.41	0.88	12	10	-2
0023	2F	14_3	14	25	9	2500	2660	160	0.36	1.06	4	4	0
0023	2F	14_3	15	10	2	1000	680	-320	0.20	0.68	1	1	0
0023	2F	14_3	16	1	0	100	0	-100	0.00	0.00	0	0	0
0023	2F	14_4	12	83	17	8300	4960	-3340	0.20	0.60	14	8	-6
0023	2F	14_4	13	57	19	5700	5120	-580	0.33	0.90	10	9	-1
0023	2F	14_4	14	33	7	3300	2590	-710	0.21	0.78	5	4	-1
0023	2F	14_4	15	13	2	1300	1110	-190	0.15	0.85	2	1	-1
0023	2F	14_4	16	8	1	800	280	-520	0.13	0.35	1	0	-1
0023	2F	14_4	23	3	0	300	0	-300	0.00	0.00	0	0	0
0023	2F	14_4	24	1	0	100	0	-100	0.00	0.00	0	0	0
0023	2F	14_4	25	1	0	100	0	-100	0.00	0.00	0	0	0
0023	2F	14_4	26	1	0	100	0	-100	0.00	0.00	0	0	0
0023	2F	14_5	12	155	53	15500	12660	-2840	0.34	0.82	27	22	-5
0023	2F	14_5	13	31	10	3100	2500	-600	0.32	0.81	5	4	-1
0023	2F	14_5	14	28	5	2800	1730	-1070	0.18	0.62	4	3	-1
0023	2F	14_5	15	5	2	500	500	0	0.40	1.00	0	0	0
0023	2F	14_5	16	2	0	200	0	-200	0.00	0.00	0	0	0
0023	2F	14_5	25	1	0	100	0	-100	0.00	0.00	0	0	0
0023	2F	14_6	12	46	10	4600	3200	-1400	0.22	0.70	8	5	-3
0023	2F	14_6	13	36	10	3600	2440	-1160	0.28	0.68	6	4	-2
0023	2F	14_6	14	24	8	2400	2750	350	0.33	1.15	4	4	0
0023	2F	14_6	15	23	4	2300	2060	-240	0.17	0.90	4	3	-1
0023	2F	14_6	16	12	2	1200	790	-410	0.17	0.66	2	1	-1
0023	2F	14_6	23	3	2	300	520	220	0.67	1.73	0	0	0
0023	2F	14_6	24	4	0	400	0	-400	0.00	0.00	0	0	0
0023	2F	14_6	25	3	1	300	320	20	0.33	1.07	0	0	0
0023	2F	14_6	26	5	1	500	290	-210	0.20	0.58	0	0	0
0023	2F	14_7	12	57	14	5700	4570	-1130	0.25	0.80	10	8	-2
0023	2F	14_7	13	34	7	3400	2470	-930	0.21	0.73	6	4	-2
0023	2F	14_7	14	22	0	2200	0	-2200	0.00	0.00	3	0	-3
0023	2F	14_7	15	15	2	1500	1140	-360	0.13	0.76	2	2	0
0023	2F	14_7	16	19	3	1900	1690	-210	0.16	0.89	3	2	-1
0023	2F	14_7	23	5	1	500	120	-380	0.20	0.24	0	0	0
0023	2F	14_7	24	2	0	200	0	-200	0.00	0.00	0	0	0
0023	2F	14_7	26	4	1	400	310	-90	0.25	0.78	0	0	0
0023	2F	14_8	12	49	13	4900	3670	-1230	0.27	0.75	8	6	-2
0023	2F	14_8	13	35	6	3500	1290	-2210	0.17	0.37	6	2	-4
0023	2F	14_8	14	31	10	3100	2590	-510	0.32	0.84	5	4	-1
0023	2F	14_8	15	14	1	1400	440	-960	0.07	0.31	2	0	-2
0023	2F	14_8	16	15	3	1500	1080	-420	0.20	0.72	2	1	-1
0023	2F	14_8	23	7	2	700	570	-130	0.29	0.81	1	1	0
0023	2F	14_8	24	4	0	400	0	-400	0.00	0.00	0	0	0
0023	2F	14_8	25	2	1	200	510	310	0.50	2.55	0	0	0
0023	2F	14_8	26	4	0	400	0	-400	0.00	0.00	0	0	0
0023	2F	14_9	12	83	26	8300	7080	-1220	0.31	0.85	14	12	-2
0023	2F	14_9	13	36	12	3600	3300	-300	0.33	0.92	6	5	-1
0023	2F	14_9	14	15	2	1500	580	-920	0.13	0.39	2	1	-1
0023	2F	14_9	15	3	2	300	1540	1240	0.67	5.13	0	2	2
0023	2F	14_9	16	6	0	600	0	-600	0.00	0.00	1	0	-1
0023	2F	14_9	23	3	0	300	0	-300	0.00	0.00	0	0	0
0023	2F	14_9	24	5	1	500	190	-310	0.20	0.38	0	0	0
0023	2F	14_9	25	4	0	400	0	-400	0.00	0.00	0	0	0
0023	2F	14_9	26	1	0	100	0	-100	0.00	0.00	0	0	0
0023	2F	15_1	12	167	55	16700	13950	-2750	0.33	0.84	29	24	-5
0023	2F	15_1	13	75	19	7500	4450	-3050	0.25	0.59	13	7	-6
0023	2F	15_1	14	19	5	1900	1300	-600	0.26	0.68	3	2	-1
0023	2F	15_1	15	5	2	500	970	470	0.40	1.94	0	1	1
0023	2F	15_1	16	8	5	800	2760	1960	0.63	3.45	1	4	3
0023	2F	15_10	12	172	50	17200	11140	-6060	0.29	0.65	30	19	-11
0023	2F	15_10	13	78	31	7800	7000	-800	0.40	0.90	13	12	-1
0023	2F	15_10	14	22	5	2200	1700	-500	0.23	0.77	3	3	0
0023	2F	15_10	15	3	0	300	0	-300	0.00	0.00	0	0	0
0023	2F	15_10	16	2	0	200	0	-200	0.00	0.00	0	0	0
0023	2F	15_10	23	1	0	100	0	-100	0.00	0.00	0	0	0
0023	2F	15_10	24	1	0	100	0	-100	0.00	0.00	0	0	0
0023	2F	15_11	12	211	64	21100	15760	-5340	0.30	0.75	37	27	-10
0023	2F	15_11	13	53	18	5300	4870	-430	0.34	0.92	9	8	-1
0023	2F	15_11	14	15	6	1500	1860	360	0.40	1.24	2	3	1
0023	2F	15_11	15	1	1	100	1110	1010	1.00	11.10	0	1	1
0023	2F	15_12	12	214	63	21400	14970	-6430	0.29	0.70	37	26	-11
0023	2F	15_12	13	52	17	5200	3810	-1390	0.33	0.73	9	6	-3
0023	2F	15_12	14	12	2	1200	570	-630	0.17	0.48	2	1	-1
0023	2F	15_12	15	1	0	100	0	-100	0.00	0.00	0	0	0
0023	2F	15_2	12	96	31	9600	10330	730	0.32	1.08	16	18	2
0023	2F	15_2	13	64	10	6400	3450	-2950	0.16	0.54	11	6	-5
0023	2F	15_2	14	36	7	3600	3600	0	0.19	1.00	6	6	0
0023	2F	15_2	15	15	1	1500	230	-1270	0.07	0.15	2	0	-2
0023	2F	15_2	16	2	0	200	0	-200	0.00	0.00	0	0	0
0023	2F	15_2	23	4	0	400	0	-400	0.00	0.00	0	0	0
0023	2F	15_2	24	2	0	200	0	-200	0.00	0.00	0	0	0
0023	2F	15_2	25	1	0	100	0	-100	0.00	0.00	0	0	0
0023	2F	15_3	12	69	16	6900	7490	590	0.23	1.09	12	13	1
0023	2F	15_3	13	58	15	5800	5110	-690	0.26	0.88	10	9	-1
0023	2F	15_3	14	25	7	2500	3730	1230	0.28	1.49	4	6	2
0023	2F	15_3	15	21	3	2100	2120	20	0.14	1.01	3	3	0
0023	2F	15_3	16	23	5	2300	6090	3790	0.22	2.65	4	10	6
0023	2F	15_3	23	2	0	200	0	-200	0.00	0.00	0	0	0
0023	2F	15_3	26	5	0	500	0	-500	0.00	0.00	0	0	0
0023	2F	15_4	12	37	8	3700	2320	-1380	0.22	0.63	6	4	-2
0023	2F	15_4	13	65	17	6500	5150	-1350	0.26	0.79	11	9	-2
0023	2F	15_4	14	34	4	3400	2620	-780	0.12	0.77	6	4	-2
0023	2F	15_4	15	25	7	2500	5480	2980	0.28	2.19	4	9	5
0023	2F	15_4	16	29	2	2900	520	-2380	0.07	0.18	5	0	-5
0023	2F	15_4	23	3	0	300	0	-300	0.00	0.00	0	0	0
0023	2F	15_4	25	3	0	300	0	-300	0.00	0.00	0	0	0
0023	2F	15_4	26	2	0	200	0	-200	0.00	0.00	0	0	0
0023	2F	15_5	12	84	26	8400	6840	-1560	0.31	0.81	14	12	-2
0023	2F	15_5	13	105	47	10500	11510	1010	0.45	1.10	18	20	2
0023	2F	15_5	14	88	24	8800	6220	-2580	0.27	0.71	15	11	-4
0023	2F	15_5	15	1	0	100	0	-100	0.00	0.00	0	0	0
0023	2F	15_5	24	1	1	100	400	300	1.00	4.00	0	0	0
0023	2F	15_6	12	105	29	10500	8860	-1640	0.28	0.84	18	15	-3
0023	2F	15_6	13	34	9	3400	2850	-550	0.26	0.84	6	5	-1
0023	2F	15_6	14	14	3	1400	560	-840	0.21	0.40	2	0	-2
0023	2F	15_6	15	9	0	900	0	-900	0.00	0.00	1	0	-1
0023	2F	15_6	16	9	5	900	2030	1130	0.56	2.26	1	3	2
0023	2F	15_6	23	4	1	400	380	-20	0.25	0.95	0	0	0
0023	2F	15_6	24	2	0	200	0	-200	0.00	0.00	0	0	0
0023	2F	15_6	25	3	0	300	0	-300	0.00	0.00	0	0	0
0023	2F	15_6	26	9	4	900	1960	1060	0.44	2.18	1	3	2
0023	2F	15_7	12	103	26	10300	7620	-2680	0.25	0.74	18	13	-5
0023	2F	15_7	13	43	14	4300	3650	-650	0.33	0.85	7	6	-1
0023	2F	15_7	14	24	10	2400	2910	510	0.42	1.21	4	5	1
0023	2F	15_7	15	13	4	1300	1220	-80	0.31	0.94	2	2	0
0023	2F	15_7	16	12	6	1200	1860	660	0.50	1.55	2	3	1
0023	2F	15_7	23	5	2	500	460	-40	0.40	0.92	0	0	0
0023	2F	15_7	24	1	1	100	390	290	1.00	3.90	0	0	0
0023	2F	15_7	25	1	0	100	0	-100	0.00	0.00	0	0	0
0023	2F	15_7	26	4	1	400	680	280	0.25	1.70	0	1	1
0023	2F	15_8	12	233	97	23300	18940	-4360	0.42	0.81	41	33	-8
0023	2F	15_8	13	3	3	300	810	510	1.00	2.70	0	1	1
0023	2F	15_8	14	47	15	4700	3270	-1430	0.32	0.70	8	5	-3
0023	2F	15_9	12	142	50	14200	11480	-2720	0.35	0.81	25	20	-5
0023	2F	15_9	13	59	17	5900	4380	-1520	0.29	0.74	10	7	-3
0023	2F	15_9	14	28	8	2800	2290	-510	0.29	0.82	4	4	0
0023	2F	15_9	15	6	0	600	0	-600	0.00	0.00	1	0	-1
0023	2F	15_9	16	6	2	600	1030	430	0.33	1.72	1	1	0
0023	2F	15_9	23	1	0	100	0	-100	0.00	0.00	0	0	0
0023	2F	16_1	12	197	61	19700	14720	-4980	0.31	0.75	34	26	-8
0023	2F	16_1	13	63	17	6300	3920	-2380	0.27	0.62	11	6	-5
0023	2F	16_1	14	19	7	1900	2210	310	0.37	1.16	3	3	0
0023	2F	16_1	15	5	1	500	490	-10	0.20	0.98	0	0	0
0023	2F	16_10	12	193	72	19300	16420	-2880	0.37	0.85	34	29	-5
0023	2F	16_10	13	49	20	4900	4660	-240	0.41	0.95	8	8	0
0023	2F	16_10	14	20	4	2000	870	-1130	0.20	0.44	3	1	-2
0023	2F	16_10	15	4	2	400	500	100	0.50	1.25	0	0	0
0023	2F	16_10	16	11	4	1100	2040	940	0.36	1.85	1	3	2
0023	2F	16_10	23	1	0	100	0	-100	0.00	0.00	0	0	0
0023	2F	16_11	12	197	70	19700	16740	-2960	0.36	0.85	34	29	-5
0023	2F	16_11	13	59	17	5900	4630	-1270	0.29	0.78	10	8	-2
0023	2F	16_11	14	29	6	2900	2420	-480	0.21	0.83	5	4	-1
0023	2F	16_11	15	1	0	100	0	-100	0.00	0.00	0	0	0
0023	2F	16_12	12	224	72	22400	18060	-4340	0.32	0.81	39	31	-8
0023	2F	16_12	13	45	19	4500	4480	-20	0.42	1.00	7	7	0
0023	2F	16_12	14	10	5	1000	1540	540	0.50	1.54	1	2	1
0023	2F	16_2	12	116	39	11600	10620	-980	0.34	0.92	20	18	-2
0023	2F	16_2	13	56	13	5600	3920	-1680	0.23	0.70	9	6	-3
0023	2F	16_2	14	35	7	3500	1830	-1670	0.20	0.52	6	3	-3
0023	2F	16_2	15	13	3	1300	1300	0	0.23	1.00	2	2	0
0023	2F	16_2	16	17	1	1700	320	-1380	0.06	0.19	3	0	-3
0023	2F	16_2	23	3	0	300	0	-300	0.00	0.00	0	0	0
0023	2F	16_2	24	1	0	100	0	-100	0.00	0.00	0	0	0
0023	2F	16_2	25	2	1	200	1510	1310	0.50	7.55	0	2	2
0023	2F	16_2	26	1	0	100	0	-100	0.00	0.00	0	0	0
0023	2F	16_3	12	75	20	7500	6240	-1260	0.27	0.83	13	11	-2
0023	2F	16_3	13	49	6	4900	1720	-3180	0.12	0.35	8	3	-5
0023	2F	16_3	14	34	5	3400	1170	-2230	0.15	0.34	6	2	-4
0023	2F	16_3	15	19	4	1900	1600	-300	0.21	0.84	3	2	-1
0023	2F	16_3	16	21	4	2100	3860	1760	0.19	1.84	3	6	3
0023	2F	16_3	23	2	1	200	340	140	0.50	1.70	0	0	0
0023	2F	16_3	24	3	1	300	280	-20	0.33	0.93	0	0	0
0023	2F	16_3	25	1	0	100	0	-100	0.00	0.00	0	0	0
0023	2F	16_3	26	2	0	200	0	-200	0.00	0.00	0	0	0
0023	2F	16_4	12	79	20	7900	5790	-2110	0.25	0.73	13	10	-3
0023	2F	16_4	13	59	12	5900	3990	-1910	0.20	0.68	10	7	-3
0023	2F	16_4	14	32	14	3200	5020	1820	0.44	1.57	5	8	3
0023	2F	16_4	15	15	2	1500	1210	-290	0.13	0.81	2	2	0
0023	2F	16_4	16	12	1	1200	940	-260	0.08	0.78	2	1	-1
0023	2F	16_4	23	3	1	300	650	350	0.33	2.17	0	1	1
0023	2F	16_4	24	4	0	400	0	-400	0.00	0.00	0	0	0
0023	2F	16_4	25	5	1	500	1480	980	0.20	2.96	0	2	2
0023	2F	16_4	26	5	0	500	0	-500	0.00	0.00	0	0	0
0023	2F	16_5	12	87	32	8700	7420	-1280	0.37	0.85	15	13	-2
0023	2F	16_5	13	65	18	6500	4980	-1520	0.28	0.77	11	8	-3
0023	2F	16_5	14	29	8	2900	1900	-1000	0.28	0.66	5	3	-2
0023	2F	16_5	15	10	3	1000	1870	870	0.30	1.87	1	3	2
0023	2F	16_5	16	16	3	1600	1100	-500	0.19	0.69	2	1	-1
0023	2F	16_5	23	2	0	200	0	-200	0.00	0.00	0	0	0
0023	2F	16_5	24	2	1	200	510	310	0.50	2.55	0	0	0
0023	2F	16_5	25	3	2	300	680	380	0.67	2.27	0	1	1
0023	2F	16_5	26	2	1	200	330	130	0.50	1.65	0	0	0
0023	2F	16_6	12	205	95	20500	18800	-1700	0.46	0.92	36	33	-3
0023	2F	16_6	13	76	31	7600	6600	-1000	0.41	0.87	13	11	-2
0023	2F	16_6	14	2	0	200	0	-200	0.00	0.00	0	0	0
0023	2F	16_6	15	1	1	100	250	150	1.00	2.50	0	0	0
0023	2F	16_6	16	2	0	200	0	-200	0.00	0.00	0	0	0
0023	2F	16_6	23	1	0	100	0	-100	0.00	0.00	0	0	0
0023	2F	16_7	12	80	22	8000	6420	-1580	0.28	0.80	14	11	-3
0023	2F	16_7	13	30	10	3000	2540	-460	0.33	0.85	5	4	-1
0023	2F	16_7	14	31	12	3100	2520	-580	0.39	0.81	5	4	-1
0023	2F	16_7	15	12	2	1200	760	-440	0.17	0.63	2	1	-1
0023	2F	16_7	16	15	4	1500	2100	600	0.27	1.40	2	3	1
0023	2F	16_7	23	2	1	200	230	30	0.50	1.15	0	0	0
0023	2F	16_7	24	2	0	200	0	-200	0.00	0.00	0	0	0
0023	2F	16_7	25	6	2	600	650	50	0.33	1.08	1	1	0
0023	2F	16_7	26	5	0	500	0	-500	0.00	0.00	0	0	0
0023	2F	16_8	12	105	35	10500	9660	-840	0.33	0.92	18	17	-1
0023	2F	16_8	13	37	4	3700	1600	-2100	0.11	0.43	6	2	-4
0023	2F	16_8	14	48	15	4800	2970	-1830	0.31	0.62	8	5	-3
0023	2F	16_8	15	13	3	1300	1200	-100	0.23	0.92	2	2	0
0023	2F	16_8	16	2	0	200	0	-200	0.00	0.00	0	0	0
0023	2F	16_8	23	4	0	400	0	-400	0.00	0.00	0	0	0
0023	2F	16_8	25	7	3	700	1390	690	0.43	1.99	1	2	1
0023	2F	16_8	26	6	0	600	0	-600	0.00	0.00	1	0	-1
0023	2F	16_9	12	77	18	7700	4550	-3150	0.23	0.59	13	8	-5
0023	2F	16_9	13	27	8	2700	3080	380	0.30	1.14	4	5	1
0023	2F	16_9	14	177	79	17700	15820	-1880	0.45	0.89	31	28	-3
0023	2F	16_9	15	1	0	100	0	-100	0.00	0.00	0	0	0
0023	2F	17_1	12	185	50	18500	12330	-6170	0.27	0.67	32	21	-11
0023	2F	17_1	13	66	18	6600	5320	-1280	0.27	0.81	11	9	-2
0023	2F	17_1	14	21	5	2100	1300	-800	0.24	0.62	3	2	-1
0023	2F	17_1	15	1	1	100	220	120	1.00	2.20	0	0	0
0023	2F	17_10	12	152	50	15200	10670	-4530	0.33	0.70	26	18	-8
0023	2F	17_10	13	77	27	7700	7290	-410	0.35	0.95	13	12	-1
0023	2F	17_10	14	22	4	2200	1950	-250	0.18	0.89	3	3	0
0023	2F	17_10	15	1	0	100	0	-100	0.00	0.00	0	0	0
0023	2F	17_10	16	2	0	200	0	-200	0.00	0.00	0	0	0
0023	2F	17_10	26	1	0	100	0	-100	0.00	0.00	0	0	0
0023	2F	17_11	12	159	54	15900	11830	-4070	0.34	0.74	28	20	-8
0023	2F	17_11	13	68	21	6800	5740	-1060	0.31	0.84	12	10	-2
0023	2F	17_11	14	21	2	2100	490	-1610	0.10	0.23	3	0	-3
0023	2F	17_11	26	1	0	100	0	-100	0.00	0.00	0	0	0
0023	2F	17_12	12	223	67	22300	15320	-6980	0.30	0.69	39	27	-12
0023	2F	17_12	13	30	6	3000	1550	-1450	0.20	0.52	5	2	-3
0023	2F	17_12	15	1	0	100	0	-100	0.00	0.00	0	0	0
0023	2F	17_12	25	1	0	100	0	-100	0.00	0.00	0	0	0
0023	2F	17_2	12	124	24	12400	6860	-5540	0.19	0.55	21	12	-9
0023	2F	17_2	13	55	14	5500	4750	-750	0.25	0.86	9	8	-1
0023	2F	17_2	14	25	4	2500	1910	-590	0.16	0.76	4	3	-1
0023	2F	17_2	15	9	1	900	1180	280	0.11	1.31	1	2	1
0023	2F	17_2	16	2	0	200	0	-200	0.00	0.00	0	0	0
0023	2F	17_2	23	1	0	100	0	-100	0.00	0.00	0	0	0
0023	2F	17_2	24	2	0	200	0	-200	0.00	0.00	0	0	0
0023	2F	17_2	25	2	0	200	0	-200	0.00	0.00	0	0	0
0023	2F	17_3	12	75	19	7500	5980	-1520	0.25	0.80	13	10	-3
0023	2F	17_3	13	43	4	4300	1400	-2900	0.09	0.33	7	2	-5
0023	2F	17_3	14	26	0	2600	0	-2600	0.00	0.00	4	0	-4
0023	2F	17_3	15	14	2	1400	900	-500	0.14	0.64	2	1	-1
0023	2F	17_3	16	4	1	400	850	450	0.25	2.13	0	1	1
0023	2F	17_3	23	9	1	900	450	-450	0.11	0.50	1	0	-1
0023	2F	17_3	24	4	0	400	0	-400	0.00	0.00	0	0	0
0023	2F	17_3	25	1	0	100	0	-100	0.00	0.00	0	0	0
0023	2F	17_3	26	1	0	100	0	-100	0.00	0.00	0	0	0
0023	2F	17_4	12	108	29	10800	6990	-3810	0.27	0.65	19	12	-7
0023	2F	17_4	13	59	23	5900	5400	-500	0.39	0.92	10	9	-1
0023	2F	17_4	14	29	10	2900	3910	1010	0.34	1.35	5	6	1
0023	2F	17_4	15	9	2	900	980	80	0.22	1.09	1	1	0
0023	2F	17_4	16	1	0	100	0	-100	0.00	0.00	0	0	0
0023	2F	17_4	23	6	2	600	560	-40	0.33	0.93	1	0	-1
0023	2F	17_4	24	6	0	600	0	-600	0.00	0.00	1	0	-1
0023	2F	17_4	25	3	2	300	950	650	0.67	3.17	0	1	1
0023	2F	17_5	12	101	38	10100	10600	500	0.38	1.05	17	18	1
0023	2F	17_5	13	75	33	7500	6770	-730	0.44	0.90	13	11	-2
0023	2F	17_5	14	31	9	3100	2050	-1050	0.29	0.66	5	3	-2
0023	2F	17_5	15	4	0	400	0	-400	0.00	0.00	0	0	0
0023	2F	17_5	16	1	0	100	0	-100	0.00	0.00	0	0	0
0023	2F	17_5	23	1	0	100	0	-100	0.00	0.00	0	0	0
0023	2F	17_5	24	2	0	200	0	-200	0.00	0.00	0	0	0
0023	2F	17_5	25	3	0	300	0	-300	0.00	0.00	0	0	0
0023	2F	17_5	26	4	0	400	0	-400	0.00	0.00	0	0	0
0023	2F	17_6	12	106	37	10600	8140	-2460	0.35	0.77	18	14	-4
0023	2F	17_6	13	38	15	3800	5350	1550	0.39	1.41	6	9	3
0023	2F	17_6	14	26	9	2600	2380	-220	0.35	0.92	4	4	0
0023	2F	17_6	15	11	3	1100	820	-280	0.27	0.75	1	1	0
0023	2F	17_6	16	2	1	200	360	160	0.50	1.80	0	0	0
0023	2F	17_6	23	5	1	500	270	-230	0.20	0.54	0	0	0
0023	2F	17_6	24	7	3	700	710	10	0.43	1.01	1	1	0
0023	2F	17_6	25	1	0	100	0	-100	0.00	0.00	0	0	0
0023	2F	17_6	26	1	0	100	0	-100	0.00	0.00	0	0	0
0023	2F	17_7	12	100	36	10000	8130	-1870	0.36	0.81	17	14	-3
0023	2F	17_7	13	61	23	6100	6540	440	0.38	1.07	10	11	1
0023	2F	17_7	14	28	8	2800	2130	-670	0.29	0.76	4	3	-1
0023	2F	17_7	15	5	2	500	530	30	0.40	1.06	0	0	0
0023	2F	17_7	16	3	0	300	0	-300	0.00	0.00	0	0	0
0023	2F	17_7	23	6	1	600	210	-390	0.17	0.35	1	0	-1
0023	2F	17_7	24	7	1	700	270	-430	0.14	0.39	1	0	-1
0023	2F	17_7	25	1	0	100	0	-100	0.00	0.00	0	0	0
0023	2F	17_8	12	103	22	10300	5170	-5130	0.21	0.50	18	9	-9
0023	2F	17_8	13	63	21	6300	4550	-1750	0.33	0.72	11	8	-3
0023	2F	17_8	14	34	12	3400	2690	-710	0.35	0.79	6	4	-2
0023	2F	17_8	15	7	1	700	310	-390	0.14	0.44	1	0	-1
0023	2F	17_8	16	4	2	400	530	130	0.50	1.33	0	0	0
0023	2F	17_8	23	1	0	100	0	-100	0.00	0.00	0	0	0
0023	2F	17_8	24	1	0	100	0	-100	0.00	0.00	0	0	0
0023	2F	17_8	25	1	0	100	0	-100	0.00	0.00	0	0	0
0023	2F	17_9	12	135	58	13500	12890	-610	0.43	0.95	23	22	-1
0023	2F	17_9	13	110	45	11000	9110	-1890	0.41	0.83	19	16	-3
0023	2F	17_9	14	23	8	2300	1900	-400	0.35	0.83	4	3	-1
0023	2F	18_1	12	244	95	24400	24290	-110	0.39	1.00	43	42	-1
0023	2F	18_1	13	38	7	3800	1860	-1940	0.18	0.49	6	3	-3
0023	2F	18_1	14	7	1	700	530	-170	0.14	0.76	1	0	-1
0023	2F	18_1	15	6	2	600	980	380	0.33	1.63	1	1	0
0023	2F	18_10	12	127	53	12700	12060	-640	0.42	0.95	22	21	-1
0023	2F	18_10	13	46	19	4600	5710	1110	0.41	1.24	8	10	2
0023	2F	18_10	14	24	6	2400	1890	-510	0.25	0.79	4	3	-1
0023	2F	18_10	15	9	2	900	510	-390	0.22	0.57	1	0	-1
0023	2F	18_10	16	12	1	1200	290	-910	0.08	0.24	2	0	-2
0023	2F	18_10	23	1	0	100	0	-100	0.00	0.00	0	0	0
0023	2F	18_10	25	1	0	100	0	-100	0.00	0.00	0	0	0
0023	2F	18_10	26	4	0	400	0	-400	0.00	0.00	0	0	0
0023	2F	18_11	12	144	58	14400	12500	-1900	0.40	0.87	25	22	-3
0023	2F	18_11	13	89	34	8900	8050	-850	0.38	0.90	15	14	-1
0023	2F	18_11	14	38	12	3800	2480	-1320	0.32	0.65	6	4	-2
0023	2F	18_11	15	13	2	1300	420	-880	0.15	0.32	2	0	-2
0023	2F	18_11	16	2	0	200	0	-200	0.00	0.00	0	0	0
0023	2F	18_12	12	257	106	25700	23450	-2250	0.41	0.91	45	41	-4
0023	2F	18_12	13	25	12	2500	3090	590	0.48	1.24	4	5	1
0023	2F	18_12	14	7	2	700	420	-280	0.29	0.60	1	0	-1
0023	2F	18_2	12	178	57	17800	16040	-1760	0.32	0.90	31	28	-3
0023	2F	18_2	13	59	9	5900	2800	-3100	0.15	0.47	10	4	-6
0023	2F	18_2	14	38	13	3800	3480	-320	0.34	0.92	6	6	0
0023	2F	18_2	15	5	2	500	520	20	0.40	1.04	0	0	0
0023	2F	18_2	16	3	0	300	0	-300	0.00	0.00	0	0	0
0023	2F	18_3	12	134	49	13400	14990	1590	0.37	1.12	23	26	3
0023	2F	18_3	13	107	33	10700	10010	-690	0.31	0.94	18	17	-1
0023	2F	18_3	14	28	9	2800	2880	80	0.32	1.03	4	5	1
0023	2F	18_3	15	6	2	600	500	-100	0.33	0.83	1	0	-1
0023	2F	18_3	16	11	3	1100	1150	50	0.27	1.05	1	2	1
0023	2F	18_4	12	289	154	28900	22250	-6650	0.53	0.77	51	39	-12
0023	2F	18_4	13	4	0	400	0	-400	0.00	0.00	0	0	0
0023	2F	18_4	14	2	0	200	0	-200	0.00	0.00	0	0	0
0023	2F	18_5	12	95	24	9500	6750	-2750	0.25	0.71	16	11	-5
0023	2F	18_5	13	62	20	6200	6810	610	0.32	1.10	10	12	2
0023	2F	18_5	14	12	3	1200	660	-540	0.25	0.55	2	1	-1
0023	2F	18_5	15	10	2	1000	1270	270	0.20	1.27	1	2	1
0023	2F	18_5	16	8	3	800	1040	240	0.38	1.30	1	1	0
0023	2F	18_5	23	9	1	900	200	-700	0.11	0.22	1	0	-1
0023	2F	18_5	24	18	5	1800	3120	1320	0.28	1.73	3	5	2
0023	2F	18_5	25	1	0	100	0	-100	0.00	0.00	0	0	0
0023	2F	18_5	26	6	1	600	300	-300	0.17	0.50	1	0	-1
0023	2F	18_6	12	77	18	7700	4790	-2910	0.23	0.62	13	8	-5
0023	2F	18_6	13	58	13	5800	4220	-1580	0.22	0.73	10	7	-3
0023	2F	18_6	14	25	8	2500	4560	2060	0.32	1.82	4	8	4
0023	2F	18_6	15	2	1	200	300	100	0.50	1.50	0	0	0
0023	2F	18_6	16	15	1	1500	300	-1200	0.07	0.20	2	0	-2
0023	2F	18_6	23	9	1	900	630	-270	0.11	0.70	1	1	0
0023	2F	18_6	24	2	0	200	0	-200	0.00	0.00	0	0	0
0023	2F	18_6	25	1	0	100	0	-100	0.00	0.00	0	0	0
0023	2F	18_6	26	6	1	600	550	-50	0.17	0.92	1	0	-1
0023	2F	18_7	12	137	39	13700	13190	-510	0.28	0.96	24	23	-1
0023	2F	18_7	13	67	18	6700	5830	-870	0.27	0.87	11	10	-1
0023	2F	18_7	14	18	3	1800	1380	-420	0.17	0.77	3	2	-1
0023	2F	18_7	15	2	0	200	0	-200	0.00	0.00	0	0	0
0023	2F	18_7	16	3	1	300	440	140	0.33	1.47	0	0	0
0023	2F	18_7	23	6	0	600	0	-600	0.00	0.00	1	0	-1
0023	2F	18_7	24	1	0	100	0	-100	0.00	0.00	0	0	0
0023	2F	18_7	26	1	0	100	0	-100	0.00	0.00	0	0	0
0023	2F	18_8	12	80	24	8000	6050	-1950	0.30	0.76	14	10	-4
0023	2F	18_8	13	65	21	6500	5700	-800	0.32	0.88	11	10	-1
0023	2F	18_8	14	26	6	2600	1400	-1200	0.23	0.54	4	2	-2
0023	2F	18_8	15	15	4	1500	720	-780	0.27	0.48	2	1	-1
0023	2F	18_8	16	7	3	700	1790	1090	0.43	2.56	1	3	2
0023	2F	18_8	23	3	1	300	470	170	0.33	1.57	0	0	0
0023	2F	18_8	24	2	0	200	0	-200	0.00	0.00	0	0	0
0023	2F	18_8	25	3	0	300	0	-300	0.00	0.00	0	0	0
0023	2F	18_8	26	7	0	700	0	-700	0.00	0.00	1	0	-1
0023	2F	18_9	12	88	32	8800	8250	-550	0.36	0.94	15	14	-1
0023	2F	18_9	13	80	24	8000	6420	-1580	0.30	0.80	14	11	-3
0023	2F	18_9	14	26	7	2600	2030	-570	0.27	0.78	4	3	-1
0023	2F	18_9	15	2	0	200	0	-200	0.00	0.00	0	0	0
0023	2F	18_9	16	4	1	400	560	160	0.25	1.40	0	0	0
0023	2F	18_9	23	2	1	200	420	220	0.50	2.10	0	0	0
0023	2F	18_9	24	4	1	400	600	200	0.25	1.50	0	1	1
0023	2F	18_9	25	2	0	200	0	-200	0.00	0.00	0	0	0
0023	2F	18_9	26	3	1	300	400	100	0.33	1.33	0	0	0
0023	2F	19_1	12	149	49	14900	11830	-3070	0.33	0.79	26	20	-6
0023	2F	19_1	13	50	12	5000	2810	-2190	0.24	0.56	8	4	-4
0023	2F	19_1	14	19	5	1900	1410	-490	0.26	0.74	3	2	-1
0023	2F	19_1	15	3	0	300	0	-300	0.00	0.00	0	0	0
0023	2F	19_1	16	3	1	300	230	-70	0.33	0.77	0	0	0
0023	2F	19_10	12	163	58	16300	13980	-2320	0.36	0.86	28	24	-4
0023	2F	19_10	13	62	18	6200	4440	-1760	0.29	0.72	10	7	-3
0023	2F	19_10	14	23	7	2300	2000	-300	0.30	0.87	4	3	-1
0023	2F	19_10	15	1	0	100	0	-100	0.00	0.00	0	0	0
0023	2F	19_10	16	1	0	100	0	-100	0.00	0.00	0	0	0
0023	2F	19_11	12	181	68	18100	15590	-2510	0.38	0.86	32	27	-5
0023	2F	19_11	13	53	17	5300	3800	-1500	0.32	0.72	9	6	-3
0023	2F	19_11	14	18	6	1800	1630	-170	0.33	0.91	3	2	-1
0023	2F	19_11	15	1	0	100	0	-100	0.00	0.00	0	0	0
0023	2F	19_12	12	208	63	20800	16160	-4640	0.30	0.78	36	28	-8
0023	2F	19_12	13	26	10	2600	2160	-440	0.38	0.83	4	3	-1
0023	2F	19_12	14	10	2	1000	500	-500	0.20	0.50	1	0	-1
0023	2F	19_2	12	71	17	7100	4530	-2570	0.24	0.64	12	8	-4
0023	2F	19_2	13	51	8	5100	2390	-2710	0.16	0.47	9	4	-5
0023	2F	19_2	14	23	5	2300	2300	0	0.22	1.00	4	4	0
0023	2F	19_2	15	13	0	1300	0	-1300	0.00	0.00	2	0	-2
0023	2F	19_2	16	11	0	1100	0	-1100	0.00	0.00	1	0	-1
0023	2F	19_2	23	5	1	500	680	180	0.20	1.36	0	1	1
0023	2F	19_2	26	3	1	300	220	-80	0.33	0.73	0	0	0
0023	2F	19_3	12	58	16	5800	5240	-560	0.28	0.90	10	9	-1
0023	2F	19_3	13	38	8	3800	2400	-1400	0.21	0.63	6	4	-2
0023	2F	19_3	14	11	5	1100	1460	360	0.45	1.33	1	2	1
0023	2F	19_3	15	12	0	1200	0	-1200	0.00	0.00	2	0	-2
0023	2F	19_3	16	17	5	1700	3320	1620	0.29	1.95	3	5	2
0023	2F	19_3	23	4	0	400	0	-400	0.00	0.00	0	0	0
0023	2F	19_3	24	5	1	500	410	-90	0.20	0.82	0	0	0
0023	2F	19_3	25	1	0	100	0	-100	0.00	0.00	0	0	0
0023	2F	19_3	26	4	0	400	0	-400	0.00	0.00	0	0	0
0023	2F	19_4	12	61	11	6100	3040	-3060	0.18	0.50	10	5	-5
0023	2F	19_4	13	50	14	5000	3870	-1130	0.28	0.77	8	6	-2
0023	2F	19_4	14	8	2	800	570	-230	0.25	0.71	1	1	0
0023	2F	19_4	15	8	1	800	540	-260	0.13	0.68	1	0	-1
0023	2F	19_4	16	10	2	1000	1080	80	0.20	1.08	1	1	0
0023	2F	19_4	23	5	0	500	0	-500	0.00	0.00	0	0	0
0023	2F	19_4	24	2	1	200	250	50	0.50	1.25	0	0	0
0023	2F	19_4	26	9	4	900	1510	610	0.44	1.68	1	2	1
0023	2F	19_5	12	67	22	6700	6310	-390	0.33	0.94	11	11	0
0023	2F	19_5	13	25	7	2500	2210	-290	0.28	0.88	4	3	-1
0023	2F	19_5	14	159	69	15900	13780	-2120	0.43	0.87	28	24	-4
0023	2F	19_6	12	56	13	5600	3500	-2100	0.23	0.63	9	6	-3
0023	2F	19_6	13	48	15	4800	2630	-2170	0.31	0.55	8	4	-4
0023	2F	19_6	14	15	2	1500	670	-830	0.13	0.45	2	1	-1
0023	2F	19_6	15	2	0	200	0	-200	0.00	0.00	0	0	0
0023	2F	19_6	16	9	0	900	0	-900	0.00	0.00	1	0	-1
0023	2F	19_6	23	7	1	700	360	-340	0.14	0.51	1	0	-1
0023	2F	19_6	24	4	0	400	0	-400	0.00	0.00	0	0	0
0023	2F	19_6	25	1	0	100	0	-100	0.00	0.00	0	0	0
0023	2F	19_6	26	7	2	700	670	-30	0.29	0.96	1	1	0
0023	2F	19_7	12	63	17	6300	3610	-2690	0.27	0.57	11	6	-5
0023	2F	19_7	13	120	58	12000	10340	-1660	0.48	0.86	21	18	-3
0023	2F	19_7	14	53	25	5300	5750	450	0.47	1.08	9	10	1
0023	2F	19_7	15	3	1	300	190	-110	0.33	0.63	0	0	0
0023	2F	19_7	16	5	1	500	240	-260	0.20	0.48	0	0	0
0023	2F	19_8	12	83	26	8300	7610	-690	0.31	0.92	14	13	-1
0023	2F	19_8	13	94	37	9400	7700	-1700	0.39	0.82	16	13	-3
0023	2F	19_8	14	41	14	4100	3440	-660	0.34	0.84	7	6	-1
0023	2F	19_8	15	5	0	500	0	-500	0.00	0.00	0	0	0
0023	2F	19_8	16	3	0	300	0	-300	0.00	0.00	0	0	0
0023	2F	19_8	24	1	0	100	0	-100	0.00	0.00	0	0	0
0023	2F	19_9	12	129	57	12900	12490	-410	0.44	0.97	22	22	0
0023	2F	19_9	13	78	34	7800	6980	-820	0.44	0.89	13	12	-1
0023	2F	19_9	14	31	2	3100	500	-2600	0.06	0.16	5	0	-5
0023	2F	19_9	15	3	1	300	150	-150	0.33	0.50	0	0	0
0023	2F	19_9	16	2	0	200	0	-200	0.00	0.00	0	0	0
0023	2F	19_9	23	1	0	100	0	-100	0.00	0.00	0	0	0
0023	2F	20_1	12	142	33	14200	9640	-4560	0.23	0.68	25	17	-8
0023	2F	20_1	13	46	7	4600	2280	-2320	0.15	0.50	8	4	-4
0023	2F	20_1	14	28	4	2800	1130	-1670	0.14	0.40	4	2	-2
0023	2F	20_1	15	11	2	1100	1270	170	0.18	1.15	1	2	1
0023	2F	20_1	16	2	1	200	520	320	0.50	2.60	0	0	0
0023	2F	20_1	23	1	0	100	0	-100	0.00	0.00	0	0	0
0023	2F	20_1	24	1	0	100	0	-100	0.00	0.00	0	0	0
0023	2F	20_1	25	1	0	100	0	-100	0.00	0.00	0	0	0
0023	2F	20_10	12	156	53	15600	14040	-1560	0.34	0.90	27	24	-3
0023	2F	20_10	13	74	25	7400	5850	-1550	0.34	0.79	13	10	-3
0023	2F	20_10	14	28	9	2800	2100	-700	0.32	0.75	4	3	-1
0023	2F	20_10	15	3	1	300	270	-30	0.33	0.90	0	0	0
0023	2F	20_11	12	181	67	18100	15380	-2720	0.37	0.85	32	27	-5
0023	2F	20_11	13	61	24	6100	5910	-190	0.39	0.97	10	10	0
0023	2F	20_11	14	25	10	2500	1930	-570	0.40	0.77	4	3	-1
0023	2F	20_11	15	2	1	200	280	80	0.50	1.40	0	0	0
0023	2F	20_12	12	204	60	20400	16270	-4130	0.29	0.80	36	28	-8
0023	2F	20_12	13	37	14	3700	3020	-680	0.38	0.82	6	5	-1
0023	2F	20_12	14	15	1	1500	300	-1200	0.07	0.20	2	0	-2
0023	2F	20_12	15	1	1	100	250	150	1.00	2.50	0	0	0
0023	2F	20_12	16	1	1	100	620	520	1.00	6.20	0	1	1
0023	2F	20_2	12	81	22	8100	6720	-1380	0.27	0.83	14	11	-3
0023	2F	20_2	13	42	8	4200	1830	-2370	0.19	0.44	7	3	-4
0023	2F	20_2	14	35	8	3500	2030	-1470	0.23	0.58	6	3	-3
0023	2F	20_2	15	19	4	1900	1990	90	0.21	1.05	3	3	0
0023	2F	20_2	16	17	2	1700	590	-1110	0.12	0.35	3	1	-2
0023	2F	20_2	23	4	1	400	420	20	0.25	1.05	0	0	0
0023	2F	20_2	24	2	1	200	600	400	0.50	3.00	0	1	1
0023	2F	20_2	25	2	0	200	0	-200	0.00	0.00	0	0	0
0023	2F	20_2	26	1	0	100	0	-100	0.00	0.00	0	0	0
0023	2F	20_3	12	70	23	7000	8170	1170	0.33	1.17	12	14	2
0023	2F	20_3	13	39	9	3900	2850	-1050	0.23	0.73	6	5	-1
0023	2F	20_3	14	30	7	3000	1680	-1320	0.23	0.56	5	2	-3
0023	2F	20_3	15	26	7	2600	2530	-70	0.27	0.97	4	4	0
0023	2F	20_3	16	18	5	1800	1350	-450	0.28	0.75	3	2	-1
0023	2F	20_3	23	4	1	400	240	-160	0.25	0.60	0	0	0
0023	2F	20_3	24	2	0	200	0	-200	0.00	0.00	0	0	0
0023	2F	20_3	25	1	0	100	0	-100	0.00	0.00	0	0	0
0023	2F	20_4	12	58	18	5800	6160	360	0.31	1.06	10	10	0
0023	2F	20_4	13	47	11	4700	4050	-650	0.23	0.86	8	7	-1
0023	2F	20_4	14	35	6	3500	2340	-1160	0.17	0.67	6	4	-2
0023	2F	20_4	15	20	3	2000	660	-1340	0.15	0.33	3	1	-2
0023	2F	20_4	16	21	5	2100	1310	-790	0.24	0.62	3	2	-1
0023	2F	20_4	23	4	0	400	0	-400	0.00	0.00	0	0	0
0023	2F	20_4	24	6	3	600	1440	840	0.50	2.40	1	2	1
0023	2F	20_4	26	2	0	200	0	-200	0.00	0.00	0	0	0
0023	2F	20_5	12	228	114	22800	19620	-3180	0.50	0.86	40	34	-6
0023	2F	20_5	13	3	2	300	570	270	0.67	1.90	0	1	1
0023	2F	20_5	14	4	2	400	630	230	0.50	1.58	0	1	1
0023	2F	20_6	12	82	24	8200	6530	-1670	0.29	0.80	14	11	-3
0023	2F	20_6	13	88	24	8800	5310	-3490	0.27	0.60	15	9	-6
0023	2F	20_6	14	66	22	6600	4990	-1610	0.33	0.76	11	8	-3
0023	2F	20_6	15	14	5	1400	1360	-40	0.36	0.97	2	2	0
0023	2F	20_6	16	4	2	400	1240	840	0.50	3.10	0	2	2
0023	2F	20_6	26	1	1	100	240	140	1.00	2.40	0	0	0
0023	2F	20_7	12	104	28	10400	8420	-1980	0.27	0.81	18	14	-4
0023	2F	20_7	13	75	32	7500	8080	580	0.43	1.08	13	14	1
0023	2F	20_7	14	68	23	6800	5110	-1690	0.34	0.75	12	9	-3
0023	2F	20_7	15	11	1	1100	320	-780	0.09	0.29	1	0	-1
0023	2F	20_7	16	2	1	200	430	230	0.50	2.15	0	0	0
0023	2F	20_8	12	175	68	17500	13550	-3950	0.39	0.77	30	23	-7
0023	2F	20_8	13	82	40	8200	8370	170	0.49	1.02	14	14	0
0023	2F	20_8	14	5	2	500	350	-150	0.40	0.70	0	0	0
0023	2F	20_8	15	1	1	100	190	90	1.00	1.90	0	0	0
0023	2F	20_8	16	1	0	100	0	-100	0.00	0.00	0	0	0
0023	2F	20_9	12	106	40	10600	10910	310	0.38	1.03	18	19	1
0023	2F	20_9	13	88	29	8800	6770	-2030	0.33	0.77	15	11	-4
0023	2F	20_9	14	54	18	5400	4010	-1390	0.33	0.74	9	7	-2
0023	2F	20_9	15	8	3	800	880	80	0.38	1.10	1	1	0
0023	2F	20_9	16	8	2	800	640	-160	0.25	0.80	1	1	0
0023	2F	21_1	12	157	44	15700	11290	-4410	0.28	0.72	27	19	-8
0023	2F	21_1	13	94	37	9400	8950	-450	0.39	0.95	16	15	-1
0023	2F	21_1	14	15	8	1500	1630	130	0.53	1.09	2	2	0
0023	2F	21_1	15	6	0	600	0	-600	0.00	0.00	1	0	-1
0023	2F	21_10	12	155	50	15500	12370	-3130	0.32	0.80	27	21	-6
0023	2F	21_10	13	73	26	7300	6580	-720	0.36	0.90	12	11	-1
0023	2F	21_10	14	25	9	2500	2650	150	0.36	1.06	4	4	0
0023	2F	21_10	15	4	1	400	460	60	0.25	1.15	0	0	0
0023	2F	21_11	12	191	57	19100	12980	-6120	0.30	0.68	33	22	-11
0023	2F	21_11	13	54	16	5400	3820	-1580	0.30	0.71	9	6	-3
0023	2F	21_11	14	18	7	1800	1740	-60	0.39	0.97	3	3	0
0023	2F	21_11	15	2	1	200	170	-30	0.50	0.85	0	0	0
0023	2F	21_11	23	1	1	100	200	100	1.00	2.00	0	0	0
0023	2F	21_12	12	226	68	22600	17170	-5430	0.30	0.76	40	30	-10
0023	2F	21_12	13	32	11	3200	2260	-940	0.34	0.71	5	4	-1
0023	2F	21_12	14	8	4	800	920	120	0.50	1.15	1	1	0
0023	2F	21_2	12	64	11	6400	3620	-2780	0.17	0.57	11	6	-5
0023	2F	21_2	13	24	9	2400	4510	2110	0.38	1.88	4	7	3
0023	2F	21_2	14	175	78	17500	13120	-4380	0.45	0.75	30	23	-7
0023	2F	21_2	16	2	1	200	560	360	0.50	2.80	0	0	0
0023	2F	21_3	12	20	3	2000	1160	-840	0.15	0.58	3	2	-1
0023	2F	21_3	13	220	97	22000	18340	-3660	0.44	0.83	38	32	-6
0023	2F	21_3	15	20	3	2000	850	-1150	0.15	0.43	3	1	-2
0023	2F	21_4	12	143	55	14300	12550	-1750	0.38	0.88	25	22	-3
0023	2F	21_4	13	114	41	11400	9240	-2160	0.36	0.81	20	16	-4
0023	2F	21_4	14	14	6	1400	1690	290	0.43	1.21	2	2	0
0023	2F	21_4	15	2	1	200	270	70	0.50	1.35	0	0	0
0023	2F	21_5	12	220	117	22000	19940	-2060	0.53	0.91	38	35	-3
0023	2F	21_5	13	4	0	400	0	-400	0.00	0.00	0	0	0
0023	2F	21_5	14	1	0	100	0	-100	0.00	0.00	0	0	0
0023	2F	21_5	16	1	0	100	0	-100	0.00	0.00	0	0	0
0023	2F	21_5	23	1	0	100	0	-100	0.00	0.00	0	0	0
0023	2F	21_5	26	2	1	200	330	130	0.50	1.65	0	0	0
0023	2F	21_6	12	107	29	10700	8180	-2520	0.27	0.76	18	14	-4
0023	2F	21_6	13	39	13	3900	4850	950	0.33	1.24	6	8	2
0023	2F	21_6	14	18	4	1800	2050	250	0.22	1.14	3	3	0
0023	2F	21_6	15	3	0	300	0	-300	0.00	0.00	0	0	0
0023	2F	21_6	16	3	1	300	760	460	0.33	2.53	0	1	1
0023	2F	21_6	23	2	0	200	0	-200	0.00	0.00	0	0	0
0023	2F	21_6	24	6	2	600	890	290	0.33	1.48	1	1	0
0023	2F	21_6	26	3	0	300	0	-300	0.00	0.00	0	0	0
0023	2F	21_7	12	146	51	14600	12260	-2340	0.35	0.84	25	21	-4
0023	2F	21_7	13	70	21	7000	5640	-1360	0.30	0.81	12	9	-3
0023	2F	21_7	14	28	5	2800	1940	-860	0.18	0.69	4	3	-1
0023	2F	21_7	15	6	1	600	590	-10	0.17	0.98	1	1	0
0023	2F	21_7	23	4	2	400	1060	660	0.50	2.65	0	1	1
0023	2F	21_7	24	1	0	100	0	-100	0.00	0.00	0	0	0
0023	2F	21_7	26	1	0	100	0	-100	0.00	0.00	0	0	0
0023	2F	21_8	12	100	34	10000	10550	550	0.34	1.06	17	18	1
0023	2F	21_8	13	89	39	8900	7870	-1030	0.44	0.88	15	13	-2
0023	2F	21_8	14	49	22	4900	4910	10	0.45	1.00	8	8	0
0023	2F	21_8	15	9	3	900	780	-120	0.33	0.87	1	1	0
0023	2F	21_8	16	4	1	400	340	-60	0.25	0.85	0	0	0
0023	2F	21_8	25	1	0	100	0	-100	0.00	0.00	0	0	0
0023	2F	21_9	12	106	41	10600	9360	-1240	0.39	0.88	18	16	-2
0023	2F	21_9	13	40	10	4000	3370	-630	0.25	0.84	7	5	-2
0023	2F	21_9	14	25	8	2500	1790	-710	0.32	0.72	4	3	-1
0023	2F	21_9	15	3	1	300	330	30	0.33	1.10	0	0	0
0023	2F	21_9	16	2	1	200	900	700	0.50	4.50	0	1	1
0023	2F	21_9	23	2	0	200	0	-200	0.00	0.00	0	0	0
0023	2F	21_9	24	3	2	300	900	600	0.67	3.00	0	1	1
0023	2F	21_9	25	2	1	200	280	80	0.50	1.40	0	0	0
0023	2F	21_9	26	1	0	100	0	-100	0.00	0.00	0	0	0
0023	2F	22_1	12	128	46	12800	11450	-1350	0.36	0.89	22	20	-2
0023	2F	22_1	13	56	22	5600	4890	-710	0.39	0.87	9	8	-1
0023	2F	22_1	14	25	9	2500	2160	-340	0.36	0.86	4	3	-1
0023	2F	22_1	15	4	2	400	1210	810	0.50	3.03	0	2	2
0023	2F	22_1	16	2	0	200	0	-200	0.00	0.00	0	0	0
0023	2F	22_10	12	136	53	13600	11540	-2060	0.39	0.85	24	20	-4
0023	2F	22_10	13	63	19	6300	4040	-2260	0.30	0.64	11	7	-4
0023	2F	22_10	14	32	12	3200	3290	90	0.38	1.03	5	5	0
0023	2F	22_10	16	1	0	100	0	-100	0.00	0.00	0	0	0
0023	2F	22_11	12	150	61	15000	15460	460	0.41	1.03	26	27	1
0023	2F	22_11	13	63	15	6300	3470	-2830	0.24	0.55	11	6	-5
0023	2F	22_11	14	31	6	3100	1840	-1260	0.19	0.59	5	3	-2
0023	2F	22_12	12	176	73	17600	17800	200	0.41	1.01	31	31	0
0023	2F	22_12	13	50	18	5000	4660	-340	0.36	0.93	8	8	0
0023	2F	22_12	14	15	3	1500	1020	-480	0.20	0.68	2	1	-1
0023	2F	22_2	12	66	18	6600	5270	-1330	0.27	0.80	11	9	-2
0023	2F	22_2	13	51	12	5100	2570	-2530	0.24	0.50	9	4	-5
0023	2F	22_2	14	28	6	2800	1480	-1320	0.21	0.53	4	2	-2
0023	2F	22_2	15	5	3	500	900	400	0.60	1.80	0	1	1
0023	2F	22_2	16	4	0	400	0	-400	0.00	0.00	0	0	0
0023	2F	22_2	23	3	1	300	350	50	0.33	1.17	0	0	0
0023	2F	22_2	24	1	0	100	0	-100	0.00	0.00	0	0	0
0023	2F	22_2	25	3	0	300	0	-300	0.00	0.00	0	0	0
0023	2F	22_2	26	1	0	100	0	-100	0.00	0.00	0	0	0
0023	2F	22_3	12	70	25	7000	6560	-440	0.36	0.94	12	11	-1
0023	2F	22_3	13	48	14	4800	3030	-1770	0.29	0.63	8	5	-3
0023	2F	22_3	14	24	5	2400	1250	-1150	0.21	0.52	4	2	-2
0023	2F	22_3	15	12	3	1200	1530	330	0.25	1.28	2	2	0
0023	2F	22_3	16	8	2	800	1130	330	0.25	1.41	1	2	1
0023	2F	22_3	23	3	0	300	0	-300	0.00	0.00	0	0	0
0023	2F	22_3	24	3	0	300	0	-300	0.00	0.00	0	0	0
0023	2F	22_3	25	2	0	200	0	-200	0.00	0.00	0	0	0
0023	2F	22_3	26	1	0	100	0	-100	0.00	0.00	0	0	0
0023	2F	22_4	12	74	27	7400	7880	480	0.36	1.06	13	13	0
0023	2F	22_4	13	48	15	4800	4340	-460	0.31	0.90	8	7	-1
0023	2F	22_4	14	24	6	2400	2230	-170	0.25	0.93	4	3	-1
0023	2F	22_4	15	10	3	1000	1150	150	0.30	1.15	1	2	1
0023	2F	22_4	16	9	0	900	0	-900	0.00	0.00	1	0	-1
0023	2F	22_4	23	3	0	300	0	-300	0.00	0.00	0	0	0
0023	2F	22_4	24	2	0	200	0	-200	0.00	0.00	0	0	0
0023	2F	22_5	12	67	16	6700	4620	-2080	0.24	0.69	11	8	-3
0023	2F	22_5	13	55	15	5500	4130	-1370	0.27	0.75	9	7	-2
0023	2F	22_5	14	33	9	3300	2620	-680	0.27	0.79	5	4	-1
0023	2F	22_5	15	11	5	1100	2040	940	0.45	1.85	1	3	2
0023	2F	22_5	16	5	1	500	500	0	0.20	1.00	0	0	0
0023	2F	22_5	23	5	2	500	420	-80	0.40	0.84	0	0	0
0023	2F	22_5	24	2	0	200	0	-200	0.00	0.00	0	0	0
0023	2F	22_5	25	2	2	200	690	490	1.00	3.45	0	1	1
0023	2F	22_5	26	4	2	400	1200	800	0.50	3.00	0	2	2
0023	2F	22_6	12	73	27	7300	7150	-150	0.37	0.98	12	12	0
0023	2F	22_6	13	43	14	4300	2870	-1430	0.33	0.67	7	5	-2
0023	2F	22_6	14	29	6	2900	1770	-1130	0.21	0.61	5	3	-2
0023	2F	22_6	15	14	3	1400	1020	-380	0.21	0.73	2	1	-1
0023	2F	22_6	16	4	1	400	220	-180	0.25	0.55	0	0	0
0023	2F	22_6	23	4	3	400	990	590	0.75	2.48	0	1	1
0023	2F	22_6	24	2	0	200	0	-200	0.00	0.00	0	0	0
0023	2F	22_6	25	4	1	400	180	-220	0.25	0.45	0	0	0
0023	2F	22_6	26	3	1	300	340	40	0.33	1.13	0	0	0
0023	2F	22_7	12	87	32	8700	9020	320	0.37	1.04	15	15	0
0023	2F	22_7	13	50	15	5000	3710	-1290	0.30	0.74	8	6	-2
0023	2F	22_7	14	20	2	2000	650	-1350	0.10	0.33	3	1	-2
0023	2F	22_7	15	8	3	800	880	80	0.38	1.10	1	1	0
0023	2F	22_7	16	3	0	300	0	-300	0.00	0.00	0	0	0
0023	2F	22_7	23	1	1	100	220	120	1.00	2.20	0	0	0
0023	2F	22_7	24	4	3	400	880	480	0.75	2.20	0	1	1
0023	2F	22_7	25	3	2	300	620	320	0.67	2.07	0	1	1
0023	2F	22_8	12	94	40	9400	10360	960	0.43	1.10	16	18	2
0023	2F	22_8	13	41	14	4100	3090	-1010	0.34	0.75	7	5	-2
0023	2F	22_8	14	94	35	9400	6810	-2590	0.37	0.72	16	12	-4
0023	2F	22_8	15	1	0	100	0	-100	0.00	0.00	0	0	0
0023	2F	22_9	12	106	35	10600	9380	-1220	0.33	0.88	18	16	-2
0023	2F	22_9	13	52	19	5200	6050	850	0.37	1.16	9	10	1
0023	2F	22_9	14	19	3	1900	610	-1290	0.16	0.32	3	1	-2
0023	2F	22_9	15	8	2	800	460	-340	0.25	0.58	1	0	-1
0023	2F	22_9	16	4	0	400	0	-400	0.00	0.00	0	0	0
0023	2F	22_9	23	2	2	200	550	350	1.00	2.75	0	0	0
0023	2F	22_9	24	2	2	200	620	420	1.00	3.10	0	1	1
0023	2F	22_9	25	3	0	300	0	-300	0.00	0.00	0	0	0
0023	2F	22_9	26	1	0	100	0	-100	0.00	0.00	0	0	0
0023	2F	23_1	12	187	68	18700	16310	-2390	0.36	0.87	33	28	-5
0023	2F	23_1	13	54	9	5400	2520	-2880	0.17	0.47	9	4	-5
0023	2F	23_1	14	19	7	1900	1900	0	0.37	1.00	3	3	0
0023	2F	23_1	15	4	0	400	0	-400	0.00	0.00	0	0	0
0023	2F	23_1	16	1	0	100	0	-100	0.00	0.00	0	0	0
0023	2F	23_10	12	171	56	17100	14300	-2800	0.33	0.84	30	25	-5
0023	2F	23_10	13	54	14	5400	4410	-990	0.26	0.82	9	7	-2
0023	2F	23_10	14	24	5	2400	4680	2280	0.21	1.95	4	8	4
0023	2F	23_10	23	1	0	100	0	-100	0.00	0.00	0	0	0
0023	2F	23_10	24	7	0	700	0	-700	0.00	0.00	1	0	-1
0023	2F	23_11	12	149	52	14900	11900	-3000	0.35	0.80	26	21	-5
0023	2F	23_11	13	72	19	7200	6540	-660	0.26	0.91	12	11	-1
0023	2F	23_11	14	8	1	800	900	100	0.13	1.13	1	1	0
0023	2F	23_11	16	1	0	100	0	-100	0.00	0.00	0	0	0
0023	2F	23_12	12	210	66	21000	17820	-3180	0.31	0.85	37	31	-6
0023	2F	23_12	13	34	10	3400	2830	-570	0.29	0.83	6	5	-1
0023	2F	23_12	14	1	1	100	1180	1080	1.00	11.80	0	2	2
0023	2F	23_2	12	257	120	25700	18010	-7690	0.47	0.70	45	31	-14
0023	2F	23_2	13	3	0	300	0	-300	0.00	0.00	0	0	0
0023	2F	23_2	14	3	0	300	0	-300	0.00	0.00	0	0	0
0023	2F	23_3	12	20	8	2000	2120	120	0.40	1.06	3	3	0
0023	2F	23_3	13	236	123	23600	21880	-1720	0.52	0.93	41	38	-3
0023	2F	23_3	14	4	2	400	590	190	0.50	1.48	0	1	1
0023	2F	23_3	15	1	0	100	0	-100	0.00	0.00	0	0	0
0023	2F	23_3	23	1	0	100	0	-100	0.00	0.00	0	0	0
0023	2F	23_4	12	65	13	6500	4460	-2040	0.20	0.69	11	7	-4
0023	2F	23_4	13	80	34	8000	7120	-880	0.43	0.89	14	12	-2
0023	2F	23_4	14	98	30	9800	6750	-3050	0.31	0.69	17	11	-6
0023	2F	23_4	15	17	7	1700	2690	990	0.41	1.58	3	4	1
0023	2F	23_4	16	8	3	800	1270	470	0.38	1.59	1	2	1
0023	2F	23_5	12	91	29	9100	10030	930	0.32	1.10	16	17	1
0023	2F	23_5	13	44	12	4400	3810	-590	0.27	0.87	7	6	-1
0023	2F	23_5	14	30	8	3000	3020	20	0.27	1.01	5	5	0
0023	2F	23_5	15	13	2	1300	450	-850	0.15	0.35	2	0	-2
0023	2F	23_5	16	4	0	400	0	-400	0.00	0.00	0	0	0
0023	2F	23_5	23	3	0	300	0	-300	0.00	0.00	0	0	0
0023	2F	23_5	24	7	1	700	400	-300	0.14	0.57	1	0	-1
0023	2F	23_5	25	2	1	200	370	170	0.50	1.85	0	0	0
0023	2F	23_5	26	1	0	100	0	-100	0.00	0.00	0	0	0
0023	2F	23_6	12	64	12	6400	2960	-3440	0.19	0.46	11	5	-6
0023	2F	23_6	13	48	18	4800	5680	880	0.38	1.18	8	10	2
0023	2F	23_6	14	42	11	4200	3630	-570	0.26	0.86	7	6	-1
0023	2F	23_6	15	2	1	200	340	140	0.50	1.70	0	0	0
0023	2F	23_6	16	10	2	1000	1360	360	0.20	1.36	1	2	1
0023	2F	23_6	23	4	1	400	790	390	0.25	1.98	0	1	1
0023	2F	23_6	24	5	0	500	0	-500	0.00	0.00	0	0	0
0023	2F	23_6	25	5	2	500	510	10	0.40	1.02	0	0	0
0023	2F	23_6	26	3	0	300	0	-300	0.00	0.00	0	0	0
0023	2F	23_7	12	72	25	7200	8720	1520	0.35	1.21	12	15	3
0023	2F	23_7	13	47	3	4700	1700	-3000	0.06	0.36	8	3	-5
0023	2F	23_7	14	26	7	2600	1500	-1100	0.27	0.58	4	2	-2
0023	2F	23_7	15	8	1	800	230	-570	0.13	0.29	1	0	-1
0023	2F	23_7	16	7	1	700	410	-290	0.14	0.59	1	0	-1
0023	2F	23_7	23	1	0	100	0	-100	0.00	0.00	0	0	0
0023	2F	23_7	24	5	2	500	750	250	0.40	1.50	0	1	1
0023	2F	23_7	25	1	0	100	0	-100	0.00	0.00	0	0	0
0023	2F	23_7	26	1	0	100	0	-100	0.00	0.00	0	0	0
0023	2F	23_8	12	37	11	3700	3070	-630	0.30	0.83	6	5	-1
0023	2F	23_8	13	34	9	3400	2470	-930	0.26	0.73	6	4	-2
0023	2F	23_8	14	46	12	4600	3280	-1320	0.26	0.71	8	5	-3
0023	2F	23_8	15	14	3	1400	750	-650	0.21	0.54	2	1	-1
0023	2F	23_8	16	1	1	100	180	80	1.00	1.80	0	0	0
0023	2F	23_8	23	2	1	200	200	0	0.50	1.00	0	0	0
0023	2F	23_8	24	2	0	200	0	-200	0.00	0.00	0	0	0
0023	2F	23_8	25	2	0	200	0	-200	0.00	0.00	0	0	0
0023	2F	23_9	12	103	38	10300	9180	-1120	0.37	0.89	18	16	-2
0023	2F	23_9	13	55	10	5500	2440	-3060	0.18	0.44	9	4	-5
0023	2F	23_9	14	30	5	3000	2290	-710	0.17	0.76	5	4	-1
0023	2F	23_9	15	13	3	1300	1050	-250	0.23	0.81	2	1	-1
0023	2F	23_9	16	3	0	300	0	-300	0.00	0.00	0	0	0
0023	2F	23_9	23	4	1	400	550	150	0.25	1.38	0	0	0
0023	2F	23_9	24	2	0	200	0	-200	0.00	0.00	0	0	0
0023	2F	23_9	25	5	1	500	500	0	0.20	1.00	0	0	0
0023	2F	24_1	12	130	48	13000	10200	-2800	0.37	0.78	23	18	-5
0023	2F	24_1	13	49	17	4900	4700	-200	0.35	0.96	8	8	0
0023	2F	24_1	14	22	5	2200	2090	-110	0.23	0.95	3	3	0
0023	2F	24_1	15	10	1	1000	400	-600	0.10	0.40	1	0	-1
0023	2F	24_1	16	7	0	700	0	-700	0.00	0.00	1	0	-1
0023	2F	24_1	23	3	1	300	960	660	0.33	3.20	0	1	1
0023	2F	24_1	25	1	0	100	0	-100	0.00	0.00	0	0	0
0023	2F	24_10	12	201	66	20100	13940	-6160	0.33	0.69	35	24	-11
0023	2F	24_10	13	53	18	5300	4280	-1020	0.34	0.81	9	7	-2
0023	2F	24_10	14	15	6	1500	1680	180	0.40	1.12	2	2	0
0023	2F	24_10	15	2	1	200	360	160	0.50	1.80	0	0	0
0023	2F	24_10	16	1	0	100	0	-100	0.00	0.00	0	0	0
0023	2F	24_11	12	218	69	21800	14990	-6810	0.32	0.69	38	26	-12
0023	2F	24_11	13	44	20	4400	4540	140	0.45	1.03	7	8	1
0023	2F	24_11	14	10	6	1000	1600	600	0.60	1.60	1	2	1
0023	2F	24_11	15	1	0	100	0	-100	0.00	0.00	0	0	0
0023	2F	24_11	16	1	0	100	0	-100	0.00	0.00	0	0	0
0023	2F	24_12	12	210	66	21000	15610	-5390	0.31	0.74	37	27	-10
0023	2F	24_12	13	38	16	3800	3950	150	0.42	1.04	6	6	0
0023	2F	24_12	14	14	2	1400	360	-1040	0.14	0.26	2	0	-2
0023	2F	24_12	16	1	1	100	360	260	1.00	3.60	0	0	0
0023	2F	24_2	12	119	47	11900	9160	-2740	0.39	0.77	21	16	-5
0023	2F	24_2	13	65	19	6500	4180	-2320	0.29	0.64	11	7	-4
0023	2F	24_2	14	30	7	3000	2180	-820	0.23	0.73	5	3	-2
0023	2F	24_2	15	6	0	600	0	-600	0.00	0.00	1	0	-1
0023	2F	24_2	16	5	1	500	120	-380	0.20	0.24	0	0	0
0023	2F	24_2	23	3	0	300	0	-300	0.00	0.00	0	0	0
0023	2F	24_2	24	1	0	100	0	-100	0.00	0.00	0	0	0
0023	2F	24_2	26	2	0	200	0	-200	0.00	0.00	0	0	0
0023	2F	24_3	12	91	27	9100	6120	-2980	0.30	0.67	16	10	-6
0023	2F	24_3	13	55	15	5500	3740	-1760	0.27	0.68	9	6	-3
0023	2F	24_3	14	29	11	2900	2590	-310	0.38	0.89	5	4	-1
0023	2F	24_3	15	8	3	800	830	30	0.38	1.04	1	1	0
0023	2F	24_3	16	11	2	1100	460	-640	0.18	0.42	1	0	-1
0023	2F	24_3	23	1	0	100	0	-100	0.00	0.00	0	0	0
0023	2F	24_3	26	5	1	500	470	-30	0.20	0.94	0	0	0
0023	2F	24_4	12	92	30	9200	7830	-1370	0.33	0.85	16	13	-3
0023	2F	24_4	13	60	19	6000	4350	-1650	0.32	0.73	10	7	-3
0023	2F	24_4	14	27	8	2700	1840	-860	0.30	0.68	4	3	-1
0023	2F	24_4	15	8	4	800	950	150	0.50	1.19	1	1	0
0023	2F	24_4	16	11	5	1100	1330	230	0.45	1.21	1	2	1
0023	2F	24_4	23	2	0	200	0	-200	0.00	0.00	0	0	0
0023	2F	24_4	24	1	1	100	420	320	1.00	4.20	0	0	0
0023	2F	24_4	26	4	1	400	420	20	0.25	1.05	0	0	0
0023	2F	24_5	12	113	55	11300	11140	-160	0.49	0.99	20	19	-1
0023	2F	24_5	13	93	45	9300	9100	-200	0.48	0.98	16	16	0
0023	2F	24_5	14	47	21	4700	3630	-1070	0.45	0.77	8	6	-2
0023	2F	24_5	15	8	3	800	950	150	0.38	1.19	1	1	0
0023	2F	24_5	16	4	2	400	320	-80	0.50	0.80	0	0	0
0023	2F	24_6	12	128	54	12800	11470	-1330	0.42	0.90	22	20	-2
0023	2F	24_6	13	67	30	6700	6090	-610	0.45	0.91	11	10	-1
0023	2F	24_6	14	34	10	3400	2440	-960	0.29	0.72	6	4	-2
0023	2F	24_6	15	8	3	800	840	40	0.38	1.05	1	1	0
0023	2F	24_6	16	9	3	900	660	-240	0.33	0.73	1	1	0
0023	2F	24_6	23	1	0	100	0	-100	0.00	0.00	0	0	0
0023	2F	24_6	26	1	0	100	0	-100	0.00	0.00	0	0	0
0023	2F	24_7	12	68	25	6800	6790	-10	0.37	1.00	12	12	0
0023	2F	24_7	13	61	28	6100	5480	-620	0.46	0.90	10	9	-1
0023	2F	24_7	14	45	22	4500	3820	-680	0.49	0.85	7	6	-1
0023	2F	24_7	15	11	8	1100	1730	630	0.73	1.57	1	3	2
0023	2F	24_7	16	27	8	2700	2810	110	0.30	1.04	4	4	0
0023	2F	24_8	12	101	42	10100	11870	1770	0.42	1.18	17	21	4
0023	2F	24_8	13	68	24	6800	5460	-1340	0.35	0.80	12	9	-3
0023	2F	24_8	14	29	11	2900	2240	-660	0.38	0.77	5	3	-2
0023	2F	24_8	15	4	1	400	170	-230	0.25	0.43	0	0	0
0023	2F	24_8	16	10	1	1000	230	-770	0.10	0.23	1	0	-1
0023	2F	24_8	24	1	1	100	620	520	1.00	6.20	0	1	1
0023	2F	24_9	12	153	54	15300	10370	-4930	0.35	0.68	27	18	-9
0023	2F	24_9	13	67	20	6700	4490	-2210	0.30	0.67	11	7	-4
0023	2F	24_9	14	16	4	1600	1130	-470	0.25	0.71	2	2	0
0023	2F	24_9	15	9	2	900	630	-270	0.22	0.70	1	1	0
0023	2F	24_9	16	7	2	700	330	-370	0.29	0.47	1	0	-1
0023	2F	24_9	23	1	0	100	0	-100	0.00	0.00	0	0	0
0023	2F	24_9	26	1	0	100	0	-100	0.00	0.00	0	0	0
0023	2T	01_1	12	18	1	1800	520	-1280	0.06	0.29	3	0	-3
0023	2T	01_1	13	3	0	300	0	-300	0.00	0.00	0	0	0
0023	2T	01_1	14	89	14	8900	6250	-2650	0.16	0.70	15	11	-4
0023	2T	01_1	24	2	0	200	0	-200	0.00	0.00	0	0	0
0023	2T	01_10	12	184	39	18400	12340	-6060	0.21	0.67	32	21	-11
0023	2T	01_10	13	61	14	6100	4750	-1350	0.23	0.78	10	8	-2
0023	2T	01_10	14	17	1	1700	390	-1310	0.06	0.23	3	0	-3
0023	2T	01_10	15	2	0	200	0	-200	0.00	0.00	0	0	0
0023	2T	01_10	16	1	0	100	0	-100	0.00	0.00	0	0	0
0023	2T	01_10	23	1	0	100	0	-100	0.00	0.00	0	0	0
0023	2T	01_11	12	221	65	22100	18910	-3190	0.29	0.86	39	33	-6
0023	2T	01_11	13	46	12	4600	3880	-720	0.26	0.84	8	6	-2
0023	2T	01_11	14	12	3	1200	1410	210	0.25	1.18	2	2	0
0023	2T	01_12	12	245	55	24500	17960	-6540	0.22	0.73	43	31	-12
0023	2T	01_12	13	25	3	2500	1250	-1250	0.12	0.50	4	2	-2
0023	2T	01_12	14	3	0	300	0	-300	0.00	0.00	0	0	0
0023	2T	01_2	12	66	13	6600	5860	-740	0.20	0.89	11	10	-1
0023	2T	01_2	13	44	10	4400	4490	90	0.23	1.02	7	7	0
0023	2T	01_2	14	25	3	2500	1910	-590	0.12	0.76	4	3	-1
0023	2T	01_2	15	10	1	1000	660	-340	0.10	0.66	1	1	0
0023	2T	01_2	16	5	0	500	0	-500	0.00	0.00	0	0	0
0023	2T	01_2	23	4	0	400	0	-400	0.00	0.00	0	0	0
0023	2T	01_2	24	4	1	400	520	120	0.25	1.30	0	0	0
0023	2T	01_2	25	4	0	400	0	-400	0.00	0.00	0	0	0
0023	2T	01_2	26	6	2	600	1440	840	0.33	2.40	1	2	1
0023	2T	01_3	12	75	8	7500	3410	-4090	0.11	0.45	13	6	-7
0023	2T	01_3	13	59	11	5900	5860	-40	0.19	0.99	10	10	0
0023	2T	01_3	14	17	5	1700	2060	360	0.29	1.21	3	3	0
0023	2T	01_3	15	10	0	1000	0	-1000	0.00	0.00	1	0	-1
0023	2T	01_3	16	8	0	800	0	-800	0.00	0.00	1	0	-1
0023	2T	01_3	23	7	1	700	390	-310	0.14	0.56	1	0	-1
0023	2T	01_3	24	1	0	100	0	-100	0.00	0.00	0	0	0
0023	2T	01_3	25	2	0	200	0	-200	0.00	0.00	0	0	0
0018	3T	03_3	234	1	0	100	0	-100	0.00	0.00	0	0	0
0018	3T	03_3	235	1	0	100	0	-100	0.00	0.00	0	0	0
0018	3T	03_3	245	1	0	100	0	-100	0.00	0.00	0	0	0
0018	3T	03_3	246	1	0	100	0	-100	0.00	0.00	0	0	0
0018	3T	03_4	123	29	5	2900	4790	1890	0.17	1.65	5	8	3
0018	3T	03_4	124	40	2	4000	1570	-2430	0.05	0.39	7	2	-5
0018	3T	03_4	125	31	2	3100	4670	1570	0.06	1.51	5	8	3
0018	3T	03_4	126	15	1	1500	5130	3630	0.07	3.42	2	9	7
0018	3T	03_4	134	25	2	2500	1440	-1060	0.08	0.58	4	2	-2
0018	3T	03_4	135	12	1	1200	1390	190	0.08	1.16	2	2	0
0018	3T	03_4	136	13	1	1300	1130	-170	0.08	0.87	2	2	0
0018	3T	03_4	145	10	0	1000	0	-1000	0.00	0.00	1	0	-1
0018	3T	03_4	146	3	1	300	1160	860	0.33	3.87	0	2	2
0018	3T	03_4	153	1	0	100	0	-100	0.00	0.00	0	0	0
0018	3T	03_4	156	1	0	100	0	-100	0.00	0.00	0	0	0
0018	3T	03_4	234	1	0	100	0	-100	0.00	0.00	0	0	0
0018	3T	03_4	235	1	0	100	0	-100	0.00	0.00	0	0	0
0018	3T	03_4	246	1	0	100	0	-100	0.00	0.00	0	0	0
0018	3T	03_5	123	29	3	2900	1980	-920	0.10	0.68	5	3	-2
0018	3T	03_5	124	30	0	3000	0	-3000	0.00	0.00	5	0	-5
0018	3T	03_5	125	15	1	1500	1380	-120	0.07	0.92	2	2	0
0018	3T	03_5	126	6	1	600	1210	610	0.17	2.02	1	2	1
0018	3T	03_5	134	8	1	800	870	70	0.13	1.09	1	1	0
0018	3T	03_5	135	8	0	800	0	-800	0.00	0.00	1	0	-1
0018	3T	03_5	136	6	0	600	0	-600	0.00	0.00	1	0	-1
0023	2T	01_3	26	6	0	600	0	-600	0.00	0.00	1	0	-1
0018	3T	03_5	142	1	0	100	0	-100	0.00	0.00	0	0	0
0018	3T	03_5	145	3	0	300	0	-300	0.00	0.00	0	0	0
0018	3T	03_5	146	3	0	300	0	-300	0.00	0.00	0	0	0
0018	3T	03_5	156	3	0	300	0	-300	0.00	0.00	0	0	0
0018	3T	03_5	246	1	0	100	0	-100	0.00	0.00	0	0	0
0018	3T	03_7	123	39	3	3900	2970	-930	0.08	0.76	6	5	-1
0018	3T	03_7	124	61	3	6100	3490	-2610	0.05	0.57	10	6	-4
0018	3T	03_7	125	43	5	4300	4750	450	0.12	1.10	7	8	1
0018	3T	03_7	126	30	2	3000	6040	3040	0.07	2.01	5	10	5
0018	3T	03_7	132	2	0	200	0	-200	0.00	0.00	0	0	0
0018	3T	03_7	134	35	1	3500	630	-2870	0.03	0.18	6	1	-5
0018	3T	03_7	135	22	2	2200	1500	-700	0.09	0.68	3	2	-1
0018	3T	03_7	136	19	0	1900	0	-1900	0.00	0.00	3	0	-3
0018	3T	03_7	142	1	0	100	0	-100	0.00	0.00	0	0	0
0018	3T	03_7	145	5	2	500	1980	1480	0.40	3.96	0	3	3
0018	3T	03_7	146	7	0	700	0	-700	0.00	0.00	1	0	-1
0018	3T	03_7	156	7	0	700	0	-700	0.00	0.00	1	0	-1
0018	3T	03_7	216	1	0	100	0	-100	0.00	0.00	0	0	0
0018	3T	03_7	234	1	0	100	0	-100	0.00	0.00	0	0	0
0018	3T	03_7	236	1	0	100	0	-100	0.00	0.00	0	0	0
0018	3T	03_7	256	1	0	100	0	-100	0.00	0.00	0	0	0
0018	3T	04_1	123	24	2	2400	2380	-20	0.08	0.99	4	4	0
0018	3T	04_1	124	81	4	8100	3160	-4940	0.05	0.39	14	5	-9
0018	3T	04_1	125	39	3	3900	4520	620	0.08	1.16	6	8	2
0018	3T	04_1	126	46	4	4600	5880	1280	0.09	1.28	8	10	2
0018	3T	04_1	134	26	3	2600	3610	1010	0.12	1.39	4	6	2
0018	3T	04_1	135	29	1	2900	980	-1920	0.03	0.34	5	1	-4
0018	3T	04_1	136	20	0	2000	0	-2000	0.00	0.00	3	0	-3
0018	3T	04_1	142	1	0	100	0	-100	0.00	0.00	0	0	0
0018	3T	04_1	143	2	0	200	0	-200	0.00	0.00	0	0	0
0018	3T	04_1	145	13	1	1300	2180	880	0.08	1.68	2	3	1
0018	3T	04_1	146	16	1	1600	1740	140	0.06	1.09	2	3	1
0018	3T	04_1	156	3	0	300	0	-300	0.00	0.00	0	0	0
0018	3T	04_1	245	2	0	200	0	-200	0.00	0.00	0	0	0
0018	3T	04_1	246	2	0	200	0	-200	0.00	0.00	0	0	0
0018	3T	04_2	123	38	4	3800	3860	60	0.11	1.02	6	6	0
0018	3T	04_2	124	54	7	5400	11440	6040	0.13	2.12	9	20	11
0018	3T	04_2	125	50	3	5000	6150	1150	0.06	1.23	8	10	2
0018	3T	04_2	126	39	2	3900	1930	-1970	0.05	0.49	6	3	-3
0018	3T	04_2	132	1	0	100	0	-100	0.00	0.00	0	0	0
0018	3T	04_2	134	26	1	2600	730	-1870	0.04	0.28	4	1	-3
0018	3T	04_2	135	31	1	3100	840	-2260	0.03	0.27	5	1	-4
0018	3T	04_2	136	20	1	2000	4540	2540	0.05	2.27	3	8	5
0018	3T	04_2	143	1	0	100	0	-100	0.00	0.00	0	0	0
0018	3T	04_2	145	7	0	700	0	-700	0.00	0.00	1	0	-1
0018	3T	04_2	146	11	1	1100	2080	980	0.09	1.89	1	3	2
0018	3T	04_2	154	1	0	100	0	-100	0.00	0.00	0	0	0
0018	3T	04_2	156	3	0	300	0	-300	0.00	0.00	0	0	0
0018	3T	04_2	215	1	0	100	0	-100	0.00	0.00	0	0	0
0018	3T	04_2	235	1	1	100	400	300	1.00	4.00	0	0	0
0018	3T	04_2	236	2	0	200	0	-200	0.00	0.00	0	0	0
0018	3T	04_3	123	46	4	4600	3440	-1160	0.09	0.75	8	6	-2
0018	3T	04_3	124	69	6	6900	7320	420	0.09	1.06	12	12	0
0018	3T	04_3	125	49	3	4900	6020	1120	0.06	1.23	8	10	2
0018	3T	04_3	126	51	4	5100	5740	640	0.08	1.13	9	10	1
0018	3T	04_3	132	2	0	200	0	-200	0.00	0.00	0	0	0
0018	3T	04_3	134	21	0	2100	0	-2100	0.00	0.00	3	0	-3
0018	3T	04_3	135	27	4	2700	4420	1720	0.15	1.64	4	7	3
0018	3T	04_3	136	32	2	3200	1340	-1860	0.06	0.42	5	2	-3
0018	3T	04_3	145	14	1	1400	740	-660	0.07	0.53	2	1	-1
0018	3T	04_3	146	4	0	400	0	-400	0.00	0.00	0	0	0
0018	3T	04_3	156	4	0	400	0	-400	0.00	0.00	0	0	0
0018	3T	04_3	164	1	0	100	0	-100	0.00	0.00	0	0	0
0018	3T	04_3	216	2	0	200	0	-200	0.00	0.00	0	0	0
0018	3T	04_3	234	2	0	200	0	-200	0.00	0.00	0	0	0
0018	3T	04_3	235	1	0	100	0	-100	0.00	0.00	0	0	0
0018	3T	04_3	236	3	0	300	0	-300	0.00	0.00	0	0	0
0018	3T	04_3	246	1	0	100	0	-100	0.00	0.00	0	0	0
0018	3T	04_4	123	28	2	2800	1340	-1460	0.07	0.48	4	2	-2
0018	3T	04_4	124	70	7	7000	7310	310	0.10	1.04	12	12	0
0018	3T	04_4	125	28	0	2800	0	-2800	0.00	0.00	4	0	-4
0018	3T	04_4	126	20	1	2000	2370	370	0.05	1.19	3	4	1
0018	3T	04_4	132	1	0	100	0	-100	0.00	0.00	0	0	0
0018	3T	04_4	134	25	5	2500	3880	1380	0.20	1.55	4	6	2
0018	3T	04_4	135	19	3	1900	2830	930	0.16	1.49	3	5	2
0018	3T	04_4	136	23	3	2300	8450	6150	0.13	3.67	4	14	10
0018	3T	04_4	145	14	0	1400	0	-1400	0.00	0.00	2	0	-2
0018	3T	04_4	146	5	0	500	0	-500	0.00	0.00	0	0	0
0018	3T	04_4	156	1	0	100	0	-100	0.00	0.00	0	0	0
0018	3T	04_4	214	2	1	200	1250	1050	0.50	6.25	0	2	2
0018	3T	04_4	236	1	0	100	0	-100	0.00	0.00	0	0	0
0018	3T	04_5	123	31	4	3100	2250	-850	0.13	0.73	5	3	-2
0018	3T	04_5	124	52	2	5200	1520	-3680	0.04	0.29	9	2	-7
0018	3T	04_5	125	27	1	2700	720	-1980	0.04	0.27	4	1	-3
0018	3T	04_5	126	31	2	3100	3090	-10	0.06	1.00	5	5	0
0018	3T	04_5	132	1	0	100	0	-100	0.00	0.00	0	0	0
0018	3T	04_5	134	23	0	2300	0	-2300	0.00	0.00	4	0	-4
0018	3T	04_5	135	17	1	1700	2120	420	0.06	1.25	3	3	0
0018	3T	04_5	136	15	1	1500	840	-660	0.07	0.56	2	1	-1
0018	3T	04_5	142	1	0	100	0	-100	0.00	0.00	0	0	0
0018	3T	04_5	145	4	0	400	0	-400	0.00	0.00	0	0	0
0018	3T	04_5	146	7	0	700	0	-700	0.00	0.00	1	0	-1
0018	3T	04_5	156	1	0	100	0	-100	0.00	0.00	0	0	0
0018	3T	04_5	234	1	1	100	2470	2370	1.00	24.70	0	4	4
0018	3T	04_7	123	26	1	2600	360	-2240	0.04	0.14	4	0	-4
0018	3T	04_7	124	72	8	7200	9790	2590	0.11	1.36	12	17	5
0018	3T	04_7	125	48	3	4800	3100	-1700	0.06	0.65	8	5	-3
0018	3T	04_7	126	39	1	3900	3170	-730	0.03	0.81	6	5	-1
0018	3T	04_7	132	1	0	100	0	-100	0.00	0.00	0	0	0
0018	3T	04_7	134	27	1	2700	720	-1980	0.04	0.27	4	1	-3
0018	3T	04_7	135	26	2	2600	1620	-980	0.08	0.62	4	2	-2
0018	3T	04_7	136	13	0	1300	0	-1300	0.00	0.00	2	0	-2
0018	3T	04_7	145	10	0	1000	0	-1000	0.00	0.00	1	0	-1
0018	3T	04_7	146	8	0	800	0	-800	0.00	0.00	1	0	-1
0018	3T	04_7	156	8	0	800	0	-800	0.00	0.00	1	0	-1
0018	3T	04_7	213	1	0	100	0	-100	0.00	0.00	0	0	0
0018	3T	04_7	216	1	0	100	0	-100	0.00	0.00	0	0	0
0018	3T	04_7	234	2	0	200	0	-200	0.00	0.00	0	0	0
0018	3T	04_7	235	3	0	300	0	-300	0.00	0.00	0	0	0
0018	3T	04_7	246	1	0	100	0	-100	0.00	0.00	0	0	0
0018	3T	05_1	123	66	4	6600	4550	-2050	0.06	0.69	11	8	-3
0018	3T	05_1	124	80	6	8000	6720	-1280	0.08	0.84	14	11	-3
0018	3T	05_1	125	54	7	5400	8840	3440	0.13	1.64	9	15	6
0018	3T	05_1	126	50	3	5000	7370	2370	0.06	1.47	8	13	5
0018	3T	05_1	132	1	0	100	0	-100	0.00	0.00	0	0	0
0018	3T	05_1	134	28	2	2800	1710	-1090	0.07	0.61	4	3	-1
0018	3T	05_1	135	34	2	3400	2140	-1260	0.06	0.63	6	3	-3
0018	3T	05_1	136	34	3	3400	4850	1450	0.09	1.43	6	8	2
0018	3T	05_1	142	1	0	100	0	-100	0.00	0.00	0	0	0
0018	3T	05_1	145	11	1	1100	940	-160	0.09	0.85	1	1	0
0018	3T	05_1	146	6	0	600	0	-600	0.00	0.00	1	0	-1
0018	3T	05_1	152	1	0	100	0	-100	0.00	0.00	0	0	0
0018	3T	05_1	156	4	0	400	0	-400	0.00	0.00	0	0	0
0018	3T	05_1	164	1	0	100	0	-100	0.00	0.00	0	0	0
0018	3T	05_1	214	1	0	100	0	-100	0.00	0.00	0	0	0
0018	3T	05_1	215	4	0	400	0	-400	0.00	0.00	0	0	0
0018	3T	05_1	216	2	0	200	0	-200	0.00	0.00	0	0	0
0018	3T	05_1	236	1	0	100	0	-100	0.00	0.00	0	0	0
0018	3T	05_2	123	33	3	3300	2590	-710	0.09	0.78	5	4	-1
0018	3T	05_2	124	77	6	7700	5830	-1870	0.08	0.76	13	10	-3
0018	3T	05_2	125	64	3	6400	2890	-3510	0.05	0.45	11	5	-6
0018	3T	05_2	126	45	3	4500	3290	-1210	0.07	0.73	7	5	-2
0018	3T	05_2	134	16	0	1600	0	-1600	0.00	0.00	2	0	-2
0018	3T	05_2	135	37	4	3700	3650	-50	0.11	0.99	6	6	0
0018	3T	05_2	136	24	3	2400	2410	10	0.13	1.00	4	4	0
0018	3T	05_2	142	1	1	100	700	600	1.00	7.00	0	1	1
0018	3T	05_2	143	2	0	200	0	-200	0.00	0.00	0	0	0
0018	3T	05_2	145	9	0	900	0	-900	0.00	0.00	1	0	-1
0018	3T	05_2	146	5	0	500	0	-500	0.00	0.00	0	0	0
0018	3T	05_2	153	1	0	100	0	-100	0.00	0.00	0	0	0
0018	3T	05_2	156	6	1	600	4690	4090	0.17	7.82	1	8	7
0018	3T	05_2	215	1	0	100	0	-100	0.00	0.00	0	0	0
0018	3T	05_2	216	5	0	500	0	-500	0.00	0.00	0	0	0
0018	3T	05_2	235	1	0	100	0	-100	0.00	0.00	0	0	0
0018	3T	05_2	245	5	0	500	0	-500	0.00	0.00	0	0	0
0018	3T	05_2	246	1	0	100	0	-100	0.00	0.00	0	0	0
0018	3T	05_3	123	45	5	4500	6770	2270	0.11	1.50	7	11	4
0018	3T	05_3	124	64	4	6400	2910	-3490	0.06	0.45	11	5	-6
0018	3T	05_3	125	60	1	6000	990	-5010	0.02	0.17	10	1	-9
0018	3T	05_3	126	46	6	4600	8850	4250	0.13	1.92	8	15	7
0018	3T	05_3	134	16	1	1600	1420	-180	0.06	0.89	2	2	0
0018	3T	05_3	135	35	1	3500	570	-2930	0.03	0.16	6	1	-5
0018	3T	05_3	136	14	1	1400	1340	-60	0.07	0.96	2	2	0
0018	3T	05_3	143	1	0	100	0	-100	0.00	0.00	0	0	0
0018	3T	05_3	145	11	0	1100	0	-1100	0.00	0.00	1	0	-1
0018	3T	05_3	146	15	2	1500	6720	5220	0.13	4.48	2	11	9
0018	3T	05_3	154	1	0	100	0	-100	0.00	0.00	0	0	0
0018	3T	05_3	156	2	0	200	0	-200	0.00	0.00	0	0	0
0018	3T	05_3	214	1	0	100	0	-100	0.00	0.00	0	0	0
0018	3T	05_3	215	2	0	200	0	-200	0.00	0.00	0	0	0
0018	3T	05_3	216	1	0	100	0	-100	0.00	0.00	0	0	0
0018	3T	05_3	234	2	0	200	0	-200	0.00	0.00	0	0	0
0018	3T	05_3	235	1	0	100	0	-100	0.00	0.00	0	0	0
0018	3T	05_3	236	3	0	300	0	-300	0.00	0.00	0	0	0
0018	3T	05_3	245	1	1	100	860	760	1.00	8.60	0	1	1
0018	3T	05_3	246	1	0	100	0	-100	0.00	0.00	0	0	0
0018	3T	05_4	123	44	7	4400	5060	660	0.16	1.15	7	8	1
0018	3T	05_4	124	79	7	7900	9140	1240	0.09	1.16	13	16	3
0018	3T	05_4	125	39	3	3900	2070	-1830	0.08	0.53	6	3	-3
0018	3T	05_4	126	25	1	2500	940	-1560	0.04	0.38	4	1	-3
0018	3T	05_4	134	34	1	3400	550	-2850	0.03	0.16	6	0	-6
0018	3T	05_4	135	24	2	2400	1320	-1080	0.08	0.55	4	2	-2
0018	3T	05_4	136	15	0	1500	0	-1500	0.00	0.00	2	0	-2
0018	3T	05_4	145	8	3	800	3930	3130	0.38	4.91	1	6	5
0018	3T	05_4	146	2	0	200	0	-200	0.00	0.00	0	0	0
0018	3T	05_4	156	7	0	700	0	-700	0.00	0.00	1	0	-1
0018	3T	05_4	214	1	1	100	3350	3250	1.00	33.50	0	5	5
0018	3T	05_4	216	1	0	100	0	-100	0.00	0.00	0	0	0
0018	3T	05_4	234	1	0	100	0	-100	0.00	0.00	0	0	0
0018	3T	05_4	235	3	0	300	0	-300	0.00	0.00	0	0	0
0018	3T	05_4	236	1	1	100	810	710	1.00	8.10	0	1	1
0018	3T	05_5	123	17	0	1700	0	-1700	0.00	0.00	3	0	-3
0018	3T	05_5	124	75	9	7500	7050	-450	0.12	0.94	13	12	-1
0018	3T	05_5	125	37	3	3700	4630	930	0.08	1.25	6	8	2
0018	3T	05_5	126	12	1	1200	780	-420	0.08	0.65	2	1	-1
0018	3T	05_5	134	22	1	2200	1350	-850	0.05	0.61	3	2	-1
0018	3T	05_5	135	23	1	2300	610	-1690	0.04	0.27	4	1	-3
0018	3T	05_5	136	6	1	600	570	-30	0.17	0.95	1	1	0
0018	3T	05_5	143	2	0	200	0	-200	0.00	0.00	0	0	0
0018	3T	05_5	145	12	1	1200	1120	-80	0.08	0.93	2	1	-1
0018	3T	05_5	146	1	0	100	0	-100	0.00	0.00	0	0	0
0018	3T	05_5	156	3	0	300	0	-300	0.00	0.00	0	0	0
0018	3T	05_5	216	3	0	300	0	-300	0.00	0.00	0	0	0
0018	3T	05_5	235	1	0	100	0	-100	0.00	0.00	0	0	0
0018	3T	05_6	123	1	0	100	0	-100	0.00	0.00	0	0	0
0018	3T	05_6	124	1	0	100	0	-100	0.00	0.00	0	0	0
0018	3T	05_6	125	2	0	200	0	-200	0.00	0.00	0	0	0
0018	3T	05_7	123	43	6	4300	3780	-520	0.14	0.88	7	6	-1
0018	3T	05_7	124	102	9	10200	9170	-1030	0.09	0.90	18	16	-2
0018	3T	05_7	125	47	1	4700	2120	-2580	0.02	0.45	8	3	-5
0018	3T	05_7	126	28	1	2800	3000	200	0.04	1.07	4	5	1
0018	3T	05_7	134	29	1	2900	1490	-1410	0.03	0.51	5	2	-3
0018	3T	05_7	135	30	0	3000	0	-3000	0.00	0.00	5	0	-5
0018	3T	05_7	136	24	1	2400	1530	-870	0.04	0.64	4	2	-2
0018	3T	05_7	143	1	0	100	0	-100	0.00	0.00	0	0	0
0018	3T	05_7	145	9	1	900	2210	1310	0.11	2.46	1	3	2
0018	3T	05_7	146	8	0	800	0	-800	0.00	0.00	1	0	-1
0018	3T	05_7	156	2	0	200	0	-200	0.00	0.00	0	0	0
0018	3T	05_7	164	1	0	100	0	-100	0.00	0.00	0	0	0
0018	3T	05_7	216	2	0	200	0	-200	0.00	0.00	0	0	0
0018	3T	05_7	234	2	0	200	0	-200	0.00	0.00	0	0	0
0018	3T	05_7	235	3	0	300	0	-300	0.00	0.00	0	0	0
0018	3T	05_7	236	1	0	100	0	-100	0.00	0.00	0	0	0
0018	3T	05_7	246	1	0	100	0	-100	0.00	0.00	0	0	0
0018	3T	06_1	123	67	8	6700	6140	-560	0.12	0.92	11	10	-1
0018	3T	06_1	124	64	9	6400	8820	2420	0.14	1.38	11	15	4
0018	3T	06_1	125	53	3	5300	5330	30	0.06	1.01	9	9	0
0018	3T	06_1	126	76	2	7600	2680	-4920	0.03	0.35	13	4	-9
0018	3T	06_1	132	3	0	300	0	-300	0.00	0.00	0	0	0
0018	3T	06_1	134	37	3	3700	1860	-1840	0.08	0.50	6	3	-3
0018	3T	06_1	135	28	3	2800	2200	-600	0.11	0.79	4	3	-1
0018	3T	06_1	136	40	2	4000	1620	-2380	0.05	0.41	7	2	-5
0018	3T	06_1	143	1	0	100	0	-100	0.00	0.00	0	0	0
0018	3T	06_1	145	18	0	1800	0	-1800	0.00	0.00	3	0	-3
0018	3T	06_1	146	15	3	1500	5080	3580	0.20	3.39	2	8	6
0018	3T	06_1	156	2	0	200	0	-200	0.00	0.00	0	0	0
0018	3T	06_1	214	1	0	100	0	-100	0.00	0.00	0	0	0
0018	3T	06_1	215	2	1	200	2080	1880	0.50	10.40	0	3	3
0018	3T	06_1	216	5	1	500	4290	3790	0.20	8.58	0	7	7
0018	3T	06_1	235	1	0	100	0	-100	0.00	0.00	0	0	0
0018	3T	06_1	245	1	0	100	0	-100	0.00	0.00	0	0	0
0018	3T	06_1	256	1	0	100	0	-100	0.00	0.00	0	0	0
0018	3T	06_2	123	51	8	5100	7330	2230	0.16	1.44	9	12	3
0018	3T	06_2	124	69	7	6900	5700	-1200	0.10	0.83	12	10	-2
0018	3T	06_2	125	69	5	6900	5450	-1450	0.07	0.79	12	9	-3
0018	3T	06_2	126	64	2	6400	1770	-4630	0.03	0.28	11	3	-8
0018	3T	06_2	132	1	0	100	0	-100	0.00	0.00	0	0	0
0018	3T	06_2	134	36	3	3600	1810	-1790	0.08	0.50	6	3	-3
0018	3T	06_2	135	39	3	3900	3140	-760	0.08	0.81	6	5	-1
0018	3T	06_2	136	32	2	3200	1970	-1230	0.06	0.62	5	3	-2
0018	3T	06_2	142	2	0	200	0	-200	0.00	0.00	0	0	0
0018	3T	06_2	143	4	0	400	0	-400	0.00	0.00	0	0	0
0018	3T	06_2	145	18	1	1800	930	-870	0.06	0.52	3	1	-2
0018	3T	06_2	146	18	2	1800	9140	7340	0.11	5.08	3	16	13
0018	3T	06_2	153	1	0	100	0	-100	0.00	0.00	0	0	0
0018	3T	06_2	156	6	0	600	0	-600	0.00	0.00	1	0	-1
0018	3T	06_2	215	2	0	200	0	-200	0.00	0.00	0	0	0
0018	3T	06_2	216	4	0	400	0	-400	0.00	0.00	0	0	0
0018	3T	06_2	234	2	0	200	0	-200	0.00	0.00	0	0	0
0018	3T	06_2	235	1	0	100	0	-100	0.00	0.00	0	0	0
0018	3T	06_2	246	2	0	200	0	-200	0.00	0.00	0	0	0
0018	3T	06_3	123	35	4	3500	3910	410	0.11	1.12	6	6	0
0018	3T	06_3	124	69	7	6900	4870	-2030	0.10	0.71	12	8	-4
0018	3T	06_3	125	88	4	8800	3920	-4880	0.05	0.45	15	6	-9
0018	3T	06_3	126	58	4	5800	14190	8390	0.07	2.45	10	25	15
0018	3T	06_3	134	19	1	1900	760	-1140	0.05	0.40	3	1	-2
0018	3T	06_3	135	41	1	4100	640	-3460	0.02	0.16	7	1	-6
0018	3T	06_3	136	31	0	3100	0	-3100	0.00	0.00	5	0	-5
0018	3T	06_3	143	5	0	500	0	-500	0.00	0.00	0	0	0
0018	3T	06_3	145	19	3	1900	3700	1800	0.16	1.95	3	6	3
0018	3T	06_3	146	11	1	1100	3000	1900	0.09	2.73	1	5	4
0018	3T	06_3	153	1	0	100	0	-100	0.00	0.00	0	0	0
0018	3T	06_3	156	4	0	400	0	-400	0.00	0.00	0	0	0
0018	3T	06_3	164	2	0	200	0	-200	0.00	0.00	0	0	0
0018	3T	06_3	165	1	1	100	5930	5830	1.00	59.30	0	10	10
0018	3T	06_3	214	2	0	200	0	-200	0.00	0.00	0	0	0
0018	3T	06_3	215	5	0	500	0	-500	0.00	0.00	0	0	0
0018	3T	06_3	216	3	0	300	0	-300	0.00	0.00	0	0	0
0018	3T	06_3	234	1	0	100	0	-100	0.00	0.00	0	0	0
0018	3T	06_3	235	2	1	200	4250	4050	0.50	21.25	0	7	7
0018	3T	06_3	236	3	0	300	0	-300	0.00	0.00	0	0	0
0018	3T	06_3	246	2	0	200	0	-200	0.00	0.00	0	0	0
0018	3T	06_3	256	2	0	200	0	-200	0.00	0.00	0	0	0
0018	3T	06_4	123	46	5	4600	4730	130	0.11	1.03	8	8	0
0018	3T	06_4	124	50	4	5000	2550	-2450	0.08	0.51	8	4	-4
0018	3T	06_4	125	52	2	5200	860	-4340	0.04	0.17	9	1	-8
0018	3T	06_4	126	21	1	2100	1320	-780	0.05	0.63	3	2	-1
0018	3T	06_4	134	32	0	3200	0	-3200	0.00	0.00	5	0	-5
0018	3T	06_4	135	28	0	2800	0	-2800	0.00	0.00	4	0	-4
0018	3T	06_4	136	11	1	1100	2120	1020	0.09	1.93	1	3	2
0018	3T	06_4	145	15	1	1500	740	-760	0.07	0.49	2	1	-1
0018	3T	06_4	146	7	0	700	0	-700	0.00	0.00	1	0	-1
0018	3T	06_4	153	1	0	100	0	-100	0.00	0.00	0	0	0
0018	3T	06_4	215	3	0	300	0	-300	0.00	0.00	0	0	0
0018	3T	06_4	216	4	0	400	0	-400	0.00	0.00	0	0	0
0018	3T	06_4	234	1	0	100	0	-100	0.00	0.00	0	0	0
0018	3T	06_4	235	1	0	100	0	-100	0.00	0.00	0	0	0
0018	3T	06_4	236	1	0	100	0	-100	0.00	0.00	0	0	0
0018	3T	06_4	245	3	0	300	0	-300	0.00	0.00	0	0	0
0018	3T	06_4	246	2	0	200	0	-200	0.00	0.00	0	0	0
0018	3T	06_5	123	27	4	2700	2200	-500	0.15	0.81	4	3	-1
0018	3T	06_5	124	37	3	3700	1720	-1980	0.08	0.46	6	3	-3
0018	3T	06_5	125	27	0	2700	0	-2700	0.00	0.00	4	0	-4
0018	3T	06_5	126	15	3	1500	11480	9980	0.20	7.65	2	20	18
0018	3T	06_5	132	1	0	100	0	-100	0.00	0.00	0	0	0
0018	3T	06_5	134	13	1	1300	470	-830	0.08	0.36	2	0	-2
0018	3T	06_5	135	11	0	1100	0	-1100	0.00	0.00	1	0	-1
0018	3T	06_5	136	9	2	900	2890	1990	0.22	3.21	1	5	4
0018	3T	06_5	143	1	0	100	0	-100	0.00	0.00	0	0	0
0018	3T	06_5	145	4	1	400	1630	1230	0.25	4.08	0	2	2
0018	3T	06_5	146	10	0	1000	0	-1000	0.00	0.00	1	0	-1
0018	3T	06_5	156	3	0	300	0	-300	0.00	0.00	0	0	0
0018	3T	06_5	216	7	0	700	0	-700	0.00	0.00	1	0	-1
0018	3T	06_5	236	1	0	100	0	-100	0.00	0.00	0	0	0
0018	3T	06_5	245	1	0	100	0	-100	0.00	0.00	0	0	0
0018	3T	06_5	246	1	0	100	0	-100	0.00	0.00	0	0	0
0018	3T	06_6	123	7	0	700	0	-700	0.00	0.00	1	0	-1
0018	3T	06_6	124	3	1	300	560	260	0.33	1.87	0	0	0
0018	3T	06_6	125	2	0	200	0	-200	0.00	0.00	0	0	0
0018	3T	06_6	126	2	1	200	9170	8970	0.50	45.85	0	16	16
0018	3T	06_6	134	1	0	100	0	-100	0.00	0.00	0	0	0
0018	3T	06_6	135	4	0	400	0	-400	0.00	0.00	0	0	0
0018	3T	06_6	145	1	0	100	0	-100	0.00	0.00	0	0	0
0018	3T	06_6	146	2	0	200	0	-200	0.00	0.00	0	0	0
0018	3T	06_6	216	2	0	200	0	-200	0.00	0.00	0	0	0
0018	3T	06_7	123	67	6	6700	3150	-3550	0.09	0.47	11	5	-6
0018	3T	06_7	124	81	6	8100	4990	-3110	0.07	0.62	14	8	-6
0018	3T	06_7	125	75	5	7500	5730	-1770	0.07	0.76	13	10	-3
0018	3T	06_7	126	59	5	5900	5030	-870	0.08	0.85	10	8	-2
0018	3T	06_7	134	32	1	3200	620	-2580	0.03	0.19	5	1	-4
0018	3T	06_7	135	41	3	4100	1670	-2430	0.07	0.41	7	2	-5
0018	3T	06_7	136	38	2	3800	1270	-2530	0.05	0.33	6	2	-4
0018	3T	06_7	143	4	1	400	1580	1180	0.25	3.95	0	2	2
0018	3T	06_7	145	28	2	2800	2860	60	0.07	1.02	4	5	1
0018	3T	06_7	146	10	0	1000	0	-1000	0.00	0.00	1	0	-1
0018	3T	06_7	153	1	0	100	0	-100	0.00	0.00	0	0	0
0018	3T	06_7	156	2	0	200	0	-200	0.00	0.00	0	0	0
0018	3T	06_7	164	2	0	200	0	-200	0.00	0.00	0	0	0
0018	3T	06_7	215	2	0	200	0	-200	0.00	0.00	0	0	0
0018	3T	06_7	216	3	0	300	0	-300	0.00	0.00	0	0	0
0018	3T	06_7	235	2	0	200	0	-200	0.00	0.00	0	0	0
0018	3T	06_7	236	1	0	100	0	-100	0.00	0.00	0	0	0
0018	3T	06_7	245	1	0	100	0	-100	0.00	0.00	0	0	0
0018	3T	06_7	246	3	0	300	0	-300	0.00	0.00	0	0	0
0018	3T	07_1	123	36	4	3600	4820	1220	0.11	1.34	6	8	2
0018	3T	07_1	124	86	1	8600	780	-7820	0.01	0.09	15	1	-14
0018	3T	07_1	125	49	4	4900	9390	4490	0.08	1.92	8	16	8
0018	3T	07_1	126	60	3	6000	10300	4300	0.05	1.72	10	18	8
0018	3T	07_1	134	55	10	5500	6140	640	0.18	1.12	9	10	1
0018	3T	07_1	135	33	1	3300	1140	-2160	0.03	0.35	5	2	-3
0018	3T	07_1	136	22	0	2200	0	-2200	0.00	0.00	3	0	-3
0018	3T	07_1	145	19	1	1900	540	-1360	0.05	0.28	3	0	-3
0018	3T	07_1	146	4	0	400	0	-400	0.00	0.00	0	0	0
0018	3T	07_1	152	1	0	100	0	-100	0.00	0.00	0	0	0
0018	3T	07_1	156	7	1	700	1530	830	0.14	2.19	1	2	1
0018	3T	07_1	216	1	0	100	0	-100	0.00	0.00	0	0	0
0018	3T	07_1	235	2	0	200	0	-200	0.00	0.00	0	0	0
0018	3T	07_1	236	5	1	500	1260	760	0.20	2.52	0	2	2
0018	3T	07_2	123	39	6	3900	4420	520	0.15	1.13	6	7	1
0018	3T	07_2	124	78	4	7800	3740	-4060	0.05	0.48	13	6	-7
0018	3T	07_2	125	57	3	5700	4320	-1380	0.05	0.76	10	7	-3
0018	3T	07_2	126	38	4	3800	10230	6430	0.11	2.69	6	18	12
0018	3T	07_2	132	1	0	100	0	-100	0.00	0.00	0	0	0
0018	3T	07_2	134	55	7	5500	3820	-1680	0.13	0.69	9	6	-3
0018	3T	07_2	135	28	1	2800	350	-2450	0.04	0.13	4	0	-4
0018	3T	07_2	136	29	7	2900	8410	5510	0.24	2.90	5	14	9
0018	3T	07_2	143	1	0	100	0	-100	0.00	0.00	0	0	0
0018	3T	07_2	145	22	3	2200	2640	440	0.14	1.20	3	4	1
0018	3T	07_2	146	9	2	900	4300	3400	0.22	4.78	1	7	6
0018	3T	07_2	156	7	2	700	2640	1940	0.29	3.77	1	4	3
0018	3T	07_2	235	1	0	100	0	-100	0.00	0.00	0	0	0
0018	3T	07_2	236	1	0	100	0	-100	0.00	0.00	0	0	0
0018	3T	07_2	245	2	0	200	0	-200	0.00	0.00	0	0	0
0018	3T	07_3	123	50	7	5000	5540	540	0.14	1.11	8	9	1
0018	3T	07_3	124	101	3	10100	1770	-8330	0.03	0.18	17	3	-14
0018	3T	07_3	125	54	4	5400	3870	-1530	0.07	0.72	9	6	-3
0018	3T	07_3	126	41	4	4100	2850	-1250	0.10	0.70	7	5	-2
0018	3T	07_3	134	57	4	5700	2940	-2760	0.07	0.52	10	5	-5
0018	3T	07_3	135	32	2	3200	1530	-1670	0.06	0.48	5	2	-3
0018	3T	07_3	136	19	2	1900	4320	2420	0.11	2.27	3	7	4
0018	3T	07_3	143	1	0	100	0	-100	0.00	0.00	0	0	0
0018	3T	07_3	145	18	1	1800	770	-1030	0.06	0.43	3	1	-2
0018	3T	07_3	146	5	0	500	0	-500	0.00	0.00	0	0	0
0018	3T	07_3	156	4	0	400	0	-400	0.00	0.00	0	0	0
0018	3T	07_3	235	3	0	300	0	-300	0.00	0.00	0	0	0
0018	3T	07_3	236	1	0	100	0	-100	0.00	0.00	0	0	0
0018	3T	07_3	256	2	0	200	0	-200	0.00	0.00	0	0	0
0018	3T	07_4	123	52	8	5200	7420	2220	0.15	1.43	9	13	4
0018	3T	07_4	124	80	12	8000	9640	1640	0.15	1.21	14	17	3
0018	3T	07_4	125	45	3	4500	4670	170	0.07	1.04	7	8	1
0018	3T	07_4	126	30	1	3000	1500	-1500	0.03	0.50	5	2	-3
0018	3T	07_4	132	1	0	100	0	-100	0.00	0.00	0	0	0
0018	3T	07_4	134	51	8	5100	13100	8000	0.16	2.57	9	23	14
0018	3T	07_4	135	28	2	2800	2770	-30	0.07	0.99	4	4	0
0018	3T	07_4	136	18	0	1800	0	-1800	0.00	0.00	3	0	-3
0018	3T	07_4	145	19	3	1900	2590	690	0.16	1.36	3	4	1
0018	3T	07_4	146	6	0	600	0	-600	0.00	0.00	1	0	-1
0018	3T	07_4	154	1	0	100	0	-100	0.00	0.00	0	0	0
0018	3T	07_4	156	3	0	300	0	-300	0.00	0.00	0	0	0
0018	3T	07_4	213	1	0	100	0	-100	0.00	0.00	0	0	0
0018	3T	07_4	214	1	0	100	0	-100	0.00	0.00	0	0	0
0018	3T	07_4	234	1	0	100	0	-100	0.00	0.00	0	0	0
0018	3T	07_4	235	3	0	300	0	-300	0.00	0.00	0	0	0
0018	3T	07_5	123	28	0	2800	0	-2800	0.00	0.00	4	0	-4
0018	3T	07_5	124	73	5	7300	4460	-2840	0.07	0.61	12	7	-5
0018	3T	07_5	125	42	3	4200	3490	-710	0.07	0.83	7	6	-1
0018	3T	07_5	126	27	3	2700	3680	980	0.11	1.36	4	6	2
0018	3T	07_5	134	40	4	4000	2990	-1010	0.10	0.75	7	5	-2
0018	3T	07_5	135	15	1	1500	750	-750	0.07	0.50	2	1	-1
0018	3T	07_5	136	17	2	1700	3770	2070	0.12	2.22	3	6	3
0018	3T	07_5	145	11	1	1100	800	-300	0.09	0.73	1	1	0
0018	3T	07_5	146	9	0	900	0	-900	0.00	0.00	1	0	-1
0018	3T	07_5	154	1	0	100	0	-100	0.00	0.00	0	0	0
0018	3T	07_5	156	2	0	200	0	-200	0.00	0.00	0	0	0
0018	3T	07_5	162	1	0	100	0	-100	0.00	0.00	0	0	0
0018	3T	07_5	235	1	0	100	0	-100	0.00	0.00	0	0	0
0018	3T	07_6	123	4	1	400	680	280	0.25	1.70	0	1	1
0018	3T	07_6	124	9	0	900	0	-900	0.00	0.00	1	0	-1
0018	3T	07_6	125	2	0	200	0	-200	0.00	0.00	0	0	0
0018	3T	07_6	126	7	1	700	1560	860	0.14	2.23	1	2	1
0018	3T	07_6	134	5	1	500	650	150	0.20	1.30	0	1	1
0018	3T	07_6	135	5	0	500	0	-500	0.00	0.00	0	0	0
0018	3T	07_6	136	4	0	400	0	-400	0.00	0.00	0	0	0
0018	3T	07_6	145	4	0	400	0	-400	0.00	0.00	0	0	0
0018	3T	07_6	146	1	0	100	0	-100	0.00	0.00	0	0	0
0018	3T	07_7	123	56	7	5600	5410	-190	0.13	0.97	9	9	0
0018	3T	07_7	124	126	11	12600	7910	-4690	0.09	0.63	22	14	-8
0018	3T	07_7	125	51	5	5100	4460	-640	0.10	0.87	9	7	-2
0018	3T	07_7	126	36	2	3600	3800	200	0.06	1.06	6	6	0
0018	3T	07_7	134	46	6	4600	4460	-140	0.13	0.97	8	7	-1
0018	3T	07_7	135	38	0	3800	0	-3800	0.00	0.00	6	0	-6
0018	3T	07_7	136	20	5	2000	6640	4640	0.25	3.32	3	11	8
0018	3T	07_7	143	1	0	100	0	-100	0.00	0.00	0	0	0
0018	3T	07_7	145	17	2	1700	2160	460	0.12	1.27	3	3	0
0018	3T	07_7	146	7	0	700	0	-700	0.00	0.00	1	0	-1
0018	3T	07_7	152	1	0	100	0	-100	0.00	0.00	0	0	0
0018	3T	07_7	154	1	0	100	0	-100	0.00	0.00	0	0	0
0018	3T	07_7	236	1	0	100	0	-100	0.00	0.00	0	0	0
0018	3T	08_1	123	52	8	5200	5720	520	0.15	1.10	9	10	1
0018	3T	08_1	124	114	13	11400	9690	-1710	0.11	0.85	20	17	-3
0018	3T	08_1	125	52	3	5200	2990	-2210	0.06	0.58	9	5	-4
0018	3T	08_1	126	64	4	6400	5200	-1200	0.06	0.81	11	9	-2
0018	3T	08_1	132	1	0	100	0	-100	0.00	0.00	0	0	0
0018	3T	08_1	134	41	3	4100	2180	-1920	0.07	0.53	7	3	-4
0018	3T	08_1	135	35	3	3500	2150	-1350	0.09	0.61	6	3	-3
0018	3T	08_1	136	46	4	4600	3310	-1290	0.09	0.72	8	5	-3
0018	3T	08_1	143	1	0	100	0	-100	0.00	0.00	0	0	0
0018	3T	08_1	145	16	1	1600	1220	-380	0.06	0.76	2	2	0
0018	3T	08_1	146	11	2	1100	2190	1090	0.18	1.99	1	3	2
0018	3T	08_1	153	1	0	100	0	-100	0.00	0.00	0	0	0
0018	3T	08_1	156	8	0	800	0	-800	0.00	0.00	1	0	-1
0018	3T	08_1	235	1	0	100	0	-100	0.00	0.00	0	0	0
0018	3T	08_1	236	1	0	100	0	-100	0.00	0.00	0	0	0
0018	3T	08_1	246	1	0	100	0	-100	0.00	0.00	0	0	0
0018	3T	08_2	123	59	2	5900	1080	-4820	0.03	0.18	10	1	-9
0018	3T	08_2	124	108	12	10800	10400	-400	0.11	0.96	19	18	-1
0018	3T	08_2	125	53	6	5300	5470	170	0.11	1.03	9	9	0
0018	3T	08_2	126	84	5	8400	4240	-4160	0.06	0.50	14	7	-7
0018	3T	08_2	132	1	0	100	0	-100	0.00	0.00	0	0	0
0018	3T	08_2	134	49	7	4900	4540	-360	0.14	0.93	8	8	0
0018	3T	08_2	135	33	1	3300	910	-2390	0.03	0.28	5	1	-4
0018	3T	08_2	136	38	2	3800	2740	-1060	0.05	0.72	6	4	-2
0018	3T	08_2	142	1	0	100	0	-100	0.00	0.00	0	0	0
0018	3T	08_2	145	18	0	1800	0	-1800	0.00	0.00	3	0	-3
0018	3T	08_2	146	18	2	1800	1740	-60	0.11	0.97	3	3	0
0018	3T	08_2	153	2	1	200	1360	1160	0.50	6.80	0	2	2
0018	3T	08_2	156	9	0	900	0	-900	0.00	0.00	1	0	-1
0018	3T	08_2	165	1	0	100	0	-100	0.00	0.00	0	0	0
0018	3T	08_2	213	1	0	100	0	-100	0.00	0.00	0	0	0
0018	3T	08_2	214	1	0	100	0	-100	0.00	0.00	0	0	0
0018	3T	08_2	235	2	1	200	850	650	0.50	4.25	0	1	1
0018	3T	08_2	236	2	1	200	700	500	0.50	3.50	0	1	1
0018	3T	08_3	123	59	11	5900	5160	-740	0.19	0.87	10	9	-1
0018	3T	08_3	124	124	11	12400	14710	2310	0.09	1.19	21	26	5
0018	3T	08_3	125	90	7	9000	8240	-760	0.08	0.92	15	14	-1
0018	3T	08_3	126	34	5	3400	5720	2320	0.15	1.68	6	10	4
0018	3T	08_3	132	2	0	200	0	-200	0.00	0.00	0	0	0
0018	3T	08_3	134	46	6	4600	4740	140	0.13	1.03	8	8	0
0018	3T	08_3	135	43	3	4300	1800	-2500	0.07	0.42	7	3	-4
0018	3T	08_3	136	13	0	1300	0	-1300	0.00	0.00	2	0	-2
0018	3T	08_3	142	1	0	100	0	-100	0.00	0.00	0	0	0
0018	3T	08_3	145	30	1	3000	580	-2420	0.03	0.19	5	1	-4
0018	3T	08_3	146	8	0	800	0	-800	0.00	0.00	1	0	-1
0018	3T	08_3	152	1	0	100	0	-100	0.00	0.00	0	0	0
0018	3T	08_3	153	1	0	100	0	-100	0.00	0.00	0	0	0
0018	3T	08_3	154	1	0	100	0	-100	0.00	0.00	0	0	0
0018	3T	08_3	156	5	0	500	0	-500	0.00	0.00	0	0	0
0018	3T	08_3	215	1	0	100	0	-100	0.00	0.00	0	0	0
0018	3T	08_3	216	2	0	200	0	-200	0.00	0.00	0	0	0
0018	3T	08_3	234	3	0	300	0	-300	0.00	0.00	0	0	0
0018	3T	08_3	236	2	0	200	0	-200	0.00	0.00	0	0	0
0018	3T	08_3	245	2	0	200	0	-200	0.00	0.00	0	0	0
0018	3T	08_3	246	1	0	100	0	-100	0.00	0.00	0	0	0
0018	3T	08_4	123	21	1	2100	980	-1120	0.05	0.47	3	1	-2
0018	3T	08_4	124	43	3	4300	2010	-2290	0.07	0.47	7	3	-4
0018	3T	08_4	125	29	2	2900	1310	-1590	0.07	0.45	5	2	-3
0018	3T	08_4	126	10	0	1000	0	-1000	0.00	0.00	1	0	-1
0018	3T	08_4	134	16	3	1600	2290	690	0.19	1.43	2	4	2
0018	3T	08_4	135	16	2	1600	2280	680	0.13	1.43	2	4	2
0018	3T	08_4	136	9	2	900	1450	550	0.22	1.61	1	2	1
0018	3T	08_4	145	7	1	700	1910	1210	0.14	2.73	1	3	2
0018	3T	08_4	146	1	0	100	0	-100	0.00	0.00	0	0	0
0018	3T	08_4	156	2	0	200	0	-200	0.00	0.00	0	0	0
0018	3T	08_4	215	1	0	100	0	-100	0.00	0.00	0	0	0
0018	3T	08_4	235	2	0	200	0	-200	0.00	0.00	0	0	0
0018	3T	08_5	123	19	4	1900	1770	-130	0.21	0.93	3	3	0
0018	3T	08_5	124	26	2	2600	1470	-1130	0.08	0.57	4	2	-2
0018	3T	08_5	125	14	0	1400	0	-1400	0.00	0.00	2	0	-2
0018	3T	08_5	126	6	0	600	0	-600	0.00	0.00	1	0	-1
0018	3T	08_5	134	14	0	1400	0	-1400	0.00	0.00	2	0	-2
0018	3T	08_5	135	9	0	900	0	-900	0.00	0.00	1	0	-1
0018	3T	08_5	136	5	1	500	890	390	0.20	1.78	0	1	1
0018	3T	08_5	145	8	0	800	0	-800	0.00	0.00	1	0	-1
0018	3T	08_5	146	1	0	100	0	-100	0.00	0.00	0	0	0
0018	3T	08_5	215	1	0	100	0	-100	0.00	0.00	0	0	0
0018	3T	08_6	123	1	1	100	420	320	1.00	4.20	0	0	0
0018	3T	08_6	124	6	1	600	690	90	0.17	1.15	1	1	0
0018	3T	08_6	125	3	1	300	650	350	0.33	2.17	0	1	1
0018	3T	08_6	126	2	0	200	0	-200	0.00	0.00	0	0	0
0018	3T	08_6	132	1	0	100	0	-100	0.00	0.00	0	0	0
0018	3T	08_6	134	2	1	200	710	510	0.50	3.55	0	1	1
0018	3T	08_6	135	2	0	200	0	-200	0.00	0.00	0	0	0
0018	3T	08_6	136	4	0	400	0	-400	0.00	0.00	0	0	0
0018	3T	08_7	123	79	15	7900	10320	2420	0.19	1.31	13	18	5
0018	3T	08_7	124	130	14	13000	9580	-3420	0.11	0.74	23	16	-7
0018	3T	08_7	125	58	3	5800	3400	-2400	0.05	0.59	10	6	-4
0018	3T	08_7	126	68	3	6800	3940	-2860	0.04	0.58	12	6	-6
0018	3T	08_7	132	2	0	200	0	-200	0.00	0.00	0	0	0
0018	3T	08_7	134	42	4	4200	3310	-890	0.10	0.79	7	5	-2
0018	3T	08_7	135	28	1	2800	1380	-1420	0.04	0.49	4	2	-2
0018	3T	08_7	136	33	1	3300	1020	-2280	0.03	0.31	5	1	-4
0018	3T	08_7	142	1	0	100	0	-100	0.00	0.00	0	0	0
0018	3T	08_7	145	9	0	900	0	-900	0.00	0.00	1	0	-1
0018	3T	08_7	146	13	1	1300	680	-620	0.08	0.52	2	1	-1
0018	3T	08_7	153	1	0	100	0	-100	0.00	0.00	0	0	0
0018	3T	08_7	156	4	0	400	0	-400	0.00	0.00	0	0	0
0018	3T	08_7	214	1	0	100	0	-100	0.00	0.00	0	0	0
0018	3T	08_7	235	2	0	200	0	-200	0.00	0.00	0	0	0
0018	3T	08_7	236	1	0	100	0	-100	0.00	0.00	0	0	0
0018	3T	08_7	245	1	0	100	0	-100	0.00	0.00	0	0	0
0018	3T	08_7	246	2	1	200	1210	1010	0.50	6.05	0	2	2
0018	3T	09_1	123	81	14	8100	7810	-290	0.17	0.96	14	13	-1
0018	3T	09_1	124	134	9	13400	6250	-7150	0.07	0.47	23	11	-12
0018	3T	09_1	125	57	7	5700	5360	-340	0.12	0.94	10	9	-1
0018	3T	09_1	126	26	1	2600	520	-2080	0.04	0.20	4	0	-4
0018	3T	09_1	134	30	4	3000	3180	180	0.13	1.06	5	5	0
0018	3T	09_1	135	29	1	2900	610	-2290	0.03	0.21	5	1	-4
0018	3T	09_1	136	15	3	1500	8630	7130	0.20	5.75	2	15	13
0018	3T	09_1	143	1	0	100	0	-100	0.00	0.00	0	0	0
0018	3T	09_1	145	4	0	400	0	-400	0.00	0.00	0	0	0
0018	3T	09_1	146	5	0	500	0	-500	0.00	0.00	0	0	0
0018	3T	09_1	154	1	0	100	0	-100	0.00	0.00	0	0	0
0018	3T	09_1	156	2	0	200	0	-200	0.00	0.00	0	0	0
0018	3T	09_1	214	2	0	200	0	-200	0.00	0.00	0	0	0
0018	3T	09_1	215	2	0	200	0	-200	0.00	0.00	0	0	0
0018	3T	09_1	216	2	0	200	0	-200	0.00	0.00	0	0	0
0018	3T	09_1	234	2	1	200	1180	980	0.50	5.90	0	2	2
0018	3T	09_1	245	1	0	100	0	-100	0.00	0.00	0	0	0
0018	3T	09_1	246	4	0	400	0	-400	0.00	0.00	0	0	0
0018	3T	09_1	256	1	0	100	0	-100	0.00	0.00	0	0	0
0018	3T	09_1	264	1	0	100	0	-100	0.00	0.00	0	0	0
0018	3T	09_2	123	73	6	7300	3400	-3900	0.08	0.47	12	6	-6
0018	3T	09_2	124	81	6	8100	4840	-3260	0.07	0.60	14	8	-6
0018	3T	09_2	125	54	5	5400	4890	-510	0.09	0.91	9	8	-1
0018	3T	09_2	126	31	0	3100	0	-3100	0.00	0.00	5	0	-5
0018	3T	09_2	134	27	3	2700	2500	-200	0.11	0.93	4	4	0
0018	3T	09_2	135	31	3	3100	3550	450	0.10	1.15	5	6	1
0018	3T	09_2	136	25	1	2500	600	-1900	0.04	0.24	4	1	-3
0018	3T	09_2	143	2	1	200	890	690	0.50	4.45	0	1	1
0018	3T	09_2	145	6	0	600	0	-600	0.00	0.00	1	0	-1
0018	3T	09_2	146	12	0	1200	0	-1200	0.00	0.00	2	0	-2
0018	3T	09_2	153	1	0	100	0	-100	0.00	0.00	0	0	0
0018	3T	09_2	154	1	0	100	0	-100	0.00	0.00	0	0	0
0018	3T	09_2	156	8	0	800	0	-800	0.00	0.00	1	0	-1
0018	3T	09_2	214	2	0	200	0	-200	0.00	0.00	0	0	0
0018	3T	09_2	216	5	0	500	0	-500	0.00	0.00	0	0	0
0018	3T	09_2	234	2	0	200	0	-200	0.00	0.00	0	0	0
0018	3T	09_2	235	1	0	100	0	-100	0.00	0.00	0	0	0
0018	3T	09_2	236	2	0	200	0	-200	0.00	0.00	0	0	0
0018	3T	09_2	245	1	0	100	0	-100	0.00	0.00	0	0	0
0018	3T	09_2	246	2	0	200	0	-200	0.00	0.00	0	0	0
0018	3T	09_3	123	55	8	5500	7030	1530	0.15	1.28	9	12	3
0018	3T	09_3	124	84	9	8400	6290	-2110	0.11	0.75	14	11	-3
0018	3T	09_3	125	53	2	5300	3700	-1600	0.04	0.70	9	6	-3
0018	3T	09_3	126	42	2	4200	8420	4220	0.05	2.00	7	14	7
0018	3T	09_3	134	25	3	2500	1990	-510	0.12	0.80	4	3	-1
0018	3T	09_3	135	37	3	3700	1570	-2130	0.08	0.42	6	2	-4
0018	3T	09_3	136	26	0	2600	0	-2600	0.00	0.00	4	0	-4
0018	3T	09_3	143	1	0	100	0	-100	0.00	0.00	0	0	0
0018	3T	09_3	145	11	1	1100	780	-320	0.09	0.71	1	1	0
0018	3T	09_3	146	5	0	500	0	-500	0.00	0.00	0	0	0
0018	3T	09_3	154	2	0	200	0	-200	0.00	0.00	0	0	0
0018	3T	09_3	156	9	0	900	0	-900	0.00	0.00	1	0	-1
0018	3T	09_3	215	2	0	200	0	-200	0.00	0.00	0	0	0
0018	3T	09_3	216	3	0	300	0	-300	0.00	0.00	0	0	0
0018	3T	09_3	234	3	0	300	0	-300	0.00	0.00	0	0	0
0018	3T	09_3	236	1	0	100	0	-100	0.00	0.00	0	0	0
0018	3T	09_3	246	1	0	100	0	-100	0.00	0.00	0	0	0
0018	3T	09_4	123	41	3	4100	1170	-2930	0.07	0.29	7	2	-5
0018	3T	09_4	124	80	9	8000	7580	-420	0.11	0.95	14	13	-1
0018	3T	09_4	125	59	6	5900	5690	-210	0.10	0.96	10	10	0
0018	3T	09_4	126	36	2	3600	5300	1700	0.06	1.47	6	9	3
0018	3T	09_4	134	21	1	2100	680	-1420	0.05	0.32	3	1	-2
0018	3T	09_4	135	23	2	2300	1180	-1120	0.09	0.51	4	2	-2
0018	3T	09_4	136	16	0	1600	0	-1600	0.00	0.00	2	0	-2
0018	3T	09_4	143	3	1	300	760	460	0.33	2.53	0	1	1
0018	3T	09_4	145	10	0	1000	0	-1000	0.00	0.00	1	0	-1
0018	3T	09_4	146	9	2	900	3010	2110	0.22	3.34	1	5	4
0018	3T	09_4	153	2	0	200	0	-200	0.00	0.00	0	0	0
0018	3T	09_4	156	6	0	600	0	-600	0.00	0.00	1	0	-1
0018	3T	09_4	215	1	0	100	0	-100	0.00	0.00	0	0	0
0018	3T	09_4	216	4	0	400	0	-400	0.00	0.00	0	0	0
0018	3T	09_4	234	1	0	100	0	-100	0.00	0.00	0	0	0
0018	3T	09_4	235	1	0	100	0	-100	0.00	0.00	0	0	0
0018	3T	09_4	236	3	0	300	0	-300	0.00	0.00	0	0	0
0018	3T	09_4	246	2	0	200	0	-200	0.00	0.00	0	0	0
0018	3T	09_5	123	78	15	7800	6850	-950	0.19	0.88	13	12	-1
0018	3T	09_5	124	103	11	10300	7060	-3240	0.11	0.69	18	12	-6
0018	3T	09_5	125	55	5	5500	3930	-1570	0.09	0.71	9	6	-3
0018	3T	09_5	126	29	5	2900	5180	2280	0.17	1.79	5	9	4
0018	3T	09_5	134	33	3	3300	1720	-1580	0.09	0.52	5	3	-2
0018	3T	09_5	135	25	4	2500	4540	2040	0.16	1.82	4	8	4
0018	3T	09_5	136	15	2	1500	1610	110	0.13	1.07	2	2	0
0018	3T	09_5	145	11	1	1100	770	-330	0.09	0.70	1	1	0
0018	3T	09_5	146	7	0	700	0	-700	0.00	0.00	1	0	-1
0018	3T	09_5	156	3	1	300	710	410	0.33	2.37	0	1	1
0018	3T	09_5	164	1	1	100	1980	1880	1.00	19.80	0	3	3
0018	3T	09_5	215	1	0	100	0	-100	0.00	0.00	0	0	0
0018	3T	09_5	235	1	0	100	0	-100	0.00	0.00	0	0	0
0018	3T	09_7	123	77	11	7700	6010	-1690	0.14	0.78	13	10	-3
0018	3T	09_7	124	149	30	14900	20450	5550	0.20	1.37	26	36	10
0018	3T	09_7	125	50	5	5000	3810	-1190	0.10	0.76	8	6	-2
0018	3T	09_7	126	41	2	4100	3030	-1070	0.05	0.74	7	5	-2
0018	3T	09_7	134	33	4	3300	3170	-130	0.12	0.96	5	5	0
0018	3T	09_7	135	29	3	2900	2100	-800	0.10	0.72	5	3	-2
0018	3T	09_7	136	19	1	1900	2790	890	0.05	1.47	3	4	1
0018	3T	09_7	142	1	0	100	0	-100	0.00	0.00	0	0	0
0018	3T	09_7	143	2	0	200	0	-200	0.00	0.00	0	0	0
0018	3T	09_7	145	4	0	400	0	-400	0.00	0.00	0	0	0
0018	3T	09_7	146	11	1	1100	710	-390	0.09	0.65	1	1	0
0018	3T	09_7	156	1	0	100	0	-100	0.00	0.00	0	0	0
0018	3T	09_7	165	1	0	100	0	-100	0.00	0.00	0	0	0
0018	3T	09_7	234	2	0	200	0	-200	0.00	0.00	0	0	0
0018	3T	10_1	123	67	9	6700	4480	-2220	0.13	0.67	11	7	-4
0018	3T	10_1	124	116	18	11600	14210	2610	0.16	1.23	20	25	5
0018	3T	10_1	125	25	1	2500	590	-1910	0.04	0.24	4	1	-3
0018	3T	10_1	126	16	2	1600	3430	1830	0.13	2.14	2	6	4
0018	3T	10_1	134	39	4	3900	5620	1720	0.10	1.44	6	9	3
0018	3T	10_1	135	9	0	900	0	-900	0.00	0.00	1	0	-1
0018	3T	10_1	136	3	0	300	0	-300	0.00	0.00	0	0	0
0018	3T	10_1	143	5	0	500	0	-500	0.00	0.00	0	0	0
0018	3T	10_1	145	3	0	300	0	-300	0.00	0.00	0	0	0
0018	3T	10_1	146	3	0	300	0	-300	0.00	0.00	0	0	0
0018	3T	10_1	153	1	0	100	0	-100	0.00	0.00	0	0	0
0018	3T	10_1	164	3	0	300	0	-300	0.00	0.00	0	0	0
0018	3T	10_1	214	10	0	1000	0	-1000	0.00	0.00	1	0	-1
0018	3T	10_1	215	9	0	900	0	-900	0.00	0.00	1	0	-1
0018	3T	10_1	216	3	0	300	0	-300	0.00	0.00	0	0	0
0018	3T	10_1	235	3	0	300	0	-300	0.00	0.00	0	0	0
0018	3T	10_1	236	3	0	300	0	-300	0.00	0.00	0	0	0
0018	3T	10_1	245	1	0	100	0	-100	0.00	0.00	0	0	0
0018	3T	10_1	264	1	0	100	0	-100	0.00	0.00	0	0	0
0018	3T	10_2	123	66	11	6600	8280	1680	0.17	1.25	11	14	3
0018	3T	10_2	124	61	4	6100	6100	0	0.07	1.00	10	10	0
0018	3T	10_2	125	31	1	3100	790	-2310	0.03	0.25	5	1	-4
0018	3T	10_2	126	13	1	1300	950	-350	0.08	0.73	2	1	-1
0018	3T	10_2	134	37	2	3700	1230	-2470	0.05	0.33	6	2	-4
0018	3T	10_2	135	40	1	4000	780	-3220	0.03	0.20	7	1	-6
0018	3T	10_2	136	15	0	1500	0	-1500	0.00	0.00	2	0	-2
0018	3T	10_2	143	1	0	100	0	-100	0.00	0.00	0	0	0
0018	3T	10_2	145	10	0	1000	0	-1000	0.00	0.00	1	0	-1
0018	3T	10_2	146	1	0	100	0	-100	0.00	0.00	0	0	0
0018	3T	10_2	214	6	0	600	0	-600	0.00	0.00	1	0	-1
0018	3T	10_2	215	7	0	700	0	-700	0.00	0.00	1	0	-1
0018	3T	10_2	216	4	0	400	0	-400	0.00	0.00	0	0	0
0018	3T	10_2	234	1	0	100	0	-100	0.00	0.00	0	0	0
0018	3T	10_2	235	7	1	700	4020	3320	0.14	5.74	1	7	6
0018	3T	10_2	236	3	1	300	1720	1420	0.33	5.73	0	3	3
0018	3T	10_2	245	4	0	400	0	-400	0.00	0.00	0	0	0
0018	3T	10_2	246	1	0	100	0	-100	0.00	0.00	0	0	0
0018	3T	10_2	256	6	0	600	0	-600	0.00	0.00	1	0	-1
0018	3T	10_2	264	3	1	300	900	600	0.33	3.00	0	1	1
0018	3T	10_3	123	55	7	5500	3790	-1710	0.13	0.69	9	6	-3
0018	3T	10_3	124	72	6	7200	5560	-1640	0.08	0.77	12	9	-3
0018	3T	10_3	125	82	6	8200	8450	250	0.07	1.03	14	14	0
0018	3T	10_3	126	14	2	1400	3350	1950	0.14	2.39	2	5	3
0018	3T	10_3	134	17	4	1700	4030	2330	0.24	2.37	3	7	4
0018	3T	10_3	135	52	0	5200	0	-5200	0.00	0.00	9	0	-9
0018	3T	10_3	136	10	0	1000	0	-1000	0.00	0.00	1	0	-1
0018	3T	10_3	143	1	0	100	0	-100	0.00	0.00	0	0	0
0018	3T	10_3	145	29	1	2900	1740	-1160	0.03	0.60	5	3	-2
0018	3T	10_3	156	1	0	100	0	-100	0.00	0.00	0	0	0
0018	3T	10_3	214	2	0	200	0	-200	0.00	0.00	0	0	0
0018	3T	10_3	215	29	2	2900	3250	350	0.07	1.12	5	5	0
0018	3T	10_3	216	5	0	500	0	-500	0.00	0.00	0	0	0
0018	3T	10_3	234	1	0	100	0	-100	0.00	0.00	0	0	0
0018	3T	10_3	235	2	0	200	0	-200	0.00	0.00	0	0	0
0018	3T	10_3	236	4	0	400	0	-400	0.00	0.00	0	0	0
0018	3T	10_3	245	2	0	200	0	-200	0.00	0.00	0	0	0
0018	3T	10_3	265	1	0	100	0	-100	0.00	0.00	0	0	0
0018	3T	10_4	123	58	5	5800	3040	-2760	0.09	0.52	10	5	-5
0018	3T	10_4	124	95	11	9500	8730	-770	0.12	0.92	16	15	-1
0018	3T	10_4	125	45	2	4500	1080	-3420	0.04	0.24	7	1	-6
0018	3T	10_4	126	12	0	1200	0	-1200	0.00	0.00	2	0	-2
0018	3T	10_4	132	2	0	200	0	-200	0.00	0.00	0	0	0
0018	3T	10_4	134	27	0	2700	0	-2700	0.00	0.00	4	0	-4
0018	3T	10_4	135	35	1	3500	830	-2670	0.03	0.24	6	1	-5
0018	3T	10_4	136	17	0	1700	0	-1700	0.00	0.00	3	0	-3
0018	3T	10_4	143	4	0	400	0	-400	0.00	0.00	0	0	0
0018	3T	10_4	145	19	0	1900	0	-1900	0.00	0.00	3	0	-3
0018	3T	10_4	146	4	0	400	0	-400	0.00	0.00	0	0	0
0018	3T	10_4	214	1	0	100	0	-100	0.00	0.00	0	0	0
0018	3T	10_4	215	9	0	900	0	-900	0.00	0.00	1	0	-1
0018	3T	10_4	216	4	0	400	0	-400	0.00	0.00	0	0	0
0018	3T	10_4	235	5	1	500	340	-160	0.20	0.68	0	0	0
0018	3T	10_4	236	3	0	300	0	-300	0.00	0.00	0	0	0
0018	3T	10_4	245	7	0	700	0	-700	0.00	0.00	1	0	-1
0018	3T	10_5	123	55	10	5500	6270	770	0.18	1.14	9	11	2
0018	3T	10_5	124	55	7	5500	5910	410	0.13	1.07	9	10	1
0018	3T	10_5	125	72	5	7200	4310	-2890	0.07	0.60	12	7	-5
0018	3T	10_5	126	9	0	900	0	-900	0.00	0.00	1	0	-1
0018	3T	10_5	132	3	0	300	0	-300	0.00	0.00	0	0	0
0018	3T	10_5	134	20	1	2000	680	-1320	0.05	0.34	3	1	-2
0018	3T	10_5	135	8	0	800	0	-800	0.00	0.00	1	0	-1
0018	3T	10_5	136	3	1	300	1030	730	0.33	3.43	0	1	1
0018	3T	10_5	142	2	0	200	0	-200	0.00	0.00	0	0	0
0018	3T	10_5	143	2	0	200	0	-200	0.00	0.00	0	0	0
0018	3T	10_5	145	22	2	2200	2780	580	0.09	1.26	3	4	1
0018	3T	10_5	146	5	1	500	2130	1630	0.20	4.26	0	3	3
0018	3T	10_5	164	1	0	100	0	-100	0.00	0.00	0	0	0
0018	3T	10_5	214	2	0	200	0	-200	0.00	0.00	0	0	0
0018	3T	10_5	215	11	0	1100	0	-1100	0.00	0.00	1	0	-1
0018	3T	10_5	216	3	0	300	0	-300	0.00	0.00	0	0	0
0018	3T	10_5	236	1	0	100	0	-100	0.00	0.00	0	0	0
0018	3T	10_5	246	2	0	200	0	-200	0.00	0.00	0	0	0
0018	3T	10_6	123	6	0	600	0	-600	0.00	0.00	1	0	-1
0018	3T	10_6	143	4	0	400	0	-400	0.00	0.00	0	0	0
0018	3T	10_7	123	480	48	48000	38740	-9260	0.10	0.81	84	68	-16
0018	3T	10_7	124	23	0	2300	0	-2300	0.00	0.00	4	0	-4
0018	3T	11_1	123	46	2	4600	710	-3890	0.04	0.15	8	1	-7
0018	3T	11_1	124	94	8	9400	10360	960	0.09	1.10	16	18	2
0018	3T	11_1	125	36	2	3600	1070	-2530	0.06	0.30	6	1	-5
0018	3T	11_1	126	38	1	3800	800	-3000	0.03	0.21	6	1	-5
0018	3T	11_1	134	48	4	4800	2760	-2040	0.08	0.58	8	4	-4
0018	3T	11_1	135	34	1	3400	870	-2530	0.03	0.26	6	1	-5
0018	3T	11_1	136	17	1	1700	1890	190	0.06	1.11	3	3	0
0018	3T	11_1	142	1	0	100	0	-100	0.00	0.00	0	0	0
0018	3T	11_1	143	1	0	100	0	-100	0.00	0.00	0	0	0
0018	3T	11_1	145	10	0	1000	0	-1000	0.00	0.00	1	0	-1
0018	3T	11_1	146	6	0	600	0	-600	0.00	0.00	1	0	-1
0018	3T	11_1	156	2	0	200	0	-200	0.00	0.00	0	0	0
0018	3T	11_1	215	3	0	300	0	-300	0.00	0.00	0	0	0
0018	3T	11_1	234	2	0	200	0	-200	0.00	0.00	0	0	0
0018	3T	11_1	235	1	0	100	0	-100	0.00	0.00	0	0	0
0018	3T	11_1	246	1	1	100	3910	3810	1.00	39.10	0	6	6
0018	3T	11_2	123	40	7	4000	3760	-240	0.18	0.94	7	6	-1
0018	3T	11_2	124	77	10	7700	7030	-670	0.13	0.91	13	12	-1
0018	3T	11_2	125	21	0	2100	0	-2100	0.00	0.00	3	0	-3
0018	3T	11_2	126	44	2	4400	2670	-1730	0.05	0.61	7	4	-3
0018	3T	11_2	134	34	10	3400	8090	4690	0.29	2.38	6	14	8
0018	3T	11_2	135	15	1	1500	1030	-470	0.07	0.69	2	1	-1
0018	3T	11_2	136	44	1	4400	750	-3650	0.02	0.17	7	1	-6
0018	3T	11_2	145	7	1	700	440	-260	0.14	0.63	1	0	-1
0018	3T	11_2	146	10	0	1000	0	-1000	0.00	0.00	1	0	-1
0018	3T	11_2	154	1	0	100	0	-100	0.00	0.00	0	0	0
0018	3T	11_2	156	6	0	600	0	-600	0.00	0.00	1	0	-1
0018	3T	11_2	235	1	1	100	1280	1180	1.00	12.80	0	2	2
0018	3T	11_2	236	1	0	100	0	-100	0.00	0.00	0	0	0
0018	3T	11_2	246	1	0	100	0	-100	0.00	0.00	0	0	0
0018	3T	11_2	256	2	0	200	0	-200	0.00	0.00	0	0	0
0018	3T	11_3	123	47	4	4700	4190	-510	0.09	0.89	8	7	-1
0018	3T	11_3	124	71	5	7100	4730	-2370	0.07	0.67	12	8	-4
0018	3T	11_3	125	45	5	4500	5510	1010	0.11	1.22	7	9	2
0018	3T	11_3	126	34	3	3400	4400	1000	0.09	1.29	6	7	1
0018	3T	11_3	134	45	2	4500	960	-3540	0.04	0.21	7	1	-6
0018	3T	11_3	135	21	0	2100	0	-2100	0.00	0.00	3	0	-3
0018	3T	11_3	136	23	0	2300	0	-2300	0.00	0.00	4	0	-4
0018	3T	11_3	143	1	0	100	0	-100	0.00	0.00	0	0	0
0018	3T	11_3	145	10	0	1000	0	-1000	0.00	0.00	1	0	-1
0018	3T	11_3	146	7	0	700	0	-700	0.00	0.00	1	0	-1
0018	3T	11_3	152	1	0	100	0	-100	0.00	0.00	0	0	0
0018	3T	11_3	156	4	0	400	0	-400	0.00	0.00	0	0	0
0018	3T	11_3	234	1	0	100	0	-100	0.00	0.00	0	0	0
0018	3T	11_3	235	3	0	300	0	-300	0.00	0.00	0	0	0
0018	3T	11_3	236	3	0	300	0	-300	0.00	0.00	0	0	0
0018	3T	11_3	245	1	0	100	0	-100	0.00	0.00	0	0	0
0018	3T	11_3	246	1	0	100	0	-100	0.00	0.00	0	0	0
0018	3T	11_3	256	1	0	100	0	-100	0.00	0.00	0	0	0
0018	3T	11_4	123	50	8	5000	5410	410	0.16	1.08	8	9	1
0018	3T	11_4	124	66	4	6600	3620	-2980	0.06	0.55	11	6	-5
0018	3T	11_4	125	47	3	4700	3800	-900	0.06	0.81	8	6	-2
0018	3T	11_4	126	23	0	2300	0	-2300	0.00	0.00	4	0	-4
0018	3T	11_4	134	43	2	4300	1470	-2830	0.05	0.34	7	2	-5
0018	3T	11_4	135	25	1	2500	1530	-970	0.04	0.61	4	2	-2
0018	3T	11_4	136	7	0	700	0	-700	0.00	0.00	1	0	-1
0018	3T	11_4	142	1	0	100	0	-100	0.00	0.00	0	0	0
0018	3T	11_4	145	7	2	700	1570	870	0.29	2.24	1	2	1
0018	3T	11_4	146	6	0	600	0	-600	0.00	0.00	1	0	-1
0018	3T	11_4	156	2	0	200	0	-200	0.00	0.00	0	0	0
0018	3T	11_4	214	1	0	100	0	-100	0.00	0.00	0	0	0
0018	3T	11_4	215	1	0	100	0	-100	0.00	0.00	0	0	0
0018	3T	11_4	234	2	0	200	0	-200	0.00	0.00	0	0	0
0018	3T	11_4	235	4	0	400	0	-400	0.00	0.00	0	0	0
0018	3T	11_4	236	2	0	200	0	-200	0.00	0.00	0	0	0
0018	3T	11_4	245	2	0	200	0	-200	0.00	0.00	0	0	0
0018	3T	11_4	246	1	0	100	0	-100	0.00	0.00	0	0	0
0018	3T	11_4	256	1	0	100	0	-100	0.00	0.00	0	0	0
0018	3T	11_5	123	51	7	5100	4940	-160	0.14	0.97	9	8	-1
0018	3T	11_5	124	90	11	9000	10670	1670	0.12	1.19	15	18	3
0018	3T	11_5	125	25	3	2500	2430	-70	0.12	0.97	4	4	0
0018	3T	11_5	126	19	2	1900	5940	4040	0.11	3.13	3	10	7
0018	3T	11_5	134	36	6	3600	6780	3180	0.17	1.88	6	12	6
0018	3T	11_5	135	10	0	1000	0	-1000	0.00	0.00	1	0	-1
0018	3T	11_5	136	17	1	1700	970	-730	0.06	0.57	3	1	-2
0018	3T	11_5	145	9	0	900	0	-900	0.00	0.00	1	0	-1
0018	3T	11_5	146	6	1	600	970	370	0.17	1.62	1	1	0
0018	3T	11_7	123	74	13	7400	6950	-450	0.18	0.94	13	12	-1
0018	3T	11_7	124	104	8	10400	8700	-1700	0.08	0.84	18	15	-3
0018	3T	11_7	125	53	7	5300	7960	2660	0.13	1.50	9	14	5
0018	3T	11_7	126	34	2	3400	3970	570	0.06	1.17	6	7	1
0018	3T	11_7	132	1	1	100	540	440	1.00	5.40	0	0	0
0018	3T	11_7	134	51	6	5100	6260	1160	0.12	1.23	9	11	2
0018	3T	11_7	135	25	3	2500	1990	-510	0.12	0.80	4	3	-1
0018	3T	11_7	136	19	1	1900	2900	1000	0.05	1.53	3	5	2
0018	3T	11_7	143	2	0	200	0	-200	0.00	0.00	0	0	0
0018	3T	11_7	145	6	0	600	0	-600	0.00	0.00	1	0	-1
0018	3T	11_7	146	7	0	700	0	-700	0.00	0.00	1	0	-1
0018	3T	11_7	156	1	0	100	0	-100	0.00	0.00	0	0	0
0018	3T	11_7	245	1	0	100	0	-100	0.00	0.00	0	0	0
0018	3T	12_1	123	36	5	3600	3130	-470	0.14	0.87	6	5	-1
0018	3T	12_1	124	123	13	12300	13160	860	0.11	1.07	21	23	2
0018	3T	12_1	125	53	4	5300	4990	-310	0.08	0.94	9	8	-1
0018	3T	12_1	126	39	3	3900	3010	-890	0.08	0.77	6	5	-1
0018	3T	12_1	132	1	0	100	0	-100	0.00	0.00	0	0	0
0018	3T	12_1	134	33	1	3300	660	-2640	0.03	0.20	5	1	-4
0018	3T	12_1	135	25	2	2500	1470	-1030	0.08	0.59	4	2	-2
0018	3T	12_1	136	22	2	2200	1110	-1090	0.09	0.50	3	1	-2
0018	3T	12_1	145	11	0	1100	0	-1100	0.00	0.00	1	0	-1
0018	3T	12_1	146	4	0	400	0	-400	0.00	0.00	0	0	0
0018	3T	12_1	156	2	0	200	0	-200	0.00	0.00	0	0	0
0018	3T	12_1	214	2	0	200	0	-200	0.00	0.00	0	0	0
0018	3T	12_1	234	2	1	200	490	290	0.50	2.45	0	0	0
0018	3T	12_1	235	2	0	200	0	-200	0.00	0.00	0	0	0
0018	3T	12_1	236	1	0	100	0	-100	0.00	0.00	0	0	0
0018	3T	12_1	245	1	0	100	0	-100	0.00	0.00	0	0	0
0018	3T	12_1	246	2	0	200	0	-200	0.00	0.00	0	0	0
0018	3T	12_2	123	38	3	3800	1440	-2360	0.08	0.38	6	2	-4
0018	3T	12_2	124	77	5	7700	3410	-4290	0.06	0.44	13	6	-7
0018	3T	12_2	125	65	5	6500	7440	940	0.08	1.14	11	13	2
0018	3T	12_2	126	50	1	5000	510	-4490	0.02	0.10	8	0	-8
0018	3T	12_2	132	1	0	100	0	-100	0.00	0.00	0	0	0
0018	3T	12_2	134	22	2	2200	1500	-700	0.09	0.68	3	2	-1
0018	3T	12_2	135	25	2	2500	1360	-1140	0.08	0.54	4	2	-2
0018	3T	12_2	136	22	2	2200	1240	-960	0.09	0.56	3	2	-1
0018	3T	12_2	145	9	1	900	700	-200	0.11	0.78	1	1	0
0018	3T	12_2	146	12	1	1200	680	-520	0.08	0.57	2	1	-1
0018	3T	12_2	153	1	1	100	1170	1070	1.00	11.70	0	2	2
0018	3T	12_2	154	3	0	300	0	-300	0.00	0.00	0	0	0
0018	3T	12_2	156	3	1	300	1270	970	0.33	4.23	0	2	2
0018	3T	12_2	236	1	0	100	0	-100	0.00	0.00	0	0	0
0018	3T	12_2	246	1	0	100	0	-100	0.00	0.00	0	0	0
0018	3T	12_3	123	39	4	3900	2770	-1130	0.10	0.71	6	4	-2
0018	3T	12_3	124	82	2	8200	1930	-6270	0.02	0.24	14	3	-11
0018	3T	12_3	125	52	5	5200	5820	620	0.10	1.12	9	10	1
0018	3T	12_3	126	38	5	3800	5490	1690	0.13	1.44	6	9	3
0018	3T	12_3	132	1	0	100	0	-100	0.00	0.00	0	0	0
0018	3T	12_3	134	25	0	2500	0	-2500	0.00	0.00	4	0	-4
0018	3T	12_3	135	29	2	2900	1710	-1190	0.07	0.59	5	3	-2
0018	3T	12_3	136	31	2	3100	2220	-880	0.06	0.72	5	3	-2
0018	3T	12_3	145	19	1	1900	1690	-210	0.05	0.89	3	2	-1
0018	3T	12_3	146	9	0	900	0	-900	0.00	0.00	1	0	-1
0018	3T	12_3	154	1	1	100	1770	1670	1.00	17.70	0	3	3
0018	3T	12_3	156	2	0	200	0	-200	0.00	0.00	0	0	0
0018	3T	12_3	213	1	0	100	0	-100	0.00	0.00	0	0	0
0018	3T	12_3	215	2	0	200	0	-200	0.00	0.00	0	0	0
0018	3T	12_3	216	2	0	200	0	-200	0.00	0.00	0	0	0
0018	3T	12_3	234	1	0	100	0	-100	0.00	0.00	0	0	0
0018	3T	12_3	235	1	0	100	0	-100	0.00	0.00	0	0	0
0018	3T	12_3	236	3	1	300	1380	1080	0.33	4.60	0	2	2
0018	3T	12_3	245	1	0	100	0	-100	0.00	0.00	0	0	0
0018	3T	12_4	123	46	9	4600	5250	650	0.20	1.14	8	9	1
0018	3T	12_4	124	82	12	8200	8150	-50	0.15	0.99	14	14	0
0018	3T	12_4	125	55	2	5500	1990	-3510	0.04	0.36	9	3	-6
0018	3T	12_4	126	34	1	3400	750	-2650	0.03	0.22	6	1	-5
0018	3T	12_4	134	19	2	1900	2110	210	0.11	1.11	3	3	0
0018	3T	12_4	135	19	0	1900	0	-1900	0.00	0.00	3	0	-3
0018	3T	12_4	136	13	5	1300	4500	3200	0.38	3.46	2	7	5
0018	3T	12_4	143	2	0	200	0	-200	0.00	0.00	0	0	0
0018	3T	12_4	145	8	2	800	2200	1400	0.25	2.75	1	3	2
0018	3T	12_4	146	7	1	700	730	30	0.14	1.04	1	1	0
0018	3T	12_4	156	2	0	200	0	-200	0.00	0.00	0	0	0
0018	3T	12_4	164	1	0	100	0	-100	0.00	0.00	0	0	0
0018	3T	12_4	213	2	0	200	0	-200	0.00	0.00	0	0	0
0018	3T	12_4	214	2	0	200	0	-200	0.00	0.00	0	0	0
0018	3T	12_4	215	3	0	300	0	-300	0.00	0.00	0	0	0
0018	3T	12_4	234	2	0	200	0	-200	0.00	0.00	0	0	0
0018	3T	12_4	235	3	0	300	0	-300	0.00	0.00	0	0	0
0018	3T	12_4	245	1	0	100	0	-100	0.00	0.00	0	0	0
0018	3T	12_4	246	1	1	100	390	290	1.00	3.90	0	0	0
0018	3T	12_4	256	1	0	100	0	-100	0.00	0.00	0	0	0
0018	3T	12_5	123	38	3	3800	1440	-2360	0.08	0.38	6	2	-4
0018	3T	12_5	124	115	17	11500	12640	1140	0.15	1.10	20	22	2
0018	3T	12_5	125	43	4	4300	3790	-510	0.09	0.88	7	6	-1
0018	3T	12_5	126	25	4	2500	2470	-30	0.16	0.99	4	4	0
0018	3T	12_5	132	2	1	200	790	590	0.50	3.95	0	1	1
0018	3T	12_5	134	21	1	2100	540	-1560	0.05	0.26	3	0	-3
0018	3T	12_5	135	24	1	2400	660	-1740	0.04	0.28	4	1	-3
0018	3T	12_5	136	8	1	800	2480	1680	0.13	3.10	1	4	3
0018	3T	12_5	143	1	0	100	0	-100	0.00	0.00	0	0	0
0018	3T	12_5	145	8	1	800	1000	200	0.13	1.25	1	1	0
0018	3T	12_5	146	2	1	200	1090	890	0.50	5.45	0	1	1
0018	3T	12_5	152	1	0	100	0	-100	0.00	0.00	0	0	0
0018	3T	12_5	153	1	0	100	0	-100	0.00	0.00	0	0	0
0018	3T	12_5	154	1	1	100	960	860	1.00	9.60	0	1	1
0018	3T	12_5	165	1	1	100	1870	1770	1.00	18.70	0	3	3
0018	3T	12_6	123	4	1	400	520	120	0.25	1.30	0	0	0
0018	3T	12_6	124	5	0	500	0	-500	0.00	0.00	0	0	0
0018	3T	12_6	125	5	0	500	0	-500	0.00	0.00	0	0	0
0018	3T	12_6	126	5	0	500	0	-500	0.00	0.00	0	0	0
0018	3T	12_6	134	1	1	100	430	330	1.00	4.30	0	0	0
0018	3T	12_6	135	3	0	300	0	-300	0.00	0.00	0	0	0
0018	3T	12_6	136	2	0	200	0	-200	0.00	0.00	0	0	0
0018	3T	12_7	123	64	7	6400	3990	-2410	0.11	0.62	11	7	-4
0018	3T	12_7	124	116	10	11600	6560	-5040	0.09	0.57	20	11	-9
0018	3T	12_7	125	68	5	6800	4150	-2650	0.07	0.61	12	7	-5
0018	3T	12_7	126	38	5	3800	5820	2020	0.13	1.53	6	10	4
0018	3T	12_7	132	2	0	200	0	-200	0.00	0.00	0	0	0
0018	3T	12_7	134	34	4	3400	3290	-110	0.12	0.97	6	5	-1
0018	3T	12_7	135	29	1	2900	1510	-1390	0.03	0.52	5	2	-3
0018	3T	12_7	136	17	0	1700	0	-1700	0.00	0.00	3	0	-3
0018	3T	12_7	143	1	0	100	0	-100	0.00	0.00	0	0	0
0018	3T	12_7	145	6	0	600	0	-600	0.00	0.00	1	0	-1
0018	3T	12_7	146	3	0	300	0	-300	0.00	0.00	0	0	0
0018	3T	12_7	152	1	0	100	0	-100	0.00	0.00	0	0	0
0018	3T	12_7	214	1	0	100	0	-100	0.00	0.00	0	0	0
0018	3T	12_7	216	1	0	100	0	-100	0.00	0.00	0	0	0
0018	3T	12_7	234	2	0	200	0	-200	0.00	0.00	0	0	0
0018	3T	12_7	235	1	0	100	0	-100	0.00	0.00	0	0	0
0018	3T	12_7	245	2	0	200	0	-200	0.00	0.00	0	0	0
0018	3T	13_1	123	44	4	4400	3310	-1090	0.09	0.75	7	5	-2
0018	3T	13_1	124	119	15	11900	11650	-250	0.13	0.98	21	20	-1
0018	3T	13_1	125	22	1	2200	460	-1740	0.05	0.21	3	0	-3
0018	3T	13_1	126	24	0	2400	0	-2400	0.00	0.00	4	0	-4
0018	3T	13_1	134	77	11	7700	7560	-140	0.14	0.98	13	13	0
0018	3T	13_1	135	15	1	1500	1020	-480	0.07	0.68	2	1	-1
0018	3T	13_1	136	15	0	1500	0	-1500	0.00	0.00	2	0	-2
0018	3T	13_1	143	1	0	100	0	-100	0.00	0.00	0	0	0
0018	3T	13_1	145	16	0	1600	0	-1600	0.00	0.00	2	0	-2
0018	3T	13_1	146	12	0	1200	0	-1200	0.00	0.00	2	0	-2
0018	3T	13_1	156	1	0	100	0	-100	0.00	0.00	0	0	0
0018	3T	13_1	164	1	0	100	0	-100	0.00	0.00	0	0	0
0018	3T	13_1	214	1	0	100	0	-100	0.00	0.00	0	0	0
0018	3T	13_1	216	1	0	100	0	-100	0.00	0.00	0	0	0
0018	3T	13_1	234	2	0	200	0	-200	0.00	0.00	0	0	0
0018	3T	13_1	246	1	0	100	0	-100	0.00	0.00	0	0	0
0018	3T	13_2	123	37	3	3700	3150	-550	0.08	0.85	6	5	-1
0018	3T	13_2	124	53	5	5300	5960	660	0.09	1.12	9	10	1
0018	3T	13_2	125	42	6	4200	11360	7160	0.14	2.70	7	20	13
0018	3T	13_2	126	28	3	2800	2370	-430	0.11	0.85	4	4	0
0018	3T	13_2	134	29	3	2900	2390	-510	0.10	0.82	5	4	-1
0018	3T	13_2	135	21	1	2100	1300	-800	0.05	0.62	3	2	-1
0018	3T	13_2	136	14	2	1400	1600	200	0.14	1.14	2	2	0
0018	3T	13_2	143	1	0	100	0	-100	0.00	0.00	0	0	0
0018	3T	13_2	145	11	1	1100	980	-120	0.09	0.89	1	1	0
0018	3T	13_2	146	11	1	1100	2640	1540	0.09	2.40	1	4	3
0018	3T	13_2	152	1	0	100	0	-100	0.00	0.00	0	0	0
0018	3T	13_2	156	1	0	100	0	-100	0.00	0.00	0	0	0
0018	3T	13_2	165	1	0	100	0	-100	0.00	0.00	0	0	0
0018	3T	13_2	214	1	0	100	0	-100	0.00	0.00	0	0	0
0018	3T	13_2	216	2	0	200	0	-200	0.00	0.00	0	0	0
0018	3T	13_2	245	1	0	100	0	-100	0.00	0.00	0	0	0
0018	3T	13_3	123	33	3	3300	1850	-1450	0.09	0.56	5	3	-2
0018	3T	13_3	124	55	2	5500	2640	-2860	0.04	0.48	9	4	-5
0018	3T	13_3	125	51	4	5100	3870	-1230	0.08	0.76	9	6	-3
0018	3T	13_3	126	56	2	5600	2700	-2900	0.04	0.48	9	4	-5
0018	3T	13_3	134	18	2	1800	1640	-160	0.11	0.91	3	2	-1
0018	3T	13_3	135	30	4	3000	2780	-220	0.13	0.93	5	4	-1
0018	3T	13_3	136	33	2	3300	6430	3130	0.06	1.95	5	11	6
0018	3T	13_3	143	2	1	200	870	670	0.50	4.35	0	1	1
0018	3T	13_3	145	10	1	1000	1800	800	0.10	1.80	1	3	2
0018	3T	13_3	146	7	0	700	0	-700	0.00	0.00	1	0	-1
0018	3T	13_3	154	1	0	100	0	-100	0.00	0.00	0	0	0
0018	3T	13_3	156	7	0	700	0	-700	0.00	0.00	1	0	-1
0018	3T	13_3	164	2	0	200	0	-200	0.00	0.00	0	0	0
0018	3T	13_3	215	2	0	200	0	-200	0.00	0.00	0	0	0
0018	3T	13_3	216	2	0	200	0	-200	0.00	0.00	0	0	0
0018	3T	13_3	235	4	1	400	680	280	0.25	1.70	0	1	1
0018	3T	13_3	236	1	0	100	0	-100	0.00	0.00	0	0	0
0018	3T	13_3	245	4	0	400	0	-400	0.00	0.00	0	0	0
0018	3T	13_3	246	3	0	300	0	-300	0.00	0.00	0	0	0
0018	3T	13_3	256	2	0	200	0	-200	0.00	0.00	0	0	0
0018	3T	13_4	123	38	3	3800	3130	-670	0.08	0.82	6	5	-1
0018	3T	13_4	124	69	6	6900	4140	-2760	0.09	0.60	12	7	-5
0018	3T	13_4	125	55	4	5500	2300	-3200	0.07	0.42	9	4	-5
0018	3T	13_4	126	23	0	2300	0	-2300	0.00	0.00	4	0	-4
0018	3T	13_4	134	27	4	2700	2110	-590	0.15	0.78	4	3	-1
0018	3T	13_4	135	18	2	1800	1440	-360	0.11	0.80	3	2	-1
0018	3T	13_4	136	10	0	1000	0	-1000	0.00	0.00	1	0	-1
0018	3T	13_4	143	3	0	300	0	-300	0.00	0.00	0	0	0
0018	3T	13_4	145	16	1	1600	1170	-430	0.06	0.73	2	2	0
0018	3T	13_4	146	8	1	800	1110	310	0.13	1.39	1	1	0
0018	3T	13_4	156	2	0	200	0	-200	0.00	0.00	0	0	0
0018	3T	13_4	164	1	0	100	0	-100	0.00	0.00	0	0	0
0018	3T	13_4	214	1	0	100	0	-100	0.00	0.00	0	0	0
0018	3T	13_4	215	1	0	100	0	-100	0.00	0.00	0	0	0
0018	3T	13_4	216	1	0	100	0	-100	0.00	0.00	0	0	0
0018	3T	13_4	234	1	0	100	0	-100	0.00	0.00	0	0	0
0018	3T	13_4	235	3	0	300	0	-300	0.00	0.00	0	0	0
0018	3T	13_4	236	3	0	300	0	-300	0.00	0.00	0	0	0
0018	3T	13_4	245	1	0	100	0	-100	0.00	0.00	0	0	0
0018	3T	13_4	246	1	0	100	0	-100	0.00	0.00	0	0	0
0018	3T	13_5	123	40	5	4000	4660	660	0.13	1.17	7	8	1
0018	3T	13_5	124	87	15	8700	8640	-60	0.17	0.99	15	15	0
0018	3T	13_5	125	36	3	3600	2860	-740	0.08	0.79	6	5	-1
0018	3T	13_5	126	31	1	3100	1370	-1730	0.03	0.44	5	2	-3
0018	3T	13_5	134	26	4	2600	3390	790	0.15	1.30	4	6	2
0018	3T	13_5	135	13	0	1300	0	-1300	0.00	0.00	2	0	-2
0018	3T	13_5	136	16	0	1600	0	-1600	0.00	0.00	2	0	-2
0018	3T	13_5	143	2	1	200	1720	1520	0.50	8.60	0	3	3
0018	3T	13_5	145	7	0	700	0	-700	0.00	0.00	1	0	-1
0018	3T	13_5	146	4	0	400	0	-400	0.00	0.00	0	0	0
0018	3T	13_5	153	1	0	100	0	-100	0.00	0.00	0	0	0
0018	3T	13_5	154	1	0	100	0	-100	0.00	0.00	0	0	0
0018	3T	13_5	163	1	0	100	0	-100	0.00	0.00	0	0	0
0018	3T	13_5	164	1	0	100	0	-100	0.00	0.00	0	0	0
0018	3T	13_5	165	1	0	100	0	-100	0.00	0.00	0	0	0
0018	3T	13_5	234	1	0	100	0	-100	0.00	0.00	0	0	0
0018	3T	13_6	123	1	0	100	0	-100	0.00	0.00	0	0	0
0018	3T	13_6	124	10	0	1000	0	-1000	0.00	0.00	1	0	-1
0018	3T	13_6	125	6	1	600	1810	1210	0.17	3.02	1	3	2
0018	3T	13_6	126	4	0	400	0	-400	0.00	0.00	0	0	0
0018	3T	13_6	134	3	0	300	0	-300	0.00	0.00	0	0	0
0018	3T	13_6	135	1	0	100	0	-100	0.00	0.00	0	0	0
0018	3T	13_6	136	1	0	100	0	-100	0.00	0.00	0	0	0
0018	3T	13_6	143	2	0	200	0	-200	0.00	0.00	0	0	0
0018	3T	13_6	146	2	0	200	0	-200	0.00	0.00	0	0	0
0018	3T	13_7	123	46	9	4600	6040	1440	0.20	1.31	8	10	2
0018	3T	13_7	124	86	5	8600	5120	-3480	0.06	0.60	15	9	-6
0018	3T	13_7	125	43	4	4300	3190	-1110	0.09	0.74	7	5	-2
0018	3T	13_7	126	40	3	4000	3580	-420	0.08	0.90	7	6	-1
0018	3T	13_7	134	32	6	3200	8630	5430	0.19	2.70	5	15	10
0018	3T	13_7	135	21	2	2100	2480	380	0.10	1.18	3	4	1
0018	3T	13_7	136	18	1	1800	1520	-280	0.06	0.84	3	2	-1
0018	3T	13_7	143	1	0	100	0	-100	0.00	0.00	0	0	0
0018	3T	13_7	145	5	0	500	0	-500	0.00	0.00	0	0	0
0018	3T	13_7	146	9	0	900	0	-900	0.00	0.00	1	0	-1
0018	3T	13_7	152	1	0	100	0	-100	0.00	0.00	0	0	0
0018	3T	13_7	154	3	0	300	0	-300	0.00	0.00	0	0	0
0018	3T	13_7	156	3	0	300	0	-300	0.00	0.00	0	0	0
0018	3T	13_7	164	1	0	100	0	-100	0.00	0.00	0	0	0
0018	3T	13_7	216	1	0	100	0	-100	0.00	0.00	0	0	0
0018	3T	13_7	236	1	0	100	0	-100	0.00	0.00	0	0	0
0018	3T	13_7	246	3	0	300	0	-300	0.00	0.00	0	0	0
0018	3T	14_1	123	59	8	5900	9020	3120	0.14	1.53	10	15	5
0018	3T	14_1	124	46	5	4600	2880	-1720	0.11	0.63	8	5	-3
0018	3T	14_1	125	81	5	8100	12000	3900	0.06	1.48	14	21	7
0018	3T	14_1	126	31	1	3100	2340	-760	0.03	0.75	5	4	-1
0018	3T	14_1	132	4	1	400	1410	1010	0.25	3.53	0	2	2
0018	3T	14_1	134	15	0	1500	0	-1500	0.00	0.00	2	0	-2
0018	3T	14_1	135	19	2	1900	2860	960	0.11	1.51	3	5	2
0018	3T	14_1	136	14	0	1400	0	-1400	0.00	0.00	2	0	-2
0018	3T	14_1	142	7	0	700	0	-700	0.00	0.00	1	0	-1
0018	3T	14_1	143	6	0	600	0	-600	0.00	0.00	1	0	-1
0018	3T	14_1	145	25	2	2500	2270	-230	0.08	0.91	4	4	0
0018	3T	14_1	146	10	0	1000	0	-1000	0.00	0.00	1	0	-1
0018	3T	14_1	213	1	0	100	0	-100	0.00	0.00	0	0	0
0018	3T	14_1	214	1	0	100	0	-100	0.00	0.00	0	0	0
0018	3T	14_1	215	15	0	1500	0	-1500	0.00	0.00	2	0	-2
0018	3T	14_1	216	5	1	500	6220	5720	0.20	12.44	0	11	11
0018	3T	14_1	234	2	0	200	0	-200	0.00	0.00	0	0	0
0018	3T	14_1	235	1	0	100	0	-100	0.00	0.00	0	0	0
0018	3T	14_1	236	2	0	200	0	-200	0.00	0.00	0	0	0
0018	3T	14_1	245	6	0	600	0	-600	0.00	0.00	1	0	-1
0018	3T	14_1	246	7	0	700	0	-700	0.00	0.00	1	0	-1
0018	3T	14_1	256	1	0	100	0	-100	0.00	0.00	0	0	0
0018	3T	14_2	123	114	6	11400	6560	-4840	0.05	0.58	20	11	-9
0018	3T	14_2	124	68	2	6800	2110	-4690	0.03	0.31	12	3	-9
0018	3T	14_2	125	20	1	2000	750	-1250	0.05	0.38	3	1	-2
0018	3T	14_2	126	28	0	2800	0	-2800	0.00	0.00	4	0	-4
0018	3T	14_2	132	4	0	400	0	-400	0.00	0.00	0	0	0
0018	3T	14_2	134	22	1	2200	910	-1290	0.05	0.41	3	1	-2
0018	3T	14_2	135	6	0	600	0	-600	0.00	0.00	1	0	-1
0018	3T	14_2	136	1	0	100	0	-100	0.00	0.00	0	0	0
0018	3T	14_2	142	4	0	400	0	-400	0.00	0.00	0	0	0
0018	3T	14_2	143	24	1	2400	680	-1720	0.04	0.28	4	1	-3
0018	3T	14_2	145	6	0	600	0	-600	0.00	0.00	1	0	-1
0018	3T	14_2	146	6	1	600	910	310	0.17	1.52	1	1	0
0018	3T	14_2	153	3	0	300	0	-300	0.00	0.00	0	0	0
0018	3T	14_2	154	2	0	200	0	-200	0.00	0.00	0	0	0
0018	3T	14_2	163	1	0	100	0	-100	0.00	0.00	0	0	0
0018	3T	14_2	164	1	0	100	0	-100	0.00	0.00	0	0	0
0018	3T	14_2	213	2	1	200	4260	4060	0.50	21.30	0	7	7
0018	3T	14_2	214	2	0	200	0	-200	0.00	0.00	0	0	0
0018	3T	14_2	215	5	0	500	0	-500	0.00	0.00	0	0	0
0018	3T	14_2	216	4	0	400	0	-400	0.00	0.00	0	0	0
0018	3T	14_2	234	4	0	400	0	-400	0.00	0.00	0	0	0
0018	3T	14_2	236	1	0	100	0	-100	0.00	0.00	0	0	0
0018	3T	14_2	243	3	0	300	0	-300	0.00	0.00	0	0	0
0018	3T	14_2	246	1	0	100	0	-100	0.00	0.00	0	0	0
0018	3T	14_3	123	273	21	27300	27520	220	0.08	1.01	48	48	0
0018	3T	14_3	124	7	1	700	5110	4410	0.14	7.30	1	9	8
0018	3T	14_3	134	4	0	400	0	-400	0.00	0.00	0	0	0
0018	3T	14_3	143	96	4	9600	8770	-830	0.04	0.91	16	15	-1
0018	3T	14_3	243	17	0	1700	0	-1700	0.00	0.00	3	0	-3
0018	3T	14_4	123	56	7	5600	4550	-1050	0.13	0.81	9	8	-1
0018	3T	14_4	124	75	2	7500	1100	-6400	0.03	0.15	13	1	-12
0018	3T	14_4	125	38	4	3800	4160	360	0.11	1.09	6	7	1
0018	3T	14_4	126	19	2	1900	3100	1200	0.11	1.63	3	5	2
0018	3T	14_4	132	1	1	100	870	770	1.00	8.70	0	1	1
0018	3T	14_4	134	26	0	2600	0	-2600	0.00	0.00	4	0	-4
0018	3T	14_4	135	16	1	1600	920	-680	0.06	0.58	2	1	-1
0018	3T	14_4	136	8	1	800	1470	670	0.13	1.84	1	2	1
0018	3T	14_4	143	1	0	100	0	-100	0.00	0.00	0	0	0
0018	3T	14_4	145	7	2	700	2150	1450	0.29	3.07	1	3	2
0018	3T	14_4	146	8	1	800	3950	3150	0.13	4.94	1	6	5
0018	3T	14_4	156	2	0	200	0	-200	0.00	0.00	0	0	0
0018	3T	14_4	214	1	0	100	0	-100	0.00	0.00	0	0	0
0018	3T	14_4	215	2	0	200	0	-200	0.00	0.00	0	0	0
0018	3T	14_4	216	4	0	400	0	-400	0.00	0.00	0	0	0
0018	3T	14_4	234	3	0	300	0	-300	0.00	0.00	0	0	0
0018	3T	14_4	235	8	0	800	0	-800	0.00	0.00	1	0	-1
0018	3T	14_4	236	2	1	200	1660	1460	0.50	8.30	0	2	2
0018	3T	14_4	245	2	0	200	0	-200	0.00	0.00	0	0	0
0018	3T	14_5	123	45	3	4500	4290	-210	0.07	0.95	7	7	0
0018	3T	14_5	124	34	1	3400	470	-2930	0.03	0.14	6	0	-6
0018	3T	14_5	125	22	0	2200	0	-2200	0.00	0.00	3	0	-3
0018	3T	14_5	126	17	1	1700	1090	-610	0.06	0.64	3	1	-2
0018	3T	14_5	132	1	0	100	0	-100	0.00	0.00	0	0	0
0018	3T	14_5	134	11	0	1100	0	-1100	0.00	0.00	1	0	-1
0018	3T	14_5	135	6	0	600	0	-600	0.00	0.00	1	0	-1
0018	3T	14_5	136	5	0	500	0	-500	0.00	0.00	0	0	0
0018	3T	14_5	143	3	0	300	0	-300	0.00	0.00	0	0	0
0018	3T	14_5	145	7	0	700	0	-700	0.00	0.00	1	0	-1
0018	3T	14_5	146	4	0	400	0	-400	0.00	0.00	0	0	0
0018	3T	14_5	153	3	0	300	0	-300	0.00	0.00	0	0	0
0018	3T	14_5	156	3	0	300	0	-300	0.00	0.00	0	0	0
0018	3T	14_5	164	2	0	200	0	-200	0.00	0.00	0	0	0
0018	3T	14_5	214	2	0	200	0	-200	0.00	0.00	0	0	0
0018	3T	14_5	234	1	0	100	0	-100	0.00	0.00	0	0	0
0018	3T	14_5	236	1	0	100	0	-100	0.00	0.00	0	0	0
0018	3T	14_5	256	1	0	100	0	-100	0.00	0.00	0	0	0
0018	3T	14_6	123	4	0	400	0	-400	0.00	0.00	0	0	0
0018	3T	14_6	124	4	0	400	0	-400	0.00	0.00	0	0	0
0018	3T	14_6	125	3	1	300	1370	1070	0.33	4.57	0	2	2
0018	3T	14_6	126	1	0	100	0	-100	0.00	0.00	0	0	0
0018	3T	14_6	134	1	0	100	0	-100	0.00	0.00	0	0	0
0018	3T	14_6	135	1	0	100	0	-100	0.00	0.00	0	0	0
0018	3T	14_6	136	1	0	100	0	-100	0.00	0.00	0	0	0
0018	3T	14_6	145	1	0	100	0	-100	0.00	0.00	0	0	0
0018	3T	14_6	164	1	0	100	0	-100	0.00	0.00	0	0	0
0018	3T	14_7	123	88	5	8800	6560	-2240	0.06	0.75	15	11	-4
0018	3T	14_7	124	81	7	8100	8050	-50	0.09	0.99	14	14	0
0018	3T	14_7	125	53	5	5300	7490	2190	0.09	1.41	9	13	4
0018	3T	14_7	126	29	5	2900	6100	3200	0.17	2.10	5	10	5
0018	3T	14_7	132	1	0	100	0	-100	0.00	0.00	0	0	0
0018	3T	14_7	134	36	2	3600	1710	-1890	0.06	0.48	6	3	-3
0018	3T	14_7	135	15	1	1500	3020	1520	0.07	2.01	2	5	3
0018	3T	14_7	136	6	0	600	0	-600	0.00	0.00	1	0	-1
0018	3T	14_7	143	1	0	100	0	-100	0.00	0.00	0	0	0
0018	3T	14_7	145	15	0	1500	0	-1500	0.00	0.00	2	0	-2
0018	3T	14_7	146	3	0	300	0	-300	0.00	0.00	0	0	0
0018	3T	14_7	153	2	0	200	0	-200	0.00	0.00	0	0	0
0018	3T	14_7	154	2	0	200	0	-200	0.00	0.00	0	0	0
0018	3T	14_7	164	2	0	200	0	-200	0.00	0.00	0	0	0
0018	3T	14_7	165	1	0	100	0	-100	0.00	0.00	0	0	0
0018	3T	14_7	214	1	0	100	0	-100	0.00	0.00	0	0	0
0018	3T	14_7	234	1	0	100	0	-100	0.00	0.00	0	0	0
0018	3T	14_7	235	1	0	100	0	-100	0.00	0.00	0	0	0
0018	3T	14_7	236	1	0	100	0	-100	0.00	0.00	0	0	0
0018	3T	14_7	245	1	0	100	0	-100	0.00	0.00	0	0	0
0018	3T	15_1	123	53	4	5300	3720	-1580	0.08	0.70	9	6	-3
0018	3T	15_1	124	108	8	10800	3980	-6820	0.07	0.37	19	7	-12
0018	3T	15_1	125	52	7	5200	8440	3240	0.13	1.62	9	14	5
0018	3T	15_1	126	48	2	4800	2380	-2420	0.04	0.50	8	4	-4
0018	3T	15_1	134	57	6	5700	3970	-1730	0.11	0.70	10	7	-3
0018	3T	15_1	135	32	3	3200	3330	130	0.09	1.04	5	5	0
0018	3T	15_1	136	29	1	2900	400	-2500	0.03	0.14	5	0	-5
0018	3T	15_1	142	2	0	200	0	-200	0.00	0.00	0	0	0
0018	3T	15_1	143	1	0	100	0	-100	0.00	0.00	0	0	0
0018	3T	15_1	145	6	0	600	0	-600	0.00	0.00	1	0	-1
0018	3T	15_1	146	6	1	600	2470	1870	0.17	4.12	1	4	3
0018	3T	15_1	156	7	0	700	0	-700	0.00	0.00	1	0	-1
0018	3T	15_1	213	1	0	100	0	-100	0.00	0.00	0	0	0
0018	3T	15_1	214	2	0	200	0	-200	0.00	0.00	0	0	0
0018	3T	15_1	216	1	0	100	0	-100	0.00	0.00	0	0	0
0018	3T	15_1	234	1	0	100	0	-100	0.00	0.00	0	0	0
0018	3T	15_1	236	2	0	200	0	-200	0.00	0.00	0	0	0
0018	3T	15_2	123	38	6	3800	5460	1660	0.16	1.44	6	9	3
0018	3T	15_2	124	110	18	11000	9410	-1590	0.16	0.86	19	16	-3
0018	3T	15_2	125	59	9	5900	15210	9310	0.15	2.58	10	26	16
0018	3T	15_2	126	42	1	4200	1090	-3110	0.02	0.26	7	1	-6
0018	3T	15_2	132	1	0	100	0	-100	0.00	0.00	0	0	0
0018	3T	15_2	134	40	4	4000	4610	610	0.10	1.15	7	8	1
0018	3T	15_2	135	27	3	2700	2240	-460	0.11	0.83	4	3	-1
0018	3T	15_2	136	20	1	2000	1200	-800	0.05	0.60	3	2	-1
0018	3T	15_2	142	1	0	100	0	-100	0.00	0.00	0	0	0
0018	3T	15_2	143	1	0	100	0	-100	0.00	0.00	0	0	0
0018	3T	15_2	145	9	0	900	0	-900	0.00	0.00	1	0	-1
0018	3T	15_2	146	9	0	900	0	-900	0.00	0.00	1	0	-1
0018	3T	15_2	152	1	0	100	0	-100	0.00	0.00	0	0	0
0018	3T	15_2	156	4	0	400	0	-400	0.00	0.00	0	0	0
0018	3T	15_2	235	1	0	100	0	-100	0.00	0.00	0	0	0
0018	3T	15_2	236	5	0	500	0	-500	0.00	0.00	0	0	0
0018	3T	15_2	245	1	1	100	2140	2040	1.00	21.40	0	3	3
0018	3T	15_3	123	51	4	5100	2130	-2970	0.08	0.42	9	3	-6
0018	3T	15_3	124	128	13	12800	10460	-2340	0.10	0.82	22	18	-4
0018	3T	15_3	125	51	2	5100	2060	-3040	0.04	0.40	9	3	-6
0018	3T	15_3	126	32	3	3200	2680	-520	0.09	0.84	5	4	-1
0018	3T	15_3	134	41	5	4100	3680	-420	0.12	0.90	7	6	-1
0018	3T	15_3	135	23	2	2300	1990	-310	0.09	0.87	4	3	-1
0018	3T	15_3	136	23	4	2300	4530	2230	0.17	1.97	4	8	4
0018	3T	15_3	145	12	1	1200	590	-610	0.08	0.49	2	1	-1
0018	3T	15_3	146	9	1	900	2740	1840	0.11	3.04	1	4	3
0018	3T	15_3	156	8	2	800	6040	5240	0.25	7.55	1	10	9
0018	3T	15_3	234	1	0	100	0	-100	0.00	0.00	0	0	0
0018	3T	15_3	245	1	0	100	0	-100	0.00	0.00	0	0	0
0018	3T	15_3	256	2	0	200	0	-200	0.00	0.00	0	0	0
0018	3T	15_4	123	52	5	5200	3610	-1590	0.10	0.69	9	6	-3
0018	3T	15_4	124	108	14	10800	9210	-1590	0.13	0.85	19	16	-3
0018	3T	15_4	125	46	1	4600	690	-3910	0.02	0.15	8	1	-7
0018	3T	15_4	126	26	1	2600	660	-1940	0.04	0.25	4	1	-3
0018	3T	15_4	132	1	0	100	0	-100	0.00	0.00	0	0	0
0018	3T	15_4	134	24	6	2400	3880	1480	0.25	1.62	4	6	2
0018	3T	15_4	135	20	1	2000	1190	-810	0.05	0.60	3	2	-1
0018	3T	15_4	136	15	1	1500	990	-510	0.07	0.66	2	1	-1
0018	3T	15_4	143	1	0	100	0	-100	0.00	0.00	0	0	0
0018	3T	15_4	145	8	0	800	0	-800	0.00	0.00	1	0	-1
0018	3T	15_4	146	6	0	600	0	-600	0.00	0.00	1	0	-1
0018	3T	15_4	152	1	0	100	0	-100	0.00	0.00	0	0	0
0018	3T	15_4	156	6	0	600	0	-600	0.00	0.00	1	0	-1
0018	3T	15_4	235	2	1	200	1340	1140	0.50	6.70	0	2	2
0018	3T	15_4	236	3	0	300	0	-300	0.00	0.00	0	0	0
0018	3T	15_5	123	38	5	3800	2820	-980	0.13	0.74	6	4	-2
0018	3T	15_5	124	111	8	11100	4870	-6230	0.07	0.44	19	8	-11
0018	3T	15_5	125	29	1	2900	1240	-1660	0.03	0.43	5	2	-3
0018	3T	15_5	126	24	0	2400	0	-2400	0.00	0.00	4	0	-4
0018	3T	15_5	132	1	0	100	0	-100	0.00	0.00	0	0	0
0018	3T	15_5	134	26	2	2600	1300	-1300	0.08	0.50	4	2	-2
0018	3T	15_5	135	14	0	1400	0	-1400	0.00	0.00	2	0	-2
0018	3T	15_5	136	15	1	1500	960	-540	0.07	0.64	2	1	-1
0018	3T	15_5	142	1	0	100	0	-100	0.00	0.00	0	0	0
0018	3T	15_5	145	4	1	400	1180	780	0.25	2.95	0	2	2
0018	3T	15_5	146	2	0	200	0	-200	0.00	0.00	0	0	0
0018	3T	15_5	156	4	1	400	1370	970	0.25	3.43	0	2	2
0018	3T	15_5	216	1	0	100	0	-100	0.00	0.00	0	0	0
0018	3T	15_5	236	1	0	100	0	-100	0.00	0.00	0	0	0
0018	3T	15_5	256	1	0	100	0	-100	0.00	0.00	0	0	0
0018	3T	15_6	123	7	0	700	0	-700	0.00	0.00	1	0	-1
0018	3T	15_6	124	22	3	2200	1730	-470	0.14	0.79	3	3	0
0018	3T	15_6	125	4	0	400	0	-400	0.00	0.00	0	0	0
0018	3T	15_6	126	5	0	500	0	-500	0.00	0.00	0	0	0
0018	3T	15_6	134	2	0	200	0	-200	0.00	0.00	0	0	0
0018	3T	15_6	135	5	0	500	0	-500	0.00	0.00	0	0	0
0018	3T	15_6	136	2	1	200	870	670	0.50	4.35	0	1	1
0018	3T	15_6	143	1	0	100	0	-100	0.00	0.00	0	0	0
0018	3T	15_6	146	1	1	100	1750	1650	1.00	17.50	0	3	3
0018	3T	15_6	156	3	0	300	0	-300	0.00	0.00	0	0	0
0018	3T	15_7	123	58	9	5800	6680	880	0.16	1.15	10	11	1
0018	3T	15_7	124	147	15	14700	9080	-5620	0.10	0.62	26	16	-10
0018	3T	15_7	125	59	2	5900	1510	-4390	0.03	0.26	10	2	-8
0018	3T	15_7	126	50	4	5000	5130	130	0.08	1.03	8	9	1
0018	3T	15_7	132	3	0	300	0	-300	0.00	0.00	0	0	0
0018	3T	15_7	134	45	2	4500	2100	-2400	0.04	0.47	7	3	-4
0018	3T	15_7	135	23	0	2300	0	-2300	0.00	0.00	4	0	-4
0018	3T	15_7	136	31	3	3100	2800	-300	0.10	0.90	5	4	-1
0018	3T	15_7	145	6	0	600	0	-600	0.00	0.00	1	0	-1
0018	3T	15_7	146	5	0	500	0	-500	0.00	0.00	0	0	0
0018	3T	15_7	153	1	0	100	0	-100	0.00	0.00	0	0	0
0018	3T	15_7	156	3	0	300	0	-300	0.00	0.00	0	0	0
0018	3T	15_7	236	1	0	100	0	-100	0.00	0.00	0	0	0
0018	3T	15_7	246	1	0	100	0	-100	0.00	0.00	0	0	0
0018	3T	16_1	123	61	10	6100	4770	-1330	0.16	0.78	10	8	-2
0018	3T	16_1	124	152	16	15200	15010	-190	0.11	0.99	26	26	0
0018	3T	16_1	125	67	5	6700	5460	-1240	0.07	0.81	11	9	-2
0018	3T	16_1	126	41	4	4100	4600	500	0.10	1.12	7	8	1
0018	3T	16_1	134	29	1	2900	1010	-1890	0.03	0.35	5	1	-4
0018	3T	16_1	135	16	0	1600	0	-1600	0.00	0.00	2	0	-2
0018	3T	16_1	136	28	1	2800	1170	-1630	0.04	0.42	4	2	-2
0018	3T	16_1	143	4	1	400	1290	890	0.25	3.23	0	2	2
0018	3T	16_1	145	10	1	1000	550	-450	0.10	0.55	1	0	-1
0018	3T	16_1	146	6	1	600	610	10	0.17	1.02	1	1	0
0018	3T	16_1	154	1	1	100	1490	1390	1.00	14.90	0	2	2
0018	3T	16_1	156	3	0	300	0	-300	0.00	0.00	0	0	0
0018	3T	16_1	164	1	0	100	0	-100	0.00	0.00	0	0	0
0018	3T	16_1	213	1	0	100	0	-100	0.00	0.00	0	0	0
0018	3T	16_1	215	1	0	100	0	-100	0.00	0.00	0	0	0
0018	3T	16_1	216	2	0	200	0	-200	0.00	0.00	0	0	0
0018	3T	16_2	123	51	9	5100	5040	-60	0.18	0.99	9	8	-1
0018	3T	16_2	124	79	8	7900	7710	-190	0.10	0.98	13	13	0
0018	3T	16_2	125	42	3	4200	2400	-1800	0.07	0.57	7	4	-3
0018	3T	16_2	126	44	5	4400	8700	4300	0.11	1.98	7	15	8
0018	3T	16_2	132	2	0	200	0	-200	0.00	0.00	0	0	0
0018	3T	16_2	134	30	1	3000	550	-2450	0.03	0.18	5	0	-5
0018	3T	16_2	135	23	2	2300	1840	-460	0.09	0.80	4	3	-1
0018	3T	16_2	136	18	0	1800	0	-1800	0.00	0.00	3	0	-3
0018	3T	16_2	142	2	1	200	1910	1710	0.50	9.55	0	3	3
0018	3T	16_2	145	14	1	1400	1380	-20	0.07	0.99	2	2	0
0018	3T	16_2	146	4	0	400	0	-400	0.00	0.00	0	0	0
0018	3T	16_2	152	1	0	100	0	-100	0.00	0.00	0	0	0
0018	3T	16_2	154	1	0	100	0	-100	0.00	0.00	0	0	0
0018	3T	16_2	156	4	1	400	760	360	0.25	1.90	0	1	1
0018	3T	16_2	214	1	0	100	0	-100	0.00	0.00	0	0	0
0018	3T	16_2	234	1	0	100	0	-100	0.00	0.00	0	0	0
0018	3T	16_2	236	2	1	200	610	410	0.50	3.05	0	1	1
0018	3T	16_2	245	2	0	200	0	-200	0.00	0.00	0	0	0
0018	3T	16_2	256	3	0	300	0	-300	0.00	0.00	0	0	0
0018	3T	16_3	123	57	9	5700	5730	30	0.16	1.01	10	10	0
0018	3T	16_3	124	73	9	7300	7170	-130	0.12	0.98	12	12	0
0018	3T	16_3	125	46	6	4600	4220	-380	0.13	0.92	8	7	-1
0018	3T	16_3	126	40	4	4000	5620	1620	0.10	1.41	7	9	2
0018	3T	16_3	132	1	0	100	0	-100	0.00	0.00	0	0	0
0018	3T	16_3	134	22	4	2200	3330	1130	0.18	1.51	3	5	2
0018	3T	16_3	135	21	2	2100	1310	-790	0.10	0.62	3	2	-1
0018	3T	16_3	136	31	0	3100	0	-3100	0.00	0.00	5	0	-5
0018	3T	16_3	142	2	0	200	0	-200	0.00	0.00	0	0	0
0018	3T	16_3	143	1	0	100	0	-100	0.00	0.00	0	0	0
0018	3T	16_3	145	14	1	1400	800	-600	0.07	0.57	2	1	-1
0018	3T	16_3	146	5	0	500	0	-500	0.00	0.00	0	0	0
0018	3T	16_3	156	14	0	1400	0	-1400	0.00	0.00	2	0	-2
0018	3T	16_3	214	1	0	100	0	-100	0.00	0.00	0	0	0
0018	3T	16_3	216	2	0	200	0	-200	0.00	0.00	0	0	0
0018	3T	16_3	235	4	0	400	0	-400	0.00	0.00	0	0	0
0018	3T	16_3	245	1	0	100	0	-100	0.00	0.00	0	0	0
0018	3T	16_4	123	71	11	7100	5100	-2000	0.15	0.72	12	9	-3
0018	3T	16_4	124	83	8	8300	9080	780	0.10	1.09	14	16	2
0018	3T	16_4	125	53	3	5300	4920	-380	0.06	0.93	9	8	-1
0018	3T	16_4	126	26	3	2600	1860	-740	0.12	0.72	4	3	-1
0018	3T	16_4	132	2	1	200	350	150	0.50	1.75	0	0	0
0018	3T	16_4	134	28	2	2800	1360	-1440	0.07	0.49	4	2	-2
0018	3T	16_4	135	14	1	1400	1060	-340	0.07	0.76	2	1	-1
0018	3T	16_4	136	10	0	1000	0	-1000	0.00	0.00	1	0	-1
0018	3T	16_4	145	7	1	700	500	-200	0.14	0.71	1	0	-1
0018	3T	16_4	146	6	2	600	3830	3230	0.33	6.38	1	6	5
0018	3T	16_4	156	3	0	300	0	-300	0.00	0.00	0	0	0
0018	3T	16_4	215	1	0	100	0	-100	0.00	0.00	0	0	0
0018	3T	16_4	216	1	0	100	0	-100	0.00	0.00	0	0	0
0018	3T	16_4	235	1	0	100	0	-100	0.00	0.00	0	0	0
0018	3T	16_4	236	2	1	200	1970	1770	0.50	9.85	0	3	3
0018	3T	16_4	246	2	0	200	0	-200	0.00	0.00	0	0	0
0018	3T	16_4	256	3	0	300	0	-300	0.00	0.00	0	0	0
0018	3T	16_5	123	51	6	5100	2790	-2310	0.12	0.55	9	4	-5
0018	3T	16_5	124	111	11	11100	7920	-3180	0.10	0.71	19	14	-5
0018	3T	16_5	125	39	2	3900	1290	-2610	0.05	0.33	6	2	-4
0018	3T	16_5	126	22	1	2200	2540	340	0.05	1.15	3	4	1
0018	3T	16_5	134	19	1	1900	400	-1500	0.05	0.21	3	0	-3
0018	3T	16_5	135	20	1	2000	590	-1410	0.05	0.30	3	1	-2
0018	3T	16_5	136	12	1	1200	1580	380	0.08	1.32	2	2	0
0018	3T	16_5	142	1	0	100	0	-100	0.00	0.00	0	0	0
0018	3T	16_5	143	1	0	100	0	-100	0.00	0.00	0	0	0
0018	3T	16_5	145	17	0	1700	0	-1700	0.00	0.00	3	0	-3
0018	3T	16_5	146	11	0	1100	0	-1100	0.00	0.00	1	0	-1
0018	3T	16_5	156	4	0	400	0	-400	0.00	0.00	0	0	0
0018	3T	16_5	214	1	0	100	0	-100	0.00	0.00	0	0	0
0018	3T	16_5	234	1	0	100	0	-100	0.00	0.00	0	0	0
0018	3T	16_7	123	70	14	7000	7720	720	0.20	1.10	12	13	1
0018	3T	16_7	124	139	13	13900	9130	-4770	0.09	0.66	24	16	-8
0018	3T	16_7	125	47	2	4700	1070	-3630	0.04	0.23	8	1	-7
0018	3T	16_7	126	43	6	4300	5970	1670	0.14	1.39	7	10	3
0018	3T	16_7	132	1	0	100	0	-100	0.00	0.00	0	0	0
0018	3T	16_7	134	39	0	3900	0	-3900	0.00	0.00	6	0	-6
0018	3T	16_7	135	17	0	1700	0	-1700	0.00	0.00	3	0	-3
0018	3T	16_7	136	21	2	2100	1620	-480	0.10	0.77	3	2	-1
0018	3T	16_7	142	2	0	200	0	-200	0.00	0.00	0	0	0
0018	3T	16_7	143	1	0	100	0	-100	0.00	0.00	0	0	0
0018	3T	16_7	145	8	0	800	0	-800	0.00	0.00	1	0	-1
0018	3T	16_7	146	9	1	900	850	-50	0.11	0.94	1	1	0
0018	3T	16_7	152	1	0	100	0	-100	0.00	0.00	0	0	0
0018	3T	16_7	156	3	0	300	0	-300	0.00	0.00	0	0	0
0018	3T	17_1	123	71	12	7100	7210	110	0.17	1.02	12	12	0
0018	3T	17_1	124	110	9	11000	7690	-3310	0.08	0.70	19	13	-6
0018	3T	17_1	125	36	2	3600	2490	-1110	0.06	0.69	6	4	-2
0018	3T	17_1	126	35	0	3500	0	-3500	0.00	0.00	6	0	-6
0018	3T	17_1	134	35	4	3500	5390	1890	0.11	1.54	6	9	3
0018	3T	17_1	135	37	2	3700	1550	-2150	0.05	0.42	6	2	-4
0018	3T	17_1	136	14	1	1400	630	-770	0.07	0.45	2	1	-1
0018	3T	17_1	143	1	0	100	0	-100	0.00	0.00	0	0	0
0018	3T	17_1	145	18	0	1800	0	-1800	0.00	0.00	3	0	-3
0018	3T	17_1	146	5	1	500	1470	970	0.20	2.94	0	2	2
0018	3T	17_1	156	3	0	300	0	-300	0.00	0.00	0	0	0
0018	3T	17_1	214	2	0	200	0	-200	0.00	0.00	0	0	0
0018	3T	17_1	215	1	0	100	0	-100	0.00	0.00	0	0	0
0018	3T	17_1	235	3	1	300	2190	1890	0.33	7.30	0	3	3
0018	3T	17_1	236	1	0	100	0	-100	0.00	0.00	0	0	0
0018	3T	17_1	245	1	0	100	0	-100	0.00	0.00	0	0	0
0018	3T	17_1	246	1	0	100	0	-100	0.00	0.00	0	0	0
0018	3T	17_1	256	2	0	200	0	-200	0.00	0.00	0	0	0
0018	3T	17_2	123	53	6	5300	3750	-1550	0.11	0.71	9	6	-3
0018	3T	17_2	124	99	10	9900	9200	-700	0.10	0.93	17	16	-1
0018	3T	17_2	125	48	5	4800	3790	-1010	0.10	0.79	8	6	-2
0018	3T	17_2	126	47	5	4700	7020	2320	0.11	1.49	8	12	4
0018	3T	17_2	132	1	0	100	0	-100	0.00	0.00	0	0	0
0018	3T	17_2	134	47	6	4700	4880	180	0.13	1.04	8	8	0
0018	3T	17_2	135	19	1	1900	1300	-600	0.05	0.68	3	2	-1
0018	3T	17_2	136	26	1	2600	1090	-1510	0.04	0.42	4	1	-3
0018	3T	17_2	143	1	0	100	0	-100	0.00	0.00	0	0	0
0018	3T	17_2	145	7	0	700	0	-700	0.00	0.00	1	0	-1
0018	3T	17_2	146	7	0	700	0	-700	0.00	0.00	1	0	-1
0018	3T	17_2	153	1	0	100	0	-100	0.00	0.00	0	0	0
0018	3T	17_2	156	4	0	400	0	-400	0.00	0.00	0	0	0
0018	3T	17_2	164	1	0	100	0	-100	0.00	0.00	0	0	0
0018	3T	17_2	213	1	0	100	0	-100	0.00	0.00	0	0	0
0018	3T	17_2	214	1	0	100	0	-100	0.00	0.00	0	0	0
0018	3T	17_2	215	2	0	200	0	-200	0.00	0.00	0	0	0
0018	3T	17_2	216	1	0	100	0	-100	0.00	0.00	0	0	0
0018	3T	17_2	234	1	0	100	0	-100	0.00	0.00	0	0	0
0018	3T	17_2	235	2	0	200	0	-200	0.00	0.00	0	0	0
0018	3T	17_2	236	3	0	300	0	-300	0.00	0.00	0	0	0
0018	3T	17_2	245	1	0	100	0	-100	0.00	0.00	0	0	0
0018	3T	17_2	246	1	0	100	0	-100	0.00	0.00	0	0	0
0018	3T	17_2	256	1	0	100	0	-100	0.00	0.00	0	0	0
0018	3T	17_3	123	49	7	4900	3510	-1390	0.14	0.72	8	6	-2
0018	3T	17_3	124	103	9	10300	6600	-3700	0.09	0.64	18	11	-7
0018	3T	17_3	125	59	3	5900	2390	-3510	0.05	0.41	10	4	-6
0018	3T	17_3	126	49	2	4900	3550	-1350	0.04	0.72	8	6	-2
0018	3T	17_3	134	45	3	4500	3630	-870	0.07	0.81	7	6	-1
0018	3T	17_3	135	24	0	2400	0	-2400	0.00	0.00	4	0	-4
0018	3T	17_3	136	18	1	1800	970	-830	0.06	0.54	3	1	-2
0018	3T	17_3	145	8	1	800	670	-130	0.13	0.84	1	1	0
0018	3T	17_3	146	5	0	500	0	-500	0.00	0.00	0	0	0
0018	3T	17_3	154	2	0	200	0	-200	0.00	0.00	0	0	0
0018	3T	17_3	156	4	0	400	0	-400	0.00	0.00	0	0	0
0018	3T	17_3	215	1	0	100	0	-100	0.00	0.00	0	0	0
0018	3T	17_3	234	2	1	200	1160	960	0.50	5.80	0	2	2
0018	3T	17_3	235	1	0	100	0	-100	0.00	0.00	0	0	0
0018	3T	17_3	246	1	0	100	0	-100	0.00	0.00	0	0	0
0018	3T	17_3	256	1	0	100	0	-100	0.00	0.00	0	0	0
0018	3T	17_4	123	51	4	5100	2180	-2920	0.08	0.43	9	3	-6
0018	3T	17_4	124	80	7	8000	5320	-2680	0.09	0.67	14	9	-5
0018	3T	17_4	125	56	1	5600	570	-5030	0.02	0.10	9	1	-8
0018	3T	17_4	126	23	3	2300	5150	2850	0.13	2.24	4	9	5
0018	3T	17_4	134	32	5	3200	3860	660	0.16	1.21	5	6	1
0018	3T	17_4	135	25	5	2500	5320	2820	0.20	2.13	4	9	5
0018	3T	17_4	136	9	0	900	0	-900	0.00	0.00	1	0	-1
0018	3T	17_4	143	2	0	200	0	-200	0.00	0.00	0	0	0
0018	3T	17_4	145	12	0	1200	0	-1200	0.00	0.00	2	0	-2
0018	3T	17_4	146	6	0	600	0	-600	0.00	0.00	1	0	-1
0018	3T	17_4	153	1	0	100	0	-100	0.00	0.00	0	0	0
0018	3T	17_4	154	1	1	100	1210	1110	1.00	12.10	0	2	2
0018	3T	17_4	156	1	0	100	0	-100	0.00	0.00	0	0	0
0018	3T	17_4	214	2	0	200	0	-200	0.00	0.00	0	0	0
0018	3T	17_4	215	1	0	100	0	-100	0.00	0.00	0	0	0
0018	3T	17_4	216	2	0	200	0	-200	0.00	0.00	0	0	0
0018	3T	17_4	236	1	0	100	0	-100	0.00	0.00	0	0	0
0018	3T	17_4	245	1	1	100	1140	1040	1.00	11.40	0	2	2
0018	3T	17_4	246	1	0	100	0	-100	0.00	0.00	0	0	0
0018	3T	17_5	123	47	10	4700	3940	-760	0.21	0.84	8	6	-2
0018	3T	17_5	124	103	7	10300	4560	-5740	0.07	0.44	18	8	-10
0018	3T	17_5	125	51	3	5100	2270	-2830	0.06	0.45	9	4	-5
0018	3T	17_5	126	16	0	1600	0	-1600	0.00	0.00	2	0	-2
0018	3T	17_5	132	1	0	100	0	-100	0.00	0.00	0	0	0
0018	3T	17_5	134	29	3	2900	1970	-930	0.10	0.68	5	3	-2
0018	3T	17_5	135	21	1	2100	860	-1240	0.05	0.41	3	1	-2
0018	3T	17_5	136	10	1	1000	2980	1980	0.10	2.98	1	5	4
0018	3T	17_5	143	1	0	100	0	-100	0.00	0.00	0	0	0
0018	3T	17_5	145	5	0	500	0	-500	0.00	0.00	0	0	0
0018	3T	17_5	146	2	0	200	0	-200	0.00	0.00	0	0	0
0018	3T	17_5	154	2	0	200	0	-200	0.00	0.00	0	0	0
0018	3T	17_5	156	2	0	200	0	-200	0.00	0.00	0	0	0
0018	3T	17_5	164	1	0	100	0	-100	0.00	0.00	0	0	0
0018	3T	17_5	216	2	0	200	0	-200	0.00	0.00	0	0	0
0018	3T	17_5	235	1	0	100	0	-100	0.00	0.00	0	0	0
0018	3T	17_5	236	2	0	200	0	-200	0.00	0.00	0	0	0
0018	3T	17_7	123	73	8	7300	5680	-1620	0.11	0.78	12	10	-2
0018	3T	17_7	124	96	3	9600	1680	-7920	0.03	0.18	16	2	-14
0018	3T	17_7	125	82	6	8200	5000	-3200	0.07	0.61	14	8	-6
0018	3T	17_7	126	44	3	4400	2760	-1640	0.07	0.63	7	4	-3
0018	3T	17_7	132	1	0	100	0	-100	0.00	0.00	0	0	0
0018	3T	17_7	134	46	3	4600	2530	-2070	0.07	0.55	8	4	-4
0018	3T	17_7	135	28	0	2800	0	-2800	0.00	0.00	4	0	-4
0018	3T	17_7	136	16	3	1600	2750	1150	0.19	1.72	2	4	2
0018	3T	17_7	145	8	0	800	0	-800	0.00	0.00	1	0	-1
0018	3T	17_7	146	9	1	900	1730	830	0.11	1.92	1	3	2
0018	3T	17_7	153	1	0	100	0	-100	0.00	0.00	0	0	0
0018	3T	17_7	156	4	0	400	0	-400	0.00	0.00	0	0	0
0018	3T	17_7	162	1	0	100	0	-100	0.00	0.00	0	0	0
0018	3T	17_7	216	1	0	100	0	-100	0.00	0.00	0	0	0
0018	3T	17_7	245	1	0	100	0	-100	0.00	0.00	0	0	0
0018	3T	17_7	253	2	0	200	0	-200	0.00	0.00	0	0	0
0018	3T	17_7	256	1	0	100	0	-100	0.00	0.00	0	0	0
0018	3T	18_1	123	66	8	6600	7010	410	0.12	1.06	11	12	1
0018	3T	18_1	124	57	1	5700	760	-4940	0.02	0.13	10	1	-9
0018	3T	18_1	125	78	6	7800	3820	-3980	0.08	0.49	13	6	-7
0018	3T	18_1	126	15	0	1500	0	-1500	0.00	0.00	2	0	-2
0018	3T	18_1	134	26	2	2600	1180	-1420	0.08	0.45	4	2	-2
0018	3T	18_1	135	42	2	4200	1200	-3000	0.05	0.29	7	2	-5
0018	3T	18_1	136	11	1	1100	2540	1440	0.09	2.31	1	4	3
0018	3T	18_1	143	10	1	1000	630	-370	0.10	0.63	1	1	0
0018	3T	18_1	145	16	1	1600	970	-630	0.06	0.61	2	1	-1
0018	3T	18_1	146	15	1	1500	700	-800	0.07	0.47	2	1	-1
0018	3T	18_1	152	1	0	100	0	-100	0.00	0.00	0	0	0
0018	3T	18_1	153	1	0	100	0	-100	0.00	0.00	0	0	0
0018	3T	18_1	164	1	0	100	0	-100	0.00	0.00	0	0	0
0018	3T	18_1	214	4	0	400	0	-400	0.00	0.00	0	0	0
0018	3T	18_1	215	10	1	1000	1180	180	0.10	1.18	1	2	1
0018	3T	18_1	216	5	2	500	4330	3830	0.40	8.66	0	7	7
0018	3T	18_1	234	1	0	100	0	-100	0.00	0.00	0	0	0
0018	3T	18_1	235	1	0	100	0	-100	0.00	0.00	0	0	0
0018	3T	18_1	236	4	0	400	0	-400	0.00	0.00	0	0	0
0018	3T	18_1	245	3	1	300	560	260	0.33	1.87	0	0	0
0018	3T	18_2	123	72	5	7200	7260	60	0.07	1.01	12	12	0
0018	3T	18_2	124	65	7	6500	4070	-2430	0.11	0.63	11	7	-4
0018	3T	18_2	125	69	9	6900	9440	2540	0.13	1.37	12	16	4
0018	3T	18_2	126	15	0	1500	0	-1500	0.00	0.00	2	0	-2
0018	3T	18_2	132	2	0	200	0	-200	0.00	0.00	0	0	0
0018	3T	18_2	134	32	1	3200	690	-2510	0.03	0.22	5	1	-4
0018	3T	18_2	135	28	2	2800	2030	-770	0.07	0.73	4	3	-1
0018	3T	18_2	136	15	0	1500	0	-1500	0.00	0.00	2	0	-2
0018	3T	18_2	143	10	1	1000	800	-200	0.10	0.80	1	1	0
0018	3T	18_2	145	14	1	1400	2390	990	0.07	1.71	2	4	2
0018	3T	18_2	146	9	1	900	650	-250	0.11	0.72	1	1	0
0018	3T	18_2	153	1	1	100	730	630	1.00	7.30	0	1	1
0018	3T	18_2	156	1	0	100	0	-100	0.00	0.00	0	0	0
0018	3T	18_2	164	5	0	500	0	-500	0.00	0.00	0	0	0
0018	3T	18_2	214	2	0	200	0	-200	0.00	0.00	0	0	0
0018	3T	18_2	215	5	1	500	10220	9720	0.20	20.44	0	18	18
0018	3T	18_2	216	2	0	200	0	-200	0.00	0.00	0	0	0
0018	3T	18_2	236	3	0	300	0	-300	0.00	0.00	0	0	0
0018	3T	18_2	245	2	0	200	0	-200	0.00	0.00	0	0	0
0018	3T	18_2	246	2	0	200	0	-200	0.00	0.00	0	0	0
0018	3T	18_2	265	1	0	100	0	-100	0.00	0.00	0	0	0
0018	3T	18_3	123	70	5	7000	4290	-2710	0.07	0.61	12	7	-5
0018	3T	18_3	124	79	9	7900	5140	-2760	0.11	0.65	13	9	-4
0018	3T	18_3	125	55	9	5500	7370	1870	0.16	1.34	9	13	4
0018	3T	18_3	126	25	4	2500	5680	3180	0.16	2.27	4	10	6
0018	3T	18_3	134	33	6	3300	3670	370	0.18	1.11	5	6	1
0018	3T	18_3	135	18	2	1800	1440	-360	0.11	0.80	3	2	-1
0018	3T	18_3	136	4	0	400	0	-400	0.00	0.00	0	0	0
0018	3T	18_3	143	7	0	700	0	-700	0.00	0.00	1	0	-1
0018	3T	18_3	145	15	1	1500	630	-870	0.07	0.42	2	1	-1
0018	3T	18_3	146	2	0	200	0	-200	0.00	0.00	0	0	0
0018	3T	18_3	153	2	0	200	0	-200	0.00	0.00	0	0	0
0018	3T	18_3	154	2	0	200	0	-200	0.00	0.00	0	0	0
0018	3T	18_3	156	1	0	100	0	-100	0.00	0.00	0	0	0
0018	3T	18_3	164	5	0	500	0	-500	0.00	0.00	0	0	0
0018	3T	18_3	165	1	0	100	0	-100	0.00	0.00	0	0	0
0018	3T	18_3	214	10	0	1000	0	-1000	0.00	0.00	1	0	-1
0018	3T	18_3	215	5	0	500	0	-500	0.00	0.00	0	0	0
0018	3T	18_3	216	2	0	200	0	-200	0.00	0.00	0	0	0
0018	3T	18_3	234	2	0	200	0	-200	0.00	0.00	0	0	0
0018	3T	18_3	235	1	0	100	0	-100	0.00	0.00	0	0	0
0018	3T	18_3	236	2	0	200	0	-200	0.00	0.00	0	0	0
0018	3T	18_3	245	1	0	100	0	-100	0.00	0.00	0	0	0
0018	3T	18_3	246	2	0	200	0	-200	0.00	0.00	0	0	0
0018	3T	18_3	256	1	0	100	0	-100	0.00	0.00	0	0	0
0018	3T	18_3	264	2	0	200	0	-200	0.00	0.00	0	0	0
0018	3T	18_4	123	89	15	8900	9550	650	0.17	1.07	15	16	1
0018	3T	18_4	124	110	11	11000	8980	-2020	0.10	0.82	19	15	-4
0018	3T	18_4	125	46	5	4600	4220	-380	0.11	0.92	8	7	-1
0018	3T	18_4	126	13	1	1300	980	-320	0.08	0.75	2	1	-1
0018	3T	18_4	132	1	1	100	960	860	1.00	9.60	0	1	1
0018	3T	18_4	134	22	3	2200	6240	4040	0.14	2.84	3	11	8
0018	3T	18_4	135	21	2	2100	3850	1750	0.10	1.83	3	6	3
0018	3T	18_4	136	6	0	600	0	-600	0.00	0.00	1	0	-1
0018	3T	18_4	143	6	0	600	0	-600	0.00	0.00	1	0	-1
0018	3T	18_4	145	9	0	900	0	-900	0.00	0.00	1	0	-1
0018	3T	18_4	146	2	1	200	1320	1120	0.50	6.60	0	2	2
0018	3T	18_4	153	4	0	400	0	-400	0.00	0.00	0	0	0
0018	3T	18_4	154	2	0	200	0	-200	0.00	0.00	0	0	0
0018	3T	18_4	156	2	0	200	0	-200	0.00	0.00	0	0	0
0018	3T	18_4	164	2	0	200	0	-200	0.00	0.00	0	0	0
0018	3T	18_4	214	3	0	300	0	-300	0.00	0.00	0	0	0
0018	3T	18_4	215	1	0	100	0	-100	0.00	0.00	0	0	0
0018	3T	18_4	216	1	0	100	0	-100	0.00	0.00	0	0	0
0018	3T	18_4	234	4	0	400	0	-400	0.00	0.00	0	0	0
0018	3T	18_4	235	2	0	200	0	-200	0.00	0.00	0	0	0
0018	3T	18_4	236	1	0	100	0	-100	0.00	0.00	0	0	0
0018	3T	18_4	246	1	0	100	0	-100	0.00	0.00	0	0	0
0018	3T	18_5	123	124	22	12400	14210	1810	0.18	1.15	21	25	4
0018	3T	18_5	124	99	12	9900	8280	-1620	0.12	0.84	17	14	-3
0018	3T	18_5	125	87	4	8700	4080	-4620	0.05	0.47	15	7	-8
0018	3T	18_5	126	11	2	1100	2100	1000	0.18	1.91	1	3	2
0018	3T	18_5	134	10	0	1000	0	-1000	0.00	0.00	1	0	-1
0018	3T	18_5	135	28	3	2800	3100	300	0.11	1.11	4	5	1
0018	3T	18_5	136	2	1	200	1140	940	0.50	5.70	0	2	2
0018	3T	18_5	143	10	0	1000	0	-1000	0.00	0.00	1	0	-1
0018	3T	18_5	145	11	3	1100	2670	1570	0.27	2.43	1	4	3
0018	3T	18_5	146	6	2	600	1930	1330	0.33	3.22	1	3	2
0018	3T	18_5	153	10	1	1000	600	-400	0.10	0.60	1	1	0
0018	3T	18_5	154	4	1	400	770	370	0.25	1.93	0	1	1
0018	3T	18_5	163	2	0	200	0	-200	0.00	0.00	0	0	0
0018	3T	18_5	165	1	0	100	0	-100	0.00	0.00	0	0	0
0018	3T	18_5	214	2	0	200	0	-200	0.00	0.00	0	0	0
0018	3T	18_5	246	1	0	100	0	-100	0.00	0.00	0	0	0
0018	3T	18_6	123	9	0	900	0	-900	0.00	0.00	1	0	-1
0018	3T	18_6	124	16	4	1600	2300	700	0.25	1.44	2	4	2
0018	3T	18_6	125	6	2	600	1490	890	0.33	2.48	1	2	1
0018	3T	18_6	134	4	0	400	0	-400	0.00	0.00	0	0	0
0018	3T	18_6	135	1	1	100	1150	1050	1.00	11.50	0	2	2
0018	3T	18_6	143	1	0	100	0	-100	0.00	0.00	0	0	0
0018	3T	18_6	145	1	0	100	0	-100	0.00	0.00	0	0	0
0018	3T	18_6	146	1	0	100	0	-100	0.00	0.00	0	0	0
0018	3T	18_7	123	83	7	8300	4270	-4030	0.08	0.51	14	7	-7
0018	3T	18_7	124	146	16	14600	14060	-540	0.11	0.96	25	24	-1
0018	3T	18_7	125	75	10	7500	8970	1470	0.13	1.20	13	15	2
0018	3T	18_7	126	19	1	1900	1020	-880	0.05	0.54	3	1	-2
0018	3T	18_7	132	2	0	200	0	-200	0.00	0.00	0	0	0
0018	3T	18_7	134	33	5	3300	4380	1080	0.15	1.33	5	7	2
0018	3T	18_7	135	23	0	2300	0	-2300	0.00	0.00	4	0	-4
0018	3T	18_7	136	5	0	500	0	-500	0.00	0.00	0	0	0
0018	3T	18_7	143	5	0	500	0	-500	0.00	0.00	0	0	0
0018	3T	18_7	145	11	0	1100	0	-1100	0.00	0.00	1	0	-1
0018	3T	18_7	146	4	0	400	0	-400	0.00	0.00	0	0	0
0018	3T	18_7	153	2	0	200	0	-200	0.00	0.00	0	0	0
0018	3T	18_7	154	2	0	200	0	-200	0.00	0.00	0	0	0
0018	3T	18_7	164	3	1	300	1630	1330	0.33	5.43	0	2	2
0018	3T	18_7	214	5	0	500	0	-500	0.00	0.00	0	0	0
0018	3T	18_7	215	1	0	100	0	-100	0.00	0.00	0	0	0
0018	3T	18_7	234	1	0	100	0	-100	0.00	0.00	0	0	0
0018	3T	18_7	235	3	0	300	0	-300	0.00	0.00	0	0	0
0018	3T	18_7	236	1	0	100	0	-100	0.00	0.00	0	0	0
0018	3T	19_1	123	32	3	3200	2220	-980	0.09	0.69	5	3	-2
0018	3T	19_1	124	139	9	13900	6890	-7010	0.06	0.50	24	12	-12
0018	3T	19_1	125	22	1	2200	690	-1510	0.05	0.31	3	1	-2
0018	3T	19_1	126	20	1	2000	1220	-780	0.05	0.61	3	2	-1
0018	3T	19_1	132	1	0	100	0	-100	0.00	0.00	0	0	0
0018	3T	19_1	134	61	9	6100	6370	270	0.15	1.04	10	11	1
0018	3T	19_1	135	21	1	2100	650	-1450	0.05	0.31	3	1	-2
0018	3T	19_1	136	25	3	2500	3280	780	0.12	1.31	4	5	1
0018	3T	19_1	142	2	1	200	620	420	0.50	3.10	0	1	1
0018	3T	19_1	145	7	1	700	1390	690	0.14	1.99	1	2	1
0018	3T	19_1	146	5	1	500	880	380	0.20	1.76	0	1	1
0018	3T	19_1	216	2	0	200	0	-200	0.00	0.00	0	0	0
0018	3T	19_1	236	1	0	100	0	-100	0.00	0.00	0	0	0
0018	3T	19_1	246	1	0	100	0	-100	0.00	0.00	0	0	0
0018	3T	19_2	123	38	4	3800	5810	2010	0.11	1.53	6	10	4
0018	3T	19_2	124	94	13	9400	10010	610	0.14	1.06	16	17	1
0018	3T	19_2	125	35	1	3500	550	-2950	0.03	0.16	6	0	-6
0018	3T	19_2	126	33	1	3300	1580	-1720	0.03	0.48	5	2	-3
0018	3T	19_2	134	40	1	4000	900	-3100	0.03	0.23	7	1	-6
0018	3T	19_2	135	20	2	2000	2090	90	0.10	1.05	3	3	0
0018	3T	19_2	136	33	3	3300	2860	-440	0.09	0.87	5	5	0
0018	3T	19_2	142	1	0	100	0	-100	0.00	0.00	0	0	0
0018	3T	19_2	145	14	1	1400	730	-670	0.07	0.52	2	1	-1
0018	3T	19_2	146	6	0	600	0	-600	0.00	0.00	1	0	-1
0018	3T	19_2	153	1	0	100	0	-100	0.00	0.00	0	0	0
0018	3T	19_2	164	1	0	100	0	-100	0.00	0.00	0	0	0
0018	3T	19_2	236	1	0	100	0	-100	0.00	0.00	0	0	0
0018	3T	19_2	246	1	0	100	0	-100	0.00	0.00	0	0	0
0018	3T	19_3	123	38	5	3800	4660	860	0.13	1.23	6	8	2
0018	3T	19_3	124	90	6	9000	4630	-4370	0.07	0.51	15	8	-7
0018	3T	19_3	125	45	2	4500	1390	-3110	0.04	0.31	7	2	-5
0018	3T	19_3	126	41	2	4100	3980	-120	0.05	0.97	7	7	0
0018	3T	19_3	134	24	3	2400	3210	810	0.13	1.34	4	5	1
0018	3T	19_3	135	32	2	3200	1420	-1780	0.06	0.44	5	2	-3
0018	3T	19_3	136	24	2	2400	1770	-630	0.08	0.74	4	3	-1
0018	3T	19_3	145	10	1	1000	550	-450	0.10	0.55	1	0	-1
0018	3T	19_3	146	7	0	700	0	-700	0.00	0.00	1	0	-1
0018	3T	19_3	154	2	0	200	0	-200	0.00	0.00	0	0	0
0018	3T	19_3	156	3	0	300	0	-300	0.00	0.00	0	0	0
0018	3T	19_3	214	1	0	100	0	-100	0.00	0.00	0	0	0
0018	3T	19_3	235	1	0	100	0	-100	0.00	0.00	0	0	0
0018	3T	19_3	236	1	0	100	0	-100	0.00	0.00	0	0	0
0018	3T	19_4	123	39	6	3900	3110	-790	0.15	0.80	6	5	-1
0018	3T	19_4	124	103	9	10300	6750	-3550	0.09	0.66	18	11	-7
0018	3T	19_4	125	35	1	3500	1630	-1870	0.03	0.47	6	2	-4
0018	3T	19_4	126	13	1	1300	3650	2350	0.08	2.81	2	6	4
0018	3T	19_4	132	1	0	100	0	-100	0.00	0.00	0	0	0
0018	3T	19_4	134	38	4	3800	2240	-1560	0.11	0.59	6	3	-3
0018	3T	19_4	135	32	3	3200	1580	-1620	0.09	0.49	5	2	-3
0018	3T	19_4	136	12	0	1200	0	-1200	0.00	0.00	2	0	-2
0018	3T	19_4	143	1	0	100	0	-100	0.00	0.00	0	0	0
0018	3T	19_4	145	7	1	700	700	0	0.14	1.00	1	1	0
0018	3T	19_4	146	1	0	100	0	-100	0.00	0.00	0	0	0
0018	3T	19_4	156	3	0	300	0	-300	0.00	0.00	0	0	0
0018	3T	19_4	214	1	0	100	0	-100	0.00	0.00	0	0	0
0018	3T	19_4	215	1	0	100	0	-100	0.00	0.00	0	0	0
0018	3T	19_4	234	1	0	100	0	-100	0.00	0.00	0	0	0
0018	3T	19_4	235	1	0	100	0	-100	0.00	0.00	0	0	0
0018	3T	19_4	245	1	0	100	0	-100	0.00	0.00	0	0	0
0018	3T	19_4	246	2	0	200	0	-200	0.00	0.00	0	0	0
0018	3T	19_5	123	23	2	2300	1130	-1170	0.09	0.49	4	2	-2
0018	3T	19_5	124	70	8	7000	5270	-1730	0.11	0.75	12	9	-3
0018	3T	19_5	125	21	3	2100	3820	1720	0.14	1.82	3	6	3
0018	3T	19_5	126	15	1	1500	1700	200	0.07	1.13	2	3	1
0018	3T	19_5	132	3	0	300	0	-300	0.00	0.00	0	0	0
0018	3T	19_5	134	32	4	3200	2610	-590	0.13	0.82	5	4	-1
0018	3T	19_5	135	19	2	1900	1060	-840	0.11	0.56	3	1	-2
0018	3T	19_5	136	17	2	1700	2610	910	0.12	1.54	3	4	1
0018	3T	19_5	145	6	2	600	2980	2380	0.33	4.97	1	5	4
0018	3T	19_5	146	5	0	500	0	-500	0.00	0.00	0	0	0
0018	3T	19_5	216	1	0	100	0	-100	0.00	0.00	0	0	0
0018	3T	19_5	234	2	0	200	0	-200	0.00	0.00	0	0	0
0018	3T	19_5	235	1	0	100	0	-100	0.00	0.00	0	0	0
0018	3T	19_6	123	5	1	500	450	-50	0.20	0.90	0	0	0
0018	3T	19_6	124	10	0	1000	0	-1000	0.00	0.00	1	0	-1
0018	3T	19_6	125	1	0	100	0	-100	0.00	0.00	0	0	0
0018	3T	19_6	126	2	0	200	0	-200	0.00	0.00	0	0	0
0018	3T	19_6	135	3	1	300	660	360	0.33	2.20	0	1	1
0018	3T	19_6	136	3	0	300	0	-300	0.00	0.00	0	0	0
0018	3T	19_6	143	1	0	100	0	-100	0.00	0.00	0	0	0
0018	3T	19_6	145	1	0	100	0	-100	0.00	0.00	0	0	0
0018	3T	19_6	236	1	0	100	0	-100	0.00	0.00	0	0	0
0018	3T	19_7	123	41	2	4100	800	-3300	0.05	0.20	7	1	-6
0018	3T	19_7	124	125	16	12500	10820	-1680	0.13	0.87	22	19	-3
0018	3T	19_7	125	29	3	2900	2640	-260	0.10	0.91	5	4	-1
0018	3T	19_7	126	27	1	2700	860	-1840	0.04	0.32	4	1	-3
0018	3T	19_7	134	37	6	3700	5890	2190	0.16	1.59	6	10	4
0018	3T	19_7	135	17	3	1700	1910	210	0.18	1.12	3	3	0
0018	3T	19_7	136	28	2	2800	1210	-1590	0.07	0.43	4	2	-2
0018	3T	19_7	145	9	0	900	0	-900	0.00	0.00	1	0	-1
0018	3T	19_7	146	7	0	700	0	-700	0.00	0.00	1	0	-1
0018	3T	19_7	235	2	0	200	0	-200	0.00	0.00	0	0	0
0018	3T	19_7	246	1	0	100	0	-100	0.00	0.00	0	0	0
0018	3T	20_1	123	72	10	7200	7110	-90	0.14	0.99	12	12	0
0018	3T	20_1	124	124	14	12400	10410	-1990	0.11	0.84	21	18	-3
0018	3T	20_1	125	32	1	3200	1310	-1890	0.03	0.41	5	2	-3
0018	3T	20_1	126	14	2	1400	1630	230	0.14	1.16	2	2	0
0018	3T	20_1	134	40	6	4000	3770	-230	0.15	0.94	7	6	-1
0018	3T	20_1	135	38	4	3800	3830	30	0.11	1.01	6	6	0
0018	3T	20_1	136	28	0	2800	0	-2800	0.00	0.00	4	0	-4
0018	3T	20_1	143	1	0	100	0	-100	0.00	0.00	0	0	0
0018	3T	20_1	145	7	0	700	0	-700	0.00	0.00	1	0	-1
0018	3T	20_1	146	17	1	1700	1100	-600	0.06	0.65	3	1	-2
0018	3T	20_1	156	1	0	100	0	-100	0.00	0.00	0	0	0
0018	3T	20_1	216	1	0	100	0	-100	0.00	0.00	0	0	0
0018	3T	20_1	236	1	0	100	0	-100	0.00	0.00	0	0	0
0018	3T	20_2	123	58	8	5800	5310	-490	0.14	0.92	10	9	-1
0018	3T	20_2	124	96	7	9600	4130	-5470	0.07	0.43	16	7	-9
0018	3T	20_2	125	47	1	4700	710	-3990	0.02	0.15	8	1	-7
0018	3T	20_2	126	34	1	3400	900	-2500	0.03	0.26	6	1	-5
0018	3T	20_2	134	26	1	2600	820	-1780	0.04	0.32	4	1	-3
0018	3T	20_2	135	37	6	3700	5400	1700	0.16	1.46	6	9	3
0018	3T	20_2	136	30	2	3000	1910	-1090	0.07	0.64	5	3	-2
0018	3T	20_2	145	11	0	1100	0	-1100	0.00	0.00	1	0	-1
0018	3T	20_2	146	14	0	1400	0	-1400	0.00	0.00	2	0	-2
0018	3T	20_2	154	1	0	100	0	-100	0.00	0.00	0	0	0
0018	3T	20_2	156	5	0	500	0	-500	0.00	0.00	0	0	0
0018	3T	20_2	163	1	0	100	0	-100	0.00	0.00	0	0	0
0018	3T	20_2	165	1	0	100	0	-100	0.00	0.00	0	0	0
0018	3T	20_2	214	1	0	100	0	-100	0.00	0.00	0	0	0
0018	3T	20_2	245	1	0	100	0	-100	0.00	0.00	0	0	0
0018	3T	20_3	123	50	8	5000	4450	-550	0.16	0.89	8	7	-1
0018	3T	20_3	124	96	11	9600	8670	-930	0.11	0.90	16	15	-1
0018	3T	20_3	125	70	5	7000	4560	-2440	0.07	0.65	12	8	-4
0018	3T	20_3	126	40	1	4000	3110	-890	0.03	0.78	7	5	-2
0018	3T	20_3	134	19	0	1900	0	-1900	0.00	0.00	3	0	-3
0018	3T	20_3	135	27	3	2700	2100	-600	0.11	0.78	4	3	-1
0018	3T	20_3	136	29	0	2900	0	-2900	0.00	0.00	5	0	-5
0018	3T	20_3	142	1	0	100	0	-100	0.00	0.00	0	0	0
0018	3T	20_3	145	17	1	1700	640	-1060	0.06	0.38	3	1	-2
0018	3T	20_3	146	15	0	1500	0	-1500	0.00	0.00	2	0	-2
0018	3T	20_3	152	1	0	100	0	-100	0.00	0.00	0	0	0
0018	3T	20_3	156	8	1	800	1990	1190	0.13	2.49	1	3	2
0018	3T	20_3	165	1	0	100	0	-100	0.00	0.00	0	0	0
0018	3T	20_3	213	1	0	100	0	-100	0.00	0.00	0	0	0
0018	3T	20_3	235	1	0	100	0	-100	0.00	0.00	0	0	0
0018	3T	20_3	245	1	0	100	0	-100	0.00	0.00	0	0	0
0018	3T	20_4	123	48	10	4800	7320	2520	0.21	1.53	8	12	4
0018	3T	20_4	124	98	8	9800	8000	-1800	0.08	0.82	17	14	-3
0018	3T	20_4	125	52	1	5200	640	-4560	0.02	0.12	9	1	-8
0018	3T	20_4	126	16	0	1600	0	-1600	0.00	0.00	2	0	-2
0018	3T	20_4	134	27	1	2700	760	-1940	0.04	0.28	4	1	-3
0018	3T	20_4	135	23	4	2300	3960	1660	0.17	1.72	4	7	3
0018	3T	20_4	136	17	3	1700	2230	530	0.18	1.31	3	3	0
0018	3T	20_4	143	1	0	100	0	-100	0.00	0.00	0	0	0
0018	3T	20_4	145	18	0	1800	0	-1800	0.00	0.00	3	0	-3
0018	3T	20_4	146	8	0	800	0	-800	0.00	0.00	1	0	-1
0018	3T	20_4	154	1	0	100	0	-100	0.00	0.00	0	0	0
0018	3T	20_4	156	9	1	900	1320	420	0.11	1.47	1	2	1
0018	3T	20_4	216	1	0	100	0	-100	0.00	0.00	0	0	0
0018	3T	20_4	235	1	0	100	0	-100	0.00	0.00	0	0	0
0018	3T	20_4	236	1	0	100	0	-100	0.00	0.00	0	0	0
0018	3T	20_4	245	2	0	200	0	-200	0.00	0.00	0	0	0
0018	3T	20_5	123	50	5	5000	2210	-2790	0.10	0.44	8	3	-5
0018	3T	20_5	124	96	14	9600	10190	590	0.15	1.06	16	18	2
0018	3T	20_5	125	60	2	6000	2170	-3830	0.03	0.36	10	3	-7
0018	3T	20_5	126	17	0	1700	0	-1700	0.00	0.00	3	0	-3
0018	3T	20_5	134	20	1	2000	1650	-350	0.05	0.83	3	2	-1
0018	3T	20_5	135	15	1	1500	680	-820	0.07	0.45	2	1	-1
0018	3T	20_5	136	10	0	1000	0	-1000	0.00	0.00	1	0	-1
0018	3T	20_5	143	1	0	100	0	-100	0.00	0.00	0	0	0
0018	3T	20_5	145	11	1	1100	3080	1980	0.09	2.80	1	5	4
0018	3T	20_5	146	9	0	900	0	-900	0.00	0.00	1	0	-1
0018	3T	20_5	152	1	0	100	0	-100	0.00	0.00	0	0	0
0018	3T	20_5	214	1	0	100	0	-100	0.00	0.00	0	0	0
0018	3T	20_5	235	1	0	100	0	-100	0.00	0.00	0	0	0
0018	3T	20_6	123	8	2	800	1060	260	0.25	1.33	1	1	0
0018	3T	20_6	124	22	3	2200	1670	-530	0.14	0.76	3	2	-1
0018	3T	20_6	125	11	1	1100	590	-510	0.09	0.54	1	1	0
0018	3T	20_6	126	3	1	300	980	680	0.33	3.27	0	1	1
0018	3T	20_6	134	5	1	500	780	280	0.20	1.56	0	1	1
0018	3T	20_6	135	2	0	200	0	-200	0.00	0.00	0	0	0
0018	3T	20_6	136	3	0	300	0	-300	0.00	0.00	0	0	0
0018	3T	20_6	145	4	0	400	0	-400	0.00	0.00	0	0	0
0018	3T	20_6	216	1	1	100	920	820	1.00	9.20	0	1	1
0018	3T	20_7	123	56	8	5600	4040	-1560	0.14	0.72	9	7	-2
0018	3T	20_7	124	140	10	14000	7600	-6400	0.07	0.54	24	13	-11
0018	3T	20_7	125	56	6	5600	7200	1600	0.11	1.29	9	12	3
0018	3T	20_7	126	31	3	3100	2720	-380	0.10	0.88	5	4	-1
0018	3T	20_7	132	1	0	100	0	-100	0.00	0.00	0	0	0
0018	3T	20_7	134	33	5	3300	4680	1380	0.15	1.42	5	8	3
0018	3T	20_7	135	25	1	2500	750	-1750	0.04	0.30	4	1	-3
0018	3T	20_7	136	15	1	1500	890	-610	0.07	0.59	2	1	-1
0018	3T	20_7	145	11	0	1100	0	-1100	0.00	0.00	1	0	-1
0018	3T	20_7	146	12	2	1200	1580	380	0.17	1.32	2	2	0
0018	3T	20_7	154	1	0	100	0	-100	0.00	0.00	0	0	0
0018	3T	20_7	156	4	0	400	0	-400	0.00	0.00	0	0	0
0018	3T	20_7	165	1	0	100	0	-100	0.00	0.00	0	0	0
0018	3T	21_1	123	70	5	7000	4010	-2990	0.07	0.57	12	7	-5
0018	3T	21_1	124	74	10	7400	5730	-1670	0.14	0.77	13	10	-3
0018	3T	21_1	125	68	8	6800	6500	-300	0.12	0.96	12	11	-1
0018	3T	21_1	126	50	0	5000	0	-5000	0.00	0.00	8	0	-8
0018	3T	21_1	134	36	2	3600	980	-2620	0.06	0.27	6	1	-5
0018	3T	21_1	135	69	10	6900	7120	220	0.14	1.03	12	12	0
0018	3T	21_1	136	14	1	1400	1740	340	0.07	1.24	2	3	1
0018	3T	21_1	143	2	2	200	2630	2430	1.00	13.15	0	4	4
0018	3T	21_1	145	26	0	2600	0	-2600	0.00	0.00	4	0	-4
0018	3T	21_1	146	8	1	800	960	160	0.13	1.20	1	1	0
0018	3T	21_1	215	1	0	100	0	-100	0.00	0.00	0	0	0
0018	3T	21_1	216	2	1	200	1410	1210	0.50	7.05	0	2	2
0018	3T	21_1	235	1	0	100	0	-100	0.00	0.00	0	0	0
0018	3T	21_1	236	1	0	100	0	-100	0.00	0.00	0	0	0
0018	3T	21_1	264	1	0	100	0	-100	0.00	0.00	0	0	0
0018	3T	21_2	123	43	7	4300	9120	4820	0.16	2.12	7	16	9
0018	3T	21_2	124	83	12	8300	7650	-650	0.14	0.92	14	13	-1
0018	3T	21_2	125	92	7	9200	9220	20	0.08	1.00	16	16	0
0018	3T	21_2	126	43	4	4300	5190	890	0.09	1.21	7	9	2
0018	3T	21_2	134	21	2	2100	1540	-560	0.10	0.73	3	2	-1
0018	3T	21_2	135	59	11	5900	8610	2710	0.19	1.46	10	15	5
0018	3T	21_2	136	15	0	1500	0	-1500	0.00	0.00	2	0	-2
0018	3T	21_2	143	4	0	400	0	-400	0.00	0.00	0	0	0
0018	3T	21_2	145	19	1	1900	900	-1000	0.05	0.47	3	1	-2
0018	3T	21_2	146	6	1	600	1170	570	0.17	1.95	1	2	1
0018	3T	21_2	153	1	0	100	0	-100	0.00	0.00	0	0	0
0018	3T	21_2	156	1	0	100	0	-100	0.00	0.00	0	0	0
0018	3T	21_2	215	1	0	100	0	-100	0.00	0.00	0	0	0
0018	3T	21_2	216	3	0	300	0	-300	0.00	0.00	0	0	0
0018	3T	21_3	123	75	13	7500	10340	2840	0.17	1.38	13	18	5
0018	3T	21_3	124	93	6	9300	3410	-5890	0.06	0.37	16	6	-10
0018	3T	21_3	125	71	8	7100	7010	-90	0.11	0.99	12	12	0
0018	3T	21_3	126	30	2	3000	1900	-1100	0.07	0.63	5	3	-2
0018	3T	21_3	134	16	3	1600	1730	130	0.19	1.08	2	3	1
0018	3T	21_3	135	43	3	4300	2070	-2230	0.07	0.48	7	3	-4
0018	3T	21_3	136	9	0	900	0	-900	0.00	0.00	1	0	-1
0018	3T	21_3	143	13	1	1300	1350	50	0.08	1.04	2	2	0
0018	3T	21_3	145	14	1	1400	690	-710	0.07	0.49	2	1	-1
0018	3T	21_3	146	8	0	800	0	-800	0.00	0.00	1	0	-1
0018	3T	21_3	153	2	0	200	0	-200	0.00	0.00	0	0	0
0018	3T	21_3	154	1	1	100	2130	2030	1.00	21.30	0	3	3
0018	3T	21_3	156	4	0	400	0	-400	0.00	0.00	0	0	0
0018	3T	21_3	164	1	0	100	0	-100	0.00	0.00	0	0	0
0018	3T	21_3	215	5	0	500	0	-500	0.00	0.00	0	0	0
0018	3T	21_3	216	4	0	400	0	-400	0.00	0.00	0	0	0
0018	3T	21_3	234	2	1	200	600	400	0.50	3.00	0	1	1
0018	3T	21_3	236	2	0	200	0	-200	0.00	0.00	0	0	0
0018	3T	21_3	246	1	0	100	0	-100	0.00	0.00	0	0	0
0018	3T	21_4	123	53	5	5300	3440	-1860	0.09	0.65	9	6	-3
0018	3T	21_4	124	65	6	6500	5400	-1100	0.09	0.83	11	9	-2
0018	3T	21_4	125	82	7	8200	7990	-210	0.09	0.97	14	14	0
0018	3T	21_4	126	27	2	2700	3960	1260	0.07	1.47	4	7	3
0018	3T	21_4	134	30	3	3000	1770	-1230	0.10	0.59	5	3	-2
0018	3T	21_4	135	48	10	4800	7450	2650	0.21	1.55	8	13	5
0018	3T	21_4	136	9	0	900	0	-900	0.00	0.00	1	0	-1
0018	3T	21_4	143	6	0	600	0	-600	0.00	0.00	1	0	-1
0018	3T	21_4	145	8	0	800	0	-800	0.00	0.00	1	0	-1
0018	3T	21_4	146	8	0	800	0	-800	0.00	0.00	1	0	-1
0018	3T	21_4	215	1	0	100	0	-100	0.00	0.00	0	0	0
0018	3T	21_4	216	2	0	200	0	-200	0.00	0.00	0	0	0
0018	3T	21_4	234	1	0	100	0	-100	0.00	0.00	0	0	0
0018	3T	21_4	235	1	0	100	0	-100	0.00	0.00	0	0	0
0018	3T	21_4	236	1	0	100	0	-100	0.00	0.00	0	0	0
0018	3T	21_4	245	1	0	100	0	-100	0.00	0.00	0	0	0
0018	3T	21_5	123	58	6	5800	3690	-2110	0.10	0.64	10	6	-4
0018	3T	21_5	124	116	14	11600	10950	-650	0.12	0.94	20	19	-1
0018	3T	21_5	125	63	6	6300	4950	-1350	0.10	0.79	11	8	-3
0018	3T	21_5	126	14	2	1400	2030	630	0.14	1.45	2	3	1
0018	3T	21_5	134	18	0	1800	0	-1800	0.00	0.00	3	0	-3
0018	3T	21_5	135	31	5	3100	3080	-20	0.16	0.99	5	5	0
0018	3T	21_5	136	3	0	300	0	-300	0.00	0.00	0	0	0
0018	3T	21_5	145	6	0	600	0	-600	0.00	0.00	1	0	-1
0018	3T	21_5	146	2	1	200	1010	810	0.50	5.05	0	1	1
0018	3T	21_5	153	4	0	400	0	-400	0.00	0.00	0	0	0
0018	3T	21_5	154	2	1	200	1830	1630	0.50	9.15	0	3	3
0018	3T	21_5	214	3	0	300	0	-300	0.00	0.00	0	0	0
0018	3T	21_5	216	1	0	100	0	-100	0.00	0.00	0	0	0
0018	3T	21_6	123	8	1	800	710	-90	0.13	0.89	1	1	0
0018	3T	21_6	124	9	0	900	0	-900	0.00	0.00	1	0	-1
0018	3T	21_6	125	1	0	100	0	-100	0.00	0.00	0	0	0
0018	3T	21_6	134	1	0	100	0	-100	0.00	0.00	0	0	0
0018	3T	21_6	145	1	0	100	0	-100	0.00	0.00	0	0	0
0018	3T	21_6	146	1	0	100	0	-100	0.00	0.00	0	0	0
0018	3T	21_6	215	1	0	100	0	-100	0.00	0.00	0	0	0
0018	3T	21_6	216	1	0	100	0	-100	0.00	0.00	0	0	0
0018	3T	21_7	123	86	2	8600	1830	-6770	0.02	0.21	15	3	-12
0018	3T	21_7	124	135	11	13500	7830	-5670	0.08	0.58	23	13	-10
0018	3T	21_7	125	70	7	7000	6080	-920	0.10	0.87	12	10	-2
0018	3T	21_7	126	25	0	2500	0	-2500	0.00	0.00	4	0	-4
0018	3T	21_7	134	31	3	3100	1720	-1380	0.10	0.55	5	3	-2
0018	3T	21_7	135	25	2	2500	3260	760	0.08	1.30	4	5	1
0018	3T	21_7	136	4	0	400	0	-400	0.00	0.00	0	0	0
0018	3T	21_7	143	4	0	400	0	-400	0.00	0.00	0	0	0
0018	3T	21_7	145	12	1	1200	570	-630	0.08	0.48	2	1	-1
0018	3T	21_7	146	3	0	300	0	-300	0.00	0.00	0	0	0
0018	3T	21_7	163	1	0	100	0	-100	0.00	0.00	0	0	0
0018	3T	21_7	164	1	0	100	0	-100	0.00	0.00	0	0	0
0018	3T	21_7	165	1	0	100	0	-100	0.00	0.00	0	0	0
0018	3T	21_7	216	3	0	300	0	-300	0.00	0.00	0	0	0
0018	3T	21_7	234	2	0	200	0	-200	0.00	0.00	0	0	0
0018	3T	21_7	256	1	0	100	0	-100	0.00	0.00	0	0	0
0018	3T	22_1	123	59	8	5900	6750	850	0.14	1.14	10	11	1
0018	3T	22_1	124	115	6	11500	4500	-7000	0.05	0.39	20	7	-13
0018	3T	22_1	125	29	1	2900	990	-1910	0.03	0.34	5	1	-4
0018	3T	22_1	126	34	1	3400	2600	-800	0.03	0.76	6	4	-2
0018	3T	22_1	134	21	3	2100	3800	1700	0.14	1.81	3	6	3
0018	3T	22_1	135	24	1	2400	850	-1550	0.04	0.35	4	1	-3
0018	3T	22_1	136	21	0	2100	0	-2100	0.00	0.00	3	0	-3
0018	3T	22_1	145	4	0	400	0	-400	0.00	0.00	0	0	0
0018	3T	22_1	146	3	0	300	0	-300	0.00	0.00	0	0	0
0018	3T	22_1	156	2	0	200	0	-200	0.00	0.00	0	0	0
0018	3T	22_1	235	1	0	100	0	-100	0.00	0.00	0	0	0
0018	3T	22_1	236	1	0	100	0	-100	0.00	0.00	0	0	0
0018	3T	22_1	245	1	0	100	0	-100	0.00	0.00	0	0	0
0018	3T	22_2	123	44	6	4400	3760	-640	0.14	0.85	7	6	-1
0018	3T	22_2	124	74	7	7400	7360	-40	0.09	0.99	13	13	0
0018	3T	22_2	125	24	1	2400	1410	-990	0.04	0.59	4	2	-2
0018	3T	22_2	126	41	1	4100	2140	-1960	0.02	0.52	7	3	-4
0018	3T	22_2	134	25	1	2500	440	-2060	0.04	0.18	4	0	-4
0018	3T	22_2	135	18	1	1800	680	-1120	0.06	0.38	3	1	-2
0018	3T	22_2	136	27	0	2700	0	-2700	0.00	0.00	4	0	-4
0018	3T	22_2	143	1	0	100	0	-100	0.00	0.00	0	0	0
0018	3T	22_2	145	11	2	1100	1690	590	0.18	1.54	1	2	1
0018	3T	22_2	146	10	1	1000	1860	860	0.10	1.86	1	3	2
0018	3T	22_2	156	2	0	200	0	-200	0.00	0.00	0	0	0
0018	3T	22_2	234	1	0	100	0	-100	0.00	0.00	0	0	0
0018	3T	22_2	235	1	0	100	0	-100	0.00	0.00	0	0	0
0018	3T	22_2	245	1	0	100	0	-100	0.00	0.00	0	0	0
0018	3T	22_3	123	37	11	3700	9810	6110	0.30	2.65	6	17	11
0018	3T	22_3	124	73	9	7300	9060	1760	0.12	1.24	12	16	4
0018	3T	22_3	125	35	3	3500	2670	-830	0.09	0.76	6	4	-2
0018	3T	22_3	126	30	3	3000	5010	2010	0.10	1.67	5	8	3
0018	3T	22_3	132	1	0	100	0	-100	0.00	0.00	0	0	0
0018	3T	22_3	134	29	2	2900	2540	-360	0.07	0.88	5	4	-1
0018	3T	22_3	135	24	1	2400	2310	-90	0.04	0.96	4	4	0
0018	3T	22_3	136	26	0	2600	0	-2600	0.00	0.00	4	0	-4
0018	3T	22_3	143	2	0	200	0	-200	0.00	0.00	0	0	0
0018	3T	22_3	145	11	0	1100	0	-1100	0.00	0.00	1	0	-1
0018	3T	22_3	146	3	0	300	0	-300	0.00	0.00	0	0	0
0018	3T	22_3	156	2	0	200	0	-200	0.00	0.00	0	0	0
0018	3T	22_3	215	1	0	100	0	-100	0.00	0.00	0	0	0
0018	3T	22_3	216	2	0	200	0	-200	0.00	0.00	0	0	0
0018	3T	22_3	236	2	0	200	0	-200	0.00	0.00	0	0	0
0018	3T	22_3	245	2	0	200	0	-200	0.00	0.00	0	0	0
0018	3T	22_4	123	37	5	3700	4470	770	0.14	1.21	6	7	1
0018	3T	22_4	124	62	9	6200	7330	1130	0.15	1.18	10	12	2
0018	3T	22_4	125	44	5	4400	6060	1660	0.11	1.38	7	10	3
0018	3T	22_4	126	29	1	2900	1220	-1680	0.03	0.42	5	2	-3
0018	3T	22_4	134	32	3	3200	2310	-890	0.09	0.72	5	4	-1
0018	3T	22_4	135	26	2	2600	1130	-1470	0.08	0.43	4	2	-2
0018	3T	22_4	136	17	2	1700	2020	320	0.12	1.19	3	3	0
0018	3T	22_4	143	1	1	100	770	670	1.00	7.70	0	1	1
0018	3T	22_4	145	8	0	800	0	-800	0.00	0.00	1	0	-1
0018	3T	22_4	146	4	0	400	0	-400	0.00	0.00	0	0	0
0018	3T	22_4	152	1	0	100	0	-100	0.00	0.00	0	0	0
0018	3T	22_4	156	2	1	200	1200	1000	0.50	6.00	0	2	2
0018	3T	22_4	216	1	0	100	0	-100	0.00	0.00	0	0	0
0018	3T	22_4	234	3	0	300	0	-300	0.00	0.00	0	0	0
0018	3T	22_4	236	1	1	100	590	490	1.00	5.90	0	1	1
0018	3T	22_4	245	1	0	100	0	-100	0.00	0.00	0	0	0
0018	3T	22_4	246	1	0	100	0	-100	0.00	0.00	0	0	0
0018	3T	22_4	256	1	0	100	0	-100	0.00	0.00	0	0	0
0018	3T	22_5	123	54	10	5400	6010	610	0.19	1.11	9	10	1
0018	3T	22_5	124	99	9	9900	5550	-4350	0.09	0.56	17	9	-8
0018	3T	22_5	125	20	2	2000	1290	-710	0.10	0.65	3	2	-1
0018	3T	22_5	126	9	1	900	2520	1620	0.11	2.80	1	4	3
0018	3T	22_5	134	26	1	2600	990	-1610	0.04	0.38	4	1	-3
0018	3T	22_5	135	25	1	2500	580	-1920	0.04	0.23	4	1	-3
0018	3T	22_5	136	4	0	400	0	-400	0.00	0.00	0	0	0
0018	3T	22_5	142	1	0	100	0	-100	0.00	0.00	0	0	0
0018	3T	22_5	145	4	0	400	0	-400	0.00	0.00	0	0	0
0018	3T	22_5	146	4	0	400	0	-400	0.00	0.00	0	0	0
0018	3T	22_5	215	1	0	100	0	-100	0.00	0.00	0	0	0
0018	3T	22_5	234	1	0	100	0	-100	0.00	0.00	0	0	0
0018	3T	22_5	245	1	0	100	0	-100	0.00	0.00	0	0	0
0018	3T	22_7	123	57	9	5700	5900	200	0.16	1.04	10	10	0
0018	3T	22_7	124	117	11	11700	9000	-2700	0.09	0.77	20	15	-5
0018	3T	22_7	125	36	2	3600	1370	-2230	0.06	0.38	6	2	-4
0018	3T	22_7	126	34	1	3400	830	-2570	0.03	0.24	6	1	-5
0018	3T	22_7	134	38	5	3800	3280	-520	0.13	0.86	6	5	-1
0018	3T	22_7	135	18	1	1800	1570	-230	0.06	0.87	3	2	-1
0018	3T	22_7	136	13	0	1300	0	-1300	0.00	0.00	2	0	-2
0018	3T	22_7	145	8	0	800	0	-800	0.00	0.00	1	0	-1
0018	3T	22_7	146	4	1	400	3940	3540	0.25	9.85	0	6	6
0018	3T	22_7	154	1	0	100	0	-100	0.00	0.00	0	0	0
0018	3T	22_7	156	1	0	100	0	-100	0.00	0.00	0	0	0
0018	3T	22_7	234	1	0	100	0	-100	0.00	0.00	0	0	0
0018	3T	22_7	235	1	0	100	0	-100	0.00	0.00	0	0	0
0018	3T	23_1	123	65	7	6500	4820	-1680	0.11	0.74	11	8	-3
0018	3T	23_1	124	103	8	10300	6120	-4180	0.08	0.59	18	10	-8
0018	3T	23_1	125	52	1	5200	1000	-4200	0.02	0.19	9	1	-8
0018	3T	23_1	126	25	0	2500	0	-2500	0.00	0.00	4	0	-4
0018	3T	23_1	132	1	0	100	0	-100	0.00	0.00	0	0	0
0018	3T	23_1	134	23	1	2300	1450	-850	0.04	0.63	4	2	-2
0018	3T	23_1	135	25	1	2500	760	-1740	0.04	0.30	4	1	-3
0018	3T	23_1	136	19	2	1900	4620	2720	0.11	2.43	3	8	5
0018	3T	23_1	145	10	1	1000	620	-380	0.10	0.62	1	1	0
0018	3T	23_1	146	9	1	900	1040	140	0.11	1.16	1	1	0
0018	3T	23_1	214	1	0	100	0	-100	0.00	0.00	0	0	0
0018	3T	23_1	246	1	0	100	0	-100	0.00	0.00	0	0	0
0018	3T	23_2	123	55	3	5500	2110	-3390	0.05	0.38	9	3	-6
0018	3T	23_2	124	107	12	10700	19040	8340	0.11	1.78	18	33	15
0018	3T	23_2	125	52	5	5200	5760	560	0.10	1.11	9	10	1
0018	3T	23_2	126	26	1	2600	1240	-1360	0.04	0.48	4	2	-2
0018	3T	23_2	132	2	0	200	0	-200	0.00	0.00	0	0	0
0018	3T	23_2	134	42	6	4200	6890	2690	0.14	1.64	7	12	5
0018	3T	23_2	135	21	2	2100	1550	-550	0.10	0.74	3	2	-1
0018	3T	23_2	136	8	0	800	0	-800	0.00	0.00	1	0	-1
0018	3T	23_2	143	1	0	100	0	-100	0.00	0.00	0	0	0
0018	3T	23_2	145	12	0	1200	0	-1200	0.00	0.00	2	0	-2
0018	3T	23_2	146	6	0	600	0	-600	0.00	0.00	1	0	-1
0018	3T	23_2	214	2	1	200	1510	1310	0.50	7.55	0	2	2
0018	3T	23_2	216	1	0	100	0	-100	0.00	0.00	0	0	0
0018	3T	23_2	234	1	0	100	0	-100	0.00	0.00	0	0	0
0018	3T	23_2	236	2	0	200	0	-200	0.00	0.00	0	0	0
0018	3T	23_2	245	2	0	200	0	-200	0.00	0.00	0	0	0
0018	3T	23_2	246	1	0	100	0	-100	0.00	0.00	0	0	0
0018	3T	23_2	256	1	0	100	0	-100	0.00	0.00	0	0	0
0018	3T	23_3	123	50	9	5000	6120	1120	0.18	1.22	8	10	2
0018	3T	23_3	124	95	9	9500	7340	-2160	0.09	0.77	16	12	-4
0018	3T	23_3	125	60	2	6000	1660	-4340	0.03	0.28	10	2	-8
0018	3T	23_3	126	16	3	1600	4430	2830	0.19	2.77	2	7	5
0018	3T	23_3	132	1	0	100	0	-100	0.00	0.00	0	0	0
0018	3T	23_3	134	45	1	4500	440	-4060	0.02	0.10	7	0	-7
0018	3T	23_3	135	27	0	2700	0	-2700	0.00	0.00	4	0	-4
0018	3T	23_3	136	15	1	1500	10980	9480	0.07	7.32	2	19	17
0018	3T	23_3	145	12	0	1200	0	-1200	0.00	0.00	2	0	-2
0018	3T	23_3	146	4	0	400	0	-400	0.00	0.00	0	0	0
0018	3T	23_3	154	1	0	100	0	-100	0.00	0.00	0	0	0
0018	3T	23_3	156	1	0	100	0	-100	0.00	0.00	0	0	0
0018	3T	23_3	214	2	0	200	0	-200	0.00	0.00	0	0	0
0018	3T	23_3	215	2	0	200	0	-200	0.00	0.00	0	0	0
0018	3T	23_3	234	2	0	200	0	-200	0.00	0.00	0	0	0
0018	3T	23_3	235	1	0	100	0	-100	0.00	0.00	0	0	0
0018	3T	23_3	246	2	0	200	0	-200	0.00	0.00	0	0	0
0018	3T	23_3	256	1	0	100	0	-100	0.00	0.00	0	0	0
0018	3T	23_4	123	73	12	7300	5990	-1310	0.16	0.82	12	10	-2
0018	3T	23_4	124	101	4	10100	3580	-6520	0.04	0.35	17	6	-11
0018	3T	23_4	125	44	1	4400	370	-4030	0.02	0.08	7	0	-7
0018	3T	23_4	126	17	1	1700	1110	-590	0.06	0.65	3	1	-2
0018	3T	23_4	132	2	0	200	0	-200	0.00	0.00	0	0	0
0018	3T	23_4	134	33	3	3300	2330	-970	0.09	0.71	5	4	-1
0018	3T	23_4	135	21	4	2100	1880	-220	0.19	0.90	3	3	0
0018	3T	23_4	136	12	1	1200	620	-580	0.08	0.52	2	1	-1
0018	3T	23_4	145	11	2	1100	2750	1650	0.18	2.50	1	4	3
0018	3T	23_4	146	2	0	200	0	-200	0.00	0.00	0	0	0
0018	3T	23_4	156	1	0	100	0	-100	0.00	0.00	0	0	0
0018	3T	23_4	234	1	0	100	0	-100	0.00	0.00	0	0	0
0018	3T	23_4	235	2	0	200	0	-200	0.00	0.00	0	0	0
0018	3T	23_4	245	8	0	800	0	-800	0.00	0.00	1	0	-1
0018	3T	23_5	123	41	4	4100	3150	-950	0.10	0.77	7	5	-2
0018	3T	23_5	124	81	5	8100	3070	-5030	0.06	0.38	14	5	-9
0018	3T	23_5	125	31	1	3100	1270	-1830	0.03	0.41	5	2	-3
0018	3T	23_5	126	13	0	1300	0	-1300	0.00	0.00	2	0	-2
0018	3T	23_5	132	2	0	200	0	-200	0.00	0.00	0	0	0
0018	3T	23_5	134	23	1	2300	540	-1760	0.04	0.23	4	0	-4
0018	3T	23_5	135	18	0	1800	0	-1800	0.00	0.00	3	0	-3
0018	3T	23_5	136	5	1	500	1370	870	0.20	2.74	0	2	2
0018	3T	23_5	143	1	0	100	0	-100	0.00	0.00	0	0	0
0018	3T	23_5	145	19	1	1900	840	-1060	0.05	0.44	3	1	-2
0018	3T	23_5	146	5	0	500	0	-500	0.00	0.00	0	0	0
0018	3T	23_5	152	1	0	100	0	-100	0.00	0.00	0	0	0
0018	3T	23_5	154	1	0	100	0	-100	0.00	0.00	0	0	0
0018	3T	23_5	156	2	0	200	0	-200	0.00	0.00	0	0	0
0018	3T	23_5	234	1	0	100	0	-100	0.00	0.00	0	0	0
0018	3T	23_5	235	1	0	100	0	-100	0.00	0.00	0	0	0
0018	3T	23_5	246	2	0	200	0	-200	0.00	0.00	0	0	0
0018	3T	23_6	123	2	1	200	420	220	0.50	2.10	0	0	0
0018	3T	23_6	124	6	1	600	1510	910	0.17	2.52	1	2	1
0018	3T	23_6	125	6	0	600	0	-600	0.00	0.00	1	0	-1
0018	3T	23_6	126	1	0	100	0	-100	0.00	0.00	0	0	0
0018	3T	23_6	134	2	0	200	0	-200	0.00	0.00	0	0	0
0018	3T	23_6	135	3	0	300	0	-300	0.00	0.00	0	0	0
0018	3T	23_6	145	1	0	100	0	-100	0.00	0.00	0	0	0
0018	3T	23_7	123	56	5	5600	2580	-3020	0.09	0.46	9	4	-5
0018	3T	23_7	124	123	9	12300	6920	-5380	0.07	0.56	21	12	-9
0018	3T	23_7	125	49	2	4900	1640	-3260	0.04	0.33	8	2	-6
0018	3T	23_7	126	17	1	1700	2880	1180	0.06	1.69	3	5	2
0018	3T	23_7	132	3	0	300	0	-300	0.00	0.00	0	0	0
0018	3T	23_7	134	46	4	4600	3890	-710	0.09	0.85	8	6	-2
0018	3T	23_7	135	31	3	3100	3330	230	0.10	1.07	5	5	0
0018	3T	23_7	136	10	0	1000	0	-1000	0.00	0.00	1	0	-1
0018	3T	23_7	145	29	2	2900	1780	-1120	0.07	0.61	5	3	-2
0018	3T	23_7	146	12	0	1200	0	-1200	0.00	0.00	2	0	-2
0018	3T	23_7	156	3	0	300	0	-300	0.00	0.00	0	0	0
0018	3T	23_7	215	1	0	100	0	-100	0.00	0.00	0	0	0
0018	3T	24_1	123	78	7	7800	4400	-3400	0.09	0.56	13	7	-6
0018	3T	24_1	124	115	13	11500	9170	-2330	0.11	0.80	20	16	-4
0018	3T	24_1	125	42	5	4200	6380	2180	0.12	1.52	7	11	4
0018	3T	24_1	126	65	5	6500	4270	-2230	0.08	0.66	11	7	-4
0018	3T	24_1	132	1	0	100	0	-100	0.00	0.00	0	0	0
0018	3T	24_1	134	33	6	3300	4150	850	0.18	1.26	5	7	2
0018	3T	24_1	135	15	0	1500	0	-1500	0.00	0.00	2	0	-2
0018	3T	24_1	136	38	2	3800	1420	-2380	0.05	0.37	6	2	-4
0018	3T	24_1	143	1	1	100	2950	2850	1.00	29.50	0	5	5
0018	3T	24_1	145	8	2	800	2760	1960	0.25	3.45	1	4	3
0018	3T	24_1	146	5	1	500	610	110	0.20	1.22	0	1	1
0018	3T	24_1	152	3	0	300	0	-300	0.00	0.00	0	0	0
0018	3T	24_1	156	3	1	300	730	430	0.33	2.43	0	1	1
0018	3T	24_1	215	2	1	200	1050	850	0.50	5.25	0	1	1
0018	3T	24_1	216	1	0	100	0	-100	0.00	0.00	0	0	0
0018	3T	24_2	123	71	9	7100	5430	-1670	0.13	0.76	12	9	-3
0018	3T	24_2	124	101	10	10100	6110	-3990	0.10	0.60	17	10	-7
0018	3T	24_2	125	36	4	3600	2950	-650	0.11	0.82	6	5	-1
0018	3T	24_2	126	45	6	4500	4830	330	0.13	1.07	7	8	1
0018	3T	24_2	134	39	5	3900	3850	-50	0.13	0.99	6	6	0
0018	3T	24_2	135	25	2	2500	1320	-1180	0.08	0.53	4	2	-2
0018	3T	24_2	136	32	3	3200	2340	-860	0.09	0.73	5	4	-1
0018	3T	24_2	145	8	1	800	550	-250	0.13	0.69	1	0	-1
0018	3T	24_2	146	5	0	500	0	-500	0.00	0.00	0	0	0
0018	3T	24_2	152	1	0	100	0	-100	0.00	0.00	0	0	0
0018	3T	24_2	156	2	1	200	1910	1710	0.50	9.55	0	3	3
0018	3T	24_2	163	1	0	100	0	-100	0.00	0.00	0	0	0
0018	3T	24_2	245	1	0	100	0	-100	0.00	0.00	0	0	0
0018	3T	24_2	256	1	0	100	0	-100	0.00	0.00	0	0	0
0018	3T	24_3	123	87	14	8700	7790	-910	0.16	0.90	15	13	-2
0018	3T	24_3	124	109	13	10900	8530	-2370	0.12	0.78	19	15	-4
0018	3T	24_3	125	61	4	6100	3660	-2440	0.07	0.60	10	6	-4
0018	3T	24_3	126	33	2	3300	2120	-1180	0.06	0.64	5	3	-2
0018	3T	24_3	134	48	7	4800	4500	-300	0.15	0.94	8	7	-1
0018	3T	24_3	135	28	3	2800	2310	-490	0.11	0.83	4	4	0
0018	3T	24_3	136	22	1	2200	1080	-1120	0.05	0.49	3	1	-2
0018	3T	24_3	143	4	0	400	0	-400	0.00	0.00	0	0	0
0018	3T	24_3	145	12	1	1200	660	-540	0.08	0.55	2	1	-1
0018	3T	24_3	146	5	0	500	0	-500	0.00	0.00	0	0	0
0018	3T	24_3	153	1	1	100	560	460	1.00	5.60	0	0	0
0018	3T	24_3	156	1	0	100	0	-100	0.00	0.00	0	0	0
0018	3T	24_3	214	1	1	100	1280	1180	1.00	12.80	0	2	2
0018	3T	24_3	215	1	0	100	0	-100	0.00	0.00	0	0	0
0018	3T	24_3	236	1	0	100	0	-100	0.00	0.00	0	0	0
0018	3T	24_3	246	1	0	100	0	-100	0.00	0.00	0	0	0
0018	3T	24_4	123	53	10	5300	4440	-860	0.19	0.84	9	7	-2
0018	3T	24_4	124	85	5	8500	3180	-5320	0.06	0.37	15	5	-10
0018	3T	24_4	125	47	5	4700	5760	1060	0.11	1.23	8	10	2
0018	3T	24_4	126	16	0	1600	0	-1600	0.00	0.00	2	0	-2
0018	3T	24_4	134	51	13	5100	8250	3150	0.25	1.62	9	14	5
0018	3T	24_4	135	27	4	2700	4370	1670	0.15	1.62	4	7	3
0018	3T	24_4	136	5	0	500	0	-500	0.00	0.00	0	0	0
0018	3T	24_4	143	2	0	200	0	-200	0.00	0.00	0	0	0
0018	3T	24_4	145	9	1	900	1050	150	0.11	1.17	1	1	0
0018	3T	24_4	146	2	0	200	0	-200	0.00	0.00	0	0	0
0018	3T	24_4	214	1	0	100	0	-100	0.00	0.00	0	0	0
0018	3T	24_4	245	1	0	100	0	-100	0.00	0.00	0	0	0
0018	3T	24_5	123	28	2	2800	660	-2140	0.07	0.24	4	1	-3
0018	3T	24_5	124	58	6	5800	2450	-3350	0.10	0.42	10	4	-6
0018	3T	24_5	125	36	6	3600	5460	1860	0.17	1.52	6	9	3
0018	3T	24_5	126	11	0	1100	0	-1100	0.00	0.00	1	0	-1
0018	3T	24_5	134	15	0	1500	0	-1500	0.00	0.00	2	0	-2
0018	3T	24_5	135	12	0	1200	0	-1200	0.00	0.00	2	0	-2
0018	3T	24_5	136	2	1	200	1140	940	0.50	5.70	0	2	2
0018	3T	24_5	143	2	0	200	0	-200	0.00	0.00	0	0	0
0018	3T	24_5	145	5	0	500	0	-500	0.00	0.00	0	0	0
0018	3T	24_5	146	1	0	100	0	-100	0.00	0.00	0	0	0
0018	3T	24_5	215	1	0	100	0	-100	0.00	0.00	0	0	0
0018	3T	24_5	234	1	0	100	0	-100	0.00	0.00	0	0	0
0018	3T	24_5	235	2	0	200	0	-200	0.00	0.00	0	0	0
0018	3T	24_6	123	4	0	400	0	-400	0.00	0.00	0	0	0
0018	3T	24_6	124	16	2	1600	650	-950	0.13	0.41	2	1	-1
0018	3T	24_6	125	4	0	400	0	-400	0.00	0.00	0	0	0
0018	3T	24_6	126	3	1	300	1080	780	0.33	3.60	0	1	1
0018	3T	24_6	134	3	1	300	680	380	0.33	2.27	0	1	1
0018	3T	24_6	135	7	1	700	320	-380	0.14	0.46	1	0	-1
0018	3T	24_6	136	1	0	100	0	-100	0.00	0.00	0	0	0
0018	3T	24_6	145	2	0	200	0	-200	0.00	0.00	0	0	0
0018	3T	24_7	123	86	16	8600	8540	-60	0.19	0.99	15	15	0
0018	3T	24_7	124	132	16	13200	12560	-640	0.12	0.95	23	22	-1
0018	3T	24_7	125	70	7	7000	6220	-780	0.10	0.89	12	11	-1
0018	3T	24_7	126	31	3	3100	2000	-1100	0.10	0.65	5	3	-2
0018	3T	24_7	134	36	2	3600	1080	-2520	0.06	0.30	6	1	-5
0018	3T	24_7	135	29	3	2900	3520	620	0.10	1.21	5	6	1
0018	3T	24_7	136	10	0	1000	0	-1000	0.00	0.00	1	0	-1
0018	3T	24_7	142	1	0	100	0	-100	0.00	0.00	0	0	0
0018	3T	24_7	143	2	0	200	0	-200	0.00	0.00	0	0	0
0018	3T	24_7	145	10	1	1000	1010	10	0.10	1.01	1	1	0
0018	3T	24_7	146	3	1	300	6010	5710	0.33	20.03	0	10	10
0018	3T	24_7	153	1	0	100	0	-100	0.00	0.00	0	0	0
0018	3T	24_7	163	1	0	100	0	-100	0.00	0.00	0	0	0
0018	3T	24_7	215	1	0	100	0	-100	0.00	0.00	0	0	0
0018	3T	24_7	216	1	0	100	0	-100	0.00	0.00	0	0	0
0018	3T	24_7	234	1	0	100	0	-100	0.00	0.00	0	0	0
0018	3T	24_7	236	1	0	100	0	-100	0.00	0.00	0	0	0
0005	2F	10	14	324	88	32400	33540	1140	0.27	1.04	57	59	2
0005	2F	10	15	117	15	11700	7810	-3890	0.13	0.67	20	13	-7
0005	2F	10	16	74	15	7400	9040	1640	0.20	1.22	13	16	3
0005	2F	10	23	46	11	4600	5200	600	0.24	1.13	8	9	1
0005	2F	10	24	31	10	3100	4010	910	0.32	1.29	5	7	2
0005	2F	10	25	19	2	1900	620	-1280	0.11	0.33	3	1	-2
0005	2F	10	26	26	8	2600	2640	40	0.31	1.02	4	4	0
0005	2F	11	12	1125	321	112500	111120	-1380	0.29	0.99	199	196	-3
0005	2F	11	13	408	75	40800	33330	-7470	0.18	0.82	72	58	-14
0005	2F	11	14	352	51	35200	22000	-13200	0.14	0.63	62	38	-24
0005	2F	11	15	130	4	13000	3840	-9160	0.03	0.30	23	6	-17
0005	2F	11	16	45	3	4500	3630	-870	0.07	0.81	7	6	-1
0005	2F	11	23	51	3	5100	1510	-3590	0.06	0.30	9	2	-7
0005	2F	11	24	55	2	5500	1720	-3780	0.04	0.31	9	3	-6
0005	2F	11	25	29	0	2900	0	-2900	0.00	0.00	5	0	-5
0005	2F	11	26	13	0	1300	0	-1300	0.00	0.00	2	0	-2
0005	2F	12	12	1055	298	105500	86180	-19320	0.28	0.82	186	152	-34
0005	2F	12	13	564	136	56400	45920	-10480	0.24	0.81	99	81	-18
0005	2F	12	14	315	54	31500	22840	-8660	0.17	0.73	55	40	-15
0005	2F	12	15	152	17	15200	12170	-3030	0.11	0.80	26	21	-5
0005	2F	12	16	66	8	6600	2750	-3850	0.12	0.42	11	4	-7
0005	2F	12	23	72	10	7200	6860	-340	0.14	0.95	12	12	0
0005	2F	12	24	42	3	4200	5340	1140	0.07	1.27	7	9	2
0005	2F	12	25	19	0	1900	0	-1900	0.00	0.00	3	0	-3
0005	2F	12	26	9	1	900	5510	4610	0.11	6.12	1	9	8
0005	2F	13	12	1024	310	102400	91030	-11370	0.30	0.89	181	161	-20
0005	2F	13	13	565	131	56500	51850	-4650	0.23	0.92	100	91	-9
0005	2F	13	14	432	102	43200	38020	-5180	0.24	0.88	76	67	-9
0005	2F	13	15	144	20	14400	9750	-4650	0.14	0.68	25	17	-8
0005	2F	13	16	80	11	8000	5830	-2170	0.14	0.73	14	10	-4
0005	2F	13	23	61	6	6100	4770	-1330	0.10	0.78	10	8	-2
0009	1T	1	1	11201	6366	1120100	1027150	-92950	0.57	0.92	1982	1817	-165
0009	1T	1	2	1775	652	177500	153610	-23890	0.37	0.87	314	271	-43
0009	1T	2	1	10865	5983	1086500	985790	-100710	0.55	0.91	1923	1744	-179
0009	1T	2	2	1805	696	180500	172370	-8130	0.39	0.95	319	305	-14
0009	1T	3	1	10996	6304	1099600	1033840	-65760	0.57	0.94	1946	1829	-117
0009	1T	3	2	1799	651	179900	166660	-13240	0.36	0.93	318	294	-24
0009	1T	4	1	8927	5405	892700	825000	-67700	0.61	0.92	1580	1460	-120
0009	1T	4	2	1436	542	143600	128330	-15270	0.38	0.89	254	227	-27
0009	1T	5	1	7772	4930	777200	719360	-57840	0.63	0.93	1375	1273	-102
0009	1T	5	2	487	147	48700	37880	-10820	0.30	0.78	86	67	-19
0009	1T	6	1	627	372	62700	53670	-9030	0.59	0.86	110	94	-16
0009	1T	6	2	33	13	3300	3180	-120	0.39	0.96	5	5	0
0009	1T	7	1	12635	7863	1263500	1162610	-100890	0.62	0.92	2236	2057	-179
0009	1T	7	2	854	273	85400	72380	-13020	0.32	0.85	151	128	-23
0009	2F	1	12	5549	1724	554900	467930	-86970	0.31	0.84	982	828	-154
0009	2F	1	13	3283	1013	328300	274440	-53860	0.31	0.84	581	485	-96
0009	2F	1	14	1427	378	142700	111490	-31210	0.26	0.78	252	197	-55
0009	2F	1	15	221	54	22100	19880	-2220	0.24	0.90	39	35	-4
0009	2F	1	16	223	49	22300	17730	-4570	0.22	0.80	39	31	-8
0009	2F	1	23	187	41	18700	16380	-2320	0.22	0.88	33	28	-5
0009	2F	1	24	105	19	10500	10360	-140	0.18	0.99	18	18	0
0009	2F	1	25	7	0	700	0	-700	0.00	0.00	1	0	-1
0009	2F	1	26	40	6	4000	3010	-990	0.15	0.75	7	5	-2
0009	2F	2	12	4886	1604	488600	411600	-77000	0.33	0.84	864	728	-136
0009	2F	2	13	3254	969	325400	255490	-69910	0.30	0.79	575	452	-123
0009	2F	2	14	1585	486	158500	129080	-29420	0.31	0.81	280	228	-52
0009	2F	2	15	417	107	41700	38730	-2970	0.26	0.93	73	68	-5
0009	2F	2	16	316	66	31600	30460	-1140	0.21	0.96	55	53	-2
0009	2F	2	23	203	49	20300	22480	2180	0.24	1.11	35	39	4
0009	2F	2	24	78	19	7800	8380	580	0.24	1.07	13	14	1
0009	2F	2	25	55	7	5500	3150	-2350	0.13	0.57	9	5	-4
0009	2F	2	26	77	14	7700	5010	-2690	0.18	0.65	13	8	-5
0009	2F	3	12	5141	1761	514100	444670	-69430	0.34	0.86	909	787	-122
0009	2F	3	13	3006	913	300600	234180	-66420	0.30	0.78	532	414	-118
0009	2F	3	14	1800	460	180000	133860	-46140	0.26	0.74	318	236	-82
0009	2F	3	15	433	89	43300	31380	-11920	0.21	0.72	76	55	-21
0009	2F	3	16	336	71	33600	33640	40	0.21	1.00	59	59	0
0009	2F	3	23	179	34	17900	14540	-3360	0.19	0.81	31	25	-6
0009	2F	3	24	120	23	12000	11460	-540	0.19	0.96	21	20	-1
0009	2F	3	25	68	10	6800	4210	-2590	0.15	0.62	12	7	-5
0009	2F	3	26	87	16	8700	6990	-1710	0.18	0.80	15	12	-3
0009	2F	4	12	4460	1544	446000	375950	-70050	0.35	0.84	789	665	-124
0009	2F	4	13	2425	783	242500	201780	-40720	0.32	0.83	429	357	-72
0009	2F	4	14	1377	415	137700	116050	-21650	0.30	0.84	243	205	-38
0009	2F	4	15	341	89	34100	30630	-3470	0.26	0.90	60	54	-6
0009	2F	4	16	152	32	15200	16410	1210	0.21	1.08	26	29	3
0009	2F	4	23	155	41	15500	12170	-3330	0.26	0.79	27	21	-6
0009	2F	4	24	110	20	11000	5690	-5310	0.18	0.52	19	10	-9
0009	2F	4	25	84	10	8400	4980	-3420	0.12	0.59	14	8	-6
0009	2F	4	26	49	8	4900	3830	-1070	0.16	0.78	8	6	-2
0009	2F	5	12	4172	1510	417200	347180	-70020	0.36	0.83	738	614	-124
0009	2F	5	13	1828	563	182800	141750	-41050	0.31	0.78	323	250	-73
0009	2F	5	14	1119	327	111900	89570	-22330	0.29	0.80	198	158	-40
0009	2F	5	15	252	54	25200	20100	-5100	0.21	0.80	44	35	-9
0009	2F	5	16	174	31	17400	15560	-1840	0.18	0.89	30	27	-3
0009	2F	5	23	46	5	4600	2100	-2500	0.11	0.46	8	3	-5
0009	2F	5	24	23	2	2300	810	-1490	0.09	0.35	4	1	-3
0009	2F	5	25	21	0	2100	0	-2100	0.00	0.00	3	0	-3
0009	2F	5	26	24	0	2400	0	-2400	0.00	0.00	4	0	-4
0009	2F	6	12	328	118	32800	27800	-5000	0.36	0.85	58	49	-9
0009	2F	6	13	143	53	14300	13510	-790	0.37	0.94	25	23	-2
0009	2F	6	14	88	16	8800	3800	-5000	0.18	0.43	15	6	-9
0009	2F	6	15	25	6	2500	3050	550	0.24	1.22	4	5	1
0009	2F	6	16	24	9	2400	4110	1710	0.38	1.71	4	7	3
0009	2F	6	23	4	1	400	850	450	0.25	2.13	0	1	1
0009	2F	6	24	3	0	300	0	-300	0.00	0.00	0	0	0
0009	2F	6	25	1	0	100	0	-100	0.00	0.00	0	0	0
0009	2F	6	26	1	0	100	0	-100	0.00	0.00	0	0	0
0009	2F	7	12	7260	2482	726000	609260	-116740	0.34	0.84	1284	1078	-206
0009	2F	7	13	2791	828	279100	215660	-63440	0.30	0.77	493	381	-112
0009	2F	7	14	1552	426	155200	119560	-35640	0.27	0.77	274	211	-63
0009	2F	7	15	409	82	40900	35500	-5400	0.20	0.87	72	62	-10
0009	2F	7	16	328	61	32800	29420	-3380	0.19	0.90	58	52	-6
0009	2F	7	23	67	14	6700	4580	-2120	0.21	0.68	11	8	-3
0009	2F	7	24	25	7	2500	2120	-380	0.28	0.85	4	3	-1
0009	2F	7	25	34	3	3400	990	-2410	0.09	0.29	6	1	-5
0009	2F	7	26	36	6	3600	3400	-200	0.17	0.94	6	6	0
0009	2T	1	12	5502	1270	550200	438220	-111980	0.23	0.80	973	775	-198
0009	2T	1	13	3283	699	328300	250110	-78190	0.21	0.76	581	442	-139
0009	2T	1	14	1427	278	142700	111800	-30900	0.19	0.78	252	197	-55
0009	2T	1	15	221	39	22100	20070	-2030	0.18	0.91	39	35	-4
0009	2T	1	16	223	34	22300	20480	-1820	0.15	0.92	39	36	-3
0009	2T	1	21	47	5	4700	3610	-1090	0.11	0.77	8	6	-2
0009	2T	1	23	187	23	18700	14490	-4210	0.12	0.77	33	25	-8
0009	2T	1	24	105	8	10500	7830	-2670	0.08	0.75	18	13	-5
0009	2T	1	25	7	0	700	0	-700	0.00	0.00	1	0	-1
0009	2T	1	26	40	2	4000	1030	-2970	0.05	0.26	7	1	-6
0009	2T	2	12	4845	1137	484500	385790	-98710	0.23	0.80	857	682	-175
0009	2T	2	13	3254	712	325400	259260	-66140	0.22	0.80	575	458	-117
0009	2T	2	14	1585	349	158500	129310	-29190	0.22	0.82	280	228	-52
0009	2T	2	15	417	69	41700	35750	-5950	0.17	0.86	73	63	-10
0009	2T	2	16	316	48	31600	30320	-1280	0.15	0.96	55	53	-2
0009	2T	2	21	41	5	4100	3650	-450	0.12	0.89	7	6	-1
0009	2T	2	23	203	25	20300	12860	-7440	0.12	0.63	35	22	-13
0009	2T	2	24	78	12	7800	9930	2130	0.15	1.27	13	17	4
0009	2T	2	25	55	6	5500	5960	460	0.11	1.08	9	10	1
0009	2T	2	26	77	9	7700	6470	-1230	0.12	0.84	13	11	-2
0009	2T	3	12	5098	1316	509800	440380	-69420	0.26	0.86	902	779	-123
0009	2T	3	13	3006	662	300600	231890	-68710	0.22	0.77	532	410	-122
0009	2T	3	14	1800	323	180000	136420	-43580	0.18	0.76	318	241	-77
0009	2T	3	15	433	63	43300	32450	-10850	0.15	0.75	76	57	-19
0009	2T	3	16	336	47	33600	37500	3900	0.14	1.12	59	66	7
0009	2T	3	21	43	5	4300	4480	180	0.12	1.04	7	7	0
0009	2T	3	23	179	22	17900	16000	-1900	0.12	0.89	31	28	-3
0009	2T	3	24	120	14	12000	12320	320	0.12	1.03	21	21	0
0009	2T	3	25	68	8	6800	6140	-660	0.12	0.90	12	10	-2
0009	2T	3	26	87	7	8700	6030	-2670	0.08	0.69	15	10	-5
0009	2T	4	12	4430	1174	443000	368140	-74860	0.27	0.83	784	651	-133
0009	2T	4	13	2425	602	242500	203730	-38770	0.25	0.84	429	360	-69
0009	2T	4	14	1377	314	137700	118510	-19190	0.23	0.86	243	209	-34
0009	2T	4	15	341	69	34100	33690	-410	0.20	0.99	60	59	-1
0009	2T	4	16	152	22	15200	15790	590	0.14	1.04	26	27	1
0009	2T	4	21	30	3	3000	3270	270	0.10	1.09	5	5	0
0009	2T	4	23	155	19	15500	8880	-6620	0.12	0.57	27	15	-12
0009	2T	4	24	110	12	11000	5780	-5220	0.11	0.53	19	10	-9
0009	2T	4	25	84	5	8400	3410	-4990	0.06	0.41	14	6	-8
0009	2T	4	26	49	5	4900	3330	-1570	0.10	0.68	8	5	-3
0009	2T	5	12	4158	1185	415800	340090	-75710	0.28	0.82	735	601	-134
0009	2T	5	13	1828	409	182800	135580	-47220	0.22	0.74	323	239	-84
0009	2T	5	14	1119	245	111900	92540	-19360	0.22	0.83	198	163	-35
0009	2T	5	15	252	39	25200	20930	-4270	0.15	0.83	44	37	-7
0009	2T	5	16	174	25	17400	18430	1030	0.14	1.06	30	32	2
0009	2T	5	21	14	1	1400	450	-950	0.07	0.32	2	0	-2
0009	2T	5	23	46	1	4600	520	-4080	0.02	0.11	8	0	-8
0009	2T	5	24	23	0	2300	0	-2300	0.00	0.00	4	0	-4
0009	2T	5	25	21	0	2100	0	-2100	0.00	0.00	3	0	-3
0009	2T	5	26	24	0	2400	0	-2400	0.00	0.00	4	0	-4
0009	2T	6	12	326	90	32600	26010	-6590	0.28	0.80	57	46	-11
0009	2T	6	13	143	36	14300	11440	-2860	0.25	0.80	25	20	-5
0009	2T	6	14	88	10	8800	3240	-5560	0.11	0.37	15	5	-10
0009	2T	6	15	25	2	2500	2240	-260	0.08	0.90	4	3	-1
0009	2T	6	16	24	8	2400	5640	3240	0.33	2.35	4	9	5
0009	2T	6	21	2	1	200	2000	1800	0.50	10.00	0	3	3
0009	2T	6	23	4	1	400	1820	1420	0.25	4.55	0	3	3
0009	2T	6	24	3	0	300	0	-300	0.00	0.00	0	0	0
0009	2T	6	25	1	0	100	0	-100	0.00	0.00	0	0	0
0009	2T	6	26	1	0	100	0	-100	0.00	0.00	0	0	0
0009	2T	7	12	7253	1954	725300	595090	-130210	0.27	0.82	1283	1053	-230
0009	2T	7	13	2791	629	279100	205380	-73720	0.23	0.74	493	363	-130
0009	2T	7	14	1552	319	155200	120110	-35090	0.21	0.77	274	212	-62
0009	2T	7	15	409	68	40900	39930	-970	0.17	0.98	72	70	-2
0009	2T	7	16	328	48	32800	30270	-2530	0.15	0.92	58	53	-5
0009	2T	7	21	7	0	700	0	-700	0.00	0.00	1	0	-1
0009	2T	7	23	67	9	6700	5130	-1570	0.13	0.77	11	9	-2
0009	2T	7	24	25	2	2500	860	-1640	0.08	0.34	4	1	-3
0009	2T	7	25	34	2	3400	1290	-2110	0.06	0.38	6	2	-4
0009	2T	7	26	36	4	3600	3440	-160	0.11	0.96	6	6	0
0009	3F	1	123	357	94	35700	27140	-8560	0.26	0.76	63	48	-15
0009	3F	1	124	1677	384	167700	136200	-31500	0.23	0.81	296	241	-55
0009	3F	1	125	1046	178	104600	85630	-18970	0.17	0.82	185	151	-34
0009	3F	1	126	2297	222	229700	228280	-1420	0.10	0.99	406	404	-2
0009	3F	1	134	1113	250	111300	83890	-27410	0.22	0.75	196	148	-48
0009	3F	1	135	593	120	59300	47940	-11360	0.20	0.81	104	84	-20
0009	3F	1	136	1206	126	120600	94060	-26540	0.10	0.78	213	166	-47
0009	3F	1	145	297	54	29700	24590	-5110	0.18	0.83	52	43	-9
0009	3F	1	146	366	33	36600	26800	-9800	0.09	0.73	64	47	-17
0009	3F	1	156	38	5	3800	2590	-1210	0.13	0.68	6	4	-2
0009	3F	1	234	41	6	4100	2340	-1760	0.15	0.57	7	4	-3
0009	3F	1	235	48	8	4800	2950	-1850	0.17	0.61	8	5	-3
0009	3F	1	236	87	8	8700	6140	-2560	0.09	0.71	15	10	-5
0009	3F	1	245	29	3	2900	1210	-1690	0.10	0.42	5	2	-3
0009	3F	1	246	27	2	2700	2900	200	0.07	1.07	4	5	1
0009	3F	1	256	2	0	200	0	-200	0.00	0.00	0	0	0
0009	3F	2	123	492	144	49200	37970	-11230	0.29	0.77	87	67	-20
0009	3F	2	124	1520	375	152000	120050	-31950	0.25	0.79	269	212	-57
0009	3F	2	125	1113	216	111300	91090	-20210	0.19	0.82	196	161	-35
0009	3F	2	126	1548	223	154800	115340	-39460	0.14	0.75	273	204	-69
0009	3F	2	134	973	203	97300	73160	-24140	0.21	0.75	172	129	-43
0009	3F	2	135	768	139	76800	51070	-25730	0.18	0.66	135	90	-45
0009	3F	2	136	1000	163	100000	82980	-17020	0.16	0.83	176	146	-30
0009	3F	2	145	281	57	28100	22760	-5340	0.20	0.81	49	40	-9
0009	3F	2	146	303	46	30300	28570	-1730	0.15	0.94	53	50	-3
0009	3F	2	156	68	22	6800	9410	2610	0.32	1.38	12	16	4
0009	3F	2	234	34	5	3400	1820	-1580	0.15	0.54	6	3	-3
0009	3F	2	235	58	15	5800	9380	3580	0.26	1.62	10	16	6
0009	3F	2	236	74	12	7400	8210	810	0.16	1.11	13	14	1
0009	3F	2	245	20	1	2000	370	-1630	0.05	0.19	3	0	-3
0009	3F	2	246	14	1	1400	480	-920	0.07	0.34	2	0	-2
0009	3F	2	256	7	0	700	0	-700	0.00	0.00	1	0	-1
0009	3F	3	123	799	253	79900	73520	-6380	0.32	0.92	141	130	-11
0009	3F	3	124	1521	347	152100	114200	-37900	0.23	0.75	269	202	-67
0009	3F	3	125	1286	212	128600	83480	-45120	0.16	0.65	227	147	-80
0009	3F	3	126	1376	203	137600	128490	-9110	0.15	0.93	243	227	-16
0009	3F	3	134	771	174	77100	63500	-13600	0.23	0.82	136	112	-24
0009	3F	3	135	816	152	81600	62260	-19340	0.19	0.76	144	110	-34
0009	3F	3	136	802	102	80200	54000	-26200	0.13	0.67	141	95	-46
0009	3F	3	145	469	75	46900	30760	-16140	0.16	0.66	83	54	-29
0009	3F	3	146	258	30	25800	16960	-8840	0.12	0.66	45	30	-15
0009	3F	3	156	75	10	7500	4990	-2510	0.13	0.67	13	8	-5
0009	3F	3	234	41	7	4100	2420	-1680	0.17	0.59	7	4	-3
0009	3F	3	235	43	8	4300	2350	-1950	0.19	0.55	7	4	-3
0009	3F	3	236	56	8	5600	4820	-780	0.14	0.86	9	8	-1
0009	3F	3	245	32	3	3200	1120	-2080	0.09	0.35	5	1	-4
0009	3F	3	246	21	4	2100	7840	5740	0.19	3.73	3	13	10
0009	3F	3	256	8	2	800	790	-10	0.25	0.99	1	1	0
0009	3F	4	123	935	287	93500	80000	-13500	0.31	0.86	165	141	-24
0009	3F	4	124	1588	333	158800	110930	-47870	0.21	0.70	281	196	-85
0009	3F	4	125	1031	195	103100	84700	-18400	0.19	0.82	182	149	-33
0009	3F	4	126	761	98	76100	58600	-17500	0.13	0.77	134	103	-31
0009	3F	4	134	695	160	69500	57330	-12170	0.23	0.82	123	101	-22
0009	3F	4	135	647	116	64700	48200	-16500	0.18	0.74	114	85	-29
0009	3F	4	136	476	74	47600	38730	-8870	0.16	0.81	84	68	-16
0009	3F	4	145	292	45	29200	18710	-10490	0.15	0.64	51	33	-18
0009	3F	4	146	150	28	15000	14650	-350	0.19	0.98	26	25	-1
0009	3F	4	156	34	7	3400	4600	1200	0.21	1.35	6	8	2
0009	3F	4	234	33	6	3300	1690	-1610	0.18	0.51	5	2	-3
0009	3F	4	235	54	8	5400	3200	-2200	0.15	0.59	9	5	-4
0009	3F	4	236	29	4	2900	2270	-630	0.14	0.78	5	4	-1
0009	3F	4	245	34	6	3400	1870	-1530	0.18	0.55	6	3	-3
0009	3F	4	246	21	1	2100	150	-1950	0.05	0.07	3	0	-3
0009	3F	4	256	9	2	900	1000	100	0.22	1.11	1	1	0
0009	3F	5	123	833	249	83300	64970	-18330	0.30	0.78	147	114	-33
0009	3F	5	124	1940	423	194000	142340	-51660	0.22	0.73	343	251	-92
0009	3F	5	125	710	121	71000	48200	-22800	0.17	0.68	125	85	-40
0009	3F	5	126	585	103	58500	62370	3870	0.18	1.07	103	110	7
0009	3F	5	134	599	130	59900	41640	-18260	0.22	0.70	106	73	-33
0009	3F	5	135	412	69	41200	30280	-10920	0.17	0.73	72	53	-19
0009	3F	5	136	264	43	26400	20300	-6100	0.16	0.77	46	35	-11
0009	3F	5	145	227	47	22700	17530	-5170	0.21	0.77	40	31	-9
0009	3F	5	146	116	24	11600	9710	-1890	0.21	0.84	20	17	-3
0009	3F	5	156	31	3	3100	790	-2310	0.10	0.25	5	1	-4
0009	3F	5	234	11	1	1100	400	-700	0.09	0.36	1	0	-1
0009	3F	5	235	14	1	1400	440	-960	0.07	0.31	2	0	-2
0009	3F	5	236	10	1	1000	1040	40	0.10	1.04	1	1	0
0009	3F	5	245	1	0	100	0	-100	0.00	0.00	0	0	0
0009	3F	5	246	9	1	900	430	-470	0.11	0.48	1	0	-1
0009	3F	5	256	3	1	300	1140	840	0.33	3.80	0	2	2
0009	3F	6	123	63	14	6300	3900	-2400	0.22	0.62	11	6	-5
0009	3F	6	124	158	30	15800	9220	-6580	0.19	0.58	27	16	-11
0009	3F	6	125	53	13	5300	6170	870	0.25	1.16	9	10	1
0009	3F	6	126	48	10	4800	6530	1730	0.21	1.36	8	11	3
0009	3F	6	134	49	9	4900	2470	-2430	0.18	0.50	8	4	-4
0009	3F	6	135	32	5	3200	1070	-2130	0.16	0.33	5	1	-4
0009	3F	6	136	24	2	2400	1290	-1110	0.08	0.54	4	2	-2
0009	3F	6	145	14	4	1400	1640	240	0.29	1.17	2	2	0
0009	3F	6	146	10	2	1000	600	-400	0.20	0.60	1	1	0
0009	3F	6	156	2	0	200	0	-200	0.00	0.00	0	0	0
0009	3F	6	235	2	1	200	840	640	0.50	4.20	0	1	1
0009	3F	6	236	1	0	100	0	-100	0.00	0.00	0	0	0
0009	3F	6	245	1	0	100	0	-100	0.00	0.00	0	0	0
0009	3F	6	246	1	0	100	0	-100	0.00	0.00	0	0	0
0009	3F	6	256	1	0	100	0	-100	0.00	0.00	0	0	0
0009	3F	7	123	1707	480	170700	145270	-25430	0.28	0.85	302	257	-45
0009	3F	7	124	2954	600	295400	223010	-72390	0.20	0.75	522	394	-128
0009	3F	7	125	1206	224	120600	103410	-17190	0.19	0.86	213	183	-30
0009	3F	7	126	1011	137	101100	81110	-19990	0.14	0.80	178	143	-35
0009	3F	7	134	816	173	81600	65550	-16050	0.21	0.80	144	116	-28
0009	3F	7	135	621	98	62100	40430	-21670	0.16	0.65	109	71	-38
0009	3F	7	136	431	53	43100	30570	-12530	0.12	0.71	76	54	-22
0009	3F	7	145	252	29	25200	14900	-10300	0.12	0.59	44	26	-18
0009	3F	7	146	180	25	18000	14340	-3660	0.14	0.80	31	25	-6
0009	3F	7	156	45	4	4500	1970	-2530	0.09	0.44	7	3	-4
0009	3F	7	234	10	1	1000	280	-720	0.10	0.28	1	0	-1
0009	3F	7	235	17	4	1700	2520	820	0.24	1.48	3	4	1
0009	3F	7	236	5	1	500	410	-90	0.20	0.82	0	0	0
0009	3F	7	245	7	0	700	0	-700	0.00	0.00	1	0	-1
0009	3F	7	246	1	0	100	0	-100	0.00	0.00	0	0	0
0009	3F	7	256	6	0	600	0	-600	0.00	0.00	1	0	-1
0009	3T	1	123	337	39	33700	26520	-7180	0.12	0.79	59	46	-13
0009	3T	1	124	1662	156	166200	138900	-27300	0.09	0.84	294	245	-49
0009	3T	1	125	1031	71	103100	83400	-19700	0.07	0.81	182	147	-35
0009	3T	1	126	2273	90	227300	201670	-25630	0.04	0.89	402	356	-46
0009	3T	1	132	17	1	1700	430	-1270	0.06	0.25	3	0	-3
0009	3T	1	134	1109	101	110900	76470	-34430	0.09	0.69	196	135	-61
0009	3T	1	135	579	50	57900	52710	-5190	0.09	0.91	102	93	-9
0009	3T	1	136	1200	51	120000	87920	-32080	0.04	0.73	212	155	-57
0009	3T	1	143	4	0	400	0	-400	0.00	0.00	0	0	0
0009	3T	1	145	276	18	27600	21810	-5790	0.07	0.79	48	38	-10
0009	3T	1	146	335	12	33500	19700	-13800	0.04	0.59	59	34	-25
0009	3T	1	152	10	0	1000	0	-1000	0.00	0.00	1	0	-1
0009	3T	1	153	14	0	1400	0	-1400	0.00	0.00	2	0	-2
0009	3T	1	154	21	3	2100	7260	5160	0.14	3.46	3	12	9
0009	3T	1	156	33	0	3300	0	-3300	0.00	0.00	5	0	-5
0009	3T	1	163	6	0	600	0	-600	0.00	0.00	1	0	-1
0009	3T	1	164	31	1	3100	1260	-1840	0.03	0.41	5	2	-3
0009	3T	1	165	5	1	500	3550	3050	0.20	7.10	0	6	6
0009	3T	1	213	3	0	300	0	-300	0.00	0.00	0	0	0
0009	3T	1	214	15	0	1500	0	-1500	0.00	0.00	2	0	-2
0009	3T	1	215	5	0	500	0	-500	0.00	0.00	0	0	0
0009	3T	1	216	24	0	2400	0	-2400	0.00	0.00	4	0	-4
0009	3T	1	234	39	1	3900	1520	-2380	0.03	0.39	6	2	-4
0009	3T	1	235	48	1	4800	1230	-3570	0.02	0.26	8	2	-6
0009	3T	1	236	87	5	8700	11100	2400	0.06	1.28	15	19	4
0009	3T	1	243	2	0	200	0	-200	0.00	0.00	0	0	0
0009	3T	1	245	29	1	2900	1980	-920	0.03	0.68	5	3	-2
0009	3T	1	246	27	1	2700	6600	3900	0.04	2.44	4	11	7
0009	3T	1	256	2	0	200	0	-200	0.00	0.00	0	0	0
0009	3T	2	123	483	53	48300	33550	-14750	0.11	0.69	85	59	-26
0009	3T	2	124	1508	142	150800	123710	-27090	0.09	0.82	266	218	-48
0009	3T	2	125	1103	84	110300	89330	-20970	0.08	0.81	195	158	-37
0009	3T	2	126	1527	86	152700	129650	-23050	0.06	0.85	270	229	-41
0009	3T	2	132	8	0	800	0	-800	0.00	0.00	1	0	-1
0009	3T	2	134	958	94	95800	88650	-7150	0.10	0.93	169	156	-13
0009	3T	2	135	756	52	75600	48410	-27190	0.07	0.64	133	85	-48
0009	3T	2	136	999	67	99900	94170	-5730	0.07	0.94	176	166	-10
0009	3T	2	142	4	0	400	0	-400	0.00	0.00	0	0	0
0009	3T	2	143	15	2	1500	1730	230	0.13	1.15	2	3	1
0009	3T	2	145	267	15	26700	13440	-13260	0.06	0.50	47	23	-24
0009	3T	2	146	298	22	29800	30220	420	0.07	1.01	52	53	1
0009	3T	2	152	2	0	200	0	-200	0.00	0.00	0	0	0
0009	3T	2	153	12	0	1200	0	-1200	0.00	0.00	2	0	-2
0009	3T	2	154	14	1	1400	980	-420	0.07	0.70	2	1	-1
0009	3T	2	156	68	8	6800	15020	8220	0.12	2.21	12	26	14
0009	3T	2	163	1	0	100	0	-100	0.00	0.00	0	0	0
0009	3T	2	164	5	0	500	0	-500	0.00	0.00	0	0	0
0009	3T	2	213	1	0	100	0	-100	0.00	0.00	0	0	0
0009	3T	2	214	8	0	800	0	-800	0.00	0.00	1	0	-1
0009	3T	2	215	8	0	800	0	-800	0.00	0.00	1	0	-1
0009	3T	2	216	21	1	2100	4110	2010	0.05	1.96	3	7	4
0009	3T	2	234	34	0	3400	0	-3400	0.00	0.00	6	0	-6
0009	3T	2	235	57	6	5700	10390	4690	0.11	1.82	10	18	8
0009	3T	2	236	73	3	7300	7290	-10	0.04	1.00	12	12	0
0009	3T	2	245	20	1	2000	1350	-650	0.05	0.68	3	2	-1
0009	3T	2	246	14	0	1400	0	-1400	0.00	0.00	2	0	-2
0009	3T	2	253	1	0	100	0	-100	0.00	0.00	0	0	0
0009	3T	2	256	7	0	700	0	-700	0.00	0.00	1	0	-1
0009	3T	2	263	1	0	100	0	-100	0.00	0.00	0	0	0
0009	3T	3	123	795	113	79500	75850	-3650	0.14	0.95	140	134	-6
0009	3T	3	124	1504	143	150400	104300	-46100	0.10	0.69	266	184	-82
0009	3T	3	125	1273	93	127300	94730	-32570	0.07	0.74	225	167	-58
0009	3T	3	126	1359	105	135900	141730	5830	0.08	1.04	240	250	10
0009	3T	3	132	3	0	300	0	-300	0.00	0.00	0	0	0
0009	3T	3	134	753	78	75300	71590	-3710	0.10	0.95	133	126	-7
0009	3T	3	135	806	57	80600	61810	-18790	0.07	0.77	142	109	-33
0009	3T	3	136	800	42	80000	51940	-28060	0.05	0.65	141	91	-50
0009	3T	3	142	5	0	500	0	-500	0.00	0.00	0	0	0
0009	3T	3	143	18	1	1800	3590	1790	0.06	1.99	3	6	3
0009	3T	3	145	464	27	46400	30480	-15920	0.06	0.66	82	53	-29
0009	3T	3	146	258	9	25800	11370	-14430	0.03	0.44	45	20	-25
0009	3T	3	153	10	1	1000	1390	390	0.10	1.39	1	2	1
0009	3T	3	154	5	1	500	980	480	0.20	1.96	0	1	1
0009	3T	3	156	75	5	7500	8160	660	0.07	1.09	13	14	1
0009	3T	3	163	2	0	200	0	-200	0.00	0.00	0	0	0
0009	3T	3	213	1	1	100	2190	2090	1.00	21.90	0	3	3
0009	3T	3	214	12	0	1200	0	-1200	0.00	0.00	2	0	-2
0009	3T	3	215	13	0	1300	0	-1300	0.00	0.00	2	0	-2
0009	3T	3	216	17	0	1700	0	-1700	0.00	0.00	3	0	-3
0009	3T	3	234	41	3	4100	3460	-640	0.07	0.84	7	6	-1
0009	3T	3	235	41	1	4100	680	-3420	0.02	0.17	7	1	-6
0009	3T	3	236	56	2	5600	2260	-3340	0.04	0.40	9	4	-5
0009	3T	3	245	32	1	3200	1420	-1780	0.03	0.44	5	2	-3
0009	3T	3	246	21	1	2100	30170	28070	0.05	14.37	3	53	50
0009	3T	3	253	2	1	200	1100	900	0.50	5.50	0	1	1
0009	3T	3	256	8	0	800	0	-800	0.00	0.00	1	0	-1
0009	3T	4	123	928	129	92800	82640	-10160	0.14	0.89	164	146	-18
0009	3T	4	124	1575	154	157500	127980	-29520	0.10	0.81	278	226	-52
0009	3T	4	125	1025	75	102500	80340	-22160	0.07	0.78	181	142	-39
0009	3T	4	126	751	40	75100	55360	-19740	0.05	0.74	132	97	-35
0009	3T	4	132	5	1	500	860	360	0.20	1.72	0	1	1
0009	3T	4	134	674	81	67400	70760	3360	0.12	1.05	119	125	6
0009	3T	4	135	643	54	64300	57640	-6660	0.08	0.90	113	102	-11
0009	3T	4	136	474	40	47400	41420	-5980	0.08	0.87	83	73	-10
0009	3T	4	142	1	0	100	0	-100	0.00	0.00	0	0	0
0009	3T	4	143	21	1	2100	860	-1240	0.05	0.41	3	1	-2
0009	3T	4	145	289	16	28900	20360	-8540	0.06	0.70	51	36	-15
0009	3T	4	146	148	17	14800	22680	7880	0.11	1.53	26	40	14
0009	3T	4	153	4	0	400	0	-400	0.00	0.00	0	0	0
0009	3T	4	154	3	0	300	0	-300	0.00	0.00	0	0	0
0009	3T	4	156	34	4	3400	4830	1430	0.12	1.42	6	8	2
0009	3T	4	163	2	0	200	0	-200	0.00	0.00	0	0	0
0009	3T	4	164	2	0	200	0	-200	0.00	0.00	0	0	0
0009	3T	4	213	2	0	200	0	-200	0.00	0.00	0	0	0
0009	3T	4	214	12	1	1200	890	-310	0.08	0.74	2	1	-1
0009	3T	4	215	6	0	600	0	-600	0.00	0.00	1	0	-1
0009	3T	4	216	10	1	1000	10090	9090	0.10	10.09	1	17	16
0009	3T	4	234	33	0	3300	0	-3300	0.00	0.00	5	0	-5
0009	3T	4	235	54	1	5400	340	-5060	0.02	0.06	9	0	-9
0009	3T	4	236	28	2	2800	2250	-550	0.07	0.80	4	3	-1
0009	3T	4	245	33	1	3300	1140	-2160	0.03	0.35	5	2	-3
0009	3T	4	246	21	1	2100	390	-1710	0.05	0.19	3	0	-3
0009	3T	4	254	1	0	100	0	-100	0.00	0.00	0	0	0
0009	3T	4	256	9	0	900	0	-900	0.00	0.00	1	0	-1
0009	3T	4	263	1	0	100	0	-100	0.00	0.00	0	0	0
0009	3T	5	123	828	113	82800	66110	-16690	0.14	0.80	146	117	-29
0009	3T	5	124	1939	201	193900	143830	-50070	0.10	0.74	343	254	-89
0009	3T	5	125	705	60	70500	57210	-13290	0.09	0.81	124	101	-23
0009	3T	5	126	578	41	57800	60880	3080	0.07	1.05	102	107	5
0009	3T	5	132	4	0	400	0	-400	0.00	0.00	0	0	0
0009	3T	5	134	590	48	59000	38080	-20920	0.08	0.65	104	67	-37
0009	3T	5	135	406	25	40600	26960	-13640	0.06	0.66	71	47	-24
0009	3T	5	136	264	19	26400	24440	-1960	0.07	0.93	46	43	-3
0009	3T	5	143	9	0	900	0	-900	0.00	0.00	1	0	-1
0009	3T	5	145	221	16	22100	15670	-6430	0.07	0.71	39	27	-12
0009	3T	5	146	112	2	11200	2840	-8360	0.02	0.25	19	5	-14
0009	3T	5	153	6	0	600	0	-600	0.00	0.00	1	0	-1
0009	3T	5	154	6	1	600	890	290	0.17	1.48	1	1	0
0009	3T	5	156	31	1	3100	1540	-1560	0.03	0.50	5	2	-3
0009	3T	5	164	4	0	400	0	-400	0.00	0.00	0	0	0
0009	3T	5	213	1	0	100	0	-100	0.00	0.00	0	0	0
0009	3T	5	214	1	0	100	0	-100	0.00	0.00	0	0	0
0009	3T	5	215	5	0	500	0	-500	0.00	0.00	0	0	0
0009	3T	5	216	7	0	700	0	-700	0.00	0.00	1	0	-1
0009	3T	5	234	11	0	1100	0	-1100	0.00	0.00	1	0	-1
0009	3T	5	235	14	0	1400	0	-1400	0.00	0.00	2	0	-2
0009	3T	5	236	10	0	1000	0	-1000	0.00	0.00	1	0	-1
0009	3T	5	245	1	0	100	0	-100	0.00	0.00	0	0	0
0009	3T	5	246	9	0	900	0	-900	0.00	0.00	1	0	-1
0009	3T	5	256	3	0	300	0	-300	0.00	0.00	0	0	0
0009	3T	6	123	63	4	6300	2150	-4150	0.06	0.34	11	3	-8
0009	3T	6	124	158	12	15800	8290	-7510	0.08	0.52	27	14	-13
0009	3T	6	125	53	7	5300	7840	2540	0.13	1.48	9	13	4
0009	3T	6	126	46	4	4600	12790	8190	0.09	2.78	8	22	14
0009	3T	6	134	48	6	4800	3970	-830	0.13	0.83	8	7	-1
0009	3T	6	135	32	2	3200	980	-2220	0.06	0.31	5	1	-4
0009	3T	6	136	24	0	2400	0	-2400	0.00	0.00	4	0	-4
0009	3T	6	143	1	0	100	0	-100	0.00	0.00	0	0	0
0009	3T	6	145	14	1	1400	820	-580	0.07	0.59	2	1	-1
0009	3T	6	146	9	0	900	0	-900	0.00	0.00	1	0	-1
0009	3T	6	156	2	0	200	0	-200	0.00	0.00	0	0	0
0009	3T	6	164	1	0	100	0	-100	0.00	0.00	0	0	0
0009	3T	6	216	2	1	200	8510	8310	0.50	42.55	0	15	15
0009	3T	6	235	2	1	200	4620	4420	0.50	23.10	0	8	8
0009	3T	6	236	1	0	100	0	-100	0.00	0.00	0	0	0
0009	3T	6	245	1	0	100	0	-100	0.00	0.00	0	0	0
0009	3T	6	246	1	0	100	0	-100	0.00	0.00	0	0	0
0009	3T	6	256	1	0	100	0	-100	0.00	0.00	0	0	0
0009	3T	7	123	1702	230	170200	152450	-17750	0.14	0.90	301	269	-32
0009	3T	7	124	2940	261	294000	219650	-74350	0.09	0.75	520	388	-132
0009	3T	7	125	1198	96	119800	103680	-16120	0.08	0.87	212	183	-29
0009	3T	7	126	1008	63	100800	92920	-7880	0.06	0.92	178	164	-14
0009	3T	7	132	5	1	500	450	-50	0.20	0.90	0	0	0
0009	3T	7	134	789	72	78900	62810	-16090	0.09	0.80	139	111	-28
0009	3T	7	135	616	47	61600	43650	-17950	0.08	0.71	109	77	-32
0009	3T	7	136	431	30	43100	38560	-4540	0.07	0.89	76	68	-8
0009	3T	7	142	12	0	1200	0	-1200	0.00	0.00	2	0	-2
0009	3T	7	143	27	3	2700	2310	-390	0.11	0.86	4	4	0
0009	3T	7	145	248	13	24800	19510	-5290	0.05	0.79	43	34	-9
0009	3T	7	146	180	10	18000	15600	-2400	0.06	0.87	31	27	-4
0009	3T	7	152	6	0	600	0	-600	0.00	0.00	1	0	-1
0009	3T	7	153	5	2	500	2130	1630	0.40	4.26	0	3	3
0009	3T	7	154	4	0	400	0	-400	0.00	0.00	0	0	0
0009	3T	7	156	44	1	4400	2530	-1870	0.02	0.58	7	4	-3
0009	3T	7	165	1	0	100	0	-100	0.00	0.00	0	0	0
0009	3T	7	214	2	0	200	0	-200	0.00	0.00	0	0	0
0009	3T	7	215	2	0	200	0	-200	0.00	0.00	0	0	0
0009	3T	7	216	3	0	300	0	-300	0.00	0.00	0	0	0
0009	3T	7	234	10	1	1000	1140	140	0.10	1.14	1	2	1
0009	3T	7	235	16	2	1600	4840	3240	0.13	3.03	2	8	6
0009	3T	7	236	5	0	500	0	-500	0.00	0.00	0	0	0
0009	3T	7	245	7	0	700	0	-700	0.00	0.00	1	0	-1
0009	3T	7	246	1	0	100	0	-100	0.00	0.00	0	0	0
0009	3T	7	253	1	0	100	0	-100	0.00	0.00	0	0	0
0009	3T	7	256	6	0	600	0	-600	0.00	0.00	1	0	-1
0005	2F	13	24	37	3	3700	2560	-1140	0.08	0.69	6	4	-2
0005	2F	13	25	28	2	2800	730	-2070	0.07	0.26	4	1	-3
0005	2F	13	26	11	1	1100	530	-570	0.09	0.48	1	0	-1
0005	2F	14	12	902	256	90200	78990	-11210	0.28	0.88	159	139	-20
0005	2F	14	13	525	116	52500	45280	-7220	0.22	0.86	92	80	-12
0005	2F	14	14	405	86	40500	30100	-10400	0.21	0.74	71	53	-18
0005	2F	14	15	153	11	15300	6970	-8330	0.07	0.46	27	12	-15
0005	2F	14	16	65	6	6500	3490	-3010	0.09	0.54	11	6	-5
0003	1T	nopattern	1	64293	37127	6429300	5975460	-453840	0.58	0.93	11379	10576	-803
0003	1T	nopattern	2	6222	2053	622200	602750	-19450	0.33	0.97	1101	1066	-35
0003	2F	nopattern	12	27173	8333	2717300	2356420	-360880	0.31	0.87	4809	4170	-639
0003	2F	nopattern	13	15757	4034	1575700	1345680	-230020	0.26	0.85	2788	2381	-407
0003	2F	nopattern	14	9381	2030	938100	756890	-181210	0.22	0.81	1660	1339	-321
0003	2F	nopattern	15	3590	547	359000	319210	-39790	0.15	0.89	635	564	-71
0003	2F	nopattern	16	1823	265	182300	164880	-17420	0.15	0.90	322	291	-31
0003	2F	nopattern	23	1189	169	118900	100950	-17950	0.14	0.85	210	178	-32
0003	2F	nopattern	24	669	110	66900	56200	-10700	0.16	0.84	118	99	-19
0003	2F	nopattern	25	474	47	47400	33890	-13510	0.10	0.71	83	59	-24
0003	2F	nopattern	26	343	46	34300	28260	-6040	0.13	0.82	60	50	-10
0003	2T	nopattern	12	25196	5877	2519600	2094290	-425310	0.23	0.83	4459	3706	-753
0003	2T	nopattern	13	15757	3096	1575700	1322510	-253190	0.20	0.84	2788	2340	-448
0003	2T	nopattern	14	9381	1526	938100	743410	-194690	0.16	0.79	1660	1315	-345
0003	2T	nopattern	15	3590	402	359000	313650	-45350	0.11	0.87	635	555	-80
0003	2T	nopattern	16	1823	190	182300	162750	-19550	0.10	0.89	322	288	-34
0003	2T	nopattern	21	1977	259	197700	196420	-1280	0.13	0.99	349	347	-2
0003	2T	nopattern	23	1189	100	118900	111170	-7730	0.08	0.93	210	196	-14
0003	2T	nopattern	24	669	73	66900	63180	-3720	0.11	0.94	118	111	-7
0003	2T	nopattern	25	474	31	47400	38460	-8940	0.07	0.81	83	68	-15
0003	2T	nopattern	26	343	30	34300	29680	-4620	0.09	0.87	60	52	-8
0003	3F	nopattern	123	11670	2449	1167000	960490	-206510	0.21	0.82	2065	1699	-366
0003	3F	nopattern	124	9405	1685	940500	729180	-211320	0.18	0.78	1664	1290	-374
0003	3F	nopattern	125	5400	717	540000	447360	-92640	0.13	0.83	955	791	-164
0003	3F	nopattern	126	4028	448	402800	370800	-32000	0.11	0.92	712	656	-56
0003	3F	nopattern	134	6301	1034	630100	522570	-107530	0.16	0.83	1115	924	-191
0003	3F	nopattern	135	3407	405	340700	237180	-103520	0.12	0.70	603	419	-184
0003	3F	nopattern	136	2606	279	260600	191490	-69110	0.11	0.73	461	338	-123
0003	3F	nopattern	145	2096	208	209600	156380	-53220	0.10	0.75	370	276	-94
0003	3F	nopattern	146	1443	139	144300	112890	-31410	0.10	0.78	255	199	-56
0003	3F	nopattern	156	732	58	73200	62720	-10480	0.08	0.86	129	111	-18
0003	3F	nopattern	234	407	56	40700	41210	510	0.14	1.01	72	72	0
0003	3F	nopattern	235	282	28	28200	28420	220	0.10	1.01	49	50	1
0003	3F	nopattern	236	296	28	29600	27450	-2150	0.09	0.93	52	48	-4
0003	3F	nopattern	245	171	13	17100	10480	-6620	0.08	0.61	30	18	-12
0003	3F	nopattern	246	140	12	14000	16210	2210	0.09	1.16	24	28	4
0003	3F	nopattern	256	114	7	11400	6170	-5230	0.06	0.54	20	10	-10
0003	3T	nopattern	123	7289	689	728900	613850	-115050	0.09	0.84	1290	1086	-204
0003	3T	nopattern	124	6551	498	655100	506060	-149040	0.08	0.77	1159	895	-264
0003	3T	nopattern	125	4154	252	415400	361560	-53840	0.06	0.87	735	639	-96
0003	3T	nopattern	126	3192	126	319200	253930	-65270	0.04	0.80	564	449	-115
0003	3T	nopattern	132	3758	279	375800	338620	-37180	0.07	0.90	665	599	-66
0003	3T	nopattern	134	3993	312	399300	408580	9280	0.08	1.02	706	723	17
0003	3T	nopattern	135	2566	139	256600	186900	-69700	0.05	0.73	454	330	-124
0003	3T	nopattern	136	2165	110	216500	176140	-40360	0.05	0.81	383	311	-72
0003	3T	nopattern	142	2340	148	234000	206140	-27860	0.06	0.88	414	364	-50
0003	3T	nopattern	143	2308	118	230800	168000	-62800	0.05	0.73	408	297	-111
0003	3T	nopattern	145	1473	50	147300	75880	-71420	0.03	0.52	260	134	-126
0003	3T	nopattern	146	1140	48	114000	98040	-15960	0.04	0.86	201	173	-28
0003	3T	nopattern	152	829	33	82900	55490	-27410	0.04	0.67	146	98	-48
0003	3T	nopattern	153	841	28	84100	50160	-33940	0.03	0.60	148	88	-60
0003	3T	nopattern	154	623	17	62300	49070	-13230	0.03	0.79	110	86	-24
0003	3T	nopattern	156	545	17	54500	56250	1750	0.03	1.03	96	99	3
0003	3T	nopattern	162	439	21	43900	47160	3260	0.05	1.07	77	83	6
0003	3T	nopattern	163	441	12	44100	22530	-21570	0.03	0.51	78	39	-39
0003	3T	nopattern	164	303	11	30300	20150	-10150	0.04	0.67	53	35	-18
0003	3T	nopattern	165	187	2	18700	5100	-13600	0.01	0.27	33	9	-24
0003	3T	nopattern	213	481	29	48100	51870	3770	0.06	1.08	85	91	6
0003	3T	nopattern	214	414	24	41400	48560	7160	0.06	1.17	73	85	12
0003	3T	nopattern	215	346	11	34600	23920	-10680	0.03	0.69	61	42	-19
0003	3T	nopattern	216	340	12	34000	35370	1370	0.04	1.04	60	62	2
0003	3T	nopattern	231	142	2	14200	3830	-10370	0.01	0.27	25	6	-19
0003	3T	nopattern	234	244	5	24400	5720	-18680	0.02	0.23	43	10	-33
0003	3T	nopattern	235	205	4	20500	6630	-13870	0.02	0.32	36	11	-25
0003	3T	nopattern	236	217	3	21700	9590	-12110	0.01	0.44	38	16	-22
0003	3T	nopattern	241	100	4	10000	7700	-2300	0.04	0.77	17	13	-4
0003	3T	nopattern	243	163	10	16300	73980	57680	0.06	4.54	28	130	102
0003	3T	nopattern	245	84	0	8400	0	-8400	0.00	0.00	14	0	-14
0003	3T	nopattern	246	96	4	9600	22670	13070	0.04	2.36	16	40	24
0003	3T	nopattern	251	71	1	7100	1040	-6060	0.01	0.15	12	1	-11
0003	3T	nopattern	253	77	5	7700	8000	300	0.06	1.04	13	14	1
0003	3T	nopattern	254	87	0	8700	0	-8700	0.00	0.00	15	0	-15
0003	3T	nopattern	256	71	0	7100	0	-7100	0.00	0.00	12	0	-12
0003	3T	nopattern	261	57	4	5700	18900	13200	0.07	3.32	10	33	23
0003	3T	nopattern	263	79	3	7900	4050	-3850	0.04	0.51	13	7	-6
0003	3T	nopattern	264	44	0	4400	0	-4400	0.00	0.00	7	0	-7
0003	3T	nopattern	265	43	0	4300	0	-4300	0.00	0.00	7	0	-7
0005	2F	14	23	69	14	6900	7290	390	0.20	1.06	12	12	0
0005	2F	14	24	40	3	4000	1330	-2670	0.08	0.33	7	2	-5
0005	2F	14	25	27	0	2700	0	-2700	0.00	0.00	4	0	-4
0005	2F	14	26	11	0	1100	0	-1100	0.00	0.00	1	0	-1
0005	2F	15	12	1206	346	120600	100290	-20310	0.29	0.83	213	177	-36
0014	1T	01_1	1	479	257	47900	42680	-5220	0.54	0.89	84	75	-9
0014	1T	01_1	2	50	18	5000	4370	-630	0.36	0.87	8	7	-1
0014	1T	01_2	1	433	204	43300	38890	-4410	0.47	0.90	76	68	-8
0014	1T	01_2	2	68	23	6800	7260	460	0.34	1.07	12	12	0
0014	1T	01_3	1	421	225	42100	39220	-2880	0.53	0.93	74	69	-5
0014	1T	01_3	2	58	16	5800	4450	-1350	0.28	0.77	10	7	-3
0014	1T	01_4	1	399	232	39900	36700	-3200	0.58	0.92	70	64	-6
0014	1T	01_4	2	68	22	6800	4830	-1970	0.32	0.71	12	8	-4
0014	1T	01_5	1	282	179	28200	27200	-1000	0.63	0.96	49	48	-1
0014	1T	01_5	2	24	5	2400	1260	-1140	0.21	0.53	4	2	-2
0014	1T	01_6	1	32	17	3200	2380	-820	0.53	0.74	5	4	-1
0014	1T	01_6	2	3	0	300	0	-300	0.00	0.00	0	0	0
0014	1T	01_7	1	488	328	48800	50660	1860	0.67	1.04	86	89	3
0014	1T	01_7	2	49	9	4900	3020	-1880	0.18	0.62	8	5	-3
0014	1T	02_1	1	499	225	49900	43350	-6550	0.45	0.87	88	76	-12
0014	1T	02_1	2	75	18	7500	7120	-380	0.24	0.95	13	12	-1
0014	1T	02_2	1	460	201	46000	38940	-7060	0.44	0.85	81	68	-13
0014	1T	02_2	2	84	28	8400	10030	1630	0.33	1.19	14	17	3
0014	1T	02_3	1	483	242	48300	48670	370	0.50	1.01	85	86	1
0014	1T	02_3	2	88	21	8800	6420	-2380	0.24	0.73	15	11	-4
0014	1T	02_4	1	307	161	30700	27970	-2730	0.52	0.91	54	49	-5
0014	1T	02_4	2	59	18	5900	4610	-1290	0.31	0.78	10	8	-2
0014	1T	02_5	1	175	90	17500	14090	-3410	0.51	0.81	30	24	-6
0014	1T	02_5	2	16	3	1600	730	-870	0.19	0.46	2	1	-1
0014	1T	02_6	1	11	2	1100	400	-700	0.18	0.36	1	0	-1
0014	1T	02_6	2	1	0	100	0	-100	0.00	0.00	0	0	0
0014	1T	02_7	1	484	232	48400	44590	-3810	0.48	0.92	85	78	-7
0014	1T	02_7	2	72	21	7200	6760	-440	0.29	0.94	12	11	-1
0014	1T	03_1	1	338	169	33800	30440	-3360	0.50	0.90	59	53	-6
0014	1T	03_1	2	59	13	5900	2650	-3250	0.22	0.45	10	4	-6
0014	1T	03_2	1	295	126	29500	26410	-3090	0.43	0.90	52	46	-6
0014	1T	03_2	2	68	28	6800	10760	3960	0.41	1.58	12	19	7
0014	1T	03_3	1	380	198	38000	37600	-400	0.52	0.99	67	66	-1
0014	1T	03_3	2	52	17	5200	7810	2610	0.33	1.50	9	13	4
0014	1T	03_4	1	228	128	22800	21820	-980	0.56	0.96	40	38	-2
0014	1T	03_4	2	32	8	3200	3200	0	0.25	1.00	5	5	0
0014	1T	03_5	1	137	77	13700	13440	-260	0.56	0.98	24	23	-1
0014	1T	03_5	2	23	10	2300	2820	520	0.43	1.23	4	4	0
0014	1T	03_7	1	353	187	35300	34020	-1280	0.53	0.96	62	60	-2
0014	1T	03_7	2	77	22	7700	8530	830	0.29	1.11	13	15	2
0014	1T	04_1	1	394	189	39400	32250	-7150	0.48	0.82	69	57	-12
0014	1T	04_1	2	57	17	5700	6190	490	0.30	1.09	10	10	0
0014	1T	04_2	1	368	181	36800	37520	720	0.49	1.02	65	66	1
0014	1T	04_2	2	44	18	4400	5200	800	0.41	1.18	7	9	2
0014	1T	04_3	1	397	209	39700	37110	-2590	0.53	0.93	70	65	-5
0014	1T	04_3	2	61	20	6100	6710	610	0.33	1.10	10	11	1
0014	1T	04_4	1	291	163	29100	28720	-380	0.56	0.99	51	50	-1
0014	1T	04_4	2	51	9	5100	2750	-2350	0.18	0.54	9	4	-5
0014	1T	04_5	1	271	130	27100	22790	-4310	0.48	0.84	47	40	-7
0014	1T	04_5	2	23	8	2300	2710	410	0.35	1.18	4	4	0
0014	1T	04_7	1	353	186	35300	32260	-3040	0.53	0.91	62	57	-5
0014	1T	04_7	2	73	21	7300	6350	-950	0.29	0.87	12	11	-1
0014	1T	05_1	1	457	258	45700	45270	-430	0.56	0.99	80	80	0
0014	1T	05_1	2	66	23	6600	6730	130	0.35	1.02	11	11	0
0014	1T	05_2	1	437	250	43700	45360	1660	0.57	1.04	77	80	3
0014	1T	05_2	2	70	23	7000	7220	220	0.33	1.03	12	12	0
0014	1T	05_3	1	419	247	41900	45620	3720	0.59	1.09	74	80	6
0014	1T	05_3	2	89	25	8900	5840	-3060	0.28	0.66	15	10	-5
0014	1T	05_4	1	349	211	34900	33780	-1120	0.60	0.97	61	59	-2
0014	1T	05_4	2	61	20	6100	5220	-880	0.33	0.86	10	9	-1
0014	1T	05_5	1	259	155	25900	23820	-2080	0.60	0.92	45	42	-3
0014	1T	05_5	2	23	7	2300	1610	-690	0.30	0.70	4	2	-2
0014	1T	05_6	1	8	5	800	620	-180	0.63	0.78	1	1	0
0014	1T	05_6	2	1	0	100	0	-100	0.00	0.00	0	0	0
0014	1T	05_7	1	432	253	43200	38670	-4530	0.59	0.90	76	68	-8
0014	1T	05_7	2	65	18	6500	5490	-1010	0.28	0.84	11	9	-2
0014	1T	06_1	1	500	272	50000	44160	-5840	0.54	0.88	88	78	-10
0014	1T	06_1	2	82	25	8200	5770	-2430	0.30	0.70	14	10	-4
0014	1T	06_2	1	498	234	49800	41160	-8640	0.47	0.83	88	72	-16
0014	1T	06_2	2	89	23	8900	5160	-3740	0.26	0.58	15	9	-6
0014	1T	06_3	1	486	267	48600	47410	-1190	0.55	0.98	86	83	-3
0014	1T	06_3	2	72	18	7200	6740	-460	0.25	0.94	12	11	-1
0014	1T	06_4	1	318	162	31800	27760	-4040	0.51	0.87	56	49	-7
0014	1T	06_4	2	55	12	5500	3410	-2090	0.22	0.62	9	6	-3
0014	1T	06_5	1	194	117	19400	17720	-1680	0.60	0.91	34	31	-3
0014	1T	06_5	2	40	6	4000	3060	-940	0.15	0.77	7	5	-2
0014	1T	06_6	1	30	14	3000	2460	-540	0.47	0.82	5	4	-1
0014	1T	06_6	2	2	1	200	190	-10	0.50	0.95	0	0	0
0014	1T	06_7	1	521	288	52100	44670	-7430	0.55	0.86	92	79	-13
0014	1T	06_7	2	68	17	6800	4830	-1970	0.25	0.71	12	8	-4
0014	1T	07_1	1	460	279	46000	47100	1100	0.61	1.02	81	83	2
0014	1T	07_1	2	67	28	6700	10310	3610	0.42	1.54	11	18	7
0014	1T	07_2	1	460	265	46000	45510	-490	0.58	0.99	81	80	-1
0014	1T	07_2	2	61	21	6100	6240	140	0.34	1.02	10	11	1
0014	1T	07_3	1	458	264	45800	45020	-780	0.58	0.98	81	79	-2
0014	1T	07_3	2	80	27	8000	6750	-1250	0.34	0.84	14	11	-3
0014	1T	07_4	1	410	250	41000	39730	-1270	0.61	0.97	72	70	-2
0014	1T	07_4	2	54	13	5400	2620	-2780	0.24	0.49	9	4	-5
0014	1T	07_5	1	329	211	32900	30670	-2230	0.64	0.93	58	54	-4
0014	1T	07_5	2	34	7	3400	2140	-1260	0.21	0.63	6	3	-3
0014	1T	07_6	1	55	35	5500	5340	-160	0.64	0.97	9	9	0
0014	1T	07_7	1	509	300	50900	45110	-5790	0.59	0.89	90	79	-11
0014	1T	07_7	2	36	11	3600	2670	-930	0.31	0.74	6	4	-2
0014	1T	08_1	1	539	309	53900	48330	-5570	0.57	0.90	95	85	-10
0014	1T	08_1	2	57	17	5700	4520	-1180	0.30	0.79	10	8	-2
0014	1T	08_2	1	547	347	54700	54720	20	0.63	1.00	96	96	0
0014	1T	08_2	2	63	20	6300	6020	-280	0.32	0.96	11	10	-1
0014	1T	08_3	1	537	315	53700	49680	-4020	0.59	0.93	95	87	-8
0014	1T	08_3	2	73	20	7300	6110	-1190	0.27	0.84	12	10	-2
0014	1T	08_4	1	177	112	17700	17400	-300	0.63	0.98	31	30	-1
0014	1T	08_4	2	24	7	2400	1870	-530	0.29	0.78	4	3	-1
0014	1T	08_5	1	127	77	12700	10840	-1860	0.61	0.85	22	19	-3
0014	1T	08_5	2	3	1	300	370	70	0.33	1.23	0	0	0
0014	1T	08_6	1	18	14	1800	2190	390	0.78	1.22	3	3	0
0014	1T	08_6	2	2	1	200	540	340	0.50	2.70	0	0	0
0014	1T	08_7	1	590	379	59000	56990	-2010	0.64	0.97	104	100	-4
0014	1T	08_7	2	63	21	6300	10810	4510	0.33	1.72	11	19	8
0014	1T	09_1	1	446	274	44600	45270	670	0.61	1.02	78	80	2
0014	1T	09_1	2	86	45	8600	11040	2440	0.52	1.28	15	19	4
0014	1T	09_2	1	437	252	43700	40910	-2790	0.58	0.94	77	72	-5
0014	1T	09_2	2	56	13	5600	3240	-2360	0.23	0.58	9	5	-4
0014	1T	09_3	1	443	260	44300	44170	-130	0.59	1.00	78	78	0
0014	1T	09_3	2	66	22	6600	6930	330	0.33	1.05	11	12	1
0014	1T	09_4	1	366	220	36600	38240	1640	0.60	1.04	64	67	3
0014	1T	09_4	2	73	39	7300	10530	3230	0.53	1.44	12	18	6
0014	1T	09_5	1	417	280	41700	40640	-1060	0.67	0.97	73	71	-2
0014	1T	09_5	2	40	6	4000	1160	-2840	0.15	0.29	7	2	-5
0014	1T	09_7	1	534	373	53400	49220	-4180	0.70	0.92	94	87	-7
0014	1T	09_7	2	39	11	3900	3310	-590	0.28	0.85	6	5	-1
0014	1T	10_1	1	450	233	45000	37980	-7020	0.52	0.84	79	67	-12
0014	1T	10_1	2	69	19	6900	4730	-2170	0.28	0.69	12	8	-4
0014	1T	10_2	1	429	220	42900	40710	-2190	0.51	0.95	75	72	-3
0014	1T	10_2	2	80	23	8000	7180	-820	0.29	0.90	14	12	-2
0014	1T	10_3	1	430	202	43000	34660	-8340	0.47	0.81	76	61	-15
0014	1T	10_3	2	72	17	7200	6490	-710	0.24	0.90	12	11	-1
0014	1T	10_4	1	418	216	41800	35850	-5950	0.52	0.86	73	63	-10
0014	1T	10_4	2	62	19	6200	4630	-1570	0.31	0.75	10	8	-2
0014	1T	10_5	1	336	200	33600	28900	-4700	0.60	0.86	59	51	-8
0014	1T	10_5	2	38	5	3800	2160	-1640	0.13	0.57	6	3	-3
0014	1T	10_6	1	10	7	1000	1120	120	0.70	1.12	1	1	0
0014	1T	10_6	2	1	0	100	0	-100	0.00	0.00	0	0	0
0014	1T	10_7	1	486	305	48600	41720	-6880	0.63	0.86	86	73	-13
0014	1T	10_7	2	45	3	4500	1090	-3410	0.07	0.24	7	1	-6
0014	1T	11_1	1	423	190	42300	34860	-7440	0.45	0.82	74	61	-13
0014	1T	11_1	2	55	15	5500	3800	-1700	0.27	0.69	9	6	-3
0014	1T	11_2	1	393	185	39300	31580	-7720	0.47	0.80	69	55	-14
0014	1T	11_2	2	68	25	6800	6320	-480	0.37	0.93	12	11	-1
0014	1T	11_3	1	375	195	37500	34430	-3070	0.52	0.92	66	60	-6
0014	1T	11_3	2	74	31	7400	8950	1550	0.42	1.21	13	15	2
0014	1T	11_4	1	361	185	36100	34230	-1870	0.51	0.95	63	60	-3
0014	1T	11_4	2	60	27	6000	7360	1360	0.45	1.23	10	13	3
0014	1T	11_5	1	348	194	34800	29640	-5160	0.56	0.85	61	52	-9
0014	1T	11_5	2	28	3	2800	780	-2020	0.11	0.28	4	1	-3
0014	1T	11_7	1	456	285	45600	41500	-4100	0.63	0.91	80	73	-7
0014	1T	11_7	2	40	7	4000	1710	-2290	0.18	0.43	7	3	-4
0014	1T	12_1	1	447	263	44700	41100	-3600	0.59	0.92	79	72	-7
0014	1T	12_1	2	35	19	3500	4070	570	0.54	1.16	6	7	1
0014	1T	12_2	1	424	246	42400	39360	-3040	0.58	0.93	75	69	-6
0014	1T	12_2	2	57	19	5700	6280	580	0.33	1.10	10	11	1
0014	1T	12_3	1	410	232	41000	36950	-4050	0.57	0.90	72	65	-7
0014	1T	12_3	2	59	24	5900	5920	20	0.41	1.00	10	10	0
0014	1T	12_4	1	362	204	36200	31310	-4890	0.56	0.86	64	55	-9
0014	1T	12_4	2	59	20	5900	5080	-820	0.34	0.86	10	8	-2
0014	1T	12_5	1	345	238	34500	32960	-1540	0.69	0.96	61	58	-3
0014	1T	12_5	2	15	3	1500	610	-890	0.20	0.41	2	1	-1
0014	1T	12_6	1	31	16	3100	2410	-690	0.52	0.78	5	4	-1
0014	1T	12_6	2	3	2	300	610	310	0.67	2.03	0	1	1
0014	1T	12_7	1	458	290	45800	41870	-3930	0.63	0.91	81	74	-7
0014	1T	12_7	2	51	14	5100	3170	-1930	0.27	0.62	9	5	-4
0014	1T	13_1	1	444	248	44400	40190	-4210	0.56	0.91	78	71	-7
0014	1T	13_1	2	55	13	5500	4950	-550	0.24	0.90	9	8	-1
0014	1T	13_2	1	396	215	39600	36940	-2660	0.54	0.93	70	65	-5
0014	1T	13_2	2	79	28	7900	9250	1350	0.35	1.17	13	16	3
0014	1T	13_3	1	395	212	39500	38140	-1360	0.54	0.97	69	67	-2
0014	1T	13_3	2	78	28	7800	8040	240	0.36	1.03	13	14	1
0014	1T	13_4	1	379	243	37900	39220	1320	0.64	1.03	67	69	2
0014	1T	13_4	2	56	19	5600	4800	-800	0.34	0.86	9	8	-1
0014	1T	13_5	1	373	251	37300	36270	-1030	0.67	0.97	66	64	-2
0014	1T	13_5	2	15	4	1500	2220	720	0.27	1.48	2	3	1
0014	1T	13_6	1	49	24	4900	4690	-210	0.49	0.96	8	8	0
0014	1T	13_6	2	2	0	200	0	-200	0.00	0.00	0	0	0
0014	1T	13_7	1	439	300	43900	42870	-1030	0.68	0.98	77	75	-2
0014	1T	13_7	2	41	8	4100	2930	-1170	0.20	0.71	7	5	-2
0014	1T	14_1	1	420	201	42000	35900	-6100	0.48	0.85	74	63	-11
0014	1T	14_1	2	56	13	5600	4120	-1480	0.23	0.74	9	7	-2
0014	1T	14_2	1	409	186	40900	33960	-6940	0.45	0.83	72	60	-12
0014	1T	14_2	2	76	15	7600	6420	-1180	0.20	0.84	13	11	-2
0014	1T	14_3	1	447	235	44700	45280	580	0.53	1.01	79	80	1
0014	1T	14_3	2	58	12	5800	3730	-2070	0.21	0.64	10	6	-4
0014	1T	14_4	1	364	201	36400	34610	-1790	0.55	0.95	64	61	-3
0014	1T	14_4	2	51	16	5100	10070	4970	0.31	1.97	9	17	8
0014	1T	14_5	1	219	110	21900	16780	-5120	0.50	0.77	38	29	-9
0014	1T	14_5	2	27	4	2700	3050	350	0.15	1.13	4	5	1
0014	1T	14_6	1	19	11	1900	1570	-330	0.58	0.83	3	2	-1
0014	1T	14_6	2	3	0	300	0	-300	0.00	0.00	0	0	0
0014	1T	14_7	1	451	231	45100	38980	-6120	0.51	0.86	79	68	-11
0014	1T	14_7	2	59	17	5900	5790	-110	0.29	0.98	10	10	0
0014	1T	15_1	1	480	277	48000	46250	-1750	0.58	0.96	84	81	-3
0014	1T	15_1	2	58	17	5800	4530	-1270	0.29	0.78	10	8	-2
0014	1T	15_2	1	484	268	48400	45510	-2890	0.55	0.94	85	80	-5
0014	1T	15_2	2	53	15	5300	3380	-1920	0.28	0.64	9	5	-4
0014	1T	15_3	1	492	266	49200	44020	-5180	0.54	0.89	87	77	-10
0014	1T	15_3	2	60	15	6000	4210	-1790	0.25	0.70	10	7	-3
0014	1T	15_4	1	408	209	40800	32350	-8450	0.51	0.79	72	57	-15
0014	1T	15_4	2	53	20	5300	4820	-480	0.38	0.91	9	8	-1
0014	1T	15_5	1	349	215	34900	31910	-2990	0.62	0.91	61	56	-5
0014	1T	15_5	2	22	8	2200	3040	840	0.36	1.38	3	5	2
0014	1T	15_6	1	62	31	6200	4750	-1450	0.50	0.77	10	8	-2
0014	1T	15_6	2	5	2	500	740	240	0.40	1.48	0	1	1
0014	1T	15_7	1	543	332	54300	47020	-7280	0.61	0.87	96	83	-13
0014	1T	15_7	2	38	13	3800	6170	2370	0.34	1.62	6	10	4
0014	1T	16_1	1	534	328	53400	54690	1290	0.61	1.02	94	96	2
0014	1T	16_1	2	54	21	5400	5450	50	0.39	1.01	9	9	0
0014	1T	16_2	1	476	249	47600	39650	-7950	0.52	0.83	84	70	-14
0014	1T	16_2	2	76	20	7600	5190	-2410	0.26	0.68	13	9	-4
0014	1T	16_3	1	449	267	44900	47050	2150	0.59	1.05	79	83	4
0014	1T	16_3	2	65	17	6500	6180	-320	0.26	0.95	11	10	-1
0014	1T	16_4	1	437	266	43700	39550	-4150	0.61	0.91	77	70	-7
0014	1T	16_4	2	69	31	6900	25340	18440	0.45	3.67	12	44	32
0014	1T	16_5	1	446	278	44600	40760	-3840	0.62	0.91	78	72	-6
0014	1T	16_5	2	17	6	1700	2180	480	0.35	1.28	3	3	0
0014	1T	16_7	1	543	374	54300	53210	-1090	0.69	0.98	96	94	-2
0014	1T	16_7	2	21	6	2100	1980	-120	0.29	0.94	3	3	0
0014	1T	17_1	1	496	263	49600	40950	-8650	0.53	0.83	87	72	-15
0014	1T	17_1	2	57	20	5700	5680	-20	0.35	1.00	10	10	0
0014	1T	17_2	1	499	277	49900	49250	-650	0.56	0.99	88	87	-1
0014	1T	17_2	2	54	23	5400	7690	2290	0.43	1.42	9	13	4
0014	1T	17_3	1	497	285	49700	56500	6800	0.57	1.14	87	100	13
0014	1T	17_3	2	69	31	6900	8000	1100	0.45	1.16	12	14	2
0014	1T	17_4	1	424	260	42400	42450	50	0.61	1.00	75	75	0
0014	1T	17_4	2	44	18	4400	4310	-90	0.41	0.98	7	7	0
0014	1T	17_5	1	381	239	38100	35980	-2120	0.63	0.94	67	63	-4
0014	1T	17_5	2	20	7	2000	2720	720	0.35	1.36	3	4	1
0014	1T	17_7	1	531	352	53100	48720	-4380	0.66	0.92	93	86	-7
0014	1T	17_7	2	39	10	3900	5260	1360	0.26	1.35	6	9	3
0014	1T	18_1	1	485	281	48500	44210	-4290	0.58	0.91	85	78	-7
0014	1T	18_1	2	75	27	7500	9870	2370	0.36	1.32	13	17	4
0014	1T	18_2	1	506	299	50600	44980	-5620	0.59	0.89	89	79	-10
0014	1T	18_2	2	57	18	5700	5260	-440	0.32	0.92	10	9	-1
0014	1T	18_3	1	469	286	46900	41980	-4920	0.61	0.90	83	74	-9
0014	1T	18_3	2	72	21	7200	6350	-850	0.29	0.88	12	11	-1
0014	1T	18_4	1	485	317	48500	48590	90	0.65	1.00	85	86	1
0014	1T	18_4	2	51	19	5100	5090	-10	0.37	1.00	9	9	0
0014	1T	18_5	1	462	358	46200	44940	-1260	0.77	0.97	81	79	-2
0014	1T	18_5	2	27	3	2700	1760	-940	0.11	0.65	4	3	-1
0014	1T	18_6	1	54	39	5400	4840	-560	0.72	0.90	9	8	-1
0014	1T	18_6	2	3	0	300	0	-300	0.00	0.00	0	0	0
0014	1T	18_7	1	527	403	52700	50610	-2090	0.76	0.96	93	89	-4
0014	1T	18_7	2	45	5	4500	2370	-2130	0.11	0.53	7	4	-3
0014	1T	19_1	1	460	275	46000	41360	-4640	0.60	0.90	81	73	-8
0014	1T	19_1	2	37	9	3700	2020	-1680	0.24	0.55	6	3	-3
0014	1T	19_2	1	432	253	43200	40170	-3030	0.59	0.93	76	71	-5
0014	1T	19_2	2	41	19	4100	6010	1910	0.46	1.47	7	10	3
0014	1T	19_3	1	457	263	45700	40910	-4790	0.58	0.90	80	72	-8
0014	1T	19_3	2	44	18	4400	5160	760	0.41	1.17	7	9	2
0014	1T	19_4	1	384	245	38400	36270	-2130	0.64	0.94	67	64	-3
0014	1T	19_4	2	41	13	4100	3170	-930	0.32	0.77	7	5	-2
0014	1T	19_5	1	280	188	28000	29440	1440	0.67	1.05	49	52	3
0014	1T	19_5	2	35	9	3500	3450	-50	0.26	0.99	6	6	0
0014	1T	19_6	1	40	28	4000	4000	0	0.70	1.00	7	7	0
0014	1T	19_6	2	5	3	500	1680	1180	0.60	3.36	0	2	2
0014	1T	19_7	1	472	305	47200	44120	-3080	0.65	0.93	83	78	-5
0014	1T	19_7	2	40	13	4000	4650	650	0.33	1.16	7	8	1
0014	1T	20_1	1	503	300	50300	46420	-3880	0.60	0.92	89	82	-7
0014	1T	20_1	2	30	9	3000	1880	-1120	0.30	0.63	5	3	-2
0014	1T	20_2	1	472	261	47200	42220	-4980	0.55	0.89	83	74	-9
0014	1T	20_2	2	26	12	2600	3770	1170	0.46	1.45	4	6	2
0014	1T	20_3	1	473	282	47300	45320	-1980	0.60	0.96	83	80	-3
0014	1T	20_3	2	25	7	2500	1710	-790	0.28	0.68	4	3	-1
0014	1T	20_4	1	387	226	38700	35830	-2870	0.58	0.93	68	63	-5
0014	1T	20_4	2	37	12	3700	3950	250	0.32	1.07	6	6	0
0014	1T	20_5	1	340	207	34000	33890	-110	0.61	1.00	60	59	-1
0014	1T	20_5	2	29	11	2900	4730	1830	0.38	1.63	5	8	3
0014	1T	20_6	1	74	39	7400	5600	-1800	0.53	0.76	13	9	-4
0014	1T	20_6	2	3	2	300	400	100	0.67	1.33	0	0	0
0014	1T	20_7	1	489	283	48900	41320	-7580	0.58	0.84	86	73	-13
0014	1T	20_7	2	33	7	3300	2390	-910	0.21	0.72	5	4	-1
0014	1T	21_1	1	497	314	49700	45050	-4650	0.63	0.91	87	79	-8
0014	1T	21_1	2	32	8	3200	2520	-680	0.25	0.79	5	4	-1
0014	1T	21_2	1	504	294	50400	43180	-7220	0.58	0.86	89	76	-13
0014	1T	21_2	2	44	15	4400	2800	-1600	0.34	0.64	7	4	-3
0014	1T	21_3	1	497	320	49700	47010	-2690	0.64	0.95	87	83	-4
0014	1T	21_3	2	33	8	3300	1390	-1910	0.24	0.42	5	2	-3
0014	1T	21_4	1	442	284	44200	41480	-2720	0.64	0.94	78	73	-5
0014	1T	21_4	2	28	10	2800	2930	130	0.36	1.05	4	5	1
0014	1T	21_5	1	391	275	39100	36000	-3100	0.70	0.92	69	63	-6
0014	1T	21_5	2	20	6	2000	3130	1130	0.30	1.57	3	5	2
0014	1T	21_6	1	31	19	3100	3730	630	0.61	1.20	5	6	1
0014	1T	21_6	2	3	1	300	220	-80	0.33	0.73	0	0	0
0014	1T	21_7	1	510	330	51000	45740	-5260	0.65	0.90	90	80	-10
0014	1T	21_7	2	28	7	2800	1650	-1150	0.25	0.59	4	2	-2
0014	1T	22_1	1	441	233	44100	38230	-5870	0.53	0.87	78	67	-11
0014	1T	22_1	2	51	11	5100	2780	-2320	0.22	0.55	9	4	-5
0014	1T	22_2	1	414	205	41400	37400	-4000	0.50	0.90	73	66	-7
0014	1T	22_2	2	57	24	5700	5070	-630	0.42	0.89	10	8	-2
0014	1T	22_3	1	381	219	38100	42110	4010	0.57	1.11	67	74	7
0014	1T	22_3	2	54	18	5400	4610	-790	0.33	0.85	9	8	-1
0014	1T	22_4	1	376	216	37600	35720	-1880	0.57	0.95	66	63	-3
0014	1T	22_4	2	51	15	5100	3580	-1520	0.29	0.70	9	6	-3
0014	1T	22_5	1	340	213	34000	33640	-360	0.63	0.99	60	59	-1
0014	1T	22_5	2	33	11	3300	3240	-60	0.33	0.98	5	5	0
0014	1T	22_7	1	436	248	43600	36150	-7450	0.57	0.83	77	63	-14
0014	1T	22_7	2	47	17	4700	5200	500	0.36	1.11	8	9	1
0014	1T	23_1	1	447	240	44700	51030	6330	0.54	1.14	79	90	11
0014	1T	23_1	2	42	13	4200	2870	-1330	0.31	0.68	7	5	-2
0014	1T	23_2	1	453	216	45300	34820	-10480	0.48	0.77	80	61	-19
0014	1T	23_2	2	52	20	5200	4970	-230	0.38	0.96	9	8	-1
0014	1T	23_3	1	437	240	43700	39560	-4140	0.55	0.91	77	70	-7
0014	1T	23_3	2	56	28	5600	6410	810	0.50	1.14	9	11	2
0014	1T	23_4	1	452	288	45200	43810	-1390	0.64	0.97	80	77	-3
0014	1T	23_4	2	26	3	2600	980	-1620	0.12	0.38	4	1	-3
0014	1T	23_5	1	347	224	34700	33250	-1450	0.65	0.96	61	58	-3
0014	1T	23_5	2	17	6	1700	2010	310	0.35	1.18	3	3	0
0014	1T	23_6	1	36	23	3600	3650	50	0.64	1.01	6	6	0
0014	1T	23_7	1	523	317	52300	46440	-5860	0.61	0.89	92	82	-10
0014	1T	23_7	2	26	6	2600	2200	-400	0.23	0.85	4	3	-1
0014	1T	24_1	1	542	362	54200	55570	1370	0.67	1.03	95	98	3
0014	1T	24_1	2	46	28	4600	7400	2800	0.61	1.61	8	13	5
0014	1T	24_2	1	532	359	53200	51950	-1250	0.67	0.98	94	91	-3
0014	1T	24_2	2	45	17	4500	3840	-660	0.38	0.85	7	6	-1
0014	1T	24_3	1	566	386	56600	56060	-540	0.68	0.99	100	99	-1
0014	1T	24_3	2	29	10	2900	2680	-220	0.34	0.92	5	4	-1
0014	1T	24_4	1	394	280	39400	38170	-1230	0.71	0.97	69	67	-2
0014	1T	24_4	2	18	6	1800	1060	-740	0.33	0.59	3	1	-2
0014	1T	24_5	1	218	169	21800	23390	1590	0.78	1.07	38	41	3
0014	1T	24_5	2	12	3	1200	1020	-180	0.25	0.85	2	1	-1
0014	1T	24_6	1	55	47	5500	6290	790	0.85	1.14	9	11	2
0014	1T	24_7	1	577	438	57700	56000	-1700	0.76	0.97	102	99	-3
0014	1T	24_7	2	25	8	2500	3750	1250	0.32	1.50	4	6	2
0014	2F	01_1	12	209	57	20900	16370	-4530	0.27	0.78	36	28	-8
0014	2F	01_1	13	93	21	9300	6270	-3030	0.23	0.67	16	11	-5
0014	2F	01_1	14	60	13	6000	8300	2300	0.22	1.38	10	14	4
0014	2F	01_1	15	31	5	3100	1800	-1300	0.16	0.58	5	3	-2
0014	2F	01_1	16	8	1	800	1680	880	0.13	2.10	1	2	1
0014	2F	01_1	23	8	1	800	300	-500	0.13	0.38	1	0	-1
0014	2F	01_1	24	5	2	500	1940	1440	0.40	3.88	0	3	3
0014	2F	01_1	25	4	2	400	640	240	0.50	1.60	0	1	1
0014	2F	01_2	12	196	33	19600	9490	-10110	0.17	0.48	34	16	-18
0014	2F	01_2	13	81	21	8100	5790	-2310	0.26	0.71	14	10	-4
0014	2F	01_2	14	51	14	5100	5820	720	0.27	1.14	9	10	1
0014	2F	01_2	15	43	9	4300	3170	-1130	0.21	0.74	7	5	-2
0014	2F	01_2	16	9	0	900	0	-900	0.00	0.00	1	0	-1
0014	2F	01_2	23	9	2	900	1480	580	0.22	1.64	1	2	1
0014	2F	01_2	24	14	2	1400	1230	-170	0.14	0.88	2	2	0
0014	2F	01_2	25	9	2	900	640	-260	0.22	0.71	1	1	0
0014	2F	01_2	26	4	1	400	530	130	0.25	1.33	0	0	0
0014	2F	01_3	12	174	51	17400	18740	1340	0.29	1.08	30	33	3
0014	2F	01_3	13	101	30	10100	11630	1530	0.30	1.15	17	20	3
0014	2F	01_3	14	48	11	4800	4000	-800	0.23	0.83	8	7	-1
0014	2F	01_3	15	33	6	3300	2300	-1000	0.18	0.70	5	4	-1
0014	2F	01_3	16	20	4	2000	4080	2080	0.20	2.04	3	7	4
0014	2F	01_3	23	11	1	1100	290	-810	0.09	0.26	1	0	-1
0014	2F	01_3	24	5	1	500	1210	710	0.20	2.42	0	2	2
0014	2F	01_3	25	9	0	900	0	-900	0.00	0.00	1	0	-1
0014	2F	01_3	26	1	0	100	0	-100	0.00	0.00	0	0	0
0014	2F	01_4	12	182	54	18200	13940	-4260	0.30	0.77	32	24	-8
0014	2F	01_4	13	93	27	9300	11450	2150	0.29	1.23	16	20	4
0014	2F	01_4	14	62	4	6200	1330	-4870	0.06	0.21	10	2	-8
0014	2F	01_4	15	30	4	3000	4140	1140	0.13	1.38	5	7	2
0014	2F	01_4	16	10	0	1000	0	-1000	0.00	0.00	1	0	-1
0014	2F	01_4	23	14	3	1400	1100	-300	0.21	0.79	2	1	-1
0014	2F	01_4	24	9	1	900	190	-710	0.11	0.21	1	0	-1
0014	2F	01_4	25	6	1	600	280	-320	0.17	0.47	1	0	-1
0014	2F	01_4	26	4	0	400	0	-400	0.00	0.00	0	0	0
0014	2F	01_5	12	110	32	11000	10400	-600	0.29	0.95	19	18	-1
0014	2F	01_5	13	68	11	6800	3720	-3080	0.16	0.55	12	6	-6
0014	2F	01_5	14	37	5	3700	2160	-1540	0.14	0.58	6	3	-3
0014	2F	01_5	15	16	3	1600	1040	-560	0.19	0.65	2	1	-1
0014	2F	01_5	16	9	1	900	360	-540	0.11	0.40	1	0	-1
0014	2F	01_5	23	7	0	700	0	-700	0.00	0.00	1	0	-1
0014	2F	01_5	24	5	0	500	0	-500	0.00	0.00	0	0	0
0014	2F	01_5	25	2	0	200	0	-200	0.00	0.00	0	0	0
0014	2F	01_5	26	1	0	100	0	-100	0.00	0.00	0	0	0
0014	2F	01_6	12	12	3	1200	640	-560	0.25	0.53	2	1	-1
0014	2F	01_6	13	8	0	800	0	-800	0.00	0.00	1	0	-1
0014	2F	01_6	14	5	0	500	0	-500	0.00	0.00	0	0	0
0014	2F	01_6	15	1	1	100	230	130	1.00	2.30	0	0	0
0014	2F	01_6	16	2	0	200	0	-200	0.00	0.00	0	0	0
0014	2F	01_6	23	2	0	200	0	-200	0.00	0.00	0	0	0
0014	2F	01_6	25	1	0	100	0	-100	0.00	0.00	0	0	0
0014	2F	01_7	12	188	61	18800	16890	-1910	0.32	0.90	33	29	-4
0014	2F	01_7	13	105	25	10500	7730	-2770	0.24	0.74	18	13	-5
0014	2F	01_7	14	80	12	8000	3850	-4150	0.15	0.48	14	6	-8
0014	2F	01_7	15	42	9	4200	3300	-900	0.21	0.79	7	5	-2
0014	2F	01_7	16	18	3	1800	2170	370	0.17	1.21	3	3	0
0014	2F	01_7	23	9	1	900	1630	730	0.11	1.81	1	2	1
0014	2F	01_7	24	3	1	300	400	100	0.33	1.33	0	0	0
0014	2F	01_7	25	6	0	600	0	-600	0.00	0.00	1	0	-1
0014	2F	01_7	26	9	2	900	1060	160	0.22	1.18	1	1	0
0014	2F	02_1	12	224	61	22400	22990	590	0.27	1.03	39	40	1
0014	2F	02_1	13	112	17	11200	9290	-1910	0.15	0.83	19	16	-3
0014	2F	02_1	14	51	10	5100	4380	-720	0.20	0.86	9	7	-2
0014	2F	02_1	15	28	2	2800	1430	-1370	0.07	0.51	4	2	-2
0014	2F	02_1	16	24	2	2400	720	-1680	0.08	0.30	4	1	-3
0014	2F	02_1	23	13	1	1300	400	-900	0.08	0.31	2	0	-2
0014	2F	02_1	24	6	0	600	0	-600	0.00	0.00	1	0	-1
0014	2F	02_1	25	7	1	700	1680	980	0.14	2.40	1	2	1
0014	2F	02_1	26	4	0	400	0	-400	0.00	0.00	0	0	0
0014	2F	02_2	12	208	37	20800	16350	-4450	0.18	0.79	36	28	-8
0014	2F	02_2	13	97	22	9700	10720	1020	0.23	1.11	17	18	1
0014	2F	02_2	14	69	14	6900	5410	-1490	0.20	0.78	12	9	-3
0014	2F	02_2	15	24	2	2400	510	-1890	0.08	0.21	4	0	-4
0014	2F	02_2	16	16	1	1600	480	-1120	0.06	0.30	2	0	-2
0014	2F	02_2	23	15	2	1500	620	-880	0.13	0.41	2	1	-1
0014	2F	02_2	24	14	1	1400	450	-950	0.07	0.32	2	0	-2
0014	2F	02_2	25	8	2	800	1060	260	0.25	1.33	1	1	0
0014	2F	02_2	26	5	0	500	0	-500	0.00	0.00	0	0	0
0014	2F	02_3	12	193	47	19300	18360	-940	0.24	0.95	34	32	-2
0014	2F	02_3	13	105	25	10500	12560	2060	0.24	1.20	18	22	4
0014	2F	02_3	14	74	5	7400	2530	-4870	0.07	0.34	13	4	-9
0014	2F	02_3	15	32	6	3200	6160	2960	0.19	1.93	5	10	5
0014	2F	02_3	16	27	2	2700	1150	-1550	0.07	0.43	4	2	-2
0014	2F	02_3	23	15	3	1500	1970	470	0.20	1.31	2	3	1
0014	2F	02_3	24	21	2	2100	990	-1110	0.10	0.47	3	1	-2
0014	2F	02_3	25	4	0	400	0	-400	0.00	0.00	0	0	0
0014	2F	02_3	26	3	0	300	0	-300	0.00	0.00	0	0	0
0014	2F	02_4	12	121	28	12100	10930	-1170	0.23	0.90	21	19	-2
0014	2F	02_4	13	83	19	8300	7810	-490	0.23	0.94	14	13	-1
0014	2F	02_4	14	45	4	4500	2650	-1850	0.09	0.59	7	4	-3
0014	2F	02_4	15	16	1	1600	1420	-180	0.06	0.89	2	2	0
0014	2F	02_4	16	7	0	700	0	-700	0.00	0.00	1	0	-1
0014	2F	02_4	23	15	2	1500	540	-960	0.13	0.36	2	0	-2
0014	2F	02_4	24	7	1	700	470	-230	0.14	0.67	1	0	-1
0014	2F	02_4	25	6	0	600	0	-600	0.00	0.00	1	0	-1
0014	2F	02_4	26	3	0	300	0	-300	0.00	0.00	0	0	0
0014	2F	02_5	12	75	29	7500	7480	-20	0.39	1.00	13	13	0
0014	2F	02_5	13	39	3	3900	1050	-2850	0.08	0.27	6	1	-5
0014	2F	02_5	14	25	3	2500	970	-1530	0.12	0.39	4	1	-3
0014	2F	02_5	15	9	1	900	1090	190	0.11	1.21	1	1	0
0014	2F	02_5	16	7	1	700	280	-420	0.14	0.40	1	0	-1
0014	2F	02_5	23	5	0	500	0	-500	0.00	0.00	0	0	0
0014	2F	02_5	25	1	0	100	0	-100	0.00	0.00	0	0	0
0014	2F	02_6	12	5	1	500	280	-220	0.20	0.56	0	0	0
0014	2F	02_6	13	1	0	100	0	-100	0.00	0.00	0	0	0
0014	2F	02_6	15	1	0	100	0	-100	0.00	0.00	0	0	0
0014	2F	02_6	23	1	0	100	0	-100	0.00	0.00	0	0	0
0014	2F	02_7	12	206	42	20600	13980	-6620	0.20	0.68	36	24	-12
0014	2F	02_7	13	98	16	9800	6660	-3140	0.16	0.68	17	11	-6
0014	2F	02_7	14	74	16	7400	7300	-100	0.22	0.99	13	12	-1
0014	2F	02_7	15	31	2	3100	900	-2200	0.06	0.29	5	1	-4
0014	2F	02_7	16	23	1	2300	1100	-1200	0.04	0.48	4	1	-3
0014	2F	02_7	23	21	2	2100	1330	-770	0.10	0.63	3	2	-1
0014	2F	02_7	24	9	1	900	460	-440	0.11	0.51	1	0	-1
0014	2F	02_7	25	7	0	700	0	-700	0.00	0.00	1	0	-1
0014	2F	02_7	26	5	0	500	0	-500	0.00	0.00	0	0	0
0014	2F	03_1	12	129	40	12900	14000	1100	0.31	1.09	22	24	2
0014	2F	03_1	13	79	27	7900	10280	2380	0.34	1.30	13	18	5
0014	2F	03_1	14	56	8	5600	3590	-2010	0.14	0.64	9	6	-3
0014	2F	03_1	15	29	7	2900	4220	1320	0.24	1.46	5	7	2
0014	2F	03_1	16	15	1	1500	460	-1040	0.07	0.31	2	0	-2
0014	2F	03_1	23	5	0	500	0	-500	0.00	0.00	0	0	0
0014	2F	03_1	24	5	1	500	670	170	0.20	1.34	0	1	1
0014	2F	03_1	25	12	0	1200	0	-1200	0.00	0.00	2	0	-2
0014	2F	03_1	26	5	0	500	0	-500	0.00	0.00	0	0	0
0014	2F	03_2	12	126	31	12600	8900	-3700	0.25	0.71	22	15	-7
0014	2F	03_2	13	61	22	6100	7530	1430	0.36	1.23	10	13	3
0014	2F	03_2	14	35	9	3500	2980	-520	0.26	0.85	6	5	-1
0014	2F	03_2	15	28	7	2800	2360	-440	0.25	0.84	4	4	0
0014	2F	03_2	16	21	1	2100	1060	-1040	0.05	0.50	3	1	-2
0014	2F	03_2	23	17	4	1700	1600	-100	0.24	0.94	3	2	-1
0014	2F	03_2	24	7	1	700	900	200	0.14	1.29	1	1	0
0014	2F	03_2	25	4	0	400	0	-400	0.00	0.00	0	0	0
0014	2F	03_2	26	5	0	500	0	-500	0.00	0.00	0	0	0
0014	2F	03_3	12	159	56	15900	15320	-580	0.35	0.96	28	27	-1
0014	2F	03_3	13	83	20	8300	7380	-920	0.24	0.89	14	13	-1
0014	2F	03_3	14	46	6	4600	2690	-1910	0.13	0.58	8	4	-4
0014	2F	03_3	15	35	4	3500	3250	-250	0.11	0.93	6	5	-1
0014	2F	03_3	16	19	4	1900	2490	590	0.21	1.31	3	4	1
0014	2F	03_3	23	10	1	1000	460	-540	0.10	0.46	1	0	-1
0014	2F	03_3	24	4	1	400	390	-10	0.25	0.98	0	0	0
0014	2F	03_3	25	4	0	400	0	-400	0.00	0.00	0	0	0
0014	2F	03_3	26	4	0	400	0	-400	0.00	0.00	0	0	0
0014	2F	03_4	12	86	23	8600	6540	-2060	0.27	0.76	15	11	-4
0014	2F	03_4	13	60	18	6000	7670	1670	0.30	1.28	10	13	3
0014	2F	03_4	14	28	6	2800	2090	-710	0.21	0.75	4	3	-1
0014	2F	03_4	15	17	1	1700	320	-1380	0.06	0.19	3	0	-3
0014	2F	03_4	16	8	1	800	1140	340	0.13	1.43	1	2	1
0014	2F	03_4	23	8	4	800	3130	2330	0.50	3.91	1	5	4
0014	2F	03_4	24	3	0	300	0	-300	0.00	0.00	0	0	0
0014	2F	03_4	25	3	1	300	280	-20	0.33	0.93	0	0	0
0014	2F	03_4	26	2	1	200	9220	9020	0.50	46.10	0	16	16
0014	2F	03_5	12	58	23	5800	5870	70	0.40	1.01	10	10	0
0014	2F	03_5	13	41	10	4100	4990	890	0.24	1.22	7	8	1
0014	2F	03_5	14	13	1	1300	740	-560	0.08	0.57	2	1	-1
0014	2F	03_5	15	8	3	800	2180	1380	0.38	2.73	1	3	2
0014	2F	03_5	16	9	3	900	1300	400	0.33	1.44	1	2	1
0014	2F	03_5	23	3	0	300	0	-300	0.00	0.00	0	0	0
0014	2F	03_5	24	3	0	300	0	-300	0.00	0.00	0	0	0
0014	2F	03_5	25	1	1	100	1840	1740	1.00	18.40	0	3	3
0014	2F	03_5	26	1	0	100	0	-100	0.00	0.00	0	0	0
0014	2F	03_7	12	145	41	14500	12790	-1710	0.28	0.88	25	22	-3
0014	2F	03_7	13	84	20	8400	7030	-1370	0.24	0.84	14	12	-2
0014	2F	03_7	14	46	6	4600	2780	-1820	0.13	0.60	8	4	-4
0014	2F	03_7	15	23	2	2300	610	-1690	0.09	0.27	4	1	-3
0014	2F	03_7	16	21	2	2100	450	-1650	0.10	0.21	3	0	-3
0014	2F	03_7	23	15	0	1500	0	-1500	0.00	0.00	2	0	-2
0014	2F	03_7	24	11	1	1100	370	-730	0.09	0.34	1	0	-1
0014	2F	03_7	25	12	1	1200	300	-900	0.08	0.25	2	0	-2
0014	2F	03_7	26	3	0	300	0	-300	0.00	0.00	0	0	0
0014	2F	04_1	12	151	37	15100	14330	-770	0.25	0.95	26	25	-1
0014	2F	04_1	13	82	15	8200	5240	-2960	0.18	0.64	14	9	-5
0014	2F	04_1	14	75	11	7500	5870	-1630	0.15	0.78	13	10	-3
0014	2F	04_1	15	27	4	2700	1910	-790	0.15	0.71	4	3	-1
0014	2F	04_1	16	19	1	1900	420	-1480	0.05	0.22	3	0	-3
0014	2F	04_1	23	14	2	1400	590	-810	0.14	0.42	2	1	-1
0014	2F	04_1	24	6	1	600	270	-330	0.17	0.45	1	0	-1
0014	2F	04_1	25	4	2	400	720	320	0.50	1.80	0	1	1
0014	2F	04_1	26	7	0	700	0	-700	0.00	0.00	1	0	-1
0014	2F	04_2	12	140	40	14000	14030	30	0.29	1.00	24	24	0
0014	2F	04_2	13	83	24	8300	8260	-40	0.29	1.00	14	14	0
0014	2F	04_2	14	51	6	5100	1550	-3550	0.12	0.30	9	2	-7
0014	2F	04_2	15	43	7	4300	3290	-1010	0.16	0.77	7	5	-2
0014	2F	04_2	16	20	3	2000	1770	-230	0.15	0.89	3	3	0
0014	2F	04_2	23	7	3	700	1040	340	0.43	1.49	1	1	0
0014	2F	04_2	24	8	0	800	0	-800	0.00	0.00	1	0	-1
0014	2F	04_2	25	1	0	100	0	-100	0.00	0.00	0	0	0
0014	2F	04_2	26	1	0	100	0	-100	0.00	0.00	0	0	0
0014	2F	04_3	12	145	40	14500	11200	-3300	0.28	0.77	25	19	-6
0014	2F	04_3	13	92	24	9200	10470	1270	0.26	1.14	16	18	2
0014	2F	04_3	14	51	11	5100	5150	50	0.22	1.01	9	9	0
0014	2F	04_3	15	48	7	4800	2920	-1880	0.15	0.61	8	5	-3
0014	2F	04_3	16	18	3	1800	1780	-20	0.17	0.99	3	3	0
0014	2F	04_3	23	15	0	1500	0	-1500	0.00	0.00	2	0	-2
0014	2F	04_3	24	5	1	500	270	-230	0.20	0.54	0	0	0
0014	2F	04_3	25	5	0	500	0	-500	0.00	0.00	0	0	0
0014	2F	04_3	26	10	1	1000	480	-520	0.10	0.48	1	0	-1
0014	2F	04_4	12	128	35	12800	10890	-1910	0.27	0.85	22	19	-3
0014	2F	04_4	13	81	21	8100	7220	-880	0.26	0.89	14	12	-2
0014	2F	04_4	14	41	14	4100	5380	1280	0.34	1.31	7	9	2
0014	2F	04_4	15	16	3	1600	1950	350	0.19	1.22	2	3	1
0014	2F	04_4	16	13	3	1300	4800	3500	0.23	3.69	2	8	6
0014	2F	04_4	23	9	1	900	430	-470	0.11	0.48	1	0	-1
0014	2F	04_4	24	4	0	400	0	-400	0.00	0.00	0	0	0
0014	2F	04_4	25	5	1	500	540	40	0.20	1.08	0	0	0
0014	2F	04_4	26	4	0	400	0	-400	0.00	0.00	0	0	0
0014	2F	04_5	12	109	31	10900	10130	-770	0.28	0.93	19	17	-2
0014	2F	04_5	13	58	11	5800	3630	-2170	0.19	0.63	10	6	-4
0014	2F	04_5	14	34	8	3400	3380	-20	0.24	0.99	6	5	-1
0014	2F	04_5	15	23	1	2300	600	-1700	0.04	0.26	4	1	-3
0014	2F	04_5	16	18	3	1800	1160	-640	0.17	0.64	3	2	-1
0014	2F	04_5	23	5	1	500	340	-160	0.20	0.68	0	0	0
0014	2F	04_5	24	3	0	300	0	-300	0.00	0.00	0	0	0
0014	2F	04_5	25	4	0	400	0	-400	0.00	0.00	0	0	0
0014	2F	04_5	26	2	0	200	0	-200	0.00	0.00	0	0	0
0014	2F	04_7	12	134	36	13400	11730	-1670	0.27	0.88	23	20	-3
0014	2F	04_7	13	81	13	8100	4680	-3420	0.16	0.58	14	8	-6
0014	2F	04_7	14	47	5	4700	1960	-2740	0.11	0.42	8	3	-5
0014	2F	04_7	15	38	4	3800	1400	-2400	0.11	0.37	6	2	-4
0014	2F	04_7	16	16	1	1600	390	-1210	0.06	0.24	2	0	-2
0014	2F	04_7	23	19	2	1900	760	-1140	0.11	0.40	3	1	-2
0014	2F	04_7	24	11	2	1100	550	-550	0.18	0.50	1	0	-1
0014	2F	04_7	25	3	0	300	0	-300	0.00	0.00	0	0	0
0014	2F	04_7	26	7	1	700	740	40	0.14	1.06	1	1	0
0014	2F	05_1	12	167	51	16700	17930	1230	0.31	1.07	29	31	2
0014	2F	05_1	13	117	24	11700	8990	-2710	0.21	0.77	20	15	-5
0014	2F	05_1	14	78	15	7800	5110	-2690	0.19	0.66	13	9	-4
0014	2F	05_1	15	34	5	3400	5170	1770	0.15	1.52	6	9	3
0014	2F	05_1	16	11	0	1100	0	-1100	0.00	0.00	1	0	-1
0014	2F	05_1	23	14	3	1400	1570	170	0.21	1.12	2	2	0
0014	2F	05_1	24	8	0	800	0	-800	0.00	0.00	1	0	-1
0014	2F	05_1	25	4	0	400	0	-400	0.00	0.00	0	0	0
0014	2F	05_1	26	5	0	500	0	-500	0.00	0.00	0	0	0
0014	2F	05_2	12	169	50	16900	13910	-2990	0.30	0.82	29	24	-5
0014	2F	05_2	13	101	33	10100	13720	3620	0.33	1.36	17	24	7
0014	2F	05_2	14	72	18	7200	6290	-910	0.25	0.87	12	11	-1
0014	2F	05_2	15	37	3	3700	1170	-2530	0.08	0.32	6	2	-4
0014	2F	05_2	16	17	1	1700	550	-1150	0.06	0.32	3	0	-3
0014	2F	05_2	23	13	5	1300	2770	1470	0.38	2.13	2	4	2
0014	2F	05_2	24	7	1	700	590	-110	0.14	0.84	1	1	0
0014	2F	05_2	25	3	2	300	990	690	0.67	3.30	0	1	1
0014	2F	05_2	26	6	1	600	460	-140	0.17	0.77	1	0	-1
0014	2F	05_3	12	176	46	17600	15430	-2170	0.26	0.88	31	27	-4
0014	2F	05_3	13	83	17	8300	6380	-1920	0.20	0.77	14	11	-3
0014	2F	05_3	14	66	10	6600	4680	-1920	0.15	0.71	11	8	-3
0014	2F	05_3	15	44	6	4400	4470	70	0.14	1.02	7	7	0
0014	2F	05_3	16	21	2	2100	1270	-830	0.10	0.60	3	2	-1
0014	2F	05_3	23	16	3	1600	1100	-500	0.19	0.69	2	1	-1
0014	2F	05_3	24	13	0	1300	0	-1300	0.00	0.00	2	0	-2
0014	2F	05_3	25	10	2	1000	990	-10	0.20	0.99	1	1	0
0014	2F	05_3	26	9	0	900	0	-900	0.00	0.00	1	0	-1
0014	2F	05_4	12	146	34	14600	11990	-2610	0.23	0.82	25	21	-4
0014	2F	05_4	13	86	21	8600	6560	-2040	0.24	0.76	15	11	-4
0014	2F	05_4	14	64	13	6400	4770	-1630	0.20	0.75	11	8	-3
0014	2F	05_4	15	25	3	2500	1340	-1160	0.12	0.54	4	2	-2
0014	2F	05_4	16	8	2	800	2730	1930	0.25	3.41	1	4	3
0014	2F	05_4	23	13	2	1300	550	-750	0.15	0.42	2	0	-2
0014	2F	05_4	24	5	1	500	290	-210	0.20	0.58	0	0	0
0014	2F	05_4	25	6	1	600	320	-280	0.17	0.53	1	0	-1
0014	2F	05_4	26	5	2	500	510	10	0.40	1.02	0	0	0
0014	2F	05_5	12	102	30	10200	9180	-1020	0.29	0.90	18	16	-2
0014	2F	05_5	13	63	17	6300	7990	1690	0.27	1.27	11	14	3
0014	2F	05_5	14	40	15	4000	5340	1340	0.38	1.34	7	9	2
0014	2F	05_5	15	19	2	1900	950	-950	0.11	0.50	3	1	-2
0014	2F	05_5	16	9	0	900	0	-900	0.00	0.00	1	0	-1
0014	2F	05_5	23	5	1	500	260	-240	0.20	0.52	0	0	0
0014	2F	05_5	24	2	0	200	0	-200	0.00	0.00	0	0	0
0014	2F	05_5	25	2	0	200	0	-200	0.00	0.00	0	0	0
0014	2F	05_5	26	2	0	200	0	-200	0.00	0.00	0	0	0
0014	2F	05_6	12	3	2	300	330	30	0.67	1.10	0	0	0
0014	2F	05_6	13	5	2	500	1060	560	0.40	2.12	0	1	1
0014	2F	05_6	15	1	0	100	0	-100	0.00	0.00	0	0	0
0014	2F	05_7	12	158	50	15800	14840	-960	0.32	0.94	27	26	-1
0014	2F	05_7	13	110	28	11000	8620	-2380	0.25	0.78	19	15	-4
0014	2F	05_7	14	70	16	7000	5850	-1150	0.23	0.84	12	10	-2
0014	2F	05_7	15	30	2	3000	1820	-1180	0.07	0.61	5	3	-2
0014	2F	05_7	16	14	2	1400	1290	-110	0.14	0.92	2	2	0
0014	2F	05_7	23	14	1	1400	610	-790	0.07	0.44	2	1	-1
0014	2F	05_7	24	8	1	800	330	-470	0.13	0.41	1	0	-1
0014	2F	05_7	25	5	1	500	500	0	0.20	1.00	0	0	0
0014	2F	05_7	26	2	0	200	0	-200	0.00	0.00	0	0	0
0014	2F	06_1	12	221	47	22100	15320	-6780	0.21	0.69	39	27	-12
0014	2F	06_1	13	121	22	12100	6800	-5300	0.18	0.56	21	12	-9
0014	2F	06_1	14	85	20	8500	7670	-830	0.24	0.90	15	13	-2
0014	2F	06_1	15	26	4	2600	2650	50	0.15	1.02	4	4	0
0014	2F	06_1	16	10	1	1000	400	-600	0.10	0.40	1	0	-1
0014	2F	06_1	23	15	3	1500	2370	870	0.20	1.58	2	4	2
0014	2F	06_1	24	11	1	1100	1250	150	0.09	1.14	1	2	1
0014	2F	06_1	25	8	2	800	830	30	0.25	1.04	1	1	0
0014	2F	06_1	26	4	1	400	570	170	0.25	1.43	0	1	1
0014	2F	06_2	12	217	57	21700	17430	-4270	0.26	0.80	38	30	-8
0014	2F	06_2	13	123	25	12300	11780	-520	0.20	0.96	21	20	-1
0014	2F	06_2	14	80	12	8000	5290	-2710	0.15	0.66	14	9	-5
0014	2F	06_2	15	25	3	2500	1910	-590	0.12	0.76	4	3	-1
0014	2F	06_2	16	20	4	2000	2070	70	0.20	1.04	3	3	0
0014	2F	06_2	23	16	2	1600	1810	210	0.13	1.13	2	3	1
0014	2F	06_2	24	11	1	1100	360	-740	0.09	0.33	1	0	-1
0014	2F	06_2	25	6	1	600	390	-210	0.17	0.65	1	0	-1
0014	2F	06_2	26	4	0	400	0	-400	0.00	0.00	0	0	0
0014	2F	06_3	12	200	58	20000	18030	-1970	0.29	0.90	35	31	-4
0014	2F	06_3	13	127	36	12700	12460	-240	0.28	0.98	22	22	0
0014	2F	06_3	14	70	14	7000	5430	-1570	0.20	0.78	12	9	-3
0014	2F	06_3	15	32	2	3200	2200	-1000	0.06	0.69	5	3	-2
0014	2F	06_3	16	14	1	1400	890	-510	0.07	0.64	2	1	-1
0014	2F	06_3	23	12	1	1200	2290	1090	0.08	1.91	2	4	2
0014	2F	06_3	24	12	2	1200	1420	220	0.17	1.18	2	2	0
0014	2F	06_3	25	5	0	500	0	-500	0.00	0.00	0	0	0
0014	2F	06_3	26	3	0	300	0	-300	0.00	0.00	0	0	0
0014	2F	06_4	12	133	33	13300	9930	-3370	0.25	0.75	23	17	-6
0014	2F	06_4	13	77	14	7700	5760	-1940	0.18	0.75	13	10	-3
0014	2F	06_4	14	45	6	4500	3590	-910	0.13	0.80	7	6	-1
0014	2F	06_4	15	18	5	1800	1210	-590	0.28	0.67	3	2	-1
0014	2F	06_4	16	14	4	1400	2400	1000	0.29	1.71	2	4	2
0014	2F	06_4	23	16	2	1600	380	-1220	0.13	0.24	2	0	-2
0014	2F	06_4	24	9	0	900	0	-900	0.00	0.00	1	0	-1
0014	2F	06_4	25	7	0	700	0	-700	0.00	0.00	1	0	-1
0014	2F	06_4	26	2	0	200	0	-200	0.00	0.00	0	0	0
0014	2F	06_5	12	71	15	7100	5200	-1900	0.21	0.73	12	9	-3
0014	2F	06_5	13	38	7	3800	2040	-1760	0.18	0.54	6	3	-3
0014	2F	06_5	14	42	5	4200	2460	-1740	0.12	0.59	7	4	-3
0014	2F	06_5	15	10	1	1000	440	-560	0.10	0.44	1	0	-1
0014	2F	06_5	16	12	0	1200	0	-1200	0.00	0.00	2	0	-2
0014	2F	06_5	23	13	1	1300	1380	80	0.08	1.06	2	2	0
0014	2F	06_5	24	4	0	400	0	-400	0.00	0.00	0	0	0
0014	2F	06_5	25	3	0	300	0	-300	0.00	0.00	0	0	0
0014	2F	06_5	26	4	0	400	0	-400	0.00	0.00	0	0	0
0014	2F	06_6	12	14	3	1400	1870	470	0.21	1.34	2	3	1
0014	2F	06_6	13	3	1	300	280	-20	0.33	0.93	0	0	0
0014	2F	06_6	14	5	2	500	690	190	0.40	1.38	0	1	1
0014	2F	06_6	15	3	1	300	980	680	0.33	3.27	0	1	1
0014	2F	06_6	16	1	1	100	1560	1460	1.00	15.60	0	2	2
0014	2F	06_6	26	1	0	100	0	-100	0.00	0.00	0	0	0
0014	2F	06_7	12	215	66	21500	20100	-1400	0.31	0.93	38	35	-3
0014	2F	06_7	13	128	35	12800	11410	-1390	0.27	0.89	22	20	-2
0014	2F	06_7	14	87	16	8700	5470	-3230	0.18	0.63	15	9	-6
0014	2F	06_7	15	37	4	3700	2690	-1010	0.11	0.73	6	4	-2
0014	2F	06_7	16	14	1	1400	140	-1260	0.07	0.10	2	0	-2
0014	2F	06_7	23	11	1	1100	390	-710	0.09	0.35	1	0	-1
0014	2F	06_7	24	9	0	900	0	-900	0.00	0.00	1	0	-1
0014	2F	06_7	25	8	0	800	0	-800	0.00	0.00	1	0	-1
0014	2F	06_7	26	2	0	200	0	-200	0.00	0.00	0	0	0
0014	2F	07_1	12	171	43	17100	14810	-2290	0.25	0.87	30	26	-4
0014	2F	07_1	13	113	30	11300	8590	-2710	0.27	0.76	20	15	-5
0014	2F	07_1	14	66	17	6600	6080	-520	0.26	0.92	11	10	-1
0014	2F	07_1	15	40	11	4000	4980	980	0.28	1.25	7	8	1
0014	2F	07_1	16	16	5	1600	1750	150	0.31	1.09	2	3	1
0014	2F	07_1	23	7	2	700	660	-40	0.29	0.94	1	1	0
0014	2F	07_1	24	2	0	200	0	-200	0.00	0.00	0	0	0
0014	2F	07_1	25	6	0	600	0	-600	0.00	0.00	1	0	-1
0014	2F	07_1	26	5	0	500	0	-500	0.00	0.00	0	0	0
0014	2F	07_2	12	190	50	19000	16030	-2970	0.26	0.84	33	28	-5
0014	2F	07_2	13	102	34	10200	9190	-1010	0.33	0.90	18	16	-2
0014	2F	07_2	14	76	25	7600	8170	570	0.33	1.08	13	14	1
0014	2F	07_2	15	30	6	3000	2210	-790	0.20	0.74	5	3	-2
0014	2F	07_2	16	19	2	1900	2300	400	0.11	1.21	3	4	1
0014	2F	07_2	23	7	0	700	0	-700	0.00	0.00	1	0	-1
0014	2F	07_2	24	7	0	700	0	-700	0.00	0.00	1	0	-1
0014	2F	07_2	25	9	0	900	0	-900	0.00	0.00	1	0	-1
0014	2F	07_2	26	7	0	700	0	-700	0.00	0.00	1	0	-1
0014	2F	07_3	12	212	62	21200	21130	-70	0.29	1.00	37	37	0
0014	2F	07_3	13	107	25	10700	8480	-2220	0.23	0.79	18	15	-3
0014	2F	07_3	14	51	13	5100	2960	-2140	0.25	0.58	9	5	-4
0014	2F	07_3	15	33	5	3300	1700	-1600	0.15	0.52	5	3	-2
0014	2F	07_3	16	22	0	2200	0	-2200	0.00	0.00	3	0	-3
0014	2F	07_3	23	14	1	1400	610	-790	0.07	0.44	2	1	-1
0014	2F	07_3	24	6	1	600	500	-100	0.17	0.83	1	0	-1
0014	2F	07_3	25	8	1	800	550	-250	0.13	0.69	1	0	-1
0014	2F	07_3	26	5	1	500	970	470	0.20	1.94	0	1	1
0014	2F	07_4	12	171	53	17100	14220	-2880	0.31	0.83	30	25	-5
0014	2F	07_4	13	93	25	9300	9380	80	0.27	1.01	16	16	0
0014	2F	07_4	14	69	15	6900	5610	-1290	0.22	0.81	12	9	-3
0014	2F	07_4	15	13	3	1300	950	-350	0.23	0.73	2	1	-1
0014	2F	07_4	16	18	5	1800	7260	5460	0.28	4.03	3	12	9
0014	2F	07_4	23	10	2	1000	880	-120	0.20	0.88	1	1	0
0014	2F	07_4	24	4	0	400	0	-400	0.00	0.00	0	0	0
0014	2F	07_4	25	4	0	400	0	-400	0.00	0.00	0	0	0
0014	2F	07_4	26	4	1	400	210	-190	0.25	0.53	0	0	0
0014	2F	07_5	12	139	39	13900	11880	-2020	0.28	0.85	24	21	-3
0014	2F	07_5	13	67	21	6700	6970	270	0.31	1.04	11	12	1
0014	2F	07_5	14	50	11	5000	4100	-900	0.22	0.82	8	7	-1
0014	2F	07_5	15	21	4	2100	1400	-700	0.19	0.67	3	2	-1
0014	2F	07_5	16	21	6	2100	3460	1360	0.29	1.65	3	6	3
0014	2F	07_5	23	6	1	600	1370	770	0.17	2.28	1	2	1
0014	2F	07_5	24	1	0	100	0	-100	0.00	0.00	0	0	0
0014	2F	07_5	25	5	0	500	0	-500	0.00	0.00	0	0	0
0014	2F	07_5	26	1	0	100	0	-100	0.00	0.00	0	0	0
0014	2F	07_6	12	21	2	2100	410	-1690	0.10	0.20	3	0	-3
0014	2F	07_6	13	9	1	900	250	-650	0.11	0.28	1	0	-1
0014	2F	07_6	14	9	2	900	1630	730	0.22	1.81	1	2	1
0014	2F	07_6	15	6	0	600	0	-600	0.00	0.00	1	0	-1
0014	2F	07_6	16	4	0	400	0	-400	0.00	0.00	0	0	0
0014	2F	07_7	12	194	56	19400	15300	-4100	0.29	0.79	34	27	-7
0014	2F	07_7	13	130	35	13000	10570	-2430	0.27	0.81	23	18	-5
0014	2F	07_7	14	71	12	7100	3800	-3300	0.17	0.54	12	6	-6
0014	2F	07_7	15	26	5	2600	2350	-250	0.19	0.90	4	4	0
0014	2F	07_7	16	19	1	1900	460	-1440	0.05	0.24	3	0	-3
0014	2F	07_7	23	3	2	300	1510	1210	0.67	5.03	0	2	2
0014	2F	07_7	24	2	0	200	0	-200	0.00	0.00	0	0	0
0014	2F	07_7	25	5	0	500	0	-500	0.00	0.00	0	0	0
0014	2F	07_7	26	1	0	100	0	-100	0.00	0.00	0	0	0
0014	2F	08_1	12	218	64	21800	19530	-2270	0.29	0.90	38	34	-4
0014	2F	08_1	13	109	29	10900	7340	-3560	0.27	0.67	19	12	-7
0014	2F	08_1	14	71	16	7100	5660	-1440	0.23	0.80	12	10	-2
0014	2F	08_1	15	37	4	3700	2830	-870	0.11	0.76	6	5	-1
0014	2F	08_1	16	37	11	3700	4240	540	0.30	1.15	6	7	1
0014	2F	08_1	23	7	1	700	790	90	0.14	1.13	1	1	0
0014	2F	08_1	24	4	1	400	340	-60	0.25	0.85	0	0	0
0014	2F	08_1	25	6	0	600	0	-600	0.00	0.00	1	0	-1
0014	2F	08_1	26	5	0	500	0	-500	0.00	0.00	0	0	0
0014	2F	08_2	12	212	58	21200	17910	-3290	0.27	0.84	37	31	-6
0014	2F	08_2	13	135	37	13500	11160	-2340	0.27	0.83	23	19	-4
0014	2F	08_2	14	72	17	7200	5870	-1330	0.24	0.82	12	10	-2
0014	2F	08_2	15	39	10	3900	5270	1370	0.26	1.35	6	9	3
0014	2F	08_2	16	32	4	3200	1420	-1780	0.13	0.44	5	2	-3
0014	2F	08_2	23	4	0	400	0	-400	0.00	0.00	0	0	0
0014	2F	08_2	24	2	0	200	0	-200	0.00	0.00	0	0	0
0014	2F	08_2	25	4	0	400	0	-400	0.00	0.00	0	0	0
0014	2F	08_2	26	11	2	1100	890	-210	0.18	0.81	1	1	0
0014	2F	08_3	12	219	65	21900	16490	-5410	0.30	0.75	38	29	-9
0014	2F	08_3	13	137	40	13700	12860	-840	0.29	0.94	24	22	-2
0014	2F	08_3	14	66	12	6600	3800	-2800	0.18	0.58	11	6	-5
0014	2F	08_3	15	44	6	4400	2860	-1540	0.14	0.65	7	5	-2
0014	2F	08_3	16	11	0	1100	0	-1100	0.00	0.00	1	0	-1
0014	2F	08_3	23	8	1	800	600	-200	0.13	0.75	1	1	0
0014	2F	08_3	24	7	2	700	1130	430	0.29	1.61	1	2	1
0014	2F	08_3	25	5	1	500	400	-100	0.20	0.80	0	0	0
0014	2F	08_3	26	9	0	900	0	-900	0.00	0.00	1	0	-1
0014	2F	08_4	12	84	30	8400	8310	-90	0.36	0.99	14	14	0
0014	2F	08_4	13	40	10	4000	2760	-1240	0.25	0.69	7	4	-3
0014	2F	08_4	14	18	5	1800	1990	190	0.28	1.11	3	3	0
0014	2F	08_4	15	13	2	1300	730	-570	0.15	0.56	2	1	-1
0014	2F	08_4	16	6	0	600	0	-600	0.00	0.00	1	0	-1
0014	2F	08_4	23	3	0	300	0	-300	0.00	0.00	0	0	0
0014	2F	08_4	24	2	1	200	770	570	0.50	3.85	0	1	1
0014	2F	08_4	25	3	0	300	0	-300	0.00	0.00	0	0	0
0014	2F	08_4	26	1	0	100	0	-100	0.00	0.00	0	0	0
0014	2F	08_5	12	53	21	5300	7570	2270	0.40	1.43	9	13	4
0014	2F	08_5	13	26	7	2600	1810	-790	0.27	0.70	4	3	-1
0014	2F	08_5	14	16	9	1600	3000	1400	0.56	1.88	2	5	3
0014	2F	08_5	15	11	2	1100	1270	170	0.18	1.15	1	2	1
0014	2F	08_5	16	5	0	500	0	-500	0.00	0.00	0	0	0
0014	2F	08_5	24	1	0	100	0	-100	0.00	0.00	0	0	0
0014	2F	08_5	26	1	0	100	0	-100	0.00	0.00	0	0	0
0014	2F	08_6	12	5	2	500	1090	590	0.40	2.18	0	1	1
0014	2F	08_6	13	4	2	400	450	50	0.50	1.13	0	0	0
0014	2F	08_6	14	3	0	300	0	-300	0.00	0.00	0	0	0
0014	2F	08_6	15	5	1	500	280	-220	0.20	0.56	0	0	0
0014	2F	08_6	25	1	0	100	0	-100	0.00	0.00	0	0	0
0014	2F	08_7	12	240	89	24000	24080	80	0.37	1.00	42	42	0
0014	2F	08_7	13	122	39	12200	13670	1470	0.32	1.12	21	24	3
0014	2F	08_7	14	90	18	9000	5590	-3410	0.20	0.62	15	9	-6
0014	2F	08_7	15	41	7	4100	4690	590	0.17	1.14	7	8	1
0014	2F	08_7	16	23	4	2300	4030	1730	0.17	1.75	4	7	3
0014	2F	08_7	23	10	0	1000	0	-1000	0.00	0.00	1	0	-1
0014	2F	08_7	24	7	1	700	370	-330	0.14	0.53	1	0	-1
0014	2F	08_7	25	8	2	800	840	40	0.25	1.05	1	1	0
0014	2F	08_7	26	8	0	800	0	-800	0.00	0.00	1	0	-1
0014	2F	09_1	12	202	62	20200	14600	-5600	0.31	0.72	35	25	-10
0014	2F	09_1	13	102	25	10200	8300	-1900	0.25	0.81	18	14	-4
0014	2F	09_1	14	62	13	6200	6130	-70	0.21	0.99	10	10	0
0014	2F	09_1	15	25	3	2500	2560	60	0.12	1.02	4	4	0
0014	2F	09_1	16	17	1	1700	2210	510	0.06	1.30	3	3	0
0014	2F	09_1	23	21	5	2100	1680	-420	0.24	0.80	3	2	-1
0014	2F	09_1	24	10	2	1000	790	-210	0.20	0.79	1	1	0
0014	2F	09_1	25	10	0	1000	0	-1000	0.00	0.00	1	0	-1
0014	2F	09_1	26	2	1	200	1130	930	0.50	5.65	0	2	2
0014	2F	09_2	12	188	63	18800	18190	-610	0.34	0.97	33	32	-1
0014	2F	09_2	13	108	30	10800	11040	240	0.28	1.02	19	19	0
0014	2F	09_2	14	61	14	6100	7410	1310	0.23	1.21	10	13	3
0014	2F	09_2	15	30	3	3000	5000	2000	0.10	1.67	5	8	3
0014	2F	09_2	16	18	3	1800	1460	-340	0.17	0.81	3	2	-1
0014	2F	09_2	23	8	0	800	0	-800	0.00	0.00	1	0	-1
0014	2F	09_2	24	7	0	700	0	-700	0.00	0.00	1	0	-1
0014	2F	09_2	25	1	0	100	0	-100	0.00	0.00	0	0	0
0014	2F	09_2	26	7	2	700	670	-30	0.29	0.96	1	1	0
0014	2F	09_3	12	183	47	18300	11800	-6500	0.26	0.64	32	20	-12
0014	2F	09_3	13	102	20	10200	8540	-1660	0.20	0.84	18	15	-3
0014	2F	09_3	14	52	12	5200	4030	-1170	0.23	0.78	9	7	-2
0014	2F	09_3	15	41	6	4100	3000	-1100	0.15	0.73	7	5	-2
0014	2F	09_3	16	17	1	1700	280	-1420	0.06	0.16	3	0	-3
0014	2F	09_3	23	7	1	700	350	-350	0.14	0.50	1	0	-1
0014	2F	09_3	24	5	3	500	2390	1890	0.60	4.78	0	4	4
0014	2F	09_3	25	10	1	1000	1280	280	0.10	1.28	1	2	1
0014	2F	09_3	26	6	1	600	140	-460	0.17	0.23	1	0	-1
0014	2F	09_4	12	165	57	16500	16290	-210	0.35	0.99	29	28	-1
0014	2F	09_4	13	97	24	9700	7500	-2200	0.25	0.77	17	13	-4
0014	2F	09_4	14	46	7	4600	2430	-2170	0.15	0.53	8	4	-4
0014	2F	09_4	15	26	2	2600	890	-1710	0.08	0.34	4	1	-3
0014	2F	09_4	16	11	2	1100	1540	440	0.18	1.40	1	2	1
0014	2F	09_4	23	13	1	1300	310	-990	0.08	0.24	2	0	-2
0014	2F	09_4	24	4	0	400	0	-400	0.00	0.00	0	0	0
0014	2F	09_4	25	8	0	800	0	-800	0.00	0.00	1	0	-1
0014	2F	09_4	26	8	0	800	0	-800	0.00	0.00	1	0	-1
0014	2F	09_5	12	185	71	18500	16040	-2460	0.38	0.87	32	28	-4
0014	2F	09_5	13	108	25	10800	8600	-2200	0.23	0.80	19	15	-4
0014	2F	09_5	14	44	7	4400	4190	-210	0.16	0.95	7	7	0
0014	2F	09_5	15	26	4	2600	1510	-1090	0.15	0.58	4	2	-2
0014	2F	09_5	16	17	1	1700	190	-1510	0.06	0.11	3	0	-3
0014	2F	09_5	23	6	2	600	780	180	0.33	1.30	1	1	0
0014	2F	09_5	24	4	0	400	0	-400	0.00	0.00	0	0	0
0014	2F	09_5	25	3	0	300	0	-300	0.00	0.00	0	0	0
0014	2F	09_5	26	1	0	100	0	-100	0.00	0.00	0	0	0
0014	2F	09_7	12	237	88	23700	21760	-1940	0.37	0.92	41	38	-3
0014	2F	09_7	13	111	33	11100	12000	900	0.30	1.08	19	21	2
0014	2F	09_7	14	70	15	7000	6390	-610	0.21	0.91	12	11	-1
0014	2F	09_7	15	42	8	4200	4870	670	0.19	1.16	7	8	1
0014	2F	09_7	16	18	2	1800	1280	-520	0.11	0.71	3	2	-1
0014	2F	09_7	23	5	0	500	0	-500	0.00	0.00	0	0	0
0014	2F	09_7	24	2	0	200	0	-200	0.00	0.00	0	0	0
0014	2F	09_7	25	2	0	200	0	-200	0.00	0.00	0	0	0
0014	2F	09_7	26	2	0	200	0	-200	0.00	0.00	0	0	0
0014	2F	10_1	12	211	64	21100	18670	-2430	0.30	0.88	37	33	-4
0014	2F	10_1	13	110	21	11000	5460	-5540	0.19	0.50	19	9	-10
0014	2F	10_1	14	74	11	7400	6540	-860	0.15	0.88	13	11	-2
0014	2F	10_1	15	15	1	1500	1010	-490	0.07	0.67	2	1	-1
0014	2F	10_1	16	8	0	800	0	-800	0.00	0.00	1	0	-1
0014	2F	10_1	23	7	2	700	790	90	0.29	1.13	1	1	0
0014	2F	10_1	24	13	1	1300	320	-980	0.08	0.25	2	0	-2
0014	2F	10_1	25	2	0	200	0	-200	0.00	0.00	0	0	0
0014	2F	10_1	26	1	0	100	0	-100	0.00	0.00	0	0	0
0014	2F	10_2	12	183	52	18300	16490	-1810	0.28	0.90	32	29	-3
0014	2F	10_2	13	114	22	11400	6630	-4770	0.19	0.58	20	11	-9
0014	2F	10_2	14	68	15	6800	9010	2210	0.22	1.33	12	15	3
0014	2F	10_2	15	19	0	1900	0	-1900	0.00	0.00	3	0	-3
0014	2F	10_2	16	11	1	1100	440	-660	0.09	0.40	1	0	-1
0014	2F	10_2	23	13	1	1300	270	-1030	0.08	0.21	2	0	-2
0014	2F	10_2	24	6	1	600	4360	3760	0.17	7.27	1	7	6
0014	2F	10_2	25	3	0	300	0	-300	0.00	0.00	0	0	0
0014	2F	10_2	26	7	1	700	160	-540	0.14	0.23	1	0	-1
0014	2F	10_3	12	211	52	21100	17970	-3130	0.25	0.85	37	31	-6
0014	2F	10_3	13	98	22	9800	9160	-640	0.22	0.93	17	16	-1
0014	2F	10_3	14	66	6	6600	2090	-4510	0.09	0.32	11	3	-8
0014	2F	10_3	15	22	2	2200	1370	-830	0.09	0.62	3	2	-1
0014	2F	10_3	16	3	0	300	0	-300	0.00	0.00	0	0	0
0014	2F	10_3	23	15	0	1500	0	-1500	0.00	0.00	2	0	-2
0014	2F	10_3	24	7	1	700	1460	760	0.14	2.09	1	2	1
0014	2F	10_3	25	3	0	300	0	-300	0.00	0.00	0	0	0
0014	2F	10_3	26	1	0	100	0	-100	0.00	0.00	0	0	0
0014	2F	10_4	12	215	57	21500	15640	-5860	0.27	0.73	38	27	-11
0014	2F	10_4	13	98	20	9800	6370	-3430	0.20	0.65	17	11	-6
0014	2F	10_4	14	56	7	5600	2850	-2750	0.13	0.51	9	5	-4
0014	2F	10_4	15	23	1	2300	890	-1410	0.04	0.39	4	1	-3
0014	2F	10_4	16	2	0	200	0	-200	0.00	0.00	0	0	0
0014	2F	10_4	23	10	1	1000	630	-370	0.10	0.63	1	1	0
0014	2F	10_4	24	14	0	1400	0	-1400	0.00	0.00	2	0	-2
0014	2F	10_4	25	3	0	300	0	-300	0.00	0.00	0	0	0
0014	2F	10_5	12	138	47	13800	11450	-2350	0.34	0.83	24	20	-4
0014	2F	10_5	13	80	21	8000	6280	-1720	0.26	0.79	14	11	-3
0014	2F	10_5	14	58	10	5800	3400	-2400	0.17	0.59	10	6	-4
0014	2F	10_5	15	8	1	800	370	-430	0.13	0.46	1	0	-1
0014	2F	10_5	16	3	0	300	0	-300	0.00	0.00	0	0	0
0014	2F	10_5	23	6	0	600	0	-600	0.00	0.00	1	0	-1
0014	2F	10_5	24	5	0	500	0	-500	0.00	0.00	0	0	0
0014	2F	10_5	25	2	0	200	0	-200	0.00	0.00	0	0	0
0014	2F	10_5	26	1	0	100	0	-100	0.00	0.00	0	0	0
0014	2F	10_6	12	3	0	300	0	-300	0.00	0.00	0	0	0
0014	2F	10_6	13	2	0	200	0	-200	0.00	0.00	0	0	0
0014	2F	10_6	14	2	0	200	0	-200	0.00	0.00	0	0	0
0014	2F	10_7	12	249	87	24900	22130	-2770	0.35	0.89	44	39	-5
0014	2F	10_7	13	105	29	10500	9580	-920	0.28	0.91	18	16	-2
0014	2F	10_7	14	67	17	6700	7640	940	0.25	1.14	11	13	2
0014	2F	10_7	15	14	3	1400	5130	3730	0.21	3.66	2	9	7
0014	2F	10_7	16	2	0	200	0	-200	0.00	0.00	0	0	0
0014	2F	10_7	23	5	0	500	0	-500	0.00	0.00	0	0	0
0014	2F	10_7	24	6	0	600	0	-600	0.00	0.00	1	0	-1
0014	2F	10_7	25	1	0	100	0	-100	0.00	0.00	0	0	0
0014	2F	11_1	12	180	54	18000	14530	-3470	0.30	0.81	31	25	-6
0014	2F	11_1	13	105	27	10500	8620	-1880	0.26	0.82	18	15	-3
0014	2F	11_1	14	64	5	6400	2170	-4230	0.08	0.34	11	3	-8
0014	2F	11_1	15	24	2	2400	1250	-1150	0.08	0.52	4	2	-2
0014	2F	11_1	16	13	2	1300	3310	2010	0.15	2.55	2	5	3
0014	2F	11_1	23	5	0	500	0	-500	0.00	0.00	0	0	0
0014	2F	11_1	24	6	0	600	0	-600	0.00	0.00	1	0	-1
0014	2F	11_1	25	3	0	300	0	-300	0.00	0.00	0	0	0
0014	2F	11_1	26	2	0	200	0	-200	0.00	0.00	0	0	0
0014	2F	11_2	12	162	51	16200	14720	-1480	0.31	0.91	28	26	-2
0014	2F	11_2	13	80	22	8000	6720	-1280	0.28	0.84	14	11	-3
0014	2F	11_2	14	59	7	5900	1880	-4020	0.12	0.32	10	3	-7
0014	2F	11_2	15	17	1	1700	530	-1170	0.06	0.31	3	0	-3
0014	2F	11_2	16	26	5	2600	3190	590	0.19	1.23	4	5	1
0014	2F	11_2	23	9	1	900	230	-670	0.11	0.26	1	0	-1
0014	2F	11_2	24	11	3	1100	1010	-90	0.27	0.92	1	1	0
0014	2F	11_2	25	1	0	100	0	-100	0.00	0.00	0	0	0
0014	2F	11_2	26	11	2	1100	880	-220	0.18	0.80	1	1	0
0014	2F	11_3	12	162	57	16200	16610	410	0.35	1.03	28	29	1
0014	2F	11_3	13	85	18	8500	4780	-3720	0.21	0.56	15	8	-7
0014	2F	11_3	14	56	12	5600	3780	-1820	0.21	0.68	9	6	-3
0014	2F	11_3	15	28	5	2800	3000	200	0.18	1.07	4	5	1
0014	2F	11_3	16	13	3	1300	1810	510	0.23	1.39	2	3	1
0014	2F	11_3	23	10	0	1000	0	-1000	0.00	0.00	1	0	-1
0014	2F	11_3	24	7	1	700	1820	1120	0.14	2.60	1	3	2
0014	2F	11_3	25	8	1	800	420	-380	0.13	0.53	1	0	-1
0014	2F	11_3	26	3	0	300	0	-300	0.00	0.00	0	0	0
0014	2F	11_4	12	166	54	16600	17000	400	0.33	1.02	29	30	1
0014	2F	11_4	13	88	21	8800	5010	-3790	0.24	0.57	15	8	-7
0014	2F	11_4	14	44	10	4400	3730	-670	0.23	0.85	7	6	-1
0014	2F	11_4	15	31	2	3100	960	-2140	0.06	0.31	5	1	-4
0014	2F	11_4	16	7	2	700	970	270	0.29	1.39	1	1	0
0014	2F	11_4	23	9	3	900	1270	370	0.33	1.41	1	2	1
0014	2F	11_4	24	6	0	600	0	-600	0.00	0.00	1	0	-1
0014	2F	11_4	25	11	2	1100	910	-190	0.18	0.83	1	1	0
0014	2F	11_4	26	2	0	200	0	-200	0.00	0.00	0	0	0
0014	2F	11_5	12	153	64	15300	16640	1340	0.42	1.09	27	29	2
0014	2F	11_5	13	80	28	8000	8630	630	0.35	1.08	14	15	1
0014	2F	11_5	14	59	11	5900	2820	-3080	0.19	0.48	10	4	-6
0014	2F	11_5	15	15	1	1500	330	-1170	0.07	0.22	2	0	-2
0014	2F	11_5	16	5	1	500	720	220	0.20	1.44	0	1	1
0014	2F	11_5	23	7	1	700	1230	530	0.14	1.76	1	2	1
0014	2F	11_5	24	5	0	500	0	-500	0.00	0.00	0	0	0
0014	2F	11_5	26	1	0	100	0	-100	0.00	0.00	0	0	0
0014	2F	11_7	12	219	80	21900	17730	-4170	0.37	0.81	38	31	-7
0014	2F	11_7	13	84	24	8400	9490	1090	0.29	1.13	14	16	2
0014	2F	11_7	14	62	10	6200	3620	-2580	0.16	0.58	10	6	-4
0014	2F	11_7	15	22	0	2200	0	-2200	0.00	0.00	3	0	-3
0014	2F	11_7	16	11	1	1100	750	-350	0.09	0.68	1	1	0
0014	2F	11_7	23	3	0	300	0	-300	0.00	0.00	0	0	0
0014	2F	11_7	24	4	1	400	590	190	0.25	1.48	0	1	1
0014	2F	11_7	25	3	0	300	0	-300	0.00	0.00	0	0	0
0014	2F	11_7	26	1	0	100	0	-100	0.00	0.00	0	0	0
0014	2F	12_1	12	190	67	19000	19900	900	0.35	1.05	33	35	2
0014	2F	12_1	13	99	27	9900	7700	-2200	0.27	0.78	17	13	-4
0014	2F	12_1	14	51	7	5100	2490	-2610	0.14	0.49	9	4	-5
0014	2F	12_1	15	31	5	3100	2000	-1100	0.16	0.65	5	3	-2
0014	2F	12_1	16	22	1	2200	440	-1760	0.05	0.20	3	0	-3
0014	2F	12_1	23	6	2	600	1190	590	0.33	1.98	1	2	1
0014	2F	12_1	24	1	0	100	0	-100	0.00	0.00	0	0	0
0014	2F	12_1	25	3	1	300	880	580	0.33	2.93	0	1	1
0014	2F	12_1	26	2	0	200	0	-200	0.00	0.00	0	0	0
0014	2F	12_2	12	164	49	16400	10800	-5600	0.30	0.66	29	19	-10
0014	2F	12_2	13	102	29	10200	8230	-1970	0.28	0.81	18	14	-4
0014	2F	12_2	14	56	15	5600	4870	-730	0.27	0.87	9	8	-1
0014	2F	12_2	15	21	3	2100	1010	-1090	0.14	0.48	3	1	-2
0014	2F	12_2	16	32	7	3200	1580	-1620	0.22	0.49	5	2	-3
0014	2F	12_2	23	10	0	1000	0	-1000	0.00	0.00	1	0	-1
0014	2F	12_2	24	10	1	1000	1060	60	0.10	1.06	1	1	0
0014	2F	12_2	25	5	0	500	0	-500	0.00	0.00	0	0	0
0014	2F	12_3	12	178	45	17800	15660	-2140	0.25	0.88	31	27	-4
0014	2F	12_3	13	90	15	9000	4610	-4390	0.17	0.51	15	8	-7
0014	2F	12_3	14	54	10	5400	4380	-1020	0.19	0.81	9	7	-2
0014	2F	12_3	15	33	7	3300	4170	870	0.21	1.26	5	7	2
0014	2F	12_3	16	22	3	2200	510	-1690	0.14	0.23	3	0	-3
0014	2F	12_3	23	14	2	1400	970	-430	0.14	0.69	2	1	-1
0014	2F	12_3	24	5	1	500	330	-170	0.20	0.66	0	0	0
0014	2F	12_3	25	6	1	600	530	-70	0.17	0.88	1	0	-1
0014	2F	12_3	26	2	0	200	0	-200	0.00	0.00	0	0	0
0014	2F	12_4	12	164	51	16400	13610	-2790	0.31	0.83	29	24	-5
0014	2F	12_4	13	74	17	7400	5420	-1980	0.23	0.73	13	9	-4
0014	2F	12_4	14	49	5	4900	1450	-3450	0.10	0.30	8	2	-6
0014	2F	12_4	15	32	5	3200	5480	2280	0.16	1.71	5	9	4
0014	2F	12_4	16	8	3	800	670	-130	0.38	0.84	1	1	0
0014	2F	12_4	23	8	2	800	970	170	0.25	1.21	1	1	0
0014	2F	12_4	24	7	2	700	1730	1030	0.29	2.47	1	3	2
0014	2F	12_4	25	9	2	900	740	-160	0.22	0.82	1	1	0
0014	2F	12_4	26	3	1	300	5510	5210	0.33	18.37	0	9	9
0014	2F	12_5	12	146	51	14600	13420	-1180	0.35	0.92	25	23	-2
0014	2F	12_5	13	68	25	6800	7620	820	0.37	1.12	12	13	1
0014	2F	12_5	14	45	7	4500	2710	-1790	0.16	0.60	7	4	-3
0014	2F	12_5	15	24	5	2400	3210	810	0.21	1.34	4	5	1
0014	2F	12_5	16	17	3	1700	850	-850	0.18	0.50	3	1	-2
0014	2F	12_5	23	3	0	300	0	-300	0.00	0.00	0	0	0
0014	2F	12_5	24	2	0	200	0	-200	0.00	0.00	0	0	0
0014	2F	12_5	25	1	0	100	0	-100	0.00	0.00	0	0	0
0014	2F	12_6	12	18	4	1800	700	-1100	0.22	0.39	3	1	-2
0014	2F	12_6	13	5	2	500	390	-110	0.40	0.78	0	0	0
0014	2F	12_6	14	5	1	500	630	130	0.20	1.26	0	1	1
0014	2F	12_6	15	2	0	200	0	-200	0.00	0.00	0	0	0
0014	2F	12_6	16	1	0	100	0	-100	0.00	0.00	0	0	0
0014	2F	12_6	26	1	0	100	0	-100	0.00	0.00	0	0	0
0014	2F	12_7	12	211	65	21100	18260	-2840	0.31	0.87	37	32	-5
0014	2F	12_7	13	99	22	9900	6050	-3850	0.22	0.61	17	10	-7
0014	2F	12_7	14	50	7	5000	3050	-1950	0.14	0.61	8	5	-3
0014	2F	12_7	15	27	6	2700	3760	1060	0.22	1.39	4	6	2
0014	2F	12_7	16	12	1	1200	250	-950	0.08	0.21	2	0	-2
0014	2F	12_7	23	10	1	1000	310	-690	0.10	0.31	1	0	-1
0014	2F	12_7	24	4	0	400	0	-400	0.00	0.00	0	0	0
0014	2F	12_7	25	3	0	300	0	-300	0.00	0.00	0	0	0
0014	2F	13_1	12	172	49	17200	14260	-2940	0.28	0.83	30	25	-5
0014	2F	13_1	13	109	29	10900	9380	-1520	0.27	0.86	19	16	-3
0014	2F	13_1	14	79	21	7900	7350	-550	0.27	0.93	13	13	0
0014	2F	13_1	15	23	1	2300	490	-1810	0.04	0.21	4	0	-4
0014	2F	13_1	16	11	2	1100	930	-170	0.18	0.85	1	1	0
0014	2F	13_1	23	11	1	1100	980	-120	0.09	0.89	1	1	0
0014	2F	13_1	24	12	2	1200	1200	0	0.17	1.00	2	2	0
0014	2F	13_1	25	3	0	300	0	-300	0.00	0.00	0	0	0
0014	2F	13_1	26	1	0	100	0	-100	0.00	0.00	0	0	0
0014	2F	13_2	12	172	59	17200	21860	4660	0.34	1.27	30	38	8
0014	2F	13_2	13	92	20	9200	6720	-2480	0.22	0.73	16	11	-5
0014	2F	13_2	14	66	18	6600	6760	160	0.27	1.02	11	11	0
0014	2F	13_2	15	39	4	3900	2090	-1810	0.10	0.54	6	3	-3
0014	2F	13_2	16	15	4	1500	6960	5460	0.27	4.64	2	12	10
0014	2F	13_2	23	12	2	1200	2890	1690	0.17	2.41	2	5	3
0014	2F	13_2	24	11	1	1100	290	-810	0.09	0.26	1	0	-1
0014	2F	13_2	25	8	2	800	1220	420	0.25	1.53	1	2	1
0014	2F	13_2	26	6	2	600	1500	900	0.33	2.50	1	2	1
0014	2F	13_3	12	157	39	15700	12220	-3480	0.25	0.78	27	21	-6
0014	2F	13_3	13	96	29	9600	11210	1610	0.30	1.17	16	19	3
0014	2F	13_3	14	52	6	5200	3720	-1480	0.12	0.72	9	6	-3
0014	2F	13_3	15	34	7	3400	3090	-310	0.21	0.91	6	5	-1
0014	2F	13_3	16	19	3	1900	1450	-450	0.16	0.76	3	2	-1
0014	2F	13_3	23	9	1	900	380	-520	0.11	0.42	1	0	-1
0014	2F	13_3	24	7	0	700	0	-700	0.00	0.00	1	0	-1
0014	2F	13_3	25	4	0	400	0	-400	0.00	0.00	0	0	0
0014	2F	13_3	26	6	0	600	0	-600	0.00	0.00	1	0	-1
0014	2F	13_4	12	165	50	16500	15700	-800	0.30	0.95	29	27	-2
0014	2F	13_4	13	104	42	10400	12400	2000	0.40	1.19	18	21	3
0014	2F	13_4	14	56	11	5600	3520	-2080	0.20	0.63	9	6	-3
0014	2F	13_4	15	14	2	1400	1100	-300	0.14	0.79	2	1	-1
0014	2F	13_4	16	10	1	1000	340	-660	0.10	0.34	1	0	-1
0014	2F	13_4	23	9	2	900	520	-380	0.22	0.58	1	0	-1
0014	2F	13_4	24	8	0	800	0	-800	0.00	0.00	1	0	-1
0014	2F	13_4	25	7	0	700	0	-700	0.00	0.00	1	0	-1
0014	2F	13_4	26	3	0	300	0	-300	0.00	0.00	0	0	0
0014	2F	13_5	12	137	54	13700	12950	-750	0.39	0.95	24	22	-2
0014	2F	13_5	13	92	31	9200	10500	1300	0.34	1.14	16	18	2
0014	2F	13_5	14	59	11	5900	3550	-2350	0.19	0.60	10	6	-4
0014	2F	13_5	15	24	3	2400	1160	-1240	0.13	0.48	4	2	-2
0014	2F	13_5	16	11	0	1100	0	-1100	0.00	0.00	1	0	-1
0014	2F	13_5	23	4	0	400	0	-400	0.00	0.00	0	0	0
0014	2F	13_5	24	1	0	100	0	-100	0.00	0.00	0	0	0
0014	2F	13_5	25	2	0	200	0	-200	0.00	0.00	0	0	0
0014	2F	13_5	26	1	0	100	0	-100	0.00	0.00	0	0	0
0014	2F	13_6	12	18	7	1800	1210	-590	0.39	0.67	3	2	-1
0014	2F	13_6	13	16	5	1600	1380	-220	0.31	0.86	2	2	0
0014	2F	13_6	14	7	2	700	500	-200	0.29	0.71	1	0	-1
0014	2F	13_6	15	2	1	200	160	-40	0.50	0.80	0	0	0
0014	2F	13_6	16	1	0	100	0	-100	0.00	0.00	0	0	0
0014	2F	13_7	12	170	61	17000	17650	650	0.36	1.04	30	31	1
0014	2F	13_7	13	105	17	10500	4720	-5780	0.16	0.45	18	8	-10
0014	2F	13_7	14	81	21	8100	6550	-1550	0.26	0.81	14	11	-3
0014	2F	13_7	15	25	3	2500	1440	-1060	0.12	0.58	4	2	-2
0014	2F	13_7	16	8	0	800	0	-800	0.00	0.00	1	0	-1
0014	2F	13_7	23	5	1	500	740	240	0.20	1.48	0	1	1
0014	2F	13_7	24	5	0	500	0	-500	0.00	0.00	0	0	0
0014	2F	13_7	25	7	0	700	0	-700	0.00	0.00	1	0	-1
0014	2F	13_7	26	1	0	100	0	-100	0.00	0.00	0	0	0
0014	2F	14_1	12	181	44	18100	14980	-3120	0.24	0.83	32	26	-6
0014	2F	14_1	13	91	18	9100	7370	-1730	0.20	0.81	16	13	-3
0014	2F	14_1	14	81	14	8100	4950	-3150	0.17	0.61	14	8	-6
0014	2F	14_1	15	24	3	2400	2450	50	0.13	1.02	4	4	0
0014	2F	14_1	16	9	0	900	0	-900	0.00	0.00	1	0	-1
0014	2F	14_1	23	12	3	1200	4050	2850	0.25	3.38	2	7	5
0014	2F	14_1	24	9	0	900	0	-900	0.00	0.00	1	0	-1
0014	2F	14_1	25	5	0	500	0	-500	0.00	0.00	0	0	0
0014	2F	14_1	26	1	0	100	0	-100	0.00	0.00	0	0	0
0014	2F	14_2	12	172	58	17200	20860	3660	0.34	1.21	30	36	6
0014	2F	14_2	13	91	15	9100	5640	-3460	0.16	0.62	16	9	-7
0014	2F	14_2	14	87	13	8700	6040	-2660	0.15	0.69	15	10	-5
0014	2F	14_2	15	22	1	2200	500	-1700	0.05	0.23	3	0	-3
0014	2F	14_2	16	9	0	900	0	-900	0.00	0.00	1	0	-1
0014	2F	14_2	23	12	2	1200	8620	7420	0.17	7.18	2	15	13
0014	2F	14_2	24	12	1	1200	3470	2270	0.08	2.89	2	6	4
0014	2F	14_2	25	3	0	300	0	-300	0.00	0.00	0	0	0
0014	2F	14_2	26	1	0	100	0	-100	0.00	0.00	0	0	0
0014	2F	14_3	12	167	36	16700	12810	-3890	0.22	0.77	29	22	-7
0014	2F	14_3	13	101	22	10100	10690	590	0.22	1.06	17	18	1
0014	2F	14_3	14	100	13	10000	6000	-4000	0.13	0.60	17	10	-7
0014	2F	14_3	15	39	2	3900	4690	790	0.05	1.20	6	8	2
0014	2F	14_3	16	4	0	400	0	-400	0.00	0.00	0	0	0
0014	2F	14_3	23	13	1	1300	11020	9720	0.08	8.48	2	19	17
0014	2F	14_3	24	10	1	1000	300	-700	0.10	0.30	1	0	-1
0014	2F	14_3	25	5	1	500	650	150	0.20	1.30	0	1	1
0014	2F	14_4	12	142	37	14200	11160	-3040	0.26	0.79	25	19	-6
0014	2F	14_4	13	94	23	9400	10130	730	0.24	1.08	16	17	1
0014	2F	14_4	14	64	12	6400	5970	-430	0.19	0.93	11	10	-1
0014	2F	14_4	15	18	4	1800	7710	5910	0.22	4.28	3	13	10
0014	2F	14_4	16	9	0	900	0	-900	0.00	0.00	1	0	-1
0014	2F	14_4	23	14	0	1400	0	-1400	0.00	0.00	2	0	-2
0014	2F	14_4	24	9	0	900	0	-900	0.00	0.00	1	0	-1
0014	2F	14_4	25	5	0	500	0	-500	0.00	0.00	0	0	0
0014	2F	14_4	26	1	0	100	0	-100	0.00	0.00	0	0	0
0014	2F	14_5	12	96	24	9600	7150	-2450	0.25	0.74	16	12	-4
0014	2F	14_5	13	51	7	5100	3100	-2000	0.14	0.61	9	5	-4
0014	2F	14_5	14	39	5	3900	2570	-1330	0.13	0.66	6	4	-2
0014	2F	14_5	15	13	2	1300	850	-450	0.15	0.65	2	1	-1
0014	2F	14_5	16	2	1	200	1350	1150	0.50	6.75	0	2	2
0014	2F	14_5	23	5	1	500	730	230	0.20	1.46	0	1	1
0014	2F	14_5	24	4	0	400	0	-400	0.00	0.00	0	0	0
0014	2F	14_5	25	2	0	200	0	-200	0.00	0.00	0	0	0
0014	2F	14_5	26	1	0	100	0	-100	0.00	0.00	0	0	0
0014	2F	14_6	12	11	3	1100	1050	-50	0.27	0.95	1	1	0
0014	2F	14_6	13	3	0	300	0	-300	0.00	0.00	0	0	0
0014	2F	14_6	14	2	0	200	0	-200	0.00	0.00	0	0	0
0014	2F	14_6	15	3	1	300	1180	880	0.33	3.93	0	2	2
0014	2F	14_6	24	1	0	100	0	-100	0.00	0.00	0	0	0
0014	2F	14_7	12	205	58	20500	16820	-3680	0.28	0.82	36	29	-7
0014	2F	14_7	13	100	21	10000	8170	-1830	0.21	0.82	17	14	-3
0014	2F	14_7	14	77	20	7700	8470	770	0.26	1.10	13	14	1
0014	2F	14_7	15	31	2	3100	760	-2340	0.06	0.25	5	1	-4
0014	2F	14_7	16	5	0	500	0	-500	0.00	0.00	0	0	0
0014	2F	14_7	23	8	0	800	0	-800	0.00	0.00	1	0	-1
0014	2F	14_7	24	5	0	500	0	-500	0.00	0.00	0	0	0
0014	2F	14_7	25	7	0	700	0	-700	0.00	0.00	1	0	-1
0014	2F	14_7	26	4	0	400	0	-400	0.00	0.00	0	0	0
0014	2F	15_1	12	200	54	20000	15400	-4600	0.27	0.77	35	27	-8
0014	2F	15_1	13	120	35	12000	10060	-1940	0.29	0.84	21	17	-4
0014	2F	15_1	14	67	12	6700	5390	-1310	0.18	0.80	11	9	-2
0014	2F	15_1	15	23	5	2300	3190	890	0.22	1.39	4	5	1
0014	2F	15_1	16	15	1	1500	270	-1230	0.07	0.18	2	0	-2
0014	2F	15_1	23	12	3	1200	930	-270	0.25	0.78	2	1	-1
0014	2F	15_1	24	5	1	500	1720	1220	0.20	3.44	0	3	3
0014	2F	15_1	25	2	0	200	0	-200	0.00	0.00	0	0	0
0014	2F	15_1	26	5	0	500	0	-500	0.00	0.00	0	0	0
0014	2F	15_2	12	204	65	20400	20100	-300	0.32	0.99	36	35	-1
0014	2F	15_2	13	111	32	11100	12800	1700	0.29	1.15	19	22	3
0014	2F	15_2	14	88	15	8800	5390	-3410	0.17	0.61	15	9	-6
0014	2F	15_2	15	29	5	2900	3490	590	0.17	1.20	5	6	1
0014	2F	15_2	16	17	3	1700	1880	180	0.18	1.11	3	3	0
0014	2F	15_2	23	14	1	1400	1890	490	0.07	1.35	2	3	1
0014	2F	15_2	24	2	1	200	290	90	0.50	1.45	0	0	0
0014	2F	15_2	25	6	1	600	190	-410	0.17	0.32	1	0	-1
0014	2F	15_2	26	2	0	200	0	-200	0.00	0.00	0	0	0
0014	2F	15_3	12	216	60	21600	17280	-4320	0.28	0.80	38	30	-8
0014	2F	15_3	13	100	22	10000	8230	-1770	0.22	0.82	17	14	-3
0014	2F	15_3	14	80	23	8000	9790	1790	0.29	1.22	14	17	3
0014	2F	15_3	15	37	3	3700	1820	-1880	0.08	0.49	6	3	-3
0014	2F	15_3	16	5	1	500	1230	730	0.20	2.46	0	2	2
0014	2F	15_3	23	8	1	800	300	-500	0.13	0.38	1	0	-1
0014	2F	15_3	24	8	2	800	1430	630	0.25	1.79	1	2	1
0014	2F	15_3	25	4	1	400	180	-220	0.25	0.45	0	0	0
0014	2F	15_3	26	2	0	200	0	-200	0.00	0.00	0	0	0
0014	2F	15_4	12	169	55	16900	14080	-2820	0.33	0.83	29	24	-5
0014	2F	15_4	13	103	30	10300	9190	-1110	0.29	0.89	18	16	-2
0014	2F	15_4	14	75	19	7500	8950	1450	0.25	1.19	13	15	2
0014	2F	15_4	15	17	0	1700	0	-1700	0.00	0.00	3	0	-3
0014	2F	15_4	16	16	2	1600	810	-790	0.13	0.51	2	1	-1
0014	2F	15_4	23	6	1	600	380	-220	0.17	0.63	1	0	-1
0014	2F	15_4	24	8	2	800	1220	420	0.25	1.53	1	2	1
0014	2F	15_4	25	5	0	500	0	-500	0.00	0.00	0	0	0
0014	2F	15_4	26	2	1	200	490	290	0.50	2.45	0	0	0
0014	2F	15_5	12	162	40	16200	13990	-2210	0.25	0.86	28	24	-4
0014	2F	15_5	13	72	18	7200	5620	-1580	0.25	0.78	12	9	-3
0014	2F	15_5	14	39	14	3900	5170	1270	0.36	1.33	6	9	3
0014	2F	15_5	15	20	2	2000	570	-1430	0.10	0.29	3	1	-2
0014	2F	15_5	16	16	5	1600	1710	110	0.31	1.07	2	3	1
0014	2F	15_5	23	1	0	100	0	-100	0.00	0.00	0	0	0
0014	2F	15_5	24	3	0	300	0	-300	0.00	0.00	0	0	0
0014	2F	15_5	25	3	0	300	0	-300	0.00	0.00	0	0	0
0014	2F	15_5	26	4	0	400	0	-400	0.00	0.00	0	0	0
0014	2F	15_6	12	28	7	2800	2290	-510	0.25	0.82	4	4	0
0014	2F	15_6	13	16	5	1600	1630	30	0.31	1.02	2	2	0
0014	2F	15_6	14	6	0	600	0	-600	0.00	0.00	1	0	-1
0014	2F	15_6	15	4	0	400	0	-400	0.00	0.00	0	0	0
0014	2F	15_6	16	1	1	100	270	170	1.00	2.70	0	0	0
0014	2F	15_6	23	1	0	100	0	-100	0.00	0.00	0	0	0
0014	2F	15_6	24	1	0	100	0	-100	0.00	0.00	0	0	0
0014	2F	15_7	12	247	88	24700	21450	-3250	0.36	0.87	43	37	-6
0014	2F	15_7	13	99	24	9900	7850	-2050	0.24	0.79	17	13	-4
0014	2F	15_7	14	85	20	8500	8540	40	0.24	1.00	15	15	0
0014	2F	15_7	15	33	4	3300	2420	-880	0.12	0.73	5	4	-1
0014	2F	15_7	16	23	7	2300	6530	4230	0.30	2.84	4	11	7
0014	2F	15_7	23	6	0	600	0	-600	0.00	0.00	1	0	-1
0014	2F	15_7	24	3	0	300	0	-300	0.00	0.00	0	0	0
0014	2F	15_7	25	4	1	400	850	450	0.25	2.13	0	1	1
0014	2F	15_7	26	2	0	200	0	-200	0.00	0.00	0	0	0
0014	2F	16_1	12	244	64	24400	17930	-6470	0.26	0.73	43	31	-12
0014	2F	16_1	13	120	20	12000	9900	-2100	0.17	0.83	21	17	-4
0014	2F	16_1	14	89	25	8900	8390	-510	0.28	0.94	15	14	-1
0014	2F	16_1	15	33	3	3300	2450	-850	0.09	0.74	5	4	-1
0014	2F	16_1	16	15	3	1500	1450	-50	0.20	0.97	2	2	0
0014	2F	16_1	23	4	0	400	0	-400	0.00	0.00	0	0	0
0014	2F	16_1	24	8	1	800	1340	540	0.13	1.68	1	2	1
0014	2F	16_1	25	2	0	200	0	-200	0.00	0.00	0	0	0
0014	2F	16_1	26	1	0	100	0	-100	0.00	0.00	0	0	0
0014	2F	16_2	12	206	62	20600	18960	-1640	0.30	0.92	36	33	-3
0014	2F	16_2	13	98	22	9800	7410	-2390	0.22	0.76	17	13	-4
0014	2F	16_2	14	76	19	7600	4640	-2960	0.25	0.61	13	8	-5
0014	2F	16_2	15	31	5	3100	4960	1860	0.16	1.60	5	8	3
0014	2F	16_2	16	21	3	2100	1860	-240	0.14	0.89	3	3	0
0014	2F	16_2	23	11	0	1100	0	-1100	0.00	0.00	1	0	-1
0014	2F	16_2	24	8	0	800	0	-800	0.00	0.00	1	0	-1
0014	2F	16_2	25	8	1	800	670	-130	0.13	0.84	1	1	0
0014	2F	16_2	26	9	2	900	1690	790	0.22	1.88	1	2	1
0014	2F	16_3	12	194	62	19400	17360	-2040	0.32	0.89	34	30	-4
0014	2F	16_3	13	117	28	11700	9640	-2060	0.24	0.82	20	17	-3
0014	2F	16_3	14	62	16	6200	9190	2990	0.26	1.48	10	16	6
0014	2F	16_3	15	31	4	3100	2250	-850	0.13	0.73	5	3	-2
0014	2F	16_3	16	13	0	1300	0	-1300	0.00	0.00	2	0	-2
0014	2F	16_3	23	14	1	1400	250	-1150	0.07	0.18	2	0	-2
0014	2F	16_3	24	2	0	200	0	-200	0.00	0.00	0	0	0
0014	2F	16_3	25	7	1	700	370	-330	0.14	0.53	1	0	-1
0014	2F	16_3	26	7	0	700	0	-700	0.00	0.00	1	0	-1
0014	2F	16_4	12	189	60	18900	14350	-4550	0.32	0.76	33	25	-8
0014	2F	16_4	13	119	36	11900	12150	250	0.30	1.02	21	21	0
0014	2F	16_4	14	64	25	6400	7060	660	0.39	1.10	11	12	1
0014	2F	16_4	15	22	2	2200	1840	-360	0.09	0.84	3	3	0
0014	2F	16_4	16	12	1	1200	630	-570	0.08	0.53	2	1	-1
0014	2F	16_4	23	10	0	1000	0	-1000	0.00	0.00	1	0	-1
0014	2F	16_4	24	9	0	900	0	-900	0.00	0.00	1	0	-1
0014	2F	16_4	25	8	2	800	870	70	0.25	1.09	1	1	0
0014	2F	16_4	26	3	0	300	0	-300	0.00	0.00	0	0	0
0014	2F	16_5	12	192	64	19200	16670	-2530	0.33	0.87	33	29	-4
0014	2F	16_5	13	100	23	10000	9320	-680	0.23	0.93	17	16	-1
0014	2F	16_5	14	75	26	7500	6610	-890	0.35	0.88	13	11	-2
0014	2F	16_5	15	20	4	2000	2500	500	0.20	1.25	3	4	1
0014	2F	16_5	16	8	0	800	0	-800	0.00	0.00	1	0	-1
0014	2F	16_5	23	7	0	700	0	-700	0.00	0.00	1	0	-1
0014	2F	16_5	24	1	1	100	1420	1320	1.00	14.20	0	2	2
0014	2F	16_5	25	1	0	100	0	-100	0.00	0.00	0	0	0
0014	2F	16_5	26	1	0	100	0	-100	0.00	0.00	0	0	0
0014	2F	16_7	12	223	78	22300	19920	-2380	0.35	0.89	39	35	-4
0014	2F	16_7	13	128	28	12800	7980	-4820	0.22	0.62	22	14	-8
0014	2F	16_7	14	83	19	8300	6490	-1810	0.23	0.78	14	11	-3
0014	2F	16_7	15	27	6	2700	3310	610	0.22	1.23	4	5	1
0014	2F	16_7	16	24	4	2400	1760	-640	0.17	0.73	4	3	-1
0014	2F	16_7	23	7	0	700	0	-700	0.00	0.00	1	0	-1
0014	2F	16_7	24	1	0	100	0	-100	0.00	0.00	0	0	0
0014	2F	16_7	26	2	0	200	0	-200	0.00	0.00	0	0	0
0014	2F	17_1	12	211	61	21100	16870	-4230	0.29	0.80	37	29	-8
0014	2F	17_1	13	142	35	14200	13120	-1080	0.25	0.92	25	23	-2
0014	2F	17_1	14	67	14	6700	5820	-880	0.21	0.87	11	10	-1
0014	2F	17_1	15	31	2	3100	3600	500	0.06	1.16	5	6	1
0014	2F	17_1	16	9	0	900	0	-900	0.00	0.00	1	0	-1
0014	2F	17_1	23	12	1	1200	380	-820	0.08	0.32	2	0	-2
0014	2F	17_1	24	5	0	500	0	-500	0.00	0.00	0	0	0
0014	2F	17_1	25	5	0	500	0	-500	0.00	0.00	0	0	0
0014	2F	17_1	26	4	1	400	330	-70	0.25	0.83	0	0	0
0014	2F	17_2	12	224	68	22400	22700	300	0.30	1.01	39	40	1
0014	2F	17_2	13	123	33	12300	10840	-1460	0.27	0.88	21	19	-2
0014	2F	17_2	14	79	13	7900	6730	-1170	0.16	0.85	13	11	-2
0014	2F	17_2	15	25	3	2500	1090	-1410	0.12	0.44	4	1	-3
0014	2F	17_2	16	8	1	800	110	-690	0.13	0.14	1	0	-1
0014	2F	17_2	23	9	2	900	2990	2090	0.22	3.32	1	5	4
0014	2F	17_2	24	10	2	1000	1040	40	0.20	1.04	1	1	0
0014	2F	17_2	25	4	2	400	1010	610	0.50	2.53	0	1	1
0014	2F	17_2	26	2	1	200	1970	1770	0.50	9.85	0	3	3
0014	2F	17_3	12	216	79	21600	23260	1660	0.37	1.08	38	41	3
0014	2F	17_3	13	123	36	12300	11200	-1100	0.29	0.91	21	19	-2
0014	2F	17_3	14	74	12	7400	7080	-320	0.16	0.96	13	12	-1
0014	2F	17_3	15	28	7	2800	2770	-30	0.25	0.99	4	4	0
0014	2F	17_3	16	10	2	1000	1260	260	0.20	1.26	1	2	1
0014	2F	17_3	23	10	2	1000	3040	2040	0.20	3.04	1	5	4
0014	2F	17_3	24	7	0	700	0	-700	0.00	0.00	1	0	-1
0014	2F	17_3	25	6	1	600	520	-80	0.17	0.87	1	0	-1
0014	2F	17_3	26	4	1	400	1200	800	0.25	3.00	0	2	2
0014	2F	17_4	12	173	40	17300	12700	-4600	0.23	0.73	30	22	-8
0014	2F	17_4	13	116	34	11600	12630	1030	0.29	1.09	20	22	2
0014	2F	17_4	14	58	12	5800	3600	-2200	0.21	0.62	10	6	-4
0014	2F	17_4	15	24	5	2400	3440	1040	0.21	1.43	4	6	2
0014	2F	17_4	16	5	0	500	0	-500	0.00	0.00	0	0	0
0014	2F	17_4	23	12	3	1200	860	-340	0.25	0.72	2	1	-1
0014	2F	17_4	24	8	1	800	190	-610	0.13	0.24	1	0	-1
0014	2F	17_4	25	3	0	300	0	-300	0.00	0.00	0	0	0
0014	2F	17_4	26	1	0	100	0	-100	0.00	0.00	0	0	0
0014	2F	17_5	12	180	51	18000	13390	-4610	0.28	0.74	31	23	-8
0014	2F	17_5	13	86	28	8600	8220	-380	0.33	0.96	15	14	-1
0014	2F	17_5	14	49	13	4900	4010	-890	0.27	0.82	8	7	-1
0014	2F	17_5	15	22	3	2200	5200	3000	0.14	2.36	3	9	6
0014	2F	17_5	16	7	1	700	250	-450	0.14	0.36	1	0	-1
0014	2F	17_5	23	2	0	200	0	-200	0.00	0.00	0	0	0
0014	2F	17_5	24	2	0	200	0	-200	0.00	0.00	0	0	0
0014	2F	17_5	25	2	0	200	0	-200	0.00	0.00	0	0	0
0014	2F	17_7	12	248	66	24800	20080	-4720	0.27	0.81	43	35	-8
0014	2F	17_7	13	117	27	11700	10500	-1200	0.23	0.90	20	18	-2
0014	2F	17_7	14	75	13	7500	3470	-4030	0.17	0.46	13	6	-7
0014	2F	17_7	15	17	1	1700	730	-970	0.06	0.43	3	1	-2
0014	2F	17_7	16	10	0	1000	0	-1000	0.00	0.00	1	0	-1
0014	2F	17_7	23	8	2	800	4070	3270	0.25	5.09	1	7	6
0014	2F	17_7	24	3	0	300	0	-300	0.00	0.00	0	0	0
0014	2F	17_7	25	2	1	200	430	230	0.50	2.15	0	0	0
0014	2F	17_7	26	2	0	200	0	-200	0.00	0.00	0	0	0
0014	2F	18_1	12	219	65	21900	16700	-5200	0.30	0.76	38	29	-9
0014	2F	18_1	13	120	28	12000	10210	-1790	0.23	0.85	21	18	-3
0014	2F	18_1	14	78	22	7800	10910	3110	0.28	1.40	13	19	6
0014	2F	18_1	15	26	6	2600	6270	3670	0.23	2.41	4	11	7
0014	2F	18_1	16	9	0	900	0	-900	0.00	0.00	1	0	-1
0014	2F	18_1	23	14	3	1400	1310	-90	0.21	0.94	2	2	0
0014	2F	18_1	24	15	1	1500	420	-1080	0.07	0.28	2	0	-2
0014	2F	18_1	25	3	1	300	580	280	0.33	1.93	0	1	1
0014	2F	18_1	26	4	0	400	0	-400	0.00	0.00	0	0	0
0014	2F	18_2	12	236	78	23600	21350	-2250	0.33	0.90	41	37	-4
0014	2F	18_2	13	97	16	9700	7080	-2620	0.16	0.73	17	12	-5
0014	2F	18_2	14	94	17	9400	5750	-3650	0.18	0.61	16	10	-6
0014	2F	18_2	15	25	3	2500	1730	-770	0.12	0.69	4	3	-1
0014	2F	18_2	16	5	0	500	0	-500	0.00	0.00	0	0	0
0014	2F	18_2	23	10	2	1000	450	-550	0.20	0.45	1	0	-1
0014	2F	18_2	24	6	2	600	4720	4120	0.33	7.87	1	8	7
0014	2F	18_2	25	6	1	600	300	-300	0.17	0.50	1	0	-1
0014	2F	18_2	26	3	0	300	0	-300	0.00	0.00	0	0	0
0014	2F	18_3	12	209	75	20900	20510	-390	0.36	0.98	36	36	0
0014	2F	18_3	13	115	37	11500	14610	3110	0.32	1.27	20	25	5
0014	2F	18_3	14	70	10	7000	4400	-2600	0.14	0.63	12	7	-5
0014	2F	18_3	15	28	2	2800	640	-2160	0.07	0.23	4	1	-3
0014	2F	18_3	16	12	0	1200	0	-1200	0.00	0.00	2	0	-2
0014	2F	18_3	23	16	3	1600	2720	1120	0.19	1.70	2	4	2
0014	2F	18_3	24	13	0	1300	0	-1300	0.00	0.00	2	0	-2
0014	2F	18_3	25	2	0	200	0	-200	0.00	0.00	0	0	0
0014	2F	18_3	26	4	0	400	0	-400	0.00	0.00	0	0	0
0014	2F	18_4	12	217	75	21700	19610	-2090	0.35	0.90	38	34	-4
0014	2F	18_4	13	120	23	12000	8870	-3130	0.19	0.74	21	15	-6
0014	2F	18_4	14	76	11	7600	6730	-870	0.14	0.89	13	11	-2
0014	2F	18_4	15	31	0	3100	0	-3100	0.00	0.00	5	0	-5
0014	2F	18_4	16	9	1	900	660	-240	0.11	0.73	1	1	0
0014	2F	18_4	23	12	0	1200	0	-1200	0.00	0.00	2	0	-2
0014	2F	18_4	24	10	0	1000	0	-1000	0.00	0.00	1	0	-1
0014	2F	18_4	25	2	0	200	0	-200	0.00	0.00	0	0	0
0014	2F	18_4	26	4	0	400	0	-400	0.00	0.00	0	0	0
0014	2F	18_5	12	205	67	20500	18750	-1750	0.33	0.91	36	33	-3
0014	2F	18_5	13	97	22	9700	8360	-1340	0.23	0.86	17	14	-3
0014	2F	18_5	14	86	15	8600	7680	-920	0.17	0.89	15	13	-2
0014	2F	18_5	15	26	4	2600	2080	-520	0.15	0.80	4	3	-1
0014	2F	18_5	16	4	0	400	0	-400	0.00	0.00	0	0	0
0014	2F	18_5	23	9	1	900	220	-680	0.11	0.24	1	0	-1
0014	2F	18_5	24	4	0	400	0	-400	0.00	0.00	0	0	0
0014	2F	18_5	25	4	0	400	0	-400	0.00	0.00	0	0	0
0014	2F	18_6	12	21	9	2100	1720	-380	0.43	0.82	3	3	0
0014	2F	18_6	13	12	2	1200	640	-560	0.17	0.53	2	1	-1
0014	2F	18_6	14	8	2	800	360	-440	0.25	0.45	1	0	-1
0014	2F	18_6	15	7	2	700	1610	910	0.29	2.30	1	2	1
0014	2F	18_6	23	1	0	100	0	-100	0.00	0.00	0	0	0
0014	2F	18_7	12	219	82	21900	19250	-2650	0.37	0.88	38	34	-4
0014	2F	18_7	13	130	31	13000	10300	-2700	0.24	0.79	23	18	-5
0014	2F	18_7	14	88	20	8800	11050	2250	0.23	1.26	15	19	4
0014	2F	18_7	15	23	5	2300	3060	760	0.22	1.33	4	5	1
0014	2F	18_7	16	6	0	600	0	-600	0.00	0.00	1	0	-1
0014	2F	18_7	23	10	0	1000	0	-1000	0.00	0.00	1	0	-1
0014	2F	18_7	24	9	0	900	0	-900	0.00	0.00	1	0	-1
0014	2F	18_7	25	2	0	200	0	-200	0.00	0.00	0	0	0
0014	2F	18_7	26	5	0	500	0	-500	0.00	0.00	0	0	0
0014	2F	19_1	12	171	51	17100	15610	-1490	0.30	0.91	30	27	-3
0014	2F	19_1	13	140	34	14000	8930	-5070	0.24	0.64	24	15	-9
0014	2F	19_1	14	76	25	7600	6320	-1280	0.33	0.83	13	11	-2
0014	2F	19_1	15	12	3	1200	2430	1230	0.25	2.03	2	4	2
0014	2F	19_1	16	16	2	1600	740	-860	0.13	0.46	2	1	-1
0014	2F	19_1	23	5	0	500	0	-500	0.00	0.00	0	0	0
0014	2F	19_1	24	4	0	400	0	-400	0.00	0.00	0	0	0
0014	2F	19_1	26	5	1	500	380	-120	0.20	0.76	0	0	0
0014	2F	19_2	12	155	46	15500	12930	-2570	0.30	0.83	27	22	-5
0014	2F	19_2	13	99	29	9900	8220	-1680	0.29	0.83	17	14	-3
0014	2F	19_2	14	90	26	9000	7230	-1770	0.29	0.80	15	12	-3
0014	2F	19_2	15	17	3	1700	1500	-200	0.18	0.88	3	2	-1
0014	2F	19_2	16	23	5	2300	3420	1120	0.22	1.49	4	6	2
0014	2F	19_2	23	9	1	900	1290	390	0.11	1.43	1	2	1
0014	2F	19_2	24	4	0	400	0	-400	0.00	0.00	0	0	0
0014	2F	19_2	25	1	0	100	0	-100	0.00	0.00	0	0	0
0014	2F	19_2	26	6	1	600	290	-310	0.17	0.48	1	0	-1
0014	2F	19_3	12	221	72	22100	19260	-2840	0.33	0.87	39	34	-5
0014	2F	19_3	13	97	23	9700	5510	-4190	0.24	0.57	17	9	-8
0014	2F	19_3	14	80	18	8000	4180	-3820	0.23	0.52	14	7	-7
0014	2F	19_3	15	26	4	2600	2050	-550	0.15	0.79	4	3	-1
0014	2F	19_3	16	10	1	1000	230	-770	0.10	0.23	1	0	-1
0014	2F	19_3	23	4	0	400	0	-400	0.00	0.00	0	0	0
0014	2F	19_3	24	2	0	200	0	-200	0.00	0.00	0	0	0
0014	2F	19_3	25	1	0	100	0	-100	0.00	0.00	0	0	0
0014	2F	19_3	26	6	1	600	310	-290	0.17	0.52	1	0	-1
0014	2F	19_4	12	163	55	16300	14450	-1850	0.34	0.89	28	25	-3
0014	2F	19_4	13	102	30	10200	7870	-2330	0.29	0.77	18	13	-5
0014	2F	19_4	14	66	17	6600	6220	-380	0.26	0.94	11	11	0
0014	2F	19_4	15	11	3	1100	2740	1640	0.27	2.49	1	4	3
0014	2F	19_4	16	8	0	800	0	-800	0.00	0.00	1	0	-1
0014	2F	19_4	23	11	3	1100	1780	680	0.27	1.62	1	3	2
0014	2F	19_4	24	3	0	300	0	-300	0.00	0.00	0	0	0
0014	2F	19_4	26	3	0	300	0	-300	0.00	0.00	0	0	0
0014	2F	19_5	12	119	31	11900	11250	-650	0.26	0.95	21	19	-2
0014	2F	19_5	13	79	28	7900	9060	1160	0.35	1.15	13	16	3
0014	2F	19_5	14	51	11	5100	4740	-360	0.22	0.93	9	8	-1
0014	2F	19_5	15	8	2	800	1660	860	0.25	2.08	1	2	1
0014	2F	19_5	16	4	0	400	0	-400	0.00	0.00	0	0	0
0014	2F	19_5	23	11	2	1100	1000	-100	0.18	0.91	1	1	0
0014	2F	19_5	24	1	0	100	0	-100	0.00	0.00	0	0	0
0014	2F	19_5	25	3	1	300	480	180	0.33	1.60	0	0	0
0014	2F	19_5	26	4	1	400	1820	1420	0.25	4.55	0	3	3
0014	2F	19_6	12	17	6	1700	1180	-520	0.35	0.69	3	2	-1
0014	2F	19_6	13	12	5	1200	1480	280	0.42	1.23	2	2	0
0014	2F	19_6	14	4	1	400	310	-90	0.25	0.78	0	0	0
0014	2F	19_6	15	4	0	400	0	-400	0.00	0.00	0	0	0
0014	2F	19_6	16	1	0	100	0	-100	0.00	0.00	0	0	0
0014	2F	19_6	24	1	0	100	0	-100	0.00	0.00	0	0	0
0014	2F	19_6	25	3	0	300	0	-300	0.00	0.00	0	0	0
0014	2F	19_7	12	198	65	19800	17950	-1850	0.33	0.91	35	31	-4
0014	2F	19_7	13	123	41	12300	14400	2100	0.33	1.17	21	25	4
0014	2F	19_7	14	79	19	7900	6750	-1150	0.24	0.85	13	11	-2
0014	2F	19_7	15	19	4	1900	2260	360	0.21	1.19	3	4	1
0014	2F	19_7	16	10	3	1000	1310	310	0.30	1.31	1	2	1
0014	2F	19_7	23	14	2	1400	1360	-40	0.14	0.97	2	2	0
0014	2F	19_7	24	1	0	100	0	-100	0.00	0.00	0	0	0
0014	2F	19_7	25	1	0	100	0	-100	0.00	0.00	0	0	0
0014	2F	20_1	12	191	62	19100	17760	-1340	0.32	0.93	33	31	-2
0014	2F	20_1	13	141	45	14100	12840	-1260	0.32	0.91	24	22	-2
0014	2F	20_1	14	79	17	7900	9320	1420	0.22	1.18	13	16	3
0014	2F	20_1	15	20	3	2000	3740	1740	0.15	1.87	3	6	3
0014	2F	20_1	16	15	2	1500	2370	870	0.13	1.58	2	4	2
0014	2F	20_1	23	5	1	500	760	260	0.20	1.52	0	1	1
0014	2F	20_1	24	1	0	100	0	-100	0.00	0.00	0	0	0
0014	2F	20_1	26	3	0	300	0	-300	0.00	0.00	0	0	0
0014	2F	20_2	12	178	52	17800	13070	-4730	0.29	0.73	31	23	-8
0014	2F	20_2	13	99	24	9900	6040	-3860	0.24	0.61	17	10	-7
0014	2F	20_2	14	76	14	7600	4470	-3130	0.18	0.59	13	7	-6
0014	2F	20_2	15	27	4	2700	2160	-540	0.15	0.80	4	3	-1
0014	2F	20_2	16	30	11	3000	5860	2860	0.37	1.95	5	10	5
0014	2F	20_2	23	5	0	500	0	-500	0.00	0.00	0	0	0
0014	2F	20_2	24	2	0	200	0	-200	0.00	0.00	0	0	0
0014	2F	20_2	25	3	1	300	680	380	0.33	2.27	0	1	1
0014	2F	20_2	26	3	1	300	670	370	0.33	2.23	0	1	1
0014	2F	20_3	12	197	68	19700	16300	-3400	0.35	0.83	34	28	-6
0014	2F	20_3	13	117	37	11700	13000	1300	0.32	1.11	20	23	3
0014	2F	20_3	14	61	10	6100	4190	-1910	0.16	0.69	10	7	-3
0014	2F	20_3	15	33	7	3300	3630	330	0.21	1.10	5	6	1
0014	2F	20_3	16	14	4	1400	1700	300	0.29	1.21	2	3	1
0014	2F	20_3	23	5	0	500	0	-500	0.00	0.00	0	0	0
0014	2F	20_3	24	2	0	200	0	-200	0.00	0.00	0	0	0
0014	2F	20_3	26	3	0	300	0	-300	0.00	0.00	0	0	0
0014	2F	20_4	12	150	44	15000	11250	-3750	0.29	0.75	26	19	-7
0014	2F	20_4	13	87	25	8700	8110	-590	0.29	0.93	15	14	-1
0014	2F	20_4	14	73	18	7300	4790	-2510	0.25	0.66	12	8	-4
0014	2F	20_4	15	31	8	3100	4580	1480	0.26	1.48	5	8	3
0014	2F	20_4	16	10	1	1000	350	-650	0.10	0.35	1	0	-1
0014	2F	20_4	23	5	1	500	480	-20	0.20	0.96	0	0	0
0014	2F	20_4	24	2	0	200	0	-200	0.00	0.00	0	0	0
0014	2F	20_4	25	3	0	300	0	-300	0.00	0.00	0	0	0
0014	2F	20_5	12	142	52	14200	12750	-1450	0.37	0.90	25	22	-3
0014	2F	20_5	13	73	10	7300	2310	-4990	0.14	0.32	12	4	-8
0014	2F	20_5	14	64	16	6400	6970	570	0.25	1.09	11	12	1
0014	2F	20_5	15	22	2	2200	820	-1380	0.09	0.37	3	1	-2
0014	2F	20_5	16	6	0	600	0	-600	0.00	0.00	1	0	-1
0014	2F	20_5	23	7	0	700	0	-700	0.00	0.00	1	0	-1
0014	2F	20_5	24	4	1	400	470	70	0.25	1.18	0	0	0
0014	2F	20_5	25	2	0	200	0	-200	0.00	0.00	0	0	0
0014	2F	20_5	26	1	0	100	0	-100	0.00	0.00	0	0	0
0014	2F	20_6	12	30	10	3000	2250	-750	0.33	0.75	5	3	-2
0014	2F	20_6	13	16	6	1600	3120	1520	0.38	1.95	2	5	3
0014	2F	20_6	14	10	1	1000	490	-510	0.10	0.49	1	0	-1
0014	2F	20_6	15	3	0	300	0	-300	0.00	0.00	0	0	0
0014	2F	20_6	16	4	0	400	0	-400	0.00	0.00	0	0	0
0014	2F	20_6	23	1	0	100	0	-100	0.00	0.00	0	0	0
0014	2F	20_7	12	187	54	18700	12690	-6010	0.29	0.68	33	22	-11
0014	2F	20_7	13	113	29	11300	9760	-1540	0.26	0.86	20	17	-3
0014	2F	20_7	14	87	18	8700	12400	3700	0.21	1.43	15	21	6
0014	2F	20_7	15	37	6	3700	3580	-120	0.16	0.97	6	6	0
0014	2F	20_7	16	14	2	1400	670	-730	0.14	0.48	2	1	-1
0014	2F	20_7	23	4	2	400	1360	960	0.50	3.40	0	2	2
0014	2F	20_7	24	3	0	300	0	-300	0.00	0.00	0	0	0
0014	2F	20_7	25	2	0	200	0	-200	0.00	0.00	0	0	0
0014	2F	20_7	26	2	0	200	0	-200	0.00	0.00	0	0	0
0014	2F	21_1	12	212	60	21200	15660	-5540	0.28	0.74	37	27	-10
0014	2F	21_1	13	106	32	10600	9590	-1010	0.30	0.90	18	16	-2
0014	2F	21_1	14	91	17	9100	7690	-1410	0.19	0.85	16	13	-3
0014	2F	21_1	15	31	3	3100	2600	-500	0.10	0.84	5	4	-1
0014	2F	21_1	16	7	0	700	0	-700	0.00	0.00	1	0	-1
0014	2F	21_1	23	6	0	600	0	-600	0.00	0.00	1	0	-1
0014	2F	21_1	24	6	1	600	3870	3270	0.17	6.45	1	6	5
0014	2F	21_1	26	2	0	200	0	-200	0.00	0.00	0	0	0
0014	2F	21_2	12	211	60	21100	16030	-5070	0.28	0.76	37	28	-9
0014	2F	21_2	13	139	32	13900	9980	-3920	0.23	0.72	24	17	-7
0014	2F	21_2	14	64	14	6400	4550	-1850	0.22	0.71	11	8	-3
0014	2F	21_2	15	37	3	3700	1610	-2090	0.08	0.44	6	2	-4
0014	2F	21_2	16	15	0	1500	0	-1500	0.00	0.00	2	0	-2
0014	2F	21_2	23	8	0	800	0	-800	0.00	0.00	1	0	-1
0014	2F	21_2	24	5	0	500	0	-500	0.00	0.00	0	0	0
0014	2F	21_2	25	5	0	500	0	-500	0.00	0.00	0	0	0
0014	2F	21_2	26	1	0	100	0	-100	0.00	0.00	0	0	0
0014	2F	21_3	12	212	63	21200	15570	-5630	0.30	0.73	37	27	-10
0014	2F	21_3	13	128	39	12800	10990	-1810	0.30	0.86	22	19	-3
0014	2F	21_3	14	75	10	7500	3580	-3920	0.13	0.48	13	6	-7
0014	2F	21_3	15	27	2	2700	370	-2330	0.07	0.14	4	0	-4
0014	2F	21_3	16	7	1	700	560	-140	0.14	0.80	1	0	-1
0014	2F	21_3	23	4	1	400	500	100	0.25	1.25	0	0	0
0014	2F	21_3	24	1	0	100	0	-100	0.00	0.00	0	0	0
0014	2F	21_3	25	2	0	200	0	-200	0.00	0.00	0	0	0
0014	2F	21_3	26	1	1	100	580	480	1.00	5.80	0	1	1
0014	2F	21_4	12	175	51	17500	14900	-2600	0.29	0.85	30	26	-4
0014	2F	21_4	13	107	33	10700	9110	-1590	0.31	0.85	18	16	-2
0014	2F	21_4	14	73	16	7300	5740	-1560	0.22	0.79	12	10	-2
0014	2F	21_4	15	30	6	3000	2420	-580	0.20	0.81	5	4	-1
0014	2F	21_4	16	8	0	800	0	-800	0.00	0.00	1	0	-1
0014	2F	21_4	23	5	0	500	0	-500	0.00	0.00	0	0	0
0014	2F	21_4	24	3	0	300	0	-300	0.00	0.00	0	0	0
0014	2F	21_4	25	3	0	300	0	-300	0.00	0.00	0	0	0
0014	2F	21_4	26	1	0	100	0	-100	0.00	0.00	0	0	0
0014	2F	21_5	12	160	53	16000	13750	-2250	0.33	0.86	28	24	-4
0014	2F	21_5	13	109	25	10900	8370	-2530	0.23	0.77	19	14	-5
0014	2F	21_5	14	57	13	5700	5700	0	0.23	1.00	10	10	0
0014	2F	21_5	15	21	3	2100	3020	920	0.14	1.44	3	5	2
0014	2F	21_5	16	6	0	600	0	-600	0.00	0.00	1	0	-1
0014	2F	21_5	23	6	0	600	0	-600	0.00	0.00	1	0	-1
0014	2F	21_5	24	2	0	200	0	-200	0.00	0.00	0	0	0
0014	2F	21_5	25	1	0	100	0	-100	0.00	0.00	0	0	0
0014	2F	21_6	12	10	3	1000	830	-170	0.30	0.83	1	1	0
0014	2F	21_6	13	10	3	1000	720	-280	0.30	0.72	1	1	0
0014	2F	21_6	14	6	1	600	670	70	0.17	1.12	1	1	0
0014	2F	21_6	15	3	0	300	0	-300	0.00	0.00	0	0	0
0014	2F	21_6	16	1	0	100	0	-100	0.00	0.00	0	0	0
0014	2F	21_6	24	1	1	100	710	610	1.00	7.10	0	1	1
0014	2F	21_6	25	1	1	100	1660	1560	1.00	16.60	0	2	2
0014	2F	21_7	12	227	69	22700	18380	-4320	0.30	0.81	40	32	-8
0014	2F	21_7	13	122	33	12200	11590	-610	0.27	0.95	21	20	-1
0014	2F	21_7	14	88	16	8800	6360	-2440	0.18	0.72	15	11	-4
0014	2F	21_7	15	25	1	2500	500	-2000	0.04	0.20	4	0	-4
0014	2F	21_7	16	9	1	900	490	-410	0.11	0.54	1	0	-1
0014	2F	21_7	23	9	1	900	660	-240	0.11	0.73	1	1	0
0014	2F	21_7	24	4	0	400	0	-400	0.00	0.00	0	0	0
0014	2F	21_7	25	2	0	200	0	-200	0.00	0.00	0	0	0
0014	2F	21_7	26	1	0	100	0	-100	0.00	0.00	0	0	0
0014	2F	22_1	12	189	56	18900	17020	-1880	0.30	0.90	33	30	-3
0014	2F	22_1	13	107	34	10700	9720	-980	0.32	0.91	18	17	-1
0014	2F	22_1	14	69	22	6900	8240	1340	0.32	1.19	12	14	2
0014	2F	22_1	15	21	2	2100	510	-1590	0.10	0.24	3	0	-3
0014	2F	22_1	16	12	2	1200	1330	130	0.17	1.11	2	2	0
0014	2F	22_1	23	11	2	1100	600	-500	0.18	0.55	1	1	0
0014	2F	22_1	24	2	1	200	110	-90	0.50	0.55	0	0	0
0014	2F	22_1	25	6	1	600	180	-420	0.17	0.30	1	0	-1
0014	2F	22_1	26	4	0	400	0	-400	0.00	0.00	0	0	0
0014	2F	22_2	12	176	59	17600	17190	-410	0.34	0.98	31	30	-1
0014	2F	22_2	13	92	22	9200	5820	-3380	0.24	0.63	16	10	-6
0014	2F	22_2	14	74	14	7400	4640	-2760	0.19	0.63	13	8	-5
0014	2F	22_2	15	21	1	2100	390	-1710	0.05	0.19	3	0	-3
0014	2F	22_2	16	12	0	1200	0	-1200	0.00	0.00	2	0	-2
0014	2F	22_2	23	6	2	600	1840	1240	0.33	3.07	1	3	2
0014	2F	22_2	24	7	2	700	720	20	0.29	1.03	1	1	0
0014	2F	22_2	25	4	0	400	0	-400	0.00	0.00	0	0	0
0014	2F	22_2	26	5	3	500	1400	900	0.60	2.80	0	2	2
0014	2F	22_3	12	163	59	16300	17150	850	0.36	1.05	28	30	2
0014	2F	22_3	13	89	15	8900	4650	-4250	0.17	0.52	15	8	-7
0014	2F	22_3	14	53	11	5300	3470	-1830	0.21	0.65	9	6	-3
0014	2F	22_3	15	29	4	2900	1840	-1060	0.14	0.63	5	3	-2
0014	2F	22_3	16	12	1	1200	180	-1020	0.08	0.15	2	0	-2
0014	2F	22_3	23	4	0	400	0	-400	0.00	0.00	0	0	0
0014	2F	22_3	24	3	0	300	0	-300	0.00	0.00	0	0	0
0014	2F	22_3	25	6	2	600	540	-60	0.33	0.90	1	0	-1
0014	2F	22_3	26	3	1	300	340	40	0.33	1.13	0	0	0
0014	2F	22_4	12	154	43	15400	10660	-4740	0.28	0.69	27	18	-9
0014	2F	22_4	13	102	29	10200	8690	-1510	0.28	0.85	18	15	-3
0014	2F	22_4	14	55	11	5500	3320	-2180	0.20	0.60	9	5	-4
0014	2F	22_4	15	20	8	2000	3220	1220	0.40	1.61	3	5	2
0014	2F	22_4	16	11	1	1100	620	-480	0.09	0.56	1	1	0
0014	2F	22_4	23	6	2	600	470	-130	0.33	0.78	1	0	-1
0014	2F	22_4	24	8	2	800	530	-270	0.25	0.66	1	0	-1
0014	2F	22_4	25	5	0	500	0	-500	0.00	0.00	0	0	0
0014	2F	22_4	26	7	1	700	650	-50	0.14	0.93	1	1	0
0014	2F	22_5	12	156	57	15600	13950	-1650	0.37	0.89	27	24	-3
0014	2F	22_5	13	94	32	9400	9000	-400	0.34	0.96	16	15	-1
0014	2F	22_5	14	52	11	5200	4620	-580	0.21	0.89	9	8	-1
0014	2F	22_5	15	4	1	400	510	110	0.25	1.28	0	0	0
0014	2F	22_5	16	3	0	300	0	-300	0.00	0.00	0	0	0
0014	2F	22_5	23	5	1	500	330	-170	0.20	0.66	0	0	0
0014	2F	22_5	24	5	1	500	300	-200	0.20	0.60	0	0	0
0014	2F	22_5	25	3	0	300	0	-300	0.00	0.00	0	0	0
0014	2F	22_7	12	196	69	19600	18530	-1070	0.35	0.95	34	32	-2
0014	2F	22_7	13	110	21	11000	6790	-4210	0.19	0.62	19	12	-7
0014	2F	22_7	14	64	10	6400	3280	-3120	0.16	0.51	11	5	-6
0014	2F	22_7	15	10	1	1000	770	-230	0.10	0.77	1	1	0
0014	2F	22_7	16	14	1	1400	470	-930	0.07	0.34	2	0	-2
0014	2F	22_7	23	9	0	900	0	-900	0.00	0.00	1	0	-1
0014	2F	22_7	24	5	0	500	0	-500	0.00	0.00	0	0	0
0014	2F	22_7	25	3	0	300	0	-300	0.00	0.00	0	0	0
0014	2F	22_7	26	1	0	100	0	-100	0.00	0.00	0	0	0
0014	2F	23_1	12	197	71	19700	19290	-410	0.36	0.98	34	34	0
0014	2F	23_1	13	112	30	11200	9240	-1960	0.27	0.83	19	16	-3
0014	2F	23_1	14	63	11	6300	6140	-160	0.17	0.97	11	10	-1
0014	2F	23_1	15	17	1	1700	860	-840	0.06	0.51	3	1	-2
0014	2F	23_1	16	9	1	900	340	-560	0.11	0.38	1	0	-1
0014	2F	23_1	23	5	1	500	1410	910	0.20	2.82	0	2	2
0014	2F	23_1	24	6	1	600	400	-200	0.17	0.67	1	0	-1
0014	2F	23_1	25	3	0	300	0	-300	0.00	0.00	0	0	0
0014	2F	23_1	26	1	0	100	0	-100	0.00	0.00	0	0	0
0014	2F	23_2	12	207	60	20700	15430	-5270	0.29	0.75	36	27	-9
0014	2F	23_2	13	103	25	10300	8230	-2070	0.24	0.80	18	14	-4
0014	2F	23_2	14	60	4	6000	1750	-4250	0.07	0.29	10	3	-7
0014	2F	23_2	15	24	4	2400	1670	-730	0.17	0.70	4	2	-2
0014	2F	23_2	16	11	0	1100	0	-1100	0.00	0.00	1	0	-1
0014	2F	23_2	23	9	0	900	0	-900	0.00	0.00	1	0	-1
0014	2F	23_2	24	9	1	900	310	-590	0.11	0.34	1	0	-1
0014	2F	23_2	25	4	0	400	0	-400	0.00	0.00	0	0	0
0014	2F	23_2	26	2	0	200	0	-200	0.00	0.00	0	0	0
0014	2F	23_3	12	182	53	18200	14800	-3400	0.29	0.81	32	26	-6
0014	2F	23_3	13	102	27	10200	8880	-1320	0.26	0.87	18	15	-3
0014	2F	23_3	14	64	11	6400	3460	-2940	0.17	0.54	11	6	-5
0014	2F	23_3	15	31	7	3100	5590	2490	0.23	1.80	5	9	4
0014	2F	23_3	16	6	1	600	1220	620	0.17	2.03	1	2	1
0014	2F	23_3	23	8	2	800	690	-110	0.25	0.86	1	1	0
0014	2F	23_3	24	10	1	1000	210	-790	0.10	0.21	1	0	-1
0014	2F	23_3	25	2	1	200	400	200	0.50	2.00	0	0	0
0014	2F	23_3	26	3	1	300	330	30	0.33	1.10	0	0	0
0014	2F	23_4	12	204	61	20400	15320	-5080	0.30	0.75	36	27	-9
0014	2F	23_4	13	138	33	13800	8520	-5280	0.24	0.62	24	15	-9
0014	2F	23_4	14	47	9	4700	3820	-880	0.19	0.81	8	6	-2
0014	2F	23_4	15	19	2	1900	850	-1050	0.11	0.45	3	1	-2
0014	2F	23_4	16	9	1	900	790	-110	0.11	0.88	1	1	0
0014	2F	23_4	23	10	1	1000	270	-730	0.10	0.27	1	0	-1
0014	2F	23_4	25	2	0	200	0	-200	0.00	0.00	0	0	0
0014	2F	23_5	12	152	55	15200	14320	-880	0.36	0.94	26	25	-1
0014	2F	23_5	13	74	15	7400	5160	-2240	0.20	0.70	13	9	-4
0014	2F	23_5	14	49	12	4900	4290	-610	0.24	0.88	8	7	-1
0014	2F	23_5	15	24	3	2400	1080	-1320	0.13	0.45	4	1	-3
0014	2F	23_5	16	10	0	1000	0	-1000	0.00	0.00	1	0	-1
0014	2F	23_5	23	3	0	300	0	-300	0.00	0.00	0	0	0
0014	2F	23_5	24	1	0	100	0	-100	0.00	0.00	0	0	0
0014	2F	23_5	25	1	0	100	0	-100	0.00	0.00	0	0	0
0014	2F	23_5	26	1	0	100	0	-100	0.00	0.00	0	0	0
0014	2F	23_6	12	15	5	1500	950	-550	0.33	0.63	2	1	-1
0014	2F	23_6	13	10	0	1000	0	-1000	0.00	0.00	1	0	-1
0014	2F	23_6	14	8	2	800	1220	420	0.25	1.53	1	2	1
0014	2F	23_6	15	1	0	100	0	-100	0.00	0.00	0	0	0
0014	2F	23_7	12	208	71	20800	19760	-1040	0.34	0.95	36	34	-2
0014	2F	23_7	13	121	33	12100	11530	-570	0.27	0.95	21	20	-1
0014	2F	23_7	14	84	18	8400	8680	280	0.21	1.03	14	15	1
0014	2F	23_7	15	29	6	2900	3550	650	0.21	1.22	5	6	1
0014	2F	23_7	16	7	0	700	0	-700	0.00	0.00	1	0	-1
0014	2F	23_7	23	2	1	200	2280	2080	0.50	11.40	0	4	4
0014	2F	23_7	24	3	0	300	0	-300	0.00	0.00	0	0	0
0014	2F	23_7	25	1	0	100	0	-100	0.00	0.00	0	0	0
0014	2F	23_7	26	2	0	200	0	-200	0.00	0.00	0	0	0
0014	2F	24_1	12	240	65	24000	16930	-7070	0.27	0.71	42	29	-13
0014	2F	24_1	13	153	47	15300	16090	790	0.31	1.05	27	28	1
0014	2F	24_1	14	70	10	7000	3760	-3240	0.14	0.54	12	6	-6
0014	2F	24_1	15	24	6	2400	3110	710	0.25	1.30	4	5	1
0014	2F	24_1	16	15	3	1500	650	-850	0.20	0.43	2	1	-1
0014	2F	24_1	23	12	2	1200	1780	580	0.17	1.48	2	3	1
0014	2F	24_1	24	2	1	200	2300	2100	0.50	11.50	0	4	4
0014	2F	24_1	25	4	1	400	310	-90	0.25	0.78	0	0	0
0014	2F	24_1	26	1	1	100	170	70	1.00	1.70	0	0	0
0014	2F	24_2	12	217	82	21700	20990	-710	0.38	0.97	38	37	-1
0014	2F	24_2	13	151	42	15100	11480	-3620	0.28	0.76	26	20	-6
0014	2F	24_2	14	67	15	6700	4720	-1980	0.22	0.70	11	8	-3
0014	2F	24_2	15	23	2	2300	390	-1910	0.09	0.17	4	0	-4
0014	2F	24_2	16	23	6	2300	1910	-390	0.26	0.83	4	3	-1
0014	2F	24_2	23	7	2	700	2280	1580	0.29	3.26	1	4	3
0014	2F	24_2	24	9	3	900	730	-170	0.33	0.81	1	1	0
0014	2F	24_2	25	1	0	100	0	-100	0.00	0.00	0	0	0
0014	2F	24_2	26	4	0	400	0	-400	0.00	0.00	0	0	0
0014	2F	24_3	12	228	73	22800	20740	-2060	0.32	0.91	40	36	-4
0014	2F	24_3	13	163	40	16300	10180	-6120	0.25	0.62	28	18	-10
0014	2F	24_3	14	90	22	9000	7800	-1200	0.24	0.87	15	13	-2
0014	2F	24_3	15	22	0	2200	0	-2200	0.00	0.00	3	0	-3
0014	2F	24_3	16	8	1	800	1840	1040	0.13	2.30	1	3	2
0014	2F	24_3	23	5	2	500	1300	800	0.40	2.60	0	2	2
0014	2F	24_3	24	5	1	500	220	-280	0.20	0.44	0	0	0
0014	2F	24_3	25	2	0	200	0	-200	0.00	0.00	0	0	0
0014	2F	24_3	26	1	1	100	850	750	1.00	8.50	0	1	1
0014	2F	24_4	12	155	44	15500	10630	-4870	0.28	0.69	27	18	-9
0014	2F	24_4	13	106	36	10600	11250	650	0.34	1.06	18	19	1
0014	2F	24_4	14	68	13	6800	4740	-2060	0.19	0.70	12	8	-4
0014	2F	24_4	15	29	6	2900	4770	1870	0.21	1.64	5	8	3
0014	2F	24_4	16	6	0	600	0	-600	0.00	0.00	1	0	-1
0014	2F	24_4	23	4	0	400	0	-400	0.00	0.00	0	0	0
0014	2F	24_4	24	5	1	500	370	-130	0.20	0.74	0	0	0
0014	2F	24_5	12	83	40	8300	9090	790	0.48	1.10	14	16	2
0014	2F	24_5	13	67	15	6700	5010	-1690	0.22	0.75	11	8	-3
0014	2F	24_5	14	32	7	3200	2450	-750	0.22	0.77	5	4	-1
0014	2F	24_5	15	11	4	1100	2170	1070	0.36	1.97	1	3	2
0014	2F	24_5	16	2	1	200	240	40	0.50	1.20	0	0	0
0014	2F	24_5	23	4	1	400	330	-70	0.25	0.83	0	0	0
0014	2F	24_5	24	1	0	100	0	-100	0.00	0.00	0	0	0
0014	2F	24_5	25	2	0	200	0	-200	0.00	0.00	0	0	0
0014	2F	24_5	26	1	0	100	0	-100	0.00	0.00	0	0	0
0014	2F	24_6	12	27	13	2700	4000	1300	0.48	1.48	4	7	3
0014	2F	24_6	13	15	5	1500	1090	-410	0.33	0.73	2	1	-1
0014	2F	24_6	14	6	3	600	640	40	0.50	1.07	1	1	0
0014	2F	24_6	15	3	1	300	310	10	0.33	1.03	0	0	0
0014	2F	24_6	16	1	0	100	0	-100	0.00	0.00	0	0	0
0014	2F	24_7	12	253	80	25300	19310	-5990	0.32	0.76	44	34	-10
0014	2F	24_7	13	135	34	13500	8780	-4720	0.25	0.65	23	15	-8
0014	2F	24_7	14	83	15	8300	7110	-1190	0.18	0.86	14	12	-2
0014	2F	24_7	15	31	9	3100	4080	980	0.29	1.32	5	7	2
0014	2F	24_7	16	15	3	1500	770	-730	0.20	0.51	2	1	-1
0014	2F	24_7	23	6	0	600	0	-600	0.00	0.00	1	0	-1
0014	2F	24_7	24	3	0	300	0	-300	0.00	0.00	0	0	0
0014	2F	24_7	26	4	0	400	0	-400	0.00	0.00	0	0	0
0014	2T	01_1	12	192	47	19200	18840	-360	0.24	0.98	33	33	0
0014	2T	01_1	13	93	17	9300	7660	-1640	0.18	0.82	16	13	-3
0014	2T	01_1	14	60	12	6000	9730	3730	0.20	1.62	10	17	7
0014	2T	01_1	15	31	4	3100	2250	-850	0.13	0.73	5	3	-2
0014	2T	01_1	16	8	1	800	1600	800	0.13	2.00	1	2	1
0014	2T	01_1	21	17	0	1700	0	-1700	0.00	0.00	3	0	-3
0014	2T	01_1	23	8	1	800	400	-400	0.13	0.50	1	0	-1
0014	2T	01_1	24	5	2	500	3690	3190	0.40	7.38	0	6	6
0014	2T	01_1	25	4	2	400	1380	980	0.50	3.45	0	2	2
0014	2T	01_2	12	177	19	17700	6690	-11010	0.11	0.38	31	11	-20
0014	2T	01_2	13	81	18	8100	7270	-830	0.22	0.90	14	12	-2
0014	2T	01_2	14	51	12	5100	7720	2620	0.24	1.51	9	13	4
0014	2T	01_2	15	43	7	4300	4530	230	0.16	1.05	7	8	1
0014	2T	01_2	16	9	0	900	0	-900	0.00	0.00	1	0	-1
0014	2T	01_2	21	19	2	1900	890	-1010	0.11	0.47	3	1	-2
0014	2T	01_2	23	9	1	900	670	-230	0.11	0.74	1	1	0
0014	2T	01_2	24	14	0	1400	0	-1400	0.00	0.00	2	0	-2
0014	2T	01_2	25	9	1	900	1180	280	0.11	1.31	1	2	1
0014	2T	01_2	26	4	1	400	1060	660	0.25	2.65	0	1	1
0014	2T	01_3	12	153	37	15300	17590	2290	0.24	1.15	27	31	4
0014	2T	01_3	13	101	22	10100	11350	1250	0.22	1.12	17	20	3
0014	2T	01_3	14	48	5	4800	3470	-1330	0.10	0.72	8	6	-2
0014	2T	01_3	15	33	4	3300	1730	-1570	0.12	0.52	5	3	-2
0014	2T	01_3	16	20	3	2000	5030	3030	0.15	2.52	3	8	5
0014	2T	01_3	21	21	2	2100	2120	20	0.10	1.01	3	3	0
0014	2T	01_3	23	11	1	1100	350	-750	0.09	0.32	1	0	-1
0014	2T	01_3	24	5	0	500	0	-500	0.00	0.00	0	0	0
0014	2T	01_3	25	9	0	900	0	-900	0.00	0.00	1	0	-1
0014	2T	01_3	26	1	0	100	0	-100	0.00	0.00	0	0	0
0014	2T	01_4	12	163	34	16300	9280	-7020	0.21	0.57	28	16	-12
0014	2T	01_4	13	93	17	9300	6780	-2520	0.18	0.73	16	12	-4
0014	2T	01_4	14	62	3	6200	2410	-3790	0.05	0.39	10	4	-6
0014	2T	01_4	15	30	1	3000	1740	-1260	0.03	0.58	5	3	-2
0014	2T	01_4	16	10	0	1000	0	-1000	0.00	0.00	1	0	-1
0014	2T	01_4	21	19	2	1900	690	-1210	0.11	0.36	3	1	-2
0014	2T	01_4	23	14	2	1400	950	-450	0.14	0.68	2	1	-1
0014	2T	01_4	24	9	0	900	0	-900	0.00	0.00	1	0	-1
0014	2T	01_4	25	6	1	600	250	-350	0.17	0.42	1	0	-1
0014	2T	01_4	26	4	0	400	0	-400	0.00	0.00	0	0	0
0014	2T	01_5	12	105	27	10500	10190	-310	0.26	0.97	18	18	0
0014	2T	01_5	13	68	10	6800	3790	-3010	0.15	0.56	12	6	-6
0014	2T	01_5	14	37	3	3700	1810	-1890	0.08	0.49	6	3	-3
0014	2T	01_5	15	16	2	1600	760	-840	0.13	0.48	2	1	-1
0014	2T	01_5	16	9	1	900	460	-440	0.11	0.51	1	0	-1
0014	2T	01_5	21	5	2	500	1760	1260	0.40	3.52	0	3	3
0014	2T	01_5	23	7	0	700	0	-700	0.00	0.00	1	0	-1
0014	2T	01_5	24	5	0	500	0	-500	0.00	0.00	0	0	0
0014	2T	01_5	25	2	0	200	0	-200	0.00	0.00	0	0	0
0014	2T	01_5	26	1	0	100	0	-100	0.00	0.00	0	0	0
0014	2T	01_6	12	12	3	1200	650	-550	0.25	0.54	2	1	-1
0014	2T	01_6	13	8	0	800	0	-800	0.00	0.00	1	0	-1
0014	2T	01_6	14	5	0	500	0	-500	0.00	0.00	0	0	0
0014	2T	01_6	15	1	1	100	310	210	1.00	3.10	0	0	0
0014	2T	01_6	16	2	0	200	0	-200	0.00	0.00	0	0	0
0014	2T	01_6	23	2	0	200	0	-200	0.00	0.00	0	0	0
0014	2T	01_6	25	1	0	100	0	-100	0.00	0.00	0	0	0
0014	2T	01_7	12	175	49	17500	17820	320	0.28	1.02	30	31	1
0014	2T	01_7	13	105	23	10500	8910	-1590	0.22	0.85	18	15	-3
0014	2T	01_7	14	80	9	8000	4060	-3940	0.11	0.51	14	7	-7
0014	2T	01_7	15	42	8	4200	3980	-220	0.19	0.95	7	7	0
0014	2T	01_7	16	18	2	1800	1360	-440	0.11	0.76	3	2	-1
0014	2T	01_7	21	13	1	1300	590	-710	0.08	0.45	2	1	-1
0014	2T	01_7	23	9	1	900	3310	2410	0.11	3.68	1	5	4
0014	2T	01_7	24	3	0	300	0	-300	0.00	0.00	0	0	0
0014	2T	01_7	25	6	0	600	0	-600	0.00	0.00	1	0	-1
0014	2T	01_7	26	9	2	900	1540	640	0.22	1.71	1	2	1
0014	2T	02_1	12	192	33	19200	18740	-460	0.17	0.98	33	33	0
0014	2T	02_1	13	112	12	11200	11590	390	0.11	1.03	19	20	1
0014	2T	02_1	14	51	5	5100	3550	-1550	0.10	0.70	9	6	-3
0014	2T	02_1	15	28	2	2800	2030	-770	0.07	0.73	4	3	-1
0014	2T	02_1	16	24	1	2400	570	-1830	0.04	0.24	4	1	-3
0014	2T	02_1	21	32	5	3200	3950	750	0.16	1.23	5	6	1
0014	2T	02_1	23	13	1	1300	730	-570	0.08	0.56	2	1	-1
0014	2T	02_1	24	6	0	600	0	-600	0.00	0.00	1	0	-1
0014	2T	02_1	25	7	0	700	0	-700	0.00	0.00	1	0	-1
0014	2T	02_1	26	4	0	400	0	-400	0.00	0.00	0	0	0
0014	2T	02_2	12	179	26	17900	15600	-2300	0.15	0.87	31	27	-4
0014	2T	02_2	13	97	12	9700	7030	-2670	0.12	0.72	17	12	-5
0014	2T	02_2	14	69	8	6900	4750	-2150	0.12	0.69	12	8	-4
0014	2T	02_2	15	24	2	2400	850	-1550	0.08	0.35	4	1	-3
0014	2T	02_2	16	16	1	1600	690	-910	0.06	0.43	2	1	-1
0014	2T	02_2	21	29	2	2900	1600	-1300	0.07	0.55	5	2	-3
0014	2T	02_2	23	15	2	1500	1070	-430	0.13	0.71	2	1	-1
0014	2T	02_2	24	14	1	1400	1360	-40	0.07	0.97	2	2	0
0014	2T	02_2	25	8	2	800	1500	700	0.25	1.88	1	2	1
0014	2T	02_2	26	5	0	500	0	-500	0.00	0.00	0	0	0
0014	2T	02_3	12	166	32	16600	17810	1210	0.19	1.07	29	31	2
0014	2T	02_3	13	105	18	10500	12810	2310	0.17	1.22	18	22	4
0014	2T	02_3	14	74	4	7400	2920	-4480	0.05	0.39	13	5	-8
0014	2T	02_3	15	32	4	3200	2460	-740	0.13	0.77	5	4	-1
0014	2T	02_3	16	27	2	2700	1910	-790	0.07	0.71	4	3	-1
0014	2T	02_3	21	27	2	2700	1700	-1000	0.07	0.63	4	3	-1
0014	2T	02_3	23	15	1	1500	2270	770	0.07	1.51	2	4	2
0014	2T	02_3	24	21	1	2100	690	-1410	0.05	0.33	3	1	-2
0014	2T	02_3	25	4	0	400	0	-400	0.00	0.00	0	0	0
0014	2T	02_3	26	3	0	300	0	-300	0.00	0.00	0	0	0
0014	2T	02_4	12	107	18	10700	11170	470	0.17	1.04	18	19	1
0014	2T	02_4	13	83	16	8300	9230	930	0.19	1.11	14	16	2
0014	2T	02_4	14	45	1	4500	370	-4130	0.02	0.08	7	0	-7
0014	2T	02_4	15	16	1	1600	1330	-270	0.06	0.83	2	2	0
0014	2T	02_4	16	7	0	700	0	-700	0.00	0.00	1	0	-1
0014	2T	02_4	21	14	4	1400	2480	1080	0.29	1.77	2	4	2
0014	2T	02_4	23	15	1	1500	680	-820	0.07	0.45	2	1	-1
0014	2T	02_4	24	7	1	700	810	110	0.14	1.16	1	1	0
0014	2T	02_4	25	6	0	600	0	-600	0.00	0.00	1	0	-1
0014	2T	02_4	26	3	0	300	0	-300	0.00	0.00	0	0	0
0014	2T	02_5	12	67	20	6700	7040	340	0.30	1.05	11	12	1
0014	2T	02_5	13	39	3	3900	1210	-2690	0.08	0.31	6	2	-4
0014	2T	02_5	14	25	2	2500	1100	-1400	0.08	0.44	4	1	-3
0014	2T	02_5	15	9	1	900	1510	610	0.11	1.68	1	2	1
0014	2T	02_5	16	7	0	700	0	-700	0.00	0.00	1	0	-1
0014	2T	02_5	21	8	0	800	0	-800	0.00	0.00	1	0	-1
0014	2T	02_5	23	5	0	500	0	-500	0.00	0.00	0	0	0
0014	2T	02_5	25	1	0	100	0	-100	0.00	0.00	0	0	0
0014	2T	02_6	12	5	0	500	0	-500	0.00	0.00	0	0	0
0014	2T	02_6	13	1	0	100	0	-100	0.00	0.00	0	0	0
0014	2T	02_6	15	1	0	100	0	-100	0.00	0.00	0	0	0
0014	2T	02_6	23	1	0	100	0	-100	0.00	0.00	0	0	0
0014	2T	02_7	12	187	30	18700	13070	-5630	0.16	0.70	33	23	-10
0014	2T	02_7	13	98	11	9800	6860	-2940	0.11	0.70	17	12	-5
0014	2T	02_7	14	74	13	7400	8000	600	0.18	1.08	13	14	1
0014	2T	02_7	15	31	1	3100	800	-2300	0.03	0.26	5	1	-4
0014	2T	02_7	16	23	1	2300	1270	-1030	0.04	0.55	4	2	-2
0014	2T	02_7	21	19	3	1900	2840	940	0.16	1.49	3	5	2
0014	2T	02_7	23	21	0	2100	0	-2100	0.00	0.00	3	0	-3
0014	2T	02_7	24	9	0	900	0	-900	0.00	0.00	1	0	-1
0014	2T	02_7	25	7	0	700	0	-700	0.00	0.00	1	0	-1
0014	2T	02_7	26	5	0	500	0	-500	0.00	0.00	0	0	0
0014	2T	03_1	12	109	22	10900	11610	710	0.20	1.07	19	20	1
0014	2T	03_1	13	79	22	7900	9730	1830	0.28	1.23	13	17	4
0014	2T	03_1	14	56	5	5600	2990	-2610	0.09	0.53	9	5	-4
0014	2T	03_1	15	29	5	2900	4370	1470	0.17	1.51	5	7	2
0014	2T	03_1	16	15	0	1500	0	-1500	0.00	0.00	2	0	-2
0014	2T	03_1	21	20	2	2000	860	-1140	0.10	0.43	3	1	-2
0014	2T	03_1	23	5	0	500	0	-500	0.00	0.00	0	0	0
0014	2T	03_1	24	5	0	500	0	-500	0.00	0.00	0	0	0
0014	2T	03_1	25	12	0	1200	0	-1200	0.00	0.00	2	0	-2
0014	2T	03_1	26	5	0	500	0	-500	0.00	0.00	0	0	0
0014	2T	03_2	12	111	15	11100	7890	-3210	0.14	0.71	19	13	-6
0014	2T	03_2	13	61	15	6100	5960	-140	0.25	0.98	10	10	0
0014	2T	03_2	14	35	7	3500	4120	620	0.20	1.18	6	7	1
0014	2T	03_2	15	28	2	2800	1540	-1260	0.07	0.55	4	2	-2
0014	2T	03_2	16	21	1	2100	1160	-940	0.05	0.55	3	2	-1
0014	2T	03_2	21	15	4	1500	1940	440	0.27	1.29	2	3	1
0014	2T	03_2	23	17	1	1700	420	-1280	0.06	0.25	3	0	-3
0014	2T	03_2	24	7	0	700	0	-700	0.00	0.00	1	0	-1
0014	2T	03_2	25	4	0	400	0	-400	0.00	0.00	0	0	0
0014	2T	03_2	26	5	0	500	0	-500	0.00	0.00	0	0	0
0014	2T	03_3	12	143	37	14300	15080	780	0.26	1.05	25	26	1
0014	2T	03_3	13	83	14	8300	7240	-1060	0.17	0.87	14	12	-2
0014	2T	03_3	14	46	3	4600	1850	-2750	0.07	0.40	8	3	-5
0014	2T	03_3	15	35	4	3500	4520	1020	0.11	1.29	6	8	2
0014	2T	03_3	16	19	3	1900	2440	540	0.16	1.28	3	4	1
0014	2T	03_3	21	16	3	1600	1420	-180	0.19	0.89	2	2	0
0014	2T	03_3	23	10	1	1000	550	-450	0.10	0.55	1	0	-1
0014	2T	03_3	24	4	1	400	610	210	0.25	1.53	0	1	1
0014	2T	03_3	25	4	0	400	0	-400	0.00	0.00	0	0	0
0014	2T	03_3	26	4	0	400	0	-400	0.00	0.00	0	0	0
0014	2T	03_4	12	77	16	7700	6180	-1520	0.21	0.80	13	10	-3
0014	2T	03_4	13	60	13	6000	8440	2440	0.22	1.41	10	14	4
0014	2T	03_4	14	28	4	2800	1600	-1200	0.14	0.57	4	2	-2
0014	2T	03_4	15	17	1	1700	560	-1140	0.06	0.33	3	0	-3
0014	2T	03_4	16	8	1	800	1750	950	0.13	2.19	1	3	2
0014	2T	03_4	21	9	1	900	780	-120	0.11	0.87	1	1	0
0014	2T	03_4	23	8	0	800	0	-800	0.00	0.00	1	0	-1
0014	2T	03_4	24	3	0	300	0	-300	0.00	0.00	0	0	0
0014	2T	03_4	25	3	1	300	390	90	0.33	1.30	0	0	0
0014	2T	03_4	26	2	1	200	10160	9960	0.50	50.80	0	17	17
0014	2T	03_5	12	49	15	4900	5930	1030	0.31	1.21	8	10	2
0014	2T	03_5	13	41	7	4100	5970	1870	0.17	1.46	7	10	3
0014	2T	03_5	14	13	1	1300	550	-750	0.08	0.42	2	0	-2
0014	2T	03_5	15	8	3	800	2630	1830	0.38	3.29	1	4	3
0014	2T	03_5	16	9	2	900	1250	350	0.22	1.39	1	2	1
0014	2T	03_5	21	9	0	900	0	-900	0.00	0.00	1	0	-1
0014	2T	03_5	23	3	0	300	0	-300	0.00	0.00	0	0	0
0014	2T	03_5	24	3	0	300	0	-300	0.00	0.00	0	0	0
0014	2T	03_5	25	1	1	100	3060	2960	1.00	30.60	0	5	5
0014	2T	03_5	26	1	0	100	0	-100	0.00	0.00	0	0	0
0014	2T	03_7	12	126	23	12600	9670	-2930	0.18	0.77	22	17	-5
0014	2T	03_7	13	84	16	8400	5920	-2480	0.19	0.70	14	10	-4
0014	2T	03_7	14	46	6	4600	4300	-300	0.13	0.93	8	7	-1
0014	2T	03_7	15	23	2	2300	1350	-950	0.09	0.59	4	2	-2
0014	2T	03_7	16	21	0	2100	0	-2100	0.00	0.00	3	0	-3
0014	2T	03_7	21	19	3	1900	1580	-320	0.16	0.83	3	2	-1
0014	2T	03_7	23	15	0	1500	0	-1500	0.00	0.00	2	0	-2
0014	2T	03_7	24	11	1	1100	520	-580	0.09	0.47	1	0	-1
0014	2T	03_7	25	12	0	1200	0	-1200	0.00	0.00	2	0	-2
0014	2T	03_7	26	3	0	300	0	-300	0.00	0.00	0	0	0
0014	2T	04_1	12	138	24	13800	11050	-2750	0.17	0.80	24	19	-5
0014	2T	04_1	13	82	11	8200	4620	-3580	0.13	0.56	14	8	-6
0014	2T	04_1	14	75	6	7500	5530	-1970	0.08	0.74	13	9	-4
0014	2T	04_1	15	27	4	2700	2550	-150	0.15	0.94	4	4	0
0014	2T	04_1	16	19	1	1900	1080	-820	0.05	0.57	3	1	-2
0014	2T	04_1	21	13	3	1300	1640	340	0.23	1.26	2	2	0
0014	2T	04_1	23	14	1	1400	780	-620	0.07	0.56	2	1	-1
0014	2T	04_1	24	6	1	600	310	-290	0.17	0.52	1	0	-1
0014	2T	04_1	25	4	0	400	0	-400	0.00	0.00	0	0	0
0014	2T	04_1	26	7	0	700	0	-700	0.00	0.00	1	0	-1
0014	2T	04_2	12	126	29	12600	12850	250	0.23	1.02	22	22	0
0014	2T	04_2	13	83	18	8300	8100	-200	0.22	0.98	14	14	0
0014	2T	04_2	14	51	4	5100	1690	-3410	0.08	0.33	9	2	-7
0014	2T	04_2	15	43	5	4300	2870	-1430	0.12	0.67	7	5	-2
0014	2T	04_2	16	20	2	2000	1090	-910	0.10	0.55	3	1	-2
0014	2T	04_2	21	14	3	1400	1300	-100	0.21	0.93	2	2	0
0014	2T	04_2	23	7	1	700	590	-110	0.14	0.84	1	1	0
0014	2T	04_2	24	8	0	800	0	-800	0.00	0.00	1	0	-1
0014	2T	04_2	25	1	0	100	0	-100	0.00	0.00	0	0	0
0014	2T	04_2	26	1	0	100	0	-100	0.00	0.00	0	0	0
0014	2T	04_3	12	134	21	13400	8020	-5380	0.16	0.60	23	14	-9
0014	2T	04_3	13	92	20	9200	12600	3400	0.22	1.37	16	22	6
0014	2T	04_3	14	51	8	5100	4830	-270	0.16	0.95	9	8	-1
0014	2T	04_3	15	48	6	4800	4050	-750	0.13	0.84	8	7	-1
0014	2T	04_3	16	18	2	1800	1970	170	0.11	1.09	3	3	0
0014	2T	04_3	21	11	4	1100	3350	2250	0.36	3.05	1	5	4
0014	2T	04_3	23	15	0	1500	0	-1500	0.00	0.00	2	0	-2
0014	2T	04_3	24	5	1	500	260	-240	0.20	0.52	0	0	0
0014	2T	04_3	25	5	0	500	0	-500	0.00	0.00	0	0	0
0014	2T	04_3	26	10	0	1000	0	-1000	0.00	0.00	1	0	-1
0014	2T	04_4	12	110	17	11000	6400	-4600	0.15	0.58	19	11	-8
0014	2T	04_4	13	81	16	8100	6670	-1430	0.20	0.82	14	11	-3
0014	2T	04_4	14	41	9	4100	5310	1210	0.22	1.30	7	9	2
0014	2T	04_4	15	16	2	1600	2010	410	0.13	1.26	2	3	1
0014	2T	04_4	16	13	3	1300	5060	3760	0.23	3.89	2	8	6
0014	2T	04_4	21	18	2	1800	1000	-800	0.11	0.56	3	1	-2
0014	2T	04_4	23	9	0	900	0	-900	0.00	0.00	1	0	-1
0014	2T	04_4	24	4	0	400	0	-400	0.00	0.00	0	0	0
0014	2T	04_4	25	5	1	500	820	320	0.20	1.64	0	1	1
0014	2T	04_4	26	4	0	400	0	-400	0.00	0.00	0	0	0
0014	2T	04_5	12	105	18	10500	7450	-3050	0.17	0.71	18	13	-5
0014	2T	04_5	13	58	6	5800	1960	-3840	0.10	0.34	10	3	-7
0014	2T	04_5	14	34	7	3400	4600	1200	0.21	1.35	6	8	2
0014	2T	04_5	15	23	0	2300	0	-2300	0.00	0.00	4	0	-4
0014	2T	04_5	16	18	2	1800	1140	-660	0.11	0.63	3	2	-1
0014	2T	04_5	21	4	1	400	970	570	0.25	2.43	0	1	1
0014	2T	04_5	23	5	1	500	370	-130	0.20	0.74	0	0	0
0014	2T	04_5	24	3	0	300	0	-300	0.00	0.00	0	0	0
0014	2T	04_5	25	4	0	400	0	-400	0.00	0.00	0	0	0
0014	2T	04_5	26	2	0	200	0	-200	0.00	0.00	0	0	0
0014	2T	04_7	12	114	24	11400	9730	-1670	0.21	0.85	20	17	-3
0014	2T	04_7	13	81	10	8100	4600	-3500	0.12	0.57	14	8	-6
0014	2T	04_7	14	47	2	4700	1660	-3040	0.04	0.35	8	2	-6
0014	2T	04_7	15	38	2	3800	1110	-2690	0.05	0.29	6	1	-5
0014	2T	04_7	16	16	1	1600	380	-1220	0.06	0.24	2	0	-2
0014	2T	04_7	21	20	1	2000	700	-1300	0.05	0.35	3	1	-2
0014	2T	04_7	23	19	1	1900	610	-1290	0.05	0.32	3	1	-2
0014	2T	04_7	24	11	1	1100	630	-470	0.09	0.57	1	1	0
0014	2T	04_7	25	3	0	300	0	-300	0.00	0.00	0	0	0
0014	2T	04_7	26	7	1	700	1670	970	0.14	2.39	1	2	1
0014	2T	05_1	12	147	35	14700	19260	4560	0.24	1.31	26	34	8
0014	2T	05_1	13	117	21	11700	9830	-1870	0.18	0.84	20	17	-3
0014	2T	05_1	14	78	12	7800	5860	-1940	0.15	0.75	13	10	-3
0014	2T	05_1	15	34	4	3400	6080	2680	0.12	1.79	6	10	4
0014	2T	05_1	16	11	0	1100	0	-1100	0.00	0.00	1	0	-1
0014	2T	05_1	21	20	1	2000	460	-1540	0.05	0.23	3	0	-3
0014	2T	05_1	23	14	3	1400	2840	1440	0.21	2.03	2	5	3
0014	2T	05_1	24	8	0	800	0	-800	0.00	0.00	1	0	-1
0014	2T	05_1	25	4	0	400	0	-400	0.00	0.00	0	0	0
0014	2T	05_1	26	5	0	500	0	-500	0.00	0.00	0	0	0
0014	2T	05_2	12	146	35	14600	12530	-2070	0.24	0.86	25	22	-3
0014	2T	05_2	13	101	24	10100	11310	1210	0.24	1.12	17	20	3
0014	2T	05_2	14	72	14	7200	9060	1860	0.19	1.26	12	16	4
0014	2T	05_2	15	37	3	3700	1480	-2220	0.08	0.40	6	2	-4
0014	2T	05_2	16	17	0	1700	0	-1700	0.00	0.00	3	0	-3
0014	2T	05_2	21	23	4	2300	3410	1110	0.17	1.48	4	6	2
0014	2T	05_2	23	13	3	1300	2930	1630	0.23	2.25	2	5	3
0014	2T	05_2	24	7	1	700	910	210	0.14	1.30	1	1	0
0014	2T	05_2	25	3	1	300	480	180	0.33	1.60	0	0	0
0014	2T	05_2	26	6	1	600	840	240	0.17	1.40	1	1	0
0014	2T	05_3	12	150	29	15000	12090	-2910	0.19	0.81	26	21	-5
0014	2T	05_3	13	83	13	8300	7150	-1150	0.16	0.86	14	12	-2
0014	2T	05_3	14	66	8	6600	6270	-330	0.12	0.95	11	11	0
0014	2T	05_3	15	44	6	4400	9520	5120	0.14	2.16	7	16	9
0014	2T	05_3	16	21	2	2100	1520	-580	0.10	0.72	3	2	-1
0014	2T	05_3	21	26	1	2600	490	-2110	0.04	0.19	4	0	-4
0014	2T	05_3	23	16	2	1600	1620	20	0.13	1.01	2	2	0
0014	2T	05_3	24	13	0	1300	0	-1300	0.00	0.00	2	0	-2
0014	2T	05_3	25	10	2	1000	1400	400	0.20	1.40	1	2	1
0014	2T	05_3	26	9	0	900	0	-900	0.00	0.00	1	0	-1
0014	2T	05_4	12	125	29	12500	13860	1360	0.23	1.11	22	24	2
0014	2T	05_4	13	86	16	8600	6920	-1680	0.19	0.80	15	12	-3
0014	2T	05_4	14	64	11	6400	6140	-260	0.17	0.96	11	10	-1
0014	2T	05_4	15	25	3	2500	1790	-710	0.12	0.72	4	3	-1
0014	2T	05_4	16	8	2	800	3240	2440	0.25	4.05	1	5	4
0014	2T	05_4	21	21	2	2100	1480	-620	0.10	0.70	3	2	-1
0014	2T	05_4	23	13	0	1300	0	-1300	0.00	0.00	2	0	-2
0014	2T	05_4	24	5	0	500	0	-500	0.00	0.00	0	0	0
0014	2T	05_4	25	6	1	600	350	-250	0.17	0.58	1	0	-1
0014	2T	05_4	26	5	0	500	0	-500	0.00	0.00	0	0	0
0014	2T	05_5	12	93	23	9300	9080	-220	0.25	0.98	16	16	0
0014	2T	05_5	13	63	16	6300	8990	2690	0.25	1.43	11	15	4
0014	2T	05_5	14	40	13	4000	5520	1520	0.33	1.38	7	9	2
0014	2T	05_5	15	19	1	1900	280	-1620	0.05	0.15	3	0	-3
0014	2T	05_5	16	9	0	900	0	-900	0.00	0.00	1	0	-1
0014	2T	05_5	21	9	1	900	520	-380	0.11	0.58	1	0	-1
0014	2T	05_5	23	5	0	500	0	-500	0.00	0.00	0	0	0
0014	2T	05_5	24	2	0	200	0	-200	0.00	0.00	0	0	0
0014	2T	05_5	25	2	0	200	0	-200	0.00	0.00	0	0	0
0014	2T	05_5	26	2	0	200	0	-200	0.00	0.00	0	0	0
0014	2T	05_6	12	2	1	200	260	60	0.50	1.30	0	0	0
0014	2T	05_6	13	5	2	500	1050	550	0.40	2.10	0	1	1
0014	2T	05_6	15	1	0	100	0	-100	0.00	0.00	0	0	0
0014	2T	05_6	21	1	0	100	0	-100	0.00	0.00	0	0	0
0014	2T	05_7	12	138	38	13800	16660	2860	0.28	1.21	24	29	5
0014	2T	05_7	13	110	22	11000	9430	-1570	0.20	0.86	19	16	-3
0014	2T	05_7	14	70	13	7000	6330	-670	0.19	0.90	12	11	-1
0014	2T	05_7	15	30	2	3000	2360	-640	0.07	0.79	5	4	-1
0014	2T	05_7	16	14	2	1400	1190	-210	0.14	0.85	2	2	0
0014	2T	05_7	21	20	4	2000	4510	2510	0.20	2.26	3	7	4
0014	2T	05_7	23	14	1	1400	1090	-310	0.07	0.78	2	1	-1
0014	2T	05_7	24	8	0	800	0	-800	0.00	0.00	1	0	-1
0014	2T	05_7	25	5	1	500	760	260	0.20	1.52	0	1	1
0014	2T	05_7	26	2	0	200	0	-200	0.00	0.00	0	0	0
0014	2T	06_1	12	190	31	19000	14290	-4710	0.16	0.75	33	25	-8
0014	2T	06_1	13	121	14	12100	5190	-6910	0.12	0.43	21	9	-12
0014	2T	06_1	14	85	16	8500	8690	190	0.19	1.02	15	15	0
0014	2T	06_1	15	26	3	2600	2780	180	0.12	1.07	4	4	0
0014	2T	06_1	16	10	1	1000	880	-120	0.10	0.88	1	1	0
0014	2T	06_1	21	31	0	3100	0	-3100	0.00	0.00	5	0	-5
0014	2T	06_1	23	15	3	1500	4870	3370	0.20	3.25	2	8	6
0014	2T	06_1	24	11	1	1100	810	-290	0.09	0.74	1	1	0
0014	2T	06_1	25	8	2	800	900	100	0.25	1.13	1	1	0
0014	2T	06_1	26	4	0	400	0	-400	0.00	0.00	0	0	0
0014	2T	06_2	12	185	32	18500	13730	-4770	0.17	0.74	32	24	-8
0014	2T	06_2	13	123	13	12300	7810	-4490	0.11	0.63	21	13	-8
0014	2T	06_2	14	80	9	8000	3940	-4060	0.11	0.49	14	6	-8
0014	2T	06_2	15	25	2	2500	970	-1530	0.08	0.39	4	1	-3
0014	2T	06_2	16	20	3	2000	1860	-140	0.15	0.93	3	3	0
0014	2T	06_2	21	32	4	3200	2130	-1070	0.13	0.67	5	3	-2
0014	2T	06_2	23	16	2	1600	4250	2650	0.13	2.66	2	7	5
0014	2T	06_2	24	11	0	1100	0	-1100	0.00	0.00	1	0	-1
0014	2T	06_2	25	6	0	600	0	-600	0.00	0.00	1	0	-1
0014	2T	06_2	26	4	0	400	0	-400	0.00	0.00	0	0	0
0014	2T	06_3	12	175	41	17500	18650	1150	0.23	1.07	30	33	3
0014	2T	06_3	13	127	22	12700	11350	-1350	0.17	0.89	22	20	-2
0014	2T	06_3	14	70	14	7000	6980	-20	0.20	1.00	12	12	0
0014	2T	06_3	15	32	1	3200	1880	-1320	0.03	0.59	5	3	-2
0014	2T	06_3	16	14	1	1400	1440	40	0.07	1.03	2	2	0
0014	2T	06_3	21	25	3	2500	1350	-1150	0.12	0.54	4	2	-2
0014	2T	06_3	23	12	1	1200	4120	2920	0.08	3.43	2	7	5
0014	2T	06_3	24	12	2	1200	1410	210	0.17	1.18	2	2	0
0014	2T	06_3	25	5	0	500	0	-500	0.00	0.00	0	0	0
0014	2T	06_3	26	3	0	300	0	-300	0.00	0.00	0	0	0
0014	2T	06_4	12	118	20	11800	7810	-3990	0.17	0.66	20	13	-7
0014	2T	06_4	13	77	11	7700	4400	-3300	0.14	0.57	13	7	-6
0014	2T	06_4	14	45	4	4500	1850	-2650	0.09	0.41	7	3	-4
0014	2T	06_4	15	18	3	1800	1170	-630	0.17	0.65	3	2	-1
0014	2T	06_4	16	14	1	1400	1200	-200	0.07	0.86	2	2	0
0014	2T	06_4	21	15	0	1500	0	-1500	0.00	0.00	2	0	-2
0014	2T	06_4	23	16	1	1600	540	-1060	0.06	0.34	2	0	-2
0014	2T	06_4	24	9	0	900	0	-900	0.00	0.00	1	0	-1
0014	2T	06_4	25	7	0	700	0	-700	0.00	0.00	1	0	-1
0014	2T	06_4	26	2	0	200	0	-200	0.00	0.00	0	0	0
0014	2T	06_5	12	63	13	6300	4950	-1350	0.21	0.79	11	8	-3
0014	2T	06_5	13	38	5	3800	2050	-1750	0.13	0.54	6	3	-3
0014	2T	06_5	14	42	3	4200	1210	-2990	0.07	0.29	7	2	-5
0014	2T	06_5	15	10	1	1000	500	-500	0.10	0.50	1	0	-1
0014	2T	06_5	16	12	0	1200	0	-1200	0.00	0.00	2	0	-2
0014	2T	06_5	21	8	0	800	0	-800	0.00	0.00	1	0	-1
0014	2T	06_5	23	13	0	1300	0	-1300	0.00	0.00	2	0	-2
0014	2T	06_5	24	4	0	400	0	-400	0.00	0.00	0	0	0
0014	2T	06_5	25	3	0	300	0	-300	0.00	0.00	0	0	0
0014	2T	06_5	26	4	0	400	0	-400	0.00	0.00	0	0	0
0014	2T	06_6	12	13	2	1300	2890	1590	0.15	2.22	2	5	3
0014	2T	06_6	13	3	0	300	0	-300	0.00	0.00	0	0	0
0014	2T	06_6	14	5	0	500	0	-500	0.00	0.00	0	0	0
0014	2T	06_6	15	3	1	300	1370	1070	0.33	4.57	0	2	2
0014	2T	06_6	16	1	1	100	3110	3010	1.00	31.10	0	5	5
0014	2T	06_6	21	1	0	100	0	-100	0.00	0.00	0	0	0
0014	2T	06_6	26	1	0	100	0	-100	0.00	0.00	0	0	0
0014	2T	06_7	12	193	46	19300	18080	-1220	0.24	0.94	34	32	-2
0014	2T	06_7	13	128	30	12800	12660	-140	0.23	0.99	22	22	0
0014	2T	06_7	14	87	12	8700	5310	-3390	0.14	0.61	15	9	-6
0014	2T	06_7	15	37	3	3700	1100	-2600	0.08	0.30	6	1	-5
0014	2T	06_7	16	14	1	1400	230	-1170	0.07	0.16	2	0	-2
0014	2T	06_7	21	22	1	2200	350	-1850	0.05	0.16	3	0	-3
0014	2T	06_7	23	11	0	1100	0	-1100	0.00	0.00	1	0	-1
0014	2T	06_7	24	9	0	900	0	-900	0.00	0.00	1	0	-1
0014	2T	06_7	25	8	0	800	0	-800	0.00	0.00	1	0	-1
0014	2T	06_7	26	2	0	200	0	-200	0.00	0.00	0	0	0
0014	2T	07_1	12	151	30	15100	12050	-3050	0.20	0.80	26	21	-5
0014	2T	07_1	13	113	16	11300	4960	-6340	0.14	0.44	20	8	-12
0014	2T	07_1	14	66	13	6600	7120	520	0.20	1.08	11	12	1
0014	2T	07_1	15	40	9	4000	5460	1460	0.23	1.37	7	9	2
0014	2T	07_1	16	16	4	1600	2730	1130	0.25	1.71	2	4	2
0014	2T	07_1	21	20	3	2000	3570	1570	0.15	1.79	3	6	3
0014	2T	07_1	23	7	1	700	910	210	0.14	1.30	1	1	0
0014	2T	07_1	24	2	0	200	0	-200	0.00	0.00	0	0	0
0014	2T	07_1	25	6	0	600	0	-600	0.00	0.00	1	0	-1
0014	2T	07_1	26	5	0	500	0	-500	0.00	0.00	0	0	0
0014	2T	07_2	12	173	38	17300	16270	-1030	0.22	0.94	30	28	-2
0014	2T	07_2	13	102	26	10200	10100	-100	0.25	0.99	18	17	-1
0014	2T	07_2	14	76	21	7600	9580	1980	0.28	1.26	13	16	3
0014	2T	07_2	15	30	5	3000	2520	-480	0.17	0.84	5	4	-1
0014	2T	07_2	16	19	2	1900	3680	1780	0.11	1.94	3	6	3
0014	2T	07_2	21	17	3	1700	2840	1140	0.18	1.67	3	5	2
0014	2T	07_2	23	7	0	700	0	-700	0.00	0.00	1	0	-1
0014	2T	07_2	24	7	0	700	0	-700	0.00	0.00	1	0	-1
0014	2T	07_2	25	9	0	900	0	-900	0.00	0.00	1	0	-1
0014	2T	07_2	26	7	0	700	0	-700	0.00	0.00	1	0	-1
0014	2T	07_3	12	192	39	19200	16190	-3010	0.20	0.84	33	28	-5
0014	2T	07_3	13	107	19	10700	8400	-2300	0.18	0.79	18	14	-4
0014	2T	07_3	14	51	10	5100	3240	-1860	0.20	0.64	9	5	-4
0014	2T	07_3	15	33	4	3300	1990	-1310	0.12	0.60	5	3	-2
0014	2T	07_3	16	22	0	2200	0	-2200	0.00	0.00	3	0	-3
0014	2T	07_3	21	20	1	2000	320	-1680	0.05	0.16	3	0	-3
0014	2T	07_3	23	14	0	1400	0	-1400	0.00	0.00	2	0	-2
0014	2T	07_3	24	6	1	600	570	-30	0.17	0.95	1	1	0
0014	2T	07_3	25	8	1	800	480	-320	0.13	0.60	1	0	-1
0014	2T	07_3	26	5	1	500	1420	920	0.20	2.84	0	2	2
0014	2T	07_4	12	150	33	15000	11270	-3730	0.22	0.75	26	19	-7
0014	2T	07_4	13	93	21	9300	10900	1600	0.23	1.17	16	19	3
0014	2T	07_4	14	69	11	6900	4700	-2200	0.16	0.68	12	8	-4
0014	2T	07_4	15	13	1	1300	440	-860	0.08	0.34	2	0	-2
0014	2T	07_4	16	18	5	1800	8080	6280	0.28	4.49	3	14	11
0014	2T	07_4	21	21	0	2100	0	-2100	0.00	0.00	3	0	-3
0014	2T	07_4	23	10	0	1000	0	-1000	0.00	0.00	1	0	-1
0014	2T	07_4	24	4	0	400	0	-400	0.00	0.00	0	0	0
0014	2T	07_4	25	4	0	400	0	-400	0.00	0.00	0	0	0
0014	2T	07_4	26	4	1	400	240	-160	0.25	0.60	0	0	0
0014	2T	07_5	12	126	31	12600	11680	-920	0.25	0.93	22	20	-2
0014	2T	07_5	13	67	16	6700	6660	-40	0.24	0.99	11	11	0
0014	2T	07_5	14	50	11	5000	5040	40	0.22	1.01	8	8	0
0014	2T	07_5	15	21	4	2100	2660	560	0.19	1.27	3	4	1
0014	2T	07_5	16	21	5	2100	2910	810	0.24	1.39	3	5	2
0014	2T	07_5	21	13	2	1300	3450	2150	0.15	2.65	2	6	4
0014	2T	07_5	23	6	0	600	0	-600	0.00	0.00	1	0	-1
0014	2T	07_5	24	1	0	100	0	-100	0.00	0.00	0	0	0
0014	2T	07_5	25	5	0	500	0	-500	0.00	0.00	0	0	0
0014	2T	07_5	26	1	0	100	0	-100	0.00	0.00	0	0	0
0014	2T	07_6	12	21	1	2100	280	-1820	0.05	0.13	3	0	-3
0014	2T	07_6	13	9	1	900	260	-640	0.11	0.29	1	0	-1
0014	2T	07_6	14	9	2	900	1470	570	0.22	1.63	1	2	1
0014	2T	07_6	15	6	0	600	0	-600	0.00	0.00	1	0	-1
0014	2T	07_6	16	4	0	400	0	-400	0.00	0.00	0	0	0
0014	2T	07_7	12	177	42	17700	13900	-3800	0.24	0.79	31	24	-7
0014	2T	07_7	13	130	27	13000	9910	-3090	0.21	0.76	23	17	-6
0014	2T	07_7	14	71	8	7100	3530	-3570	0.11	0.50	12	6	-6
0014	2T	07_7	15	26	2	2600	910	-1690	0.08	0.35	4	1	-3
0014	2T	07_7	16	19	1	1900	530	-1370	0.05	0.28	3	0	-3
0014	2T	07_7	21	17	2	1700	1270	-430	0.12	0.75	3	2	-1
0014	2T	07_7	23	3	1	300	380	80	0.33	1.27	0	0	0
0014	2T	07_7	24	2	0	200	0	-200	0.00	0.00	0	0	0
0014	2T	07_7	25	5	0	500	0	-500	0.00	0.00	0	0	0
0014	2T	07_7	26	1	0	100	0	-100	0.00	0.00	0	0	0
0014	2T	08_1	12	204	54	20400	20660	260	0.26	1.01	36	36	0
0014	2T	08_1	13	109	20	10900	7530	-3370	0.18	0.69	19	13	-6
0014	2T	08_1	14	71	12	7100	4970	-2130	0.17	0.70	12	8	-4
0014	2T	08_1	15	37	3	3700	2280	-1420	0.08	0.62	6	4	-2
0014	2T	08_1	16	37	6	3700	4390	690	0.16	1.19	6	7	1
0014	2T	08_1	21	14	2	1400	1070	-330	0.14	0.76	2	1	-1
0014	2T	08_1	23	7	1	700	1430	730	0.14	2.04	1	2	1
0014	2T	08_1	24	4	1	400	510	110	0.25	1.28	0	0	0
0014	2T	08_1	25	6	0	600	0	-600	0.00	0.00	1	0	-1
0014	2T	08_1	26	5	0	500	0	-500	0.00	0.00	0	0	0
0014	2T	08_2	12	191	42	19100	15200	-3900	0.22	0.80	33	26	-7
0014	2T	08_2	13	135	27	13500	12320	-1180	0.20	0.91	23	21	-2
0014	2T	08_2	14	72	14	7200	4420	-2780	0.19	0.61	12	7	-5
0014	2T	08_2	15	39	7	3900	4140	240	0.18	1.06	6	7	1
0014	2T	08_2	16	32	2	3200	1010	-2190	0.06	0.32	5	1	-4
0014	2T	08_2	21	21	4	2100	3700	1600	0.19	1.76	3	6	3
0014	2T	08_2	23	4	0	400	0	-400	0.00	0.00	0	0	0
0014	2T	08_2	24	2	0	200	0	-200	0.00	0.00	0	0	0
0014	2T	08_2	25	4	0	400	0	-400	0.00	0.00	0	0	0
0014	2T	08_2	26	11	2	1100	2620	1520	0.18	2.38	1	4	3
0014	2T	08_3	12	192	43	19200	13560	-5640	0.22	0.71	33	24	-9
0014	2T	08_3	13	137	30	13700	13800	100	0.22	1.01	24	24	0
0014	2T	08_3	14	66	7	6600	2700	-3900	0.11	0.41	11	4	-7
0014	2T	08_3	15	44	4	4400	4010	-390	0.09	0.91	7	7	0
0014	2T	08_3	16	11	0	1100	0	-1100	0.00	0.00	1	0	-1
0014	2T	08_3	21	27	8	2700	3610	910	0.30	1.34	4	6	2
0014	2T	08_3	23	8	0	800	0	-800	0.00	0.00	1	0	-1
0014	2T	08_3	24	7	1	700	1190	490	0.14	1.70	1	2	1
0014	2T	08_3	25	5	1	500	540	40	0.20	1.08	0	0	0
0014	2T	08_3	26	9	0	900	0	-900	0.00	0.00	1	0	-1
0014	2T	08_4	12	73	21	7300	7210	-90	0.29	0.99	12	12	0
0014	2T	08_4	13	40	6	4000	2310	-1690	0.15	0.58	7	4	-3
0014	2T	08_4	14	18	5	1800	2310	510	0.28	1.28	3	4	1
0014	2T	08_4	15	13	2	1300	890	-410	0.15	0.68	2	1	-1
0014	2T	08_4	16	6	0	600	0	-600	0.00	0.00	1	0	-1
0014	2T	08_4	21	11	4	1100	1620	520	0.36	1.47	1	2	1
0014	2T	08_4	23	3	0	300	0	-300	0.00	0.00	0	0	0
0014	2T	08_4	24	2	1	200	880	680	0.50	4.40	0	1	1
0014	2T	08_4	25	3	0	300	0	-300	0.00	0.00	0	0	0
0014	2T	08_4	26	1	0	100	0	-100	0.00	0.00	0	0	0
0014	2T	08_5	12	52	17	5200	7230	2030	0.33	1.39	9	12	3
0014	2T	08_5	13	26	5	2600	2030	-570	0.19	0.78	4	3	-1
0014	2T	08_5	14	16	8	1600	3400	1800	0.50	2.13	2	6	4
0014	2T	08_5	15	11	1	1100	1320	220	0.09	1.20	1	2	1
0014	2T	08_5	16	5	0	500	0	-500	0.00	0.00	0	0	0
0014	2T	08_5	21	1	0	100	0	-100	0.00	0.00	0	0	0
0014	2T	08_5	24	1	0	100	0	-100	0.00	0.00	0	0	0
0014	2T	08_5	26	1	0	100	0	-100	0.00	0.00	0	0	0
0014	2T	08_6	12	4	1	400	860	460	0.25	2.15	0	1	1
0014	2T	08_6	13	4	2	400	720	320	0.50	1.80	0	1	1
0014	2T	08_6	14	3	0	300	0	-300	0.00	0.00	0	0	0
0014	2T	08_6	15	5	1	500	340	-160	0.20	0.68	0	0	0
0014	2T	08_6	21	1	0	100	0	-100	0.00	0.00	0	0	0
0014	2T	08_6	25	1	0	100	0	-100	0.00	0.00	0	0	0
0014	2T	08_7	12	227	68	22700	22690	-10	0.30	1.00	40	40	0
0014	2T	08_7	13	122	29	12200	12410	210	0.24	1.02	21	21	0
0014	2T	08_7	14	90	14	9000	6900	-2100	0.16	0.77	15	12	-3
0014	2T	08_7	15	41	3	4100	3390	-710	0.07	0.83	7	6	-1
0014	2T	08_7	16	23	3	2300	1880	-420	0.13	0.82	4	3	-1
0014	2T	08_7	21	13	2	1300	4590	3290	0.15	3.53	2	8	6
0014	2T	08_7	23	10	0	1000	0	-1000	0.00	0.00	1	0	-1
0014	2T	08_7	24	7	1	700	740	40	0.14	1.06	1	1	0
0014	2T	08_7	25	8	1	800	520	-280	0.13	0.65	1	0	-1
0014	2T	08_7	26	8	0	800	0	-800	0.00	0.00	1	0	-1
0014	2T	09_1	12	181	42	18100	12090	-6010	0.23	0.67	32	21	-11
0014	2T	09_1	13	102	19	10200	7010	-3190	0.19	0.69	18	12	-6
0014	2T	09_1	14	62	12	6200	6130	-70	0.19	0.99	10	10	0
0014	2T	09_1	15	25	2	2500	2540	40	0.08	1.02	4	4	0
0014	2T	09_1	16	17	1	1700	2230	530	0.06	1.31	3	3	0
0014	2T	09_1	21	21	3	2100	1130	-970	0.14	0.54	3	2	-1
0014	2T	09_1	23	21	3	2100	1530	-570	0.14	0.73	3	2	-1
0014	2T	09_1	24	10	0	1000	0	-1000	0.00	0.00	1	0	-1
0014	2T	09_1	25	10	0	1000	0	-1000	0.00	0.00	1	0	-1
0014	2T	09_1	26	2	1	200	2320	2120	0.50	11.60	0	4	4
0014	2T	09_2	12	164	38	16400	13710	-2690	0.23	0.84	29	24	-5
0014	2T	09_2	13	108	25	10800	10720	-80	0.23	0.99	19	18	-1
0014	2T	09_2	14	61	11	6100	8730	2630	0.18	1.43	10	15	5
0014	2T	09_2	15	30	2	3000	6910	3910	0.07	2.30	5	12	7
0014	2T	09_2	16	18	1	1800	1070	-730	0.06	0.59	3	1	-2
0014	2T	09_2	21	24	4	2400	2110	-290	0.17	0.88	4	3	-1
0014	2T	09_2	23	8	0	800	0	-800	0.00	0.00	1	0	-1
0014	2T	09_2	24	7	0	700	0	-700	0.00	0.00	1	0	-1
0014	2T	09_2	25	1	0	100	0	-100	0.00	0.00	0	0	0
0014	2T	09_2	26	7	1	700	560	-140	0.14	0.80	1	0	-1
0014	2T	09_3	12	158	29	15800	9230	-6570	0.18	0.58	27	16	-11
0014	2T	09_3	13	102	17	10200	7640	-2560	0.17	0.75	18	13	-5
0014	2T	09_3	14	52	9	5200	3770	-1430	0.17	0.73	9	6	-3
0014	2T	09_3	15	41	5	4100	3140	-960	0.12	0.77	7	5	-2
0014	2T	09_3	16	17	1	1700	310	-1390	0.06	0.18	3	0	-3
0014	2T	09_3	21	25	4	2500	5910	3410	0.16	2.36	4	10	6
0014	2T	09_3	23	7	1	700	640	-60	0.14	0.91	1	1	0
0014	2T	09_3	24	5	2	500	2600	2100	0.40	5.20	0	4	4
0014	2T	09_3	25	10	1	1000	1720	720	0.10	1.72	1	3	2
0014	2T	09_3	26	6	1	600	410	-190	0.17	0.68	1	0	-1
0014	2T	09_4	12	138	36	13800	10410	-3390	0.26	0.75	24	18	-6
0014	2T	09_4	13	97	17	9700	7510	-2190	0.18	0.77	17	13	-4
0014	2T	09_4	14	46	6	4600	2560	-2040	0.13	0.56	8	4	-4
0014	2T	09_4	15	26	1	2600	390	-2210	0.04	0.15	4	0	-4
0014	2T	09_4	16	11	2	1100	2270	1170	0.18	2.06	1	4	3
0014	2T	09_4	21	27	8	2700	7450	4750	0.30	2.76	4	13	9
0014	2T	09_4	23	13	1	1300	710	-590	0.08	0.55	2	1	-1
0014	2T	09_4	24	4	0	400	0	-400	0.00	0.00	0	0	0
0014	2T	09_4	25	8	0	800	0	-800	0.00	0.00	1	0	-1
0014	2T	09_4	26	8	0	800	0	-800	0.00	0.00	1	0	-1
0014	2T	09_5	12	166	51	16600	15440	-1160	0.31	0.93	29	27	-2
0014	2T	09_5	13	108	15	10800	7880	-2920	0.14	0.73	19	13	-6
0014	2T	09_5	14	44	4	4400	2910	-1490	0.09	0.66	7	5	-2
0014	2T	09_5	15	26	4	2600	2040	-560	0.15	0.78	4	3	-1
0014	2T	09_5	16	17	1	1700	310	-1390	0.06	0.18	3	0	-3
0014	2T	09_5	21	19	1	1900	380	-1520	0.05	0.20	3	0	-3
0014	2T	09_5	23	6	1	600	340	-260	0.17	0.57	1	0	-1
0014	2T	09_5	24	4	0	400	0	-400	0.00	0.00	0	0	0
0014	2T	09_5	25	3	0	300	0	-300	0.00	0.00	0	0	0
0014	2T	09_5	26	1	0	100	0	-100	0.00	0.00	0	0	0
0014	2T	09_7	12	217	73	21700	19730	-1970	0.34	0.91	38	34	-4
0014	2T	09_7	13	111	28	11100	12740	1640	0.25	1.15	19	22	3
0014	2T	09_7	14	70	14	7000	7260	260	0.20	1.04	12	12	0
0014	2T	09_7	15	42	7	4200	5790	1590	0.17	1.38	7	10	3
0014	2T	09_7	16	18	1	1800	1030	-770	0.06	0.57	3	1	-2
0014	2T	09_7	21	20	1	2000	310	-1690	0.05	0.16	3	0	-3
0014	2T	09_7	23	5	0	500	0	-500	0.00	0.00	0	0	0
0014	2T	09_7	24	2	0	200	0	-200	0.00	0.00	0	0	0
0014	2T	09_7	25	2	0	200	0	-200	0.00	0.00	0	0	0
0014	2T	09_7	26	2	0	200	0	-200	0.00	0.00	0	0	0
0014	2T	10_1	12	176	36	17600	13450	-4150	0.20	0.76	31	23	-8
0014	2T	10_1	13	110	16	11000	4280	-6720	0.15	0.39	19	7	-12
0014	2T	10_1	14	74	8	7400	6450	-950	0.11	0.87	13	11	-2
0014	2T	10_1	15	15	1	1500	1350	-150	0.07	0.90	2	2	0
0014	2T	10_1	16	8	0	800	0	-800	0.00	0.00	1	0	-1
0014	2T	10_1	21	35	1	3500	370	-3130	0.03	0.11	6	0	-6
0014	2T	10_1	23	7	1	700	590	-110	0.14	0.84	1	1	0
0014	2T	10_1	24	13	1	1300	1020	-280	0.08	0.78	2	1	-1
0014	2T	10_1	25	2	0	200	0	-200	0.00	0.00	0	0	0
0014	2T	10_1	26	1	0	100	0	-100	0.00	0.00	0	0	0
0014	2T	10_2	12	159	31	15900	13080	-2820	0.19	0.82	28	23	-5
0014	2T	10_2	13	114	17	11400	7160	-4240	0.15	0.63	20	12	-8
0014	2T	10_2	14	68	11	6800	9100	2300	0.16	1.34	12	16	4
0014	2T	10_2	15	19	0	1900	0	-1900	0.00	0.00	3	0	-3
0014	2T	10_2	16	11	1	1100	860	-240	0.09	0.78	1	1	0
0014	2T	10_2	21	24	3	2400	2300	-100	0.13	0.96	4	4	0
0014	2T	10_2	23	13	0	1300	0	-1300	0.00	0.00	2	0	-2
0014	2T	10_2	24	6	1	600	3770	3170	0.17	6.28	1	6	5
0014	2T	10_2	25	3	0	300	0	-300	0.00	0.00	0	0	0
0014	2T	10_2	26	7	1	700	500	-200	0.14	0.71	1	0	-1
0014	2T	10_3	12	176	32	17600	10480	-7120	0.18	0.60	31	18	-13
0014	2T	10_3	13	98	18	9800	9420	-380	0.18	0.96	17	16	-1
0014	2T	10_3	14	66	5	6600	2100	-4500	0.08	0.32	11	3	-8
0014	2T	10_3	15	22	1	2200	440	-1760	0.05	0.20	3	0	-3
0014	2T	10_3	16	3	0	300	0	-300	0.00	0.00	0	0	0
0014	2T	10_3	21	35	3	3500	2980	-520	0.09	0.85	6	5	-1
0014	2T	10_3	23	15	0	1500	0	-1500	0.00	0.00	2	0	-2
0014	2T	10_3	24	7	0	700	0	-700	0.00	0.00	1	0	-1
0014	2T	10_3	25	3	0	300	0	-300	0.00	0.00	0	0	0
0014	2T	10_3	26	1	0	100	0	-100	0.00	0.00	0	0	0
0014	2T	10_4	12	190	36	19000	12750	-6250	0.19	0.67	33	22	-11
0014	2T	10_4	13	98	13	9800	4830	-4970	0.13	0.49	17	8	-9
0014	2T	10_4	14	56	5	5600	2360	-3240	0.09	0.42	9	4	-5
0014	2T	10_4	15	23	1	2300	830	-1470	0.04	0.36	4	1	-3
0014	2T	10_4	16	2	0	200	0	-200	0.00	0.00	0	0	0
0014	2T	10_4	21	25	3	2500	3200	700	0.12	1.28	4	5	1
0014	2T	10_4	23	10	1	1000	450	-550	0.10	0.45	1	0	-1
0014	2T	10_4	24	14	0	1400	0	-1400	0.00	0.00	2	0	-2
0014	2T	10_4	25	3	0	300	0	-300	0.00	0.00	0	0	0
0014	2T	10_5	12	120	22	12000	6150	-5850	0.18	0.51	21	10	-11
0014	2T	10_5	13	80	12	8000	4960	-3040	0.15	0.62	14	8	-6
0014	2T	10_5	14	58	6	5800	2230	-3570	0.10	0.38	10	3	-7
0014	2T	10_5	15	8	1	800	410	-390	0.13	0.51	1	0	-1
0014	2T	10_5	16	3	0	300	0	-300	0.00	0.00	0	0	0
0014	2T	10_5	21	18	1	1800	680	-1120	0.06	0.38	3	1	-2
0014	2T	10_5	23	6	0	600	0	-600	0.00	0.00	1	0	-1
0014	2T	10_5	24	5	0	500	0	-500	0.00	0.00	0	0	0
0014	2T	10_5	25	2	0	200	0	-200	0.00	0.00	0	0	0
0014	2T	10_5	26	1	0	100	0	-100	0.00	0.00	0	0	0
0014	2T	10_6	12	2	0	200	0	-200	0.00	0.00	0	0	0
0014	2T	10_6	13	2	0	200	0	-200	0.00	0.00	0	0	0
0014	2T	10_6	14	2	0	200	0	-200	0.00	0.00	0	0	0
0014	2T	10_6	21	1	0	100	0	-100	0.00	0.00	0	0	0
0014	2T	10_7	12	223	54	22300	18090	-4210	0.24	0.81	39	32	-7
0014	2T	10_7	13	105	24	10500	10040	-460	0.23	0.96	18	17	-1
0014	2T	10_7	14	67	15	6700	7620	920	0.22	1.14	11	13	2
0014	2T	10_7	15	14	1	1400	1000	-400	0.07	0.71	2	1	-1
0014	2T	10_7	16	2	0	200	0	-200	0.00	0.00	0	0	0
0014	2T	10_7	21	26	1	2600	1340	-1260	0.04	0.52	4	2	-2
0014	2T	10_7	23	5	0	500	0	-500	0.00	0.00	0	0	0
0014	2T	10_7	24	6	0	600	0	-600	0.00	0.00	1	0	-1
0014	2T	10_7	25	1	0	100	0	-100	0.00	0.00	0	0	0
0014	2T	11_1	12	162	32	16200	12010	-4190	0.20	0.74	28	21	-7
0014	2T	11_1	13	105	14	10500	6880	-3620	0.13	0.66	18	12	-6
0014	2T	11_1	14	64	4	6400	1750	-4650	0.06	0.27	11	3	-8
0014	2T	11_1	15	24	2	2400	1340	-1060	0.08	0.56	4	2	-2
0014	2T	11_1	16	13	2	1300	3250	1950	0.15	2.50	2	5	3
0014	2T	11_1	21	18	0	1800	0	-1800	0.00	0.00	3	0	-3
0014	2T	11_1	23	5	0	500	0	-500	0.00	0.00	0	0	0
0014	2T	11_1	24	6	0	600	0	-600	0.00	0.00	1	0	-1
0014	2T	11_1	25	3	0	300	0	-300	0.00	0.00	0	0	0
0014	2T	11_1	26	2	0	200	0	-200	0.00	0.00	0	0	0
0014	2T	11_2	12	148	33	14800	11780	-3020	0.22	0.80	26	20	-6
0014	2T	11_2	13	80	14	8000	5360	-2640	0.18	0.67	14	9	-5
0014	2T	11_2	14	59	5	5900	2170	-3730	0.08	0.37	10	3	-7
0014	2T	11_2	15	17	1	1700	520	-1180	0.06	0.31	3	0	-3
0014	2T	11_2	16	26	3	2600	3780	1180	0.12	1.45	4	6	2
0014	2T	11_2	21	14	2	1400	1180	-220	0.14	0.84	2	2	0
0014	2T	11_2	23	9	1	900	410	-490	0.11	0.46	1	0	-1
0014	2T	11_2	24	11	2	1100	2090	990	0.18	1.90	1	3	2
0014	2T	11_2	25	1	0	100	0	-100	0.00	0.00	0	0	0
0014	2T	11_2	26	11	2	1100	1350	250	0.18	1.23	1	2	1
0014	2T	11_3	12	144	34	14400	10610	-3790	0.24	0.74	25	18	-7
0014	2T	11_3	13	85	12	8500	4000	-4500	0.14	0.47	15	7	-8
0014	2T	11_3	14	56	8	5600	3160	-2440	0.14	0.56	9	5	-4
0014	2T	11_3	15	28	4	2800	3080	280	0.14	1.10	4	5	1
0014	2T	11_3	16	13	3	1300	2810	1510	0.23	2.16	2	4	2
0014	2T	11_3	21	18	3	1800	2820	1020	0.17	1.57	3	4	1
0014	2T	11_3	23	10	0	1000	0	-1000	0.00	0.00	1	0	-1
0014	2T	11_3	24	7	1	700	2200	1500	0.14	3.14	1	3	2
0014	2T	11_3	25	8	1	800	1010	210	0.13	1.26	1	1	0
0014	2T	11_3	26	3	0	300	0	-300	0.00	0.00	0	0	0
0014	2T	11_4	12	147	31	14700	11540	-3160	0.21	0.79	26	20	-6
0014	2T	11_4	13	88	19	8800	6290	-2510	0.22	0.71	15	11	-4
0014	2T	11_4	14	44	7	4400	3690	-710	0.16	0.84	7	6	-1
0014	2T	11_4	15	31	2	3100	1600	-1500	0.06	0.52	5	2	-3
0014	2T	11_4	16	7	1	700	710	10	0.14	1.01	1	1	0
0014	2T	11_4	21	19	2	1900	3750	1850	0.11	1.97	3	6	3
0014	2T	11_4	23	9	1	900	420	-480	0.11	0.47	1	0	-1
0014	2T	11_4	24	6	0	600	0	-600	0.00	0.00	1	0	-1
0014	2T	11_4	25	11	2	1100	1910	810	0.18	1.74	1	3	2
0014	2T	11_4	26	2	0	200	0	-200	0.00	0.00	0	0	0
0014	2T	11_5	12	146	45	14600	16350	1750	0.31	1.12	25	28	3
0014	2T	11_5	13	80	17	8000	8450	450	0.21	1.06	14	14	0
0014	2T	11_5	14	59	5	5900	2290	-3610	0.08	0.39	10	4	-6
0014	2T	11_5	15	15	1	1500	330	-1170	0.07	0.22	2	0	-2
0014	2T	11_5	16	5	1	500	830	330	0.20	1.66	0	1	1
0014	2T	11_5	21	7	0	700	0	-700	0.00	0.00	1	0	-1
0014	2T	11_5	23	7	0	700	0	-700	0.00	0.00	1	0	-1
0014	2T	11_5	24	5	0	500	0	-500	0.00	0.00	0	0	0
0014	2T	11_5	26	1	0	100	0	-100	0.00	0.00	0	0	0
0014	2T	11_7	12	202	57	20200	16610	-3590	0.28	0.82	35	29	-6
0014	2T	11_7	13	84	19	8400	7960	-440	0.23	0.95	14	14	0
0014	2T	11_7	14	62	7	6200	3180	-3020	0.11	0.51	10	5	-5
0014	2T	11_7	15	22	0	2200	0	-2200	0.00	0.00	3	0	-3
0014	2T	11_7	16	11	1	1100	1270	170	0.09	1.15	1	2	1
0014	2T	11_7	21	17	3	1700	1700	0	0.18	1.00	3	3	0
0014	2T	11_7	23	3	0	300	0	-300	0.00	0.00	0	0	0
0014	2T	11_7	24	4	1	400	830	430	0.25	2.08	0	1	1
0014	2T	11_7	25	3	0	300	0	-300	0.00	0.00	0	0	0
0014	2T	11_7	26	1	0	100	0	-100	0.00	0.00	0	0	0
0014	2T	12_1	12	180	54	18000	19470	1470	0.30	1.08	31	34	3
0014	2T	12_1	13	99	17	9900	6490	-3410	0.17	0.66	17	11	-6
0014	2T	12_1	14	51	5	5100	2740	-2360	0.10	0.54	9	4	-5
0014	2T	12_1	15	31	5	3100	2760	-340	0.16	0.89	5	4	-1
0014	2T	12_1	16	22	0	2200	0	-2200	0.00	0.00	3	0	-3
0014	2T	12_1	21	10	1	1000	420	-580	0.10	0.42	1	0	-1
0014	2T	12_1	23	6	2	600	1300	700	0.33	2.17	1	2	1
0014	2T	12_1	24	1	0	100	0	-100	0.00	0.00	0	0	0
0014	2T	12_1	25	3	1	300	1590	1290	0.33	5.30	0	2	2
0014	2T	12_1	26	2	0	200	0	-200	0.00	0.00	0	0	0
0014	2T	12_2	12	147	33	14700	9480	-5220	0.22	0.64	26	16	-10
0014	2T	12_2	13	102	22	10200	7970	-2230	0.22	0.78	18	14	-4
0014	2T	12_2	14	56	11	5600	5140	-460	0.20	0.92	9	9	0
0014	2T	12_2	15	21	1	2100	680	-1420	0.05	0.32	3	1	-2
0014	2T	12_2	16	32	5	3200	2100	-1100	0.16	0.66	5	3	-2
0014	2T	12_2	21	17	5	1700	2740	1040	0.29	1.61	3	4	1
0014	2T	12_2	23	10	0	1000	0	-1000	0.00	0.00	1	0	-1
0014	2T	12_2	24	10	1	1000	1280	280	0.10	1.28	1	2	1
0014	2T	12_2	25	5	0	500	0	-500	0.00	0.00	0	0	0
0014	2T	12_3	12	158	32	15800	12730	-3070	0.20	0.81	27	22	-5
0014	2T	12_3	13	90	13	9000	4050	-4950	0.14	0.45	15	7	-8
0014	2T	12_3	14	54	4	5400	2770	-2630	0.07	0.51	9	4	-5
0014	2T	12_3	15	33	2	3300	1950	-1350	0.06	0.59	5	3	-2
0014	2T	12_3	16	22	3	2200	760	-1440	0.14	0.35	3	1	-2
0014	2T	12_3	21	20	3	2000	2180	180	0.15	1.09	3	3	0
0014	2T	12_3	23	14	2	1400	1560	160	0.14	1.11	2	2	0
0014	2T	12_3	24	5	1	500	770	270	0.20	1.54	0	1	1
0014	2T	12_3	25	6	1	600	690	90	0.17	1.15	1	1	0
0014	2T	12_3	26	2	0	200	0	-200	0.00	0.00	0	0	0
0014	2T	12_4	12	152	38	15200	12980	-2220	0.25	0.85	26	22	-4
0014	2T	12_4	13	74	13	7400	5330	-2070	0.18	0.72	13	9	-4
0014	2T	12_4	14	49	4	4900	2050	-2850	0.08	0.42	8	3	-5
0014	2T	12_4	15	32	5	3200	5360	2160	0.16	1.68	5	9	4
0014	2T	12_4	16	8	3	800	860	60	0.38	1.08	1	1	0
0014	2T	12_4	21	12	1	1200	1350	150	0.08	1.13	2	2	0
0014	2T	12_4	23	8	1	800	540	-260	0.13	0.68	1	0	-1
0014	2T	12_4	24	7	2	700	2100	1400	0.29	3.00	1	3	2
0014	2T	12_4	25	9	1	900	290	-610	0.11	0.32	1	0	-1
0014	2T	12_4	26	3	1	300	8280	7980	0.33	27.60	0	14	14
0014	2T	12_5	12	142	38	14200	11520	-2680	0.27	0.81	25	20	-5
0014	2T	12_5	13	68	23	6800	8780	1980	0.34	1.29	12	15	3
0014	2T	12_5	14	45	6	4500	2910	-1590	0.13	0.65	7	5	-2
0014	2T	12_5	15	24	4	2400	2260	-140	0.17	0.94	4	4	0
0014	2T	12_5	16	17	3	1700	1050	-650	0.18	0.62	3	1	-2
0014	2T	12_5	21	4	0	400	0	-400	0.00	0.00	0	0	0
0014	2T	12_5	23	3	0	300	0	-300	0.00	0.00	0	0	0
0014	2T	12_5	24	2	0	200	0	-200	0.00	0.00	0	0	0
0014	2T	12_5	25	1	0	100	0	-100	0.00	0.00	0	0	0
0014	2T	12_6	12	16	1	1600	200	-1400	0.06	0.13	2	0	-2
0014	2T	12_6	13	5	1	500	190	-310	0.20	0.38	0	0	0
0014	2T	12_6	14	5	1	500	910	410	0.20	1.82	0	1	1
0014	2T	12_6	15	2	0	200	0	-200	0.00	0.00	0	0	0
0014	2T	12_6	16	1	0	100	0	-100	0.00	0.00	0	0	0
0014	2T	12_6	21	2	1	200	390	190	0.50	1.95	0	0	0
0014	2T	12_6	26	1	0	100	0	-100	0.00	0.00	0	0	0
0014	2T	12_7	12	193	48	19300	16820	-2480	0.25	0.87	34	29	-5
0014	2T	12_7	13	99	22	9900	7650	-2250	0.22	0.77	17	13	-4
0014	2T	12_7	14	50	5	5000	2490	-2510	0.10	0.50	8	4	-4
0014	2T	12_7	15	27	5	2700	3920	1220	0.19	1.45	4	6	2
0014	2T	12_7	16	12	1	1200	250	-950	0.08	0.21	2	0	-2
0014	2T	12_7	21	18	2	1800	2090	290	0.11	1.16	3	3	0
0014	2T	12_7	23	10	1	1000	290	-710	0.10	0.29	1	0	-1
0014	2T	12_7	24	4	0	400	0	-400	0.00	0.00	0	0	0
0014	2T	12_7	25	3	0	300	0	-300	0.00	0.00	0	0	0
0014	2T	13_1	12	152	32	15200	12140	-3060	0.21	0.80	26	21	-5
0014	2T	13_1	13	109	23	10900	10880	-20	0.21	1.00	19	19	0
0014	2T	13_1	14	79	18	7900	8920	1020	0.23	1.13	13	15	2
0014	2T	13_1	15	23	0	2300	0	-2300	0.00	0.00	4	0	-4
0014	2T	13_1	16	11	1	1100	400	-700	0.09	0.36	1	0	-1
0014	2T	13_1	21	20	2	2000	1450	-550	0.10	0.73	3	2	-1
0014	2T	13_1	23	11	1	1100	1860	760	0.09	1.69	1	3	2
0014	2T	13_1	24	12	1	1200	1600	400	0.08	1.33	2	2	0
0014	2T	13_1	25	3	0	300	0	-300	0.00	0.00	0	0	0
0014	2T	13_1	26	1	0	100	0	-100	0.00	0.00	0	0	0
0014	2T	13_2	12	145	37	14500	18800	4300	0.26	1.30	25	33	8
0014	2T	13_2	13	92	13	9200	7320	-1880	0.14	0.80	16	12	-4
0014	2T	13_2	14	66	16	6600	7880	1280	0.24	1.19	11	13	2
0014	2T	13_2	15	39	4	3900	2600	-1300	0.10	0.67	6	4	-2
0014	2T	13_2	16	15	3	1500	8490	6990	0.20	5.66	2	15	13
0014	2T	13_2	21	27	6	2700	4730	2030	0.22	1.75	4	8	4
0014	2T	13_2	23	12	1	1200	1090	-110	0.08	0.91	2	1	-1
0014	2T	13_2	24	11	1	1100	410	-690	0.09	0.37	1	0	-1
0014	2T	13_2	25	8	0	800	0	-800	0.00	0.00	1	0	-1
0014	2T	13_2	26	6	2	600	2210	1610	0.33	3.68	1	3	2
0014	2T	13_3	12	125	25	12500	9320	-3180	0.20	0.75	22	16	-6
0014	2T	13_3	13	96	18	9600	7970	-1630	0.19	0.83	16	14	-2
0014	2T	13_3	14	52	5	5200	1920	-3280	0.10	0.37	9	3	-6
0014	2T	13_3	15	34	5	3400	4230	830	0.15	1.24	6	7	1
0014	2T	13_3	16	19	2	1900	740	-1160	0.11	0.39	3	1	-2
0014	2T	13_3	21	32	6	3200	3680	480	0.19	1.15	5	6	1
0014	2T	13_3	23	9	1	900	500	-400	0.11	0.56	1	0	-1
0014	2T	13_3	24	7	0	700	0	-700	0.00	0.00	1	0	-1
0014	2T	13_3	25	4	0	400	0	-400	0.00	0.00	0	0	0
0014	2T	13_3	26	6	0	600	0	-600	0.00	0.00	1	0	-1
0014	2T	13_4	12	151	40	15100	15720	620	0.26	1.04	26	27	1
0014	2T	13_4	13	104	34	10400	13020	2620	0.33	1.25	18	23	5
0014	2T	13_4	14	56	10	5600	5250	-350	0.18	0.94	9	9	0
0014	2T	13_4	15	14	1	1400	800	-600	0.07	0.57	2	1	-1
0014	2T	13_4	16	10	1	1000	430	-570	0.10	0.43	1	0	-1
0014	2T	13_4	21	14	2	1400	1150	-250	0.14	0.82	2	2	0
0014	2T	13_4	23	9	0	900	0	-900	0.00	0.00	1	0	-1
0014	2T	13_4	24	8	0	800	0	-800	0.00	0.00	1	0	-1
0014	2T	13_4	25	7	0	700	0	-700	0.00	0.00	1	0	-1
0014	2T	13_4	26	3	0	300	0	-300	0.00	0.00	0	0	0
0014	2T	13_5	12	136	46	13600	12760	-840	0.34	0.94	24	22	-2
0014	2T	13_5	13	92	26	9200	11380	2180	0.28	1.24	16	20	4
0014	2T	13_5	14	59	7	5900	2870	-3030	0.12	0.49	10	5	-5
0014	2T	13_5	15	24	3	2400	1600	-800	0.13	0.67	4	2	-2
0014	2T	13_5	16	11	0	1100	0	-1100	0.00	0.00	1	0	-1
0014	2T	13_5	21	1	0	100	0	-100	0.00	0.00	0	0	0
0014	2T	13_5	23	4	0	400	0	-400	0.00	0.00	0	0	0
0014	2T	13_5	24	1	0	100	0	-100	0.00	0.00	0	0	0
0014	2T	13_5	25	2	0	200	0	-200	0.00	0.00	0	0	0
0014	2T	13_5	26	1	0	100	0	-100	0.00	0.00	0	0	0
0014	2T	13_6	12	16	4	1600	1050	-550	0.25	0.66	2	1	-1
0014	2T	13_6	13	16	4	1600	1120	-480	0.25	0.70	2	1	-1
0014	2T	13_6	14	7	1	700	470	-230	0.14	0.67	1	0	-1
0014	2T	13_6	15	2	0	200	0	-200	0.00	0.00	0	0	0
0014	2T	13_6	16	1	0	100	0	-100	0.00	0.00	0	0	0
0014	2T	13_6	21	2	0	200	0	-200	0.00	0.00	0	0	0
0014	2T	13_7	12	157	47	15700	15200	-500	0.30	0.97	27	26	-1
0014	2T	13_7	13	105	13	10500	4560	-5940	0.12	0.43	18	8	-10
0014	2T	13_7	14	81	20	8100	7400	-700	0.25	0.91	14	13	-1
0014	2T	13_7	15	25	3	2500	1360	-1140	0.12	0.54	4	2	-2
0014	2T	13_7	16	8	0	800	0	-800	0.00	0.00	1	0	-1
0014	2T	13_7	21	13	3	1300	1280	-20	0.23	0.98	2	2	0
0014	2T	13_7	23	5	0	500	0	-500	0.00	0.00	0	0	0
0014	2T	13_7	24	5	0	500	0	-500	0.00	0.00	0	0	0
0014	2T	13_7	25	7	0	700	0	-700	0.00	0.00	1	0	-1
0014	2T	13_7	26	1	0	100	0	-100	0.00	0.00	0	0	0
0014	2T	14_1	12	157	28	15700	16170	470	0.18	1.03	27	28	1
0014	2T	14_1	13	91	12	9100	5780	-3320	0.13	0.64	16	10	-6
0014	2T	14_1	14	81	11	8100	5470	-2630	0.14	0.68	14	9	-5
0014	2T	14_1	15	24	1	2400	280	-2120	0.04	0.12	4	0	-4
0014	2T	14_1	16	9	0	900	0	-900	0.00	0.00	1	0	-1
0014	2T	14_1	21	24	1	2400	340	-2060	0.04	0.14	4	0	-4
0014	2T	14_1	23	12	2	1200	4070	2870	0.17	3.39	2	7	5
0014	2T	14_1	24	9	0	900	0	-900	0.00	0.00	1	0	-1
0014	2T	14_1	25	5	0	500	0	-500	0.00	0.00	0	0	0
0014	2T	14_1	26	1	0	100	0	-100	0.00	0.00	0	0	0
0014	2T	14_2	12	132	23	13200	13320	120	0.17	1.01	23	23	0
0014	2T	14_2	13	91	12	9100	5740	-3360	0.13	0.63	16	10	-6
0014	2T	14_2	14	87	9	8700	4960	-3740	0.10	0.57	15	8	-7
0014	2T	14_2	15	22	1	2200	750	-1450	0.05	0.34	3	1	-2
0014	2T	14_2	16	9	0	900	0	-900	0.00	0.00	1	0	-1
0014	2T	14_2	21	40	4	4000	6770	2770	0.10	1.69	7	11	4
0014	2T	14_2	23	12	1	1200	2610	1410	0.08	2.18	2	4	2
0014	2T	14_2	24	12	0	1200	0	-1200	0.00	0.00	2	0	-2
0014	2T	14_2	25	3	0	300	0	-300	0.00	0.00	0	0	0
0014	2T	14_2	26	1	0	100	0	-100	0.00	0.00	0	0	0
0014	2T	14_3	12	143	26	14300	16650	2350	0.18	1.16	25	29	4
0014	2T	14_3	13	101	19	10100	12650	2550	0.19	1.25	17	22	5
0014	2T	14_3	14	100	9	10000	5530	-4470	0.09	0.55	17	9	-8
0014	2T	14_3	15	39	2	3900	7010	3110	0.05	1.80	6	12	6
0014	2T	14_3	16	4	0	400	0	-400	0.00	0.00	0	0	0
0014	2T	14_3	21	24	1	2400	810	-1590	0.04	0.34	4	1	-3
0014	2T	14_3	23	13	0	1300	0	-1300	0.00	0.00	2	0	-2
0014	2T	14_3	24	10	0	1000	0	-1000	0.00	0.00	1	0	-1
0014	2T	14_3	25	5	0	500	0	-500	0.00	0.00	0	0	0
0014	2T	14_4	12	129	25	12900	11250	-1650	0.19	0.87	22	19	-3
0014	2T	14_4	13	94	21	9400	13050	3650	0.22	1.39	16	23	7
0014	2T	14_4	14	64	10	6400	9260	2860	0.16	1.45	11	16	5
0014	2T	14_4	15	18	4	1800	15750	13950	0.22	8.75	3	27	24
0014	2T	14_4	16	9	0	900	0	-900	0.00	0.00	1	0	-1
0014	2T	14_4	21	13	1	1300	1130	-170	0.08	0.87	2	2	0
0014	2T	14_4	23	14	0	1400	0	-1400	0.00	0.00	2	0	-2
0014	2T	14_4	24	9	0	900	0	-900	0.00	0.00	1	0	-1
0014	2T	14_4	25	5	0	500	0	-500	0.00	0.00	0	0	0
0014	2T	14_4	26	1	0	100	0	-100	0.00	0.00	0	0	0
0014	2T	14_5	12	85	16	8500	4940	-3560	0.19	0.58	15	8	-7
0014	2T	14_5	13	51	5	5100	1700	-3400	0.10	0.33	9	3	-6
0014	2T	14_5	14	39	4	3900	1490	-2410	0.10	0.38	6	2	-4
0014	2T	14_5	15	13	1	1300	600	-700	0.08	0.46	2	1	-1
0014	2T	14_5	16	2	1	200	840	640	0.50	4.20	0	1	1
0014	2T	14_5	21	11	1	1100	650	-450	0.09	0.59	1	1	0
0014	2T	14_5	23	5	0	500	0	-500	0.00	0.00	0	0	0
0014	2T	14_5	24	4	0	400	0	-400	0.00	0.00	0	0	0
0014	2T	14_5	25	2	0	200	0	-200	0.00	0.00	0	0	0
0014	2T	14_5	26	1	0	100	0	-100	0.00	0.00	0	0	0
0014	2T	14_6	12	9	3	900	1060	160	0.33	1.18	1	1	0
0014	2T	14_6	13	3	0	300	0	-300	0.00	0.00	0	0	0
0014	2T	14_6	14	2	0	200	0	-200	0.00	0.00	0	0	0
0014	2T	14_6	15	3	1	300	1030	730	0.33	3.43	0	1	1
0014	2T	14_6	21	2	0	200	0	-200	0.00	0.00	0	0	0
0014	2T	14_6	24	1	0	100	0	-100	0.00	0.00	0	0	0
0014	2T	14_7	12	181	38	18100	11620	-6480	0.21	0.64	32	20	-12
0014	2T	14_7	13	100	14	10000	7470	-2530	0.14	0.75	17	13	-4
0014	2T	14_7	14	77	13	7700	6160	-1540	0.17	0.80	13	10	-3
0014	2T	14_7	15	31	1	3100	540	-2560	0.03	0.17	5	0	-5
0014	2T	14_7	16	5	0	500	0	-500	0.00	0.00	0	0	0
0014	2T	14_7	21	24	6	2400	4360	1960	0.25	1.82	4	7	3
0014	2T	14_7	23	8	0	800	0	-800	0.00	0.00	1	0	-1
0014	2T	14_7	24	5	0	500	0	-500	0.00	0.00	0	0	0
0014	2T	14_7	25	7	0	700	0	-700	0.00	0.00	1	0	-1
0014	2T	14_7	26	4	0	400	0	-400	0.00	0.00	0	0	0
0014	2T	15_1	12	180	39	18000	15630	-2370	0.22	0.87	31	27	-4
0014	2T	15_1	13	120	25	12000	9790	-2210	0.21	0.82	21	17	-4
0014	2T	15_1	14	67	10	6700	5150	-1550	0.15	0.77	11	9	-2
0014	2T	15_1	15	23	4	2300	2900	600	0.17	1.26	4	5	1
0014	2T	15_1	16	15	1	1500	380	-1120	0.07	0.25	2	0	-2
0014	2T	15_1	21	20	1	2000	390	-1610	0.05	0.20	3	0	-3
0014	2T	15_1	23	12	2	1200	2660	1460	0.17	2.22	2	4	2
0014	2T	15_1	24	5	0	500	0	-500	0.00	0.00	0	0	0
0014	2T	15_1	25	2	0	200	0	-200	0.00	0.00	0	0	0
0014	2T	15_1	26	5	0	500	0	-500	0.00	0.00	0	0	0
0014	2T	15_2	12	185	45	18500	17390	-1110	0.24	0.94	32	30	-2
0014	2T	15_2	13	111	27	11100	15440	4340	0.24	1.39	19	27	8
0014	2T	15_2	14	88	10	8800	5520	-3280	0.11	0.63	15	9	-6
0014	2T	15_2	15	29	4	2900	3510	610	0.14	1.21	5	6	1
0014	2T	15_2	16	17	1	1700	1210	-490	0.06	0.71	3	2	-1
0014	2T	15_2	21	19	4	1900	3210	1310	0.21	1.69	3	5	2
0014	2T	15_2	23	14	0	1400	0	-1400	0.00	0.00	2	0	-2
0014	2T	15_2	24	2	1	200	470	270	0.50	2.35	0	0	0
0014	2T	15_2	25	6	1	600	410	-190	0.17	0.68	1	0	-1
0014	2T	15_2	26	2	0	200	0	-200	0.00	0.00	0	0	0
0014	2T	15_3	12	196	37	19600	12180	-7420	0.19	0.62	34	21	-13
0014	2T	15_3	13	100	18	10000	9030	-970	0.18	0.90	17	15	-2
0014	2T	15_3	14	80	17	8000	9820	1820	0.21	1.23	14	17	3
0014	2T	15_3	15	37	2	3700	1320	-2380	0.05	0.36	6	2	-4
0014	2T	15_3	16	5	1	500	2500	2000	0.20	5.00	0	4	4
0014	2T	15_3	21	20	3	2000	1940	-60	0.15	0.97	3	3	0
0014	2T	15_3	23	8	0	800	0	-800	0.00	0.00	1	0	-1
0014	2T	15_3	24	8	1	800	410	-390	0.13	0.51	1	0	-1
0014	2T	15_3	25	4	1	400	450	50	0.25	1.13	0	0	0
0014	2T	15_3	26	2	0	200	0	-200	0.00	0.00	0	0	0
0014	2T	15_4	12	149	35	14900	12030	-2870	0.23	0.81	26	21	-5
0014	2T	15_4	13	103	24	10300	9180	-1120	0.23	0.89	18	16	-2
0014	2T	15_4	14	75	14	7500	6460	-1040	0.19	0.86	13	11	-2
0014	2T	15_4	15	17	0	1700	0	-1700	0.00	0.00	3	0	-3
0014	2T	15_4	16	16	2	1600	850	-750	0.13	0.53	2	1	-1
0014	2T	15_4	21	20	2	2000	1390	-610	0.10	0.70	3	2	-1
0014	2T	15_4	23	6	1	600	580	-20	0.17	0.97	1	1	0
0014	2T	15_4	24	8	1	800	2040	1240	0.13	2.55	1	3	2
0014	2T	15_4	25	5	0	500	0	-500	0.00	0.00	0	0	0
0014	2T	15_4	26	2	1	200	770	570	0.50	3.85	0	1	1
0014	2T	15_5	12	154	28	15400	9490	-5910	0.18	0.62	27	16	-11
0014	2T	15_5	13	72	14	7200	5060	-2140	0.19	0.70	12	8	-4
0014	2T	15_5	14	39	10	3900	5400	1500	0.26	1.38	6	9	3
0014	2T	15_5	15	20	2	2000	590	-1410	0.10	0.30	3	1	-2
0014	2T	15_5	16	16	5	1600	2730	1130	0.31	1.71	2	4	2
0014	2T	15_5	21	8	1	800	3100	2300	0.13	3.88	1	5	4
0014	2T	15_5	23	1	0	100	0	-100	0.00	0.00	0	0	0
0014	2T	15_5	24	3	0	300	0	-300	0.00	0.00	0	0	0
0014	2T	15_5	25	3	0	300	0	-300	0.00	0.00	0	0	0
0014	2T	15_5	26	4	0	400	0	-400	0.00	0.00	0	0	0
0014	2T	15_6	12	27	5	2700	1790	-910	0.19	0.66	4	3	-1
0014	2T	15_6	13	16	2	1600	900	-700	0.13	0.56	2	1	-1
0014	2T	15_6	14	6	0	600	0	-600	0.00	0.00	1	0	-1
0014	2T	15_6	15	4	0	400	0	-400	0.00	0.00	0	0	0
0014	2T	15_6	16	1	0	100	0	-100	0.00	0.00	0	0	0
0014	2T	15_6	21	1	0	100	0	-100	0.00	0.00	0	0	0
0014	2T	15_6	23	1	0	100	0	-100	0.00	0.00	0	0	0
0014	2T	15_6	24	1	0	100	0	-100	0.00	0.00	0	0	0
0014	2T	15_7	12	231	66	23100	21020	-2080	0.29	0.91	40	37	-3
0014	2T	15_7	13	99	18	9900	6970	-2930	0.18	0.70	17	12	-5
0014	2T	15_7	14	85	15	8500	6800	-1700	0.18	0.80	15	12	-3
0014	2T	15_7	15	33	3	3300	2010	-1290	0.09	0.61	5	3	-2
0014	2T	15_7	16	23	6	2300	6960	4660	0.26	3.03	4	12	8
0014	2T	15_7	21	16	3	1600	2780	1180	0.19	1.74	2	4	2
0014	2T	15_7	23	6	0	600	0	-600	0.00	0.00	1	0	-1
0014	2T	15_7	24	3	0	300	0	-300	0.00	0.00	0	0	0
0014	2T	15_7	25	4	1	400	3310	2910	0.25	8.28	0	5	5
0014	2T	15_7	26	2	0	200	0	-200	0.00	0.00	0	0	0
0014	2T	16_1	12	215	44	21500	15860	-5640	0.20	0.74	38	28	-10
0014	2T	16_1	13	120	15	12000	8240	-3760	0.13	0.69	21	14	-7
0014	2T	16_1	14	89	24	8900	10490	1590	0.27	1.18	15	18	3
0014	2T	16_1	15	33	2	3300	2000	-1300	0.06	0.61	5	3	-2
0014	2T	16_1	16	15	3	1500	2110	610	0.20	1.41	2	3	1
0014	2T	16_1	21	29	1	2900	430	-2470	0.03	0.15	5	0	-5
0014	2T	16_1	23	4	0	400	0	-400	0.00	0.00	0	0	0
0014	2T	16_1	24	8	0	800	0	-800	0.00	0.00	1	0	-1
0014	2T	16_1	25	2	0	200	0	-200	0.00	0.00	0	0	0
0014	2T	16_1	26	1	0	100	0	-100	0.00	0.00	0	0	0
0014	2T	16_2	12	188	41	18800	14700	-4100	0.22	0.78	33	26	-7
0014	2T	16_2	13	98	17	9800	8910	-890	0.17	0.91	17	15	-2
0014	2T	16_2	14	76	14	7600	4710	-2890	0.18	0.62	13	8	-5
0014	2T	16_2	15	31	5	3100	7240	4140	0.16	2.34	5	12	7
0014	2T	16_2	16	21	1	2100	450	-1650	0.05	0.21	3	0	-3
0014	2T	16_2	21	18	2	1800	1360	-440	0.11	0.76	3	2	-1
0014	2T	16_2	23	11	0	1100	0	-1100	0.00	0.00	1	0	-1
0014	2T	16_2	24	8	0	800	0	-800	0.00	0.00	1	0	-1
0014	2T	16_2	25	8	1	800	1630	830	0.13	2.04	1	2	1
0014	2T	16_2	26	9	1	900	490	-410	0.11	0.54	1	0	-1
0014	2T	16_3	12	171	46	17100	16450	-650	0.27	0.96	30	29	-1
0014	2T	16_3	13	117	20	11700	9870	-1830	0.17	0.84	20	17	-3
0014	2T	16_3	14	62	11	6200	6770	570	0.18	1.09	10	11	1
0014	2T	16_3	15	31	4	3100	2660	-440	0.13	0.86	5	4	-1
0014	2T	16_3	16	13	0	1300	0	-1300	0.00	0.00	2	0	-2
0014	2T	16_3	21	23	3	2300	2370	70	0.13	1.03	4	4	0
0014	2T	16_3	23	14	1	1400	320	-1080	0.07	0.23	2	0	-2
0014	2T	16_3	24	2	0	200	0	-200	0.00	0.00	0	0	0
0014	2T	16_3	25	7	0	700	0	-700	0.00	0.00	1	0	-1
0014	2T	16_3	26	7	0	700	0	-700	0.00	0.00	1	0	-1
0014	2T	16_4	12	170	38	17000	11000	-6000	0.22	0.65	30	19	-11
0014	2T	16_4	13	119	29	11900	14290	2390	0.24	1.20	21	25	4
0014	2T	16_4	14	64	16	6400	6470	70	0.25	1.01	11	11	0
0014	2T	16_4	15	22	2	2200	2500	300	0.09	1.14	3	4	1
0014	2T	16_4	16	12	1	1200	640	-560	0.08	0.53	2	1	-1
0014	2T	16_4	21	19	3	1900	1120	-780	0.16	0.59	3	1	-2
0014	2T	16_4	23	10	0	1000	0	-1000	0.00	0.00	1	0	-1
0014	2T	16_4	24	9	0	900	0	-900	0.00	0.00	1	0	-1
0014	2T	16_4	25	8	1	800	980	180	0.13	1.23	1	1	0
0014	2T	16_4	26	3	0	300	0	-300	0.00	0.00	0	0	0
0014	2T	16_5	12	189	54	18900	16930	-1970	0.29	0.90	33	29	-4
0014	2T	16_5	13	100	18	10000	9180	-820	0.18	0.92	17	16	-1
0014	2T	16_5	14	75	18	7500	6250	-1250	0.24	0.83	13	11	-2
0014	2T	16_5	15	20	1	2000	1540	-460	0.05	0.77	3	2	-1
0014	2T	16_5	16	8	0	800	0	-800	0.00	0.00	1	0	-1
0014	2T	16_5	21	3	1	300	760	460	0.33	2.53	0	1	1
0014	2T	16_5	23	7	0	700	0	-700	0.00	0.00	1	0	-1
0014	2T	16_5	24	1	1	100	2310	2210	1.00	23.10	0	4	4
0014	2T	16_5	25	1	0	100	0	-100	0.00	0.00	0	0	0
0014	2T	16_5	26	1	0	100	0	-100	0.00	0.00	0	0	0
0014	2T	16_7	12	216	67	21600	19940	-1660	0.31	0.92	38	35	-3
0014	2T	16_7	13	128	22	12800	7300	-5500	0.17	0.57	22	12	-10
0014	2T	16_7	14	83	19	8300	7670	-630	0.23	0.92	14	13	-1
0014	2T	16_7	15	27	5	2700	3250	550	0.19	1.20	4	5	1
0014	2T	16_7	16	24	3	2400	1760	-640	0.13	0.73	4	3	-1
0014	2T	16_7	21	7	0	700	0	-700	0.00	0.00	1	0	-1
0014	2T	16_7	23	7	0	700	0	-700	0.00	0.00	1	0	-1
0014	2T	16_7	24	1	0	100	0	-100	0.00	0.00	0	0	0
0014	2T	16_7	26	2	0	200	0	-200	0.00	0.00	0	0	0
0014	2T	17_1	12	192	42	19200	14400	-4800	0.22	0.75	33	25	-8
0014	2T	17_1	13	142	27	14200	9550	-4650	0.19	0.67	25	16	-9
0014	2T	17_1	14	67	10	6700	4820	-1880	0.15	0.72	11	8	-3
0014	2T	17_1	15	31	2	3100	6270	3170	0.06	2.02	5	11	6
0014	2T	17_1	16	9	0	900	0	-900	0.00	0.00	1	0	-1
0014	2T	17_1	21	19	1	1900	660	-1240	0.05	0.35	3	1	-2
0014	2T	17_1	23	12	1	1200	550	-650	0.08	0.46	2	0	-2
0014	2T	17_1	24	5	0	500	0	-500	0.00	0.00	0	0	0
0014	2T	17_1	25	5	0	500	0	-500	0.00	0.00	0	0	0
0014	2T	17_1	26	4	1	400	470	70	0.25	1.18	0	0	0
0014	2T	17_2	12	203	47	20300	17900	-2400	0.23	0.88	35	31	-4
0014	2T	17_2	13	123	27	12300	12310	10	0.22	1.00	21	21	0
0014	2T	17_2	14	79	9	7900	4450	-3450	0.11	0.56	13	7	-6
0014	2T	17_2	15	25	2	2500	900	-1600	0.08	0.36	4	1	-3
0014	2T	17_2	16	8	0	800	0	-800	0.00	0.00	1	0	-1
0014	2T	17_2	21	21	2	2100	980	-1120	0.10	0.47	3	1	-2
0014	2T	17_2	23	9	2	900	5320	4420	0.22	5.91	1	9	8
0014	2T	17_2	24	10	1	1000	610	-390	0.10	0.61	1	1	0
0014	2T	17_2	25	4	1	400	700	300	0.25	1.75	0	1	1
0014	2T	17_2	26	2	1	200	1550	1350	0.50	7.75	0	2	2
0014	2T	17_3	12	189	51	18900	20030	1130	0.27	1.06	33	35	2
0014	2T	17_3	13	123	28	12300	9680	-2620	0.23	0.79	21	17	-4
0014	2T	17_3	14	74	11	7400	8180	780	0.15	1.11	13	14	1
0014	2T	17_3	15	28	4	2800	2420	-380	0.14	0.86	4	4	0
0014	2T	17_3	16	10	1	1000	920	-80	0.10	0.92	1	1	0
0014	2T	17_3	21	27	4	2700	1650	-1050	0.15	0.61	4	2	-2
0014	2T	17_3	23	10	1	1000	860	-140	0.10	0.86	1	1	0
0014	2T	17_3	24	7	0	700	0	-700	0.00	0.00	1	0	-1
0014	2T	17_3	25	6	0	600	0	-600	0.00	0.00	1	0	-1
0014	2T	17_3	26	4	1	400	1290	890	0.25	3.23	0	2	2
0014	2T	17_4	12	162	30	16200	11930	-4270	0.19	0.74	28	21	-7
0014	2T	17_4	13	116	29	11600	13020	1420	0.25	1.12	20	23	3
0014	2T	17_4	14	58	8	5800	2640	-3160	0.14	0.46	10	4	-6
0014	2T	17_4	15	24	5	2400	4580	2180	0.21	1.91	4	8	4
0014	2T	17_4	16	5	0	500	0	-500	0.00	0.00	0	0	0
0014	2T	17_4	21	11	2	1100	1100	0	0.18	1.00	1	1	0
0014	2T	17_4	23	12	1	1200	270	-930	0.08	0.23	2	0	-2
0014	2T	17_4	24	8	1	800	360	-440	0.13	0.45	1	0	-1
0014	2T	17_4	25	3	0	300	0	-300	0.00	0.00	0	0	0
0014	2T	17_4	26	1	0	100	0	-100	0.00	0.00	0	0	0
0014	2T	17_5	12	172	40	17200	13470	-3730	0.23	0.78	30	23	-7
0014	2T	17_5	13	86	22	8600	7410	-1190	0.26	0.86	15	13	-2
0014	2T	17_5	14	49	9	4900	4390	-510	0.18	0.90	8	7	-1
0014	2T	17_5	15	22	3	2200	5530	3330	0.14	2.51	3	9	6
0014	2T	17_5	16	7	1	700	280	-420	0.14	0.40	1	0	-1
0014	2T	17_5	21	8	1	800	1990	1190	0.13	2.49	1	3	2
0014	2T	17_5	23	2	0	200	0	-200	0.00	0.00	0	0	0
0014	2T	17_5	24	2	0	200	0	-200	0.00	0.00	0	0	0
0014	2T	17_5	25	2	0	200	0	-200	0.00	0.00	0	0	0
0014	2T	17_7	12	231	53	23100	18090	-5010	0.23	0.78	40	32	-8
0014	2T	17_7	13	117	24	11700	11050	-650	0.21	0.94	20	19	-1
0014	2T	17_7	14	75	10	7500	4030	-3470	0.13	0.54	13	7	-6
0014	2T	17_7	15	17	1	1700	1470	-230	0.06	0.86	3	2	-1
0014	2T	17_7	16	10	0	1000	0	-1000	0.00	0.00	1	0	-1
0014	2T	17_7	21	17	1	1700	1860	160	0.06	1.09	3	3	0
0014	2T	17_7	23	8	2	800	3690	2890	0.25	4.61	1	6	5
0014	2T	17_7	24	3	0	300	0	-300	0.00	0.00	0	0	0
0014	2T	17_7	25	2	0	200	0	-200	0.00	0.00	0	0	0
0014	2T	17_7	26	2	0	200	0	-200	0.00	0.00	0	0	0
0014	2T	18_1	12	190	43	19000	14760	-4240	0.23	0.78	33	26	-7
0014	2T	18_1	13	120	21	12000	9410	-2590	0.18	0.78	21	16	-5
0014	2T	18_1	14	78	20	7800	11100	3300	0.26	1.42	13	19	6
0014	2T	18_1	15	26	6	2600	7820	5220	0.23	3.01	4	13	9
0014	2T	18_1	16	9	0	900	0	-900	0.00	0.00	1	0	-1
0014	2T	18_1	21	29	6	2900	4630	1730	0.21	1.60	5	8	3
0014	2T	18_1	23	14	3	1400	1680	280	0.21	1.20	2	2	0
0014	2T	18_1	24	15	1	1500	350	-1150	0.07	0.23	2	0	-2
0014	2T	18_1	25	3	1	300	660	360	0.33	2.20	0	1	1
0014	2T	18_1	26	4	0	400	0	-400	0.00	0.00	0	0	0
0014	2T	18_2	12	213	58	21300	20120	-1180	0.27	0.94	37	35	-2
0014	2T	18_2	13	97	14	9700	5800	-3900	0.14	0.60	17	10	-7
0014	2T	18_2	14	94	13	9400	5630	-3770	0.14	0.60	16	9	-7
0014	2T	18_2	15	25	2	2500	1450	-1050	0.08	0.58	4	2	-2
0014	2T	18_2	16	5	0	500	0	-500	0.00	0.00	0	0	0
0014	2T	18_2	21	23	2	2300	830	-1470	0.09	0.36	4	1	-3
0014	2T	18_2	23	10	2	1000	640	-360	0.20	0.64	1	1	0
0014	2T	18_2	24	6	2	600	15140	14540	0.33	25.23	1	26	25
0014	2T	18_2	25	6	1	600	380	-220	0.17	0.63	1	0	-1
0014	2T	18_2	26	3	0	300	0	-300	0.00	0.00	0	0	0
0014	2T	18_3	12	187	54	18700	16970	-1730	0.29	0.91	33	30	-3
0014	2T	18_3	13	115	28	11500	13900	2400	0.24	1.21	20	24	4
0014	2T	18_3	14	70	10	7000	5710	-1290	0.14	0.82	12	10	-2
0014	2T	18_3	15	28	2	2800	770	-2030	0.07	0.28	4	1	-3
0014	2T	18_3	16	12	0	1200	0	-1200	0.00	0.00	2	0	-2
0014	2T	18_3	21	22	1	2200	390	-1810	0.05	0.18	3	0	-3
0014	2T	18_3	23	16	2	1600	3480	1880	0.13	2.18	2	6	4
0014	2T	18_3	24	13	0	1300	0	-1300	0.00	0.00	2	0	-2
0014	2T	18_3	25	2	0	200	0	-200	0.00	0.00	0	0	0
0014	2T	18_3	26	4	0	400	0	-400	0.00	0.00	0	0	0
0014	2T	18_4	12	201	57	20100	17420	-2680	0.28	0.87	35	30	-5
0014	2T	18_4	13	120	18	12000	9230	-2770	0.15	0.77	21	16	-5
0014	2T	18_4	14	76	10	7600	6920	-680	0.13	0.91	13	12	-1
0014	2T	18_4	15	31	0	3100	0	-3100	0.00	0.00	5	0	-5
0014	2T	18_4	16	9	0	900	0	-900	0.00	0.00	1	0	-1
0014	2T	18_4	21	16	3	1600	1280	-320	0.19	0.80	2	2	0
0014	2T	18_4	23	12	0	1200	0	-1200	0.00	0.00	2	0	-2
0014	2T	18_4	24	10	0	1000	0	-1000	0.00	0.00	1	0	-1
0014	2T	18_4	25	2	0	200	0	-200	0.00	0.00	0	0	0
0014	2T	18_4	26	4	0	400	0	-400	0.00	0.00	0	0	0
0014	2T	18_5	12	199	57	19900	18450	-1450	0.29	0.93	35	32	-3
0014	2T	18_5	13	97	19	9700	8490	-1210	0.20	0.88	17	15	-2
0014	2T	18_5	14	86	13	8600	9550	950	0.15	1.11	15	16	1
0014	2T	18_5	15	26	2	2600	810	-1790	0.08	0.31	4	1	-3
0014	2T	18_5	16	4	0	400	0	-400	0.00	0.00	0	0	0
0014	2T	18_5	21	6	0	600	0	-600	0.00	0.00	1	0	-1
0014	2T	18_5	23	9	1	900	410	-490	0.11	0.46	1	0	-1
0014	2T	18_5	24	4	0	400	0	-400	0.00	0.00	0	0	0
0014	2T	18_5	25	4	0	400	0	-400	0.00	0.00	0	0	0
0014	2T	18_6	12	20	7	2000	1570	-430	0.35	0.79	3	2	-1
0014	2T	18_6	13	12	2	1200	630	-570	0.17	0.53	2	1	-1
0014	2T	18_6	14	8	2	800	530	-270	0.25	0.66	1	0	-1
0014	2T	18_6	15	7	1	700	2080	1380	0.14	2.97	1	3	2
0014	2T	18_6	21	1	0	100	0	-100	0.00	0.00	0	0	0
0014	2T	18_6	23	1	0	100	0	-100	0.00	0.00	0	0	0
0014	2T	18_7	12	206	66	20600	17480	-3120	0.32	0.85	36	30	-6
0014	2T	18_7	13	130	26	13000	9700	-3300	0.20	0.75	23	17	-6
0014	2T	18_7	14	88	15	8800	8640	-160	0.17	0.98	15	15	0
0014	2T	18_7	15	23	5	2300	3540	1240	0.22	1.54	4	6	2
0014	2T	18_7	16	6	0	600	0	-600	0.00	0.00	1	0	-1
0014	2T	18_7	21	13	0	1300	0	-1300	0.00	0.00	2	0	-2
0014	2T	18_7	23	10	0	1000	0	-1000	0.00	0.00	1	0	-1
0014	2T	18_7	24	9	0	900	0	-900	0.00	0.00	1	0	-1
0014	2T	18_7	25	2	0	200	0	-200	0.00	0.00	0	0	0
0014	2T	18_7	26	5	0	500	0	-500	0.00	0.00	0	0	0
0014	2T	19_1	12	158	37	15800	13660	-2140	0.23	0.86	27	24	-3
0014	2T	19_1	13	140	25	14000	9860	-4140	0.18	0.70	24	17	-7
0014	2T	19_1	14	76	22	7600	7050	-550	0.29	0.93	13	12	-1
0014	2T	19_1	15	12	2	1200	1170	-30	0.17	0.98	2	2	0
0014	2T	19_1	16	16	2	1600	1020	-580	0.13	0.64	2	1	-1
0014	2T	19_1	21	13	2	1300	1470	170	0.15	1.13	2	2	0
0014	2T	19_1	23	5	0	500	0	-500	0.00	0.00	0	0	0
0014	2T	19_1	24	4	0	400	0	-400	0.00	0.00	0	0	0
0014	2T	19_1	26	5	0	500	0	-500	0.00	0.00	0	0	0
0014	2T	19_2	12	144	29	14400	9090	-5310	0.20	0.63	25	16	-9
0014	2T	19_2	13	99	26	9900	10540	640	0.26	1.06	17	18	1
0014	2T	19_2	14	90	19	9000	7250	-1750	0.21	0.81	15	12	-3
0014	2T	19_2	15	17	2	1700	1920	220	0.12	1.13	3	3	0
0014	2T	19_2	16	23	4	2300	2750	450	0.17	1.20	4	4	0
0014	2T	19_2	21	11	5	1100	5030	3930	0.45	4.57	1	8	7
0014	2T	19_2	23	9	1	900	2190	1290	0.11	2.43	1	3	2
0014	2T	19_2	24	4	0	400	0	-400	0.00	0.00	0	0	0
0014	2T	19_2	25	1	0	100	0	-100	0.00	0.00	0	0	0
0014	2T	19_2	26	6	0	600	0	-600	0.00	0.00	1	0	-1
0014	2T	19_3	12	204	46	20400	16720	-3680	0.23	0.82	36	29	-7
0014	2T	19_3	13	97	19	9700	6150	-3550	0.20	0.63	17	10	-7
0014	2T	19_3	14	80	12	8000	3430	-4570	0.15	0.43	14	6	-8
0014	2T	19_3	15	26	3	2600	1570	-1030	0.12	0.60	4	2	-2
0014	2T	19_3	16	10	1	1000	260	-740	0.10	0.26	1	0	-1
0014	2T	19_3	21	17	5	1700	4500	2800	0.29	2.65	3	7	4
0014	2T	19_3	23	4	0	400	0	-400	0.00	0.00	0	0	0
0014	2T	19_3	24	2	0	200	0	-200	0.00	0.00	0	0	0
0014	2T	19_3	25	1	0	100	0	-100	0.00	0.00	0	0	0
0014	2T	19_3	26	6	1	600	630	30	0.17	1.05	1	1	0
0014	2T	19_4	12	149	34	14900	12040	-2860	0.23	0.81	26	21	-5
0014	2T	19_4	13	102	24	10200	8410	-1790	0.24	0.82	18	14	-4
0014	2T	19_4	14	66	13	6600	6740	140	0.20	1.02	11	11	0
0014	2T	19_4	15	11	1	1100	740	-360	0.09	0.67	1	1	0
0014	2T	19_4	16	8	0	800	0	-800	0.00	0.00	1	0	-1
0014	2T	19_4	21	14	3	1400	1250	-150	0.21	0.89	2	2	0
0014	2T	19_4	23	11	2	1100	860	-240	0.18	0.78	1	1	0
0014	2T	19_4	24	3	0	300	0	-300	0.00	0.00	0	0	0
0014	2T	19_4	26	3	0	300	0	-300	0.00	0.00	0	0	0
0014	2T	19_5	12	111	23	11100	10900	-200	0.21	0.98	19	19	0
0014	2T	19_5	13	79	22	7900	9430	1530	0.28	1.19	13	16	3
0014	2T	19_5	14	51	10	5100	6290	1190	0.20	1.23	9	11	2
0014	2T	19_5	15	8	2	800	4490	3690	0.25	5.61	1	7	6
0014	2T	19_5	16	4	0	400	0	-400	0.00	0.00	0	0	0
0014	2T	19_5	21	8	2	800	2290	1490	0.25	2.86	1	4	3
0014	2T	19_5	23	11	1	1100	560	-540	0.09	0.51	1	0	-1
0014	2T	19_5	24	1	0	100	0	-100	0.00	0.00	0	0	0
0014	2T	19_5	25	3	0	300	0	-300	0.00	0.00	0	0	0
0014	2T	19_5	26	4	1	400	3030	2630	0.25	7.58	0	5	5
0014	2T	19_6	12	17	6	1700	1650	-50	0.35	0.97	3	2	-1
0014	2T	19_6	13	12	4	1200	1340	140	0.33	1.12	2	2	0
0014	2T	19_6	14	4	1	400	420	20	0.25	1.05	0	0	0
0014	2T	19_6	15	4	0	400	0	-400	0.00	0.00	0	0	0
0014	2T	19_6	16	1	0	100	0	-100	0.00	0.00	0	0	0
0014	2T	19_6	24	1	0	100	0	-100	0.00	0.00	0	0	0
0014	2T	19_6	25	3	0	300	0	-300	0.00	0.00	0	0	0
0014	2T	19_7	12	187	52	18700	15020	-3680	0.28	0.80	33	26	-7
0014	2T	19_7	13	123	32	12300	11940	-360	0.26	0.97	21	21	0
0014	2T	19_7	14	79	17	7900	7190	-710	0.22	0.91	13	12	-1
0014	2T	19_7	15	19	2	1900	1760	-140	0.11	0.93	3	3	0
0014	2T	19_7	16	10	3	1000	2390	1390	0.30	2.39	1	4	3
0014	2T	19_7	21	11	0	1100	0	-1100	0.00	0.00	1	0	-1
0014	2T	19_7	23	14	1	1400	1030	-370	0.07	0.74	2	1	-1
0014	2T	19_7	24	1	0	100	0	-100	0.00	0.00	0	0	0
0014	2T	19_7	25	1	0	100	0	-100	0.00	0.00	0	0	0
0014	2T	20_1	12	178	41	17800	15260	-2540	0.23	0.86	31	27	-4
0014	2T	20_1	13	141	34	14100	14420	320	0.24	1.02	24	25	1
0014	2T	20_1	14	79	14	7900	11030	3130	0.18	1.40	13	19	6
0014	2T	20_1	15	20	1	2000	1970	-30	0.05	0.99	3	3	0
0014	2T	20_1	16	15	1	1500	2450	950	0.07	1.63	2	4	2
0014	2T	20_1	21	13	4	1300	1100	-200	0.31	0.85	2	1	-1
0014	2T	20_1	23	5	0	500	0	-500	0.00	0.00	0	0	0
0014	2T	20_1	24	1	0	100	0	-100	0.00	0.00	0	0	0
0014	2T	20_1	26	3	0	300	0	-300	0.00	0.00	0	0	0
0014	2T	20_2	12	167	36	16700	12480	-4220	0.22	0.75	29	22	-7
0014	2T	20_2	13	99	16	9900	5230	-4670	0.16	0.53	17	9	-8
0014	2T	20_2	14	76	11	7600	4950	-2650	0.14	0.65	13	8	-5
0014	2T	20_2	15	27	4	2700	2140	-560	0.15	0.79	4	3	-1
0014	2T	20_2	16	30	8	3000	5060	2060	0.27	1.69	5	8	3
0014	2T	20_2	21	11	3	1100	1830	730	0.27	1.66	1	3	2
0014	2T	20_2	23	5	0	500	0	-500	0.00	0.00	0	0	0
0014	2T	20_2	24	2	0	200	0	-200	0.00	0.00	0	0	0
0014	2T	20_2	25	3	0	300	0	-300	0.00	0.00	0	0	0
0014	2T	20_2	26	3	1	300	670	370	0.33	2.23	0	1	1
0014	2T	20_3	12	190	48	19000	15420	-3580	0.25	0.81	33	27	-6
0014	2T	20_3	13	117	29	11700	12390	690	0.25	1.06	20	21	1
0014	2T	20_3	14	61	5	6100	2750	-3350	0.08	0.45	10	4	-6
0014	2T	20_3	15	33	7	3300	4420	1120	0.21	1.34	5	7	2
0014	2T	20_3	16	14	2	1400	1340	-60	0.14	0.96	2	2	0
0014	2T	20_3	21	7	2	700	710	10	0.29	1.01	1	1	0
0014	2T	20_3	23	5	0	500	0	-500	0.00	0.00	0	0	0
0014	2T	20_3	24	2	0	200	0	-200	0.00	0.00	0	0	0
0014	2T	20_3	26	3	0	300	0	-300	0.00	0.00	0	0	0
0014	2T	20_4	12	139	28	13900	9220	-4680	0.20	0.66	24	16	-8
0014	2T	20_4	13	87	20	8700	7760	-940	0.23	0.89	15	13	-2
0014	2T	20_4	14	73	16	7300	6030	-1270	0.22	0.83	12	10	-2
0014	2T	20_4	15	31	6	3100	5470	2370	0.19	1.76	5	9	4
0014	2T	20_4	16	10	1	1000	600	-400	0.10	0.60	1	1	0
0014	2T	20_4	21	11	1	1100	550	-550	0.09	0.50	1	0	-1
0014	2T	20_4	23	5	1	500	700	200	0.20	1.40	0	1	1
0014	2T	20_4	24	2	0	200	0	-200	0.00	0.00	0	0	0
0014	2T	20_4	25	3	0	300	0	-300	0.00	0.00	0	0	0
0014	2T	20_5	12	132	38	13200	11290	-1910	0.29	0.86	23	19	-4
0014	2T	20_5	13	73	8	7300	2970	-4330	0.11	0.41	12	5	-7
0014	2T	20_5	14	64	12	6400	6200	-200	0.19	0.97	11	10	-1
0014	2T	20_5	15	22	2	2200	1290	-910	0.09	0.59	3	2	-1
0014	2T	20_5	16	6	0	600	0	-600	0.00	0.00	1	0	-1
0014	2T	20_5	21	10	0	1000	0	-1000	0.00	0.00	1	0	-1
0014	2T	20_5	23	7	0	700	0	-700	0.00	0.00	1	0	-1
0014	2T	20_5	24	4	0	400	0	-400	0.00	0.00	0	0	0
0014	2T	20_5	25	2	0	200	0	-200	0.00	0.00	0	0	0
0014	2T	20_5	26	1	0	100	0	-100	0.00	0.00	0	0	0
0014	2T	20_6	12	29	5	2900	1500	-1400	0.17	0.52	5	2	-3
0014	2T	20_6	13	16	5	1600	2690	1090	0.31	1.68	2	4	2
0014	2T	20_6	14	10	1	1000	470	-530	0.10	0.47	1	0	-1
0014	2T	20_6	15	3	0	300	0	-300	0.00	0.00	0	0	0
0014	2T	20_6	16	4	0	400	0	-400	0.00	0.00	0	0	0
0014	2T	20_6	21	1	0	100	0	-100	0.00	0.00	0	0	0
0014	2T	20_6	23	1	0	100	0	-100	0.00	0.00	0	0	0
0014	2T	20_7	12	171	36	17100	10760	-6340	0.21	0.63	30	19	-11
0014	2T	20_7	13	113	20	11300	10050	-1250	0.18	0.89	20	17	-3
0014	2T	20_7	14	87	12	8700	4850	-3850	0.14	0.56	15	8	-7
0014	2T	20_7	15	37	5	3700	3770	70	0.14	1.02	6	6	0
0014	2T	20_7	16	14	1	1400	480	-920	0.07	0.34	2	0	-2
0014	2T	20_7	21	16	2	1600	1560	-40	0.13	0.98	2	2	0
0014	2T	20_7	23	4	2	400	2580	2180	0.50	6.45	0	4	4
0014	2T	20_7	24	3	0	300	0	-300	0.00	0.00	0	0	0
0014	2T	20_7	25	2	0	200	0	-200	0.00	0.00	0	0	0
0014	2T	20_7	26	2	0	200	0	-200	0.00	0.00	0	0	0
0014	2T	21_1	12	199	41	19900	14100	-5800	0.21	0.71	35	24	-11
0014	2T	21_1	13	106	27	10600	10080	-520	0.25	0.95	18	17	-1
0014	2T	21_1	14	91	15	9100	7950	-1150	0.16	0.87	16	14	-2
0014	2T	21_1	15	31	2	3100	4070	970	0.06	1.31	5	7	2
0014	2T	21_1	16	7	0	700	0	-700	0.00	0.00	1	0	-1
0014	2T	21_1	21	13	1	1300	240	-1060	0.08	0.18	2	0	-2
0014	2T	21_1	23	6	0	600	0	-600	0.00	0.00	1	0	-1
0014	2T	21_1	24	6	0	600	0	-600	0.00	0.00	1	0	-1
0014	2T	21_1	26	2	0	200	0	-200	0.00	0.00	0	0	0
0014	2T	21_2	12	195	47	19500	16090	-3410	0.24	0.83	34	28	-6
0014	2T	21_2	13	139	27	13900	10400	-3500	0.19	0.75	24	18	-6
0014	2T	21_2	14	64	12	6400	5380	-1020	0.19	0.84	11	9	-2
0014	2T	21_2	15	37	3	3700	2370	-1330	0.08	0.64	6	4	-2
0014	2T	21_2	16	15	0	1500	0	-1500	0.00	0.00	2	0	-2
0014	2T	21_2	21	16	0	1600	0	-1600	0.00	0.00	2	0	-2
0014	2T	21_2	23	8	0	800	0	-800	0.00	0.00	1	0	-1
0014	2T	21_2	24	5	0	500	0	-500	0.00	0.00	0	0	0
0014	2T	21_2	25	5	0	500	0	-500	0.00	0.00	0	0	0
0014	2T	21_2	26	1	0	100	0	-100	0.00	0.00	0	0	0
0014	2T	21_3	12	195	46	19500	15100	-4400	0.24	0.77	34	26	-8
0014	2T	21_3	13	128	36	12800	12670	-130	0.28	0.99	22	22	0
0014	2T	21_3	14	75	8	7500	2900	-4600	0.11	0.39	13	5	-8
0014	2T	21_3	15	27	2	2700	610	-2090	0.07	0.23	4	1	-3
0014	2T	21_3	16	7	1	700	820	120	0.14	1.17	1	1	0
0014	2T	21_3	21	17	2	1700	1140	-560	0.12	0.67	3	2	-1
0014	2T	21_3	23	4	1	400	390	-10	0.25	0.98	0	0	0
0014	2T	21_3	24	1	0	100	0	-100	0.00	0.00	0	0	0
0014	2T	21_3	25	2	0	200	0	-200	0.00	0.00	0	0	0
0014	2T	21_3	26	1	0	100	0	-100	0.00	0.00	0	0	0
0014	2T	21_4	12	161	33	16100	12870	-3230	0.20	0.80	28	22	-6
0014	2T	21_4	13	107	28	10700	9300	-1400	0.26	0.87	18	16	-2
0014	2T	21_4	14	73	10	7300	2810	-4490	0.14	0.38	12	4	-8
0014	2T	21_4	15	30	6	3000	3410	410	0.20	1.14	5	6	1
0014	2T	21_4	16	8	0	800	0	-800	0.00	0.00	1	0	-1
0014	2T	21_4	21	14	3	1400	1810	410	0.21	1.29	2	3	1
0014	2T	21_4	23	5	0	500	0	-500	0.00	0.00	0	0	0
0014	2T	21_4	24	3	0	300	0	-300	0.00	0.00	0	0	0
0014	2T	21_4	25	3	0	300	0	-300	0.00	0.00	0	0	0
0014	2T	21_4	26	1	0	100	0	-100	0.00	0.00	0	0	0
0014	2T	21_5	12	152	43	15200	12550	-2650	0.28	0.83	26	22	-4
0014	2T	21_5	13	109	24	10900	10900	0	0.22	1.00	19	19	0
0014	2T	21_5	14	57	8	5700	4020	-1680	0.14	0.71	10	7	-3
0014	2T	21_5	15	21	3	2100	3890	1790	0.14	1.85	3	6	3
0014	2T	21_5	16	6	0	600	0	-600	0.00	0.00	1	0	-1
0014	2T	21_5	21	8	3	800	1010	210	0.38	1.26	1	1	0
0014	2T	21_5	23	6	0	600	0	-600	0.00	0.00	1	0	-1
0014	2T	21_5	24	2	0	200	0	-200	0.00	0.00	0	0	0
0014	2T	21_5	25	1	0	100	0	-100	0.00	0.00	0	0	0
0014	2T	21_6	12	9	2	900	550	-350	0.22	0.61	1	0	-1
0014	2T	21_6	13	10	3	1000	900	-100	0.30	0.90	1	1	0
0014	2T	21_6	14	6	1	600	1070	470	0.17	1.78	1	1	0
0014	2T	21_6	15	3	0	300	0	-300	0.00	0.00	0	0	0
0014	2T	21_6	16	1	0	100	0	-100	0.00	0.00	0	0	0
0014	2T	21_6	21	1	0	100	0	-100	0.00	0.00	0	0	0
0014	2T	21_6	24	1	0	100	0	-100	0.00	0.00	0	0	0
0014	2T	21_6	25	1	1	100	1810	1710	1.00	18.10	0	3	3
0014	2T	21_7	12	218	52	21800	16950	-4850	0.24	0.78	38	30	-8
0014	2T	21_7	13	122	27	12200	11000	-1200	0.22	0.90	21	19	-2
0014	2T	21_7	14	88	12	8800	4740	-4060	0.14	0.54	15	8	-7
0014	2T	21_7	15	25	1	2500	850	-1650	0.04	0.34	4	1	-3
0014	2T	21_7	16	9	1	900	920	20	0.11	1.02	1	1	0
0014	2T	21_7	21	9	2	900	650	-250	0.22	0.72	1	1	0
0014	2T	21_7	23	9	0	900	0	-900	0.00	0.00	1	0	-1
0014	2T	21_7	24	4	0	400	0	-400	0.00	0.00	0	0	0
0014	2T	21_7	25	2	0	200	0	-200	0.00	0.00	0	0	0
0014	2T	21_7	26	1	0	100	0	-100	0.00	0.00	0	0	0
0014	2T	22_1	12	177	38	17700	13890	-3810	0.21	0.78	31	24	-7
0014	2T	22_1	13	107	21	10700	9050	-1650	0.20	0.85	18	16	-2
0014	2T	22_1	14	69	17	6900	8930	2030	0.25	1.29	12	15	3
0014	2T	22_1	15	21	2	2100	630	-1470	0.10	0.30	3	1	-2
0014	2T	22_1	16	12	2	1200	1340	140	0.17	1.12	2	2	0
0014	2T	22_1	21	12	3	1200	1870	670	0.25	1.56	2	3	1
0014	2T	22_1	23	11	0	1100	0	-1100	0.00	0.00	1	0	-1
0014	2T	22_1	24	2	0	200	0	-200	0.00	0.00	0	0	0
0014	2T	22_1	25	6	1	600	370	-230	0.17	0.62	1	0	-1
0014	2T	22_1	26	4	0	400	0	-400	0.00	0.00	0	0	0
0014	2T	22_2	12	161	40	16100	16780	680	0.25	1.04	28	29	1
0014	2T	22_2	13	92	13	9200	5280	-3920	0.14	0.57	16	9	-7
0014	2T	22_2	14	74	11	7400	5500	-1900	0.15	0.74	13	9	-4
0014	2T	22_2	15	21	0	2100	0	-2100	0.00	0.00	3	0	-3
0014	2T	22_2	16	12	0	1200	0	-1200	0.00	0.00	2	0	-2
0014	2T	22_2	21	15	3	1500	1550	50	0.20	1.03	2	2	0
0014	2T	22_2	23	6	1	600	1280	680	0.17	2.13	1	2	1
0014	2T	22_2	24	7	1	700	410	-290	0.14	0.59	1	0	-1
0014	2T	22_2	25	4	0	400	0	-400	0.00	0.00	0	0	0
0014	2T	22_2	26	5	2	500	1160	660	0.40	2.32	0	2	2
0014	2T	22_3	12	142	42	14200	14960	760	0.30	1.05	25	26	1
0014	2T	22_3	13	89	11	8900	4340	-4560	0.12	0.49	15	7	-8
0014	2T	22_3	14	53	9	5300	4750	-550	0.17	0.90	9	8	-1
0014	2T	22_3	15	29	4	2900	3430	530	0.14	1.18	5	6	1
0014	2T	22_3	16	12	1	1200	410	-790	0.08	0.34	2	0	-2
0014	2T	22_3	21	21	4	2100	3640	1540	0.19	1.73	3	6	3
0014	2T	22_3	23	4	0	400	0	-400	0.00	0.00	0	0	0
0014	2T	22_3	24	3	0	300	0	-300	0.00	0.00	0	0	0
0014	2T	22_3	25	6	2	600	990	390	0.33	1.65	1	1	0
0014	2T	22_3	26	3	0	300	0	-300	0.00	0.00	0	0	0
0014	2T	22_4	12	142	29	14200	11390	-2810	0.20	0.80	25	20	-5
0014	2T	22_4	13	102	23	10200	7370	-2830	0.23	0.72	18	13	-5
0014	2T	22_4	14	55	8	5500	3680	-1820	0.15	0.67	9	6	-3
0014	2T	22_4	15	20	4	2000	2300	300	0.20	1.15	3	4	1
0014	2T	22_4	16	11	1	1100	570	-530	0.09	0.52	1	1	0
0014	2T	22_4	21	12	1	1200	210	-990	0.08	0.18	2	0	-2
0014	2T	22_4	23	6	1	600	410	-190	0.17	0.68	1	0	-1
0014	2T	22_4	24	8	1	800	570	-230	0.13	0.71	1	1	0
0014	2T	22_4	25	5	0	500	0	-500	0.00	0.00	0	0	0
0014	2T	22_4	26	7	1	700	500	-200	0.14	0.71	1	0	-1
0014	2T	22_5	12	147	42	14700	11720	-2980	0.29	0.80	26	20	-6
0014	2T	22_5	13	94	26	9400	11140	1740	0.28	1.19	16	19	3
0014	2T	22_5	14	52	9	5200	6320	1120	0.17	1.22	9	11	2
0014	2T	22_5	15	4	0	400	0	-400	0.00	0.00	0	0	0
0014	2T	22_5	16	3	0	300	0	-300	0.00	0.00	0	0	0
0014	2T	22_5	21	9	2	900	2470	1570	0.22	2.74	1	4	3
0014	2T	22_5	23	5	0	500	0	-500	0.00	0.00	0	0	0
0014	2T	22_5	24	5	0	500	0	-500	0.00	0.00	0	0	0
0014	2T	22_5	25	3	0	300	0	-300	0.00	0.00	0	0	0
0014	2T	22_7	12	185	47	18500	16480	-2020	0.25	0.89	32	29	-3
0014	2T	22_7	13	110	12	11000	4090	-6910	0.11	0.37	19	7	-12
0014	2T	22_7	14	64	8	6400	3250	-3150	0.13	0.51	11	5	-6
0014	2T	22_7	15	10	1	1000	750	-250	0.10	0.75	1	1	0
0014	2T	22_7	16	14	1	1400	360	-1040	0.07	0.26	2	0	-2
0014	2T	22_7	21	11	4	1100	1940	840	0.36	1.76	1	3	2
0014	2T	22_7	23	9	0	900	0	-900	0.00	0.00	1	0	-1
0014	2T	22_7	24	5	0	500	0	-500	0.00	0.00	0	0	0
0014	2T	22_7	25	3	0	300	0	-300	0.00	0.00	0	0	0
0014	2T	22_7	26	1	0	100	0	-100	0.00	0.00	0	0	0
0014	2T	23_1	12	183	47	18300	18910	610	0.26	1.03	32	33	1
0014	2T	23_1	13	112	24	11200	9400	-1800	0.21	0.84	19	16	-3
0014	2T	23_1	14	63	6	6300	6450	150	0.10	1.02	11	11	0
0014	2T	23_1	15	17	1	1700	1730	30	0.06	1.02	3	3	0
0014	2T	23_1	16	9	0	900	0	-900	0.00	0.00	1	0	-1
0014	2T	23_1	21	14	2	1400	1400	0	0.14	1.00	2	2	0
0014	2T	23_1	23	5	0	500	0	-500	0.00	0.00	0	0	0
0014	2T	23_1	24	6	1	600	670	70	0.17	1.12	1	1	0
0014	2T	23_1	25	3	0	300	0	-300	0.00	0.00	0	0	0
0014	2T	23_1	26	1	0	100	0	-100	0.00	0.00	0	0	0
0014	2T	23_2	12	196	37	19600	13480	-6120	0.19	0.69	34	23	-11
0014	2T	23_2	13	103	20	10300	9400	-900	0.19	0.91	18	16	-2
0014	2T	23_2	14	60	3	6000	1420	-4580	0.05	0.24	10	2	-8
0014	2T	23_2	15	24	3	2400	1730	-670	0.13	0.72	4	3	-1
0014	2T	23_2	16	11	0	1100	0	-1100	0.00	0.00	1	0	-1
0014	2T	23_2	21	11	1	1100	600	-500	0.09	0.55	1	1	0
0014	2T	23_2	23	9	0	900	0	-900	0.00	0.00	1	0	-1
0014	2T	23_2	24	9	0	900	0	-900	0.00	0.00	1	0	-1
0014	2T	23_2	25	4	0	400	0	-400	0.00	0.00	0	0	0
0014	2T	23_2	26	2	0	200	0	-200	0.00	0.00	0	0	0
0014	2T	23_3	12	167	34	16700	12550	-4150	0.20	0.75	29	22	-7
0014	2T	23_3	13	102	22	10200	9870	-330	0.22	0.97	18	17	-1
0014	2T	23_3	14	64	6	6400	2740	-3660	0.09	0.43	11	4	-7
0014	2T	23_3	15	31	5	3100	6510	3410	0.16	2.10	5	11	6
0014	2T	23_3	16	6	1	600	1670	1070	0.17	2.78	1	2	1
0014	2T	23_3	21	15	7	1500	4700	3200	0.47	3.13	2	8	6
0014	2T	23_3	23	8	1	800	610	-190	0.13	0.76	1	1	0
0014	2T	23_3	24	10	1	1000	440	-560	0.10	0.44	1	0	-1
0014	2T	23_3	25	2	0	200	0	-200	0.00	0.00	0	0	0
0014	2T	23_3	26	3	1	300	950	650	0.33	3.17	0	1	1
0014	2T	23_4	12	196	42	19600	12740	-6860	0.21	0.65	34	22	-12
0014	2T	23_4	13	138	28	13800	8850	-4950	0.20	0.64	24	15	-9
0014	2T	23_4	14	47	7	4700	4610	-90	0.15	0.98	8	8	0
0014	2T	23_4	15	19	2	1900	1170	-730	0.11	0.62	3	2	-1
0014	2T	23_4	16	9	1	900	1310	410	0.11	1.46	1	2	1
0014	2T	23_4	21	8	0	800	0	-800	0.00	0.00	1	0	-1
0014	2T	23_4	23	10	0	1000	0	-1000	0.00	0.00	1	0	-1
0014	2T	23_4	25	2	0	200	0	-200	0.00	0.00	0	0	0
0014	2T	23_5	12	146	41	14600	12960	-1640	0.28	0.89	25	22	-3
0014	2T	23_5	13	74	13	7400	4040	-3360	0.18	0.55	13	7	-6
0014	2T	23_5	14	49	7	4900	3420	-1480	0.14	0.70	8	6	-2
0014	2T	23_5	15	24	3	2400	1600	-800	0.13	0.67	4	2	-2
0014	2T	23_5	16	10	0	1000	0	-1000	0.00	0.00	1	0	-1
0014	2T	23_5	21	6	1	600	420	-180	0.17	0.70	1	0	-1
0014	2T	23_5	23	3	0	300	0	-300	0.00	0.00	0	0	0
0014	2T	23_5	24	1	0	100	0	-100	0.00	0.00	0	0	0
0014	2T	23_5	25	1	0	100	0	-100	0.00	0.00	0	0	0
0014	2T	23_5	26	1	0	100	0	-100	0.00	0.00	0	0	0
0014	2T	23_6	12	15	4	1500	1240	-260	0.27	0.83	2	2	0
0014	2T	23_6	13	10	0	1000	0	-1000	0.00	0.00	1	0	-1
0014	2T	23_6	14	8	1	800	350	-450	0.13	0.44	1	0	-1
0014	2T	23_6	15	1	0	100	0	-100	0.00	0.00	0	0	0
0014	2T	23_7	12	198	45	19800	14400	-5400	0.23	0.73	35	25	-10
0014	2T	23_7	13	121	27	12100	11150	-950	0.22	0.92	21	19	-2
0014	2T	23_7	14	84	8	8400	8200	-200	0.10	0.98	14	14	0
0014	2T	23_7	15	29	6	2900	5560	2660	0.21	1.92	5	9	4
0014	2T	23_7	16	7	0	700	0	-700	0.00	0.00	1	0	-1
0014	2T	23_7	21	10	3	1000	2200	1200	0.30	2.20	1	3	2
0014	2T	23_7	23	2	1	200	4410	4210	0.50	22.05	0	7	7
0014	2T	23_7	24	3	0	300	0	-300	0.00	0.00	0	0	0
0014	2T	23_7	25	1	0	100	0	-100	0.00	0.00	0	0	0
0014	2T	23_7	26	2	0	200	0	-200	0.00	0.00	0	0	0
0014	2T	24_1	12	223	44	22300	13590	-8710	0.20	0.61	39	24	-15
0014	2T	24_1	13	153	36	15300	16190	890	0.24	1.06	27	28	1
0014	2T	24_1	14	70	9	7000	4680	-2320	0.13	0.67	12	8	-4
0014	2T	24_1	15	24	6	2400	5070	2670	0.25	2.11	4	8	4
0014	2T	24_1	16	15	2	1500	460	-1040	0.13	0.31	2	0	-2
0014	2T	24_1	21	17	4	1700	1490	-210	0.24	0.88	3	2	-1
0014	2T	24_1	23	12	2	1200	2400	1200	0.17	2.00	2	4	2
0014	2T	24_1	24	2	1	200	1870	1670	0.50	9.35	0	3	3
0014	2T	24_1	25	4	0	400	0	-400	0.00	0.00	0	0	0
0014	2T	24_1	26	1	0	100	0	-100	0.00	0.00	0	0	0
0014	2T	24_2	12	203	64	20300	20730	430	0.32	1.02	35	36	1
0014	2T	24_2	13	151	37	15100	13040	-2060	0.25	0.86	26	23	-3
0014	2T	24_2	14	67	15	6700	6310	-390	0.22	0.94	11	11	0
0014	2T	24_2	15	23	1	2300	280	-2020	0.04	0.12	4	0	-4
0014	2T	24_2	16	23	2	2300	1590	-710	0.09	0.69	4	2	-2
0014	2T	24_2	21	14	3	1400	1100	-300	0.21	0.79	2	1	-1
0014	2T	24_2	23	7	2	700	2110	1410	0.29	3.01	1	3	2
0014	2T	24_2	24	9	3	900	850	-50	0.33	0.94	1	1	0
0014	2T	24_2	25	1	0	100	0	-100	0.00	0.00	0	0	0
0014	2T	24_2	26	4	0	400	0	-400	0.00	0.00	0	0	0
0014	2T	24_3	12	219	62	21900	21600	-300	0.28	0.99	38	38	0
0014	2T	24_3	13	163	28	16300	8450	-7850	0.17	0.52	28	14	-14
0014	2T	24_3	14	90	18	9000	7830	-1170	0.20	0.87	15	13	-2
0014	2T	24_3	15	22	0	2200	0	-2200	0.00	0.00	3	0	-3
0014	2T	24_3	16	8	1	800	1730	930	0.13	2.16	1	3	2
0014	2T	24_3	21	9	1	900	530	-370	0.11	0.59	1	0	-1
0014	2T	24_3	23	5	0	500	0	-500	0.00	0.00	0	0	0
0014	2T	24_3	24	5	1	500	350	-150	0.20	0.70	0	0	0
0014	2T	24_3	25	2	0	200	0	-200	0.00	0.00	0	0	0
0014	2T	24_3	26	1	1	100	1180	1080	1.00	11.80	0	2	2
0014	2T	24_4	12	149	39	14900	11560	-3340	0.26	0.78	26	20	-6
0014	2T	24_4	13	106	31	10600	10790	190	0.29	1.02	18	19	1
0014	2T	24_4	14	68	13	6800	5140	-1660	0.19	0.76	12	9	-3
0014	2T	24_4	15	29	6	2900	6510	3610	0.21	2.24	5	11	6
0014	2T	24_4	16	6	0	600	0	-600	0.00	0.00	1	0	-1
0014	2T	24_4	21	6	2	600	920	320	0.33	1.53	1	1	0
0014	2T	24_4	23	4	0	400	0	-400	0.00	0.00	0	0	0
0014	2T	24_4	24	5	1	500	560	60	0.20	1.12	0	0	0
0014	2T	24_5	12	82	33	8200	8780	580	0.40	1.07	14	15	1
0014	2T	24_5	13	67	11	6700	4230	-2470	0.16	0.63	11	7	-4
0014	2T	24_5	14	32	7	3200	2880	-320	0.22	0.90	5	5	0
0014	2T	24_5	15	11	3	1100	1920	820	0.27	1.75	1	3	2
0014	2T	24_5	16	2	1	200	420	220	0.50	2.10	0	0	0
0014	2T	24_5	21	1	1	100	1220	1120	1.00	12.20	0	2	2
0014	2T	24_5	23	4	0	400	0	-400	0.00	0.00	0	0	0
0014	2T	24_5	24	1	0	100	0	-100	0.00	0.00	0	0	0
0014	2T	24_5	25	2	0	200	0	-200	0.00	0.00	0	0	0
0014	2T	24_5	26	1	0	100	0	-100	0.00	0.00	0	0	0
0014	2T	24_6	12	27	13	2700	5000	2300	0.48	1.85	4	8	4
0014	2T	24_6	13	15	4	1500	920	-580	0.27	0.61	2	1	-1
0014	2T	24_6	14	6	1	600	210	-390	0.17	0.35	1	0	-1
0014	2T	24_6	15	3	1	300	490	190	0.33	1.63	0	0	0
0014	2T	24_6	16	1	0	100	0	-100	0.00	0.00	0	0	0
0014	2T	24_7	12	243	70	24300	19570	-4730	0.29	0.81	43	34	-9
0014	2T	24_7	13	135	30	13500	9310	-4190	0.22	0.69	23	16	-7
0014	2T	24_7	14	83	14	8300	7120	-1180	0.17	0.86	14	12	-2
0014	2T	24_7	15	31	7	3100	4820	1720	0.23	1.55	5	8	3
0014	2T	24_7	16	15	3	1500	980	-520	0.20	0.65	2	1	-1
0014	2T	24_7	21	10	0	1000	0	-1000	0.00	0.00	1	0	-1
0014	2T	24_7	23	6	0	600	0	-600	0.00	0.00	1	0	-1
0014	2T	24_7	24	3	0	300	0	-300	0.00	0.00	0	0	0
0014	2T	24_7	26	4	0	400	0	-400	0.00	0.00	0	0	0
0014	3F	01_1	123	87	16	8700	5610	-3090	0.18	0.64	15	9	-6
0014	3F	01_1	124	67	16	6700	8790	2090	0.24	1.31	11	15	4
0014	3F	01_1	125	48	9	4800	4250	-550	0.19	0.89	8	7	-1
0014	3F	01_1	126	25	1	2500	690	-1810	0.04	0.28	4	1	-3
0014	3F	01_1	134	41	10	4100	4620	520	0.24	1.13	7	8	1
0014	3F	01_1	135	16	1	1600	910	-690	0.06	0.57	2	1	-1
0014	3F	01_1	136	9	1	900	180	-720	0.11	0.20	1	0	-1
0014	3F	01_1	145	16	2	1600	1070	-530	0.13	0.67	2	1	-1
0014	3F	01_1	146	6	0	600	0	-600	0.00	0.00	1	0	-1
0014	3F	01_1	156	11	0	1100	0	-1100	0.00	0.00	1	0	-1
0014	3F	01_1	234	3	0	300	0	-300	0.00	0.00	0	0	0
0014	3F	01_1	235	4	0	400	0	-400	0.00	0.00	0	0	0
0014	3F	01_1	236	2	0	200	0	-200	0.00	0.00	0	0	0
0014	3F	01_1	246	2	0	200	0	-200	0.00	0.00	0	0	0
0014	3F	01_2	123	74	11	7400	4310	-3090	0.15	0.58	13	7	-6
0014	3F	01_2	124	58	9	5800	3060	-2740	0.16	0.53	10	5	-5
0014	3F	01_2	125	66	10	6600	4320	-2280	0.15	0.65	11	7	-4
0014	3F	01_2	126	34	5	3400	2430	-970	0.15	0.71	6	4	-2
0014	3F	01_2	134	37	5	3700	1320	-2380	0.14	0.36	6	2	-4
0014	3F	01_2	135	24	2	2400	1120	-1280	0.08	0.47	4	1	-3
0014	3F	01_2	136	11	1	1100	1220	120	0.09	1.11	1	2	1
0014	3F	01_2	145	17	4	1700	2140	440	0.24	1.26	3	3	0
0014	3F	01_2	146	5	0	500	0	-500	0.00	0.00	0	0	0
0014	3F	01_2	156	6	0	600	0	-600	0.00	0.00	1	0	-1
0014	3F	01_2	234	4	0	400	0	-400	0.00	0.00	0	0	0
0014	3F	01_2	235	2	0	200	0	-200	0.00	0.00	0	0	0
0014	3F	01_2	236	2	0	200	0	-200	0.00	0.00	0	0	0
0014	3F	01_2	245	1	0	100	0	-100	0.00	0.00	0	0	0
0014	3F	01_2	256	1	0	100	0	-100	0.00	0.00	0	0	0
0014	3F	01_3	123	72	18	7200	7030	-170	0.25	0.98	12	12	0
0014	3F	01_3	124	56	6	5600	2820	-2780	0.11	0.50	9	4	-5
0014	3F	01_3	125	47	6	4700	2920	-1780	0.13	0.62	8	5	-3
0014	3F	01_3	126	26	3	2600	1310	-1290	0.12	0.50	4	2	-2
0014	3F	01_3	134	31	8	3100	4010	910	0.26	1.29	5	7	2
0014	3F	01_3	135	26	4	2600	2670	70	0.15	1.03	4	4	0
0014	3F	01_3	136	24	3	2400	2970	570	0.13	1.24	4	5	1
0014	3F	01_3	145	12	1	1200	1370	170	0.08	1.14	2	2	0
0014	3F	01_3	146	9	0	900	0	-900	0.00	0.00	1	0	-1
0014	3F	01_3	156	6	1	600	1100	500	0.17	1.83	1	1	0
0014	3F	01_3	234	6	0	600	0	-600	0.00	0.00	1	0	-1
0014	3F	01_3	235	3	0	300	0	-300	0.00	0.00	0	0	0
0014	3F	01_3	245	2	0	200	0	-200	0.00	0.00	0	0	0
0014	3F	01_3	246	1	0	100	0	-100	0.00	0.00	0	0	0
0014	3F	01_3	256	2	0	200	0	-200	0.00	0.00	0	0	0
0014	3F	01_4	123	63	12	6300	4060	-2240	0.19	0.64	11	7	-4
0014	3F	01_4	124	65	6	6500	2860	-3640	0.09	0.44	11	5	-6
0014	3F	01_4	125	40	5	4000	2420	-1580	0.13	0.61	7	4	-3
0014	3F	01_4	126	24	1	2400	1240	-1160	0.04	0.52	4	2	-2
0014	3F	01_4	134	37	4	3700	2380	-1320	0.11	0.64	6	4	-2
0014	3F	01_4	135	27	5	2700	3880	1180	0.19	1.44	4	6	2
0014	3F	01_4	136	19	4	1900	2620	720	0.21	1.38	3	4	1
0014	3F	01_4	145	11	0	1100	0	-1100	0.00	0.00	1	0	-1
0014	3F	01_4	146	8	0	800	0	-800	0.00	0.00	1	0	-1
0014	3F	01_4	156	13	1	1300	360	-940	0.08	0.28	2	0	-2
0014	3F	01_4	234	9	2	900	710	-190	0.22	0.79	1	1	0
0014	3F	01_4	235	2	0	200	0	-200	0.00	0.00	0	0	0
0014	3F	01_4	236	2	1	200	1950	1750	0.50	9.75	0	3	3
0014	3F	01_4	245	1	0	100	0	-100	0.00	0.00	0	0	0
0014	3F	01_4	246	3	0	300	0	-300	0.00	0.00	0	0	0
0014	3F	01_4	256	3	1	300	390	90	0.33	1.30	0	0	0
0014	3F	01_5	123	39	11	3900	3610	-290	0.28	0.93	6	6	0
0014	3F	01_5	124	46	7	4600	2770	-1830	0.15	0.60	8	4	-4
0014	3F	01_5	125	26	4	2600	1600	-1000	0.15	0.62	4	2	-2
0014	3F	01_5	126	15	0	1500	0	-1500	0.00	0.00	2	0	-2
0014	3F	01_5	134	31	2	3100	860	-2240	0.06	0.28	5	1	-4
0014	3F	01_5	135	19	2	1900	2050	150	0.11	1.08	3	3	0
0014	3F	01_5	136	5	1	500	510	10	0.20	1.02	0	0	0
0014	3F	01_5	145	6	0	600	0	-600	0.00	0.00	1	0	-1
0014	3F	01_5	146	8	1	800	1440	640	0.13	1.80	1	2	1
0014	3F	01_5	234	3	0	300	0	-300	0.00	0.00	0	0	0
0014	3F	01_5	236	2	0	200	0	-200	0.00	0.00	0	0	0
0014	3F	01_6	123	7	0	700	0	-700	0.00	0.00	1	0	-1
0014	3F	01_6	124	8	0	800	0	-800	0.00	0.00	1	0	-1
0014	3F	01_6	125	3	0	300	0	-300	0.00	0.00	0	0	0
0014	3F	01_6	126	1	0	100	0	-100	0.00	0.00	0	0	0
0014	3F	01_6	134	3	0	300	0	-300	0.00	0.00	0	0	0
0014	3F	01_6	135	2	1	200	200	0	0.50	1.00	0	0	0
0014	3F	01_6	146	1	0	100	0	-100	0.00	0.00	0	0	0
0014	3F	01_6	234	1	0	100	0	-100	0.00	0.00	0	0	0
0014	3F	01_7	123	85	15	8500	5060	-3440	0.18	0.60	15	8	-7
0014	3F	01_7	124	64	4	6400	3030	-3370	0.06	0.47	11	5	-6
0014	3F	01_7	125	47	4	4700	1470	-3230	0.09	0.31	8	2	-6
0014	3F	01_7	126	35	1	3500	1150	-2350	0.03	0.33	6	2	-4
0014	3F	01_7	134	42	7	4200	3170	-1030	0.17	0.75	7	5	-2
0014	3F	01_7	135	26	2	2600	810	-1790	0.08	0.31	4	1	-3
0014	3F	01_7	136	15	2	1500	1610	110	0.13	1.07	2	2	0
0014	3F	01_7	145	12	0	1200	0	-1200	0.00	0.00	2	0	-2
0014	3F	01_7	146	12	0	1200	0	-1200	0.00	0.00	2	0	-2
0014	3F	01_7	156	13	1	1300	2110	810	0.08	1.62	2	3	1
0014	3F	01_7	234	4	0	400	0	-400	0.00	0.00	0	0	0
0014	3F	01_7	235	1	0	100	0	-100	0.00	0.00	0	0	0
0014	3F	01_7	236	6	0	600	0	-600	0.00	0.00	1	0	-1
0014	3F	01_7	245	1	0	100	0	-100	0.00	0.00	0	0	0
0014	3F	01_7	246	1	0	100	0	-100	0.00	0.00	0	0	0
0014	3F	01_7	256	2	0	200	0	-200	0.00	0.00	0	0	0
0014	3F	02_1	123	82	12	8200	7300	-900	0.15	0.89	14	12	-2
0014	3F	02_1	124	71	8	7100	4820	-2280	0.11	0.68	12	8	-4
0014	3F	02_1	125	43	5	4300	3270	-1030	0.12	0.76	7	5	-2
0014	3F	02_1	126	47	4	4700	6860	2160	0.09	1.46	8	12	4
0014	3F	02_1	134	40	5	4000	2850	-1150	0.13	0.71	7	5	-2
0014	3F	02_1	135	25	1	2500	1060	-1440	0.04	0.42	4	1	-3
0014	3F	02_1	136	15	2	1500	1900	400	0.13	1.27	2	3	1
0014	3F	02_1	145	15	0	1500	0	-1500	0.00	0.00	2	0	-2
0014	3F	02_1	146	14	1	1400	2280	880	0.07	1.63	2	4	2
0014	3F	02_1	156	8	1	800	1670	870	0.13	2.09	1	2	1
0014	3F	02_1	234	4	1	400	600	200	0.25	1.50	0	1	1
0014	3F	02_1	235	5	0	500	0	-500	0.00	0.00	0	0	0
0014	3F	02_1	236	2	0	200	0	-200	0.00	0.00	0	0	0
0014	3F	02_1	245	5	0	500	0	-500	0.00	0.00	0	0	0
0014	3F	02_1	246	1	1	100	2860	2760	1.00	28.60	0	5	5
0014	3F	02_1	256	2	0	200	0	-200	0.00	0.00	0	0	0
0014	3F	02_2	123	82	10	8200	4960	-3240	0.12	0.60	14	8	-6
0014	3F	02_2	124	71	7	7100	4000	-3100	0.10	0.56	12	7	-5
0014	3F	02_2	125	48	1	4800	300	-4500	0.02	0.06	8	0	-8
0014	3F	02_2	126	35	0	3500	0	-3500	0.00	0.00	6	0	-6
0014	3F	02_2	134	28	5	2800	2160	-640	0.18	0.77	4	3	-1
0014	3F	02_2	135	22	1	2200	340	-1860	0.05	0.15	3	0	-3
0014	3F	02_2	136	27	1	2700	530	-2170	0.04	0.20	4	0	-4
0014	3F	02_2	145	22	2	2200	1940	-260	0.09	0.88	3	3	0
0014	3F	02_2	146	15	2	1500	1430	-70	0.13	0.95	2	2	0
0014	3F	02_2	156	4	0	400	0	-400	0.00	0.00	0	0	0
0014	3F	02_2	234	7	1	700	820	120	0.14	1.17	1	1	0
0014	3F	02_2	235	4	0	400	0	-400	0.00	0.00	0	0	0
0014	3F	02_2	236	3	1	300	950	650	0.33	3.17	0	1	1
0014	3F	02_2	245	6	0	600	0	-600	0.00	0.00	1	0	-1
0014	3F	02_2	246	4	0	400	0	-400	0.00	0.00	0	0	0
0014	3F	02_2	256	2	0	200	0	-200	0.00	0.00	0	0	0
0014	3F	02_3	123	86	9	8600	3510	-5090	0.10	0.41	15	6	-9
0014	3F	02_3	124	82	12	8200	8330	130	0.15	1.02	14	14	0
0014	3F	02_3	125	31	2	3100	4450	1350	0.06	1.44	5	7	2
0014	3F	02_3	126	30	1	3000	1470	-1530	0.03	0.49	5	2	-3
0014	3F	02_3	134	36	5	3600	2470	-1130	0.14	0.69	6	4	-2
0014	3F	02_3	135	24	5	2400	5650	3250	0.21	2.35	4	10	6
0014	3F	02_3	136	24	4	2400	3300	900	0.17	1.38	4	5	1
0014	3F	02_3	145	24	4	2400	2270	-130	0.17	0.95	4	4	0
0014	3F	02_3	146	12	0	1200	0	-1200	0.00	0.00	2	0	-2
0014	3F	02_3	156	8	0	800	0	-800	0.00	0.00	1	0	-1
0014	3F	02_3	234	10	2	1000	2430	1430	0.20	2.43	1	4	3
0014	3F	02_3	235	2	0	200	0	-200	0.00	0.00	0	0	0
0014	3F	02_3	236	4	0	400	0	-400	0.00	0.00	0	0	0
0014	3F	02_3	245	4	0	400	0	-400	0.00	0.00	0	0	0
0014	3F	02_3	246	3	0	300	0	-300	0.00	0.00	0	0	0
0014	3F	02_3	256	3	0	300	0	-300	0.00	0.00	0	0	0
0014	3F	02_4	123	55	10	5500	5460	-40	0.18	0.99	9	9	0
0014	3F	02_4	124	49	4	4900	1630	-3270	0.08	0.33	8	2	-6
0014	3F	02_4	125	30	5	3000	3020	20	0.17	1.01	5	5	0
0014	3F	02_4	126	13	0	1300	0	-1300	0.00	0.00	2	0	-2
0014	3F	02_4	134	39	3	3900	1510	-2390	0.08	0.39	6	2	-4
0014	3F	02_4	135	23	3	2300	3920	1620	0.13	1.70	4	6	2
0014	3F	02_4	136	10	2	1000	1360	360	0.20	1.36	1	2	1
0014	3F	02_4	145	9	0	900	0	-900	0.00	0.00	1	0	-1
0014	3F	02_4	146	6	1	600	1740	1140	0.17	2.90	1	3	2
0014	3F	02_4	156	3	0	300	0	-300	0.00	0.00	0	0	0
0014	3F	02_4	234	8	1	800	460	-340	0.13	0.58	1	0	-1
0014	3F	02_4	235	4	0	400	0	-400	0.00	0.00	0	0	0
0014	3F	02_4	236	2	0	200	0	-200	0.00	0.00	0	0	0
0014	3F	02_4	245	4	1	400	420	20	0.25	1.05	0	0	0
0014	3F	02_4	246	1	0	100	0	-100	0.00	0.00	0	0	0
0014	3F	02_5	123	36	8	3600	3470	-130	0.22	0.96	6	6	0
0014	3F	02_5	124	21	2	2100	920	-1180	0.10	0.44	3	1	-2
0014	3F	02_5	125	14	3	1400	2000	600	0.21	1.43	2	3	1
0014	3F	02_5	126	9	0	900	0	-900	0.00	0.00	1	0	-1
0014	3F	02_5	134	11	4	1100	1070	-30	0.36	0.97	1	1	0
0014	3F	02_5	135	10	2	1000	1910	910	0.20	1.91	1	3	2
0014	3F	02_5	136	7	0	700	0	-700	0.00	0.00	1	0	-1
0014	3F	02_5	145	8	2	800	2150	1350	0.25	2.69	1	3	2
0014	3F	02_5	146	4	0	400	0	-400	0.00	0.00	0	0	0
0014	3F	02_5	156	2	0	200	0	-200	0.00	0.00	0	0	0
0014	3F	02_5	234	2	0	200	0	-200	0.00	0.00	0	0	0
0014	3F	02_5	235	1	0	100	0	-100	0.00	0.00	0	0	0
0014	3F	02_5	236	1	0	100	0	-100	0.00	0.00	0	0	0
0014	3F	02_6	123	2	1	200	480	280	0.50	2.40	0	0	0
0014	3F	02_6	124	1	0	100	0	-100	0.00	0.00	0	0	0
0014	3F	02_6	125	2	0	200	0	-200	0.00	0.00	0	0	0
0014	3F	02_6	126	1	0	100	0	-100	0.00	0.00	0	0	0
0014	3F	02_6	134	1	0	100	0	-100	0.00	0.00	0	0	0
0014	3F	02_7	123	80	20	8000	11140	3140	0.25	1.39	14	19	5
0014	3F	02_7	124	78	12	7800	6610	-1190	0.15	0.85	13	11	-2
0014	3F	02_7	125	46	5	4600	4160	-440	0.11	0.90	8	7	-1
0014	3F	02_7	126	32	1	3200	1130	-2070	0.03	0.35	5	2	-3
0014	3F	02_7	134	45	3	4500	1520	-2980	0.07	0.34	7	2	-5
0014	3F	02_7	135	26	2	2600	1580	-1020	0.08	0.61	4	2	-2
0014	3F	02_7	136	23	2	2300	2160	-140	0.09	0.94	4	3	-1
0014	3F	02_7	145	21	3	2100	5340	3240	0.14	2.54	3	9	6
0014	3F	02_7	146	6	1	600	340	-260	0.17	0.57	1	0	-1
0014	3F	02_7	156	7	0	700	0	-700	0.00	0.00	1	0	-1
0014	3F	02_7	234	9	0	900	0	-900	0.00	0.00	1	0	-1
0014	3F	02_7	235	4	0	400	0	-400	0.00	0.00	0	0	0
0014	3F	02_7	236	9	0	900	0	-900	0.00	0.00	1	0	-1
0014	3F	02_7	245	1	0	100	0	-100	0.00	0.00	0	0	0
0014	3F	02_7	246	2	0	200	0	-200	0.00	0.00	0	0	0
0014	3F	02_7	256	1	0	100	0	-100	0.00	0.00	0	0	0
0014	3F	03_1	123	45	14	4500	6060	1560	0.31	1.35	7	10	3
0014	3F	03_1	124	38	7	3800	2390	-1410	0.18	0.63	6	4	-2
0014	3F	03_1	125	29	1	2900	550	-2350	0.03	0.19	5	0	-5
0014	3F	03_1	126	15	1	1500	380	-1120	0.07	0.25	2	0	-2
0014	3F	03_1	134	43	6	4300	2920	-1380	0.14	0.68	7	5	-2
0014	3F	03_1	135	20	3	2000	3680	1680	0.15	1.84	3	6	3
0014	3F	03_1	136	12	1	1200	1040	-160	0.08	0.87	2	1	-1
0014	3F	03_1	145	15	1	1500	350	-1150	0.07	0.23	2	0	-2
0014	3F	03_1	146	11	2	1100	1210	110	0.18	1.10	1	2	1
0014	3F	03_1	156	3	1	300	980	680	0.33	3.27	0	1	1
0014	3F	03_1	234	2	0	200	0	-200	0.00	0.00	0	0	0
0014	3F	03_1	235	3	0	300	0	-300	0.00	0.00	0	0	0
0014	3F	03_1	236	1	0	100	0	-100	0.00	0.00	0	0	0
0014	3F	03_1	245	3	2	300	950	650	0.67	3.17	0	1	1
0014	3F	03_1	246	4	0	400	0	-400	0.00	0.00	0	0	0
0014	3F	03_1	256	1	0	100	0	-100	0.00	0.00	0	0	0
0014	3F	03_2	123	53	13	5300	5160	-140	0.25	0.97	9	9	0
0014	3F	03_2	124	35	6	3500	2820	-680	0.17	0.81	6	4	-2
0014	3F	03_2	125	28	4	2800	1070	-1730	0.14	0.38	4	1	-3
0014	3F	03_2	126	25	0	2500	0	-2500	0.00	0.00	4	0	-4
0014	3F	03_2	134	20	2	2000	3800	1800	0.10	1.90	3	6	3
0014	3F	03_2	135	13	1	1300	230	-1070	0.08	0.18	2	0	-2
0014	3F	03_2	136	9	1	900	470	-430	0.11	0.52	1	0	-1
0014	3F	03_2	145	12	3	1200	1380	180	0.25	1.15	2	2	0
0014	3F	03_2	146	12	1	1200	810	-390	0.08	0.68	2	1	-1
0014	3F	03_2	156	4	0	400	0	-400	0.00	0.00	0	0	0
0014	3F	03_2	234	2	0	200	0	-200	0.00	0.00	0	0	0
0014	3F	03_2	235	2	0	200	0	-200	0.00	0.00	0	0	0
0014	3F	03_2	236	8	0	800	0	-800	0.00	0.00	1	0	-1
0014	3F	03_2	245	2	0	200	0	-200	0.00	0.00	0	0	0
0014	3F	03_2	246	4	0	400	0	-400	0.00	0.00	0	0	0
0014	3F	03_2	256	1	0	100	0	-100	0.00	0.00	0	0	0
0014	3F	03_3	123	68	23	6800	8790	1990	0.34	1.29	12	15	3
0014	3F	03_3	124	45	7	4500	3160	-1340	0.16	0.70	7	5	-2
0014	3F	03_3	125	37	8	3700	3210	-490	0.22	0.87	6	5	-1
0014	3F	03_3	126	26	4	2600	1900	-700	0.15	0.73	4	3	-1
0014	3F	03_3	134	23	6	2300	2900	600	0.26	1.26	4	5	1
0014	3F	03_3	135	26	1	2600	840	-1760	0.04	0.32	4	1	-3
0014	3F	03_3	136	16	3	1600	1290	-310	0.19	0.81	2	2	0
0014	3F	03_3	145	18	3	1800	2530	730	0.17	1.41	3	4	1
0014	3F	03_3	146	11	1	1100	1590	490	0.09	1.45	1	2	1
0014	3F	03_3	156	5	0	500	0	-500	0.00	0.00	0	0	0
0014	3F	03_3	234	3	0	300	0	-300	0.00	0.00	0	0	0
0014	3F	03_3	235	4	0	400	0	-400	0.00	0.00	0	0	0
0014	3F	03_3	236	2	0	200	0	-200	0.00	0.00	0	0	0
0014	3F	03_3	246	2	0	200	0	-200	0.00	0.00	0	0	0
0014	3F	03_4	123	40	7	4000	5230	1230	0.18	1.31	7	9	2
0014	3F	03_4	124	23	6	2300	2770	470	0.26	1.20	4	4	0
0014	3F	03_4	125	25	4	2500	2100	-400	0.16	0.84	4	3	-1
0014	3F	03_4	126	13	1	1300	530	-770	0.08	0.41	2	0	-2
0014	3F	03_4	134	19	2	1900	1070	-830	0.11	0.56	3	1	-2
0014	3F	03_4	135	16	2	1600	1200	-400	0.13	0.75	2	2	0
0014	3F	03_4	136	13	3	1300	4050	2750	0.23	3.12	2	7	5
0014	3F	03_4	145	9	0	900	0	-900	0.00	0.00	1	0	-1
0014	3F	03_4	146	3	1	300	690	390	0.33	2.30	0	1	1
0014	3F	03_4	156	3	0	300	0	-300	0.00	0.00	0	0	0
0014	3F	03_4	234	1	0	100	0	-100	0.00	0.00	0	0	0
0014	3F	03_4	235	2	0	200	0	-200	0.00	0.00	0	0	0
0014	3F	03_4	236	1	0	100	0	-100	0.00	0.00	0	0	0
0014	3F	03_4	245	2	1	200	1130	930	0.50	5.65	0	2	2
0014	3F	03_5	123	24	7	2400	2270	-130	0.29	0.95	4	4	0
0014	3F	03_5	124	19	4	1900	2530	630	0.21	1.33	3	4	1
0014	3F	03_5	125	11	1	1100	380	-720	0.09	0.35	1	0	-1
0014	3F	03_5	126	9	4	900	3560	2660	0.44	3.96	1	6	5
0014	3F	03_5	134	6	0	600	0	-600	0.00	0.00	1	0	-1
0014	3F	03_5	135	12	0	1200	0	-1200	0.00	0.00	2	0	-2
0014	3F	03_5	136	12	0	1200	0	-1200	0.00	0.00	2	0	-2
0014	3F	03_5	145	3	0	300	0	-300	0.00	0.00	0	0	0
0014	3F	03_5	146	1	1	100	680	580	1.00	6.80	0	1	1
0014	3F	03_5	156	3	1	300	670	370	0.33	2.23	0	1	1
0014	3F	03_5	234	2	0	200	0	-200	0.00	0.00	0	0	0
0014	3F	03_7	123	65	15	6500	6260	-240	0.23	0.96	11	11	0
0014	3F	03_7	124	51	13	5100	7300	2200	0.25	1.43	9	12	3
0014	3F	03_7	125	30	7	3000	4130	1130	0.23	1.38	5	7	2
0014	3F	03_7	126	20	2	2000	3410	1410	0.10	1.71	3	6	3
0014	3F	03_7	134	21	4	2100	2390	290	0.19	1.14	3	4	1
0014	3F	03_7	135	27	9	2700	10980	8280	0.33	4.07	4	19	15
0014	3F	03_7	136	17	1	1700	560	-1140	0.06	0.33	3	0	-3
0014	3F	03_7	145	9	1	900	480	-420	0.11	0.53	1	0	-1
0014	3F	03_7	146	11	0	1100	0	-1100	0.00	0.00	1	0	-1
0014	3F	03_7	156	3	0	300	0	-300	0.00	0.00	0	0	0
0014	3F	03_7	234	7	0	700	0	-700	0.00	0.00	1	0	-1
0014	3F	03_7	235	7	0	700	0	-700	0.00	0.00	1	0	-1
0014	3F	03_7	236	3	0	300	0	-300	0.00	0.00	0	0	0
0014	3F	03_7	245	3	0	300	0	-300	0.00	0.00	0	0	0
0014	3F	03_7	246	2	0	200	0	-200	0.00	0.00	0	0	0
0014	3F	03_7	256	4	1	400	550	150	0.25	1.38	0	0	0
0014	3F	04_1	123	60	12	6000	7040	1040	0.20	1.17	10	12	2
0014	3F	04_1	124	50	10	5000	5420	420	0.20	1.08	8	9	1
0014	3F	04_1	125	32	4	3200	2980	-220	0.13	0.93	5	5	0
0014	3F	04_1	126	36	6	3600	3030	-570	0.17	0.84	6	5	-1
0014	3F	04_1	134	33	3	3300	1900	-1400	0.09	0.58	5	3	-2
0014	3F	04_1	135	15	0	1500	0	-1500	0.00	0.00	2	0	-2
0014	3F	04_1	136	20	2	2000	1740	-260	0.10	0.87	3	3	0
0014	3F	04_1	145	20	4	2000	3380	1380	0.20	1.69	3	5	2
0014	3F	04_1	146	17	0	1700	0	-1700	0.00	0.00	3	0	-3
0014	3F	04_1	156	11	0	1100	0	-1100	0.00	0.00	1	0	-1
0014	3F	04_1	234	2	0	200	0	-200	0.00	0.00	0	0	0
0014	3F	04_1	235	3	0	300	0	-300	0.00	0.00	0	0	0
0014	3F	04_1	236	3	0	300	0	-300	0.00	0.00	0	0	0
0014	3F	04_1	245	1	0	100	0	-100	0.00	0.00	0	0	0
0014	3F	04_1	246	1	0	100	0	-100	0.00	0.00	0	0	0
0014	3F	04_2	123	69	14	6900	5480	-1420	0.20	0.79	12	9	-3
0014	3F	04_2	124	42	4	4200	1350	-2850	0.10	0.32	7	2	-5
0014	3F	04_2	125	35	6	3500	4550	1050	0.17	1.30	6	8	2
0014	3F	04_2	126	29	1	2900	450	-2450	0.03	0.16	5	0	-5
0014	3F	04_2	134	25	4	2500	1770	-730	0.16	0.71	4	3	-1
0014	3F	04_2	135	24	0	2400	0	-2400	0.00	0.00	4	0	-4
0014	3F	04_2	136	15	1	1500	960	-540	0.07	0.64	2	1	-1
0014	3F	04_2	145	19	1	1900	400	-1500	0.05	0.21	3	0	-3
0014	3F	04_2	146	12	2	1200	1650	450	0.17	1.38	2	2	0
0014	3F	04_2	156	13	2	1300	1360	60	0.15	1.05	2	2	0
0014	3F	04_2	235	4	2	400	1370	970	0.50	3.43	0	2	2
0014	3F	04_2	256	1	0	100	0	-100	0.00	0.00	0	0	0
0014	3F	04_3	123	59	14	5900	7110	1210	0.24	1.21	10	12	2
0014	3F	04_3	124	46	5	4600	3390	-1210	0.11	0.74	8	6	-2
0014	3F	04_3	125	44	7	4400	3580	-820	0.16	0.81	7	6	-1
0014	3F	04_3	126	27	6	2700	3420	720	0.22	1.27	4	6	2
0014	3F	04_3	134	30	3	3000	1870	-1130	0.10	0.62	5	3	-2
0014	3F	04_3	135	20	1	2000	490	-1510	0.05	0.25	3	0	-3
0014	3F	04_3	136	20	3	2000	2400	400	0.15	1.20	3	4	1
0014	3F	04_3	145	17	0	1700	0	-1700	0.00	0.00	3	0	-3
0014	3F	04_3	146	14	4	1400	4560	3160	0.29	3.26	2	8	6
0014	3F	04_3	156	11	0	1100	0	-1100	0.00	0.00	1	0	-1
0014	3F	04_3	234	4	0	400	0	-400	0.00	0.00	0	0	0
0014	3F	04_3	235	3	0	300	0	-300	0.00	0.00	0	0	0
0014	3F	04_3	236	9	0	900	0	-900	0.00	0.00	1	0	-1
0014	3F	04_3	245	2	0	200	0	-200	0.00	0.00	0	0	0
0014	3F	04_3	246	2	1	200	1100	900	0.50	5.50	0	1	1
0014	3F	04_3	256	1	0	100	0	-100	0.00	0.00	0	0	0
0014	3F	04_4	123	59	11	5900	3550	-2350	0.19	0.60	10	6	-4
0014	3F	04_4	124	47	4	4700	1810	-2890	0.09	0.39	8	3	-5
0014	3F	04_4	125	30	5	3000	2350	-650	0.17	0.78	5	4	-1
0014	3F	04_4	126	20	1	2000	380	-1620	0.05	0.19	3	0	-3
0014	3F	04_4	134	32	7	3200	8300	5100	0.22	2.59	5	14	9
0014	3F	04_4	135	14	3	1400	1360	-40	0.21	0.97	2	2	0
0014	3F	04_4	136	11	3	1100	3950	2850	0.27	3.59	1	6	5
0014	3F	04_4	145	11	2	1100	4200	3100	0.18	3.82	1	7	6
0014	3F	04_4	146	9	1	900	320	-580	0.11	0.36	1	0	-1
0014	3F	04_4	156	2	0	200	0	-200	0.00	0.00	0	0	0
0014	3F	04_4	234	4	0	400	0	-400	0.00	0.00	0	0	0
0014	3F	04_4	236	3	0	300	0	-300	0.00	0.00	0	0	0
0014	3F	04_4	245	3	0	300	0	-300	0.00	0.00	0	0	0
0014	3F	04_4	246	1	0	100	0	-100	0.00	0.00	0	0	0
0014	3F	04_5	123	41	7	4100	4070	-30	0.17	0.99	7	7	0
0014	3F	04_5	124	40	7	4000	2850	-1150	0.18	0.71	7	5	-2
0014	3F	04_5	125	28	5	2800	5870	3070	0.18	2.10	4	10	6
0014	3F	04_5	126	17	1	1700	820	-880	0.06	0.48	3	1	-2
0014	3F	04_5	134	23	5	2300	2940	640	0.22	1.28	4	5	1
0014	3F	04_5	135	16	1	1600	1290	-310	0.06	0.81	2	2	0
0014	3F	04_5	136	7	2	700	800	100	0.29	1.14	1	1	0
0014	3F	04_5	145	10	2	1000	1380	380	0.20	1.38	1	2	1
0014	3F	04_5	146	9	1	900	1110	210	0.11	1.23	1	1	0
0014	3F	04_5	156	7	1	700	720	20	0.14	1.03	1	1	0
0014	3F	04_5	235	2	0	200	0	-200	0.00	0.00	0	0	0
0014	3F	04_5	236	2	0	200	0	-200	0.00	0.00	0	0	0
0014	3F	04_5	245	2	1	200	420	220	0.50	2.10	0	0	0
0014	3F	04_5	256	2	0	200	0	-200	0.00	0.00	0	0	0
0014	3F	04_7	123	54	8	5400	3880	-1520	0.15	0.72	9	6	-3
0014	3F	04_7	124	32	5	3200	2980	-220	0.16	0.93	5	5	0
0014	3F	04_7	125	37	6	3700	4600	900	0.16	1.24	6	8	2
0014	3F	04_7	126	27	1	2700	910	-1790	0.04	0.34	4	1	-3
0014	3F	04_7	134	33	3	3300	1370	-1930	0.09	0.42	5	2	-3
0014	3F	04_7	135	21	0	2100	0	-2100	0.00	0.00	3	0	-3
0014	3F	04_7	136	17	1	1700	230	-1470	0.06	0.14	3	0	-3
0014	3F	04_7	145	22	1	2200	360	-1840	0.05	0.16	3	0	-3
0014	3F	04_7	146	15	0	1500	0	-1500	0.00	0.00	2	0	-2
0014	3F	04_7	156	3	0	300	0	-300	0.00	0.00	0	0	0
0014	3F	04_7	234	8	0	800	0	-800	0.00	0.00	1	0	-1
0014	3F	04_7	235	3	0	300	0	-300	0.00	0.00	0	0	0
0014	3F	04_7	236	2	0	200	0	-200	0.00	0.00	0	0	0
0014	3F	04_7	246	5	1	500	460	-40	0.20	0.92	0	0	0
0014	3F	04_7	256	1	0	100	0	-100	0.00	0.00	0	0	0
0014	3F	05_1	123	84	9	8400	4690	-3710	0.11	0.56	14	8	-6
0014	3F	05_1	124	58	17	5800	6980	1180	0.29	1.20	10	12	2
0014	3F	05_1	125	43	3	4300	2170	-2130	0.07	0.50	7	3	-4
0014	3F	05_1	126	32	0	3200	0	-3200	0.00	0.00	5	0	-5
0014	3F	05_1	134	43	3	4300	1840	-2460	0.07	0.43	7	3	-4
0014	3F	05_1	135	28	4	2800	3090	290	0.14	1.10	4	5	1
0014	3F	05_1	136	15	3	1500	2470	970	0.20	1.65	2	4	2
0014	3F	05_1	145	19	0	1900	0	-1900	0.00	0.00	3	0	-3
0014	3F	05_1	146	6	0	600	0	-600	0.00	0.00	1	0	-1
0014	3F	05_1	156	8	1	800	6560	5760	0.13	8.20	1	11	10
0014	3F	05_1	234	5	1	500	670	170	0.20	1.34	0	1	1
0014	3F	05_1	235	6	2	600	670	70	0.33	1.12	1	1	0
0014	3F	05_1	236	1	0	100	0	-100	0.00	0.00	0	0	0
0014	3F	05_1	245	1	0	100	0	-100	0.00	0.00	0	0	0
0014	3F	05_1	256	3	0	300	0	-300	0.00	0.00	0	0	0
0014	3F	05_2	123	58	9	5800	4560	-1240	0.16	0.79	10	8	-2
0014	3F	05_2	124	69	11	6900	5080	-1820	0.16	0.74	12	8	-4
0014	3F	05_2	125	31	6	3100	6090	2990	0.19	1.96	5	10	5
0014	3F	05_2	126	36	4	3600	2100	-1500	0.11	0.58	6	3	-3
0014	3F	05_2	134	41	4	4100	2840	-1260	0.10	0.69	7	5	-2
0014	3F	05_2	135	29	2	2900	680	-2220	0.07	0.23	5	1	-4
0014	3F	05_2	136	27	1	2700	220	-2480	0.04	0.08	4	0	-4
0014	3F	05_2	145	14	2	1400	930	-470	0.14	0.66	2	1	-1
0014	3F	05_2	146	17	1	1700	220	-1480	0.06	0.13	3	0	-3
0014	3F	05_2	156	14	2	1400	870	-530	0.14	0.62	2	1	-1
0014	3F	05_2	234	3	0	300	0	-300	0.00	0.00	0	0	0
0014	3F	05_2	235	2	0	200	0	-200	0.00	0.00	0	0	0
0014	3F	05_2	236	9	1	900	340	-560	0.11	0.38	1	0	-1
0014	3F	05_2	245	3	0	300	0	-300	0.00	0.00	0	0	0
0014	3F	05_2	246	1	0	100	0	-100	0.00	0.00	0	0	0
0014	3F	05_2	256	1	0	100	0	-100	0.00	0.00	0	0	0
0014	3F	05_3	123	63	9	6300	4110	-2190	0.14	0.65	11	7	-4
0014	3F	05_3	124	60	9	6000	3590	-2410	0.15	0.60	10	6	-4
0014	3F	05_3	125	41	3	4100	2110	-1990	0.07	0.51	7	3	-4
0014	3F	05_3	126	36	3	3600	1980	-1620	0.08	0.55	6	3	-3
0014	3F	05_3	134	27	4	2700	1580	-1120	0.15	0.59	4	2	-2
0014	3F	05_3	135	22	1	2200	310	-1890	0.05	0.14	3	0	-3
0014	3F	05_3	136	23	1	2300	260	-2040	0.04	0.11	4	0	-4
0014	3F	05_3	145	19	3	1900	1800	-100	0.16	0.95	3	3	0
0014	3F	05_3	146	9	0	900	0	-900	0.00	0.00	1	0	-1
0014	3F	05_3	156	10	0	1000	0	-1000	0.00	0.00	1	0	-1
0014	3F	05_3	234	7	0	700	0	-700	0.00	0.00	1	0	-1
0014	3F	05_3	235	10	0	1000	0	-1000	0.00	0.00	1	0	-1
0014	3F	05_3	236	6	1	600	140	-460	0.17	0.23	1	0	-1
0014	3F	05_3	245	4	0	400	0	-400	0.00	0.00	0	0	0
0014	3F	05_3	246	2	0	200	0	-200	0.00	0.00	0	0	0
0014	3F	05_3	256	5	1	500	420	-80	0.20	0.84	0	0	0
0014	3F	05_4	123	63	14	6300	6620	320	0.22	1.05	11	11	0
0014	3F	05_4	124	52	8	5200	2770	-2430	0.15	0.53	9	4	-5
0014	3F	05_4	125	42	3	4200	3270	-930	0.07	0.78	7	5	-2
0014	3F	05_4	126	22	1	2200	1440	-760	0.05	0.65	3	2	-1
0014	3F	05_4	134	27	6	2700	4080	1380	0.22	1.51	4	7	3
0014	3F	05_4	135	21	2	2100	1550	-550	0.10	0.74	3	2	-1
0014	3F	05_4	136	13	1	1300	3470	2170	0.08	2.67	2	6	4
0014	3F	05_4	145	16	2	1600	910	-690	0.13	0.57	2	1	-1
0014	3F	05_4	146	10	2	1000	1610	610	0.20	1.61	1	2	1
0014	3F	05_4	156	10	0	1000	0	-1000	0.00	0.00	1	0	-1
0014	3F	05_4	234	7	0	700	0	-700	0.00	0.00	1	0	-1
0014	3F	05_4	235	2	0	200	0	-200	0.00	0.00	0	0	0
0014	3F	05_4	236	2	0	200	0	-200	0.00	0.00	0	0	0
0014	3F	05_4	246	1	0	100	0	-100	0.00	0.00	0	0	0
0014	3F	05_4	256	5	0	500	0	-500	0.00	0.00	0	0	0
0014	3F	05_5	123	42	12	4200	4690	490	0.29	1.12	7	8	1
0014	3F	05_5	124	34	4	3400	1090	-2310	0.12	0.32	6	1	-5
0014	3F	05_5	125	26	3	2600	2100	-500	0.12	0.81	4	3	-1
0014	3F	05_5	126	21	3	2100	5060	2960	0.14	2.41	3	8	5
0014	3F	05_5	134	25	4	2500	1760	-740	0.16	0.70	4	3	-1
0014	3F	05_5	135	17	3	1700	1520	-180	0.18	0.89	3	2	-1
0014	3F	05_5	136	4	0	400	0	-400	0.00	0.00	0	0	0
0014	3F	05_5	145	10	2	1000	990	-10	0.20	0.99	1	1	0
0014	3F	05_5	146	4	1	400	1250	850	0.25	3.13	0	2	2
0014	3F	05_5	156	1	0	100	0	-100	0.00	0.00	0	0	0
0014	3F	05_5	234	1	0	100	0	-100	0.00	0.00	0	0	0
0014	3F	05_5	235	2	0	200	0	-200	0.00	0.00	0	0	0
0014	3F	05_5	236	1	0	100	0	-100	0.00	0.00	0	0	0
0014	3F	05_5	245	1	0	100	0	-100	0.00	0.00	0	0	0
0014	3F	05_6	123	3	0	300	0	-300	0.00	0.00	0	0	0
0014	3F	05_6	125	2	0	200	0	-200	0.00	0.00	0	0	0
0014	3F	05_6	126	1	1	100	710	610	1.00	7.10	0	1	1
0014	3F	05_6	135	1	0	100	0	-100	0.00	0.00	0	0	0
0014	3F	05_7	123	63	18	6300	9060	2760	0.29	1.44	11	16	5
0014	3F	05_7	124	55	8	5500	3900	-1600	0.15	0.71	9	6	-3
0014	3F	05_7	125	37	1	3700	1730	-1970	0.03	0.47	6	3	-3
0014	3F	05_7	126	17	2	1700	3640	1940	0.12	2.14	3	6	3
0014	3F	05_7	134	35	6	3500	3350	-150	0.17	0.96	6	5	-1
0014	3F	05_7	135	45	8	4500	5020	520	0.18	1.12	7	8	1
0014	3F	05_7	136	19	2	1900	1010	-890	0.11	0.53	3	1	-2
0014	3F	05_7	145	14	1	1400	370	-1030	0.07	0.26	2	0	-2
0014	3F	05_7	146	14	1	1400	1230	-170	0.07	0.88	2	2	0
0014	3F	05_7	156	6	1	600	2380	1780	0.17	3.97	1	4	3
0014	3F	05_7	234	5	1	500	1850	1350	0.20	3.70	0	3	3
0014	3F	05_7	235	5	0	500	0	-500	0.00	0.00	0	0	0
0014	3F	05_7	236	1	0	100	0	-100	0.00	0.00	0	0	0
0014	3F	05_7	246	3	0	300	0	-300	0.00	0.00	0	0	0
0014	3F	05_7	256	4	0	400	0	-400	0.00	0.00	0	0	0
0014	3F	06_1	123	101	9	10100	4100	-6000	0.09	0.41	17	7	-10
0014	3F	06_1	124	71	13	7100	9790	2690	0.18	1.38	12	17	5
0014	3F	06_1	125	29	3	2900	2580	-320	0.10	0.89	5	4	-1
0014	3F	06_1	126	39	2	3900	2640	-1260	0.05	0.68	6	4	-2
0014	3F	06_1	134	44	4	4400	1280	-3120	0.09	0.29	7	2	-5
0014	3F	06_1	135	26	3	2600	1860	-740	0.12	0.72	4	3	-1
0014	3F	06_1	136	24	3	2400	5220	2820	0.13	2.18	4	9	5
0014	3F	06_1	145	24	3	2400	1720	-680	0.13	0.72	4	3	-1
0014	3F	06_1	146	10	0	1000	0	-1000	0.00	0.00	1	0	-1
0014	3F	06_1	156	7	1	700	540	-160	0.14	0.77	1	0	-1
0014	3F	06_1	234	6	0	600	0	-600	0.00	0.00	1	0	-1
0014	3F	06_1	235	8	2	800	1080	280	0.25	1.35	1	1	0
0014	3F	06_1	236	3	0	300	0	-300	0.00	0.00	0	0	0
0014	3F	06_1	245	5	0	500	0	-500	0.00	0.00	0	0	0
0014	3F	06_1	246	4	0	400	0	-400	0.00	0.00	0	0	0
0014	3F	06_1	256	1	0	100	0	-100	0.00	0.00	0	0	0
0014	3F	06_2	123	93	14	9300	6180	-3120	0.15	0.66	16	10	-6
0014	3F	06_2	124	69	12	6900	5800	-1100	0.17	0.84	12	10	-2
0014	3F	06_2	125	45	4	4500	1120	-3380	0.09	0.25	7	1	-6
0014	3F	06_2	126	38	1	3800	180	-3620	0.03	0.05	6	0	-6
0014	3F	06_2	134	49	3	4900	4950	50	0.06	1.01	8	8	0
0014	3F	06_2	135	35	4	3500	2060	-1440	0.11	0.59	6	3	-3
0014	3F	06_2	136	25	5	2500	2450	-50	0.20	0.98	4	4	0
0014	3F	06_2	145	17	0	1700	0	-1700	0.00	0.00	3	0	-3
0014	3F	06_2	146	11	0	1100	0	-1100	0.00	0.00	1	0	-1
0014	3F	06_2	156	3	0	300	0	-300	0.00	0.00	0	0	0
0014	3F	06_2	234	5	0	500	0	-500	0.00	0.00	0	0	0
0014	3F	06_2	235	4	1	400	360	-40	0.25	0.90	0	0	0
0014	3F	06_2	236	5	0	500	0	-500	0.00	0.00	0	0	0
0014	3F	06_2	245	4	0	400	0	-400	0.00	0.00	0	0	0
0014	3F	06_2	246	5	1	500	210	-290	0.20	0.42	0	0	0
0014	3F	06_2	256	1	0	100	0	-100	0.00	0.00	0	0	0
0014	3F	06_3	123	89	17	8900	5590	-3310	0.19	0.63	15	9	-6
0014	3F	06_3	124	74	13	7400	7410	10	0.18	1.00	13	13	0
0014	3F	06_3	125	34	2	3400	820	-2580	0.06	0.24	6	1	-5
0014	3F	06_3	126	20	2	2000	1960	-40	0.10	0.98	3	3	0
0014	3F	06_3	134	34	4	3400	1320	-2080	0.12	0.39	6	2	-4
0014	3F	06_3	135	35	3	3500	5650	2150	0.09	1.61	6	10	4
0014	3F	06_3	136	18	2	1800	9110	7310	0.11	5.06	3	16	13
0014	3F	06_3	145	17	2	1700	1480	-220	0.12	0.87	3	2	-1
0014	3F	06_3	146	16	0	1600	0	-1600	0.00	0.00	2	0	-2
0014	3F	06_3	156	7	0	700	0	-700	0.00	0.00	1	0	-1
0014	3F	06_3	234	3	0	300	0	-300	0.00	0.00	0	0	0
0014	3F	06_3	235	4	2	400	640	240	0.50	1.60	0	1	1
0014	3F	06_3	236	3	0	300	0	-300	0.00	0.00	0	0	0
0014	3F	06_3	245	3	0	300	0	-300	0.00	0.00	0	0	0
0014	3F	06_3	246	2	0	200	0	-200	0.00	0.00	0	0	0
0014	3F	06_4	123	48	8	4800	2950	-1850	0.17	0.61	8	5	-3
0014	3F	06_4	124	38	3	3800	1620	-2180	0.08	0.43	6	2	-4
0014	3F	06_4	125	37	5	3700	1990	-1710	0.14	0.54	6	3	-3
0014	3F	06_4	126	39	3	3900	1460	-2440	0.08	0.37	6	2	-4
0014	3F	06_4	134	33	5	3300	2120	-1180	0.15	0.64	5	3	-2
0014	3F	06_4	135	18	3	1800	1940	140	0.17	1.08	3	3	0
0014	3F	06_4	136	16	0	1600	0	-1600	0.00	0.00	2	0	-2
0014	3F	06_4	145	7	0	700	0	-700	0.00	0.00	1	0	-1
0014	3F	06_4	146	8	1	800	380	-420	0.13	0.48	1	0	-1
0014	3F	06_4	156	3	0	300	0	-300	0.00	0.00	0	0	0
0014	3F	06_4	234	2	0	200	0	-200	0.00	0.00	0	0	0
0014	3F	06_4	235	4	0	400	0	-400	0.00	0.00	0	0	0
0014	3F	06_4	236	3	0	300	0	-300	0.00	0.00	0	0	0
0014	3F	06_4	245	3	0	300	0	-300	0.00	0.00	0	0	0
0014	3F	06_4	246	3	0	300	0	-300	0.00	0.00	0	0	0
0014	3F	06_4	256	1	0	100	0	-100	0.00	0.00	0	0	0
0014	3F	06_5	123	26	6	2600	3010	410	0.23	1.16	4	5	1
0014	3F	06_5	124	30	5	3000	3330	330	0.17	1.11	5	5	0
0014	3F	06_5	125	18	1	1800	360	-1440	0.06	0.20	3	0	-3
0014	3F	06_5	126	13	0	1300	0	-1300	0.00	0.00	2	0	-2
0014	3F	06_5	134	21	5	2100	2750	650	0.24	1.31	3	4	1
0014	3F	06_5	135	10	1	1000	2220	1220	0.10	2.22	1	3	2
0014	3F	06_5	136	5	1	500	470	-30	0.20	0.94	0	0	0
0014	3F	06_5	145	7	1	700	1140	440	0.14	1.63	1	2	1
0014	3F	06_5	146	6	1	600	840	240	0.17	1.40	1	1	0
0014	3F	06_5	156	2	0	200	0	-200	0.00	0.00	0	0	0
0014	3F	06_5	234	4	0	400	0	-400	0.00	0.00	0	0	0
0014	3F	06_5	235	3	1	300	290	-10	0.33	0.97	0	0	0
0014	3F	06_5	236	5	0	500	0	-500	0.00	0.00	0	0	0
0014	3F	06_5	245	2	0	200	0	-200	0.00	0.00	0	0	0
0014	3F	06_5	256	1	0	100	0	-100	0.00	0.00	0	0	0
0014	3F	06_6	123	3	0	300	0	-300	0.00	0.00	0	0	0
0014	3F	06_6	124	4	0	400	0	-400	0.00	0.00	0	0	0
0014	3F	06_6	125	2	1	200	960	760	0.50	4.80	0	1	1
0014	3F	06_6	126	4	1	400	1100	700	0.25	2.75	0	1	1
0014	3F	06_6	134	4	0	400	0	-400	0.00	0.00	0	0	0
0014	3F	06_6	136	1	0	100	0	-100	0.00	0.00	0	0	0
0014	3F	06_6	145	1	0	100	0	-100	0.00	0.00	0	0	0
0014	3F	06_6	146	1	0	100	0	-100	0.00	0.00	0	0	0
0014	3F	06_6	156	1	0	100	0	-100	0.00	0.00	0	0	0
0014	3F	06_7	123	87	21	8700	8150	-550	0.24	0.94	15	14	-1
0014	3F	06_7	124	82	13	8200	6260	-1940	0.16	0.76	14	11	-3
0014	3F	06_7	125	49	9	4900	4990	90	0.18	1.02	8	8	0
0014	3F	06_7	126	33	2	3300	2270	-1030	0.06	0.69	5	4	-1
0014	3F	06_7	134	52	7	5200	2390	-2810	0.13	0.46	9	4	-5
0014	3F	06_7	135	21	2	2100	950	-1150	0.10	0.45	3	1	-2
0014	3F	06_7	136	19	1	1900	190	-1710	0.05	0.10	3	0	-3
0014	3F	06_7	145	28	1	2800	340	-2460	0.04	0.12	4	0	-4
0014	3F	06_7	146	13	0	1300	0	-1300	0.00	0.00	2	0	-2
0014	3F	06_7	156	5	1	500	260	-240	0.20	0.52	0	0	0
0014	3F	06_7	234	4	0	400	0	-400	0.00	0.00	0	0	0
0014	3F	06_7	235	3	0	300	0	-300	0.00	0.00	0	0	0
0014	3F	06_7	236	3	0	300	0	-300	0.00	0.00	0	0	0
0014	3F	06_7	245	3	0	300	0	-300	0.00	0.00	0	0	0
0014	3F	06_7	246	1	0	100	0	-100	0.00	0.00	0	0	0
0014	3F	06_7	256	1	0	100	0	-100	0.00	0.00	0	0	0
0014	3F	07_1	123	73	16	7300	8560	1260	0.22	1.17	12	15	3
0014	3F	07_1	124	56	10	5600	4680	-920	0.18	0.84	9	8	-1
0014	3F	07_1	125	28	4	2800	2260	-540	0.14	0.81	4	4	0
0014	3F	07_1	126	29	2	2900	1220	-1680	0.07	0.42	5	2	-3
0014	3F	07_1	134	40	7	4000	1600	-2400	0.18	0.40	7	2	-5
0014	3F	07_1	135	29	6	2900	3390	490	0.21	1.17	5	6	1
0014	3F	07_1	136	19	5	1900	2790	890	0.26	1.47	3	4	1
0014	3F	07_1	145	23	2	2300	830	-1470	0.09	0.36	4	1	-3
0014	3F	07_1	146	11	0	1100	0	-1100	0.00	0.00	1	0	-1
0014	3F	07_1	156	12	4	1200	4460	3260	0.33	3.72	2	7	5
0014	3F	07_1	235	5	1	500	4480	3980	0.20	8.96	0	7	7
0014	3F	07_1	236	2	0	200	0	-200	0.00	0.00	0	0	0
0014	3F	07_1	246	3	0	300	0	-300	0.00	0.00	0	0	0
0014	3F	07_1	256	1	0	100	0	-100	0.00	0.00	0	0	0
0014	3F	07_2	123	76	15	7600	7480	-120	0.20	0.98	13	13	0
0014	3F	07_2	124	70	8	7000	4140	-2860	0.11	0.59	12	7	-5
0014	3F	07_2	125	34	6	3400	3220	-180	0.18	0.95	6	5	-1
0014	3F	07_2	126	41	4	4100	3860	-240	0.10	0.94	7	6	-1
0014	3F	07_2	134	35	4	3500	1870	-1630	0.11	0.53	6	3	-3
0014	3F	07_2	135	21	2	2100	1900	-200	0.10	0.90	3	3	0
0014	3F	07_2	136	20	2	2000	590	-1410	0.10	0.30	3	1	-2
0014	3F	07_2	145	18	4	1800	2150	350	0.22	1.19	3	3	0
0014	3F	07_2	146	11	0	1100	0	-1100	0.00	0.00	1	0	-1
0014	3F	07_2	156	7	1	700	600	-100	0.14	0.86	1	1	0
0014	3F	07_2	234	2	1	200	340	140	0.50	1.70	0	0	0
0014	3F	07_2	235	3	0	300	0	-300	0.00	0.00	0	0	0
0014	3F	07_2	236	4	1	400	820	420	0.25	2.05	0	1	1
0014	3F	07_2	245	3	0	300	0	-300	0.00	0.00	0	0	0
0014	3F	07_2	246	1	0	100	0	-100	0.00	0.00	0	0	0
0014	3F	07_3	123	91	19	9100	7700	-1400	0.21	0.85	16	13	-3
0014	3F	07_3	124	60	9	6000	4220	-1780	0.15	0.70	10	7	-3
0014	3F	07_3	125	48	1	4800	300	-4500	0.02	0.06	8	0	-8
0014	3F	07_3	126	37	7	3700	3840	140	0.19	1.04	6	6	0
0014	3F	07_3	134	33	3	3300	1930	-1370	0.09	0.58	5	3	-2
0014	3F	07_3	135	29	7	2900	3140	240	0.24	1.08	5	5	0
0014	3F	07_3	136	21	2	2100	1940	-160	0.10	0.92	3	3	0
0014	3F	07_3	145	10	0	1000	0	-1000	0.00	0.00	1	0	-1
0014	3F	07_3	146	7	0	700	0	-700	0.00	0.00	1	0	-1
0014	3F	07_3	156	8	0	800	0	-800	0.00	0.00	1	0	-1
0014	3F	07_3	234	7	2	700	1350	650	0.29	1.93	1	2	1
0014	3F	07_3	235	2	1	200	610	410	0.50	3.05	0	1	1
0014	3F	07_3	236	3	0	300	0	-300	0.00	0.00	0	0	0
0014	3F	07_3	246	3	0	300	0	-300	0.00	0.00	0	0	0
0014	3F	07_3	256	3	1	300	2800	2500	0.33	9.33	0	4	4
0014	3F	07_4	123	89	21	8900	9820	920	0.24	1.10	15	17	2
0014	3F	07_4	124	49	7	4900	3080	-1820	0.14	0.63	8	5	-3
0014	3F	07_4	125	38	2	3800	710	-3090	0.05	0.19	6	1	-5
0014	3F	07_4	126	38	5	3800	2300	-1500	0.13	0.61	6	4	-2
0014	3F	07_4	134	41	5	4100	1710	-2390	0.12	0.42	7	3	-4
0014	3F	07_4	135	12	2	1200	650	-550	0.17	0.54	2	1	-1
0014	3F	07_4	136	16	4	1600	3380	1780	0.25	2.11	2	5	3
0014	3F	07_4	145	14	0	1400	0	-1400	0.00	0.00	2	0	-2
0014	3F	07_4	146	15	3	1500	3840	2340	0.20	2.56	2	6	4
0014	3F	07_4	156	6	0	600	0	-600	0.00	0.00	1	0	-1
0014	3F	07_4	234	5	1	500	310	-190	0.20	0.62	0	0	0
0014	3F	07_4	236	3	1	300	1240	940	0.33	4.13	0	2	2
0014	3F	07_4	245	1	0	100	0	-100	0.00	0.00	0	0	0
0014	3F	07_4	256	2	0	200	0	-200	0.00	0.00	0	0	0
0014	3F	07_5	123	65	15	6500	4680	-1820	0.23	0.72	11	8	-3
0014	3F	07_5	124	54	10	5400	5910	510	0.19	1.09	9	10	1
0014	3F	07_5	125	18	4	1800	2620	820	0.22	1.46	3	4	1
0014	3F	07_5	126	24	3	2400	1900	-500	0.13	0.79	4	3	-1
0014	3F	07_5	134	30	7	3000	7150	4150	0.23	2.38	5	12	7
0014	3F	07_5	135	19	2	1900	790	-1110	0.11	0.42	3	1	-2
0014	3F	07_5	136	12	0	1200	0	-1200	0.00	0.00	2	0	-2
0014	3F	07_5	145	15	3	1500	1200	-300	0.20	0.80	2	2	0
0014	3F	07_5	146	7	0	700	0	-700	0.00	0.00	1	0	-1
0014	3F	07_5	156	4	1	400	200	-200	0.25	0.50	0	0	0
0014	3F	07_5	234	1	0	100	0	-100	0.00	0.00	0	0	0
0014	3F	07_5	235	1	0	100	0	-100	0.00	0.00	0	0	0
0014	3F	07_5	236	1	0	100	0	-100	0.00	0.00	0	0	0
0014	3F	07_5	245	1	0	100	0	-100	0.00	0.00	0	0	0
0014	3F	07_5	246	2	0	200	0	-200	0.00	0.00	0	0	0
0014	3F	07_6	123	8	0	800	0	-800	0.00	0.00	1	0	-1
0014	3F	07_6	124	4	0	400	0	-400	0.00	0.00	0	0	0
0014	3F	07_6	125	1	0	100	0	-100	0.00	0.00	0	0	0
0014	3F	07_6	126	1	0	100	0	-100	0.00	0.00	0	0	0
0014	3F	07_6	134	5	1	500	380	-120	0.20	0.76	0	0	0
0014	3F	07_6	135	2	0	200	0	-200	0.00	0.00	0	0	0
0014	3F	07_6	136	2	0	200	0	-200	0.00	0.00	0	0	0
0014	3F	07_6	145	5	1	500	850	350	0.20	1.70	0	1	1
0014	3F	07_6	146	3	0	300	0	-300	0.00	0.00	0	0	0
0014	3F	07_6	156	1	0	100	0	-100	0.00	0.00	0	0	0
0014	3F	07_7	123	77	20	7700	7870	170	0.26	1.02	13	13	0
0014	3F	07_7	124	77	19	7700	7690	-10	0.25	1.00	13	13	0
0014	3F	07_7	125	37	7	3700	4220	520	0.19	1.14	6	7	1
0014	3F	07_7	126	23	3	2300	1880	-420	0.13	0.82	4	3	-1
0014	3F	07_7	134	48	10	4800	5380	580	0.21	1.12	8	9	1
0014	3F	07_7	135	27	4	2700	2830	130	0.15	1.05	4	5	1
0014	3F	07_7	136	20	1	2000	1930	-70	0.05	0.97	3	3	0
0014	3F	07_7	145	23	6	2300	10450	8150	0.26	4.54	4	18	14
0014	3F	07_7	146	11	0	1100	0	-1100	0.00	0.00	1	0	-1
0014	3F	07_7	156	6	2	600	1450	850	0.33	2.42	1	2	1
0014	3F	07_7	235	1	0	100	0	-100	0.00	0.00	0	0	0
0014	3F	07_7	236	1	0	100	0	-100	0.00	0.00	0	0	0
0014	3F	07_7	245	1	1	100	670	570	1.00	6.70	0	1	1
0014	3F	07_7	246	1	0	100	0	-100	0.00	0.00	0	0	0
0014	3F	07_7	256	2	0	200	0	-200	0.00	0.00	0	0	0
0014	3F	08_1	123	81	12	8100	4670	-3430	0.15	0.58	14	8	-6
0014	3F	08_1	124	60	15	6000	6100	100	0.25	1.02	10	10	0
0014	3F	08_1	125	46	5	4600	4970	370	0.11	1.08	8	8	0
0014	3F	08_1	126	64	9	6400	4500	-1900	0.14	0.70	11	7	-4
0014	3F	08_1	134	37	4	3700	1730	-1970	0.11	0.47	6	3	-3
0014	3F	08_1	135	26	0	2600	0	-2600	0.00	0.00	4	0	-4
0014	3F	08_1	136	28	7	2800	1990	-810	0.25	0.71	4	3	-1
0014	3F	08_1	145	18	2	1800	1780	-20	0.11	0.99	3	3	0
0014	3F	08_1	146	20	2	2000	1690	-310	0.10	0.85	3	2	-1
0014	3F	08_1	156	11	1	1100	290	-810	0.09	0.26	1	0	-1
0014	3F	08_1	234	2	0	200	0	-200	0.00	0.00	0	0	0
0014	3F	08_1	235	1	0	100	0	-100	0.00	0.00	0	0	0
0014	3F	08_1	236	3	0	300	0	-300	0.00	0.00	0	0	0
0014	3F	08_1	245	2	0	200	0	-200	0.00	0.00	0	0	0
0014	3F	08_2	123	89	14	8900	4650	-4250	0.16	0.52	15	8	-7
0014	3F	08_2	124	75	11	7500	6750	-750	0.15	0.90	13	11	-2
0014	3F	08_2	125	45	6	4500	3550	-950	0.13	0.79	7	6	-1
0014	3F	08_2	126	40	4	4000	2700	-1300	0.10	0.68	7	4	-3
0014	3F	08_2	134	46	9	4600	2690	-1910	0.20	0.58	8	4	-4
0014	3F	08_2	135	32	5	3200	1700	-1500	0.16	0.53	5	3	-2
0014	3F	08_2	136	34	5	3400	3560	160	0.15	1.05	6	6	0
0014	3F	08_2	145	16	3	1600	1330	-270	0.19	0.83	2	2	0
0014	3F	08_2	146	15	3	1500	1170	-330	0.20	0.78	2	2	0
0014	3F	08_2	156	10	1	1000	480	-520	0.10	0.48	1	0	-1
0014	3F	08_2	234	1	0	100	0	-100	0.00	0.00	0	0	0
0014	3F	08_2	235	1	0	100	0	-100	0.00	0.00	0	0	0
0014	3F	08_2	236	2	0	200	0	-200	0.00	0.00	0	0	0
0014	3F	08_2	246	2	0	200	0	-200	0.00	0.00	0	0	0
0014	3F	08_2	256	4	0	400	0	-400	0.00	0.00	0	0	0
0014	3F	08_3	123	101	25	10100	8350	-1750	0.25	0.83	17	14	-3
0014	3F	08_3	124	73	18	7300	8740	1440	0.25	1.20	12	15	3
0014	3F	08_3	125	54	5	5400	3710	-1690	0.09	0.69	9	6	-3
0014	3F	08_3	126	28	3	2800	1480	-1320	0.11	0.53	4	2	-2
0014	3F	08_3	134	58	9	5800	3190	-2610	0.16	0.55	10	5	-5
0014	3F	08_3	135	37	3	3700	760	-2940	0.08	0.21	6	1	-5
0014	3F	08_3	136	14	0	1400	0	-1400	0.00	0.00	2	0	-2
0014	3F	08_3	145	19	4	1900	2130	230	0.21	1.12	3	3	0
0014	3F	08_3	146	8	2	800	1190	390	0.25	1.49	1	2	1
0014	3F	08_3	156	4	1	400	1700	1300	0.25	4.25	0	3	3
0014	3F	08_3	234	2	0	200	0	-200	0.00	0.00	0	0	0
0014	3F	08_3	235	4	0	400	0	-400	0.00	0.00	0	0	0
0014	3F	08_3	236	3	0	300	0	-300	0.00	0.00	0	0	0
0014	3F	08_3	245	2	0	200	0	-200	0.00	0.00	0	0	0
0014	3F	08_3	246	3	0	300	0	-300	0.00	0.00	0	0	0
0014	3F	08_3	256	4	0	400	0	-400	0.00	0.00	0	0	0
0014	3F	08_4	123	36	4	3600	1420	-2180	0.11	0.39	6	2	-4
0014	3F	08_4	124	19	4	1900	2130	230	0.21	1.12	3	3	0
0014	3F	08_4	125	18	3	1800	1550	-250	0.17	0.86	3	2	-1
0014	3F	08_4	126	18	2	1800	1390	-410	0.11	0.77	3	2	-1
0014	3F	08_4	134	13	2	1300	3290	1990	0.15	2.53	2	5	3
0014	3F	08_4	135	13	1	1300	780	-520	0.08	0.60	2	1	-1
0014	3F	08_4	136	5	0	500	0	-500	0.00	0.00	0	0	0
0014	3F	08_4	145	4	1	400	390	-10	0.25	0.98	0	0	0
0014	3F	08_4	146	3	0	300	0	-300	0.00	0.00	0	0	0
0014	3F	08_4	156	2	0	200	0	-200	0.00	0.00	0	0	0
0014	3F	08_4	234	1	0	100	0	-100	0.00	0.00	0	0	0
0014	3F	08_4	236	1	0	100	0	-100	0.00	0.00	0	0	0
0014	3F	08_4	256	1	0	100	0	-100	0.00	0.00	0	0	0
0014	3F	08_5	123	14	3	1400	2080	680	0.21	1.49	2	3	1
0014	3F	08_5	124	16	4	1600	3710	2110	0.25	2.32	2	6	4
0014	3F	08_5	125	20	3	2000	2410	410	0.15	1.21	3	4	1
0014	3F	08_5	126	7	0	700	0	-700	0.00	0.00	1	0	-1
0014	3F	08_5	134	15	4	1500	2190	690	0.27	1.46	2	3	1
0014	3F	08_5	135	6	0	600	0	-600	0.00	0.00	1	0	-1
0014	3F	08_5	136	4	0	400	0	-400	0.00	0.00	0	0	0
0014	3F	08_5	145	5	1	500	340	-160	0.20	0.68	0	0	0
0014	3F	08_5	146	5	1	500	470	-30	0.20	0.94	0	0	0
0014	3F	08_5	156	1	0	100	0	-100	0.00	0.00	0	0	0
0014	3F	08_5	234	1	0	100	0	-100	0.00	0.00	0	0	0
0014	3F	08_5	256	1	0	100	0	-100	0.00	0.00	0	0	0
0014	3F	08_6	123	2	1	200	240	40	0.50	1.20	0	0	0
0014	3F	08_6	124	2	1	200	330	130	0.50	1.65	0	0	0
0014	3F	08_6	125	3	1	300	1110	810	0.33	3.70	0	1	1
0014	3F	08_6	134	3	1	300	240	-60	0.33	0.80	0	0	0
0014	3F	08_6	135	2	1	200	1240	1040	0.50	6.20	0	2	2
0014	3F	08_6	156	1	0	100	0	-100	0.00	0.00	0	0	0
0014	3F	08_7	123	102	30	10200	11910	1710	0.29	1.17	18	21	3
0014	3F	08_7	124	74	12	7400	5300	-2100	0.16	0.72	13	9	-4
0014	3F	08_7	125	57	9	5700	8380	2680	0.16	1.47	10	14	4
0014	3F	08_7	126	41	4	4100	1760	-2340	0.10	0.43	7	3	-4
0014	3F	08_7	134	40	6	4000	3130	-870	0.15	0.78	7	5	-2
0014	3F	08_7	135	28	4	2800	1960	-840	0.14	0.70	4	3	-1
0014	3F	08_7	136	19	3	1900	2130	230	0.16	1.12	3	3	0
0014	3F	08_7	145	23	0	2300	0	-2300	0.00	0.00	4	0	-4
0014	3F	08_7	146	21	1	2100	360	-1740	0.05	0.17	3	0	-3
0014	3F	08_7	156	6	0	600	0	-600	0.00	0.00	1	0	-1
0014	3F	08_7	234	3	0	300	0	-300	0.00	0.00	0	0	0
0014	3F	08_7	235	5	1	500	1700	1200	0.20	3.40	0	3	3
0014	3F	08_7	236	3	0	300	0	-300	0.00	0.00	0	0	0
0014	3F	08_7	245	2	0	200	0	-200	0.00	0.00	0	0	0
0014	3F	08_7	256	2	0	200	0	-200	0.00	0.00	0	0	0
0014	3F	09_1	123	78	24	7800	11290	3490	0.31	1.45	13	19	6
0014	3F	09_1	124	56	13	5600	6590	990	0.23	1.18	9	11	2
0014	3F	09_1	125	46	5	4600	5300	700	0.11	1.15	8	9	1
0014	3F	09_1	126	26	5	2600	2820	220	0.19	1.08	4	4	0
0014	3F	09_1	134	43	8	4300	5120	820	0.19	1.19	7	9	2
0014	3F	09_1	135	32	3	3200	1380	-1820	0.09	0.43	5	2	-3
0014	3F	09_1	136	10	1	1000	860	-140	0.10	0.86	1	1	0
0014	3F	09_1	145	12	0	1200	0	-1200	0.00	0.00	2	0	-2
0014	3F	09_1	146	15	1	1500	1320	-180	0.07	0.88	2	2	0
0014	3F	09_1	156	6	1	600	1520	920	0.17	2.53	1	2	1
0014	3F	09_1	234	7	0	700	0	-700	0.00	0.00	1	0	-1
0014	3F	09_1	235	9	2	900	1000	100	0.22	1.11	1	1	0
0014	3F	09_1	236	4	1	400	290	-110	0.25	0.73	0	0	0
0014	3F	09_1	245	4	1	400	110	-290	0.25	0.28	0	0	0
0014	3F	09_1	246	2	0	200	0	-200	0.00	0.00	0	0	0
0014	3F	09_1	256	1	0	100	0	-100	0.00	0.00	0	0	0
0014	3F	09_2	123	90	26	9000	9370	370	0.29	1.04	15	16	1
0014	3F	09_2	124	52	11	5200	5270	70	0.21	1.01	9	9	0
0014	3F	09_2	125	42	7	4200	3080	-1120	0.17	0.73	7	5	-2
0014	3F	09_2	126	27	1	2700	170	-2530	0.04	0.06	4	0	-4
0014	3F	09_2	134	41	4	4100	1200	-2900	0.10	0.29	7	2	-5
0014	3F	09_2	135	24	3	2400	2820	420	0.13	1.18	4	4	0
0014	3F	09_2	136	20	3	2000	1940	-60	0.15	0.97	3	3	0
0014	3F	09_2	145	17	2	1700	4910	3210	0.12	2.89	3	8	5
0014	3F	09_2	146	10	2	1000	1070	70	0.20	1.07	1	1	0
0014	3F	09_2	156	7	0	700	0	-700	0.00	0.00	1	0	-1
0014	3F	09_2	234	4	0	400	0	-400	0.00	0.00	0	0	0
0014	3F	09_2	235	4	1	400	3820	3420	0.25	9.55	0	6	6
0014	3F	09_2	236	2	1	200	360	160	0.50	1.80	0	0	0
0014	3F	09_2	245	1	0	100	0	-100	0.00	0.00	0	0	0
0014	3F	09_2	246	4	2	400	1590	1190	0.50	3.98	0	2	2
0014	3F	09_3	123	85	12	8500	4620	-3880	0.14	0.54	15	8	-7
0014	3F	09_3	124	60	6	6000	3370	-2630	0.10	0.56	10	5	-5
0014	3F	09_3	125	43	4	4300	1640	-2660	0.09	0.38	7	2	-5
0014	3F	09_3	126	26	3	2600	870	-1730	0.12	0.33	4	1	-3
0014	3F	09_3	134	44	6	4400	2850	-1550	0.14	0.65	7	5	-2
0014	3F	09_3	135	32	4	3200	3130	-70	0.13	0.98	5	5	0
0014	3F	09_3	136	16	1	1600	370	-1230	0.06	0.23	2	0	-2
0014	3F	09_3	145	13	3	1300	1560	260	0.23	1.20	2	2	0
0014	3F	09_3	146	7	1	700	600	-100	0.14	0.86	1	1	0
0014	3F	09_3	156	9	1	900	1110	210	0.11	1.23	1	1	0
0014	3F	09_3	234	2	0	200	0	-200	0.00	0.00	0	0	0
0014	3F	09_3	235	6	0	600	0	-600	0.00	0.00	1	0	-1
0014	3F	09_3	236	3	1	300	350	50	0.33	1.17	0	0	0
0014	3F	09_3	245	2	0	200	0	-200	0.00	0.00	0	0	0
0014	3F	09_3	246	2	1	200	340	140	0.50	1.70	0	0	0
0014	3F	09_3	256	1	0	100	0	-100	0.00	0.00	0	0	0
0014	3F	09_4	123	64	10	6400	3470	-2930	0.16	0.54	11	6	-5
0014	3F	09_4	124	53	10	5300	3700	-1600	0.19	0.70	9	6	-3
0014	3F	09_4	125	30	5	3000	2560	-440	0.17	0.85	5	4	-1
0014	3F	09_4	126	34	3	3400	3200	-200	0.09	0.94	6	5	-1
0014	3F	09_4	134	43	5	4300	5070	770	0.12	1.18	7	8	1
0014	3F	09_4	135	27	3	2700	830	-1870	0.11	0.31	4	1	-3
0014	3F	09_4	136	21	0	2100	0	-2100	0.00	0.00	3	0	-3
0014	3F	09_4	145	15	2	1500	1640	140	0.13	1.09	2	2	0
0014	3F	09_4	146	6	0	600	0	-600	0.00	0.00	1	0	-1
0014	3F	09_4	156	2	0	200	0	-200	0.00	0.00	0	0	0
0014	3F	09_4	234	5	1	500	180	-320	0.20	0.36	0	0	0
0014	3F	09_4	235	4	0	400	0	-400	0.00	0.00	0	0	0
0014	3F	09_4	236	5	0	500	0	-500	0.00	0.00	0	0	0
0014	3F	09_4	245	3	0	300	0	-300	0.00	0.00	0	0	0
0014	3F	09_4	246	2	0	200	0	-200	0.00	0.00	0	0	0
0014	3F	09_4	256	3	0	300	0	-300	0.00	0.00	0	0	0
0014	3F	09_5	123	86	24	8600	8200	-400	0.28	0.95	15	14	-1
0014	3F	09_5	124	64	13	6400	6230	-170	0.20	0.97	11	11	0
0014	3F	09_5	125	29	2	2900	760	-2140	0.07	0.26	5	1	-4
0014	3F	09_5	126	25	5	2500	3160	660	0.20	1.26	4	5	1
0014	3F	09_5	134	39	4	3900	2890	-1010	0.10	0.74	6	5	-1
0014	3F	09_5	135	28	2	2800	1530	-1270	0.07	0.55	4	2	-2
0014	3F	09_5	136	11	0	1100	0	-1100	0.00	0.00	1	0	-1
0014	3F	09_5	145	15	1	1500	1640	140	0.07	1.09	2	2	0
0014	3F	09_5	146	9	0	900	0	-900	0.00	0.00	1	0	-1
0014	3F	09_5	156	4	0	400	0	-400	0.00	0.00	0	0	0
0014	3F	09_5	234	3	0	300	0	-300	0.00	0.00	0	0	0
0014	3F	09_5	235	1	0	100	0	-100	0.00	0.00	0	0	0
0014	3F	09_5	236	2	1	200	480	280	0.50	2.40	0	0	0
0014	3F	09_5	245	2	0	200	0	-200	0.00	0.00	0	0	0
0014	3F	09_5	246	1	0	100	0	-100	0.00	0.00	0	0	0
0014	3F	09_5	256	1	0	100	0	-100	0.00	0.00	0	0	0
0014	3F	09_7	123	108	27	10800	10830	30	0.25	1.00	19	19	0
0014	3F	09_7	124	66	16	6600	8410	1810	0.24	1.27	11	14	3
0014	3F	09_7	125	47	7	4700	3870	-830	0.15	0.82	8	6	-2
0014	3F	09_7	126	39	3	3900	1110	-2790	0.08	0.28	6	1	-5
0014	3F	09_7	134	46	9	4600	4200	-400	0.20	0.91	8	7	-1
0014	3F	09_7	135	38	5	3800	2260	-1540	0.13	0.59	6	4	-2
0014	3F	09_7	136	12	3	1200	1970	770	0.25	1.64	2	3	1
0014	3F	09_7	145	20	3	2000	1950	-50	0.15	0.98	3	3	0
0014	3F	09_7	146	10	2	1000	780	-220	0.20	0.78	1	1	0
0014	3F	09_7	156	5	0	500	0	-500	0.00	0.00	0	0	0
0014	3F	09_7	234	1	0	100	0	-100	0.00	0.00	0	0	0
0014	3F	09_7	236	1	0	100	0	-100	0.00	0.00	0	0	0
0014	3F	09_7	246	2	0	200	0	-200	0.00	0.00	0	0	0
0014	3F	10_1	123	98	21	9800	8410	-1390	0.21	0.86	17	14	-3
0014	3F	10_1	124	65	15	6500	6760	260	0.23	1.04	11	11	0
0014	3F	10_1	125	42	4	4200	1270	-2930	0.10	0.30	7	2	-5
0014	3F	10_1	126	32	2	3200	1050	-2150	0.06	0.33	5	1	-4
0014	3F	10_1	134	46	2	4600	1070	-3530	0.04	0.23	8	1	-7
0014	3F	10_1	135	17	1	1700	250	-1450	0.06	0.15	3	0	-3
0014	3F	10_1	136	13	2	1300	12250	10950	0.15	9.42	2	21	19
0014	3F	10_1	145	14	3	1400	4220	2820	0.21	3.01	2	7	5
0014	3F	10_1	146	13	0	1300	0	-1300	0.00	0.00	2	0	-2
0014	3F	10_1	156	2	0	200	0	-200	0.00	0.00	0	0	0
0014	3F	10_1	234	2	0	200	0	-200	0.00	0.00	0	0	0
0014	3F	10_1	235	5	2	500	2530	2030	0.40	5.06	0	4	4
0014	3F	10_1	245	5	0	500	0	-500	0.00	0.00	0	0	0
0014	3F	10_1	246	2	1	200	560	360	0.50	2.80	0	0	0
0014	3F	10_1	256	1	0	100	0	-100	0.00	0.00	0	0	0
0014	3F	10_2	123	93	25	9300	7730	-1570	0.27	0.83	16	13	-3
0014	3F	10_2	124	61	9	6100	6320	220	0.15	1.04	10	11	1
0014	3F	10_2	125	32	0	3200	0	-3200	0.00	0.00	5	0	-5
0014	3F	10_2	126	27	1	2700	1020	-1680	0.04	0.38	4	1	-3
0014	3F	10_2	134	42	5	4200	2250	-1950	0.12	0.54	7	3	-4
0014	3F	10_2	135	26	1	2600	940	-1660	0.04	0.36	4	1	-3
0014	3F	10_2	136	18	0	1800	0	-1800	0.00	0.00	3	0	-3
0014	3F	10_2	145	12	0	1200	0	-1200	0.00	0.00	2	0	-2
0014	3F	10_2	146	9	1	900	1700	800	0.11	1.89	1	3	2
0014	3F	10_2	156	6	0	600	0	-600	0.00	0.00	1	0	-1
0014	3F	10_2	234	7	0	700	0	-700	0.00	0.00	1	0	-1
0014	3F	10_2	235	3	0	300	0	-300	0.00	0.00	0	0	0
0014	3F	10_2	236	7	0	700	0	-700	0.00	0.00	1	0	-1
0014	3F	10_2	245	1	0	100	0	-100	0.00	0.00	0	0	0
0014	3F	10_2	246	2	0	200	0	-200	0.00	0.00	0	0	0
0014	3F	10_2	256	1	0	100	0	-100	0.00	0.00	0	0	0
0014	3F	10_3	123	93	17	9300	6870	-2430	0.18	0.74	16	12	-4
0014	3F	10_3	124	65	13	6500	6610	110	0.20	1.02	11	11	0
0014	3F	10_3	125	46	5	4600	3270	-1330	0.11	0.71	8	5	-3
0014	3F	10_3	126	22	6	2200	4340	2140	0.27	1.97	3	7	4
0014	3F	10_3	134	55	8	5500	7330	1830	0.15	1.33	9	12	3
0014	3F	10_3	135	23	2	2300	1590	-710	0.09	0.69	4	2	-2
0014	3F	10_3	136	9	0	900	0	-900	0.00	0.00	1	0	-1
0014	3F	10_3	145	13	1	1300	590	-710	0.08	0.45	2	1	-1
0014	3F	10_3	146	8	0	800	0	-800	0.00	0.00	1	0	-1
0014	3F	10_3	156	5	1	500	780	280	0.20	1.56	0	1	1
0014	3F	10_3	234	8	1	800	940	140	0.13	1.18	1	1	0
0014	3F	10_3	235	2	0	200	0	-200	0.00	0.00	0	0	0
0014	3F	10_3	236	2	0	200	0	-200	0.00	0.00	0	0	0
0014	3F	10_3	245	4	1	400	580	180	0.25	1.45	0	1	1
0014	3F	10_3	246	2	0	200	0	-200	0.00	0.00	0	0	0
0014	3F	10_4	123	103	16	10300	5330	-4970	0.16	0.52	18	9	-9
0014	3F	10_4	124	71	12	7100	7120	20	0.17	1.00	12	12	0
0014	3F	10_4	125	37	1	3700	290	-3410	0.03	0.08	6	0	-6
0014	3F	10_4	126	24	1	2400	2130	-270	0.04	0.89	4	3	-1
0014	3F	10_4	134	40	5	4000	2600	-1400	0.13	0.65	7	4	-3
0014	3F	10_4	135	24	2	2400	3220	820	0.08	1.34	4	5	1
0014	3F	10_4	136	9	0	900	0	-900	0.00	0.00	1	0	-1
0014	3F	10_4	145	16	0	1600	0	-1600	0.00	0.00	2	0	-2
0014	3F	10_4	146	7	1	700	2250	1550	0.14	3.21	1	3	2
0014	3F	10_4	156	2	0	200	0	-200	0.00	0.00	0	0	0
0014	3F	10_4	234	4	0	400	0	-400	0.00	0.00	0	0	0
0014	3F	10_4	235	4	0	400	0	-400	0.00	0.00	0	0	0
0014	3F	10_4	236	1	0	100	0	-100	0.00	0.00	0	0	0
0014	3F	10_4	245	3	0	300	0	-300	0.00	0.00	0	0	0
0014	3F	10_4	246	1	0	100	0	-100	0.00	0.00	0	0	0
0014	3F	10_5	123	70	19	7000	4980	-2020	0.27	0.71	12	8	-4
0014	3F	10_5	124	55	10	5500	5170	-330	0.18	0.94	9	9	0
0014	3F	10_5	125	24	4	2400	4730	2330	0.17	1.97	4	8	4
0014	3F	10_5	126	10	0	1000	0	-1000	0.00	0.00	1	0	-1
0014	3F	10_5	134	39	7	3900	5350	1450	0.18	1.37	6	9	3
0014	3F	10_5	135	10	1	1000	940	-60	0.10	0.94	1	1	0
0014	3F	10_5	136	10	1	1000	450	-550	0.10	0.45	1	0	-1
0014	3F	10_5	145	8	0	800	0	-800	0.00	0.00	1	0	-1
0014	3F	10_5	146	3	0	300	0	-300	0.00	0.00	0	0	0
0014	3F	10_5	156	1	0	100	0	-100	0.00	0.00	0	0	0
0014	3F	10_5	234	2	0	200	0	-200	0.00	0.00	0	0	0
0014	3F	10_5	235	1	0	100	0	-100	0.00	0.00	0	0	0
0014	3F	10_5	236	1	0	100	0	-100	0.00	0.00	0	0	0
0014	3F	10_5	245	2	0	200	0	-200	0.00	0.00	0	0	0
0014	3F	10_5	256	1	0	100	0	-100	0.00	0.00	0	0	0
0014	3F	10_6	123	3	0	300	0	-300	0.00	0.00	0	0	0
0014	3F	10_6	124	1	0	100	0	-100	0.00	0.00	0	0	0
0014	3F	10_6	125	1	0	100	0	-100	0.00	0.00	0	0	0
0014	3F	10_6	134	1	0	100	0	-100	0.00	0.00	0	0	0
0014	3F	10_6	136	1	0	100	0	-100	0.00	0.00	0	0	0
0014	3F	10_7	123	141	27	14100	10030	-4070	0.19	0.71	24	17	-7
0014	3F	10_7	124	75	15	7500	7710	210	0.20	1.03	13	13	0
0014	3F	10_7	125	45	2	4500	1390	-3110	0.04	0.31	7	2	-5
0014	3F	10_7	126	17	1	1700	1260	-440	0.06	0.74	3	2	-1
0014	3F	10_7	134	56	8	5600	5160	-440	0.14	0.92	9	9	0
0014	3F	10_7	135	11	1	1100	900	-200	0.09	0.82	1	1	0
0014	3F	10_7	136	6	0	600	0	-600	0.00	0.00	1	0	-1
0014	3F	10_7	145	7	2	700	2490	1790	0.29	3.56	1	4	3
0014	3F	10_7	146	7	2	700	3650	2950	0.29	5.21	1	6	5
0014	3F	10_7	156	1	0	100	0	-100	0.00	0.00	0	0	0
0014	3F	10_7	234	1	0	100	0	-100	0.00	0.00	0	0	0
0014	3F	10_7	236	1	0	100	0	-100	0.00	0.00	0	0	0
0014	3F	10_7	245	1	0	100	0	-100	0.00	0.00	0	0	0
0014	3F	10_7	246	3	0	300	0	-300	0.00	0.00	0	0	0
0014	3F	11_1	123	76	14	7600	6020	-1580	0.18	0.79	13	10	-3
0014	3F	11_1	124	52	13	5200	7730	2530	0.25	1.49	9	13	4
0014	3F	11_1	125	35	2	3500	700	-2800	0.06	0.20	6	1	-5
0014	3F	11_1	126	29	2	2900	1880	-1020	0.07	0.65	5	3	-2
0014	3F	11_1	134	43	9	4300	9100	4800	0.21	2.12	7	16	9
0014	3F	11_1	135	22	1	2200	300	-1900	0.05	0.14	3	0	-3
0014	3F	11_1	136	16	0	1600	0	-1600	0.00	0.00	2	0	-2
0014	3F	11_1	145	14	2	1400	1080	-320	0.14	0.77	2	1	-1
0014	3F	11_1	146	14	0	1400	0	-1400	0.00	0.00	2	0	-2
0014	3F	11_1	156	4	1	400	660	260	0.25	1.65	0	1	1
0014	3F	11_1	234	3	0	300	0	-300	0.00	0.00	0	0	0
0014	3F	11_1	235	2	0	200	0	-200	0.00	0.00	0	0	0
0014	3F	11_1	236	1	0	100	0	-100	0.00	0.00	0	0	0
0014	3F	11_1	245	3	0	300	0	-300	0.00	0.00	0	0	0
0014	3F	11_1	246	3	0	300	0	-300	0.00	0.00	0	0	0
0014	3F	11_2	123	80	14	8000	5590	-2410	0.18	0.70	14	9	-5
0014	3F	11_2	124	50	6	5000	2050	-2950	0.12	0.41	8	3	-5
0014	3F	11_2	125	20	2	2000	1040	-960	0.10	0.52	3	1	-2
0014	3F	11_2	126	35	6	3500	5880	2380	0.17	1.68	6	10	4
0014	3F	11_2	134	32	5	3200	1270	-1930	0.16	0.40	5	2	-3
0014	3F	11_2	135	17	3	1700	1280	-420	0.18	0.75	3	2	-1
0014	3F	11_2	136	21	2	2100	500	-1600	0.10	0.24	3	0	-3
0014	3F	11_2	145	13	2	1300	730	-570	0.15	0.56	2	1	-1
0014	3F	11_2	146	13	1	1300	880	-420	0.08	0.68	2	1	-1
0014	3F	11_2	156	5	0	500	0	-500	0.00	0.00	0	0	0
0014	3F	11_2	234	4	0	400	0	-400	0.00	0.00	0	0	0
0014	3F	11_2	236	3	0	300	0	-300	0.00	0.00	0	0	0
0014	3F	11_2	246	2	0	200	0	-200	0.00	0.00	0	0	0
0014	3F	11_3	123	84	16	8400	8040	-360	0.19	0.96	14	14	0
0014	3F	11_3	124	52	9	5200	3040	-2160	0.17	0.58	9	5	-4
0014	3F	11_3	125	23	2	2300	520	-1780	0.09	0.23	4	0	-4
0014	3F	11_3	126	27	3	2700	3140	440	0.11	1.16	4	5	1
0014	3F	11_3	134	35	3	3500	1200	-2300	0.09	0.34	6	2	-4
0014	3F	11_3	135	28	2	2800	1580	-1220	0.07	0.56	4	2	-2
0014	3F	11_3	136	15	0	1500	0	-1500	0.00	0.00	2	0	-2
0014	3F	11_3	145	9	1	900	250	-650	0.11	0.28	1	0	-1
0014	3F	11_3	146	6	1	600	490	-110	0.17	0.82	1	0	-1
0014	3F	11_3	156	3	0	300	0	-300	0.00	0.00	0	0	0
0014	3F	11_3	234	3	0	300	0	-300	0.00	0.00	0	0	0
0014	3F	11_3	235	5	1	500	550	50	0.20	1.10	0	0	0
0014	3F	11_3	236	3	0	300	0	-300	0.00	0.00	0	0	0
0014	3F	11_3	245	3	1	300	360	60	0.33	1.20	0	0	0
0014	3F	11_3	246	2	1	200	1370	1170	0.50	6.85	0	2	2
0014	3F	11_4	123	80	20	8000	8150	150	0.25	1.02	14	14	0
0014	3F	11_4	124	57	10	5700	3690	-2010	0.18	0.65	10	6	-4
0014	3F	11_4	125	33	2	3300	500	-2800	0.06	0.15	5	0	-5
0014	3F	11_4	126	14	0	1400	0	-1400	0.00	0.00	2	0	-2
0014	3F	11_4	134	32	7	3200	2020	-1180	0.22	0.63	5	3	-2
0014	3F	11_4	135	22	1	2200	820	-1380	0.05	0.37	3	1	-2
0014	3F	11_4	136	8	1	800	2580	1780	0.13	3.23	1	4	3
0014	3F	11_4	145	13	3	1300	7530	6230	0.23	5.79	2	13	11
0014	3F	11_4	146	2	0	200	0	-200	0.00	0.00	0	0	0
0014	3F	11_4	156	6	0	600	0	-600	0.00	0.00	1	0	-1
0014	3F	11_4	234	2	1	200	200	0	0.50	1.00	0	0	0
0014	3F	11_4	235	4	1	400	610	210	0.25	1.53	0	1	1
0014	3F	11_4	245	2	0	200	0	-200	0.00	0.00	0	0	0
0014	3F	11_4	246	4	0	400	0	-400	0.00	0.00	0	0	0
0014	3F	11_5	123	57	14	5700	5800	100	0.25	1.02	10	10	0
0014	3F	11_5	124	56	17	5600	7620	2020	0.30	1.36	9	13	4
0014	3F	11_5	125	26	3	2600	3090	490	0.12	1.19	4	5	1
0014	3F	11_5	126	24	5	2400	4140	1740	0.21	1.73	4	7	3
0014	3F	11_5	134	35	11	3500	7060	3560	0.31	2.02	6	12	6
0014	3F	11_5	135	14	2	1400	1560	160	0.14	1.11	2	2	0
0014	3F	11_5	136	14	0	1400	0	-1400	0.00	0.00	2	0	-2
0014	3F	11_5	145	5	0	500	0	-500	0.00	0.00	0	0	0
0014	3F	11_5	146	13	1	1300	300	-1000	0.08	0.23	2	0	-2
0014	3F	11_5	234	3	0	300	0	-300	0.00	0.00	0	0	0
0014	3F	11_5	235	1	1	100	2360	2260	1.00	23.60	0	4	4
0014	3F	11_5	236	1	0	100	0	-100	0.00	0.00	0	0	0
0014	3F	11_5	246	2	0	200	0	-200	0.00	0.00	0	0	0
0014	3F	11_7	123	87	17	8700	6490	-2210	0.20	0.75	15	11	-4
0014	3F	11_7	124	61	16	6100	6400	300	0.26	1.05	10	11	1
0014	3F	11_7	125	40	8	4000	4770	770	0.20	1.19	7	8	1
0014	3F	11_7	126	24	2	2400	2120	-280	0.08	0.88	4	3	-1
0014	3F	11_7	134	35	12	3500	4230	730	0.34	1.21	6	7	1
0014	3F	11_7	135	19	1	1900	780	-1120	0.05	0.41	3	1	-2
0014	3F	11_7	136	10	2	1000	2010	1010	0.20	2.01	1	3	2
0014	3F	11_7	145	8	1	800	710	-90	0.13	0.89	1	1	0
0014	3F	11_7	146	9	1	900	650	-250	0.11	0.72	1	1	0
0014	3F	11_7	156	3	0	300	0	-300	0.00	0.00	0	0	0
0014	3F	11_7	234	1	0	100	0	-100	0.00	0.00	0	0	0
0014	3F	11_7	235	1	0	100	0	-100	0.00	0.00	0	0	0
0014	3F	11_7	245	4	0	400	0	-400	0.00	0.00	0	0	0
0014	3F	11_7	256	1	0	100	0	-100	0.00	0.00	0	0	0
0014	3F	12_1	123	68	16	6800	6640	-160	0.24	0.98	12	11	-1
0014	3F	12_1	124	54	8	5400	3590	-1810	0.15	0.66	9	6	-3
0014	3F	12_1	125	49	6	4900	2840	-2060	0.12	0.58	8	5	-3
0014	3F	12_1	126	35	4	3500	4310	810	0.11	1.23	6	7	1
0014	3F	12_1	134	33	4	3300	2360	-940	0.12	0.72	5	4	-1
0014	3F	12_1	135	28	2	2800	850	-1950	0.07	0.30	4	1	-3
0014	3F	12_1	136	23	1	2300	130	-2170	0.04	0.06	4	0	-4
0014	3F	12_1	145	11	0	1100	0	-1100	0.00	0.00	1	0	-1
0014	3F	12_1	146	10	1	1000	480	-520	0.10	0.48	1	0	-1
0014	3F	12_1	156	10	2	1000	1570	570	0.20	1.57	1	2	1
0014	3F	12_1	234	2	0	200	0	-200	0.00	0.00	0	0	0
0014	3F	12_1	236	1	0	100	0	-100	0.00	0.00	0	0	0
0014	3F	12_1	245	1	0	100	0	-100	0.00	0.00	0	0	0
0014	3F	12_1	246	1	0	100	0	-100	0.00	0.00	0	0	0
0014	3F	12_1	256	1	0	100	0	-100	0.00	0.00	0	0	0
0014	3F	12_2	123	66	21	6600	8720	2120	0.32	1.32	11	15	4
0014	3F	12_2	124	50	6	5000	1930	-3070	0.12	0.39	8	3	-5
0014	3F	12_2	125	33	2	3300	430	-2870	0.06	0.13	5	0	-5
0014	3F	12_2	126	38	4	3800	1630	-2170	0.11	0.43	6	2	-4
0014	3F	12_2	134	42	7	4200	3360	-840	0.17	0.80	7	5	-2
0014	3F	12_2	135	24	3	2400	1570	-830	0.13	0.65	4	2	-2
0014	3F	12_2	136	20	0	2000	0	-2000	0.00	0.00	3	0	-3
0014	3F	12_2	145	9	1	900	800	-100	0.11	0.89	1	1	0
0014	3F	12_2	146	13	0	1300	0	-1300	0.00	0.00	2	0	-2
0014	3F	12_2	156	8	2	800	770	-30	0.25	0.96	1	1	0
0014	3F	12_2	234	6	0	600	0	-600	0.00	0.00	1	0	-1
0014	3F	12_2	235	1	0	100	0	-100	0.00	0.00	0	0	0
0014	3F	12_2	236	1	0	100	0	-100	0.00	0.00	0	0	0
0014	3F	12_2	245	1	0	100	0	-100	0.00	0.00	0	0	0
0014	3F	12_2	246	1	0	100	0	-100	0.00	0.00	0	0	0
0014	3F	12_2	256	2	0	200	0	-200	0.00	0.00	0	0	0
0014	3F	12_3	123	62	13	6200	4620	-1580	0.21	0.75	10	8	-2
0014	3F	12_3	124	69	14	6900	7820	920	0.20	1.13	12	13	1
0014	3F	12_3	125	34	4	3400	4120	720	0.12	1.21	6	7	1
0014	3F	12_3	126	30	5	3000	4270	1270	0.17	1.42	5	7	2
0014	3F	12_3	134	36	5	3600	1520	-2080	0.14	0.42	6	2	-4
0014	3F	12_3	135	26	1	2600	660	-1940	0.04	0.25	4	1	-3
0014	3F	12_3	136	19	0	1900	0	-1900	0.00	0.00	3	0	-3
0014	3F	12_3	145	16	2	1600	1080	-520	0.13	0.68	2	1	-1
0014	3F	12_3	146	12	1	1200	740	-460	0.08	0.62	2	1	-1
0014	3F	12_3	156	8	1	800	190	-610	0.13	0.24	1	0	-1
0014	3F	12_3	234	7	0	700	0	-700	0.00	0.00	1	0	-1
0014	3F	12_3	235	3	0	300	0	-300	0.00	0.00	0	0	0
0014	3F	12_3	256	3	0	300	0	-300	0.00	0.00	0	0	0
0014	3F	12_4	123	68	16	6800	7290	490	0.24	1.07	12	12	0
0014	3F	12_4	124	50	12	5000	3520	-1480	0.24	0.70	8	6	-2
0014	3F	12_4	125	34	4	3400	3730	330	0.12	1.10	6	6	0
0014	3F	12_4	126	26	2	2600	1670	-930	0.08	0.64	4	2	-2
0014	3F	12_4	134	24	3	2400	1800	-600	0.13	0.75	4	3	-1
0014	3F	12_4	135	19	1	1900	310	-1590	0.05	0.16	3	0	-3
0014	3F	12_4	136	15	3	1500	3840	2340	0.20	2.56	2	6	4
0014	3F	12_4	145	12	1	1200	380	-820	0.08	0.32	2	0	-2
0014	3F	12_4	146	8	0	800	0	-800	0.00	0.00	1	0	-1
0014	3F	12_4	156	7	1	700	420	-280	0.14	0.60	1	0	-1
0014	3F	12_4	234	2	0	200	0	-200	0.00	0.00	0	0	0
0014	3F	12_4	235	3	2	300	1670	1370	0.67	5.57	0	2	2
0014	3F	12_4	236	2	0	200	0	-200	0.00	0.00	0	0	0
0014	3F	12_4	245	5	1	500	460	-40	0.20	0.92	0	0	0
0014	3F	12_4	246	3	0	300	0	-300	0.00	0.00	0	0	0
0014	3F	12_4	256	2	0	200	0	-200	0.00	0.00	0	0	0
0014	3F	12_5	123	53	14	5300	4050	-1250	0.26	0.76	9	7	-2
0014	3F	12_5	124	56	7	5600	3230	-2370	0.13	0.58	9	5	-4
0014	3F	12_5	125	34	1	3400	200	-3200	0.03	0.06	6	0	-6
0014	3F	12_5	126	22	2	2200	410	-1790	0.09	0.19	3	0	-3
0014	3F	12_5	134	25	4	2500	2070	-430	0.16	0.83	4	3	-1
0014	3F	12_5	135	20	1	2000	340	-1660	0.05	0.17	3	0	-3
0014	3F	12_5	136	13	1	1300	450	-850	0.08	0.35	2	0	-2
0014	3F	12_5	145	17	3	1700	4820	3120	0.18	2.84	3	8	5
0014	3F	12_5	146	9	0	900	0	-900	0.00	0.00	1	0	-1
0014	3F	12_5	156	2	0	200	0	-200	0.00	0.00	0	0	0
0014	3F	12_5	234	2	0	200	0	-200	0.00	0.00	0	0	0
0014	3F	12_5	235	1	0	100	0	-100	0.00	0.00	0	0	0
0014	3F	12_6	123	9	3	900	840	-60	0.33	0.93	1	1	0
0014	3F	12_6	124	8	1	800	380	-420	0.13	0.48	1	0	-1
0014	3F	12_6	125	2	0	200	0	-200	0.00	0.00	0	0	0
0014	3F	12_6	126	2	0	200	0	-200	0.00	0.00	0	0	0
0014	3F	12_6	134	2	1	200	220	20	0.50	1.10	0	0	0
0014	3F	12_6	135	2	0	200	0	-200	0.00	0.00	0	0	0
0014	3F	12_6	136	1	0	100	0	-100	0.00	0.00	0	0	0
0014	3F	12_7	123	87	19	8700	6600	-2100	0.22	0.76	15	11	-4
0014	3F	12_7	124	67	11	6700	5210	-1490	0.16	0.78	11	9	-2
0014	3F	12_7	125	39	6	3900	2960	-940	0.15	0.76	6	5	-1
0014	3F	12_7	126	30	5	3000	2690	-310	0.17	0.90	5	4	-1
0014	3F	12_7	134	39	10	3900	4090	190	0.26	1.05	6	7	1
0014	3F	12_7	135	26	2	2600	710	-1890	0.08	0.27	4	1	-3
0014	3F	12_7	136	19	1	1900	310	-1590	0.05	0.16	3	0	-3
0014	3F	12_7	145	14	4	1400	3400	2000	0.29	2.43	2	6	4
0014	3F	12_7	146	6	0	600	0	-600	0.00	0.00	1	0	-1
0014	3F	12_7	156	3	0	300	0	-300	0.00	0.00	0	0	0
0014	3F	12_7	234	1	0	100	0	-100	0.00	0.00	0	0	0
0014	3F	12_7	235	5	0	500	0	-500	0.00	0.00	0	0	0
0014	3F	12_7	245	1	0	100	0	-100	0.00	0.00	0	0	0
0014	3F	12_7	256	1	0	100	0	-100	0.00	0.00	0	0	0
0014	3F	13_1	123	82	15	8200	6690	-1510	0.18	0.82	14	11	-3
0014	3F	13_1	124	86	19	8600	9100	500	0.22	1.06	15	16	1
0014	3F	13_1	125	31	4	3100	2710	-390	0.13	0.87	5	4	-1
0014	3F	13_1	126	21	2	2100	1840	-260	0.10	0.88	3	3	0
0014	3F	13_1	134	43	7	4300	1650	-2650	0.16	0.38	7	2	-5
0014	3F	13_1	135	25	0	2500	0	-2500	0.00	0.00	4	0	-4
0014	3F	13_1	136	14	1	1400	260	-1140	0.07	0.19	2	0	-2
0014	3F	13_1	145	14	0	1400	0	-1400	0.00	0.00	2	0	-2
0014	3F	13_1	146	14	2	1400	3030	1630	0.14	2.16	2	5	3
0014	3F	13_1	156	3	0	300	0	-300	0.00	0.00	0	0	0
0014	3F	13_1	234	6	1	600	250	-350	0.17	0.42	1	0	-1
0014	3F	13_1	235	2	0	200	0	-200	0.00	0.00	0	0	0
0014	3F	13_1	236	1	1	100	3700	3600	1.00	37.00	0	6	6
0014	3F	13_1	245	2	0	200	0	-200	0.00	0.00	0	0	0
0014	3F	13_1	246	2	0	200	0	-200	0.00	0.00	0	0	0
0014	3F	13_1	256	1	0	100	0	-100	0.00	0.00	0	0	0
0014	3F	13_2	123	81	19	8100	8520	420	0.23	1.05	14	15	1
0014	3F	13_2	124	52	10	5200	4130	-1070	0.19	0.79	9	7	-2
0014	3F	13_2	125	44	9	4400	9700	5300	0.20	2.20	7	17	10
0014	3F	13_2	126	26	3	2600	1820	-780	0.12	0.70	4	3	-1
0014	3F	13_2	134	38	4	3800	1520	-2280	0.11	0.40	6	2	-4
0014	3F	13_2	135	31	8	3100	7810	4710	0.26	2.52	5	13	8
0014	3F	13_2	136	12	2	1200	750	-450	0.17	0.63	2	1	-1
0014	3F	13_2	145	9	1	900	530	-370	0.11	0.59	1	0	-1
0014	3F	13_2	146	10	1	1000	760	-240	0.10	0.76	1	1	0
0014	3F	13_2	156	3	0	300	0	-300	0.00	0.00	0	0	0
0014	3F	13_2	234	3	0	300	0	-300	0.00	0.00	0	0	0
0014	3F	13_2	235	4	0	400	0	-400	0.00	0.00	0	0	0
0014	3F	13_2	236	2	0	200	0	-200	0.00	0.00	0	0	0
0014	3F	13_2	245	4	0	400	0	-400	0.00	0.00	0	0	0
0014	3F	13_2	246	1	0	100	0	-100	0.00	0.00	0	0	0
0014	3F	13_2	256	3	0	300	0	-300	0.00	0.00	0	0	0
0014	3F	13_3	123	63	10	6300	3840	-2460	0.16	0.61	11	6	-5
0014	3F	13_3	124	52	9	5200	4410	-790	0.17	0.85	9	7	-2
0014	3F	13_3	125	41	7	4100	4290	190	0.17	1.05	7	7	0
0014	3F	13_3	126	23	2	2300	940	-1360	0.09	0.41	4	1	-3
0014	3F	13_3	134	34	3	3400	960	-2440	0.09	0.28	6	1	-5
0014	3F	13_3	135	22	2	2200	970	-1230	0.09	0.44	3	1	-2
0014	3F	13_3	136	18	0	1800	0	-1800	0.00	0.00	3	0	-3
0014	3F	13_3	145	15	1	1500	320	-1180	0.07	0.21	2	0	-2
0014	3F	13_3	146	7	2	700	1450	750	0.29	2.07	1	2	1
0014	3F	13_3	156	10	2	1000	1800	800	0.20	1.80	1	3	2
0014	3F	13_3	234	4	1	400	380	-20	0.25	0.95	0	0	0
0014	3F	13_3	235	3	0	300	0	-300	0.00	0.00	0	0	0
0014	3F	13_3	236	2	0	200	0	-200	0.00	0.00	0	0	0
0014	3F	13_3	245	2	0	200	0	-200	0.00	0.00	0	0	0
0014	3F	13_3	246	1	0	100	0	-100	0.00	0.00	0	0	0
0014	3F	13_3	256	1	0	100	0	-100	0.00	0.00	0	0	0
0014	3F	13_4	123	72	14	7200	7360	160	0.19	1.02	12	13	1
0014	3F	13_4	124	58	14	5800	5460	-340	0.24	0.94	10	9	-1
0014	3F	13_4	125	26	4	2600	2770	170	0.15	1.07	4	4	0
0014	3F	13_4	126	20	2	2000	1430	-570	0.10	0.72	3	2	-1
0014	3F	13_4	134	37	7	3700	2720	-980	0.19	0.74	6	4	-2
0014	3F	13_4	135	25	4	2500	3090	590	0.16	1.24	4	5	1
0014	3F	13_4	136	19	2	1900	980	-920	0.11	0.52	3	1	-2
0014	3F	13_4	145	15	0	1500	0	-1500	0.00	0.00	2	0	-2
0014	3F	13_4	146	6	1	600	2500	1900	0.17	4.17	1	4	3
0014	3F	13_4	156	2	0	200	0	-200	0.00	0.00	0	0	0
0014	3F	13_4	235	2	0	200	0	-200	0.00	0.00	0	0	0
0014	3F	13_4	236	5	0	500	0	-500	0.00	0.00	0	0	0
0014	3F	13_4	245	2	0	200	0	-200	0.00	0.00	0	0	0
0014	3F	13_4	246	3	0	300	0	-300	0.00	0.00	0	0	0
0014	3F	13_4	256	1	0	100	0	-100	0.00	0.00	0	0	0
0014	3F	13_5	123	61	11	6100	3350	-2750	0.18	0.55	10	5	-5
0014	3F	13_5	124	53	8	5300	2630	-2670	0.15	0.50	9	4	-5
0014	3F	13_5	125	38	2	3800	980	-2820	0.05	0.26	6	1	-5
0014	3F	13_5	126	16	3	1600	1790	190	0.19	1.12	2	3	1
0014	3F	13_5	134	36	8	3600	3600	0	0.22	1.00	6	6	0
0014	3F	13_5	135	20	2	2000	700	-1300	0.10	0.35	3	1	-2
0014	3F	13_5	136	17	2	1700	800	-900	0.12	0.47	3	1	-2
0014	3F	13_5	145	9	1	900	580	-320	0.11	0.64	1	1	0
0014	3F	13_5	146	6	1	600	200	-400	0.17	0.33	1	0	-1
0014	3F	13_5	156	4	0	400	0	-400	0.00	0.00	0	0	0
0014	3F	13_5	234	3	0	300	0	-300	0.00	0.00	0	0	0
0014	3F	13_5	236	1	1	100	470	370	1.00	4.70	0	0	0
0014	3F	13_5	245	1	0	100	0	-100	0.00	0.00	0	0	0
0014	3F	13_6	123	7	0	700	0	-700	0.00	0.00	1	0	-1
0014	3F	13_6	124	7	0	700	0	-700	0.00	0.00	1	0	-1
0014	3F	13_6	125	6	0	600	0	-600	0.00	0.00	1	0	-1
0014	3F	13_6	126	2	1	200	280	80	0.50	1.40	0	0	0
0014	3F	13_6	134	7	0	700	0	-700	0.00	0.00	1	0	-1
0014	3F	13_6	135	3	0	300	0	-300	0.00	0.00	0	0	0
0014	3F	13_6	136	3	0	300	0	-300	0.00	0.00	0	0	0
0014	3F	13_6	145	1	0	100	0	-100	0.00	0.00	0	0	0
0014	3F	13_6	146	2	0	200	0	-200	0.00	0.00	0	0	0
0014	3F	13_7	123	85	19	8500	7070	-1430	0.22	0.83	15	12	-3
0014	3F	13_7	124	75	9	7500	2850	-4650	0.12	0.38	13	5	-8
0014	3F	13_7	125	25	2	2500	1640	-860	0.08	0.66	4	2	-2
0014	3F	13_7	126	22	0	2200	0	-2200	0.00	0.00	3	0	-3
0014	3F	13_7	134	46	8	4600	3830	-770	0.17	0.83	8	6	-2
0014	3F	13_7	135	30	2	3000	1780	-1220	0.07	0.59	5	3	-2
0014	3F	13_7	136	10	2	1000	630	-370	0.20	0.63	1	1	0
0014	3F	13_7	145	17	1	1700	730	-970	0.06	0.43	3	1	-2
0014	3F	13_7	146	11	1	1100	210	-890	0.09	0.19	1	0	-1
0014	3F	13_7	156	2	0	200	0	-200	0.00	0.00	0	0	0
0014	3F	13_7	234	1	0	100	0	-100	0.00	0.00	0	0	0
0014	3F	13_7	235	3	0	300	0	-300	0.00	0.00	0	0	0
0014	3F	13_7	236	1	0	100	0	-100	0.00	0.00	0	0	0
0014	3F	13_7	245	3	0	300	0	-300	0.00	0.00	0	0	0
0014	3F	13_7	246	1	0	100	0	-100	0.00	0.00	0	0	0
0014	3F	14_1	123	91	17	9100	6860	-2240	0.19	0.75	16	12	-4
0014	3F	14_1	124	67	7	6700	2120	-4580	0.10	0.32	11	3	-8
0014	3F	14_1	125	40	4	4000	3410	-590	0.10	0.85	7	6	-1
0014	3F	14_1	126	26	2	2600	1690	-910	0.08	0.65	4	2	-2
0014	3F	14_1	134	40	3	4000	2340	-1660	0.08	0.59	7	4	-3
0014	3F	14_1	135	25	2	2500	870	-1630	0.08	0.35	4	1	-3
0014	3F	14_1	136	13	0	1300	0	-1300	0.00	0.00	2	0	-2
0014	3F	14_1	145	15	1	1500	640	-860	0.07	0.43	2	1	-1
0014	3F	14_1	146	9	0	900	0	-900	0.00	0.00	1	0	-1
0014	3F	14_1	156	2	0	200	0	-200	0.00	0.00	0	0	0
0014	3F	14_1	234	4	0	400	0	-400	0.00	0.00	0	0	0
0014	3F	14_1	235	6	0	600	0	-600	0.00	0.00	1	0	-1
0014	3F	14_1	236	1	0	100	0	-100	0.00	0.00	0	0	0
0014	3F	14_1	245	4	0	400	0	-400	0.00	0.00	0	0	0
0014	3F	14_1	246	2	0	200	0	-200	0.00	0.00	0	0	0
0014	3F	14_1	256	1	0	100	0	-100	0.00	0.00	0	0	0
0014	3F	14_2	123	62	3	6200	1070	-5130	0.05	0.17	10	1	-9
0014	3F	14_2	124	76	12	7600	5240	-2360	0.16	0.69	13	9	-4
0014	3F	14_2	125	26	3	2600	3710	1110	0.12	1.43	4	6	2
0014	3F	14_2	126	27	2	2700	3660	960	0.07	1.36	4	6	2
0014	3F	14_2	134	44	7	4400	5960	1560	0.16	1.35	7	10	3
0014	3F	14_2	135	27	1	2700	610	-2090	0.04	0.23	4	1	-3
0014	3F	14_2	136	12	0	1200	0	-1200	0.00	0.00	2	0	-2
0014	3F	14_2	145	18	2	1800	1170	-630	0.11	0.65	3	2	-1
0014	3F	14_2	146	15	1	1500	270	-1230	0.07	0.18	2	0	-2
0014	3F	14_2	156	6	0	600	0	-600	0.00	0.00	1	0	-1
0014	3F	14_2	234	6	0	600	0	-600	0.00	0.00	1	0	-1
0014	3F	14_2	235	3	1	300	5530	5230	0.33	18.43	0	9	9
0014	3F	14_2	236	2	0	200	0	-200	0.00	0.00	0	0	0
0014	3F	14_2	245	2	0	200	0	-200	0.00	0.00	0	0	0
0014	3F	14_2	256	1	0	100	0	-100	0.00	0.00	0	0	0
0014	3F	14_3	123	61	11	6100	4870	-1230	0.18	0.80	10	8	-2
0014	3F	14_3	124	74	12	7400	3560	-3840	0.16	0.48	13	6	-7
0014	3F	14_3	125	47	6	4700	4660	-40	0.13	0.99	8	8	0
0014	3F	14_3	126	28	0	2800	0	-2800	0.00	0.00	4	0	-4
0014	3F	14_3	134	50	5	5000	2700	-2300	0.10	0.54	8	4	-4
0014	3F	14_3	135	32	5	3200	8060	4860	0.16	2.52	5	14	9
0014	3F	14_3	136	13	0	1300	0	-1300	0.00	0.00	2	0	-2
0014	3F	14_3	145	22	1	2200	1110	-1090	0.05	0.50	3	1	-2
0014	3F	14_3	146	13	1	1300	1790	490	0.08	1.38	2	3	1
0014	3F	14_3	156	6	0	600	0	-600	0.00	0.00	1	0	-1
0014	3F	14_3	234	9	0	900	0	-900	0.00	0.00	1	0	-1
0014	3F	14_3	235	4	0	400	0	-400	0.00	0.00	0	0	0
0014	3F	14_3	236	4	0	400	0	-400	0.00	0.00	0	0	0
0014	3F	14_3	245	3	0	300	0	-300	0.00	0.00	0	0	0
0014	3F	14_4	123	55	7	5500	3120	-2380	0.13	0.57	9	5	-4
0014	3F	14_4	124	53	5	5300	2610	-2690	0.09	0.49	9	4	-5
0014	3F	14_4	125	36	5	3600	2180	-1420	0.14	0.61	6	3	-3
0014	3F	14_4	126	26	3	2600	5220	2620	0.12	2.01	4	9	5
0014	3F	14_4	134	53	5	5300	3110	-2190	0.09	0.59	9	5	-4
0014	3F	14_4	135	16	1	1600	380	-1220	0.06	0.24	2	0	-2
0014	3F	14_4	136	14	3	1400	2850	1450	0.21	2.04	2	5	3
0014	3F	14_4	145	15	3	1500	4150	2650	0.20	2.77	2	7	5
0014	3F	14_4	146	10	0	1000	0	-1000	0.00	0.00	1	0	-1
0014	3F	14_4	156	2	1	200	210	10	0.50	1.05	0	0	0
0014	3F	14_4	234	5	0	500	0	-500	0.00	0.00	0	0	0
0014	3F	14_4	235	1	0	100	0	-100	0.00	0.00	0	0	0
0014	3F	14_4	236	1	0	100	0	-100	0.00	0.00	0	0	0
0014	3F	14_4	245	2	0	200	0	-200	0.00	0.00	0	0	0
0014	3F	14_4	246	1	0	100	0	-100	0.00	0.00	0	0	0
0014	3F	14_4	256	1	0	100	0	-100	0.00	0.00	0	0	0
0014	3F	14_5	123	47	3	4700	1490	-3210	0.06	0.32	8	2	-6
0014	3F	14_5	124	31	5	3100	3800	700	0.16	1.23	5	6	1
0014	3F	14_5	125	19	2	1900	1730	-170	0.11	0.91	3	3	0
0014	3F	14_5	126	13	1	1300	590	-710	0.08	0.45	2	1	-1
0014	3F	14_5	134	21	1	2100	410	-1690	0.05	0.20	3	0	-3
0014	3F	14_5	135	16	1	1600	690	-910	0.06	0.43	2	1	-1
0014	3F	14_5	136	13	0	1300	0	-1300	0.00	0.00	2	0	-2
0014	3F	14_5	145	7	1	700	1270	570	0.14	1.81	1	2	1
0014	3F	14_5	146	4	0	400	0	-400	0.00	0.00	0	0	0
0014	3F	14_5	156	2	0	200	0	-200	0.00	0.00	0	0	0
0014	3F	14_5	234	2	1	200	1690	1490	0.50	8.45	0	2	2
0014	3F	14_5	235	2	1	200	4140	3940	0.50	20.70	0	7	7
0014	3F	14_5	236	2	0	200	0	-200	0.00	0.00	0	0	0
0014	3F	14_5	246	1	0	100	0	-100	0.00	0.00	0	0	0
0014	3F	14_6	123	4	1	400	420	20	0.25	1.05	0	0	0
0014	3F	14_6	124	3	0	300	0	-300	0.00	0.00	0	0	0
0014	3F	14_6	125	1	0	100	0	-100	0.00	0.00	0	0	0
0014	3F	14_6	126	2	0	200	0	-200	0.00	0.00	0	0	0
0014	3F	14_6	134	2	0	200	0	-200	0.00	0.00	0	0	0
0014	3F	14_6	135	1	0	100	0	-100	0.00	0.00	0	0	0
0014	3F	14_6	145	1	0	100	0	-100	0.00	0.00	0	0	0
0014	3F	14_6	146	1	0	100	0	-100	0.00	0.00	0	0	0
0014	3F	14_6	234	1	0	100	0	-100	0.00	0.00	0	0	0
0014	3F	14_7	123	81	15	8100	7450	-650	0.19	0.92	14	13	-1
0014	3F	14_7	124	75	18	7500	9010	1510	0.24	1.20	13	15	2
0014	3F	14_7	125	43	6	4300	3400	-900	0.14	0.79	7	6	-1
0014	3F	14_7	126	18	0	1800	0	-1800	0.00	0.00	3	0	-3
0014	3F	14_7	134	48	2	4800	860	-3940	0.04	0.18	8	1	-7
0014	3F	14_7	135	32	3	3200	2730	-470	0.09	0.85	5	4	-1
0014	3F	14_7	136	14	3	1400	4490	3090	0.21	3.21	2	7	5
0014	3F	14_7	145	20	1	2000	370	-1630	0.05	0.19	3	0	-3
0014	3F	14_7	146	10	0	1000	0	-1000	0.00	0.00	1	0	-1
0014	3F	14_7	156	4	0	400	0	-400	0.00	0.00	0	0	0
0014	3F	14_7	234	2	0	200	0	-200	0.00	0.00	0	0	0
0014	3F	14_7	235	3	0	300	0	-300	0.00	0.00	0	0	0
0014	3F	14_7	236	4	0	400	0	-400	0.00	0.00	0	0	0
0014	3F	14_7	245	3	1	300	1520	1220	0.33	5.07	0	2	2
0014	3F	14_7	246	2	1	200	5210	5010	0.50	26.05	0	9	9
0014	3F	15_1	123	78	7	7800	3310	-4490	0.09	0.42	13	5	-8
0014	3F	15_1	124	74	9	7400	2590	-4810	0.12	0.35	13	4	-9
0014	3F	15_1	125	35	9	3500	4690	1190	0.26	1.34	6	8	2
0014	3F	15_1	126	36	4	3600	5770	2170	0.11	1.60	6	10	4
0014	3F	15_1	134	47	11	4700	9220	4520	0.23	1.96	8	16	8
0014	3F	15_1	135	33	4	3300	2530	-770	0.12	0.77	5	4	-1
0014	3F	15_1	136	21	4	2100	2210	110	0.19	1.05	3	3	0
0014	3F	15_1	145	10	1	1000	410	-590	0.10	0.41	1	0	-1
0014	3F	15_1	146	7	0	700	0	-700	0.00	0.00	1	0	-1
0014	3F	15_1	156	5	0	500	0	-500	0.00	0.00	0	0	0
0014	3F	15_1	234	5	1	500	1600	1100	0.20	3.20	0	2	2
0014	3F	15_1	235	1	0	100	0	-100	0.00	0.00	0	0	0
0014	3F	15_1	236	2	0	200	0	-200	0.00	0.00	0	0	0
0014	3F	15_1	245	3	0	300	0	-300	0.00	0.00	0	0	0
0014	3F	15_1	256	1	0	100	0	-100	0.00	0.00	0	0	0
0014	3F	15_2	123	87	19	8700	8140	-560	0.22	0.94	15	14	-1
0014	3F	15_2	124	83	16	8300	4750	-3550	0.19	0.57	14	8	-6
0014	3F	15_2	125	42	4	4200	4090	-110	0.10	0.97	7	7	0
0014	3F	15_2	126	27	3	2700	2680	-20	0.11	0.99	4	4	0
0014	3F	15_2	134	42	5	4200	3540	-660	0.12	0.84	7	6	-1
0014	3F	15_2	135	20	3	2000	900	-1100	0.15	0.45	3	1	-2
0014	3F	15_2	136	22	4	2200	3700	1500	0.18	1.68	3	6	3
0014	3F	15_2	145	19	3	1900	2670	770	0.16	1.41	3	4	1
0014	3F	15_2	146	15	1	1500	1600	100	0.07	1.07	2	2	0
0014	3F	15_2	156	11	3	1100	3740	2640	0.27	3.40	1	6	5
0014	3F	15_2	234	1	0	100	0	-100	0.00	0.00	0	0	0
0014	3F	15_2	235	7	1	700	330	-370	0.14	0.47	1	0	-1
0014	3F	15_2	236	4	2	400	1390	990	0.50	3.48	0	2	2
0014	3F	15_2	256	2	1	200	500	300	0.50	2.50	0	0	0
0014	3F	15_3	123	83	12	8300	3800	-4500	0.14	0.46	14	6	-8
0014	3F	15_3	124	71	16	7100	7470	370	0.23	1.05	12	13	1
0014	3F	15_3	125	45	5	4500	2740	-1760	0.11	0.61	7	4	-3
0014	3F	15_3	126	32	4	3200	7890	4690	0.13	2.47	5	13	8
0014	3F	15_3	134	41	7	4100	2810	-1290	0.17	0.69	7	4	-3
0014	3F	15_3	135	28	4	2800	2620	-180	0.14	0.94	4	4	0
0014	3F	15_3	136	16	1	1600	400	-1200	0.06	0.25	2	0	-2
0014	3F	15_3	145	22	5	2200	4100	1900	0.23	1.86	3	7	4
0014	3F	15_3	146	12	1	1200	220	-980	0.08	0.18	2	0	-2
0014	3F	15_3	156	1	0	100	0	-100	0.00	0.00	0	0	0
0014	3F	15_3	234	4	1	400	3390	2990	0.25	8.48	0	6	6
0014	3F	15_3	235	2	1	200	400	200	0.50	2.00	0	0	0
0014	3F	15_3	236	1	0	100	0	-100	0.00	0.00	0	0	0
0014	3F	15_3	246	3	1	300	680	380	0.33	2.27	0	1	1
0014	3F	15_3	256	2	0	200	0	-200	0.00	0.00	0	0	0
0014	3F	15_4	123	64	17	6400	7360	960	0.27	1.15	11	13	2
0014	3F	15_4	124	73	15	7300	5110	-2190	0.21	0.70	12	9	-3
0014	3F	15_4	125	27	4	2700	2880	180	0.15	1.07	4	5	1
0014	3F	15_4	126	21	2	2100	1580	-520	0.10	0.75	3	2	-1
0014	3F	15_4	134	49	8	4900	3510	-1390	0.16	0.72	8	6	-2
0014	3F	15_4	135	21	3	2100	1080	-1020	0.14	0.51	3	1	-2
0014	3F	15_4	136	19	0	1900	0	-1900	0.00	0.00	3	0	-3
0014	3F	15_4	145	11	2	1100	1730	630	0.18	1.57	1	3	2
0014	3F	15_4	146	11	0	1100	0	-1100	0.00	0.00	1	0	-1
0014	3F	15_4	156	8	2	800	5690	4890	0.25	7.11	1	10	9
0014	3F	15_4	234	3	0	300	0	-300	0.00	0.00	0	0	0
0014	3F	15_4	235	4	1	400	260	-140	0.25	0.65	0	0	0
0014	3F	15_4	245	5	1	500	370	-130	0.20	0.74	0	0	0
0014	3F	15_4	246	1	0	100	0	-100	0.00	0.00	0	0	0
0014	3F	15_5	123	60	20	6000	7100	1100	0.33	1.18	10	12	2
0014	3F	15_5	124	58	11	5800	3380	-2420	0.19	0.58	10	5	-5
0014	3F	15_5	125	31	3	3100	1340	-1760	0.10	0.43	5	2	-3
0014	3F	15_5	126	32	1	3200	380	-2820	0.03	0.12	5	0	-5
0014	3F	15_5	134	27	5	2700	2340	-360	0.19	0.87	4	4	0
0014	3F	15_5	135	18	2	1800	780	-1020	0.11	0.43	3	1	-2
0014	3F	15_5	136	14	1	1400	1580	180	0.07	1.13	2	2	0
0014	3F	15_5	145	8	0	800	0	-800	0.00	0.00	1	0	-1
0014	3F	15_5	146	2	1	200	330	130	0.50	1.65	0	0	0
0014	3F	15_5	156	6	2	600	980	380	0.33	1.63	1	1	0
0014	3F	15_5	234	1	0	100	0	-100	0.00	0.00	0	0	0
0014	3F	15_5	235	1	0	100	0	-100	0.00	0.00	0	0	0
0014	3F	15_5	245	2	0	200	0	-200	0.00	0.00	0	0	0
0014	3F	15_6	123	14	3	1400	1510	110	0.21	1.08	2	2	0
0014	3F	15_6	124	10	2	1000	710	-290	0.20	0.71	1	1	0
0014	3F	15_6	125	2	1	200	970	770	0.50	4.85	0	1	1
0014	3F	15_6	126	2	1	200	430	230	0.50	2.15	0	0	0
0014	3F	15_6	134	8	1	800	390	-410	0.13	0.49	1	0	-1
0014	3F	15_6	135	5	0	500	0	-500	0.00	0.00	0	0	0
0014	3F	15_6	136	2	0	200	0	-200	0.00	0.00	0	0	0
0014	3F	15_6	145	2	0	200	0	-200	0.00	0.00	0	0	0
0014	3F	15_6	146	2	0	200	0	-200	0.00	0.00	0	0	0
0014	3F	15_6	156	1	0	100	0	-100	0.00	0.00	0	0	0
0014	3F	15_6	245	1	0	100	0	-100	0.00	0.00	0	0	0
0014	3F	15_7	123	104	26	10400	10470	70	0.25	1.01	18	18	0
0014	3F	15_7	124	79	18	7900	5540	-2360	0.23	0.70	13	9	-4
0014	3F	15_7	125	43	5	4300	2960	-1340	0.12	0.69	7	5	-2
0014	3F	15_7	126	42	9	4200	5960	1760	0.21	1.42	7	10	3
0014	3F	15_7	134	48	9	4800	3600	-1200	0.19	0.75	8	6	-2
0014	3F	15_7	135	20	2	2000	1470	-530	0.10	0.74	3	2	-1
0014	3F	15_7	136	18	0	1800	0	-1800	0.00	0.00	3	0	-3
0014	3F	15_7	145	19	1	1900	1510	-390	0.05	0.79	3	2	-1
0014	3F	15_7	146	15	1	1500	2090	590	0.07	1.39	2	3	1
0014	3F	15_7	156	8	2	800	2620	1820	0.25	3.28	1	4	3
0014	3F	15_7	234	1	0	100	0	-100	0.00	0.00	0	0	0
0014	3F	15_7	236	1	0	100	0	-100	0.00	0.00	0	0	0
0014	3F	16_1	123	97	23	9700	9380	-320	0.24	0.97	17	16	-1
0014	3F	16_1	124	76	11	7600	4470	-3130	0.14	0.59	13	7	-6
0014	3F	16_1	125	42	4	4200	1230	-2970	0.10	0.29	7	2	-5
0014	3F	16_1	126	36	7	3600	7560	3960	0.19	2.10	6	13	7
0014	3F	16_1	134	58	11	5800	4150	-1650	0.19	0.72	10	7	-3
0014	3F	16_1	135	30	3	3000	1670	-1330	0.10	0.56	5	2	-3
0014	3F	16_1	136	22	1	2200	710	-1490	0.05	0.32	3	1	-2
0014	3F	16_1	145	19	1	1900	610	-1290	0.05	0.32	3	1	-2
0014	3F	16_1	146	13	4	1300	2000	700	0.31	1.54	2	3	1
0014	3F	16_1	156	12	0	1200	0	-1200	0.00	0.00	2	0	-2
0014	3F	16_1	234	1	0	100	0	-100	0.00	0.00	0	0	0
0014	3F	16_1	235	1	0	100	0	-100	0.00	0.00	0	0	0
0014	3F	16_1	245	1	1	100	180	80	1.00	1.80	0	0	0
0014	3F	16_1	246	2	0	200	0	-200	0.00	0.00	0	0	0
0014	3F	16_2	123	79	12	7900	4080	-3820	0.15	0.52	13	7	-6
0014	3F	16_2	124	84	18	8400	7890	-510	0.21	0.94	14	13	-1
0014	3F	16_2	125	39	6	3900	5110	1210	0.15	1.31	6	9	3
0014	3F	16_2	126	31	7	3100	4380	1280	0.23	1.41	5	7	2
0014	3F	16_2	134	45	4	4500	2630	-1870	0.09	0.58	7	4	-3
0014	3F	16_2	135	19	4	1900	1750	-150	0.21	0.92	3	3	0
0014	3F	16_2	136	20	0	2000	0	-2000	0.00	0.00	3	0	-3
0014	3F	16_2	145	20	6	2000	2360	360	0.30	1.18	3	4	1
0014	3F	16_2	146	13	0	1300	0	-1300	0.00	0.00	2	0	-2
0014	3F	16_2	156	5	0	500	0	-500	0.00	0.00	0	0	0
0014	3F	16_2	234	2	0	200	0	-200	0.00	0.00	0	0	0
0014	3F	16_2	235	1	0	100	0	-100	0.00	0.00	0	0	0
0014	3F	16_2	236	8	0	800	0	-800	0.00	0.00	1	0	-1
0014	3F	16_2	245	7	1	700	260	-440	0.14	0.37	1	0	-1
0014	3F	16_2	246	4	0	400	0	-400	0.00	0.00	0	0	0
0014	3F	16_2	256	2	0	200	0	-200	0.00	0.00	0	0	0
0014	3F	16_3	123	85	20	8500	7940	-560	0.24	0.93	15	14	-1
0014	3F	16_3	124	72	17	7200	7570	370	0.24	1.05	12	13	1
0014	3F	16_3	125	52	4	5200	1730	-3470	0.08	0.33	9	3	-6
0014	3F	16_3	126	19	4	1900	1510	-390	0.21	0.79	3	2	-1
0014	3F	16_3	134	42	7	4200	4780	580	0.17	1.14	7	8	1
0014	3F	16_3	135	27	3	2700	1830	-870	0.11	0.68	4	3	-1
0014	3F	16_3	136	25	4	2500	7600	5100	0.16	3.04	4	13	9
0014	3F	16_3	145	11	2	1100	590	-510	0.18	0.54	1	1	0
0014	3F	16_3	146	9	0	900	0	-900	0.00	0.00	1	0	-1
0014	3F	16_3	156	4	0	400	0	-400	0.00	0.00	0	0	0
0014	3F	16_3	234	1	0	100	0	-100	0.00	0.00	0	0	0
0014	3F	16_3	235	4	1	400	440	40	0.25	1.10	0	0	0
0014	3F	16_3	236	6	0	600	0	-600	0.00	0.00	1	0	-1
0014	3F	16_3	246	2	0	200	0	-200	0.00	0.00	0	0	0
0014	3F	16_3	256	1	0	100	0	-100	0.00	0.00	0	0	0
0014	3F	16_4	123	92	24	9200	9390	190	0.26	1.02	16	16	0
0014	3F	16_4	124	59	8	5900	2590	-3310	0.14	0.44	10	4	-6
0014	3F	16_4	125	38	7	3800	3540	-260	0.18	0.93	6	6	0
0014	3F	16_4	126	30	4	3000	2340	-660	0.13	0.78	5	4	-1
0014	3F	16_4	134	42	10	4200	5680	1480	0.24	1.35	7	10	3
0014	3F	16_4	135	25	3	2500	1650	-850	0.12	0.66	4	2	-2
0014	3F	16_4	136	17	0	1700	0	-1700	0.00	0.00	3	0	-3
0014	3F	16_4	145	14	0	1400	0	-1400	0.00	0.00	2	0	-2
0014	3F	16_4	146	9	0	900	0	-900	0.00	0.00	1	0	-1
0014	3F	16_4	156	2	0	200	0	-200	0.00	0.00	0	0	0
0014	3F	16_4	234	4	0	400	0	-400	0.00	0.00	0	0	0
0014	3F	16_4	235	7	4	700	3020	2320	0.57	4.31	1	5	4
0014	3F	16_4	236	2	0	200	0	-200	0.00	0.00	0	0	0
0014	3F	16_4	245	4	0	400	0	-400	0.00	0.00	0	0	0
0014	3F	16_4	246	1	0	100	0	-100	0.00	0.00	0	0	0
0014	3F	16_5	123	91	15	9100	3530	-5570	0.16	0.39	16	6	-10
0014	3F	16_5	124	65	13	6500	5440	-1060	0.20	0.84	11	9	-2
0014	3F	16_5	125	33	3	3300	4510	1210	0.09	1.37	5	7	2
0014	3F	16_5	126	25	3	2500	3440	940	0.12	1.38	4	6	2
0014	3F	16_5	134	45	5	4500	3780	-720	0.11	0.84	7	6	-1
0014	3F	16_5	135	16	2	1600	1590	-10	0.13	0.99	2	2	0
0014	3F	16_5	136	18	1	1800	1740	-60	0.06	0.97	3	3	0
0014	3F	16_5	145	21	1	2100	400	-1700	0.05	0.19	3	0	-3
0014	3F	16_5	146	12	2	1200	680	-520	0.17	0.57	2	1	-1
0014	3F	16_5	156	2	0	200	0	-200	0.00	0.00	0	0	0
0014	3F	16_5	235	2	0	200	0	-200	0.00	0.00	0	0	0
0014	3F	16_5	236	1	0	100	0	-100	0.00	0.00	0	0	0
0014	3F	16_5	246	1	0	100	0	-100	0.00	0.00	0	0	0
0014	3F	16_7	123	92	14	9200	4910	-4290	0.15	0.53	16	8	-8
0014	3F	16_7	124	74	9	7400	4250	-3150	0.12	0.57	13	7	-6
0014	3F	16_7	125	52	10	5200	8850	3650	0.19	1.70	9	15	6
0014	3F	16_7	126	33	5	3300	5680	2380	0.15	1.72	5	10	5
0014	3F	16_7	134	56	8	5600	2860	-2740	0.14	0.51	9	5	-4
0014	3F	16_7	135	30	4	3000	1850	-1150	0.13	0.62	5	3	-2
0014	3F	16_7	136	26	2	2600	590	-2010	0.08	0.23	4	1	-3
0014	3F	16_7	145	18	1	1800	1220	-580	0.06	0.68	3	2	-1
0014	3F	16_7	146	15	3	1500	1270	-230	0.20	0.85	2	2	0
0014	3F	16_7	156	4	0	400	0	-400	0.00	0.00	0	0	0
0014	3F	16_7	234	1	0	100	0	-100	0.00	0.00	0	0	0
0014	3F	16_7	236	3	0	300	0	-300	0.00	0.00	0	0	0
0014	3F	16_7	246	1	0	100	0	-100	0.00	0.00	0	0	0
0014	3F	17_1	123	100	27	10000	9870	-130	0.27	0.99	17	17	0
0014	3F	17_1	124	69	14	6900	6290	-610	0.20	0.91	12	11	-1
0014	3F	17_1	125	36	2	3600	1070	-2530	0.06	0.30	6	1	-5
0014	3F	17_1	126	33	4	3300	6560	3260	0.12	1.99	5	11	6
0014	3F	17_1	134	51	9	5100	4870	-230	0.18	0.95	9	8	-1
0014	3F	17_1	135	38	3	3800	830	-2970	0.08	0.22	6	1	-5
0014	3F	17_1	136	12	0	1200	0	-1200	0.00	0.00	2	0	-2
0014	3F	17_1	145	17	2	1700	1510	-190	0.12	0.89	3	2	-1
0014	3F	17_1	146	6	0	600	0	-600	0.00	0.00	1	0	-1
0014	3F	17_1	156	2	1	200	710	510	0.50	3.55	0	1	1
0014	3F	17_1	234	5	2	500	1540	1040	0.40	3.08	0	2	2
0014	3F	17_1	235	6	2	600	2070	1470	0.33	3.45	1	3	2
0014	3F	17_1	236	2	0	200	0	-200	0.00	0.00	0	0	0
0014	3F	17_1	246	2	0	200	0	-200	0.00	0.00	0	0	0
0014	3F	17_1	256	1	0	100	0	-100	0.00	0.00	0	0	0
0014	3F	17_2	123	99	24	9900	13100	3200	0.24	1.32	17	23	6
0014	3F	17_2	124	77	13	7700	5980	-1720	0.17	0.78	13	10	-3
0014	3F	17_2	125	47	7	4700	5080	380	0.15	1.08	8	8	0
0014	3F	17_2	126	26	2	2600	2760	160	0.08	1.06	4	4	0
0014	3F	17_2	134	50	9	5000	5450	450	0.18	1.09	8	9	1
0014	3F	17_2	135	24	1	2400	190	-2210	0.04	0.08	4	0	-4
0014	3F	17_2	136	16	0	1600	0	-1600	0.00	0.00	2	0	-2
0014	3F	17_2	145	15	0	1500	0	-1500	0.00	0.00	2	0	-2
0014	3F	17_2	146	12	0	1200	0	-1200	0.00	0.00	2	0	-2
0014	3F	17_2	156	5	1	500	1950	1450	0.20	3.90	0	3	3
0014	3F	17_2	234	4	1	400	330	-70	0.25	0.83	0	0	0
0014	3F	17_2	235	6	0	600	0	-600	0.00	0.00	1	0	-1
0014	3F	17_2	236	2	1	200	960	760	0.50	4.80	0	1	1
0014	3F	17_2	245	1	0	100	0	-100	0.00	0.00	0	0	0
0014	3F	17_3	123	93	22	9300	9350	50	0.24	1.01	16	16	0
0014	3F	17_3	124	80	12	8000	5880	-2120	0.15	0.74	14	10	-4
0014	3F	17_3	125	40	9	4000	4810	810	0.23	1.20	7	8	1
0014	3F	17_3	126	29	2	2900	1190	-1710	0.07	0.41	5	2	-3
0014	3F	17_3	134	45	9	4500	4280	-220	0.20	0.95	7	7	0
0014	3F	17_3	135	31	4	3100	4140	1040	0.13	1.34	5	7	2
0014	3F	17_3	136	19	2	1900	2110	210	0.11	1.11	3	3	0
0014	3F	17_3	145	13	1	1300	1390	90	0.08	1.07	2	2	0
0014	3F	17_3	146	14	2	1400	1270	-130	0.14	0.91	2	2	0
0014	3F	17_3	156	3	1	300	850	550	0.33	2.83	0	1	1
0014	3F	17_3	234	4	0	400	0	-400	0.00	0.00	0	0	0
0014	3F	17_3	235	5	0	500	0	-500	0.00	0.00	0	0	0
0014	3F	17_3	236	1	0	100	0	-100	0.00	0.00	0	0	0
0014	3F	17_3	245	3	2	300	1060	760	0.67	3.53	0	1	1
0014	3F	17_3	246	3	0	300	0	-300	0.00	0.00	0	0	0
0014	3F	17_4	123	89	23	8900	8080	-820	0.26	0.91	15	14	-1
0014	3F	17_4	124	53	9	5300	5460	160	0.17	1.03	9	9	0
0014	3F	17_4	125	40	4	4000	1870	-2130	0.10	0.47	7	3	-4
0014	3F	17_4	126	19	2	1900	850	-1050	0.11	0.45	3	1	-2
0014	3F	17_4	134	50	7	5000	3340	-1660	0.14	0.67	8	5	-3
0014	3F	17_4	135	24	5	2400	4320	1920	0.21	1.80	4	7	3
0014	3F	17_4	136	12	1	1200	1000	-200	0.08	0.83	2	1	-1
0014	3F	17_4	145	11	1	1100	510	-590	0.09	0.46	1	0	-1
0014	3F	17_4	146	10	1	1000	400	-600	0.10	0.40	1	0	-1
0014	3F	17_4	156	2	0	200	0	-200	0.00	0.00	0	0	0
0014	3F	17_4	234	5	1	500	830	330	0.20	1.66	0	1	1
0014	3F	17_4	235	2	0	200	0	-200	0.00	0.00	0	0	0
0014	3F	17_4	236	2	1	200	1790	1590	0.50	8.95	0	3	3
0014	3F	17_4	245	3	0	300	0	-300	0.00	0.00	0	0	0
0014	3F	17_4	246	3	0	300	0	-300	0.00	0.00	0	0	0
0014	3F	17_4	256	1	0	100	0	-100	0.00	0.00	0	0	0
0014	3F	17_5	123	80	23	8000	7770	-230	0.29	0.97	14	13	-1
0014	3F	17_5	124	79	11	7900	4360	-3540	0.14	0.55	13	7	-6
0014	3F	17_5	125	28	4	2800	6170	3370	0.14	2.20	4	10	6
0014	3F	17_5	126	15	0	1500	0	-1500	0.00	0.00	2	0	-2
0014	3F	17_5	134	23	0	2300	0	-2300	0.00	0.00	4	0	-4
0014	3F	17_5	135	28	3	2800	2460	-340	0.11	0.88	4	4	0
0014	3F	17_5	136	9	1	900	210	-690	0.11	0.23	1	0	-1
0014	3F	17_5	145	10	1	1000	690	-310	0.10	0.69	1	1	0
0014	3F	17_5	146	5	1	500	580	80	0.20	1.16	0	1	1
0014	3F	17_5	156	5	0	500	0	-500	0.00	0.00	0	0	0
0014	3F	17_5	234	2	0	200	0	-200	0.00	0.00	0	0	0
0014	3F	17_5	235	1	0	100	0	-100	0.00	0.00	0	0	0
0014	3F	17_5	246	1	0	100	0	-100	0.00	0.00	0	0	0
0014	3F	17_5	256	1	0	100	0	-100	0.00	0.00	0	0	0
0014	3F	17_7	123	98	20	9800	9830	30	0.20	1.00	17	17	0
0014	3F	17_7	124	77	4	7700	2040	-5660	0.05	0.26	13	3	-10
0014	3F	17_7	125	53	4	5300	2270	-3030	0.08	0.43	9	4	-5
0014	3F	17_7	126	32	3	3200	1220	-1980	0.09	0.38	5	2	-3
0014	3F	17_7	134	52	6	5200	3650	-1550	0.12	0.70	9	6	-3
0014	3F	17_7	135	29	2	2900	2130	-770	0.07	0.73	5	3	-2
0014	3F	17_7	136	14	0	1400	0	-1400	0.00	0.00	2	0	-2
0014	3F	17_7	145	18	2	1800	2330	530	0.11	1.29	3	4	1
0014	3F	17_7	146	8	0	800	0	-800	0.00	0.00	1	0	-1
0014	3F	17_7	156	1	0	100	0	-100	0.00	0.00	0	0	0
0014	3F	17_7	234	4	0	400	0	-400	0.00	0.00	0	0	0
0014	3F	17_7	235	2	0	200	0	-200	0.00	0.00	0	0	0
0014	3F	17_7	236	3	0	300	0	-300	0.00	0.00	0	0	0
0014	3F	17_7	245	2	0	200	0	-200	0.00	0.00	0	0	0
0014	3F	17_7	256	1	0	100	0	-100	0.00	0.00	0	0	0
0014	3F	18_1	123	88	14	8800	6620	-2180	0.16	0.75	15	11	-4
0014	3F	18_1	124	86	20	8600	8600	0	0.23	1.00	15	15	0
0014	3F	18_1	125	49	9	4900	4830	-70	0.18	0.99	8	8	0
0014	3F	18_1	126	30	2	3000	3610	610	0.07	1.20	5	6	1
0014	3F	18_1	134	60	13	6000	7240	1240	0.22	1.21	10	12	2
0014	3F	18_1	135	24	1	2400	1060	-1340	0.04	0.44	4	1	-3
0014	3F	18_1	136	18	2	1800	1250	-550	0.11	0.69	3	2	-1
0014	3F	18_1	145	14	0	1400	0	-1400	0.00	0.00	2	0	-2
0014	3F	18_1	146	9	1	900	410	-490	0.11	0.46	1	0	-1
0014	3F	18_1	156	3	0	300	0	-300	0.00	0.00	0	0	0
0014	3F	18_1	234	11	1	1100	2650	1550	0.09	2.41	1	4	3
0014	3F	18_1	235	6	2	600	540	-60	0.33	0.90	1	0	-1
0014	3F	18_1	236	3	0	300	0	-300	0.00	0.00	0	0	0
0014	3F	18_1	245	2	0	200	0	-200	0.00	0.00	0	0	0
0014	3F	18_1	246	9	1	900	440	-460	0.11	0.49	1	0	-1
0014	3F	18_2	123	94	13	9400	7010	-2390	0.14	0.75	16	12	-4
0014	3F	18_2	124	98	11	9800	4500	-5300	0.11	0.46	17	7	-10
0014	3F	18_2	125	49	3	4900	4590	-310	0.06	0.94	8	8	0
0014	3F	18_2	126	25	4	2500	3190	690	0.16	1.28	4	5	1
0014	3F	18_2	134	50	8	5000	4280	-720	0.16	0.86	8	7	-1
0014	3F	18_2	135	21	1	2100	560	-1540	0.05	0.27	3	0	-3
0014	3F	18_2	136	13	1	1300	280	-1020	0.08	0.22	2	0	-2
0014	3F	18_2	145	25	4	2500	3430	930	0.16	1.37	4	6	2
0014	3F	18_2	146	8	0	800	0	-800	0.00	0.00	1	0	-1
0014	3F	18_2	156	4	1	400	2570	2170	0.25	6.43	0	4	4
0014	3F	18_2	234	3	0	300	0	-300	0.00	0.00	0	0	0
0014	3F	18_2	235	6	1	600	570	-30	0.17	0.95	1	1	0
0014	3F	18_2	236	1	0	100	0	-100	0.00	0.00	0	0	0
0014	3F	18_2	246	1	0	100	0	-100	0.00	0.00	0	0	0
0014	3F	18_2	256	1	0	100	0	-100	0.00	0.00	0	0	0
0014	3F	18_3	123	114	22	11400	9370	-2030	0.19	0.82	20	16	-4
0014	3F	18_3	124	66	11	6600	4950	-1650	0.17	0.75	11	8	-3
0014	3F	18_3	125	52	7	5200	3390	-1810	0.13	0.65	9	6	-3
0014	3F	18_3	126	19	5	1900	2340	440	0.26	1.23	3	4	1
0014	3F	18_3	134	44	5	4400	1850	-2550	0.11	0.42	7	3	-4
0014	3F	18_3	135	27	1	2700	2940	240	0.04	1.09	4	5	1
0014	3F	18_3	136	22	0	2200	0	-2200	0.00	0.00	3	0	-3
0014	3F	18_3	145	16	1	1600	610	-990	0.06	0.38	2	1	-1
0014	3F	18_3	146	6	0	600	0	-600	0.00	0.00	1	0	-1
0014	3F	18_3	156	8	0	800	0	-800	0.00	0.00	1	0	-1
0014	3F	18_3	234	5	0	500	0	-500	0.00	0.00	0	0	0
0014	3F	18_3	235	3	1	300	2140	1840	0.33	7.13	0	3	3
0014	3F	18_3	236	3	1	300	270	-30	0.33	0.90	0	0	0
0014	3F	18_3	245	3	0	300	0	-300	0.00	0.00	0	0	0
0014	3F	18_3	246	2	0	200	0	-200	0.00	0.00	0	0	0
0014	3F	18_3	256	1	0	100	0	-100	0.00	0.00	0	0	0
0014	3F	18_4	123	105	23	10500	9810	-690	0.22	0.93	18	17	-1
0014	3F	18_4	124	83	15	8300	5750	-2550	0.18	0.69	14	10	-4
0014	3F	18_4	125	42	11	4200	9450	5250	0.26	2.25	7	16	9
0014	3F	18_4	126	30	2	3000	1610	-1390	0.07	0.54	5	2	-3
0014	3F	18_4	134	42	5	4200	2030	-2170	0.12	0.48	7	3	-4
0014	3F	18_4	135	28	0	2800	0	-2800	0.00	0.00	4	0	-4
0014	3F	18_4	136	19	3	1900	1200	-700	0.16	0.63	3	2	-1
0014	3F	18_4	145	21	3	2100	4920	2820	0.14	2.34	3	8	5
0014	3F	18_4	146	9	1	900	270	-630	0.11	0.30	1	0	-1
0014	3F	18_4	156	3	0	300	0	-300	0.00	0.00	0	0	0
0014	3F	18_4	234	9	0	900	0	-900	0.00	0.00	1	0	-1
0014	3F	18_4	236	2	1	200	1070	870	0.50	5.35	0	1	1
0014	3F	18_4	245	3	0	300	0	-300	0.00	0.00	0	0	0
0014	3F	18_4	246	6	0	600	0	-600	0.00	0.00	1	0	-1
0014	3F	18_5	123	86	26	8600	13350	4750	0.30	1.55	15	23	8
0014	3F	18_5	124	73	13	7300	6780	-520	0.18	0.93	12	12	0
0014	3F	18_5	125	48	6	4800	3060	-1740	0.13	0.64	8	5	-3
0014	3F	18_5	126	13	0	1300	0	-1300	0.00	0.00	2	0	-2
0014	3F	18_5	134	49	4	4900	2030	-2870	0.08	0.41	8	3	-5
0014	3F	18_5	135	32	3	3200	1430	-1770	0.09	0.45	5	2	-3
0014	3F	18_5	136	10	0	1000	0	-1000	0.00	0.00	1	0	-1
0014	3F	18_5	145	20	3	2000	690	-1310	0.15	0.35	3	1	-2
0014	3F	18_5	146	10	0	1000	0	-1000	0.00	0.00	1	0	-1
0014	3F	18_5	156	2	0	200	0	-200	0.00	0.00	0	0	0
0014	3F	18_5	234	4	0	400	0	-400	0.00	0.00	0	0	0
0014	3F	18_5	235	3	0	300	0	-300	0.00	0.00	0	0	0
0014	3F	18_5	236	2	0	200	0	-200	0.00	0.00	0	0	0
0014	3F	18_5	245	1	0	100	0	-100	0.00	0.00	0	0	0
0014	3F	18_5	256	1	0	100	0	-100	0.00	0.00	0	0	0
0014	3F	18_6	123	8	1	800	420	-380	0.13	0.53	1	0	-1
0014	3F	18_6	124	12	3	1200	990	-210	0.25	0.83	2	1	-1
0014	3F	18_6	125	4	1	400	300	-100	0.25	0.75	0	0	0
0014	3F	18_6	126	1	1	100	380	280	1.00	3.80	0	0	0
0014	3F	18_6	134	5	0	500	0	-500	0.00	0.00	0	0	0
0014	3F	18_6	135	4	0	400	0	-400	0.00	0.00	0	0	0
0014	3F	18_6	136	1	0	100	0	-100	0.00	0.00	0	0	0
0014	3F	18_6	145	1	0	100	0	-100	0.00	0.00	0	0	0
0014	3F	18_6	146	2	0	200	0	-200	0.00	0.00	0	0	0
0014	3F	18_6	156	3	0	300	0	-300	0.00	0.00	0	0	0
0014	3F	18_7	123	99	23	9900	8340	-1560	0.23	0.84	17	14	-3
0014	3F	18_7	124	63	15	6300	6450	150	0.24	1.02	11	11	0
0014	3F	18_7	125	62	8	6200	4350	-1850	0.13	0.70	10	7	-3
0014	3F	18_7	126	21	0	2100	0	-2100	0.00	0.00	3	0	-3
0014	3F	18_7	134	57	7	5700	3580	-2120	0.12	0.63	10	6	-4
0014	3F	18_7	135	32	4	3200	3850	650	0.13	1.20	5	6	1
0014	3F	18_7	136	17	0	1700	0	-1700	0.00	0.00	3	0	-3
0014	3F	18_7	145	20	2	2000	1570	-430	0.10	0.79	3	2	-1
0014	3F	18_7	146	7	0	700	0	-700	0.00	0.00	1	0	-1
0014	3F	18_7	156	5	0	500	0	-500	0.00	0.00	0	0	0
0014	3F	18_7	234	4	0	400	0	-400	0.00	0.00	0	0	0
0014	3F	18_7	235	2	0	200	0	-200	0.00	0.00	0	0	0
0014	3F	18_7	236	2	0	200	0	-200	0.00	0.00	0	0	0
0014	3F	18_7	245	4	0	400	0	-400	0.00	0.00	0	0	0
0014	3F	18_7	246	2	0	200	0	-200	0.00	0.00	0	0	0
0014	3F	18_7	256	2	0	200	0	-200	0.00	0.00	0	0	0
0014	3F	19_1	123	79	18	7900	7460	-440	0.23	0.94	13	13	0
0014	3F	19_1	124	80	14	8000	5190	-2810	0.18	0.65	14	9	-5
0014	3F	19_1	125	27	4	2700	4050	1350	0.15	1.50	4	7	3
0014	3F	19_1	126	26	4	2600	1260	-1340	0.15	0.48	4	2	-2
0014	3F	19_1	134	50	7	5000	2830	-2170	0.14	0.57	8	5	-3
0014	3F	19_1	135	25	1	2500	400	-2100	0.04	0.16	4	0	-4
0014	3F	19_1	136	27	2	2700	1550	-1150	0.07	0.57	4	2	-2
0014	3F	19_1	145	11	2	1100	1820	720	0.18	1.65	1	3	2
0014	3F	19_1	146	8	0	800	0	-800	0.00	0.00	1	0	-1
0014	3F	19_1	156	2	0	200	0	-200	0.00	0.00	0	0	0
0014	3F	19_1	234	1	0	100	0	-100	0.00	0.00	0	0	0
0014	3F	19_1	235	1	0	100	0	-100	0.00	0.00	0	0	0
0014	3F	19_1	236	2	0	200	0	-200	0.00	0.00	0	0	0
0014	3F	19_1	246	1	0	100	0	-100	0.00	0.00	0	0	0
0014	3F	19_2	123	69	11	6900	5510	-1390	0.16	0.80	12	9	-3
0014	3F	19_2	124	73	9	7300	4270	-3030	0.12	0.58	12	7	-5
0014	3F	19_2	125	24	1	2400	370	-2030	0.04	0.15	4	0	-4
0014	3F	19_2	126	26	6	2600	3220	620	0.23	1.24	4	5	1
0014	3F	19_2	134	36	5	3600	3790	190	0.14	1.05	6	6	0
0014	3F	19_2	135	28	2	2800	850	-1950	0.07	0.30	4	1	-3
0014	3F	19_2	136	24	5	2400	2380	-20	0.21	0.99	4	4	0
0014	3F	19_2	145	13	3	1300	900	-400	0.23	0.69	2	1	-1
0014	3F	19_2	146	15	1	1500	450	-1050	0.07	0.30	2	0	-2
0014	3F	19_2	156	4	0	400	0	-400	0.00	0.00	0	0	0
0014	3F	19_2	235	1	0	100	0	-100	0.00	0.00	0	0	0
0014	3F	19_2	236	3	0	300	0	-300	0.00	0.00	0	0	0
0014	3F	19_2	246	3	1	300	560	260	0.33	1.87	0	0	0
0014	3F	19_2	256	1	0	100	0	-100	0.00	0.00	0	0	0
0014	3F	19_3	123	90	13	9000	4630	-4370	0.14	0.51	15	8	-7
0014	3F	19_3	124	82	16	8200	4660	-3540	0.20	0.57	14	8	-6
0014	3F	19_3	125	44	7	4400	1990	-2410	0.16	0.45	7	3	-4
0014	3F	19_3	126	28	5	2800	3000	200	0.18	1.07	4	5	1
0014	3F	19_3	134	36	6	3600	3160	-440	0.17	0.88	6	5	-1
0014	3F	19_3	135	19	4	1900	3650	1750	0.21	1.92	3	6	3
0014	3F	19_3	136	20	2	2000	770	-1230	0.10	0.39	3	1	-2
0014	3F	19_3	145	18	3	1800	760	-1040	0.17	0.42	3	1	-2
0014	3F	19_3	146	7	2	700	520	-180	0.29	0.74	1	0	-1
0014	3F	19_3	156	5	0	500	0	-500	0.00	0.00	0	0	0
0014	3F	19_3	236	4	1	400	270	-130	0.25	0.68	0	0	0
0014	3F	19_3	246	2	0	200	0	-200	0.00	0.00	0	0	0
0014	3F	19_4	123	75	22	7500	7840	340	0.29	1.05	13	13	0
0014	3F	19_4	124	70	14	7000	4450	-2550	0.20	0.64	12	7	-5
0014	3F	19_4	125	24	2	2400	2290	-110	0.08	0.95	4	4	0
0014	3F	19_4	126	13	0	1300	0	-1300	0.00	0.00	2	0	-2
0014	3F	19_4	134	43	9	4300	2960	-1340	0.21	0.69	7	5	-2
0014	3F	19_4	135	18	2	1800	600	-1200	0.11	0.33	3	1	-2
0014	3F	19_4	136	13	1	1300	1060	-240	0.08	0.82	2	1	-1
0014	3F	19_4	145	13	1	1300	1580	280	0.08	1.22	2	2	0
0014	3F	19_4	146	9	1	900	530	-370	0.11	0.59	1	0	-1
0014	3F	19_4	156	1	0	100	0	-100	0.00	0.00	0	0	0
0014	3F	19_4	234	6	0	600	0	-600	0.00	0.00	1	0	-1
0014	3F	19_4	235	2	0	200	0	-200	0.00	0.00	0	0	0
0014	3F	19_4	236	1	0	100	0	-100	0.00	0.00	0	0	0
0014	3F	19_4	245	1	1	100	420	320	1.00	4.20	0	0	0
0014	3F	19_4	246	1	0	100	0	-100	0.00	0.00	0	0	0
0014	3F	19_5	123	65	15	6500	8300	1800	0.23	1.28	11	14	3
0014	3F	19_5	124	47	12	4700	4710	10	0.26	1.00	8	8	0
0014	3F	19_5	125	20	1	2000	1150	-850	0.05	0.58	3	2	-1
0014	3F	19_5	126	11	0	1100	0	-1100	0.00	0.00	1	0	-1
0014	3F	19_5	134	28	8	2800	4320	1520	0.29	1.54	4	7	3
0014	3F	19_5	135	16	2	1600	900	-700	0.13	0.56	2	1	-1
0014	3F	19_5	136	10	3	1000	1490	490	0.30	1.49	1	2	1
0014	3F	19_5	145	12	0	1200	0	-1200	0.00	0.00	2	0	-2
0014	3F	19_5	146	7	0	700	0	-700	0.00	0.00	1	0	-1
0014	3F	19_5	234	2	1	200	410	210	0.50	2.05	0	0	0
0014	3F	19_5	235	2	0	200	0	-200	0.00	0.00	0	0	0
0014	3F	19_5	236	3	0	300	0	-300	0.00	0.00	0	0	0
0014	3F	19_5	246	1	0	100	0	-100	0.00	0.00	0	0	0
0014	3F	19_5	256	3	0	300	0	-300	0.00	0.00	0	0	0
0014	3F	19_6	123	8	1	800	420	-380	0.13	0.53	1	0	-1
0014	3F	19_6	124	4	2	400	2040	1640	0.50	5.10	0	3	3
0014	3F	19_6	125	4	0	400	0	-400	0.00	0.00	0	0	0
0014	3F	19_6	126	2	0	200	0	-200	0.00	0.00	0	0	0
0014	3F	19_6	134	8	3	800	1520	720	0.38	1.90	1	2	1
0014	3F	19_6	135	2	0	200	0	-200	0.00	0.00	0	0	0
0014	3F	19_6	145	1	1	100	210	110	1.00	2.10	0	0	0
0014	3F	19_6	156	1	0	100	0	-100	0.00	0.00	0	0	0
0014	3F	19_6	235	1	0	100	0	-100	0.00	0.00	0	0	0
0014	3F	19_6	246	1	0	100	0	-100	0.00	0.00	0	0	0
0014	3F	19_6	256	1	0	100	0	-100	0.00	0.00	0	0	0
0014	3F	19_7	123	91	22	9100	8740	-360	0.24	0.96	16	15	-1
0014	3F	19_7	124	72	15	7200	6150	-1050	0.21	0.85	12	10	-2
0014	3F	19_7	125	28	1	2800	910	-1890	0.04	0.33	4	1	-3
0014	3F	19_7	126	16	0	1600	0	-1600	0.00	0.00	2	0	-2
0014	3F	19_7	134	49	14	4900	9140	4240	0.29	1.87	8	16	8
0014	3F	19_7	135	20	4	2000	1770	-230	0.20	0.89	3	3	0
0014	3F	19_7	136	20	3	2000	1070	-930	0.15	0.54	3	1	-2
0014	3F	19_7	145	22	2	2200	2000	-200	0.09	0.91	3	3	0
0014	3F	19_7	146	11	1	1100	930	-170	0.09	0.85	1	1	0
0014	3F	19_7	156	5	0	500	0	-500	0.00	0.00	0	0	0
0014	3F	19_7	234	2	0	200	0	-200	0.00	0.00	0	0	0
0014	3F	19_7	235	3	0	300	0	-300	0.00	0.00	0	0	0
0014	3F	19_7	236	2	0	200	0	-200	0.00	0.00	0	0	0
0014	3F	19_7	245	1	0	100	0	-100	0.00	0.00	0	0	0
0014	3F	20_1	123	101	25	10100	8830	-1270	0.25	0.87	17	15	-2
0014	3F	20_1	124	89	21	8900	5890	-3010	0.24	0.66	15	10	-5
0014	3F	20_1	125	19	4	1900	2630	730	0.21	1.38	3	4	1
0014	3F	20_1	126	20	2	2000	1510	-490	0.10	0.76	3	2	-1
0014	3F	20_1	134	60	13	6000	6030	30	0.22	1.01	10	10	0
0014	3F	20_1	135	25	4	2500	6280	3780	0.16	2.51	4	11	7
0014	3F	20_1	136	20	4	2000	1920	-80	0.20	0.96	3	3	0
0014	3F	20_1	145	13	2	1300	1270	-30	0.15	0.98	2	2	0
0014	3F	20_1	146	13	2	1300	3350	2050	0.15	2.58	2	5	3
0014	3F	20_1	156	4	0	400	0	-400	0.00	0.00	0	0	0
0014	3F	20_1	234	2	0	200	0	-200	0.00	0.00	0	0	0
0014	3F	20_1	246	1	0	100	0	-100	0.00	0.00	0	0	0
0014	3F	20_2	123	85	20	8500	9950	1450	0.24	1.17	15	17	2
0014	3F	20_2	124	59	9	5900	2300	-3600	0.15	0.39	10	4	-6
0014	3F	20_2	125	32	3	3200	2260	-940	0.09	0.71	5	4	-1
0014	3F	20_2	126	36	3	3600	1390	-2210	0.08	0.39	6	2	-4
0014	3F	20_2	134	33	2	3300	2720	-580	0.06	0.82	5	4	-1
0014	3F	20_2	135	22	2	2200	580	-1620	0.09	0.26	3	1	-2
0014	3F	20_2	136	21	4	2100	2720	620	0.19	1.30	3	4	1
0014	3F	20_2	145	16	2	1600	1110	-490	0.13	0.69	2	1	-1
0014	3F	20_2	146	15	3	1500	2690	1190	0.20	1.79	2	4	2
0014	3F	20_2	156	7	0	700	0	-700	0.00	0.00	1	0	-1
0014	3F	20_2	234	1	0	100	0	-100	0.00	0.00	0	0	0
0014	3F	20_2	236	2	0	200	0	-200	0.00	0.00	0	0	0
0014	3F	20_3	123	73	20	7300	8490	1190	0.27	1.16	12	15	3
0014	3F	20_3	124	54	15	5400	6100	700	0.28	1.13	9	10	1
0014	3F	20_3	125	52	2	5200	970	-4230	0.04	0.19	9	1	-8
0014	3F	20_3	126	30	3	3000	3320	320	0.10	1.11	5	5	0
0014	3F	20_3	134	38	5	3800	3770	-30	0.13	0.99	6	6	0
0014	3F	20_3	135	31	2	3100	810	-2290	0.06	0.26	5	1	-4
0014	3F	20_3	136	24	6	2400	8720	6320	0.25	3.63	4	15	11
0014	3F	20_3	145	15	1	1500	180	-1320	0.07	0.12	2	0	-2
0014	3F	20_3	146	15	0	1500	0	-1500	0.00	0.00	2	0	-2
0014	3F	20_3	156	9	0	900	0	-900	0.00	0.00	1	0	-1
0014	3F	20_3	234	2	0	200	0	-200	0.00	0.00	0	0	0
0014	3F	20_3	235	1	0	100	0	-100	0.00	0.00	0	0	0
0014	3F	20_3	236	2	0	200	0	-200	0.00	0.00	0	0	0
0014	3F	20_3	246	1	0	100	0	-100	0.00	0.00	0	0	0
0014	3F	20_3	256	1	0	100	0	-100	0.00	0.00	0	0	0
0014	3F	20_4	123	76	14	7600	4610	-2990	0.18	0.61	13	8	-5
0014	3F	20_4	124	52	6	5200	1580	-3620	0.12	0.30	9	2	-7
0014	3F	20_4	125	28	4	2800	2430	-370	0.14	0.87	4	4	0
0014	3F	20_4	126	12	0	1200	0	-1200	0.00	0.00	2	0	-2
0014	3F	20_4	134	41	7	4100	3670	-430	0.17	0.90	7	6	-1
0014	3F	20_4	135	19	3	1900	1370	-530	0.16	0.72	3	2	-1
0014	3F	20_4	136	13	1	1300	260	-1040	0.08	0.20	2	0	-2
0014	3F	20_4	145	28	5	2800	3850	1050	0.18	1.38	4	6	2
0014	3F	20_4	146	12	0	1200	0	-1200	0.00	0.00	2	0	-2
0014	3F	20_4	156	2	2	200	3700	3500	1.00	18.50	0	6	6
0014	3F	20_4	234	2	0	200	0	-200	0.00	0.00	0	0	0
0014	3F	20_4	235	2	0	200	0	-200	0.00	0.00	0	0	0
0014	3F	20_4	236	2	0	200	0	-200	0.00	0.00	0	0	0
0014	3F	20_4	256	1	0	100	0	-100	0.00	0.00	0	0	0
0014	3F	20_5	123	65	9	6500	3460	-3040	0.14	0.53	11	6	-5
0014	3F	20_5	124	50	13	5000	3430	-1570	0.26	0.69	8	6	-2
0014	3F	20_5	125	29	6	2900	2890	-10	0.21	1.00	5	5	0
0014	3F	20_5	126	22	1	2200	420	-1780	0.05	0.19	3	0	-3
0014	3F	20_5	134	48	6	4800	2820	-1980	0.13	0.59	8	4	-4
0014	3F	20_5	135	14	0	1400	0	-1400	0.00	0.00	2	0	-2
0014	3F	20_5	136	7	0	700	0	-700	0.00	0.00	1	0	-1
0014	3F	20_5	145	12	0	1200	0	-1200	0.00	0.00	2	0	-2
0014	3F	20_5	146	4	1	400	400	0	0.25	1.00	0	0	0
0014	3F	20_5	156	4	0	400	0	-400	0.00	0.00	0	0	0
0014	3F	20_5	234	1	0	100	0	-100	0.00	0.00	0	0	0
0014	3F	20_5	235	3	0	300	0	-300	0.00	0.00	0	0	0
0014	3F	20_5	236	1	0	100	0	-100	0.00	0.00	0	0	0
0014	3F	20_5	246	1	0	100	0	-100	0.00	0.00	0	0	0
0014	3F	20_6	123	13	4	1300	870	-430	0.31	0.67	2	1	-1
0014	3F	20_6	124	9	2	900	530	-370	0.22	0.59	1	0	-1
0014	3F	20_6	125	4	0	400	0	-400	0.00	0.00	0	0	0
0014	3F	20_6	126	12	2	1200	7490	6290	0.17	6.24	2	13	11
0014	3F	20_6	134	5	1	500	390	-110	0.20	0.78	0	0	0
0014	3F	20_6	135	1	1	100	1270	1170	1.00	12.70	0	2	2
0014	3F	20_6	136	2	0	200	0	-200	0.00	0.00	0	0	0
0014	3F	20_6	145	2	0	200	0	-200	0.00	0.00	0	0	0
0014	3F	20_6	146	3	0	300	0	-300	0.00	0.00	0	0	0
0014	3F	20_6	156	1	0	100	0	-100	0.00	0.00	0	0	0
0014	3F	20_7	123	91	16	9100	7460	-1640	0.18	0.82	16	13	-3
0014	3F	20_7	124	71	12	7100	5410	-1690	0.17	0.76	12	9	-3
0014	3F	20_7	125	35	5	3500	2600	-900	0.14	0.74	6	4	-2
0014	3F	20_7	126	23	0	2300	0	-2300	0.00	0.00	4	0	-4
0014	3F	20_7	134	48	11	4800	6030	1230	0.23	1.26	8	10	2
0014	3F	20_7	135	32	8	3200	5290	2090	0.25	1.65	5	9	4
0014	3F	20_7	136	15	5	1500	1750	250	0.33	1.17	2	3	1
0014	3F	20_7	145	22	3	2200	3020	820	0.14	1.37	3	5	2
0014	3F	20_7	146	19	0	1900	0	-1900	0.00	0.00	3	0	-3
0014	3F	20_7	156	1	0	100	0	-100	0.00	0.00	0	0	0
0014	3F	20_7	234	1	0	100	0	-100	0.00	0.00	0	0	0
0014	3F	20_7	235	3	0	300	0	-300	0.00	0.00	0	0	0
0014	3F	20_7	245	1	0	100	0	-100	0.00	0.00	0	0	0
0014	3F	20_7	256	1	0	100	0	-100	0.00	0.00	0	0	0
0014	3F	21_1	123	79	18	7900	9690	1790	0.23	1.23	13	17	4
0014	3F	21_1	124	79	14	7900	6780	-1120	0.18	0.86	13	12	-1
0014	3F	21_1	125	37	5	3700	8270	4570	0.14	2.24	6	14	8
0014	3F	21_1	126	28	4	2800	3160	360	0.14	1.13	4	5	1
0014	3F	21_1	134	52	8	5200	2340	-2860	0.15	0.45	9	4	-5
0014	3F	21_1	135	27	3	2700	2350	-350	0.11	0.87	4	4	0
0014	3F	21_1	136	7	1	700	420	-280	0.14	0.60	1	0	-1
0014	3F	21_1	145	23	2	2300	2950	650	0.09	1.28	4	5	1
0014	3F	21_1	146	11	0	1100	0	-1100	0.00	0.00	1	0	-1
0014	3F	21_1	156	7	0	700	0	-700	0.00	0.00	1	0	-1
0014	3F	21_1	234	3	0	300	0	-300	0.00	0.00	0	0	0
0014	3F	21_1	236	3	0	300	0	-300	0.00	0.00	0	0	0
0014	3F	21_1	245	1	0	100	0	-100	0.00	0.00	0	0	0
0014	3F	21_1	246	3	0	300	0	-300	0.00	0.00	0	0	0
0014	3F	21_2	123	103	26	10300	11530	1230	0.25	1.12	18	20	2
0014	3F	21_2	124	66	12	6600	4520	-2080	0.18	0.68	11	8	-3
0014	3F	21_2	125	53	5	5300	2160	-3140	0.09	0.41	9	3	-6
0014	3F	21_2	126	22	1	2200	1090	-1110	0.05	0.50	3	1	-2
0014	3F	21_2	134	55	8	5500	3550	-1950	0.15	0.65	9	6	-3
0014	3F	21_2	135	27	7	2700	2800	100	0.26	1.04	4	4	0
0014	3F	21_2	136	15	1	1500	900	-600	0.07	0.60	2	1	-1
0014	3F	21_2	145	22	2	2200	990	-1210	0.09	0.45	3	1	-2
0014	3F	21_2	146	10	1	1000	400	-600	0.10	0.40	1	0	-1
0014	3F	21_2	156	5	1	500	2960	2460	0.20	5.92	0	5	5
0014	3F	21_2	234	2	0	200	0	-200	0.00	0.00	0	0	0
0014	3F	21_2	235	3	0	300	0	-300	0.00	0.00	0	0	0
0014	3F	21_2	236	2	0	200	0	-200	0.00	0.00	0	0	0
0014	3F	21_2	245	1	0	100	0	-100	0.00	0.00	0	0	0
0014	3F	21_2	246	2	0	200	0	-200	0.00	0.00	0	0	0
0014	3F	21_2	256	1	0	100	0	-100	0.00	0.00	0	0	0
0014	3F	21_3	123	103	15	10300	6570	-3730	0.15	0.64	18	11	-7
0014	3F	21_3	124	65	6	6500	1670	-4830	0.09	0.26	11	2	-9
0014	3F	21_3	125	40	5	4000	3040	-960	0.13	0.76	7	5	-2
0014	3F	21_3	126	24	2	2400	1430	-970	0.08	0.60	4	2	-2
0014	3F	21_3	134	59	9	5900	3200	-2700	0.15	0.54	10	5	-5
0014	3F	21_3	135	28	0	2800	0	-2800	0.00	0.00	4	0	-4
0014	3F	21_3	136	18	1	1800	630	-1170	0.06	0.35	3	1	-2
0014	3F	21_3	145	22	0	2200	0	-2200	0.00	0.00	3	0	-3
0014	3F	21_3	146	6	1	600	410	-190	0.17	0.68	1	0	-1
0014	3F	21_3	156	5	0	500	0	-500	0.00	0.00	0	0	0
0014	3F	21_3	234	1	0	100	0	-100	0.00	0.00	0	0	0
0014	3F	21_3	236	2	0	200	0	-200	0.00	0.00	0	0	0
0014	3F	21_3	245	1	0	100	0	-100	0.00	0.00	0	0	0
0014	3F	21_3	256	2	0	200	0	-200	0.00	0.00	0	0	0
0014	3F	21_4	123	73	15	7300	5740	-1560	0.21	0.79	12	10	-2
0014	3F	21_4	124	85	9	8500	4950	-3550	0.11	0.58	15	8	-7
0014	3F	21_4	125	41	6	4100	2020	-2080	0.15	0.49	7	3	-4
0014	3F	21_4	126	22	0	2200	0	-2200	0.00	0.00	3	0	-3
0014	3F	21_4	134	53	10	5300	4170	-1130	0.19	0.79	9	7	-2
0014	3F	21_4	135	28	1	2800	220	-2580	0.04	0.08	4	0	-4
0014	3F	21_4	136	11	2	1100	1450	350	0.18	1.32	1	2	1
0014	3F	21_4	145	15	4	1500	2470	970	0.27	1.65	2	4	2
0014	3F	21_4	146	8	0	800	0	-800	0.00	0.00	1	0	-1
0014	3F	21_4	156	1	0	100	0	-100	0.00	0.00	0	0	0
0014	3F	21_4	235	3	0	300	0	-300	0.00	0.00	0	0	0
0014	3F	21_4	236	1	0	100	0	-100	0.00	0.00	0	0	0
0014	3F	21_4	256	1	0	100	0	-100	0.00	0.00	0	0	0
0014	3F	21_5	123	74	12	7400	3860	-3540	0.16	0.52	13	6	-7
0014	3F	21_5	124	55	8	5500	5610	110	0.15	1.02	9	9	0
0014	3F	21_5	125	37	5	3700	5910	2210	0.14	1.60	6	10	4
0014	3F	21_5	126	19	0	1900	0	-1900	0.00	0.00	3	0	-3
0014	3F	21_5	134	47	4	4700	2770	-1930	0.09	0.59	8	4	-4
0014	3F	21_5	135	26	4	2600	850	-1750	0.15	0.33	4	1	-3
0014	3F	21_5	136	11	2	1100	1400	300	0.18	1.27	1	2	1
0014	3F	21_5	145	14	1	1400	400	-1000	0.07	0.29	2	0	-2
0014	3F	21_5	146	6	2	600	2500	1900	0.33	4.17	1	4	3
0014	3F	21_5	235	4	0	400	0	-400	0.00	0.00	0	0	0
0014	3F	21_5	245	1	0	100	0	-100	0.00	0.00	0	0	0
0014	3F	21_5	246	1	0	100	0	-100	0.00	0.00	0	0	0
0014	3F	21_6	123	8	2	800	630	-170	0.25	0.79	1	1	0
0014	3F	21_6	124	4	0	400	0	-400	0.00	0.00	0	0	0
0014	3F	21_6	125	4	1	400	200	-200	0.25	0.50	0	0	0
0014	3F	21_6	134	4	0	400	0	-400	0.00	0.00	0	0	0
0014	3F	21_6	135	2	0	200	0	-200	0.00	0.00	0	0	0
0014	3F	21_6	136	1	0	100	0	-100	0.00	0.00	0	0	0
0014	3F	21_6	145	2	0	200	0	-200	0.00	0.00	0	0	0
0014	3F	21_6	146	1	0	100	0	-100	0.00	0.00	0	0	0
0014	3F	21_7	123	87	15	8700	6620	-2080	0.17	0.76	15	11	-4
0014	3F	21_7	124	83	17	8300	7420	-880	0.20	0.89	14	13	-1
0014	3F	21_7	125	53	10	5300	3850	-1450	0.19	0.73	9	6	-3
0014	3F	21_7	126	23	1	2300	500	-1800	0.04	0.22	4	0	-4
0014	3F	21_7	134	54	14	5400	7460	2060	0.26	1.38	9	13	4
0014	3F	21_7	135	31	2	3100	600	-2500	0.06	0.19	5	1	-4
0014	3F	21_7	136	12	2	1200	1710	510	0.17	1.43	2	3	1
0014	3F	21_7	145	21	2	2100	1080	-1020	0.10	0.51	3	1	-2
0014	3F	21_7	146	14	0	1400	0	-1400	0.00	0.00	2	0	-2
0014	3F	21_7	156	5	0	500	0	-500	0.00	0.00	0	0	0
0014	3F	21_7	234	2	1	200	460	260	0.50	2.30	0	0	0
0014	3F	21_7	235	4	0	400	0	-400	0.00	0.00	0	0	0
0014	3F	21_7	236	2	0	200	0	-200	0.00	0.00	0	0	0
0014	3F	21_7	245	3	0	300	0	-300	0.00	0.00	0	0	0
0014	3F	22_1	123	81	16	8100	7260	-840	0.20	0.90	14	12	-2
0014	3F	22_1	124	71	18	7100	5420	-1680	0.25	0.76	12	9	-3
0014	3F	22_1	125	41	3	4100	1230	-2870	0.07	0.30	7	2	-5
0014	3F	22_1	126	25	1	2500	3620	1120	0.04	1.45	4	6	2
0014	3F	22_1	134	39	13	3900	5070	1170	0.33	1.30	6	8	2
0014	3F	22_1	135	27	5	2700	2350	-350	0.19	0.87	4	4	0
0014	3F	22_1	136	20	2	2000	710	-1290	0.10	0.36	3	1	-2
0014	3F	22_1	145	12	1	1200	790	-410	0.08	0.66	2	1	-1
0014	3F	22_1	146	10	0	1000	0	-1000	0.00	0.00	1	0	-1
0014	3F	22_1	156	1	0	100	0	-100	0.00	0.00	0	0	0
0014	3F	22_1	234	1	0	100	0	-100	0.00	0.00	0	0	0
0014	3F	22_1	235	2	0	200	0	-200	0.00	0.00	0	0	0
0014	3F	22_1	236	1	0	100	0	-100	0.00	0.00	0	0	0
0014	3F	22_1	256	1	0	100	0	-100	0.00	0.00	0	0	0
0014	3F	22_2	123	72	17	7200	8740	1540	0.24	1.21	12	15	3
0014	3F	22_2	124	62	11	6200	7940	1740	0.18	1.28	10	14	4
0014	3F	22_2	125	41	11	4100	4420	320	0.27	1.08	7	7	0
0014	3F	22_2	126	33	1	3300	260	-3040	0.03	0.08	5	0	-5
0014	3F	22_2	134	40	6	4000	2120	-1880	0.15	0.53	7	3	-4
0014	3F	22_2	135	12	3	1200	1780	580	0.25	1.48	2	3	1
0014	3F	22_2	136	19	1	1900	500	-1400	0.05	0.26	3	0	-3
0014	3F	22_2	145	11	2	1100	2030	930	0.18	1.85	1	3	2
0014	3F	22_2	146	12	0	1200	0	-1200	0.00	0.00	2	0	-2
0014	3F	22_2	156	3	0	300	0	-300	0.00	0.00	0	0	0
0014	3F	22_2	234	1	0	100	0	-100	0.00	0.00	0	0	0
0014	3F	22_2	235	3	1	300	1480	1180	0.33	4.93	0	2	2
0014	3F	22_2	236	2	1	200	760	560	0.50	3.80	0	1	1
0014	3F	22_2	245	2	0	200	0	-200	0.00	0.00	0	0	0
0014	3F	22_2	246	2	0	200	0	-200	0.00	0.00	0	0	0
0014	3F	22_2	256	1	0	100	0	-100	0.00	0.00	0	0	0
0014	3F	22_3	123	69	20	6900	8410	1510	0.29	1.22	12	14	2
0014	3F	22_3	124	49	8	4900	2350	-2550	0.16	0.48	8	4	-4
0014	3F	22_3	125	29	3	2900	1320	-1580	0.10	0.46	5	2	-3
0014	3F	22_3	126	31	2	3100	1050	-2050	0.06	0.34	5	1	-4
0014	3F	22_3	134	30	5	3000	2100	-900	0.17	0.70	5	3	-2
0014	3F	22_3	135	23	2	2300	1510	-790	0.09	0.66	4	2	-2
0014	3F	22_3	136	14	4	1400	3710	2310	0.29	2.65	2	6	4
0014	3F	22_3	145	13	1	1300	460	-840	0.08	0.35	2	0	-2
0014	3F	22_3	146	9	1	900	380	-520	0.11	0.42	1	0	-1
0014	3F	22_3	156	6	0	600	0	-600	0.00	0.00	1	0	-1
0014	3F	22_3	234	3	0	300	0	-300	0.00	0.00	0	0	0
0014	3F	22_3	235	5	1	500	320	-180	0.20	0.64	0	0	0
0014	3F	22_3	256	1	1	100	610	510	1.00	6.10	0	1	1
0014	3F	22_4	123	68	12	6800	3890	-2910	0.18	0.57	12	6	-6
0014	3F	22_4	124	57	7	5700	2310	-3390	0.12	0.41	10	4	-6
0014	3F	22_4	125	33	5	3300	2080	-1220	0.15	0.63	5	3	-2
0014	3F	22_4	126	21	2	2100	2680	580	0.10	1.28	3	4	1
0014	3F	22_4	134	35	7	3500	2500	-1000	0.20	0.71	6	4	-2
0014	3F	22_4	135	18	2	1800	570	-1230	0.11	0.32	3	1	-2
0014	3F	22_4	136	22	7	2200	4920	2720	0.32	2.24	3	8	5
0014	3F	22_4	145	10	1	1000	2100	1100	0.10	2.10	1	3	2
0014	3F	22_4	146	8	1	800	880	80	0.13	1.10	1	1	0
0014	3F	22_4	156	3	0	300	0	-300	0.00	0.00	0	0	0
0014	3F	22_4	234	4	0	400	0	-400	0.00	0.00	0	0	0
0014	3F	22_4	235	3	0	300	0	-300	0.00	0.00	0	0	0
0014	3F	22_4	236	1	1	100	210	110	1.00	2.10	0	0	0
0014	3F	22_4	245	4	1	400	150	-250	0.25	0.38	0	0	0
0014	3F	22_4	246	3	0	300	0	-300	0.00	0.00	0	0	0
0014	3F	22_4	256	2	0	200	0	-200	0.00	0.00	0	0	0
0014	3F	22_5	123	75	21	7500	9050	1550	0.28	1.21	13	16	3
0014	3F	22_5	124	66	16	6600	6680	80	0.24	1.01	11	11	0
0014	3F	22_5	125	16	0	1600	0	-1600	0.00	0.00	2	0	-2
0014	3F	22_5	126	16	0	1600	0	-1600	0.00	0.00	2	0	-2
0014	3F	22_5	134	38	8	3800	4040	240	0.21	1.06	6	7	1
0014	3F	22_5	135	18	5	1800	4170	2370	0.28	2.32	3	7	4
0014	3F	22_5	136	12	0	1200	0	-1200	0.00	0.00	2	0	-2
0014	3F	22_5	145	9	2	900	1750	850	0.22	1.94	1	3	2
0014	3F	22_5	146	1	0	100	0	-100	0.00	0.00	0	0	0
0014	3F	22_5	234	3	0	300	0	-300	0.00	0.00	0	0	0
0014	3F	22_5	235	1	1	100	640	540	1.00	6.40	0	1	1
0014	3F	22_5	246	1	0	100	0	-100	0.00	0.00	0	0	0
0014	3F	22_5	256	1	0	100	0	-100	0.00	0.00	0	0	0
0014	3F	22_7	123	91	23	9100	9320	220	0.25	1.02	16	16	0
0014	3F	22_7	124	54	10	5400	5260	-140	0.19	0.97	9	9	0
0014	3F	22_7	125	42	9	4200	6200	2000	0.21	1.48	7	10	3
0014	3F	22_7	126	21	2	2100	1010	-1090	0.10	0.48	3	1	-2
0014	3F	22_7	134	42	10	4200	3970	-230	0.24	0.95	7	7	0
0014	3F	22_7	135	22	2	2200	1640	-560	0.09	0.75	3	2	-1
0014	3F	22_7	136	12	2	1200	2090	890	0.17	1.74	2	3	1
0014	3F	22_7	145	13	1	1300	1190	-110	0.08	0.92	2	2	0
0014	3F	22_7	146	6	0	600	0	-600	0.00	0.00	1	0	-1
0014	3F	22_7	156	2	1	200	3290	3090	0.50	16.45	0	5	5
0014	3F	22_7	234	3	0	300	0	-300	0.00	0.00	0	0	0
0014	3F	22_7	235	2	0	200	0	-200	0.00	0.00	0	0	0
0014	3F	22_7	246	2	0	200	0	-200	0.00	0.00	0	0	0
0014	3F	23_1	123	96	26	9600	8530	-1070	0.27	0.89	16	15	-1
0014	3F	23_1	124	48	10	4800	4960	160	0.21	1.03	8	8	0
0014	3F	23_1	125	35	2	3500	1330	-2170	0.06	0.38	6	2	-4
0014	3F	23_1	126	26	2	2600	1020	-1580	0.08	0.39	4	1	-3
0014	3F	23_1	134	44	6	4400	3290	-1110	0.14	0.75	7	5	-2
0014	3F	23_1	135	25	5	2500	5380	2880	0.20	2.15	4	9	5
0014	3F	23_1	136	20	2	2000	1710	-290	0.10	0.86	3	3	0
0014	3F	23_1	145	14	1	1400	210	-1190	0.07	0.15	2	0	-2
0014	3F	23_1	146	11	1	1100	230	-870	0.09	0.21	1	0	-1
0014	3F	23_1	156	3	2	300	4100	3800	0.67	13.67	0	7	7
0014	3F	23_1	234	3	0	300	0	-300	0.00	0.00	0	0	0
0014	3F	23_1	235	3	0	300	0	-300	0.00	0.00	0	0	0
0014	3F	23_1	245	1	0	100	0	-100	0.00	0.00	0	0	0
0014	3F	23_1	256	1	0	100	0	-100	0.00	0.00	0	0	0
0014	3F	23_2	123	84	16	8400	4990	-3410	0.19	0.59	14	8	-6
0014	3F	23_2	124	75	13	7500	5760	-1740	0.17	0.77	13	10	-3
0014	3F	23_2	125	41	12	4100	5920	1820	0.29	1.44	7	10	3
0014	3F	23_2	126	29	1	2900	740	-2160	0.03	0.26	5	1	-4
0014	3F	23_2	134	35	5	3500	2620	-880	0.14	0.75	6	4	-2
0014	3F	23_2	135	20	0	2000	0	-2000	0.00	0.00	3	0	-3
0014	3F	23_2	136	15	0	1500	0	-1500	0.00	0.00	2	0	-2
0014	3F	23_2	145	17	1	1700	840	-860	0.06	0.49	3	1	-2
0014	3F	23_2	146	8	1	800	1110	310	0.13	1.39	1	1	0
0014	3F	23_2	156	7	0	700	0	-700	0.00	0.00	1	0	-1
0014	3F	23_2	234	4	0	400	0	-400	0.00	0.00	0	0	0
0014	3F	23_2	235	2	0	200	0	-200	0.00	0.00	0	0	0
0014	3F	23_2	236	1	0	100	0	-100	0.00	0.00	0	0	0
0014	3F	23_2	245	2	1	200	380	180	0.50	1.90	0	0	0
0014	3F	23_2	246	1	0	100	0	-100	0.00	0.00	0	0	0
0014	3F	23_3	123	91	33	9100	14120	5020	0.36	1.55	16	24	8
0014	3F	23_3	124	53	9	5300	3380	-1920	0.17	0.64	9	5	-4
0014	3F	23_3	125	28	1	2800	410	-2390	0.04	0.15	4	0	-4
0014	3F	23_3	126	21	3	2100	11480	9380	0.14	5.47	3	20	17
0014	3F	23_3	134	39	7	3900	3000	-900	0.18	0.77	6	5	-1
0014	3F	23_3	135	26	4	2600	5930	3330	0.15	2.28	4	10	6
0014	3F	23_3	136	14	1	1400	2020	620	0.07	1.44	2	3	1
0014	3F	23_3	145	16	1	1600	520	-1080	0.06	0.33	2	0	-2
0014	3F	23_3	146	8	0	800	0	-800	0.00	0.00	1	0	-1
0014	3F	23_3	156	4	1	400	540	140	0.25	1.35	0	0	0
0014	3F	23_3	234	3	1	300	320	20	0.33	1.07	0	0	0
0014	3F	23_3	235	2	1	200	1070	870	0.50	5.35	0	1	1
0014	3F	23_3	236	2	1	200	4060	3860	0.50	20.30	0	7	7
0014	3F	23_3	245	4	0	400	0	-400	0.00	0.00	0	0	0
0014	3F	23_3	246	3	1	300	600	300	0.33	2.00	0	1	1
0014	3F	23_4	123	111	23	11100	7070	-4030	0.21	0.64	19	12	-7
0014	3F	23_4	124	57	12	5700	3960	-1740	0.21	0.69	10	7	-3
0014	3F	23_4	125	37	5	3700	7070	3370	0.14	1.91	6	12	6
0014	3F	23_4	126	15	1	1500	2310	810	0.07	1.54	2	4	2
0014	3F	23_4	134	38	5	3800	2190	-1610	0.13	0.58	6	3	-3
0014	3F	23_4	135	37	5	3700	1610	-2090	0.14	0.44	6	2	-4
0014	3F	23_4	136	14	2	1400	4170	2770	0.14	2.98	2	7	5
0014	3F	23_4	145	10	1	1000	570	-430	0.10	0.57	1	1	0
0014	3F	23_4	146	6	1	600	1680	1080	0.17	2.80	1	2	1
0014	3F	23_4	156	5	0	500	0	-500	0.00	0.00	0	0	0
0014	3F	23_4	234	4	0	400	0	-400	0.00	0.00	0	0	0
0014	3F	23_4	235	1	0	100	0	-100	0.00	0.00	0	0	0
0014	3F	23_4	236	2	0	200	0	-200	0.00	0.00	0	0	0
0014	3F	23_5	123	67	8	6700	2330	-4370	0.12	0.35	11	4	-7
0014	3F	23_5	124	56	12	5600	5320	-280	0.21	0.95	9	9	0
0014	3F	23_5	125	42	8	4200	3790	-410	0.19	0.90	7	6	-1
0014	3F	23_5	126	17	1	1700	250	-1450	0.06	0.15	3	0	-3
0014	3F	23_5	134	27	4	2700	3790	1090	0.15	1.40	4	6	2
0014	3F	23_5	135	12	0	1200	0	-1200	0.00	0.00	2	0	-2
0014	3F	23_5	136	8	0	800	0	-800	0.00	0.00	1	0	-1
0014	3F	23_5	145	17	3	1700	2910	1210	0.18	1.71	3	5	2
0014	3F	23_5	146	8	1	800	470	-330	0.13	0.59	1	0	-1
0014	3F	23_5	156	4	1	400	410	10	0.25	1.03	0	0	0
0014	3F	23_5	235	1	0	100	0	-100	0.00	0.00	0	0	0
0014	3F	23_5	236	1	0	100	0	-100	0.00	0.00	0	0	0
0014	3F	23_5	246	1	0	100	0	-100	0.00	0.00	0	0	0
0014	3F	23_6	123	4	1	400	230	-170	0.25	0.58	0	0	0
0014	3F	23_6	124	7	1	700	490	-210	0.14	0.70	1	0	-1
0014	3F	23_6	125	4	0	400	0	-400	0.00	0.00	0	0	0
0014	3F	23_6	126	1	0	100	0	-100	0.00	0.00	0	0	0
0014	3F	23_6	134	3	0	300	0	-300	0.00	0.00	0	0	0
0014	3F	23_6	135	2	0	200	0	-200	0.00	0.00	0	0	0
0014	3F	23_6	136	1	0	100	0	-100	0.00	0.00	0	0	0
0014	3F	23_6	145	2	1	200	370	170	0.50	1.85	0	0	0
0014	3F	23_6	146	1	0	100	0	-100	0.00	0.00	0	0	0
0014	3F	23_7	123	96	22	9600	6390	-3210	0.23	0.67	16	11	-5
0014	3F	23_7	124	82	10	8200	3840	-4360	0.12	0.47	14	6	-8
0014	3F	23_7	125	37	4	3700	3360	-340	0.11	0.91	6	5	-1
0014	3F	23_7	126	25	3	2500	2580	80	0.12	1.03	4	4	0
0014	3F	23_7	134	52	4	5200	2630	-2570	0.08	0.51	9	4	-5
0014	3F	23_7	135	25	4	2500	3700	1200	0.16	1.48	4	6	2
0014	3F	23_7	136	16	3	1600	1950	350	0.19	1.22	2	3	1
0014	3F	23_7	145	15	3	1500	840	-660	0.20	0.56	2	1	-1
0014	3F	23_7	146	8	0	800	0	-800	0.00	0.00	1	0	-1
0014	3F	23_7	156	6	0	600	0	-600	0.00	0.00	1	0	-1
0014	3F	23_7	234	2	0	200	0	-200	0.00	0.00	0	0	0
0014	3F	23_7	235	2	1	200	5180	4980	0.50	25.90	0	9	9
0014	3F	23_7	236	2	0	200	0	-200	0.00	0.00	0	0	0
0014	3F	24_1	123	100	24	10000	9480	-520	0.24	0.95	17	16	-1
0014	3F	24_1	124	80	9	8000	3090	-4910	0.11	0.39	14	5	-9
0014	3F	24_1	125	47	15	4700	16140	11440	0.32	3.43	8	28	20
0014	3F	24_1	126	33	6	3300	3510	210	0.18	1.06	5	6	1
0014	3F	24_1	134	56	12	5600	8620	3020	0.21	1.54	9	15	6
0014	3F	24_1	135	28	4	2800	3660	860	0.14	1.31	4	6	2
0014	3F	24_1	136	24	4	2400	4130	1730	0.17	1.72	4	7	3
0014	3F	24_1	145	14	1	1400	230	-1170	0.07	0.16	2	0	-2
0014	3F	24_1	146	10	1	1000	2540	1540	0.10	2.54	1	4	3
0014	3F	24_1	156	5	0	500	0	-500	0.00	0.00	0	0	0
0014	3F	24_1	234	3	1	300	3990	3690	0.33	13.30	0	7	7
0014	3F	24_1	235	2	0	200	0	-200	0.00	0.00	0	0	0
0014	3F	24_1	236	1	0	100	0	-100	0.00	0.00	0	0	0
0014	3F	24_1	245	1	1	100	400	300	1.00	4.00	0	0	0
0014	3F	24_1	256	2	0	200	0	-200	0.00	0.00	0	0	0
0014	3F	24_2	123	91	26	9100	8300	-800	0.29	0.91	16	14	-2
0014	3F	24_2	124	78	13	7800	4270	-3530	0.17	0.55	13	7	-6
0014	3F	24_2	125	46	5	4600	1740	-2860	0.11	0.38	8	3	-5
0014	3F	24_2	126	41	6	4100	2710	-1390	0.15	0.66	7	4	-3
0014	3F	24_2	134	63	10	6300	4260	-2040	0.16	0.68	11	7	-4
0014	3F	24_2	135	26	3	2600	6590	3990	0.12	2.53	4	11	7
0014	3F	24_2	136	35	4	3500	1630	-1870	0.11	0.47	6	2	-4
0014	3F	24_2	145	13	1	1300	400	-900	0.08	0.31	2	0	-2
0014	3F	24_2	146	8	0	800	0	-800	0.00	0.00	1	0	-1
0014	3F	24_2	156	1	0	100	0	-100	0.00	0.00	0	0	0
0014	3F	24_2	234	6	2	600	1100	500	0.33	1.83	1	1	0
0014	3F	24_2	236	5	2	500	4020	3520	0.40	8.04	0	7	7
0014	3F	24_2	245	1	0	100	0	-100	0.00	0.00	0	0	0
0014	3F	24_2	246	2	0	200	0	-200	0.00	0.00	0	0	0
0014	3F	24_2	256	1	0	100	0	-100	0.00	0.00	0	0	0
0014	3F	24_3	123	133	43	13300	18420	5120	0.32	1.38	23	32	9
0014	3F	24_3	124	89	18	8900	10320	1420	0.20	1.16	15	18	3
0014	3F	24_3	125	34	2	3400	630	-2770	0.06	0.19	6	1	-5
0014	3F	24_3	126	21	1	2100	250	-1850	0.05	0.12	3	0	-3
0014	3F	24_3	134	55	7	5500	2900	-2600	0.13	0.53	9	5	-4
0014	3F	24_3	135	36	5	3600	1920	-1680	0.14	0.53	6	3	-3
0014	3F	24_3	136	19	1	1900	430	-1470	0.05	0.23	3	0	-3
0014	3F	24_3	145	20	1	2000	1900	-100	0.05	0.95	3	3	0
0014	3F	24_3	146	6	0	600	0	-600	0.00	0.00	1	0	-1
0014	3F	24_3	156	3	0	300	0	-300	0.00	0.00	0	0	0
0014	3F	24_3	234	4	2	400	2150	1750	0.50	5.38	0	3	3
0014	3F	24_3	236	2	1	200	1390	1190	0.50	6.95	0	2	2
0014	3F	24_3	246	2	0	200	0	-200	0.00	0.00	0	0	0
0014	3F	24_3	256	2	0	200	0	-200	0.00	0.00	0	0	0
0014	3F	24_4	123	72	19	7200	5250	-1950	0.26	0.73	12	9	-3
0014	3F	24_4	124	68	12	6800	4430	-2370	0.18	0.65	12	7	-5
0014	3F	24_4	125	26	8	2600	4360	1760	0.31	1.68	4	7	3
0014	3F	24_4	126	18	1	1800	1200	-600	0.06	0.67	3	2	-1
0014	3F	24_4	134	46	12	4600	5880	1280	0.26	1.28	8	10	2
0014	3F	24_4	135	34	8	3400	5280	1880	0.24	1.55	6	9	3
0014	3F	24_4	136	6	0	600	0	-600	0.00	0.00	1	0	-1
0014	3F	24_4	145	20	0	2000	0	-2000	0.00	0.00	3	0	-3
0014	3F	24_4	146	9	0	900	0	-900	0.00	0.00	1	0	-1
0014	3F	24_4	156	2	0	200	0	-200	0.00	0.00	0	0	0
0014	3F	24_4	234	2	1	200	580	380	0.50	2.90	0	1	1
0014	3F	24_4	236	1	0	100	0	-100	0.00	0.00	0	0	0
0014	3F	24_4	245	1	0	100	0	-100	0.00	0.00	0	0	0
0014	3F	24_4	246	2	0	200	0	-200	0.00	0.00	0	0	0
0014	3F	24_5	123	41	10	4100	3150	-950	0.24	0.77	7	5	-2
0014	3F	24_5	124	34	7	3400	1750	-1650	0.21	0.51	6	3	-3
0014	3F	24_5	125	16	2	1600	790	-810	0.13	0.49	2	1	-1
0014	3F	24_5	126	4	0	400	0	-400	0.00	0.00	0	0	0
0014	3F	24_5	134	24	2	2400	670	-1730	0.08	0.28	4	1	-3
0014	3F	24_5	135	17	3	1700	1210	-490	0.18	0.71	3	2	-1
0014	3F	24_5	136	8	0	800	0	-800	0.00	0.00	1	0	-1
0014	3F	24_5	145	3	0	300	0	-300	0.00	0.00	0	0	0
0014	3F	24_5	146	1	0	100	0	-100	0.00	0.00	0	0	0
0014	3F	24_5	156	2	0	200	0	-200	0.00	0.00	0	0	0
0014	3F	24_5	235	2	0	200	0	-200	0.00	0.00	0	0	0
0014	3F	24_5	236	1	0	100	0	-100	0.00	0.00	0	0	0
0014	3F	24_5	245	1	0	100	0	-100	0.00	0.00	0	0	0
0014	3F	24_5	256	1	0	100	0	-100	0.00	0.00	0	0	0
0014	3F	24_6	123	14	0	1400	0	-1400	0.00	0.00	2	0	-2
0014	3F	24_6	124	12	4	1200	1360	160	0.33	1.13	2	2	0
0014	3F	24_6	125	6	3	600	2340	1740	0.50	3.90	1	4	3
0014	3F	24_6	134	5	1	500	450	-50	0.20	0.90	0	0	0
0014	3F	24_6	135	1	0	100	0	-100	0.00	0.00	0	0	0
0014	3F	24_6	136	2	1	200	220	20	0.50	1.10	0	0	0
0014	3F	24_6	145	3	0	300	0	-300	0.00	0.00	0	0	0
0014	3F	24_7	123	118	24	11800	6790	-5010	0.20	0.58	20	12	-8
0014	3F	24_7	124	79	13	7900	5530	-2370	0.16	0.70	13	9	-4
0014	3F	24_7	125	52	9	5200	4700	-500	0.17	0.90	9	8	-1
0014	3F	24_7	126	26	4	2600	3650	1050	0.15	1.40	4	6	2
0014	3F	24_7	134	64	7	6400	3620	-2780	0.11	0.57	11	6	-5
0014	3F	24_7	135	40	6	4000	3030	-970	0.15	0.76	7	5	-2
0014	3F	24_7	136	23	3	2300	3400	1100	0.13	1.48	4	6	2
0014	3F	24_7	145	20	0	2000	0	-2000	0.00	0.00	3	0	-3
0014	3F	24_7	146	7	0	700	0	-700	0.00	0.00	1	0	-1
0014	3F	24_7	156	5	0	500	0	-500	0.00	0.00	0	0	0
0014	3F	24_7	234	2	0	200	0	-200	0.00	0.00	0	0	0
0014	3F	24_7	235	1	0	100	0	-100	0.00	0.00	0	0	0
0014	3F	24_7	236	2	0	200	0	-200	0.00	0.00	0	0	0
0014	3F	24_7	245	1	0	100	0	-100	0.00	0.00	0	0	0
0014	3F	24_7	256	3	0	300	0	-300	0.00	0.00	0	0	0
0014	3T	01_1	123	59	8	5900	7300	1400	0.14	1.24	10	12	2
0014	3T	01_1	124	43	4	4300	4910	610	0.09	1.14	7	8	1
0014	3T	01_1	125	37	6	3700	6240	2540	0.16	1.69	6	11	5
0014	3T	01_1	126	21	0	2100	0	-2100	0.00	0.00	3	0	-3
0014	3T	01_1	132	23	1	2300	1250	-1050	0.04	0.54	4	2	-2
0014	3T	01_1	134	22	2	2200	1900	-300	0.09	0.86	3	3	0
0014	3T	01_1	135	13	0	1300	0	-1300	0.00	0.00	2	0	-2
0014	3T	01_1	136	7	0	700	0	-700	0.00	0.00	1	0	-1
0014	3T	01_1	142	18	4	1800	5750	3950	0.22	3.19	3	10	7
0014	3T	01_1	143	19	0	1900	0	-1900	0.00	0.00	3	0	-3
0014	3T	01_1	145	11	0	1100	0	-1100	0.00	0.00	1	0	-1
0014	3T	01_1	146	4	0	400	0	-400	0.00	0.00	0	0	0
0014	3T	01_1	152	8	0	800	0	-800	0.00	0.00	1	0	-1
0014	3T	01_1	153	3	0	300	0	-300	0.00	0.00	0	0	0
0014	3T	01_1	154	5	0	500	0	-500	0.00	0.00	0	0	0
0014	3T	01_1	156	10	0	1000	0	-1000	0.00	0.00	1	0	-1
0014	3T	01_1	162	3	0	300	0	-300	0.00	0.00	0	0	0
0014	3T	01_1	163	2	0	200	0	-200	0.00	0.00	0	0	0
0014	3T	01_1	164	2	0	200	0	-200	0.00	0.00	0	0	0
0014	3T	01_1	165	1	0	100	0	-100	0.00	0.00	0	0	0
0014	3T	01_1	213	5	0	500	0	-500	0.00	0.00	0	0	0
0014	3T	01_1	214	5	0	500	0	-500	0.00	0.00	0	0	0
0014	3T	01_1	215	2	0	200	0	-200	0.00	0.00	0	0	0
0014	3T	01_1	216	1	0	100	0	-100	0.00	0.00	0	0	0
0014	3T	01_1	234	2	0	200	0	-200	0.00	0.00	0	0	0
0014	3T	01_1	235	1	0	100	0	-100	0.00	0.00	0	0	0
0014	3T	01_1	236	2	0	200	0	-200	0.00	0.00	0	0	0
0014	3T	01_1	241	1	0	100	0	-100	0.00	0.00	0	0	0
0014	3T	01_1	243	1	0	100	0	-100	0.00	0.00	0	0	0
0014	3T	01_1	246	2	0	200	0	-200	0.00	0.00	0	0	0
0014	3T	01_1	251	1	0	100	0	-100	0.00	0.00	0	0	0
0014	3T	01_1	253	3	0	300	0	-300	0.00	0.00	0	0	0
0014	3T	01_2	123	56	2	5600	1370	-4230	0.04	0.24	9	2	-7
0014	3T	01_2	124	35	1	3500	1030	-2470	0.03	0.29	6	1	-5
0014	3T	01_2	125	43	1	4300	1080	-3220	0.02	0.25	7	1	-6
0014	3T	01_2	126	24	0	2400	0	-2400	0.00	0.00	4	0	-4
0014	3T	01_2	132	13	1	1300	1600	300	0.08	1.23	2	2	0
0014	3T	01_2	134	23	3	2300	4080	1780	0.13	1.77	4	7	3
0014	3T	01_2	135	18	0	1800	0	-1800	0.00	0.00	3	0	-3
0014	3T	01_2	136	10	1	1000	3060	2060	0.10	3.06	1	5	4
0014	3T	01_2	142	15	4	1500	5810	4310	0.27	3.87	2	10	8
0014	3T	01_2	143	14	0	1400	0	-1400	0.00	0.00	2	0	-2
0014	3T	01_2	145	8	2	800	2530	1730	0.25	3.16	1	4	3
0014	3T	01_2	146	5	0	500	0	-500	0.00	0.00	0	0	0
0014	3T	01_2	152	13	2	1300	3730	2430	0.15	2.87	2	6	4
0014	3T	01_2	153	6	0	600	0	-600	0.00	0.00	1	0	-1
0014	3T	01_2	154	9	0	900	0	-900	0.00	0.00	1	0	-1
0014	3T	01_2	156	6	0	600	0	-600	0.00	0.00	1	0	-1
0014	3T	01_2	162	5	0	500	0	-500	0.00	0.00	0	0	0
0014	3T	01_2	163	1	0	100	0	-100	0.00	0.00	0	0	0
0014	3T	01_2	213	3	0	300	0	-300	0.00	0.00	0	0	0
0014	3T	01_2	214	4	0	400	0	-400	0.00	0.00	0	0	0
0014	3T	01_2	215	6	0	600	0	-600	0.00	0.00	1	0	-1
0014	3T	01_2	216	4	0	400	0	-400	0.00	0.00	0	0	0
0014	3T	01_2	231	2	0	200	0	-200	0.00	0.00	0	0	0
0014	3T	01_2	234	2	0	200	0	-200	0.00	0.00	0	0	0
0014	3T	01_2	235	2	0	200	0	-200	0.00	0.00	0	0	0
0014	3T	01_2	236	1	0	100	0	-100	0.00	0.00	0	0	0
0014	3T	01_2	241	4	0	400	0	-400	0.00	0.00	0	0	0
0014	3T	01_2	243	2	0	200	0	-200	0.00	0.00	0	0	0
0014	3T	01_2	251	4	0	400	0	-400	0.00	0.00	0	0	0
0014	3T	01_2	254	1	0	100	0	-100	0.00	0.00	0	0	0
0014	3T	01_2	256	1	0	100	0	-100	0.00	0.00	0	0	0
0014	3T	01_2	261	1	0	100	0	-100	0.00	0.00	0	0	0
0014	3T	01_2	263	1	0	100	0	-100	0.00	0.00	0	0	0
0014	3T	01_3	123	38	5	3800	4680	880	0.13	1.23	6	8	2
0014	3T	01_3	124	35	1	3500	1540	-1960	0.03	0.44	6	2	-4
0014	3T	01_3	125	35	3	3500	4710	1210	0.09	1.35	6	8	2
0014	3T	01_3	126	19	2	1900	1850	-50	0.11	0.97	3	3	0
0014	3T	01_3	132	26	2	2600	1180	-1420	0.08	0.45	4	2	-2
0014	3T	01_3	134	15	3	1500	4500	3000	0.20	3.00	2	7	5
0014	3T	01_3	135	18	2	1800	4480	2680	0.11	2.49	3	7	4
0014	3T	01_3	136	21	0	2100	0	-2100	0.00	0.00	3	0	-3
0014	3T	01_3	142	12	0	1200	0	-1200	0.00	0.00	2	0	-2
0014	3T	01_3	143	16	3	1600	7450	5850	0.19	4.66	2	13	11
0014	3T	01_3	145	7	0	700	0	-700	0.00	0.00	1	0	-1
0014	3T	01_3	146	5	0	500	0	-500	0.00	0.00	0	0	0
0014	3T	01_3	152	6	0	600	0	-600	0.00	0.00	1	0	-1
0014	3T	01_3	153	8	0	800	0	-800	0.00	0.00	1	0	-1
0014	3T	01_3	154	5	0	500	0	-500	0.00	0.00	0	0	0
0014	3T	01_3	156	5	1	500	2050	1550	0.20	4.10	0	3	3
0014	3T	01_3	162	6	0	600	0	-600	0.00	0.00	1	0	-1
0014	3T	01_3	163	3	0	300	0	-300	0.00	0.00	0	0	0
0014	3T	01_3	164	4	0	400	0	-400	0.00	0.00	0	0	0
0014	3T	01_3	165	1	0	100	0	-100	0.00	0.00	0	0	0
0014	3T	01_3	213	6	1	600	3100	2500	0.17	5.17	1	5	4
0014	3T	01_3	214	9	0	900	0	-900	0.00	0.00	1	0	-1
0014	3T	01_3	215	4	0	400	0	-400	0.00	0.00	0	0	0
0014	3T	01_3	216	1	0	100	0	-100	0.00	0.00	0	0	0
0014	3T	01_3	231	2	0	200	0	-200	0.00	0.00	0	0	0
0014	3T	01_3	234	4	0	400	0	-400	0.00	0.00	0	0	0
0014	3T	01_3	235	1	0	100	0	-100	0.00	0.00	0	0	0
0014	3T	01_3	243	2	0	200	0	-200	0.00	0.00	0	0	0
0014	3T	01_3	245	1	0	100	0	-100	0.00	0.00	0	0	0
0014	3T	01_3	246	1	0	100	0	-100	0.00	0.00	0	0	0
0014	3T	01_3	251	2	0	200	0	-200	0.00	0.00	0	0	0
0014	3T	01_3	253	2	0	200	0	-200	0.00	0.00	0	0	0
0014	3T	01_3	254	1	0	100	0	-100	0.00	0.00	0	0	0
0014	3T	01_3	256	1	0	100	0	-100	0.00	0.00	0	0	0
0014	3T	01_3	265	1	0	100	0	-100	0.00	0.00	0	0	0
0014	3T	01_4	123	46	5	4600	3660	-940	0.11	0.80	8	6	-2
0014	3T	01_4	124	39	2	3900	1400	-2500	0.05	0.36	6	2	-4
0014	3T	01_4	125	31	1	3100	820	-2280	0.03	0.26	5	1	-4
0014	3T	01_4	126	19	0	1900	0	-1900	0.00	0.00	3	0	-3
0014	3T	01_4	132	10	2	1000	1380	380	0.20	1.38	1	2	1
0014	3T	01_4	134	24	0	2400	0	-2400	0.00	0.00	4	0	-4
0014	3T	01_4	135	20	0	2000	0	-2000	0.00	0.00	3	0	-3
0014	3T	01_4	136	17	3	1700	6610	4910	0.18	3.89	3	11	8
0014	3T	01_4	142	16	1	1600	2370	770	0.06	1.48	2	4	2
0014	3T	01_4	143	13	0	1300	0	-1300	0.00	0.00	2	0	-2
0014	3T	01_4	145	8	0	800	0	-800	0.00	0.00	1	0	-1
0014	3T	01_4	146	7	0	700	0	-700	0.00	0.00	1	0	-1
0014	3T	01_4	152	8	0	800	0	-800	0.00	0.00	1	0	-1
0014	3T	01_4	153	7	0	700	0	-700	0.00	0.00	1	0	-1
0014	3T	01_4	154	3	0	300	0	-300	0.00	0.00	0	0	0
0014	3T	01_4	156	9	0	900	0	-900	0.00	0.00	1	0	-1
0014	3T	01_4	162	3	0	300	0	-300	0.00	0.00	0	0	0
0014	3T	01_4	163	2	0	200	0	-200	0.00	0.00	0	0	0
0014	3T	01_4	164	1	0	100	0	-100	0.00	0.00	0	0	0
0014	3T	01_4	165	4	0	400	0	-400	0.00	0.00	0	0	0
0014	3T	01_4	213	5	0	500	0	-500	0.00	0.00	0	0	0
0014	3T	01_4	214	6	0	600	0	-600	0.00	0.00	1	0	-1
0014	3T	01_4	215	1	0	100	0	-100	0.00	0.00	0	0	0
0014	3T	01_4	216	2	0	200	0	-200	0.00	0.00	0	0	0
0014	3T	01_4	231	2	0	200	0	-200	0.00	0.00	0	0	0
0014	3T	01_4	234	8	0	800	0	-800	0.00	0.00	1	0	-1
0014	3T	01_4	235	1	0	100	0	-100	0.00	0.00	0	0	0
0014	3T	01_4	236	1	0	100	0	-100	0.00	0.00	0	0	0
0014	3T	01_4	241	4	0	400	0	-400	0.00	0.00	0	0	0
0014	3T	01_4	243	1	0	100	0	-100	0.00	0.00	0	0	0
0014	3T	01_4	246	1	0	100	0	-100	0.00	0.00	0	0	0
0014	3T	01_4	253	1	0	100	0	-100	0.00	0.00	0	0	0
0014	3T	01_4	254	1	0	100	0	-100	0.00	0.00	0	0	0
0014	3T	01_4	256	2	0	200	0	-200	0.00	0.00	0	0	0
0014	3T	01_4	263	1	0	100	0	-100	0.00	0.00	0	0	0
0014	3T	01_4	264	2	0	200	0	-200	0.00	0.00	0	0	0
0014	3T	01_4	265	1	0	100	0	-100	0.00	0.00	0	0	0
0014	3T	01_5	123	26	3	2600	1900	-700	0.12	0.73	4	3	-1
0014	3T	01_5	124	31	2	3100	2440	-660	0.06	0.79	5	4	-1
0014	3T	01_5	125	17	1	1700	1760	60	0.06	1.04	3	3	0
0014	3T	01_5	126	11	0	1100	0	-1100	0.00	0.00	1	0	-1
0014	3T	01_5	132	11	2	1100	1710	610	0.18	1.55	1	3	2
0014	3T	01_5	134	26	0	2600	0	-2600	0.00	0.00	4	0	-4
0014	3T	01_5	135	16	1	1600	1680	80	0.06	1.05	2	2	0
0014	3T	01_5	136	3	0	300	0	-300	0.00	0.00	0	0	0
0014	3T	01_5	142	15	0	1500	0	-1500	0.00	0.00	2	0	-2
0014	3T	01_5	143	5	0	500	0	-500	0.00	0.00	0	0	0
0014	3T	01_5	145	5	0	500	0	-500	0.00	0.00	0	0	0
0014	3T	01_5	146	4	0	400	0	-400	0.00	0.00	0	0	0
0014	3T	01_5	152	8	1	800	770	-30	0.13	0.96	1	1	0
0014	3T	01_5	153	3	0	300	0	-300	0.00	0.00	0	0	0
0014	3T	01_5	154	1	0	100	0	-100	0.00	0.00	0	0	0
0014	3T	01_5	162	2	0	200	0	-200	0.00	0.00	0	0	0
0014	3T	01_5	163	2	0	200	0	-200	0.00	0.00	0	0	0
0014	3T	01_5	164	4	0	400	0	-400	0.00	0.00	0	0	0
0014	3T	01_5	213	1	0	100	0	-100	0.00	0.00	0	0	0
0014	3T	01_5	216	2	0	200	0	-200	0.00	0.00	0	0	0
0014	3T	01_5	231	1	0	100	0	-100	0.00	0.00	0	0	0
0014	3T	01_5	234	1	0	100	0	-100	0.00	0.00	0	0	0
0014	3T	01_5	236	1	0	100	0	-100	0.00	0.00	0	0	0
0014	3T	01_5	243	2	0	200	0	-200	0.00	0.00	0	0	0
0014	3T	01_5	251	1	0	100	0	-100	0.00	0.00	0	0	0
0014	3T	01_5	263	1	0	100	0	-100	0.00	0.00	0	0	0
0014	3T	01_6	123	3	0	300	0	-300	0.00	0.00	0	0	0
0014	3T	01_6	124	5	0	500	0	-500	0.00	0.00	0	0	0
0014	3T	01_6	125	3	0	300	0	-300	0.00	0.00	0	0	0
0014	3T	01_6	126	1	0	100	0	-100	0.00	0.00	0	0	0
0014	3T	01_6	132	4	0	400	0	-400	0.00	0.00	0	0	0
0014	3T	01_6	134	3	0	300	0	-300	0.00	0.00	0	0	0
0014	3T	01_6	135	1	0	100	0	-100	0.00	0.00	0	0	0
0014	3T	01_6	142	3	0	300	0	-300	0.00	0.00	0	0	0
0014	3T	01_6	153	1	1	100	620	520	1.00	6.20	0	1	1
0014	3T	01_6	164	1	0	100	0	-100	0.00	0.00	0	0	0
0014	3T	01_6	234	1	0	100	0	-100	0.00	0.00	0	0	0
0014	3T	01_7	123	46	6	4600	5560	960	0.13	1.21	8	9	1
0014	3T	01_7	124	36	0	3600	0	-3600	0.00	0.00	6	0	-6
0014	3T	01_7	125	35	2	3500	1550	-1950	0.06	0.44	6	2	-4
0014	3T	01_7	126	27	0	2700	0	-2700	0.00	0.00	4	0	-4
0014	3T	01_7	132	35	0	3500	0	-3500	0.00	0.00	6	0	-6
0014	3T	01_7	134	24	2	2400	2410	10	0.08	1.00	4	4	0
0014	3T	01_7	135	15	1	1500	1490	-10	0.07	0.99	2	2	0
0014	3T	01_7	136	9	0	900	0	-900	0.00	0.00	1	0	-1
0014	3T	01_7	142	25	1	2500	720	-1780	0.04	0.29	4	1	-3
0014	3T	01_7	143	18	1	1800	830	-970	0.06	0.46	3	1	-2
0014	3T	01_7	145	7	0	700	0	-700	0.00	0.00	1	0	-1
0014	3T	01_7	146	8	0	800	0	-800	0.00	0.00	1	0	-1
0014	3T	01_7	152	10	0	1000	0	-1000	0.00	0.00	1	0	-1
0014	3T	01_7	153	11	0	1100	0	-1100	0.00	0.00	1	0	-1
0014	3T	01_7	154	5	0	500	0	-500	0.00	0.00	0	0	0
0014	3T	01_7	156	9	1	900	4420	3520	0.11	4.91	1	7	6
0014	3T	01_7	162	3	0	300	0	-300	0.00	0.00	0	0	0
0014	3T	01_7	163	6	1	600	2070	1470	0.17	3.45	1	3	2
0014	3T	01_7	164	4	0	400	0	-400	0.00	0.00	0	0	0
0014	3T	01_7	165	4	0	400	0	-400	0.00	0.00	0	0	0
0014	3T	01_7	213	2	0	200	0	-200	0.00	0.00	0	0	0
0014	3T	01_7	214	3	0	300	0	-300	0.00	0.00	0	0	0
0014	3T	01_7	215	2	0	200	0	-200	0.00	0.00	0	0	0
0014	3T	01_7	216	3	0	300	0	-300	0.00	0.00	0	0	0
0014	3T	01_7	231	2	0	200	0	-200	0.00	0.00	0	0	0
0014	3T	01_7	234	4	0	400	0	-400	0.00	0.00	0	0	0
0014	3T	01_7	236	2	0	200	0	-200	0.00	0.00	0	0	0
0014	3T	01_7	246	1	0	100	0	-100	0.00	0.00	0	0	0
0014	3T	01_7	253	1	0	100	0	-100	0.00	0.00	0	0	0
0014	3T	01_7	254	1	0	100	0	-100	0.00	0.00	0	0	0
0014	3T	01_7	261	2	0	200	0	-200	0.00	0.00	0	0	0
0014	3T	01_7	263	4	0	400	0	-400	0.00	0.00	0	0	0
0014	3T	01_7	265	2	0	200	0	-200	0.00	0.00	0	0	0
0014	3T	02_1	123	44	2	4400	1150	-3250	0.05	0.26	7	2	-5
0014	3T	02_1	124	53	4	5300	6240	940	0.08	1.18	9	11	2
0014	3T	02_1	125	33	3	3300	5720	2420	0.09	1.73	5	10	5
0014	3T	02_1	126	33	2	3300	4190	890	0.06	1.27	5	7	2
0014	3T	02_1	132	28	1	2800	3900	1100	0.04	1.39	4	6	2
0014	3T	02_1	134	30	1	3000	3090	90	0.03	1.03	5	5	0
0014	3T	02_1	135	18	0	1800	0	-1800	0.00	0.00	3	0	-3
0014	3T	02_1	136	10	0	1000	0	-1000	0.00	0.00	1	0	-1
0014	3T	02_1	142	14	0	1400	0	-1400	0.00	0.00	2	0	-2
0014	3T	02_1	143	10	1	1000	2360	1360	0.10	2.36	1	4	3
0014	3T	02_1	145	10	0	1000	0	-1000	0.00	0.00	1	0	-1
0014	3T	02_1	146	7	0	700	0	-700	0.00	0.00	1	0	-1
0014	3T	02_1	152	6	0	600	0	-600	0.00	0.00	1	0	-1
0014	3T	02_1	153	7	0	700	0	-700	0.00	0.00	1	0	-1
0014	3T	02_1	154	5	0	500	0	-500	0.00	0.00	0	0	0
0014	3T	02_1	156	5	0	500	0	-500	0.00	0.00	0	0	0
0014	3T	02_1	162	5	0	500	0	-500	0.00	0.00	0	0	0
0014	3T	02_1	163	5	0	500	0	-500	0.00	0.00	0	0	0
0014	3T	02_1	164	7	1	700	6920	6220	0.14	9.89	1	12	11
0014	3T	02_1	165	3	0	300	0	-300	0.00	0.00	0	0	0
0014	3T	02_1	213	8	0	800	0	-800	0.00	0.00	1	0	-1
0014	3T	02_1	214	4	0	400	0	-400	0.00	0.00	0	0	0
0014	3T	02_1	215	4	0	400	0	-400	0.00	0.00	0	0	0
0014	3T	02_1	216	9	0	900	0	-900	0.00	0.00	1	0	-1
0014	3T	02_1	231	2	0	200	0	-200	0.00	0.00	0	0	0
0014	3T	02_1	234	3	0	300	0	-300	0.00	0.00	0	0	0
0014	3T	02_1	235	4	0	400	0	-400	0.00	0.00	0	0	0
0014	3T	02_1	236	1	0	100	0	-100	0.00	0.00	0	0	0
0014	3T	02_1	243	1	0	100	0	-100	0.00	0.00	0	0	0
0014	3T	02_1	245	3	0	300	0	-300	0.00	0.00	0	0	0
0014	3T	02_1	253	1	0	100	0	-100	0.00	0.00	0	0	0
0014	3T	02_1	254	2	0	200	0	-200	0.00	0.00	0	0	0
0014	3T	02_1	256	2	0	200	0	-200	0.00	0.00	0	0	0
0014	3T	02_1	263	1	0	100	0	-100	0.00	0.00	0	0	0
0014	3T	02_1	264	1	0	100	0	-100	0.00	0.00	0	0	0
0014	3T	02_2	123	42	1	4200	1170	-3030	0.02	0.28	7	2	-5
0014	3T	02_2	124	54	1	5400	1910	-3490	0.02	0.35	9	3	-6
0014	3T	02_2	125	29	1	2900	920	-1980	0.03	0.32	5	1	-4
0014	3T	02_2	126	24	0	2400	0	-2400	0.00	0.00	4	0	-4
0014	3T	02_2	132	31	2	3100	2030	-1070	0.06	0.65	5	3	-2
0014	3T	02_2	134	16	1	1600	840	-760	0.06	0.53	2	1	-1
0014	3T	02_2	135	15	0	1500	0	-1500	0.00	0.00	2	0	-2
0014	3T	02_2	136	20	1	2000	1330	-670	0.05	0.67	3	2	-1
0014	3T	02_2	142	16	0	1600	0	-1600	0.00	0.00	2	0	-2
0014	3T	02_2	143	12	2	1200	3930	2730	0.17	3.28	2	6	4
0014	3T	02_2	145	16	1	1600	4720	3120	0.06	2.95	2	8	6
0014	3T	02_2	146	11	0	1100	0	-1100	0.00	0.00	1	0	-1
0014	3T	02_2	152	7	0	700	0	-700	0.00	0.00	1	0	-1
0014	3T	02_2	153	7	0	700	0	-700	0.00	0.00	1	0	-1
0014	3T	02_2	154	6	0	600	0	-600	0.00	0.00	1	0	-1
0014	3T	02_2	156	4	0	400	0	-400	0.00	0.00	0	0	0
0014	3T	02_2	162	2	0	200	0	-200	0.00	0.00	0	0	0
0014	3T	02_2	163	7	0	700	0	-700	0.00	0.00	1	0	-1
0014	3T	02_2	164	4	1	400	1920	1520	0.25	4.80	0	3	3
0014	3T	02_2	213	7	0	700	0	-700	0.00	0.00	1	0	-1
0014	3T	02_2	214	1	0	100	0	-100	0.00	0.00	0	0	0
0014	3T	02_2	215	10	0	1000	0	-1000	0.00	0.00	1	0	-1
0014	3T	02_2	216	8	0	800	0	-800	0.00	0.00	1	0	-1
0014	3T	02_2	231	2	0	200	0	-200	0.00	0.00	0	0	0
0014	3T	02_2	234	3	1	300	2380	2080	0.33	7.93	0	4	4
0014	3T	02_2	235	4	0	400	0	-400	0.00	0.00	0	0	0
0014	3T	02_2	236	2	0	200	0	-200	0.00	0.00	0	0	0
0014	3T	02_2	243	4	0	400	0	-400	0.00	0.00	0	0	0
0014	3T	02_2	245	4	0	400	0	-400	0.00	0.00	0	0	0
0014	3T	02_2	246	2	0	200	0	-200	0.00	0.00	0	0	0
0014	3T	02_2	251	2	0	200	0	-200	0.00	0.00	0	0	0
0014	3T	02_2	254	2	0	200	0	-200	0.00	0.00	0	0	0
0014	3T	02_2	256	2	0	200	0	-200	0.00	0.00	0	0	0
0014	3T	02_2	261	1	0	100	0	-100	0.00	0.00	0	0	0
0014	3T	02_2	263	1	0	100	0	-100	0.00	0.00	0	0	0
0014	3T	02_2	264	2	0	200	0	-200	0.00	0.00	0	0	0
0014	3T	02_3	123	46	1	4600	1000	-3600	0.02	0.22	8	1	-7
0014	3T	02_3	124	49	5	4900	7670	2770	0.10	1.57	8	13	5
0014	3T	02_3	125	24	1	2400	1230	-1170	0.04	0.51	4	2	-2
0014	3T	02_3	126	21	0	2100	0	-2100	0.00	0.00	3	0	-3
0014	3T	02_3	132	29	1	2900	1030	-1870	0.03	0.36	5	1	-4
0014	3T	02_3	134	21	0	2100	0	-2100	0.00	0.00	3	0	-3
0014	3T	02_3	135	16	1	1600	3050	1450	0.06	1.91	2	5	3
0014	3T	02_3	136	18	0	1800	0	-1800	0.00	0.00	3	0	-3
0014	3T	02_3	142	17	0	1700	0	-1700	0.00	0.00	3	0	-3
0014	3T	02_3	143	15	0	1500	0	-1500	0.00	0.00	2	0	-2
0014	3T	02_3	145	18	0	1800	0	-1800	0.00	0.00	3	0	-3
0014	3T	02_3	146	10	0	1000	0	-1000	0.00	0.00	1	0	-1
0014	3T	02_3	152	7	0	700	0	-700	0.00	0.00	1	0	-1
0014	3T	02_3	153	8	1	800	1250	450	0.13	1.56	1	2	1
0014	3T	02_3	154	6	0	600	0	-600	0.00	0.00	1	0	-1
0014	3T	02_3	156	5	0	500	0	-500	0.00	0.00	0	0	0
0014	3T	02_3	162	6	0	600	0	-600	0.00	0.00	1	0	-1
0014	3T	02_3	163	6	0	600	0	-600	0.00	0.00	1	0	-1
0014	3T	02_3	164	2	0	200	0	-200	0.00	0.00	0	0	0
0014	3T	02_3	165	3	0	300	0	-300	0.00	0.00	0	0	0
0014	3T	02_3	213	7	0	700	0	-700	0.00	0.00	1	0	-1
0014	3T	02_3	214	12	0	1200	0	-1200	0.00	0.00	2	0	-2
0014	3T	02_3	216	2	0	200	0	-200	0.00	0.00	0	0	0
0014	3T	02_3	231	4	0	400	0	-400	0.00	0.00	0	0	0
0014	3T	02_3	234	4	0	400	0	-400	0.00	0.00	0	0	0
0014	3T	02_3	235	1	0	100	0	-100	0.00	0.00	0	0	0
0014	3T	02_3	236	4	0	400	0	-400	0.00	0.00	0	0	0
0014	3T	02_3	241	4	0	400	0	-400	0.00	0.00	0	0	0
0014	3T	02_3	243	6	0	600	0	-600	0.00	0.00	1	0	-1
0014	3T	02_3	245	4	0	400	0	-400	0.00	0.00	0	0	0
0014	3T	02_3	246	3	0	300	0	-300	0.00	0.00	0	0	0
0014	3T	02_3	253	1	0	100	0	-100	0.00	0.00	0	0	0
0014	3T	02_3	256	1	0	100	0	-100	0.00	0.00	0	0	0
0014	3T	02_3	261	1	0	100	0	-100	0.00	0.00	0	0	0
0014	3T	02_3	265	2	0	200	0	-200	0.00	0.00	0	0	0
0014	3T	02_4	123	32	1	3200	980	-2220	0.03	0.31	5	1	-4
0014	3T	02_4	124	35	1	3500	1300	-2200	0.03	0.37	6	2	-4
0014	3T	02_4	125	22	1	2200	910	-1290	0.05	0.41	3	1	-2
0014	3T	02_4	126	9	0	900	0	-900	0.00	0.00	1	0	-1
0014	3T	02_4	132	19	2	1900	4950	3050	0.11	2.61	3	8	5
0014	3T	02_4	134	22	1	2200	1190	-1010	0.05	0.54	3	2	-1
0014	3T	02_4	135	18	2	1800	10610	8810	0.11	5.89	3	18	15
0014	3T	02_4	136	7	0	700	0	-700	0.00	0.00	1	0	-1
0014	3T	02_4	142	9	0	900	0	-900	0.00	0.00	1	0	-1
0014	3T	02_4	143	17	0	1700	0	-1700	0.00	0.00	3	0	-3
0014	3T	02_4	145	7	0	700	0	-700	0.00	0.00	1	0	-1
0014	3T	02_4	146	5	1	500	3870	3370	0.20	7.74	0	6	6
0014	3T	02_4	152	4	0	400	0	-400	0.00	0.00	0	0	0
0014	3T	02_4	153	5	0	500	0	-500	0.00	0.00	0	0	0
0014	3T	02_4	154	2	0	200	0	-200	0.00	0.00	0	0	0
0014	3T	02_4	156	2	0	200	0	-200	0.00	0.00	0	0	0
0014	3T	02_4	162	2	0	200	0	-200	0.00	0.00	0	0	0
0014	3T	02_4	163	3	0	300	0	-300	0.00	0.00	0	0	0
0014	3T	02_4	164	1	0	100	0	-100	0.00	0.00	0	0	0
0014	3T	02_4	165	1	0	100	0	-100	0.00	0.00	0	0	0
0014	3T	02_4	213	3	1	300	780	480	0.33	2.60	0	1	1
0014	3T	02_4	214	4	2	400	4030	3630	0.50	10.08	0	7	7
0014	3T	02_4	215	4	0	400	0	-400	0.00	0.00	0	0	0
0014	3T	02_4	216	1	0	100	0	-100	0.00	0.00	0	0	0
0014	3T	02_4	231	1	0	100	0	-100	0.00	0.00	0	0	0
0014	3T	02_4	234	5	0	500	0	-500	0.00	0.00	0	0	0
0014	3T	02_4	235	2	0	200	0	-200	0.00	0.00	0	0	0
0014	3T	02_4	236	2	0	200	0	-200	0.00	0.00	0	0	0
0014	3T	02_4	241	1	0	100	0	-100	0.00	0.00	0	0	0
0014	3T	02_4	243	3	0	300	0	-300	0.00	0.00	0	0	0
0014	3T	02_4	253	2	0	200	0	-200	0.00	0.00	0	0	0
0014	3T	02_4	254	4	0	400	0	-400	0.00	0.00	0	0	0
0014	3T	02_4	261	1	0	100	0	-100	0.00	0.00	0	0	0
0014	3T	02_4	264	1	0	100	0	-100	0.00	0.00	0	0	0
0014	3T	02_5	123	22	4	2200	5240	3040	0.18	2.38	3	9	6
0014	3T	02_5	124	15	1	1500	780	-720	0.07	0.52	2	1	-1
0014	3T	02_5	125	9	3	900	3950	3050	0.33	4.39	1	6	5
0014	3T	02_5	126	7	0	700	0	-700	0.00	0.00	1	0	-1
0014	3T	02_5	132	12	0	1200	0	-1200	0.00	0.00	2	0	-2
0014	3T	02_5	134	5	1	500	380	-120	0.20	0.76	0	0	0
0014	3T	02_5	135	8	0	800	0	-800	0.00	0.00	1	0	-1
0014	3T	02_5	136	4	0	400	0	-400	0.00	0.00	0	0	0
0014	3T	02_5	142	6	0	600	0	-600	0.00	0.00	1	0	-1
0014	3T	02_5	143	6	2	600	2000	1400	0.33	3.33	1	3	2
0014	3T	02_5	145	6	0	600	0	-600	0.00	0.00	1	0	-1
0014	3T	02_5	146	3	0	300	0	-300	0.00	0.00	0	0	0
0014	3T	02_5	152	2	0	200	0	-200	0.00	0.00	0	0	0
0014	3T	02_5	153	2	1	200	2700	2500	0.50	13.50	0	4	4
0014	3T	02_5	154	2	0	200	0	-200	0.00	0.00	0	0	0
0014	3T	02_5	156	1	0	100	0	-100	0.00	0.00	0	0	0
0014	3T	02_5	162	1	0	100	0	-100	0.00	0.00	0	0	0
0014	3T	02_5	163	3	0	300	0	-300	0.00	0.00	0	0	0
0014	3T	02_5	164	1	0	100	0	-100	0.00	0.00	0	0	0
0014	3T	02_5	165	1	0	100	0	-100	0.00	0.00	0	0	0
0014	3T	02_5	213	2	0	200	0	-200	0.00	0.00	0	0	0
0014	3T	02_5	215	3	0	300	0	-300	0.00	0.00	0	0	0
0014	3T	02_5	216	1	0	100	0	-100	0.00	0.00	0	0	0
0014	3T	02_5	234	2	0	200	0	-200	0.00	0.00	0	0	0
0014	3T	02_5	235	1	0	100	0	-100	0.00	0.00	0	0	0
0014	3T	02_5	236	1	0	100	0	-100	0.00	0.00	0	0	0
0014	3T	02_6	123	2	0	200	0	-200	0.00	0.00	0	0	0
0014	3T	02_6	124	1	0	100	0	-100	0.00	0.00	0	0	0
0014	3T	02_6	125	1	0	100	0	-100	0.00	0.00	0	0	0
0014	3T	02_6	126	1	0	100	0	-100	0.00	0.00	0	0	0
0014	3T	02_6	134	1	0	100	0	-100	0.00	0.00	0	0	0
0014	3T	02_6	152	1	0	100	0	-100	0.00	0.00	0	0	0
0014	3T	02_7	123	53	2	5300	2180	-3120	0.04	0.41	9	3	-6
0014	3T	02_7	124	44	3	4400	4310	-90	0.07	0.98	7	7	0
0014	3T	02_7	125	35	4	3500	7310	3810	0.11	2.09	6	12	6
0014	3T	02_7	126	22	1	2200	2350	150	0.05	1.07	3	4	1
0014	3T	02_7	132	21	0	2100	0	-2100	0.00	0.00	3	0	-3
0014	3T	02_7	134	25	1	2500	1140	-1360	0.04	0.46	4	2	-2
0014	3T	02_7	135	18	1	1800	5810	4010	0.06	3.23	3	10	7
0014	3T	02_7	136	17	0	1700	0	-1700	0.00	0.00	3	0	-3
0014	3T	02_7	142	27	1	2700	2270	-430	0.04	0.84	4	4	0
0014	3T	02_7	143	20	1	2000	2550	550	0.05	1.28	3	4	1
0014	3T	02_7	145	15	1	1500	1890	390	0.07	1.26	2	3	1
0014	3T	02_7	146	2	0	200	0	-200	0.00	0.00	0	0	0
0014	3T	02_7	152	6	0	600	0	-600	0.00	0.00	1	0	-1
0014	3T	02_7	153	8	0	800	0	-800	0.00	0.00	1	0	-1
0014	3T	02_7	154	6	0	600	0	-600	0.00	0.00	1	0	-1
0014	3T	02_7	156	3	0	300	0	-300	0.00	0.00	0	0	0
0014	3T	02_7	162	5	0	500	0	-500	0.00	0.00	0	0	0
0014	3T	02_7	163	6	0	600	0	-600	0.00	0.00	1	0	-1
0014	3T	02_7	164	4	0	400	0	-400	0.00	0.00	0	0	0
0014	3T	02_7	165	4	0	400	0	-400	0.00	0.00	0	0	0
0014	3T	02_7	213	3	0	300	0	-300	0.00	0.00	0	0	0
0014	3T	02_7	214	7	1	700	810	110	0.14	1.16	1	1	0
0014	3T	02_7	215	4	0	400	0	-400	0.00	0.00	0	0	0
0014	3T	02_7	216	2	0	200	0	-200	0.00	0.00	0	0	0
0014	3T	02_7	231	3	0	300	0	-300	0.00	0.00	0	0	0
0014	3T	02_7	234	6	0	600	0	-600	0.00	0.00	1	0	-1
0014	3T	02_7	235	2	0	200	0	-200	0.00	0.00	0	0	0
0014	3T	02_7	236	7	0	700	0	-700	0.00	0.00	1	0	-1
0014	3T	02_7	243	3	0	300	0	-300	0.00	0.00	0	0	0
0014	3T	02_7	246	2	0	200	0	-200	0.00	0.00	0	0	0
0014	3T	02_7	251	1	0	100	0	-100	0.00	0.00	0	0	0
0014	3T	02_7	253	2	0	200	0	-200	0.00	0.00	0	0	0
0014	3T	02_7	254	1	0	100	0	-100	0.00	0.00	0	0	0
0014	3T	02_7	256	1	0	100	0	-100	0.00	0.00	0	0	0
0014	3T	02_7	261	3	0	300	0	-300	0.00	0.00	0	0	0
0014	3T	02_7	263	2	0	200	0	-200	0.00	0.00	0	0	0
0014	3T	03_1	123	29	2	2900	1980	-920	0.07	0.68	5	3	-2
0014	3T	03_1	124	23	3	2300	3390	1090	0.13	1.47	4	6	2
0014	3T	03_1	125	19	1	1900	2060	160	0.05	1.08	3	3	0
0014	3T	03_1	126	10	0	1000	0	-1000	0.00	0.00	1	0	-1
0014	3T	03_1	132	12	3	1200	3820	2620	0.25	3.18	2	6	4
0014	3T	03_1	134	25	1	2500	1440	-1060	0.04	0.58	4	2	-2
0014	3T	03_1	135	14	2	1400	1890	490	0.14	1.35	2	3	1
0014	3T	03_1	136	9	1	900	2240	1340	0.11	2.49	1	3	2
0014	3T	03_1	142	12	0	1200	0	-1200	0.00	0.00	2	0	-2
0014	3T	03_1	143	18	2	1800	4380	2580	0.11	2.43	3	7	4
0014	3T	03_1	145	9	0	900	0	-900	0.00	0.00	1	0	-1
0014	3T	03_1	146	10	1	1000	1820	820	0.10	1.82	1	3	2
0014	3T	03_1	152	6	0	600	0	-600	0.00	0.00	1	0	-1
0014	3T	03_1	153	6	0	600	0	-600	0.00	0.00	1	0	-1
0014	3T	03_1	154	6	0	600	0	-600	0.00	0.00	1	0	-1
0014	3T	03_1	156	1	0	100	0	-100	0.00	0.00	0	0	0
0014	3T	03_1	162	1	0	100	0	-100	0.00	0.00	0	0	0
0014	3T	03_1	163	3	0	300	0	-300	0.00	0.00	0	0	0
0014	3T	03_1	164	1	0	100	0	-100	0.00	0.00	0	0	0
0014	3T	03_1	165	2	0	200	0	-200	0.00	0.00	0	0	0
0014	3T	03_1	213	4	0	400	0	-400	0.00	0.00	0	0	0
0014	3T	03_1	214	3	0	300	0	-300	0.00	0.00	0	0	0
0014	3T	03_1	215	4	0	400	0	-400	0.00	0.00	0	0	0
0014	3T	03_1	216	4	0	400	0	-400	0.00	0.00	0	0	0
0014	3T	03_1	234	1	0	100	0	-100	0.00	0.00	0	0	0
0014	3T	03_1	243	1	0	100	0	-100	0.00	0.00	0	0	0
0014	3T	03_1	246	3	0	300	0	-300	0.00	0.00	0	0	0
0014	3T	03_1	253	3	0	300	0	-300	0.00	0.00	0	0	0
0014	3T	03_1	254	3	0	300	0	-300	0.00	0.00	0	0	0
0014	3T	03_1	256	1	0	100	0	-100	0.00	0.00	0	0	0
0014	3T	03_1	263	1	0	100	0	-100	0.00	0.00	0	0	0
0014	3T	03_1	264	1	0	100	0	-100	0.00	0.00	0	0	0
0014	3T	03_2	123	25	4	2500	4160	1660	0.16	1.66	4	7	3
0014	3T	03_2	124	27	0	2700	0	-2700	0.00	0.00	4	0	-4
0014	3T	03_2	125	19	1	1900	810	-1090	0.05	0.43	3	1	-2
0014	3T	03_2	126	19	0	1900	0	-1900	0.00	0.00	3	0	-3
0014	3T	03_2	132	19	4	1900	4940	3040	0.21	2.60	3	8	5
0014	3T	03_2	134	11	0	1100	0	-1100	0.00	0.00	1	0	-1
0014	3T	03_2	135	8	0	800	0	-800	0.00	0.00	1	0	-1
0014	3T	03_2	136	6	0	600	0	-600	0.00	0.00	1	0	-1
0014	3T	03_2	142	4	0	400	0	-400	0.00	0.00	0	0	0
0014	3T	03_2	143	9	2	900	19330	18430	0.22	21.48	1	34	33
0014	3T	03_2	145	7	0	700	0	-700	0.00	0.00	1	0	-1
0014	3T	03_2	146	8	0	800	0	-800	0.00	0.00	1	0	-1
0014	3T	03_2	152	8	1	800	1550	750	0.13	1.94	1	2	1
0014	3T	03_2	153	5	0	500	0	-500	0.00	0.00	0	0	0
0014	3T	03_2	154	5	0	500	0	-500	0.00	0.00	0	0	0
0014	3T	03_2	156	2	0	200	0	-200	0.00	0.00	0	0	0
0014	3T	03_2	162	1	0	100	0	-100	0.00	0.00	0	0	0
0014	3T	03_2	163	3	0	300	0	-300	0.00	0.00	0	0	0
0014	3T	03_2	164	4	0	400	0	-400	0.00	0.00	0	0	0
0014	3T	03_2	165	2	0	200	0	-200	0.00	0.00	0	0	0
0014	3T	03_2	213	6	0	600	0	-600	0.00	0.00	1	0	-1
0014	3T	03_2	214	3	0	300	0	-300	0.00	0.00	0	0	0
0014	3T	03_2	215	1	0	100	0	-100	0.00	0.00	0	0	0
0014	3T	03_2	216	5	0	500	0	-500	0.00	0.00	0	0	0
0014	3T	03_2	231	3	0	300	0	-300	0.00	0.00	0	0	0
0014	3T	03_2	234	1	0	100	0	-100	0.00	0.00	0	0	0
0014	3T	03_2	235	2	0	200	0	-200	0.00	0.00	0	0	0
0014	3T	03_2	236	5	0	500	0	-500	0.00	0.00	0	0	0
0014	3T	03_2	241	1	0	100	0	-100	0.00	0.00	0	0	0
0014	3T	03_2	243	1	0	100	0	-100	0.00	0.00	0	0	0
0014	3T	03_2	245	1	0	100	0	-100	0.00	0.00	0	0	0
0014	3T	03_2	246	3	0	300	0	-300	0.00	0.00	0	0	0
0014	3T	03_2	254	1	0	100	0	-100	0.00	0.00	0	0	0
0014	3T	03_2	256	1	0	100	0	-100	0.00	0.00	0	0	0
0014	3T	03_2	263	3	0	300	0	-300	0.00	0.00	0	0	0
0014	3T	03_2	264	1	0	100	0	-100	0.00	0.00	0	0	0
0014	3T	03_3	123	50	7	5000	6750	1750	0.14	1.35	8	11	3
0014	3T	03_3	124	30	3	3000	4050	1050	0.10	1.35	5	7	2
0014	3T	03_3	125	25	3	2500	1700	-800	0.12	0.68	4	3	-1
0014	3T	03_3	126	20	0	2000	0	-2000	0.00	0.00	3	0	-3
0014	3T	03_3	132	10	2	1000	2020	1020	0.20	2.02	1	3	2
0014	3T	03_3	134	17	1	1700	1420	-280	0.06	0.84	3	2	-1
0014	3T	03_3	135	21	0	2100	0	-2100	0.00	0.00	3	0	-3
0014	3T	03_3	136	11	1	1100	1480	380	0.09	1.35	1	2	1
0014	3T	03_3	142	13	0	1300	0	-1300	0.00	0.00	2	0	-2
0014	3T	03_3	143	6	0	600	0	-600	0.00	0.00	1	0	-1
0014	3T	03_3	145	8	0	800	0	-800	0.00	0.00	1	0	-1
0014	3T	03_3	146	8	0	800	0	-800	0.00	0.00	1	0	-1
0014	3T	03_3	152	10	0	1000	0	-1000	0.00	0.00	1	0	-1
0014	3T	03_3	153	5	0	500	0	-500	0.00	0.00	0	0	0
0014	3T	03_3	154	10	0	1000	0	-1000	0.00	0.00	1	0	-1
0014	3T	03_3	156	5	0	500	0	-500	0.00	0.00	0	0	0
0014	3T	03_3	162	4	0	400	0	-400	0.00	0.00	0	0	0
0014	3T	03_3	163	5	1	500	2280	1780	0.20	4.56	0	4	4
0014	3T	03_3	164	3	0	300	0	-300	0.00	0.00	0	0	0
0014	3T	03_3	213	6	0	600	0	-600	0.00	0.00	1	0	-1
0014	3T	03_3	214	2	0	200	0	-200	0.00	0.00	0	0	0
0014	3T	03_3	215	2	0	200	0	-200	0.00	0.00	0	0	0
0014	3T	03_3	216	1	0	100	0	-100	0.00	0.00	0	0	0
0014	3T	03_3	231	2	0	200	0	-200	0.00	0.00	0	0	0
0014	3T	03_3	234	2	0	200	0	-200	0.00	0.00	0	0	0
0014	3T	03_3	235	2	0	200	0	-200	0.00	0.00	0	0	0
0014	3T	03_3	236	1	0	100	0	-100	0.00	0.00	0	0	0
0014	3T	03_3	243	1	0	100	0	-100	0.00	0.00	0	0	0
0014	3T	03_3	246	1	0	100	0	-100	0.00	0.00	0	0	0
0014	3T	03_3	253	2	0	200	0	-200	0.00	0.00	0	0	0
0014	3T	03_3	261	1	0	100	0	-100	0.00	0.00	0	0	0
0014	3T	03_3	263	1	0	100	0	-100	0.00	0.00	0	0	0
0014	3T	03_3	264	1	0	100	0	-100	0.00	0.00	0	0	0
0014	3T	03_4	123	22	1	2200	550	-1650	0.05	0.25	3	0	-3
0014	3T	03_4	124	18	1	1800	3370	1570	0.06	1.87	3	5	2
0014	3T	03_4	125	17	0	1700	0	-1700	0.00	0.00	3	0	-3
0014	3T	03_4	126	9	0	900	0	-900	0.00	0.00	1	0	-1
0014	3T	03_4	132	15	1	1500	13860	12360	0.07	9.24	2	24	22
0014	3T	03_4	134	11	0	1100	0	-1100	0.00	0.00	1	0	-1
0014	3T	03_4	135	14	1	1400	1390	-10	0.07	0.99	2	2	0
0014	3T	03_4	136	12	0	1200	0	-1200	0.00	0.00	2	0	-2
0014	3T	03_4	142	4	1	400	2130	1730	0.25	5.33	0	3	3
0014	3T	03_4	143	8	0	800	0	-800	0.00	0.00	1	0	-1
0014	3T	03_4	145	6	0	600	0	-600	0.00	0.00	1	0	-1
0014	3T	03_4	146	2	0	200	0	-200	0.00	0.00	0	0	0
0014	3T	03_4	152	4	0	400	0	-400	0.00	0.00	0	0	0
0014	3T	03_4	153	2	0	200	0	-200	0.00	0.00	0	0	0
0014	3T	03_4	154	3	0	300	0	-300	0.00	0.00	0	0	0
0014	3T	03_4	156	3	0	300	0	-300	0.00	0.00	0	0	0
0014	3T	03_4	162	3	1	300	4720	4420	0.33	15.73	0	8	8
0014	3T	03_4	163	1	0	100	0	-100	0.00	0.00	0	0	0
0014	3T	03_4	164	1	0	100	0	-100	0.00	0.00	0	0	0
0014	3T	03_4	213	1	0	100	0	-100	0.00	0.00	0	0	0
0014	3T	03_4	214	1	0	100	0	-100	0.00	0.00	0	0	0
0014	3T	03_4	215	4	0	400	0	-400	0.00	0.00	0	0	0
0014	3T	03_4	216	1	0	100	0	-100	0.00	0.00	0	0	0
0014	3T	03_4	231	2	0	200	0	-200	0.00	0.00	0	0	0
0014	3T	03_4	234	1	0	100	0	-100	0.00	0.00	0	0	0
0014	3T	03_4	235	1	0	100	0	-100	0.00	0.00	0	0	0
0014	3T	03_4	245	1	0	100	0	-100	0.00	0.00	0	0	0
0014	3T	03_4	253	1	0	100	0	-100	0.00	0.00	0	0	0
0014	3T	03_4	254	1	1	100	2690	2590	1.00	26.90	0	4	4
0014	3T	03_4	263	1	0	100	0	-100	0.00	0.00	0	0	0
0014	3T	03_5	123	17	4	1700	3180	1480	0.24	1.87	3	5	2
0014	3T	03_5	124	13	0	1300	0	-1300	0.00	0.00	2	0	-2
0014	3T	03_5	125	6	0	600	0	-600	0.00	0.00	1	0	-1
0014	3T	03_5	126	5	2	500	4520	4020	0.40	9.04	0	8	8
0014	3T	03_5	132	7	0	700	0	-700	0.00	0.00	1	0	-1
0014	3T	03_5	134	5	0	500	0	-500	0.00	0.00	0	0	0
0014	3T	03_5	135	11	0	1100	0	-1100	0.00	0.00	1	0	-1
0014	3T	03_5	136	10	0	1000	0	-1000	0.00	0.00	1	0	-1
0014	3T	03_5	142	4	0	400	0	-400	0.00	0.00	0	0	0
0014	3T	03_5	143	1	0	100	0	-100	0.00	0.00	0	0	0
0014	3T	03_5	145	1	0	100	0	-100	0.00	0.00	0	0	0
0014	3T	03_5	152	2	0	200	0	-200	0.00	0.00	0	0	0
0014	3T	03_5	153	1	0	100	0	-100	0.00	0.00	0	0	0
0014	3T	03_5	154	2	0	200	0	-200	0.00	0.00	0	0	0
0014	3T	03_5	156	2	1	200	1500	1300	0.50	7.50	0	2	2
0014	3T	03_5	162	2	1	200	1470	1270	0.50	7.35	0	2	2
0014	3T	03_5	163	2	0	200	0	-200	0.00	0.00	0	0	0
0014	3T	03_5	164	1	0	100	0	-100	0.00	0.00	0	0	0
0014	3T	03_5	165	1	0	100	0	-100	0.00	0.00	0	0	0
0014	3T	03_5	214	1	0	100	0	-100	0.00	0.00	0	0	0
0014	3T	03_5	215	3	0	300	0	-300	0.00	0.00	0	0	0
0014	3T	03_5	216	2	0	200	0	-200	0.00	0.00	0	0	0
0014	3T	03_5	234	1	0	100	0	-100	0.00	0.00	0	0	0
0014	3T	03_5	241	1	0	100	0	-100	0.00	0.00	0	0	0
0014	3T	03_5	243	1	0	100	0	-100	0.00	0.00	0	0	0
0014	3T	03_7	123	38	1	3800	1140	-2660	0.03	0.30	6	2	-4
0014	3T	03_7	124	33	4	3300	3730	430	0.12	1.13	5	6	1
0014	3T	03_7	125	21	3	2100	6090	3990	0.14	2.90	3	10	7
0014	3T	03_7	126	13	1	1300	1980	680	0.08	1.52	2	3	1
0014	3T	03_7	132	20	1	2000	1110	-890	0.05	0.56	3	1	-2
0014	3T	03_7	134	14	2	1400	2630	1230	0.14	1.88	2	4	2
0014	3T	03_7	135	19	1	1900	1490	-410	0.05	0.78	3	2	-1
0014	3T	03_7	136	15	1	1500	1270	-230	0.07	0.85	2	2	0
0014	3T	03_7	142	15	3	1500	9900	8400	0.20	6.60	2	17	15
0014	3T	03_7	143	7	0	700	0	-700	0.00	0.00	1	0	-1
0014	3T	03_7	145	6	0	600	0	-600	0.00	0.00	1	0	-1
0014	3T	03_7	146	9	0	900	0	-900	0.00	0.00	1	0	-1
0014	3T	03_7	152	5	0	500	0	-500	0.00	0.00	0	0	0
0014	3T	03_7	153	8	1	800	1440	640	0.13	1.80	1	2	1
0014	3T	03_7	154	3	0	300	0	-300	0.00	0.00	0	0	0
0014	3T	03_7	156	2	0	200	0	-200	0.00	0.00	0	0	0
0014	3T	03_7	162	7	0	700	0	-700	0.00	0.00	1	0	-1
0014	3T	03_7	163	2	0	200	0	-200	0.00	0.00	0	0	0
0014	3T	03_7	164	2	0	200	0	-200	0.00	0.00	0	0	0
0014	3T	03_7	165	1	0	100	0	-100	0.00	0.00	0	0	0
0014	3T	03_7	213	7	0	700	0	-700	0.00	0.00	1	0	-1
0014	3T	03_7	214	2	0	200	0	-200	0.00	0.00	0	0	0
0014	3T	03_7	215	4	1	400	1140	740	0.25	2.85	0	2	2
0014	3T	03_7	234	6	0	600	0	-600	0.00	0.00	1	0	-1
0014	3T	03_7	235	3	0	300	0	-300	0.00	0.00	0	0	0
0014	3T	03_7	236	2	0	200	0	-200	0.00	0.00	0	0	0
0014	3T	03_7	241	1	0	100	0	-100	0.00	0.00	0	0	0
0014	3T	03_7	243	1	0	100	0	-100	0.00	0.00	0	0	0
0014	3T	03_7	245	2	0	200	0	-200	0.00	0.00	0	0	0
0014	3T	03_7	246	2	0	200	0	-200	0.00	0.00	0	0	0
0014	3T	03_7	253	4	0	400	0	-400	0.00	0.00	0	0	0
0014	3T	03_7	254	1	0	100	0	-100	0.00	0.00	0	0	0
0014	3T	03_7	256	3	0	300	0	-300	0.00	0.00	0	0	0
0014	3T	03_7	263	1	0	100	0	-100	0.00	0.00	0	0	0
0014	3T	03_7	265	1	0	100	0	-100	0.00	0.00	0	0	0
0014	3T	04_1	123	34	2	3400	1240	-2160	0.06	0.36	6	2	-4
0014	3T	04_1	124	34	3	3400	3090	-310	0.09	0.91	6	5	-1
0014	3T	04_1	125	27	3	2700	6420	3720	0.11	2.38	4	11	7
0014	3T	04_1	126	24	2	2400	3390	990	0.08	1.41	4	6	2
0014	3T	04_1	132	20	1	2000	1650	-350	0.05	0.83	3	2	-1
0014	3T	04_1	134	23	1	2300	1220	-1080	0.04	0.53	4	2	-2
0014	3T	04_1	135	9	0	900	0	-900	0.00	0.00	1	0	-1
0014	3T	04_1	136	18	0	1800	0	-1800	0.00	0.00	3	0	-3
0014	3T	04_1	142	12	0	1200	0	-1200	0.00	0.00	2	0	-2
0014	3T	04_1	143	10	0	1000	0	-1000	0.00	0.00	1	0	-1
0014	3T	04_1	145	12	0	1200	0	-1200	0.00	0.00	2	0	-2
0014	3T	04_1	146	15	0	1500	0	-1500	0.00	0.00	2	0	-2
0014	3T	04_1	152	3	0	300	0	-300	0.00	0.00	0	0	0
0014	3T	04_1	153	6	0	600	0	-600	0.00	0.00	1	0	-1
0014	3T	04_1	154	8	1	800	3000	2200	0.13	3.75	1	5	4
0014	3T	04_1	156	6	0	600	0	-600	0.00	0.00	1	0	-1
0014	3T	04_1	162	7	1	700	3000	2300	0.14	4.29	1	5	4
0014	3T	04_1	163	2	0	200	0	-200	0.00	0.00	0	0	0
0014	3T	04_1	164	2	0	200	0	-200	0.00	0.00	0	0	0
0014	3T	04_1	165	5	0	500	0	-500	0.00	0.00	0	0	0
0014	3T	04_1	213	3	1	300	3900	3600	0.33	13.00	0	6	6
0014	3T	04_1	214	2	0	200	0	-200	0.00	0.00	0	0	0
0014	3T	04_1	215	1	0	100	0	-100	0.00	0.00	0	0	0
0014	3T	04_1	216	3	0	300	0	-300	0.00	0.00	0	0	0
0014	3T	04_1	231	3	0	300	0	-300	0.00	0.00	0	0	0
0014	3T	04_1	234	2	0	200	0	-200	0.00	0.00	0	0	0
0014	3T	04_1	235	2	0	200	0	-200	0.00	0.00	0	0	0
0014	3T	04_1	236	3	0	300	0	-300	0.00	0.00	0	0	0
0014	3T	04_1	241	2	0	200	0	-200	0.00	0.00	0	0	0
0014	3T	04_1	245	1	0	100	0	-100	0.00	0.00	0	0	0
0014	3T	04_1	246	1	0	100	0	-100	0.00	0.00	0	0	0
0014	3T	04_1	251	1	0	100	0	-100	0.00	0.00	0	0	0
0014	3T	04_1	253	1	0	100	0	-100	0.00	0.00	0	0	0
0014	3T	04_1	261	2	0	200	0	-200	0.00	0.00	0	0	0
0014	3T	04_2	123	37	3	3700	3120	-580	0.08	0.84	6	5	-1
0014	3T	04_2	124	29	1	2900	1000	-1900	0.03	0.34	5	1	-4
0014	3T	04_2	125	24	3	2400	5110	2710	0.13	2.13	4	9	5
0014	3T	04_2	126	21	1	2100	1300	-800	0.05	0.62	3	2	-1
0014	3T	04_2	132	28	3	2800	4170	1370	0.11	1.49	4	7	3
0014	3T	04_2	134	16	1	1600	1130	-470	0.06	0.71	2	2	0
0014	3T	04_2	135	13	0	1300	0	-1300	0.00	0.00	2	0	-2
0014	3T	04_2	136	11	1	1100	1670	570	0.09	1.52	1	2	1
0014	3T	04_2	142	8	0	800	0	-800	0.00	0.00	1	0	-1
0014	3T	04_2	143	9	0	900	0	-900	0.00	0.00	1	0	-1
0014	3T	04_2	145	14	0	1400	0	-1400	0.00	0.00	2	0	-2
0014	3T	04_2	146	8	1	800	840	40	0.13	1.05	1	1	0
0014	3T	04_2	152	8	0	800	0	-800	0.00	0.00	1	0	-1
0014	3T	04_2	153	11	0	1100	0	-1100	0.00	0.00	1	0	-1
0014	3T	04_2	154	5	0	500	0	-500	0.00	0.00	0	0	0
0014	3T	04_2	156	10	1	1000	1500	500	0.10	1.50	1	2	1
0014	3T	04_2	162	2	0	200	0	-200	0.00	0.00	0	0	0
0014	3T	04_2	163	4	0	400	0	-400	0.00	0.00	0	0	0
0014	3T	04_2	164	4	0	400	0	-400	0.00	0.00	0	0	0
0014	3T	04_2	165	3	0	300	0	-300	0.00	0.00	0	0	0
0014	3T	04_2	213	3	0	300	0	-300	0.00	0.00	0	0	0
0014	3T	04_2	214	2	1	200	1150	950	0.50	5.75	0	2	2
0014	3T	04_2	215	3	0	300	0	-300	0.00	0.00	0	0	0
0014	3T	04_2	216	5	0	500	0	-500	0.00	0.00	0	0	0
0014	3T	04_2	231	1	0	100	0	-100	0.00	0.00	0	0	0
0014	3T	04_2	235	4	1	400	2480	2080	0.25	6.20	0	4	4
0014	3T	04_2	241	3	0	300	0	-300	0.00	0.00	0	0	0
0014	3T	04_2	256	1	0	100	0	-100	0.00	0.00	0	0	0
0014	3T	04_2	261	1	0	100	0	-100	0.00	0.00	0	0	0
0014	3T	04_3	123	28	2	2800	2330	-470	0.07	0.83	4	4	0
0014	3T	04_3	124	34	2	3400	4700	1300	0.06	1.38	6	8	2
0014	3T	04_3	125	27	3	2700	3080	380	0.11	1.14	4	5	1
0014	3T	04_3	126	23	1	2300	2150	-150	0.04	0.93	4	3	-1
0014	3T	04_3	132	24	1	2400	1520	-880	0.04	0.63	4	2	-2
0014	3T	04_3	134	19	1	1900	910	-990	0.05	0.48	3	1	-2
0014	3T	04_3	135	14	0	1400	0	-1400	0.00	0.00	2	0	-2
0014	3T	04_3	136	17	1	1700	2430	730	0.06	1.43	3	4	1
0014	3T	04_3	142	12	0	1200	0	-1200	0.00	0.00	2	0	-2
0014	3T	04_3	143	11	2	1100	4440	3340	0.18	4.04	1	7	6
0014	3T	04_3	145	11	0	1100	0	-1100	0.00	0.00	1	0	-1
0014	3T	04_3	146	10	0	1000	0	-1000	0.00	0.00	1	0	-1
0014	3T	04_3	152	14	1	1400	1500	100	0.07	1.07	2	2	0
0014	3T	04_3	153	6	0	600	0	-600	0.00	0.00	1	0	-1
0014	3T	04_3	154	6	0	600	0	-600	0.00	0.00	1	0	-1
0014	3T	04_3	156	6	0	600	0	-600	0.00	0.00	1	0	-1
0014	3T	04_3	162	1	0	100	0	-100	0.00	0.00	0	0	0
0014	3T	04_3	163	3	0	300	0	-300	0.00	0.00	0	0	0
0014	3T	04_3	164	4	0	400	0	-400	0.00	0.00	0	0	0
0014	3T	04_3	165	5	0	500	0	-500	0.00	0.00	0	0	0
0014	3T	04_3	213	5	3	500	4160	3660	0.60	8.32	0	7	7
0014	3T	04_3	216	2	0	200	0	-200	0.00	0.00	0	0	0
0014	3T	04_3	231	2	0	200	0	-200	0.00	0.00	0	0	0
0014	3T	04_3	234	4	0	400	0	-400	0.00	0.00	0	0	0
0014	3T	04_3	235	3	0	300	0	-300	0.00	0.00	0	0	0
0014	3T	04_3	236	5	0	500	0	-500	0.00	0.00	0	0	0
0014	3T	04_3	245	2	0	200	0	-200	0.00	0.00	0	0	0
0014	3T	04_3	246	1	0	100	0	-100	0.00	0.00	0	0	0
0014	3T	04_3	251	3	0	300	0	-300	0.00	0.00	0	0	0
0014	3T	04_3	261	1	0	100	0	-100	0.00	0.00	0	0	0
0014	3T	04_3	263	4	0	400	0	-400	0.00	0.00	0	0	0
0014	3T	04_3	264	1	0	100	0	-100	0.00	0.00	0	0	0
0014	3T	04_3	265	1	0	100	0	-100	0.00	0.00	0	0	0
0014	3T	04_4	123	27	2	2700	2440	-260	0.07	0.90	4	4	0
0014	3T	04_4	124	34	1	3400	1530	-1870	0.03	0.45	6	2	-4
0014	3T	04_4	125	21	0	2100	0	-2100	0.00	0.00	3	0	-3
0014	3T	04_4	126	15	0	1500	0	-1500	0.00	0.00	2	0	-2
0014	3T	04_4	132	25	1	2500	770	-1730	0.04	0.31	4	1	-3
0014	3T	04_4	134	21	1	2100	690	-1410	0.05	0.33	3	1	-2
0014	3T	04_4	135	12	3	1200	2730	1530	0.25	2.28	2	4	2
0014	3T	04_4	136	6	0	600	0	-600	0.00	0.00	1	0	-1
0014	3T	04_4	142	8	0	800	0	-800	0.00	0.00	1	0	-1
0014	3T	04_4	143	11	3	1100	4940	3840	0.27	4.49	1	8	7
0014	3T	04_4	145	8	1	800	1070	270	0.13	1.34	1	1	0
0014	3T	04_4	146	8	0	800	0	-800	0.00	0.00	1	0	-1
0014	3T	04_4	152	5	0	500	0	-500	0.00	0.00	0	0	0
0014	3T	04_4	153	2	0	200	0	-200	0.00	0.00	0	0	0
0014	3T	04_4	154	3	0	300	0	-300	0.00	0.00	0	0	0
0014	3T	04_4	156	2	0	200	0	-200	0.00	0.00	0	0	0
0014	3T	04_4	162	3	0	300	0	-300	0.00	0.00	0	0	0
0014	3T	04_4	163	5	1	500	11580	11080	0.20	23.16	0	20	20
0014	3T	04_4	164	1	1	100	760	660	1.00	7.60	0	1	1
0014	3T	04_4	213	6	0	600	0	-600	0.00	0.00	1	0	-1
0014	3T	04_4	214	5	0	500	0	-500	0.00	0.00	0	0	0
0014	3T	04_4	215	2	0	200	0	-200	0.00	0.00	0	0	0
0014	3T	04_4	216	1	0	100	0	-100	0.00	0.00	0	0	0
0014	3T	04_4	231	1	0	100	0	-100	0.00	0.00	0	0	0
0014	3T	04_4	234	2	0	200	0	-200	0.00	0.00	0	0	0
0014	3T	04_4	236	2	0	200	0	-200	0.00	0.00	0	0	0
0014	3T	04_4	243	2	0	200	0	-200	0.00	0.00	0	0	0
0014	3T	04_4	245	1	0	100	0	-100	0.00	0.00	0	0	0
0014	3T	04_4	251	2	0	200	0	-200	0.00	0.00	0	0	0
0014	3T	04_4	254	2	0	200	0	-200	0.00	0.00	0	0	0
0014	3T	04_4	261	1	0	100	0	-100	0.00	0.00	0	0	0
0014	3T	04_4	263	1	0	100	0	-100	0.00	0.00	0	0	0
0014	3T	04_4	264	1	0	100	0	-100	0.00	0.00	0	0	0
0014	3T	04_5	123	23	2	2300	1860	-440	0.09	0.81	4	3	-1
0014	3T	04_5	124	33	2	3300	1740	-1560	0.06	0.53	5	3	-2
0014	3T	04_5	125	18	1	1800	4760	2960	0.06	2.64	3	8	5
0014	3T	04_5	126	13	0	1300	0	-1300	0.00	0.00	2	0	-2
0014	3T	04_5	132	16	1	1600	1090	-510	0.06	0.68	2	1	-1
0014	3T	04_5	134	13	1	1300	2060	760	0.08	1.58	2	3	1
0014	3T	04_5	135	10	0	1000	0	-1000	0.00	0.00	1	0	-1
0014	3T	04_5	136	5	0	500	0	-500	0.00	0.00	0	0	0
0014	3T	04_5	142	6	0	600	0	-600	0.00	0.00	1	0	-1
0014	3T	04_5	143	10	1	1000	1410	410	0.10	1.41	1	2	1
0014	3T	04_5	145	6	2	600	3130	2530	0.33	5.22	1	5	4
0014	3T	04_5	146	7	0	700	0	-700	0.00	0.00	1	0	-1
0014	3T	04_5	152	6	0	600	0	-600	0.00	0.00	1	0	-1
0014	3T	04_5	153	6	0	600	0	-600	0.00	0.00	1	0	-1
0014	3T	04_5	154	4	0	400	0	-400	0.00	0.00	0	0	0
0014	3T	04_5	156	3	0	300	0	-300	0.00	0.00	0	0	0
0014	3T	04_5	162	4	0	400	0	-400	0.00	0.00	0	0	0
0014	3T	04_5	163	2	0	200	0	-200	0.00	0.00	0	0	0
0014	3T	04_5	164	2	0	200	0	-200	0.00	0.00	0	0	0
0014	3T	04_5	165	4	1	400	2340	1940	0.25	5.85	0	4	4
0014	3T	04_5	214	1	0	100	0	-100	0.00	0.00	0	0	0
0014	3T	04_5	215	3	0	300	0	-300	0.00	0.00	0	0	0
0014	3T	04_5	231	2	0	200	0	-200	0.00	0.00	0	0	0
0014	3T	04_5	235	1	0	100	0	-100	0.00	0.00	0	0	0
0014	3T	04_5	236	2	0	200	0	-200	0.00	0.00	0	0	0
0014	3T	04_5	245	1	0	100	0	-100	0.00	0.00	0	0	0
0014	3T	04_5	251	1	0	100	0	-100	0.00	0.00	0	0	0
0014	3T	04_5	253	1	0	100	0	-100	0.00	0.00	0	0	0
0014	3T	04_5	254	1	0	100	0	-100	0.00	0.00	0	0	0
0014	3T	04_5	256	1	0	100	0	-100	0.00	0.00	0	0	0
0014	3T	04_5	265	1	0	100	0	-100	0.00	0.00	0	0	0
0014	3T	04_7	123	30	1	3000	840	-2160	0.03	0.28	5	1	-4
0014	3T	04_7	124	22	1	2200	1700	-500	0.05	0.77	3	3	0
0014	3T	04_7	125	26	2	2600	1970	-630	0.08	0.76	4	3	-1
0014	3T	04_7	126	20	0	2000	0	-2000	0.00	0.00	3	0	-3
0014	3T	04_7	132	17	1	1700	1190	-510	0.06	0.70	3	2	-1
0014	3T	04_7	134	21	1	2100	1010	-1090	0.05	0.48	3	1	-2
0014	3T	04_7	135	12	0	1200	0	-1200	0.00	0.00	2	0	-2
0014	3T	04_7	136	9	0	900	0	-900	0.00	0.00	1	0	-1
0014	3T	04_7	142	5	0	500	0	-500	0.00	0.00	0	0	0
0014	3T	04_7	143	12	0	1200	0	-1200	0.00	0.00	2	0	-2
0014	3T	04_7	145	12	0	1200	0	-1200	0.00	0.00	2	0	-2
0014	3T	04_7	146	10	0	1000	0	-1000	0.00	0.00	1	0	-1
0014	3T	04_7	152	7	0	700	0	-700	0.00	0.00	1	0	-1
0014	3T	04_7	153	9	0	900	0	-900	0.00	0.00	1	0	-1
0014	3T	04_7	154	10	1	1000	1180	180	0.10	1.18	1	2	1
0014	3T	04_7	156	3	0	300	0	-300	0.00	0.00	0	0	0
0014	3T	04_7	162	2	0	200	0	-200	0.00	0.00	0	0	0
0014	3T	04_7	163	8	0	800	0	-800	0.00	0.00	1	0	-1
0014	3T	04_7	164	5	0	500	0	-500	0.00	0.00	0	0	0
0014	3T	04_7	213	3	0	300	0	-300	0.00	0.00	0	0	0
0014	3T	04_7	214	3	0	300	0	-300	0.00	0.00	0	0	0
0014	3T	04_7	215	4	0	400	0	-400	0.00	0.00	0	0	0
0014	3T	04_7	216	4	0	400	0	-400	0.00	0.00	0	0	0
0014	3T	04_7	231	4	0	400	0	-400	0.00	0.00	0	0	0
0014	3T	04_7	234	6	0	600	0	-600	0.00	0.00	1	0	-1
0014	3T	04_7	235	3	0	300	0	-300	0.00	0.00	0	0	0
0014	3T	04_7	236	2	0	200	0	-200	0.00	0.00	0	0	0
0014	3T	04_7	241	2	0	200	0	-200	0.00	0.00	0	0	0
0014	3T	04_7	243	2	0	200	0	-200	0.00	0.00	0	0	0
0014	3T	04_7	246	2	0	200	0	-200	0.00	0.00	0	0	0
0014	3T	04_7	256	1	0	100	0	-100	0.00	0.00	0	0	0
0014	3T	04_7	261	1	0	100	0	-100	0.00	0.00	0	0	0
0014	3T	04_7	264	3	0	300	0	-300	0.00	0.00	0	0	0
0014	3T	05_1	123	50	5	5000	8470	3470	0.10	1.69	8	14	6
0014	3T	05_1	124	27	1	2700	1000	-1700	0.04	0.37	4	1	-3
0014	3T	05_1	125	26	1	2600	730	-1870	0.04	0.28	4	1	-3
0014	3T	05_1	126	26	0	2600	0	-2600	0.00	0.00	4	0	-4
0014	3T	05_1	132	28	2	2800	2580	-220	0.07	0.92	4	4	0
0014	3T	05_1	134	26	1	2600	1190	-1410	0.04	0.46	4	2	-2
0014	3T	05_1	135	22	2	2200	4910	2710	0.09	2.23	3	8	5
0014	3T	05_1	136	12	1	1200	1110	-90	0.08	0.93	2	1	-1
0014	3T	05_1	142	24	4	2400	4970	2570	0.17	2.07	4	8	4
0014	3T	05_1	143	17	1	1700	1760	60	0.06	1.04	3	3	0
0014	3T	05_1	145	16	0	1600	0	-1600	0.00	0.00	2	0	-2
0014	3T	05_1	146	5	0	500	0	-500	0.00	0.00	0	0	0
0014	3T	05_1	152	14	0	1400	0	-1400	0.00	0.00	2	0	-2
0014	3T	05_1	153	6	0	600	0	-600	0.00	0.00	1	0	-1
0014	3T	05_1	154	3	0	300	0	-300	0.00	0.00	0	0	0
0014	3T	05_1	156	6	1	600	10580	9980	0.17	17.63	1	18	17
0014	3T	05_1	162	2	0	200	0	-200	0.00	0.00	0	0	0
0014	3T	05_1	163	3	0	300	0	-300	0.00	0.00	0	0	0
0014	3T	05_1	164	1	0	100	0	-100	0.00	0.00	0	0	0
0014	3T	05_1	165	2	0	200	0	-200	0.00	0.00	0	0	0
0014	3T	05_1	213	5	0	500	0	-500	0.00	0.00	0	0	0
0014	3T	05_1	214	5	0	500	0	-500	0.00	0.00	0	0	0
0014	3T	05_1	215	3	0	300	0	-300	0.00	0.00	0	0	0
0014	3T	05_1	216	3	0	300	0	-300	0.00	0.00	0	0	0
0014	3T	05_1	231	1	0	100	0	-100	0.00	0.00	0	0	0
0014	3T	05_1	234	2	0	200	0	-200	0.00	0.00	0	0	0
0014	3T	05_1	235	4	0	400	0	-400	0.00	0.00	0	0	0
0014	3T	05_1	236	1	0	100	0	-100	0.00	0.00	0	0	0
0014	3T	05_1	241	2	0	200	0	-200	0.00	0.00	0	0	0
0014	3T	05_1	243	3	0	300	0	-300	0.00	0.00	0	0	0
0014	3T	05_1	245	1	0	100	0	-100	0.00	0.00	0	0	0
0014	3T	05_1	253	2	0	200	0	-200	0.00	0.00	0	0	0
0014	3T	05_1	256	1	0	100	0	-100	0.00	0.00	0	0	0
0014	3T	05_1	261	1	0	100	0	-100	0.00	0.00	0	0	0
0014	3T	05_1	265	2	0	200	0	-200	0.00	0.00	0	0	0
0014	3T	05_2	123	35	2	3500	4370	870	0.06	1.25	6	7	1
0014	3T	05_2	124	41	6	4100	7570	3470	0.15	1.85	7	13	6
0014	3T	05_2	125	24	3	2400	7940	5540	0.13	3.31	4	14	10
0014	3T	05_2	126	20	1	2000	710	-1290	0.05	0.36	3	1	-2
0014	3T	05_2	132	19	1	1900	1210	-690	0.05	0.64	3	2	-1
0014	3T	05_2	134	27	2	2700	3440	740	0.07	1.27	4	6	2
0014	3T	05_2	135	22	2	2200	1340	-860	0.09	0.61	3	2	-1
0014	3T	05_2	136	23	0	2300	0	-2300	0.00	0.00	4	0	-4
0014	3T	05_2	142	21	1	2100	750	-1350	0.05	0.36	3	1	-2
0014	3T	05_2	143	14	0	1400	0	-1400	0.00	0.00	2	0	-2
0014	3T	05_2	145	9	1	900	880	-20	0.11	0.98	1	1	0
0014	3T	05_2	146	12	1	1200	590	-610	0.08	0.49	2	1	-1
0014	3T	05_2	152	5	0	500	0	-500	0.00	0.00	0	0	0
0014	3T	05_2	153	7	0	700	0	-700	0.00	0.00	1	0	-1
0014	3T	05_2	154	5	0	500	0	-500	0.00	0.00	0	0	0
0014	3T	05_2	156	13	0	1300	0	-1300	0.00	0.00	2	0	-2
0014	3T	05_2	162	5	0	500	0	-500	0.00	0.00	0	0	0
0014	3T	05_2	163	4	0	400	0	-400	0.00	0.00	0	0	0
0014	3T	05_2	164	5	0	500	0	-500	0.00	0.00	0	0	0
0014	3T	05_2	165	1	0	100	0	-100	0.00	0.00	0	0	0
0014	3T	05_2	213	3	0	300	0	-300	0.00	0.00	0	0	0
0014	3T	05_2	214	5	0	500	0	-500	0.00	0.00	0	0	0
0014	3T	05_2	215	1	0	100	0	-100	0.00	0.00	0	0	0
0014	3T	05_2	216	10	1	1000	3320	2320	0.10	3.32	1	5	4
0014	3T	05_2	231	1	0	100	0	-100	0.00	0.00	0	0	0
0014	3T	05_2	234	1	0	100	0	-100	0.00	0.00	0	0	0
0014	3T	05_2	235	2	0	200	0	-200	0.00	0.00	0	0	0
0014	3T	05_2	236	7	0	700	0	-700	0.00	0.00	1	0	-1
0014	3T	05_2	241	2	0	200	0	-200	0.00	0.00	0	0	0
0014	3T	05_2	243	2	0	200	0	-200	0.00	0.00	0	0	0
0014	3T	05_2	245	3	0	300	0	-300	0.00	0.00	0	0	0
0014	3T	05_2	251	1	0	100	0	-100	0.00	0.00	0	0	0
0014	3T	05_2	256	1	0	100	0	-100	0.00	0.00	0	0	0
0014	3T	05_2	261	1	0	100	0	-100	0.00	0.00	0	0	0
0014	3T	05_2	263	2	0	200	0	-200	0.00	0.00	0	0	0
0014	3T	05_2	264	1	0	100	0	-100	0.00	0.00	0	0	0
0014	3T	05_3	123	36	2	3600	3540	-60	0.06	0.98	6	6	0
0014	3T	05_3	124	36	1	3600	500	-3100	0.03	0.14	6	0	-6
0014	3T	05_3	125	25	2	2500	2430	-70	0.08	0.97	4	4	0
0014	3T	05_3	126	26	0	2600	0	-2600	0.00	0.00	4	0	-4
0014	3T	05_3	132	20	0	2000	0	-2000	0.00	0.00	3	0	-3
0014	3T	05_3	134	15	1	1500	1190	-310	0.07	0.79	2	2	0
0014	3T	05_3	135	15	1	1500	570	-930	0.07	0.38	2	1	-1
0014	3T	05_3	136	17	0	1700	0	-1700	0.00	0.00	3	0	-3
0014	3T	05_3	142	17	0	1700	0	-1700	0.00	0.00	3	0	-3
0014	3T	05_3	143	12	0	1200	0	-1200	0.00	0.00	2	0	-2
0014	3T	05_3	145	12	0	1200	0	-1200	0.00	0.00	2	0	-2
0014	3T	05_3	146	6	0	600	0	-600	0.00	0.00	1	0	-1
0014	3T	05_3	152	11	0	1100	0	-1100	0.00	0.00	1	0	-1
0014	3T	05_3	153	7	0	700	0	-700	0.00	0.00	1	0	-1
0014	3T	05_3	154	7	1	700	2890	2190	0.14	4.13	1	5	4
0014	3T	05_3	156	7	0	700	0	-700	0.00	0.00	1	0	-1
0014	3T	05_3	162	5	0	500	0	-500	0.00	0.00	0	0	0
0014	3T	05_3	163	6	0	600	0	-600	0.00	0.00	1	0	-1
0014	3T	05_3	164	3	0	300	0	-300	0.00	0.00	0	0	0
0014	3T	05_3	165	3	0	300	0	-300	0.00	0.00	0	0	0
0014	3T	05_3	213	5	0	500	0	-500	0.00	0.00	0	0	0
0014	3T	05_3	214	7	1	700	1440	740	0.14	2.06	1	2	1
0014	3T	05_3	215	5	0	500	0	-500	0.00	0.00	0	0	0
0014	3T	05_3	216	4	0	400	0	-400	0.00	0.00	0	0	0
0014	3T	05_3	231	2	0	200	0	-200	0.00	0.00	0	0	0
0014	3T	05_3	234	3	0	300	0	-300	0.00	0.00	0	0	0
0014	3T	05_3	235	5	0	500	0	-500	0.00	0.00	0	0	0
0014	3T	05_3	236	2	0	200	0	-200	0.00	0.00	0	0	0
0014	3T	05_3	243	4	0	400	0	-400	0.00	0.00	0	0	0
0014	3T	05_3	245	3	0	300	0	-300	0.00	0.00	0	0	0
0014	3T	05_3	246	1	0	100	0	-100	0.00	0.00	0	0	0
0014	3T	05_3	253	5	0	500	0	-500	0.00	0.00	0	0	0
0014	3T	05_3	254	1	0	100	0	-100	0.00	0.00	0	0	0
0014	3T	05_3	256	4	1	400	1170	770	0.25	2.93	0	2	2
0014	3T	05_3	261	1	0	100	0	-100	0.00	0.00	0	0	0
0014	3T	05_3	263	4	0	400	0	-400	0.00	0.00	0	0	0
0014	3T	05_3	264	1	0	100	0	-100	0.00	0.00	0	0	0
0014	3T	05_3	265	1	0	100	0	-100	0.00	0.00	0	0	0
0014	3T	05_4	123	35	4	3500	4010	510	0.11	1.15	6	7	1
0014	3T	05_4	124	29	2	2900	1530	-1370	0.07	0.53	5	2	-3
0014	3T	05_4	125	28	1	2800	490	-2310	0.04	0.18	4	0	-4
0014	3T	05_4	126	16	0	1600	0	-1600	0.00	0.00	2	0	-2
0014	3T	05_4	132	26	1	2600	800	-1800	0.04	0.31	4	1	-3
0014	3T	05_4	134	16	2	1600	1200	-400	0.13	0.75	2	2	0
0014	3T	05_4	135	17	1	1700	740	-960	0.06	0.44	3	1	-2
0014	3T	05_4	136	12	1	1200	8300	7100	0.08	6.92	2	14	12
0014	3T	05_4	142	14	0	1400	0	-1400	0.00	0.00	2	0	-2
0014	3T	05_4	143	11	0	1100	0	-1100	0.00	0.00	1	0	-1
0014	3T	05_4	145	13	1	1300	680	-620	0.08	0.52	2	1	-1
0014	3T	05_4	146	10	2	1000	3260	2260	0.20	3.26	1	5	4
0014	3T	05_4	152	7	0	700	0	-700	0.00	0.00	1	0	-1
0014	3T	05_4	153	4	1	400	2640	2240	0.25	6.60	0	4	4
0014	3T	05_4	154	3	0	300	0	-300	0.00	0.00	0	0	0
0014	3T	05_4	156	8	0	800	0	-800	0.00	0.00	1	0	-1
0014	3T	05_4	162	2	1	200	4120	3920	0.50	20.60	0	7	7
0014	3T	05_4	163	1	0	100	0	-100	0.00	0.00	0	0	0
0014	3T	05_4	165	2	0	200	0	-200	0.00	0.00	0	0	0
0014	3T	05_4	213	1	0	100	0	-100	0.00	0.00	0	0	0
0014	3T	05_4	214	8	0	800	0	-800	0.00	0.00	1	0	-1
0014	3T	05_4	215	7	0	700	0	-700	0.00	0.00	1	0	-1
0014	3T	05_4	216	2	0	200	0	-200	0.00	0.00	0	0	0
0014	3T	05_4	231	1	0	100	0	-100	0.00	0.00	0	0	0
0014	3T	05_4	234	6	0	600	0	-600	0.00	0.00	1	0	-1
0014	3T	05_4	235	2	0	200	0	-200	0.00	0.00	0	0	0
0014	3T	05_4	236	2	0	200	0	-200	0.00	0.00	0	0	0
0014	3T	05_4	241	1	0	100	0	-100	0.00	0.00	0	0	0
0014	3T	05_4	243	1	0	100	0	-100	0.00	0.00	0	0	0
0014	3T	05_4	246	1	0	100	0	-100	0.00	0.00	0	0	0
0014	3T	05_4	256	4	0	400	0	-400	0.00	0.00	0	0	0
0014	3T	05_4	261	2	0	200	0	-200	0.00	0.00	0	0	0
0014	3T	05_4	265	1	0	100	0	-100	0.00	0.00	0	0	0
0014	3T	05_5	123	28	2	2800	1690	-1110	0.07	0.60	4	2	-2
0014	3T	05_5	124	19	2	1900	1680	-220	0.11	0.88	3	2	-1
0014	3T	05_5	125	19	1	1900	1290	-610	0.05	0.68	3	2	-1
0014	3T	05_5	126	17	1	1700	3720	2020	0.06	2.19	3	6	3
0014	3T	05_5	132	12	5	1200	6250	5050	0.42	5.21	2	11	9
0014	3T	05_5	134	16	3	1600	2810	1210	0.19	1.76	2	4	2
0014	3T	05_5	135	13	1	1300	1830	530	0.08	1.41	2	3	1
0014	3T	05_5	136	2	0	200	0	-200	0.00	0.00	0	0	0
0014	3T	05_5	142	12	0	1200	0	-1200	0.00	0.00	2	0	-2
0014	3T	05_5	143	9	1	900	930	30	0.11	1.03	1	1	0
0014	3T	05_5	145	8	1	800	1450	650	0.13	1.81	1	2	1
0014	3T	05_5	146	3	0	300	0	-300	0.00	0.00	0	0	0
0014	3T	05_5	152	7	0	700	0	-700	0.00	0.00	1	0	-1
0014	3T	05_5	153	4	0	400	0	-400	0.00	0.00	0	0	0
0014	3T	05_5	154	2	1	200	720	520	0.50	3.60	0	1	1
0014	3T	05_5	162	2	0	200	0	-200	0.00	0.00	0	0	0
0014	3T	05_5	163	2	0	200	0	-200	0.00	0.00	0	0	0
0014	3T	05_5	164	1	0	100	0	-100	0.00	0.00	0	0	0
0014	3T	05_5	165	1	0	100	0	-100	0.00	0.00	0	0	0
0014	3T	05_5	213	2	0	200	0	-200	0.00	0.00	0	0	0
0014	3T	05_5	214	3	0	300	0	-300	0.00	0.00	0	0	0
0014	3T	05_5	216	1	0	100	0	-100	0.00	0.00	0	0	0
0014	3T	05_5	234	1	0	100	0	-100	0.00	0.00	0	0	0
0014	3T	05_5	235	1	0	100	0	-100	0.00	0.00	0	0	0
0014	3T	05_5	236	1	0	100	0	-100	0.00	0.00	0	0	0
0014	3T	05_5	253	1	0	100	0	-100	0.00	0.00	0	0	0
0014	3T	05_5	254	1	0	100	0	-100	0.00	0.00	0	0	0
0014	3T	05_5	261	1	0	100	0	-100	0.00	0.00	0	0	0
0014	3T	05_6	125	1	0	100	0	-100	0.00	0.00	0	0	0
0014	3T	05_6	126	1	0	100	0	-100	0.00	0.00	0	0	0
0014	3T	05_6	132	3	0	300	0	-300	0.00	0.00	0	0	0
0014	3T	05_6	135	1	0	100	0	-100	0.00	0.00	0	0	0
0014	3T	05_6	152	1	0	100	0	-100	0.00	0.00	0	0	0
0014	3T	05_7	123	40	4	4000	5400	1400	0.10	1.35	7	9	2
0014	3T	05_7	124	33	1	3300	1840	-1460	0.03	0.56	5	3	-2
0014	3T	05_7	125	24	1	2400	2640	240	0.04	1.10	4	4	0
0014	3T	05_7	126	15	0	1500	0	-1500	0.00	0.00	2	0	-2
0014	3T	05_7	132	15	1	1500	1560	60	0.07	1.04	2	2	0
0014	3T	05_7	134	21	2	2100	3430	1330	0.10	1.63	3	6	3
0014	3T	05_7	135	40	2	4000	5050	1050	0.05	1.26	7	8	1
0014	3T	05_7	136	15	1	1500	570	-930	0.07	0.38	2	1	-1
0014	3T	05_7	142	15	1	1500	810	-690	0.07	0.54	2	1	-1
0014	3T	05_7	143	14	0	1400	0	-1400	0.00	0.00	2	0	-2
0014	3T	05_7	145	9	1	900	1080	180	0.11	1.20	1	1	0
0014	3T	05_7	146	11	1	1100	2320	1220	0.09	2.11	1	4	3
0014	3T	05_7	152	9	0	900	0	-900	0.00	0.00	1	0	-1
0014	3T	05_7	153	5	0	500	0	-500	0.00	0.00	0	0	0
0014	3T	05_7	154	5	0	500	0	-500	0.00	0.00	0	0	0
0014	3T	05_7	156	5	0	500	0	-500	0.00	0.00	0	0	0
0014	3T	05_7	163	4	0	400	0	-400	0.00	0.00	0	0	0
0014	3T	05_7	164	3	0	300	0	-300	0.00	0.00	0	0	0
0014	3T	05_7	165	1	0	100	0	-100	0.00	0.00	0	0	0
0014	3T	05_7	213	6	1	600	2430	1830	0.17	4.05	1	4	3
0014	3T	05_7	214	5	0	500	0	-500	0.00	0.00	0	0	0
0014	3T	05_7	215	4	0	400	0	-400	0.00	0.00	0	0	0
0014	3T	05_7	216	2	0	200	0	-200	0.00	0.00	0	0	0
0014	3T	05_7	231	2	0	200	0	-200	0.00	0.00	0	0	0
0014	3T	05_7	234	3	1	300	5100	4800	0.33	17.00	0	9	9
0014	3T	05_7	235	5	0	500	0	-500	0.00	0.00	0	0	0
0014	3T	05_7	236	1	0	100	0	-100	0.00	0.00	0	0	0
0014	3T	05_7	241	2	0	200	0	-200	0.00	0.00	0	0	0
0014	3T	05_7	243	2	0	200	0	-200	0.00	0.00	0	0	0
0014	3T	05_7	246	3	0	300	0	-300	0.00	0.00	0	0	0
0014	3T	05_7	256	2	0	200	0	-200	0.00	0.00	0	0	0
0014	3T	05_7	265	2	0	200	0	-200	0.00	0.00	0	0	0
0014	3T	06_1	123	54	4	5400	3600	-1800	0.07	0.67	9	6	-3
0014	3T	06_1	124	46	4	4600	8310	3710	0.09	1.81	8	14	6
0014	3T	06_1	125	22	1	2200	1500	-700	0.05	0.68	3	2	-1
0014	3T	06_1	126	33	1	3300	6640	3340	0.03	2.01	5	11	6
0014	3T	06_1	132	38	0	3800	0	-3800	0.00	0.00	6	0	-6
0014	3T	06_1	134	22	2	2200	1960	-240	0.09	0.89	3	3	0
0014	3T	06_1	135	21	0	2100	0	-2100	0.00	0.00	3	0	-3
0014	3T	06_1	136	22	2	2200	3690	1490	0.09	1.68	3	6	3
0014	3T	06_1	142	16	0	1600	0	-1600	0.00	0.00	2	0	-2
0014	3T	06_1	143	22	1	2200	970	-1230	0.05	0.44	3	1	-2
0014	3T	06_1	145	16	1	1600	1770	170	0.06	1.11	2	3	1
0014	3T	06_1	146	9	0	900	0	-900	0.00	0.00	1	0	-1
0014	3T	06_1	152	3	0	300	0	-300	0.00	0.00	0	0	0
0014	3T	06_1	153	5	1	500	3550	3050	0.20	7.10	0	6	6
0014	3T	06_1	154	8	0	800	0	-800	0.00	0.00	1	0	-1
0014	3T	06_1	156	5	0	500	0	-500	0.00	0.00	0	0	0
0014	3T	06_1	162	1	0	100	0	-100	0.00	0.00	0	0	0
0014	3T	06_1	163	2	0	200	0	-200	0.00	0.00	0	0	0
0014	3T	06_1	164	1	0	100	0	-100	0.00	0.00	0	0	0
0014	3T	06_1	165	2	0	200	0	-200	0.00	0.00	0	0	0
0014	3T	06_1	213	7	0	700	0	-700	0.00	0.00	1	0	-1
0014	3T	06_1	214	8	0	800	0	-800	0.00	0.00	1	0	-1
0014	3T	06_1	215	4	0	400	0	-400	0.00	0.00	0	0	0
0014	3T	06_1	216	5	0	500	0	-500	0.00	0.00	0	0	0
0014	3T	06_1	231	2	0	200	0	-200	0.00	0.00	0	0	0
0014	3T	06_1	234	4	0	400	0	-400	0.00	0.00	0	0	0
0014	3T	06_1	235	4	0	400	0	-400	0.00	0.00	0	0	0
0014	3T	06_1	236	1	0	100	0	-100	0.00	0.00	0	0	0
0014	3T	06_1	241	1	0	100	0	-100	0.00	0.00	0	0	0
0014	3T	06_1	243	2	0	200	0	-200	0.00	0.00	0	0	0
0014	3T	06_1	245	3	0	300	0	-300	0.00	0.00	0	0	0
0014	3T	06_1	246	4	0	400	0	-400	0.00	0.00	0	0	0
0014	3T	06_1	253	4	0	400	0	-400	0.00	0.00	0	0	0
0014	3T	06_1	254	2	0	200	0	-200	0.00	0.00	0	0	0
0014	3T	06_1	256	1	0	100	0	-100	0.00	0.00	0	0	0
0014	3T	06_1	263	2	0	200	0	-200	0.00	0.00	0	0	0
0014	3T	06_2	123	57	4	5700	4900	-800	0.07	0.86	10	8	-2
0014	3T	06_2	124	41	5	4100	4930	830	0.12	1.20	7	8	1
0014	3T	06_2	125	24	0	2400	0	-2400	0.00	0.00	4	0	-4
0014	3T	06_2	126	30	0	3000	0	-3000	0.00	0.00	5	0	-5
0014	3T	06_2	132	32	0	3200	0	-3200	0.00	0.00	5	0	-5
0014	3T	06_2	134	26	1	2600	1040	-1560	0.04	0.40	4	1	-3
0014	3T	06_2	135	28	0	2800	0	-2800	0.00	0.00	4	0	-4
0014	3T	06_2	136	19	1	1900	1440	-460	0.05	0.76	3	2	-1
0014	3T	06_2	142	19	0	1900	0	-1900	0.00	0.00	3	0	-3
0014	3T	06_2	143	23	0	2300	0	-2300	0.00	0.00	4	0	-4
0014	3T	06_2	145	11	0	1100	0	-1100	0.00	0.00	1	0	-1
0014	3T	06_2	146	9	0	900	0	-900	0.00	0.00	1	0	-1
0014	3T	06_2	152	7	0	700	0	-700	0.00	0.00	1	0	-1
0014	3T	06_2	153	7	0	700	0	-700	0.00	0.00	1	0	-1
0014	3T	06_2	154	6	0	600	0	-600	0.00	0.00	1	0	-1
0014	3T	06_2	156	2	0	200	0	-200	0.00	0.00	0	0	0
0014	3T	06_2	162	6	0	600	0	-600	0.00	0.00	1	0	-1
0014	3T	06_2	163	6	0	600	0	-600	0.00	0.00	1	0	-1
0014	3T	06_2	164	2	0	200	0	-200	0.00	0.00	0	0	0
0014	3T	06_2	165	1	0	100	0	-100	0.00	0.00	0	0	0
0014	3T	06_2	213	3	0	300	0	-300	0.00	0.00	0	0	0
0014	3T	06_2	214	9	0	900	0	-900	0.00	0.00	1	0	-1
0014	3T	06_2	215	12	0	1200	0	-1200	0.00	0.00	2	0	-2
0014	3T	06_2	216	2	0	200	0	-200	0.00	0.00	0	0	0
0014	3T	06_2	231	1	0	100	0	-100	0.00	0.00	0	0	0
0014	3T	06_2	234	3	0	300	0	-300	0.00	0.00	0	0	0
0014	3T	06_2	235	4	0	400	0	-400	0.00	0.00	0	0	0
0014	3T	06_2	236	5	0	500	0	-500	0.00	0.00	0	0	0
0014	3T	06_2	243	2	0	200	0	-200	0.00	0.00	0	0	0
0014	3T	06_2	245	1	0	100	0	-100	0.00	0.00	0	0	0
0014	3T	06_2	246	4	0	400	0	-400	0.00	0.00	0	0	0
0014	3T	06_2	251	2	0	200	0	-200	0.00	0.00	0	0	0
0014	3T	06_2	254	3	0	300	0	-300	0.00	0.00	0	0	0
0014	3T	06_2	264	1	0	100	0	-100	0.00	0.00	0	0	0
0014	3T	06_2	265	1	0	100	0	-100	0.00	0.00	0	0	0
0014	3T	06_3	123	54	5	5400	7020	1620	0.09	1.30	9	12	3
0014	3T	06_3	124	51	4	5100	5860	760	0.08	1.15	9	10	1
0014	3T	06_3	125	24	0	2400	0	-2400	0.00	0.00	4	0	-4
0014	3T	06_3	126	14	1	1400	3290	1890	0.07	2.35	2	5	3
0014	3T	06_3	132	30	4	3000	4830	1830	0.13	1.61	5	8	3
0014	3T	06_3	134	20	0	2000	0	-2000	0.00	0.00	3	0	-3
0014	3T	06_3	135	24	0	2400	0	-2400	0.00	0.00	4	0	-4
0014	3T	06_3	136	17	0	1700	0	-1700	0.00	0.00	3	0	-3
0014	3T	06_3	142	17	2	1700	2320	620	0.12	1.36	3	4	1
0014	3T	06_3	143	14	0	1400	0	-1400	0.00	0.00	2	0	-2
0014	3T	06_3	145	13	2	1300	4100	2800	0.15	3.15	2	7	5
0014	3T	06_3	146	12	0	1200	0	-1200	0.00	0.00	2	0	-2
0014	3T	06_3	152	4	0	400	0	-400	0.00	0.00	0	0	0
0014	3T	06_3	153	11	0	1100	0	-1100	0.00	0.00	1	0	-1
0014	3T	06_3	154	4	0	400	0	-400	0.00	0.00	0	0	0
0014	3T	06_3	156	6	0	600	0	-600	0.00	0.00	1	0	-1
0014	3T	06_3	162	3	0	300	0	-300	0.00	0.00	0	0	0
0014	3T	06_3	163	1	0	100	0	-100	0.00	0.00	0	0	0
0014	3T	06_3	164	4	0	400	0	-400	0.00	0.00	0	0	0
0014	3T	06_3	165	1	0	100	0	-100	0.00	0.00	0	0	0
0014	3T	06_3	213	4	0	400	0	-400	0.00	0.00	0	0	0
0014	3T	06_3	214	4	0	400	0	-400	0.00	0.00	0	0	0
0014	3T	06_3	215	4	0	400	0	-400	0.00	0.00	0	0	0
0014	3T	06_3	216	3	0	300	0	-300	0.00	0.00	0	0	0
0014	3T	06_3	231	1	0	100	0	-100	0.00	0.00	0	0	0
0014	3T	06_3	234	1	0	100	0	-100	0.00	0.00	0	0	0
0014	3T	06_3	235	3	0	300	0	-300	0.00	0.00	0	0	0
0014	3T	06_3	236	3	0	300	0	-300	0.00	0.00	0	0	0
0014	3T	06_3	241	2	0	200	0	-200	0.00	0.00	0	0	0
0014	3T	06_3	243	2	0	200	0	-200	0.00	0.00	0	0	0
0014	3T	06_3	245	3	0	300	0	-300	0.00	0.00	0	0	0
0014	3T	06_3	246	1	0	100	0	-100	0.00	0.00	0	0	0
0014	3T	06_3	251	2	0	200	0	-200	0.00	0.00	0	0	0
0014	3T	06_3	253	1	0	100	0	-100	0.00	0.00	0	0	0
0014	3T	06_3	264	1	0	100	0	-100	0.00	0.00	0	0	0
0014	3T	06_4	123	24	1	2400	1030	-1370	0.04	0.43	4	1	-3
0014	3T	06_4	124	21	2	2100	2210	110	0.10	1.05	3	3	0
0014	3T	06_4	125	24	1	2400	770	-1630	0.04	0.32	4	1	-3
0014	3T	06_4	126	31	0	3100	0	-3100	0.00	0.00	5	0	-5
0014	3T	06_4	132	22	2	2200	1700	-500	0.09	0.77	3	3	0
0014	3T	06_4	134	15	1	1500	1070	-430	0.07	0.71	2	1	-1
0014	3T	06_4	135	14	0	1400	0	-1400	0.00	0.00	2	0	-2
0014	3T	06_4	136	11	0	1100	0	-1100	0.00	0.00	1	0	-1
0014	3T	06_4	142	12	0	1200	0	-1200	0.00	0.00	2	0	-2
0014	3T	06_4	143	18	1	1800	1670	-130	0.06	0.93	3	2	-1
0014	3T	06_4	145	5	0	500	0	-500	0.00	0.00	0	0	0
0014	3T	06_4	146	4	0	400	0	-400	0.00	0.00	0	0	0
0014	3T	06_4	152	9	0	900	0	-900	0.00	0.00	1	0	-1
0014	3T	06_4	153	4	0	400	0	-400	0.00	0.00	0	0	0
0014	3T	06_4	154	2	0	200	0	-200	0.00	0.00	0	0	0
0014	3T	06_4	156	2	0	200	0	-200	0.00	0.00	0	0	0
0014	3T	06_4	162	4	0	400	0	-400	0.00	0.00	0	0	0
0014	3T	06_4	163	5	0	500	0	-500	0.00	0.00	0	0	0
0014	3T	06_4	164	4	0	400	0	-400	0.00	0.00	0	0	0
0014	3T	06_4	165	1	0	100	0	-100	0.00	0.00	0	0	0
0014	3T	06_4	213	1	0	100	0	-100	0.00	0.00	0	0	0
0014	3T	06_4	214	2	0	200	0	-200	0.00	0.00	0	0	0
0014	3T	06_4	215	4	0	400	0	-400	0.00	0.00	0	0	0
0014	3T	06_4	216	4	0	400	0	-400	0.00	0.00	0	0	0
0014	3T	06_4	231	1	0	100	0	-100	0.00	0.00	0	0	0
0014	3T	06_4	234	1	0	100	0	-100	0.00	0.00	0	0	0
0014	3T	06_4	235	3	0	300	0	-300	0.00	0.00	0	0	0
0014	3T	06_4	236	3	0	300	0	-300	0.00	0.00	0	0	0
0014	3T	06_4	241	3	0	300	0	-300	0.00	0.00	0	0	0
0014	3T	06_4	243	1	0	100	0	-100	0.00	0.00	0	0	0
0014	3T	06_4	245	1	0	100	0	-100	0.00	0.00	0	0	0
0014	3T	06_4	246	2	0	200	0	-200	0.00	0.00	0	0	0
0014	3T	06_4	253	1	0	100	0	-100	0.00	0.00	0	0	0
0014	3T	06_4	254	2	0	200	0	-200	0.00	0.00	0	0	0
0014	3T	06_4	256	1	0	100	0	-100	0.00	0.00	0	0	0
0014	3T	06_4	264	1	0	100	0	-100	0.00	0.00	0	0	0
0014	3T	06_5	123	12	1	1200	970	-230	0.08	0.81	2	1	-1
0014	3T	06_5	124	16	3	1600	5140	3540	0.19	3.21	2	9	7
0014	3T	06_5	125	13	0	1300	0	-1300	0.00	0.00	2	0	-2
0014	3T	06_5	126	8	0	800	0	-800	0.00	0.00	1	0	-1
0014	3T	06_5	132	13	1	1300	1430	130	0.08	1.10	2	2	0
0014	3T	06_5	134	11	1	1100	810	-290	0.09	0.74	1	1	0
0014	3T	06_5	135	7	0	700	0	-700	0.00	0.00	1	0	-1
0014	3T	06_5	136	2	0	200	0	-200	0.00	0.00	0	0	0
0014	3T	06_5	142	11	0	1100	0	-1100	0.00	0.00	1	0	-1
0014	3T	06_5	143	10	0	1000	0	-1000	0.00	0.00	1	0	-1
0014	3T	06_5	145	4	0	400	0	-400	0.00	0.00	0	0	0
0014	3T	06_5	146	5	0	500	0	-500	0.00	0.00	0	0	0
0014	3T	06_5	152	3	0	300	0	-300	0.00	0.00	0	0	0
0014	3T	06_5	153	3	0	300	0	-300	0.00	0.00	0	0	0
0014	3T	06_5	154	3	0	300	0	-300	0.00	0.00	0	0	0
0014	3T	06_5	162	3	0	300	0	-300	0.00	0.00	0	0	0
0014	3T	06_5	163	3	0	300	0	-300	0.00	0.00	0	0	0
0014	3T	06_5	164	1	0	100	0	-100	0.00	0.00	0	0	0
0014	3T	06_5	165	2	0	200	0	-200	0.00	0.00	0	0	0
0014	3T	06_5	213	1	0	100	0	-100	0.00	0.00	0	0	0
0014	3T	06_5	214	2	0	200	0	-200	0.00	0.00	0	0	0
0014	3T	06_5	215	2	0	200	0	-200	0.00	0.00	0	0	0
0014	3T	06_5	216	2	0	200	0	-200	0.00	0.00	0	0	0
0014	3T	06_5	234	4	0	400	0	-400	0.00	0.00	0	0	0
0014	3T	06_5	235	2	0	200	0	-200	0.00	0.00	0	0	0
0014	3T	06_5	236	3	0	300	0	-300	0.00	0.00	0	0	0
0014	3T	06_5	241	1	0	100	0	-100	0.00	0.00	0	0	0
0014	3T	06_5	245	1	0	100	0	-100	0.00	0.00	0	0	0
0014	3T	06_5	253	1	0	100	0	-100	0.00	0.00	0	0	0
0014	3T	06_5	254	1	0	100	0	-100	0.00	0.00	0	0	0
0014	3T	06_5	263	2	0	200	0	-200	0.00	0.00	0	0	0
0014	3T	06_5	265	1	0	100	0	-100	0.00	0.00	0	0	0
0014	3T	06_6	123	3	0	300	0	-300	0.00	0.00	0	0	0
0014	3T	06_6	124	2	0	200	0	-200	0.00	0.00	0	0	0
0014	3T	06_6	125	2	1	200	1730	1530	0.50	8.65	0	3	3
0014	3T	06_6	126	4	1	400	9170	8770	0.25	22.93	0	16	16
0014	3T	06_6	134	2	0	200	0	-200	0.00	0.00	0	0	0
0014	3T	06_6	136	1	0	100	0	-100	0.00	0.00	0	0	0
0014	3T	06_6	142	1	0	100	0	-100	0.00	0.00	0	0	0
0014	3T	06_6	143	2	0	200	0	-200	0.00	0.00	0	0	0
0014	3T	06_6	154	1	0	100	0	-100	0.00	0.00	0	0	0
0014	3T	06_6	156	1	0	100	0	-100	0.00	0.00	0	0	0
0014	3T	06_6	164	1	0	100	0	-100	0.00	0.00	0	0	0
0014	3T	06_6	214	1	0	100	0	-100	0.00	0.00	0	0	0
0014	3T	06_7	123	50	7	5000	5580	580	0.14	1.12	8	9	1
0014	3T	06_7	124	46	4	4600	5070	470	0.09	1.10	8	8	0
0014	3T	06_7	125	29	2	2900	1980	-920	0.07	0.68	5	3	-2
0014	3T	06_7	126	29	1	2900	2790	-110	0.03	0.96	5	4	-1
0014	3T	06_7	132	30	3	3000	3000	0	0.10	1.00	5	5	0
0014	3T	06_7	134	33	2	3300	1240	-2060	0.06	0.38	5	2	-3
0014	3T	06_7	135	14	0	1400	0	-1400	0.00	0.00	2	0	-2
0014	3T	06_7	136	16	1	1600	780	-820	0.06	0.49	2	1	-1
0014	3T	06_7	142	30	2	3000	2290	-710	0.07	0.76	5	4	-1
0014	3T	06_7	143	19	3	1900	5040	3140	0.16	2.65	3	8	5
0014	3T	06_7	145	18	1	1800	880	-920	0.06	0.49	3	1	-2
0014	3T	06_7	146	8	0	800	0	-800	0.00	0.00	1	0	-1
0014	3T	06_7	152	14	0	1400	0	-1400	0.00	0.00	2	0	-2
0014	3T	06_7	153	7	0	700	0	-700	0.00	0.00	1	0	-1
0014	3T	06_7	154	10	0	1000	0	-1000	0.00	0.00	1	0	-1
0014	3T	06_7	156	4	1	400	530	130	0.25	1.33	0	0	0
0014	3T	06_7	162	2	0	200	0	-200	0.00	0.00	0	0	0
0014	3T	06_7	163	3	0	300	0	-300	0.00	0.00	0	0	0
0014	3T	06_7	164	5	0	500	0	-500	0.00	0.00	0	0	0
0014	3T	06_7	165	1	0	100	0	-100	0.00	0.00	0	0	0
0014	3T	06_7	213	6	0	600	0	-600	0.00	0.00	1	0	-1
0014	3T	06_7	214	4	0	400	0	-400	0.00	0.00	0	0	0
0014	3T	06_7	215	5	0	500	0	-500	0.00	0.00	0	0	0
0014	3T	06_7	216	2	0	200	0	-200	0.00	0.00	0	0	0
0014	3T	06_7	231	1	0	100	0	-100	0.00	0.00	0	0	0
0014	3T	06_7	234	2	0	200	0	-200	0.00	0.00	0	0	0
0014	3T	06_7	235	3	0	300	0	-300	0.00	0.00	0	0	0
0014	3T	06_7	236	2	0	200	0	-200	0.00	0.00	0	0	0
0014	3T	06_7	241	2	0	200	0	-200	0.00	0.00	0	0	0
0014	3T	06_7	243	2	0	200	0	-200	0.00	0.00	0	0	0
0014	3T	06_7	245	1	0	100	0	-100	0.00	0.00	0	0	0
0014	3T	06_7	246	1	0	100	0	-100	0.00	0.00	0	0	0
0014	3T	06_7	251	1	0	100	0	-100	0.00	0.00	0	0	0
0014	3T	06_7	254	2	0	200	0	-200	0.00	0.00	0	0	0
0014	3T	06_7	256	1	0	100	0	-100	0.00	0.00	0	0	0
0014	3T	06_7	263	1	0	100	0	-100	0.00	0.00	0	0	0
0014	3T	07_1	123	48	4	4800	5460	660	0.08	1.14	8	9	1
0014	3T	07_1	124	37	2	3700	1960	-1740	0.05	0.53	6	3	-3
0014	3T	07_1	125	19	1	1900	1370	-530	0.05	0.72	3	2	-1
0014	3T	07_1	126	24	0	2400	0	-2400	0.00	0.00	4	0	-4
0014	3T	07_1	132	22	0	2200	0	-2200	0.00	0.00	3	0	-3
0014	3T	07_1	134	29	3	2900	1780	-1120	0.10	0.61	5	3	-2
0014	3T	07_1	135	19	2	1900	2230	330	0.11	1.17	3	3	0
0014	3T	07_1	136	18	1	1800	2060	260	0.06	1.14	3	3	0
0014	3T	07_1	142	11	1	1100	1540	440	0.09	1.40	1	2	1
0014	3T	07_1	143	11	0	1100	0	-1100	0.00	0.00	1	0	-1
0014	3T	07_1	145	17	0	1700	0	-1700	0.00	0.00	3	0	-3
0014	3T	07_1	146	9	0	900	0	-900	0.00	0.00	1	0	-1
0014	3T	07_1	152	5	1	500	3770	3270	0.20	7.54	0	6	6
0014	3T	07_1	153	10	0	1000	0	-1000	0.00	0.00	1	0	-1
0014	3T	07_1	154	6	0	600	0	-600	0.00	0.00	1	0	-1
0014	3T	07_1	156	8	3	800	7860	7060	0.38	9.83	1	13	12
0014	3T	07_1	162	2	0	200	0	-200	0.00	0.00	0	0	0
0014	3T	07_1	163	1	0	100	0	-100	0.00	0.00	0	0	0
0014	3T	07_1	164	2	0	200	0	-200	0.00	0.00	0	0	0
0014	3T	07_1	165	4	0	400	0	-400	0.00	0.00	0	0	0
0014	3T	07_1	213	2	0	200	0	-200	0.00	0.00	0	0	0
0014	3T	07_1	214	7	1	700	1960	1260	0.14	2.80	1	3	2
0014	3T	07_1	215	4	0	400	0	-400	0.00	0.00	0	0	0
0014	3T	07_1	216	3	0	300	0	-300	0.00	0.00	0	0	0
0014	3T	07_1	231	1	0	100	0	-100	0.00	0.00	0	0	0
0014	3T	07_1	235	2	0	200	0	-200	0.00	0.00	0	0	0
0014	3T	07_1	236	2	0	200	0	-200	0.00	0.00	0	0	0
0014	3T	07_1	241	1	0	100	0	-100	0.00	0.00	0	0	0
0014	3T	07_1	253	3	0	300	0	-300	0.00	0.00	0	0	0
0014	3T	07_1	256	1	0	100	0	-100	0.00	0.00	0	0	0
0014	3T	07_1	264	3	0	300	0	-300	0.00	0.00	0	0	0
0014	3T	07_2	123	46	1	4600	1900	-2700	0.02	0.41	8	3	-5
0014	3T	07_2	124	48	4	4800	4500	-300	0.08	0.94	8	7	-1
0014	3T	07_2	125	24	5	2400	8360	5960	0.21	3.48	4	14	10
0014	3T	07_2	126	28	2	2800	3830	1030	0.07	1.37	4	6	2
0014	3T	07_2	132	24	4	2400	8010	5610	0.17	3.34	4	14	10
0014	3T	07_2	134	19	2	1900	820	-1080	0.11	0.43	3	1	-2
0014	3T	07_2	135	16	0	1600	0	-1600	0.00	0.00	2	0	-2
0014	3T	07_2	136	20	2	2000	1350	-650	0.10	0.68	3	2	-1
0014	3T	07_2	142	18	1	1800	1170	-630	0.06	0.65	3	2	-1
0014	3T	07_2	143	16	2	1600	5140	3540	0.13	3.21	2	9	7
0014	3T	07_2	145	11	1	1100	1810	710	0.09	1.65	1	3	2
0014	3T	07_2	146	9	0	900	0	-900	0.00	0.00	1	0	-1
0014	3T	07_2	152	7	0	700	0	-700	0.00	0.00	1	0	-1
0014	3T	07_2	153	5	0	500	0	-500	0.00	0.00	0	0	0
0014	3T	07_2	154	7	0	700	0	-700	0.00	0.00	1	0	-1
0014	3T	07_2	156	4	1	400	1480	1080	0.25	3.70	0	2	2
0014	3T	07_2	162	4	0	400	0	-400	0.00	0.00	0	0	0
0014	3T	07_2	164	2	0	200	0	-200	0.00	0.00	0	0	0
0014	3T	07_2	165	3	0	300	0	-300	0.00	0.00	0	0	0
0014	3T	07_2	213	4	0	400	0	-400	0.00	0.00	0	0	0
0014	3T	07_2	214	2	0	200	0	-200	0.00	0.00	0	0	0
0014	3T	07_2	215	3	0	300	0	-300	0.00	0.00	0	0	0
0014	3T	07_2	216	5	0	500	0	-500	0.00	0.00	0	0	0
0014	3T	07_2	231	2	0	200	0	-200	0.00	0.00	0	0	0
0014	3T	07_2	234	1	0	100	0	-100	0.00	0.00	0	0	0
0014	3T	07_2	236	2	0	200	0	-200	0.00	0.00	0	0	0
0014	3T	07_2	241	2	0	200	0	-200	0.00	0.00	0	0	0
0014	3T	07_2	243	1	0	100	0	-100	0.00	0.00	0	0	0
0014	3T	07_2	246	1	0	100	0	-100	0.00	0.00	0	0	0
0014	3T	07_2	253	3	0	300	0	-300	0.00	0.00	0	0	0
0014	3T	07_2	254	3	0	300	0	-300	0.00	0.00	0	0	0
0014	3T	07_2	261	4	0	400	0	-400	0.00	0.00	0	0	0
0014	3T	07_2	263	2	0	200	0	-200	0.00	0.00	0	0	0
0014	3T	07_3	123	59	4	5900	5500	-400	0.07	0.93	10	9	-1
0014	3T	07_3	124	45	2	4500	3940	-560	0.04	0.88	7	6	-1
0014	3T	07_3	125	37	0	3700	0	-3700	0.00	0.00	6	0	-6
0014	3T	07_3	126	25	1	2500	570	-1930	0.04	0.23	4	1	-3
0014	3T	07_3	132	25	2	2500	2710	210	0.08	1.08	4	4	0
0014	3T	07_3	134	24	1	2400	3830	1430	0.04	1.60	4	6	2
0014	3T	07_3	135	22	3	2200	3190	990	0.14	1.45	3	5	2
0014	3T	07_3	136	14	0	1400	0	-1400	0.00	0.00	2	0	-2
0014	3T	07_3	142	12	1	1200	840	-360	0.08	0.70	2	1	-1
0014	3T	07_3	143	9	0	900	0	-900	0.00	0.00	1	0	-1
0014	3T	07_3	145	6	0	600	0	-600	0.00	0.00	1	0	-1
0014	3T	07_3	146	7	0	700	0	-700	0.00	0.00	1	0	-1
0014	3T	07_3	152	6	0	600	0	-600	0.00	0.00	1	0	-1
0014	3T	07_3	153	7	0	700	0	-700	0.00	0.00	1	0	-1
0014	3T	07_3	154	4	0	400	0	-400	0.00	0.00	0	0	0
0014	3T	07_3	156	7	0	700	0	-700	0.00	0.00	1	0	-1
0014	3T	07_3	162	7	0	700	0	-700	0.00	0.00	1	0	-1
0014	3T	07_3	163	7	0	700	0	-700	0.00	0.00	1	0	-1
0014	3T	07_3	165	1	0	100	0	-100	0.00	0.00	0	0	0
0014	3T	07_3	213	5	0	500	0	-500	0.00	0.00	0	0	0
0014	3T	07_3	214	3	0	300	0	-300	0.00	0.00	0	0	0
0014	3T	07_3	215	3	0	300	0	-300	0.00	0.00	0	0	0
0014	3T	07_3	216	4	0	400	0	-400	0.00	0.00	0	0	0
0014	3T	07_3	231	2	0	200	0	-200	0.00	0.00	0	0	0
0014	3T	07_3	234	4	0	400	0	-400	0.00	0.00	0	0	0
0014	3T	07_3	235	2	0	200	0	-200	0.00	0.00	0	0	0
0014	3T	07_3	236	2	0	200	0	-200	0.00	0.00	0	0	0
0014	3T	07_3	243	3	1	300	3100	2800	0.33	10.33	0	5	5
0014	3T	07_3	246	2	0	200	0	-200	0.00	0.00	0	0	0
0014	3T	07_3	251	2	0	200	0	-200	0.00	0.00	0	0	0
0014	3T	07_3	256	2	0	200	0	-200	0.00	0.00	0	0	0
0014	3T	07_3	261	1	0	100	0	-100	0.00	0.00	0	0	0
0014	3T	07_3	263	1	0	100	0	-100	0.00	0.00	0	0	0
0014	3T	07_3	264	1	0	100	0	-100	0.00	0.00	0	0	0
0014	3T	07_3	265	1	1	100	8860	8760	1.00	88.60	0	15	15
0014	3T	07_4	123	52	4	5200	3880	-1320	0.08	0.75	9	6	-3
0014	3T	07_4	124	24	2	2400	1070	-1330	0.08	0.45	4	1	-3
0014	3T	07_4	125	34	2	3400	1730	-1670	0.06	0.51	6	3	-3
0014	3T	07_4	126	27	2	2700	2500	-200	0.07	0.93	4	4	0
0014	3T	07_4	132	29	4	2900	10440	7540	0.14	3.60	5	18	13
0014	3T	07_4	134	28	3	2800	2100	-700	0.11	0.75	4	3	-1
0014	3T	07_4	135	11	2	1100	2200	1100	0.18	2.00	1	3	2
0014	3T	07_4	136	12	0	1200	0	-1200	0.00	0.00	2	0	-2
0014	3T	07_4	142	18	2	1800	1050	-750	0.11	0.58	3	1	-2
0014	3T	07_4	143	13	0	1300	0	-1300	0.00	0.00	2	0	-2
0014	3T	07_4	145	13	0	1300	0	-1300	0.00	0.00	2	0	-2
0014	3T	07_4	146	12	0	1200	0	-1200	0.00	0.00	2	0	-2
0014	3T	07_4	152	2	0	200	0	-200	0.00	0.00	0	0	0
0014	3T	07_4	153	1	0	100	0	-100	0.00	0.00	0	0	0
0014	3T	07_4	154	1	0	100	0	-100	0.00	0.00	0	0	0
0014	3T	07_4	156	4	0	400	0	-400	0.00	0.00	0	0	0
0014	3T	07_4	162	4	2	400	4020	3620	0.50	10.05	0	7	7
0014	3T	07_4	163	4	1	400	2580	2180	0.25	6.45	0	4	4
0014	3T	07_4	164	3	0	300	0	-300	0.00	0.00	0	0	0
0014	3T	07_4	165	2	0	200	0	-200	0.00	0.00	0	0	0
0014	3T	07_4	213	7	0	700	0	-700	0.00	0.00	1	0	-1
0014	3T	07_4	214	6	0	600	0	-600	0.00	0.00	1	0	-1
0014	3T	07_4	215	1	0	100	0	-100	0.00	0.00	0	0	0
0014	3T	07_4	216	5	0	500	0	-500	0.00	0.00	0	0	0
0014	3T	07_4	231	1	0	100	0	-100	0.00	0.00	0	0	0
0014	3T	07_4	234	4	0	400	0	-400	0.00	0.00	0	0	0
0014	3T	07_4	236	2	0	200	0	-200	0.00	0.00	0	0	0
0014	3T	07_4	241	1	0	100	0	-100	0.00	0.00	0	0	0
0014	3T	07_4	243	1	0	100	0	-100	0.00	0.00	0	0	0
0014	3T	07_4	245	1	0	100	0	-100	0.00	0.00	0	0	0
0014	3T	07_4	251	1	0	100	0	-100	0.00	0.00	0	0	0
0014	3T	07_4	256	2	0	200	0	-200	0.00	0.00	0	0	0
0014	3T	07_4	261	2	0	200	0	-200	0.00	0.00	0	0	0
0014	3T	07_4	263	1	0	100	0	-100	0.00	0.00	0	0	0
0014	3T	07_5	123	40	3	4000	2040	-1960	0.08	0.51	7	3	-4
0014	3T	07_5	124	41	3	4100	4340	240	0.07	1.06	7	7	0
0014	3T	07_5	125	10	1	1000	1360	360	0.10	1.36	1	2	1
0014	3T	07_5	126	21	2	2100	2280	180	0.10	1.09	3	4	1
0014	3T	07_5	132	20	1	2000	860	-1140	0.05	0.43	3	1	-2
0014	3T	07_5	134	16	3	1600	4630	3030	0.19	2.89	2	8	6
0014	3T	07_5	135	16	1	1600	1580	-20	0.06	0.99	2	2	0
0014	3T	07_5	136	8	0	800	0	-800	0.00	0.00	1	0	-1
0014	3T	07_5	142	11	1	1100	2400	1300	0.09	2.18	1	4	3
0014	3T	07_5	143	14	0	1400	0	-1400	0.00	0.00	2	0	-2
0014	3T	07_5	145	13	2	1300	2240	940	0.15	1.72	2	3	1
0014	3T	07_5	146	4	0	400	0	-400	0.00	0.00	0	0	0
0014	3T	07_5	152	4	1	400	790	390	0.25	1.98	0	1	1
0014	3T	07_5	153	3	0	300	0	-300	0.00	0.00	0	0	0
0014	3T	07_5	154	2	0	200	0	-200	0.00	0.00	0	0	0
0014	3T	07_5	156	2	0	200	0	-200	0.00	0.00	0	0	0
0014	3T	07_5	162	2	0	200	0	-200	0.00	0.00	0	0	0
0014	3T	07_5	163	4	0	400	0	-400	0.00	0.00	0	0	0
0014	3T	07_5	164	3	0	300	0	-300	0.00	0.00	0	0	0
0014	3T	07_5	165	2	0	200	0	-200	0.00	0.00	0	0	0
0014	3T	07_5	213	4	0	400	0	-400	0.00	0.00	0	0	0
0014	3T	07_5	214	2	1	200	1650	1450	0.50	8.25	0	2	2
0014	3T	07_5	215	3	0	300	0	-300	0.00	0.00	0	0	0
0014	3T	07_5	216	1	0	100	0	-100	0.00	0.00	0	0	0
0014	3T	07_5	231	1	0	100	0	-100	0.00	0.00	0	0	0
0014	3T	07_5	234	1	0	100	0	-100	0.00	0.00	0	0	0
0014	3T	07_5	236	1	0	100	0	-100	0.00	0.00	0	0	0
0014	3T	07_5	246	1	0	100	0	-100	0.00	0.00	0	0	0
0014	3T	07_5	251	1	0	100	0	-100	0.00	0.00	0	0	0
0014	3T	07_5	253	1	0	100	0	-100	0.00	0.00	0	0	0
0014	3T	07_5	254	1	0	100	0	-100	0.00	0.00	0	0	0
0014	3T	07_5	264	1	0	100	0	-100	0.00	0.00	0	0	0
0014	3T	07_6	123	6	0	600	0	-600	0.00	0.00	1	0	-1
0014	3T	07_6	124	4	0	400	0	-400	0.00	0.00	0	0	0
0014	3T	07_6	125	1	0	100	0	-100	0.00	0.00	0	0	0
0014	3T	07_6	126	1	0	100	0	-100	0.00	0.00	0	0	0
0014	3T	07_6	132	2	0	200	0	-200	0.00	0.00	0	0	0
0014	3T	07_6	134	2	0	200	0	-200	0.00	0.00	0	0	0
0014	3T	07_6	135	1	0	100	0	-100	0.00	0.00	0	0	0
0014	3T	07_6	136	2	0	200	0	-200	0.00	0.00	0	0	0
0014	3T	07_6	143	3	0	300	0	-300	0.00	0.00	0	0	0
0014	3T	07_6	145	2	1	200	4780	4580	0.50	23.90	0	8	8
0014	3T	07_6	146	2	0	200	0	-200	0.00	0.00	0	0	0
0014	3T	07_6	153	1	0	100	0	-100	0.00	0.00	0	0	0
0014	3T	07_6	154	3	0	300	0	-300	0.00	0.00	0	0	0
0014	3T	07_6	156	1	0	100	0	-100	0.00	0.00	0	0	0
0014	3T	07_6	164	1	0	100	0	-100	0.00	0.00	0	0	0
0014	3T	07_7	123	50	5	5000	4540	-460	0.10	0.91	8	8	0
0014	3T	07_7	124	53	4	5300	2580	-2720	0.08	0.49	9	4	-5
0014	3T	07_7	125	31	3	3100	3200	100	0.10	1.03	5	5	0
0014	3T	07_7	126	17	1	1700	1840	140	0.06	1.08	3	3	0
0014	3T	07_7	132	24	3	2400	2250	-150	0.13	0.94	4	3	-1
0014	3T	07_7	134	32	3	3200	2970	-230	0.09	0.93	5	5	0
0014	3T	07_7	135	21	1	2100	2040	-60	0.05	0.97	3	3	0
0014	3T	07_7	136	14	0	1400	0	-1400	0.00	0.00	2	0	-2
0014	3T	07_7	142	17	0	1700	0	-1700	0.00	0.00	3	0	-3
0014	3T	07_7	143	16	1	1600	1680	80	0.06	1.05	2	2	0
0014	3T	07_7	145	18	2	1800	3750	1950	0.11	2.08	3	6	3
0014	3T	07_7	146	8	0	800	0	-800	0.00	0.00	1	0	-1
0014	3T	07_7	152	5	0	500	0	-500	0.00	0.00	0	0	0
0014	3T	07_7	153	6	0	600	0	-600	0.00	0.00	1	0	-1
0014	3T	07_7	154	5	0	500	0	-500	0.00	0.00	0	0	0
0014	3T	07_7	156	4	0	400	0	-400	0.00	0.00	0	0	0
0014	3T	07_7	162	2	0	200	0	-200	0.00	0.00	0	0	0
0014	3T	07_7	163	6	0	600	0	-600	0.00	0.00	1	0	-1
0014	3T	07_7	164	3	0	300	0	-300	0.00	0.00	0	0	0
0014	3T	07_7	165	2	0	200	0	-200	0.00	0.00	0	0	0
0014	3T	07_7	213	2	0	200	0	-200	0.00	0.00	0	0	0
0014	3T	07_7	214	6	2	600	8260	7660	0.33	13.77	1	14	13
0014	3T	07_7	216	4	0	400	0	-400	0.00	0.00	0	0	0
0014	3T	07_7	231	1	0	100	0	-100	0.00	0.00	0	0	0
0014	3T	07_7	236	1	0	100	0	-100	0.00	0.00	0	0	0
0014	3T	07_7	241	1	0	100	0	-100	0.00	0.00	0	0	0
0014	3T	07_7	246	1	0	100	0	-100	0.00	0.00	0	0	0
0014	3T	07_7	251	1	0	100	0	-100	0.00	0.00	0	0	0
0014	3T	07_7	253	1	0	100	0	-100	0.00	0.00	0	0	0
0014	3T	07_7	254	1	0	100	0	-100	0.00	0.00	0	0	0
0014	3T	07_7	256	2	0	200	0	-200	0.00	0.00	0	0	0
0014	3T	08_1	123	51	4	5100	2270	-2830	0.08	0.45	9	4	-5
0014	3T	08_1	124	48	8	4800	7850	3050	0.17	1.64	8	13	5
0014	3T	08_1	125	36	0	3600	0	-3600	0.00	0.00	6	0	-6
0014	3T	08_1	126	45	2	4500	3420	-1080	0.04	0.76	7	6	-1
0014	3T	08_1	132	25	1	2500	810	-1690	0.04	0.32	4	1	-3
0014	3T	08_1	134	25	1	2500	1160	-1340	0.04	0.46	4	2	-2
0014	3T	08_1	135	19	0	1900	0	-1900	0.00	0.00	3	0	-3
0014	3T	08_1	136	22	4	2200	3160	960	0.18	1.44	3	5	2
0014	3T	08_1	142	12	0	1200	0	-1200	0.00	0.00	2	0	-2
0014	3T	08_1	143	12	0	1200	0	-1200	0.00	0.00	2	0	-2
0014	3T	08_1	145	13	0	1300	0	-1300	0.00	0.00	2	0	-2
0014	3T	08_1	146	13	1	1300	2560	1260	0.08	1.97	2	4	2
0014	3T	08_1	152	6	0	600	0	-600	0.00	0.00	1	0	-1
0014	3T	08_1	153	7	0	700	0	-700	0.00	0.00	1	0	-1
0014	3T	08_1	154	5	0	500	0	-500	0.00	0.00	0	0	0
0014	3T	08_1	156	8	1	800	930	130	0.13	1.16	1	1	0
0014	3T	08_1	162	10	0	1000	0	-1000	0.00	0.00	1	0	-1
0014	3T	08_1	163	6	0	600	0	-600	0.00	0.00	1	0	-1
0014	3T	08_1	164	7	0	700	0	-700	0.00	0.00	1	0	-1
0014	3T	08_1	165	3	0	300	0	-300	0.00	0.00	0	0	0
0014	3T	08_1	213	5	1	500	1410	910	0.20	2.82	0	2	2
0014	3T	08_1	215	1	0	100	0	-100	0.00	0.00	0	0	0
0014	3T	08_1	216	6	0	600	0	-600	0.00	0.00	1	0	-1
0014	3T	08_1	235	1	0	100	0	-100	0.00	0.00	0	0	0
0014	3T	08_1	236	3	0	300	0	-300	0.00	0.00	0	0	0
0014	3T	08_1	243	2	0	200	0	-200	0.00	0.00	0	0	0
0014	3T	08_1	245	1	0	100	0	-100	0.00	0.00	0	0	0
0014	3T	08_1	251	3	0	300	0	-300	0.00	0.00	0	0	0
0014	3T	08_1	254	1	0	100	0	-100	0.00	0.00	0	0	0
0014	3T	08_1	261	3	0	300	0	-300	0.00	0.00	0	0	0
0014	3T	08_2	123	51	4	5100	4010	-1090	0.08	0.79	9	7	-2
0014	3T	08_2	124	54	7	5400	9910	4510	0.13	1.84	9	17	8
0014	3T	08_2	125	32	2	3200	1410	-1790	0.06	0.44	5	2	-3
0014	3T	08_2	126	27	2	2700	3560	860	0.07	1.32	4	6	2
0014	3T	08_2	132	33	2	3300	1940	-1360	0.06	0.59	5	3	-2
0014	3T	08_2	134	31	3	3100	2660	-440	0.10	0.86	5	4	-1
0014	3T	08_2	135	23	1	2300	770	-1530	0.04	0.33	4	1	-3
0014	3T	08_2	136	26	3	2600	4460	1860	0.12	1.72	4	7	3
0014	3T	08_2	142	17	0	1700	0	-1700	0.00	0.00	3	0	-3
0014	3T	08_2	143	15	2	1500	2030	530	0.13	1.35	2	3	1
0014	3T	08_2	145	9	0	900	0	-900	0.00	0.00	1	0	-1
0014	3T	08_2	146	13	2	1300	1580	280	0.15	1.22	2	2	0
0014	3T	08_2	152	9	1	900	1280	380	0.11	1.42	1	2	1
0014	3T	08_2	153	9	2	900	2440	1540	0.22	2.71	1	4	3
0014	3T	08_2	154	7	1	700	1450	750	0.14	2.07	1	2	1
0014	3T	08_2	156	8	0	800	0	-800	0.00	0.00	1	0	-1
0014	3T	08_2	162	6	0	600	0	-600	0.00	0.00	1	0	-1
0014	3T	08_2	163	8	0	800	0	-800	0.00	0.00	1	0	-1
0014	3T	08_2	164	2	0	200	0	-200	0.00	0.00	0	0	0
0014	3T	08_2	165	2	0	200	0	-200	0.00	0.00	0	0	0
0014	3T	08_2	213	5	1	500	950	450	0.20	1.90	0	1	1
0014	3T	08_2	214	4	0	400	0	-400	0.00	0.00	0	0	0
0014	3T	08_2	215	3	1	300	3930	3630	0.33	13.10	0	6	6
0014	3T	08_2	216	3	0	300	0	-300	0.00	0.00	0	0	0
0014	3T	08_2	235	1	0	100	0	-100	0.00	0.00	0	0	0
0014	3T	08_2	236	1	0	100	0	-100	0.00	0.00	0	0	0
0014	3T	08_2	243	1	0	100	0	-100	0.00	0.00	0	0	0
0014	3T	08_2	246	1	0	100	0	-100	0.00	0.00	0	0	0
0014	3T	08_2	251	1	0	100	0	-100	0.00	0.00	0	0	0
0014	3T	08_2	256	3	0	300	0	-300	0.00	0.00	0	0	0
0014	3T	08_2	261	4	0	400	0	-400	0.00	0.00	0	0	0
0014	3T	08_2	263	1	0	100	0	-100	0.00	0.00	0	0	0
0014	3T	08_2	264	1	0	100	0	-100	0.00	0.00	0	0	0
0014	3T	08_2	265	1	0	100	0	-100	0.00	0.00	0	0	0
0014	3T	08_3	123	56	5	5600	4030	-1570	0.09	0.72	9	7	-2
0014	3T	08_3	124	51	7	5100	6570	1470	0.14	1.29	9	11	2
0014	3T	08_3	125	44	2	4400	1850	-2550	0.05	0.42	7	3	-4
0014	3T	08_3	126	22	1	2200	950	-1250	0.05	0.43	3	1	-2
0014	3T	08_3	132	36	4	3600	4850	1250	0.11	1.35	6	8	2
0014	3T	08_3	134	44	5	4400	7790	3390	0.11	1.77	7	13	6
0014	3T	08_3	135	23	2	2300	2140	-160	0.09	0.93	4	3	-1
0014	3T	08_3	136	10	0	1000	0	-1000	0.00	0.00	1	0	-1
0014	3T	08_3	142	13	0	1300	0	-1300	0.00	0.00	2	0	-2
0014	3T	08_3	143	14	1	1400	640	-760	0.07	0.46	2	1	-1
0014	3T	08_3	145	9	0	900	0	-900	0.00	0.00	1	0	-1
0014	3T	08_3	146	8	1	800	1070	270	0.13	1.34	1	1	0
0014	3T	08_3	152	6	0	600	0	-600	0.00	0.00	1	0	-1
0014	3T	08_3	153	14	0	1400	0	-1400	0.00	0.00	2	0	-2
0014	3T	08_3	154	10	1	1000	940	-60	0.10	0.94	1	1	0
0014	3T	08_3	156	3	0	300	0	-300	0.00	0.00	0	0	0
0014	3T	08_3	163	4	0	400	0	-400	0.00	0.00	0	0	0
0014	3T	08_3	165	1	0	100	0	-100	0.00	0.00	0	0	0
0014	3T	08_3	213	8	1	800	680	-120	0.13	0.85	1	1	0
0014	3T	08_3	214	9	2	900	1600	700	0.22	1.78	1	2	1
0014	3T	08_3	215	3	0	300	0	-300	0.00	0.00	0	0	0
0014	3T	08_3	216	3	0	300	0	-300	0.00	0.00	0	0	0
0014	3T	08_3	231	1	0	100	0	-100	0.00	0.00	0	0	0
0014	3T	08_3	235	3	0	300	0	-300	0.00	0.00	0	0	0
0014	3T	08_3	236	2	0	200	0	-200	0.00	0.00	0	0	0
0014	3T	08_3	243	2	0	200	0	-200	0.00	0.00	0	0	0
0014	3T	08_3	245	1	0	100	0	-100	0.00	0.00	0	0	0
0014	3T	08_3	246	2	0	200	0	-200	0.00	0.00	0	0	0
0014	3T	08_3	251	1	0	100	0	-100	0.00	0.00	0	0	0
0014	3T	08_3	253	1	0	100	0	-100	0.00	0.00	0	0	0
0014	3T	08_3	254	1	0	100	0	-100	0.00	0.00	0	0	0
0014	3T	08_3	256	1	0	100	0	-100	0.00	0.00	0	0	0
0014	3T	08_3	261	3	0	300	0	-300	0.00	0.00	0	0	0
0014	3T	08_3	263	1	0	100	0	-100	0.00	0.00	0	0	0
0014	3T	08_3	264	1	0	100	0	-100	0.00	0.00	0	0	0
0014	3T	08_3	265	3	0	300	0	-300	0.00	0.00	0	0	0
0014	3T	08_4	123	23	1	2300	500	-1800	0.04	0.22	4	0	-4
0014	3T	08_4	124	13	0	1300	0	-1300	0.00	0.00	2	0	-2
0014	3T	08_4	125	10	1	1000	990	-10	0.10	0.99	1	1	0
0014	3T	08_4	126	14	1	1400	2430	1030	0.07	1.74	2	4	2
0014	3T	08_4	132	9	0	900	0	-900	0.00	0.00	1	0	-1
0014	3T	08_4	134	11	1	1100	4290	3190	0.09	3.90	1	7	6
0014	3T	08_4	135	9	0	900	0	-900	0.00	0.00	1	0	-1
0014	3T	08_4	136	5	0	500	0	-500	0.00	0.00	0	0	0
0014	3T	08_4	142	3	0	300	0	-300	0.00	0.00	0	0	0
0014	3T	08_4	143	2	1	200	3400	3200	0.50	17.00	0	6	6
0014	3T	08_4	145	4	0	400	0	-400	0.00	0.00	0	0	0
0014	3T	08_4	146	2	0	200	0	-200	0.00	0.00	0	0	0
0014	3T	08_4	152	4	1	400	870	470	0.25	2.18	0	1	1
0014	3T	08_4	153	4	0	400	0	-400	0.00	0.00	0	0	0
0014	3T	08_4	162	1	0	100	0	-100	0.00	0.00	0	0	0
0014	3T	08_4	164	1	0	100	0	-100	0.00	0.00	0	0	0
0014	3T	08_4	165	2	0	200	0	-200	0.00	0.00	0	0	0
0014	3T	08_4	213	2	0	200	0	-200	0.00	0.00	0	0	0
0014	3T	08_4	214	2	0	200	0	-200	0.00	0.00	0	0	0
0014	3T	08_4	215	3	0	300	0	-300	0.00	0.00	0	0	0
0014	3T	08_4	216	2	0	200	0	-200	0.00	0.00	0	0	0
0014	3T	08_4	231	2	0	200	0	-200	0.00	0.00	0	0	0
0014	3T	08_4	236	1	0	100	0	-100	0.00	0.00	0	0	0
0014	3T	08_4	241	1	1	100	6930	6830	1.00	69.30	0	12	12
0014	3T	08_4	243	1	0	100	0	-100	0.00	0.00	0	0	0
0014	3T	08_4	251	1	0	100	0	-100	0.00	0.00	0	0	0
0014	3T	08_4	256	1	0	100	0	-100	0.00	0.00	0	0	0
0014	3T	08_4	261	1	0	100	0	-100	0.00	0.00	0	0	0
0014	3T	08_5	123	11	0	1100	0	-1100	0.00	0.00	1	0	-1
0014	3T	08_5	124	13	2	1300	6100	4800	0.15	4.69	2	10	8
0014	3T	08_5	125	12	2	1200	3760	2560	0.17	3.13	2	6	4
0014	3T	08_5	126	6	0	600	0	-600	0.00	0.00	1	0	-1
0014	3T	08_5	132	3	0	300	0	-300	0.00	0.00	0	0	0
0014	3T	08_5	134	9	1	900	570	-330	0.11	0.63	1	1	0
0014	3T	08_5	135	5	0	500	0	-500	0.00	0.00	0	0	0
0014	3T	08_5	136	4	0	400	0	-400	0.00	0.00	0	0	0
0014	3T	08_5	142	3	1	300	630	330	0.33	2.10	0	1	1
0014	3T	08_5	143	6	1	600	2290	1690	0.17	3.82	1	4	3
0014	3T	08_5	145	4	1	400	810	410	0.25	2.03	0	1	1
0014	3T	08_5	146	1	0	100	0	-100	0.00	0.00	0	0	0
0014	3T	08_5	152	8	0	800	0	-800	0.00	0.00	1	0	-1
0014	3T	08_5	153	1	0	100	0	-100	0.00	0.00	0	0	0
0014	3T	08_5	154	1	0	100	0	-100	0.00	0.00	0	0	0
0014	3T	08_5	156	1	0	100	0	-100	0.00	0.00	0	0	0
0014	3T	08_5	162	1	0	100	0	-100	0.00	0.00	0	0	0
0014	3T	08_5	164	4	0	400	0	-400	0.00	0.00	0	0	0
0014	3T	08_5	243	1	0	100	0	-100	0.00	0.00	0	0	0
0014	3T	08_5	265	1	0	100	0	-100	0.00	0.00	0	0	0
0014	3T	08_6	124	2	0	200	0	-200	0.00	0.00	0	0	0
0014	3T	08_6	125	1	0	100	0	-100	0.00	0.00	0	0	0
0014	3T	08_6	132	1	0	100	0	-100	0.00	0.00	0	0	0
0014	3T	08_6	134	2	1	200	710	510	0.50	3.55	0	1	1
0014	3T	08_6	135	1	1	100	2750	2650	1.00	27.50	0	4	4
0014	3T	08_6	143	1	0	100	0	-100	0.00	0.00	0	0	0
0014	3T	08_6	152	2	0	200	0	-200	0.00	0.00	0	0	0
0014	3T	08_6	153	1	0	100	0	-100	0.00	0.00	0	0	0
0014	3T	08_6	156	1	0	100	0	-100	0.00	0.00	0	0	0
0014	3T	08_6	213	1	0	100	0	-100	0.00	0.00	0	0	0
0014	3T	08_7	123	60	11	6000	8730	2730	0.18	1.46	10	15	5
0014	3T	08_7	124	54	5	5400	3610	-1790	0.09	0.67	9	6	-3
0014	3T	08_7	125	40	3	4000	5280	1280	0.08	1.32	7	9	2
0014	3T	08_7	126	33	0	3300	0	-3300	0.00	0.00	5	0	-5
0014	3T	08_7	132	37	3	3700	3310	-390	0.08	0.89	6	5	-1
0014	3T	08_7	134	24	2	2400	2320	-80	0.08	0.97	4	4	0
0014	3T	08_7	135	19	2	1900	3430	1530	0.11	1.81	3	6	3
0014	3T	08_7	136	14	1	1400	1020	-380	0.07	0.73	2	1	-1
0014	3T	08_7	142	17	0	1700	0	-1700	0.00	0.00	3	0	-3
0014	3T	08_7	143	16	1	1600	770	-830	0.06	0.48	2	1	-1
0014	3T	08_7	145	17	0	1700	0	-1700	0.00	0.00	3	0	-3
0014	3T	08_7	146	19	0	1900	0	-1900	0.00	0.00	3	0	-3
0014	3T	08_7	152	13	1	1300	6380	5080	0.08	4.91	2	11	9
0014	3T	08_7	153	9	0	900	0	-900	0.00	0.00	1	0	-1
0014	3T	08_7	154	6	0	600	0	-600	0.00	0.00	1	0	-1
0014	3T	08_7	156	3	0	300	0	-300	0.00	0.00	0	0	0
0014	3T	08_7	162	4	0	400	0	-400	0.00	0.00	0	0	0
0014	3T	08_7	163	5	0	500	0	-500	0.00	0.00	0	0	0
0014	3T	08_7	164	2	0	200	0	-200	0.00	0.00	0	0	0
0014	3T	08_7	165	3	0	300	0	-300	0.00	0.00	0	0	0
0014	3T	08_7	213	3	0	300	0	-300	0.00	0.00	0	0	0
0014	3T	08_7	214	2	0	200	0	-200	0.00	0.00	0	0	0
0014	3T	08_7	215	1	0	100	0	-100	0.00	0.00	0	0	0
0014	3T	08_7	216	2	0	200	0	-200	0.00	0.00	0	0	0
0014	3T	08_7	231	2	0	200	0	-200	0.00	0.00	0	0	0
0014	3T	08_7	234	1	0	100	0	-100	0.00	0.00	0	0	0
0014	3T	08_7	235	3	0	300	0	-300	0.00	0.00	0	0	0
0014	3T	08_7	236	1	0	100	0	-100	0.00	0.00	0	0	0
0014	3T	08_7	241	1	0	100	0	-100	0.00	0.00	0	0	0
0014	3T	08_7	243	2	0	200	0	-200	0.00	0.00	0	0	0
0014	3T	08_7	245	2	0	200	0	-200	0.00	0.00	0	0	0
0014	3T	08_7	251	3	0	300	0	-300	0.00	0.00	0	0	0
0014	3T	08_7	253	2	0	200	0	-200	0.00	0.00	0	0	0
0014	3T	08_7	256	1	0	100	0	-100	0.00	0.00	0	0	0
0014	3T	08_7	261	2	0	200	0	-200	0.00	0.00	0	0	0
0014	3T	08_7	263	2	0	200	0	-200	0.00	0.00	0	0	0
0014	3T	08_7	265	1	0	100	0	-100	0.00	0.00	0	0	0
0014	3T	09_1	123	45	10	4500	8840	4340	0.22	1.96	7	15	8
0014	3T	09_1	124	44	5	4400	4350	-50	0.11	0.99	7	7	0
0014	3T	09_1	125	37	1	3700	1300	-2400	0.03	0.35	6	2	-4
0014	3T	09_1	126	17	0	1700	0	-1700	0.00	0.00	3	0	-3
0014	3T	09_1	132	26	2	2600	1840	-760	0.08	0.71	4	3	-1
0014	3T	09_1	134	31	4	3100	3520	420	0.13	1.14	5	6	1
0014	3T	09_1	135	21	1	2100	610	-1490	0.05	0.29	3	1	-2
0014	3T	09_1	136	9	0	900	0	-900	0.00	0.00	1	0	-1
0014	3T	09_1	142	9	0	900	0	-900	0.00	0.00	1	0	-1
0014	3T	09_1	143	12	1	1200	1580	380	0.08	1.32	2	2	0
0014	3T	09_1	145	10	0	1000	0	-1000	0.00	0.00	1	0	-1
0014	3T	09_1	146	10	1	1000	2710	1710	0.10	2.71	1	4	3
0014	3T	09_1	152	4	0	400	0	-400	0.00	0.00	0	0	0
0014	3T	09_1	153	11	0	1100	0	-1100	0.00	0.00	1	0	-1
0014	3T	09_1	154	2	0	200	0	-200	0.00	0.00	0	0	0
0014	3T	09_1	156	4	0	400	0	-400	0.00	0.00	0	0	0
0014	3T	09_1	162	3	0	300	0	-300	0.00	0.00	0	0	0
0014	3T	09_1	163	1	0	100	0	-100	0.00	0.00	0	0	0
0014	3T	09_1	164	5	0	500	0	-500	0.00	0.00	0	0	0
0014	3T	09_1	165	2	0	200	0	-200	0.00	0.00	0	0	0
0014	3T	09_1	213	4	1	400	590	190	0.25	1.48	0	1	1
0014	3T	09_1	214	3	0	300	0	-300	0.00	0.00	0	0	0
0014	3T	09_1	215	4	0	400	0	-400	0.00	0.00	0	0	0
0014	3T	09_1	216	5	0	500	0	-500	0.00	0.00	0	0	0
0014	3T	09_1	231	3	0	300	0	-300	0.00	0.00	0	0	0
0014	3T	09_1	234	5	0	500	0	-500	0.00	0.00	0	0	0
0014	3T	09_1	235	5	2	500	2560	2060	0.40	5.12	0	4	4
0014	3T	09_1	236	4	0	400	0	-400	0.00	0.00	0	0	0
0014	3T	09_1	243	2	0	200	0	-200	0.00	0.00	0	0	0
0014	3T	09_1	245	2	0	200	0	-200	0.00	0.00	0	0	0
0014	3T	09_1	246	1	0	100	0	-100	0.00	0.00	0	0	0
0014	3T	09_1	251	1	0	100	0	-100	0.00	0.00	0	0	0
0014	3T	09_1	253	4	0	400	0	-400	0.00	0.00	0	0	0
0014	3T	09_1	254	2	0	200	0	-200	0.00	0.00	0	0	0
0014	3T	09_1	256	1	0	100	0	-100	0.00	0.00	0	0	0
0014	3T	09_1	261	1	1	100	6100	6000	1.00	61.00	0	10	10
0014	3T	09_1	264	1	0	100	0	-100	0.00	0.00	0	0	0
0014	3T	09_2	123	58	9	5800	5070	-730	0.16	0.87	10	8	-2
0014	3T	09_2	124	33	4	3300	4770	1470	0.12	1.45	5	8	3
0014	3T	09_2	125	27	2	2700	4070	1370	0.07	1.51	4	7	3
0014	3T	09_2	126	22	0	2200	0	-2200	0.00	0.00	3	0	-3
0014	3T	09_2	132	25	3	2500	4460	1960	0.12	1.78	4	7	3
0014	3T	09_2	134	29	1	2900	310	-2590	0.03	0.11	5	0	-5
0014	3T	09_2	135	16	1	1600	1670	70	0.06	1.04	2	2	0
0014	3T	09_2	136	15	2	1500	1490	-10	0.13	0.99	2	2	0
0014	3T	09_2	142	16	0	1600	0	-1600	0.00	0.00	2	0	-2
0014	3T	09_2	143	12	1	1200	1190	-10	0.08	0.99	2	2	0
0014	3T	09_2	145	14	0	1400	0	-1400	0.00	0.00	2	0	-2
0014	3T	09_2	146	7	1	700	1330	630	0.14	1.90	1	2	1
0014	3T	09_2	152	10	0	1000	0	-1000	0.00	0.00	1	0	-1
0014	3T	09_2	153	8	0	800	0	-800	0.00	0.00	1	0	-1
0014	3T	09_2	154	3	0	300	0	-300	0.00	0.00	0	0	0
0014	3T	09_2	156	5	0	500	0	-500	0.00	0.00	0	0	0
0014	3T	09_2	162	2	0	200	0	-200	0.00	0.00	0	0	0
0014	3T	09_2	163	5	0	500	0	-500	0.00	0.00	0	0	0
0014	3T	09_2	164	3	0	300	0	-300	0.00	0.00	0	0	0
0014	3T	09_2	165	2	0	200	0	-200	0.00	0.00	0	0	0
0014	3T	09_2	213	5	1	500	1990	1490	0.20	3.98	0	3	3
0014	3T	09_2	214	3	1	300	1200	900	0.33	4.00	0	2	2
0014	3T	09_2	215	5	0	500	0	-500	0.00	0.00	0	0	0
0014	3T	09_2	216	2	0	200	0	-200	0.00	0.00	0	0	0
0014	3T	09_2	231	2	0	200	0	-200	0.00	0.00	0	0	0
0014	3T	09_2	234	2	0	200	0	-200	0.00	0.00	0	0	0
0014	3T	09_2	235	3	0	300	0	-300	0.00	0.00	0	0	0
0014	3T	09_2	236	1	0	100	0	-100	0.00	0.00	0	0	0
0014	3T	09_2	243	2	0	200	0	-200	0.00	0.00	0	0	0
0014	3T	09_2	245	1	0	100	0	-100	0.00	0.00	0	0	0
0014	3T	09_2	246	2	0	200	0	-200	0.00	0.00	0	0	0
0014	3T	09_2	253	1	0	100	0	-100	0.00	0.00	0	0	0
0014	3T	09_2	261	1	0	100	0	-100	0.00	0.00	0	0	0
0014	3T	09_2	263	1	0	100	0	-100	0.00	0.00	0	0	0
0014	3T	09_2	264	2	1	200	2820	2620	0.50	14.10	0	4	4
0014	3T	09_3	123	49	5	4900	3360	-1540	0.10	0.69	8	5	-3
0014	3T	09_3	124	41	0	4100	0	-4100	0.00	0.00	7	0	-7
0014	3T	09_3	125	26	0	2600	0	-2600	0.00	0.00	4	0	-4
0014	3T	09_3	126	19	1	1900	560	-1340	0.05	0.29	3	0	-3
0014	3T	09_3	132	30	1	3000	3870	870	0.03	1.29	5	6	1
0014	3T	09_3	134	26	1	2600	690	-1910	0.04	0.27	4	1	-3
0014	3T	09_3	135	22	0	2200	0	-2200	0.00	0.00	3	0	-3
0014	3T	09_3	136	10	0	1000	0	-1000	0.00	0.00	1	0	-1
0014	3T	09_3	142	10	2	1000	3230	2230	0.20	3.23	1	5	4
0014	3T	09_3	143	18	0	1800	0	-1800	0.00	0.00	3	0	-3
0014	3T	09_3	145	7	0	700	0	-700	0.00	0.00	1	0	-1
0014	3T	09_3	146	5	1	500	1480	980	0.20	2.96	0	2	2
0014	3T	09_3	152	9	0	900	0	-900	0.00	0.00	1	0	-1
0014	3T	09_3	153	10	1	1000	2080	1080	0.10	2.08	1	3	2
0014	3T	09_3	154	6	0	600	0	-600	0.00	0.00	1	0	-1
0014	3T	09_3	156	7	1	700	2890	2190	0.14	4.13	1	5	4
0014	3T	09_3	162	3	0	300	0	-300	0.00	0.00	0	0	0
0014	3T	09_3	163	6	0	600	0	-600	0.00	0.00	1	0	-1
0014	3T	09_3	164	2	0	200	0	-200	0.00	0.00	0	0	0
0014	3T	09_3	165	2	0	200	0	-200	0.00	0.00	0	0	0
0014	3T	09_3	213	6	0	600	0	-600	0.00	0.00	1	0	-1
0014	3T	09_3	214	7	0	700	0	-700	0.00	0.00	1	0	-1
0014	3T	09_3	215	5	0	500	0	-500	0.00	0.00	0	0	0
0014	3T	09_3	216	4	0	400	0	-400	0.00	0.00	0	0	0
0014	3T	09_3	234	2	0	200	0	-200	0.00	0.00	0	0	0
0014	3T	09_3	235	2	0	200	0	-200	0.00	0.00	0	0	0
0014	3T	09_3	236	1	0	100	0	-100	0.00	0.00	0	0	0
0014	3T	09_3	241	2	0	200	0	-200	0.00	0.00	0	0	0
0014	3T	09_3	245	1	0	100	0	-100	0.00	0.00	0	0	0
0014	3T	09_3	246	2	1	200	1270	1070	0.50	6.35	0	2	2
0014	3T	09_3	251	3	0	300	0	-300	0.00	0.00	0	0	0
0014	3T	09_3	253	4	0	400	0	-400	0.00	0.00	0	0	0
0014	3T	09_3	254	1	0	100	0	-100	0.00	0.00	0	0	0
0014	3T	09_3	256	1	0	100	0	-100	0.00	0.00	0	0	0
0014	3T	09_3	263	2	0	200	0	-200	0.00	0.00	0	0	0
0014	3T	09_4	123	33	4	3300	2990	-310	0.12	0.91	5	5	0
0014	3T	09_4	124	35	4	3500	3030	-470	0.11	0.87	6	5	-1
0014	3T	09_4	125	22	1	2200	1160	-1040	0.05	0.53	3	2	-1
0014	3T	09_4	126	22	1	2200	5720	3520	0.05	2.60	3	10	7
0014	3T	09_4	132	22	1	2200	1010	-1190	0.05	0.46	3	1	-2
0014	3T	09_4	134	24	0	2400	0	-2400	0.00	0.00	4	0	-4
0014	3T	09_4	135	21	1	2100	730	-1370	0.05	0.35	3	1	-2
0014	3T	09_4	136	18	0	1800	0	-1800	0.00	0.00	3	0	-3
0014	3T	09_4	142	12	1	1200	750	-450	0.08	0.63	2	1	-1
0014	3T	09_4	143	19	1	1900	1960	60	0.05	1.03	3	3	0
0014	3T	09_4	145	9	1	900	1260	360	0.11	1.40	1	2	1
0014	3T	09_4	146	3	0	300	0	-300	0.00	0.00	0	0	0
0014	3T	09_4	152	4	0	400	0	-400	0.00	0.00	0	0	0
0014	3T	09_4	153	6	0	600	0	-600	0.00	0.00	1	0	-1
0014	3T	09_4	154	6	0	600	0	-600	0.00	0.00	1	0	-1
0014	3T	09_4	156	2	0	200	0	-200	0.00	0.00	0	0	0
0014	3T	09_4	162	3	0	300	0	-300	0.00	0.00	0	0	0
0014	3T	09_4	163	3	0	300	0	-300	0.00	0.00	0	0	0
0014	3T	09_4	164	3	0	300	0	-300	0.00	0.00	0	0	0
0014	3T	09_4	213	6	0	600	0	-600	0.00	0.00	1	0	-1
0014	3T	09_4	214	6	1	600	1150	550	0.17	1.92	1	2	1
0014	3T	09_4	215	4	0	400	0	-400	0.00	0.00	0	0	0
0014	3T	09_4	216	7	0	700	0	-700	0.00	0.00	1	0	-1
0014	3T	09_4	231	3	0	300	0	-300	0.00	0.00	0	0	0
0014	3T	09_4	234	4	0	400	0	-400	0.00	0.00	0	0	0
0014	3T	09_4	235	1	0	100	0	-100	0.00	0.00	0	0	0
0014	3T	09_4	236	3	0	300	0	-300	0.00	0.00	0	0	0
0014	3T	09_4	243	1	0	100	0	-100	0.00	0.00	0	0	0
0014	3T	09_4	245	2	0	200	0	-200	0.00	0.00	0	0	0
0014	3T	09_4	246	1	0	100	0	-100	0.00	0.00	0	0	0
0014	3T	09_4	253	3	0	300	0	-300	0.00	0.00	0	0	0
0014	3T	09_4	254	1	0	100	0	-100	0.00	0.00	0	0	0
0014	3T	09_4	256	2	0	200	0	-200	0.00	0.00	0	0	0
0014	3T	09_4	261	2	0	200	0	-200	0.00	0.00	0	0	0
0014	3T	09_4	263	2	0	200	0	-200	0.00	0.00	0	0	0
0014	3T	09_4	264	1	0	100	0	-100	0.00	0.00	0	0	0
0014	3T	09_4	265	1	0	100	0	-100	0.00	0.00	0	0	0
0014	3T	09_5	123	49	5	4900	2410	-2490	0.10	0.49	8	4	-4
0014	3T	09_5	124	48	8	4800	8940	4140	0.17	1.86	8	15	7
0014	3T	09_5	125	22	0	2200	0	-2200	0.00	0.00	3	0	-3
0014	3T	09_5	126	19	2	1900	1850	-50	0.11	0.97	3	3	0
0014	3T	09_5	132	29	2	2900	3520	620	0.07	1.21	5	6	1
0014	3T	09_5	134	30	1	3000	1360	-1640	0.03	0.45	5	2	-3
0014	3T	09_5	135	17	1	1700	2210	510	0.06	1.30	3	3	0
0014	3T	09_5	136	7	0	700	0	-700	0.00	0.00	1	0	-1
0014	3T	09_5	142	10	0	1000	0	-1000	0.00	0.00	1	0	-1
0014	3T	09_5	143	9	0	900	0	-900	0.00	0.00	1	0	-1
0014	3T	09_5	145	11	0	1100	0	-1100	0.00	0.00	1	0	-1
0014	3T	09_5	146	5	0	500	0	-500	0.00	0.00	0	0	0
0014	3T	09_5	152	6	0	600	0	-600	0.00	0.00	1	0	-1
0014	3T	09_5	153	11	0	1100	0	-1100	0.00	0.00	1	0	-1
0014	3T	09_5	154	4	0	400	0	-400	0.00	0.00	0	0	0
0014	3T	09_5	156	1	0	100	0	-100	0.00	0.00	0	0	0
0014	3T	09_5	162	3	0	300	0	-300	0.00	0.00	0	0	0
0014	3T	09_5	163	4	0	400	0	-400	0.00	0.00	0	0	0
0014	3T	09_5	164	4	0	400	0	-400	0.00	0.00	0	0	0
0014	3T	09_5	165	3	0	300	0	-300	0.00	0.00	0	0	0
0014	3T	09_5	213	7	0	700	0	-700	0.00	0.00	1	0	-1
0014	3T	09_5	214	5	0	500	0	-500	0.00	0.00	0	0	0
0014	3T	09_5	215	1	0	100	0	-100	0.00	0.00	0	0	0
0014	3T	09_5	216	3	0	300	0	-300	0.00	0.00	0	0	0
0014	3T	09_5	231	1	0	100	0	-100	0.00	0.00	0	0	0
0014	3T	09_5	234	2	0	200	0	-200	0.00	0.00	0	0	0
0014	3T	09_5	236	2	0	200	0	-200	0.00	0.00	0	0	0
0014	3T	09_5	241	1	0	100	0	-100	0.00	0.00	0	0	0
0014	3T	09_5	243	1	0	100	0	-100	0.00	0.00	0	0	0
0014	3T	09_5	245	2	0	200	0	-200	0.00	0.00	0	0	0
0014	3T	09_5	253	1	0	100	0	-100	0.00	0.00	0	0	0
0014	3T	09_5	256	1	0	100	0	-100	0.00	0.00	0	0	0
0014	3T	09_5	264	1	0	100	0	-100	0.00	0.00	0	0	0
0014	3T	09_7	123	65	8	6500	5160	-1340	0.12	0.79	11	9	-2
0014	3T	09_7	124	51	9	5100	7760	2660	0.18	1.52	9	13	4
0014	3T	09_7	125	37	2	3700	1940	-1760	0.05	0.52	6	3	-3
0014	3T	09_7	126	30	0	3000	0	-3000	0.00	0.00	5	0	-5
0014	3T	09_7	132	32	3	3200	2730	-470	0.09	0.85	5	4	-1
0014	3T	09_7	134	26	5	2600	5250	2650	0.19	2.02	4	9	5
0014	3T	09_7	135	26	2	2600	1230	-1370	0.08	0.47	4	2	-2
0014	3T	09_7	136	10	1	1000	1180	180	0.10	1.18	1	2	1
0014	3T	09_7	142	12	0	1200	0	-1200	0.00	0.00	2	0	-2
0014	3T	09_7	143	20	2	2000	3180	1180	0.10	1.59	3	5	2
0014	3T	09_7	145	12	1	1200	1220	20	0.08	1.02	2	2	0
0014	3T	09_7	146	9	1	900	830	-70	0.11	0.92	1	1	0
0014	3T	09_7	152	9	0	900	0	-900	0.00	0.00	1	0	-1
0014	3T	09_7	153	12	1	1200	2970	1770	0.08	2.48	2	5	3
0014	3T	09_7	154	8	2	800	3520	2720	0.25	4.40	1	6	5
0014	3T	09_7	156	4	0	400	0	-400	0.00	0.00	0	0	0
0014	3T	09_7	162	7	0	700	0	-700	0.00	0.00	1	0	-1
0014	3T	09_7	163	2	0	200	0	-200	0.00	0.00	0	0	0
0014	3T	09_7	164	1	0	100	0	-100	0.00	0.00	0	0	0
0014	3T	09_7	165	1	0	100	0	-100	0.00	0.00	0	0	0
0014	3T	09_7	213	9	0	900	0	-900	0.00	0.00	1	0	-1
0014	3T	09_7	214	3	0	300	0	-300	0.00	0.00	0	0	0
0014	3T	09_7	215	1	0	100	0	-100	0.00	0.00	0	0	0
0014	3T	09_7	216	2	0	200	0	-200	0.00	0.00	0	0	0
0014	3T	09_7	231	2	0	200	0	-200	0.00	0.00	0	0	0
0014	3T	09_7	234	1	0	100	0	-100	0.00	0.00	0	0	0
0014	3T	09_7	246	2	0	200	0	-200	0.00	0.00	0	0	0
0014	3T	09_7	263	1	0	100	0	-100	0.00	0.00	0	0	0
0014	3T	10_1	123	54	4	5400	2520	-2880	0.07	0.47	9	4	-5
0014	3T	10_1	124	39	2	3900	1870	-2030	0.05	0.48	6	3	-3
0014	3T	10_1	125	29	1	2900	1830	-1070	0.03	0.63	5	3	-2
0014	3T	10_1	126	21	0	2100	0	-2100	0.00	0.00	3	0	-3
0014	3T	10_1	132	35	1	3500	680	-2820	0.03	0.19	6	1	-5
0014	3T	10_1	134	27	1	2700	1060	-1640	0.04	0.39	4	1	-3
0014	3T	10_1	135	15	1	1500	480	-1020	0.07	0.32	2	0	-2
0014	3T	10_1	136	12	1	1200	2390	1190	0.08	1.99	2	4	2
0014	3T	10_1	142	21	0	2100	0	-2100	0.00	0.00	3	0	-3
0014	3T	10_1	143	19	0	1900	0	-1900	0.00	0.00	3	0	-3
0014	3T	10_1	145	12	2	1200	8110	6910	0.17	6.76	2	14	12
0014	3T	10_1	146	11	0	1100	0	-1100	0.00	0.00	1	0	-1
0014	3T	10_1	152	5	0	500	0	-500	0.00	0.00	0	0	0
0014	3T	10_1	153	2	0	200	0	-200	0.00	0.00	0	0	0
0014	3T	10_1	154	2	0	200	0	-200	0.00	0.00	0	0	0
0014	3T	10_1	156	2	0	200	0	-200	0.00	0.00	0	0	0
0014	3T	10_1	162	4	0	400	0	-400	0.00	0.00	0	0	0
0014	3T	10_1	163	1	0	100	0	-100	0.00	0.00	0	0	0
0014	3T	10_1	164	2	0	200	0	-200	0.00	0.00	0	0	0
0014	3T	10_1	213	8	0	800	0	-800	0.00	0.00	1	0	-1
0014	3T	10_1	214	5	0	500	0	-500	0.00	0.00	0	0	0
0014	3T	10_1	215	8	0	800	0	-800	0.00	0.00	1	0	-1
0014	3T	10_1	216	7	0	700	0	-700	0.00	0.00	1	0	-1
0014	3T	10_1	231	1	0	100	0	-100	0.00	0.00	0	0	0
0014	3T	10_1	235	5	0	500	0	-500	0.00	0.00	0	0	0
0014	3T	10_1	243	2	0	200	0	-200	0.00	0.00	0	0	0
0014	3T	10_1	245	5	0	500	0	-500	0.00	0.00	0	0	0
0014	3T	10_1	246	2	0	200	0	-200	0.00	0.00	0	0	0
0014	3T	10_1	265	1	0	100	0	-100	0.00	0.00	0	0	0
0014	3T	10_2	123	53	6	5300	6170	870	0.11	1.16	9	10	1
0014	3T	10_2	124	35	1	3500	1190	-2310	0.03	0.34	6	2	-4
0014	3T	10_2	125	22	0	2200	0	-2200	0.00	0.00	3	0	-3
0014	3T	10_2	126	18	0	1800	0	-1800	0.00	0.00	3	0	-3
0014	3T	10_2	132	29	1	2900	1180	-1720	0.03	0.41	5	2	-3
0014	3T	10_2	134	28	1	2800	830	-1970	0.04	0.30	4	1	-3
0014	3T	10_2	135	20	0	2000	0	-2000	0.00	0.00	3	0	-3
0014	3T	10_2	136	15	0	1500	0	-1500	0.00	0.00	2	0	-2
0014	3T	10_2	142	22	4	2200	5970	3770	0.18	2.71	3	10	7
0014	3T	10_2	143	14	0	1400	0	-1400	0.00	0.00	2	0	-2
0014	3T	10_2	145	10	0	1000	0	-1000	0.00	0.00	1	0	-1
0014	3T	10_2	146	9	1	900	6100	5200	0.11	6.78	1	10	9
0014	3T	10_2	152	5	0	500	0	-500	0.00	0.00	0	0	0
0014	3T	10_2	153	6	0	600	0	-600	0.00	0.00	1	0	-1
0014	3T	10_2	154	2	0	200	0	-200	0.00	0.00	0	0	0
0014	3T	10_2	156	4	0	400	0	-400	0.00	0.00	0	0	0
0014	3T	10_2	162	4	0	400	0	-400	0.00	0.00	0	0	0
0014	3T	10_2	163	3	0	300	0	-300	0.00	0.00	0	0	0
0014	3T	10_2	165	2	0	200	0	-200	0.00	0.00	0	0	0
0014	3T	10_2	213	10	2	1000	1810	810	0.20	1.81	1	3	2
0014	3T	10_2	214	4	0	400	0	-400	0.00	0.00	0	0	0
0014	3T	10_2	215	4	0	400	0	-400	0.00	0.00	0	0	0
0014	3T	10_2	216	3	0	300	0	-300	0.00	0.00	0	0	0
0014	3T	10_2	231	1	0	100	0	-100	0.00	0.00	0	0	0
0014	3T	10_2	234	4	0	400	0	-400	0.00	0.00	0	0	0
0014	3T	10_2	235	2	0	200	0	-200	0.00	0.00	0	0	0
0014	3T	10_2	236	5	0	500	0	-500	0.00	0.00	0	0	0
0014	3T	10_2	243	3	0	300	0	-300	0.00	0.00	0	0	0
0014	3T	10_2	245	1	0	100	0	-100	0.00	0.00	0	0	0
0014	3T	10_2	246	1	0	100	0	-100	0.00	0.00	0	0	0
0014	3T	10_2	251	1	0	100	0	-100	0.00	0.00	0	0	0
0014	3T	10_2	253	1	0	100	0	-100	0.00	0.00	0	0	0
0014	3T	10_2	256	1	0	100	0	-100	0.00	0.00	0	0	0
0014	3T	10_2	261	2	1	200	3720	3520	0.50	18.60	0	6	6
0014	3T	10_2	263	2	0	200	0	-200	0.00	0.00	0	0	0
0014	3T	10_2	264	1	0	100	0	-100	0.00	0.00	0	0	0
0014	3T	10_3	123	57	1	5700	620	-5080	0.02	0.11	10	1	-9
0014	3T	10_3	124	43	6	4300	3340	-960	0.14	0.78	7	5	-2
0014	3T	10_3	125	36	2	3600	4610	1010	0.06	1.28	6	8	2
0014	3T	10_3	126	14	2	1400	4520	3120	0.14	3.23	2	8	6
0014	3T	10_3	132	26	2	2600	3430	830	0.08	1.32	4	6	2
0014	3T	10_3	134	36	2	3600	1260	-2340	0.06	0.35	6	2	-4
0014	3T	10_3	135	14	1	1400	1310	-90	0.07	0.94	2	2	0
0014	3T	10_3	136	6	0	600	0	-600	0.00	0.00	1	0	-1
0014	3T	10_3	142	14	0	1400	0	-1400	0.00	0.00	2	0	-2
0014	3T	10_3	143	19	0	1900	0	-1900	0.00	0.00	3	0	-3
0014	3T	10_3	145	10	0	1000	0	-1000	0.00	0.00	1	0	-1
0014	3T	10_3	146	8	0	800	0	-800	0.00	0.00	1	0	-1
0014	3T	10_3	152	3	0	300	0	-300	0.00	0.00	0	0	0
0014	3T	10_3	153	9	1	900	1650	750	0.11	1.83	1	2	1
0014	3T	10_3	154	3	0	300	0	-300	0.00	0.00	0	0	0
0014	3T	10_3	156	5	0	500	0	-500	0.00	0.00	0	0	0
0014	3T	10_3	163	3	0	300	0	-300	0.00	0.00	0	0	0
0014	3T	10_3	213	8	0	800	0	-800	0.00	0.00	1	0	-1
0014	3T	10_3	214	7	0	700	0	-700	0.00	0.00	1	0	-1
0014	3T	10_3	215	7	0	700	0	-700	0.00	0.00	1	0	-1
0014	3T	10_3	216	8	0	800	0	-800	0.00	0.00	1	0	-1
0014	3T	10_3	231	2	0	200	0	-200	0.00	0.00	0	0	0
0014	3T	10_3	234	7	0	700	0	-700	0.00	0.00	1	0	-1
0014	3T	10_3	235	2	0	200	0	-200	0.00	0.00	0	0	0
0014	3T	10_3	236	1	0	100	0	-100	0.00	0.00	0	0	0
0014	3T	10_3	241	1	0	100	0	-100	0.00	0.00	0	0	0
0014	3T	10_3	243	1	0	100	0	-100	0.00	0.00	0	0	0
0014	3T	10_3	245	2	0	200	0	-200	0.00	0.00	0	0	0
0014	3T	10_3	246	2	0	200	0	-200	0.00	0.00	0	0	0
0014	3T	10_3	254	2	0	200	0	-200	0.00	0.00	0	0	0
0014	3T	10_3	263	1	0	100	0	-100	0.00	0.00	0	0	0
0014	3T	10_4	123	67	5	6700	2460	-4240	0.07	0.37	11	4	-7
0014	3T	10_4	124	48	3	4800	2450	-2350	0.06	0.51	8	4	-4
0014	3T	10_4	125	23	0	2300	0	-2300	0.00	0.00	4	0	-4
0014	3T	10_4	126	19	1	1900	2440	540	0.05	1.28	3	4	1
0014	3T	10_4	132	29	1	2900	1680	-1220	0.03	0.58	5	2	-3
0014	3T	10_4	134	26	1	2600	890	-1710	0.04	0.34	4	1	-3
0014	3T	10_4	135	16	0	1600	0	-1600	0.00	0.00	2	0	-2
0014	3T	10_4	136	9	0	900	0	-900	0.00	0.00	1	0	-1
0014	3T	10_4	142	16	0	1600	0	-1600	0.00	0.00	2	0	-2
0014	3T	10_4	143	14	0	1400	0	-1400	0.00	0.00	2	0	-2
0014	3T	10_4	145	13	0	1300	0	-1300	0.00	0.00	2	0	-2
0014	3T	10_4	146	6	1	600	2950	2350	0.17	4.92	1	5	4
0014	3T	10_4	152	8	0	800	0	-800	0.00	0.00	1	0	-1
0014	3T	10_4	153	8	0	800	0	-800	0.00	0.00	1	0	-1
0014	3T	10_4	154	3	0	300	0	-300	0.00	0.00	0	0	0
0014	3T	10_4	156	2	0	200	0	-200	0.00	0.00	0	0	0
0014	3T	10_4	162	1	0	100	0	-100	0.00	0.00	0	0	0
0014	3T	10_4	164	1	0	100	0	-100	0.00	0.00	0	0	0
0014	3T	10_4	213	4	0	400	0	-400	0.00	0.00	0	0	0
0014	3T	10_4	214	6	0	600	0	-600	0.00	0.00	1	0	-1
0014	3T	10_4	215	6	0	600	0	-600	0.00	0.00	1	0	-1
0014	3T	10_4	216	4	0	400	0	-400	0.00	0.00	0	0	0
0014	3T	10_4	231	3	0	300	0	-300	0.00	0.00	0	0	0
0014	3T	10_4	234	1	0	100	0	-100	0.00	0.00	0	0	0
0014	3T	10_4	235	2	0	200	0	-200	0.00	0.00	0	0	0
0014	3T	10_4	236	1	0	100	0	-100	0.00	0.00	0	0	0
0014	3T	10_4	241	1	0	100	0	-100	0.00	0.00	0	0	0
0014	3T	10_4	243	3	0	300	0	-300	0.00	0.00	0	0	0
0014	3T	10_4	245	3	0	300	0	-300	0.00	0.00	0	0	0
0014	3T	10_4	246	1	0	100	0	-100	0.00	0.00	0	0	0
0014	3T	10_4	253	2	0	200	0	-200	0.00	0.00	0	0	0
0014	3T	10_5	123	37	3	3700	1440	-2260	0.08	0.39	6	2	-4
0014	3T	10_5	124	34	0	3400	0	-3400	0.00	0.00	6	0	-6
0014	3T	10_5	125	18	1	1800	2770	970	0.06	1.54	3	4	1
0014	3T	10_5	126	8	0	800	0	-800	0.00	0.00	1	0	-1
0014	3T	10_5	132	28	2	2800	1990	-810	0.07	0.71	4	3	-1
0014	3T	10_5	134	17	1	1700	670	-1030	0.06	0.39	3	1	-2
0014	3T	10_5	135	9	0	900	0	-900	0.00	0.00	1	0	-1
0014	3T	10_5	136	8	0	800	0	-800	0.00	0.00	1	0	-1
0014	3T	10_5	142	16	1	1600	1730	130	0.06	1.08	2	3	1
0014	3T	10_5	143	22	1	2200	850	-1350	0.05	0.39	3	1	-2
0014	3T	10_5	145	6	0	600	0	-600	0.00	0.00	1	0	-1
0014	3T	10_5	146	2	0	200	0	-200	0.00	0.00	0	0	0
0014	3T	10_5	152	2	1	200	1780	1580	0.50	8.90	0	3	3
0014	3T	10_5	153	1	0	100	0	-100	0.00	0.00	0	0	0
0014	3T	10_5	154	2	0	200	0	-200	0.00	0.00	0	0	0
0014	3T	10_5	156	1	0	100	0	-100	0.00	0.00	0	0	0
0014	3T	10_5	163	2	0	200	0	-200	0.00	0.00	0	0	0
0014	3T	10_5	164	1	0	100	0	-100	0.00	0.00	0	0	0
0014	3T	10_5	213	4	0	400	0	-400	0.00	0.00	0	0	0
0014	3T	10_5	214	4	0	400	0	-400	0.00	0.00	0	0	0
0014	3T	10_5	215	4	0	400	0	-400	0.00	0.00	0	0	0
0014	3T	10_5	216	2	0	200	0	-200	0.00	0.00	0	0	0
0014	3T	10_5	231	1	0	100	0	-100	0.00	0.00	0	0	0
0014	3T	10_5	234	1	0	100	0	-100	0.00	0.00	0	0	0
0014	3T	10_5	235	1	0	100	0	-100	0.00	0.00	0	0	0
0014	3T	10_5	241	1	0	100	0	-100	0.00	0.00	0	0	0
0014	3T	10_5	243	1	0	100	0	-100	0.00	0.00	0	0	0
0014	3T	10_5	245	2	0	200	0	-200	0.00	0.00	0	0	0
0014	3T	10_5	256	1	0	100	0	-100	0.00	0.00	0	0	0
0014	3T	10_5	263	1	0	100	0	-100	0.00	0.00	0	0	0
0014	3T	10_6	123	2	0	200	0	-200	0.00	0.00	0	0	0
0014	3T	10_6	132	1	0	100	0	-100	0.00	0.00	0	0	0
0014	3T	10_6	136	1	0	100	0	-100	0.00	0.00	0	0	0
0014	3T	10_6	142	1	0	100	0	-100	0.00	0.00	0	0	0
0014	3T	10_6	143	1	0	100	0	-100	0.00	0.00	0	0	0
0014	3T	10_6	215	1	0	100	0	-100	0.00	0.00	0	0	0
0014	3T	10_7	123	87	5	8700	3330	-5370	0.06	0.38	15	5	-10
0014	3T	10_7	124	46	8	4600	11540	6940	0.17	2.51	8	20	12
0014	3T	10_7	125	35	1	3500	1190	-2310	0.03	0.34	6	2	-4
0014	3T	10_7	126	14	0	1400	0	-1400	0.00	0.00	2	0	-2
0014	3T	10_7	132	38	3	3800	2340	-1460	0.08	0.62	6	4	-2
0014	3T	10_7	134	31	1	3100	1940	-1160	0.03	0.63	5	3	-2
0014	3T	10_7	135	8	0	800	0	-800	0.00	0.00	1	0	-1
0014	3T	10_7	136	5	0	500	0	-500	0.00	0.00	0	0	0
0014	3T	10_7	142	23	1	2300	1190	-1110	0.04	0.52	4	2	-2
0014	3T	10_7	143	25	1	2500	1020	-1480	0.04	0.41	4	1	-3
0014	3T	10_7	145	4	1	400	2530	2130	0.25	6.33	0	4	4
0014	3T	10_7	146	7	1	700	1590	890	0.14	2.27	1	2	1
0014	3T	10_7	152	6	0	600	0	-600	0.00	0.00	1	0	-1
0014	3T	10_7	153	3	0	300	0	-300	0.00	0.00	0	0	0
0014	3T	10_7	154	3	0	300	0	-300	0.00	0.00	0	0	0
0014	3T	10_7	156	1	0	100	0	-100	0.00	0.00	0	0	0
0014	3T	10_7	162	1	0	100	0	-100	0.00	0.00	0	0	0
0014	3T	10_7	163	1	0	100	0	-100	0.00	0.00	0	0	0
0014	3T	10_7	213	14	0	1400	0	-1400	0.00	0.00	2	0	-2
0014	3T	10_7	214	6	0	600	0	-600	0.00	0.00	1	0	-1
0014	3T	10_7	215	4	0	400	0	-400	0.00	0.00	0	0	0
0014	3T	10_7	216	2	0	200	0	-200	0.00	0.00	0	0	0
0014	3T	10_7	231	2	0	200	0	-200	0.00	0.00	0	0	0
0014	3T	10_7	236	1	0	100	0	-100	0.00	0.00	0	0	0
0014	3T	10_7	243	1	0	100	0	-100	0.00	0.00	0	0	0
0014	3T	10_7	246	3	0	300	0	-300	0.00	0.00	0	0	0
0014	3T	10_7	254	1	0	100	0	-100	0.00	0.00	0	0	0
0014	3T	11_1	123	50	5	5000	5120	120	0.10	1.02	8	9	1
0014	3T	11_1	124	32	0	3200	0	-3200	0.00	0.00	5	0	-5
0014	3T	11_1	125	25	1	2500	1420	-1080	0.04	0.57	4	2	-2
0014	3T	11_1	126	25	0	2500	0	-2500	0.00	0.00	4	0	-4
0014	3T	11_1	132	20	1	2000	1870	-130	0.05	0.94	3	3	0
0014	3T	11_1	134	28	1	2800	4160	1360	0.04	1.49	4	7	3
0014	3T	11_1	135	17	0	1700	0	-1700	0.00	0.00	3	0	-3
0014	3T	11_1	136	12	0	1200	0	-1200	0.00	0.00	2	0	-2
0014	3T	11_1	142	12	0	1200	0	-1200	0.00	0.00	2	0	-2
0014	3T	11_1	143	15	0	1500	0	-1500	0.00	0.00	2	0	-2
0014	3T	11_1	145	11	0	1100	0	-1100	0.00	0.00	1	0	-1
0014	3T	11_1	146	10	0	1000	0	-1000	0.00	0.00	1	0	-1
0014	3T	11_1	152	8	1	800	1090	290	0.13	1.36	1	1	0
0014	3T	11_1	153	5	0	500	0	-500	0.00	0.00	0	0	0
0014	3T	11_1	154	3	0	300	0	-300	0.00	0.00	0	0	0
0014	3T	11_1	156	2	0	200	0	-200	0.00	0.00	0	0	0
0014	3T	11_1	162	1	0	100	0	-100	0.00	0.00	0	0	0
0014	3T	11_1	163	4	0	400	0	-400	0.00	0.00	0	0	0
0014	3T	11_1	164	4	0	400	0	-400	0.00	0.00	0	0	0
0014	3T	11_1	165	2	0	200	0	-200	0.00	0.00	0	0	0
0014	3T	11_1	213	6	0	600	0	-600	0.00	0.00	1	0	-1
0014	3T	11_1	214	7	0	700	0	-700	0.00	0.00	1	0	-1
0014	3T	11_1	215	1	0	100	0	-100	0.00	0.00	0	0	0
0014	3T	11_1	216	3	0	300	0	-300	0.00	0.00	0	0	0
0014	3T	11_1	234	2	0	200	0	-200	0.00	0.00	0	0	0
0014	3T	11_1	235	2	0	200	0	-200	0.00	0.00	0	0	0
0014	3T	11_1	241	1	0	100	0	-100	0.00	0.00	0	0	0
0014	3T	11_1	243	1	0	100	0	-100	0.00	0.00	0	0	0
0014	3T	11_1	245	1	0	100	0	-100	0.00	0.00	0	0	0
0014	3T	11_1	246	2	0	200	0	-200	0.00	0.00	0	0	0
0014	3T	11_1	251	1	0	100	0	-100	0.00	0.00	0	0	0
0014	3T	11_1	254	2	0	200	0	-200	0.00	0.00	0	0	0
0014	3T	11_1	263	1	0	100	0	-100	0.00	0.00	0	0	0
0014	3T	11_1	264	1	0	100	0	-100	0.00	0.00	0	0	0
0014	3T	11_2	123	54	5	5400	4760	-640	0.09	0.88	9	8	-1
0014	3T	11_2	124	33	4	3300	3780	480	0.12	1.15	5	6	1
0014	3T	11_2	125	14	0	1400	0	-1400	0.00	0.00	2	0	-2
0014	3T	11_2	126	23	2	2300	2600	300	0.09	1.13	4	4	0
0014	3T	11_2	132	22	0	2200	0	-2200	0.00	0.00	3	0	-3
0014	3T	11_2	134	16	1	1600	720	-880	0.06	0.45	2	1	-1
0014	3T	11_2	135	12	0	1200	0	-1200	0.00	0.00	2	0	-2
0014	3T	11_2	136	16	0	1600	0	-1600	0.00	0.00	2	0	-2
0014	3T	11_2	142	11	0	1100	0	-1100	0.00	0.00	1	0	-1
0014	3T	11_2	143	16	1	1600	550	-1050	0.06	0.34	2	0	-2
0014	3T	11_2	145	11	1	1100	440	-660	0.09	0.40	1	0	-1
0014	3T	11_2	146	9	0	900	0	-900	0.00	0.00	1	0	-1
0014	3T	11_2	152	4	1	400	2080	1680	0.25	5.20	0	3	3
0014	3T	11_2	153	5	0	500	0	-500	0.00	0.00	0	0	0
0014	3T	11_2	154	2	0	200	0	-200	0.00	0.00	0	0	0
0014	3T	11_2	156	2	0	200	0	-200	0.00	0.00	0	0	0
0014	3T	11_2	162	7	1	700	4150	3450	0.14	5.93	1	7	6
0014	3T	11_2	163	5	1	500	1610	1110	0.20	3.22	0	2	2
0014	3T	11_2	164	4	0	400	0	-400	0.00	0.00	0	0	0
0014	3T	11_2	165	3	0	300	0	-300	0.00	0.00	0	0	0
0014	3T	11_2	213	2	0	200	0	-200	0.00	0.00	0	0	0
0014	3T	11_2	214	4	0	400	0	-400	0.00	0.00	0	0	0
0014	3T	11_2	215	1	0	100	0	-100	0.00	0.00	0	0	0
0014	3T	11_2	216	3	0	300	0	-300	0.00	0.00	0	0	0
0014	3T	11_2	231	2	0	200	0	-200	0.00	0.00	0	0	0
0014	3T	11_2	234	1	0	100	0	-100	0.00	0.00	0	0	0
0014	3T	11_2	236	2	0	200	0	-200	0.00	0.00	0	0	0
0014	3T	11_2	241	2	0	200	0	-200	0.00	0.00	0	0	0
0014	3T	11_2	243	3	0	300	0	-300	0.00	0.00	0	0	0
0014	3T	11_2	246	1	0	100	0	-100	0.00	0.00	0	0	0
0014	3T	11_2	251	1	0	100	0	-100	0.00	0.00	0	0	0
0014	3T	11_2	261	2	0	200	0	-200	0.00	0.00	0	0	0
0014	3T	11_2	263	1	0	100	0	-100	0.00	0.00	0	0	0
0014	3T	11_2	264	1	0	100	0	-100	0.00	0.00	0	0	0
0014	3T	11_3	123	50	6	5000	4530	-470	0.12	0.91	8	8	0
0014	3T	11_3	124	28	3	2800	3110	310	0.11	1.11	4	5	1
0014	3T	11_3	125	18	0	1800	0	-1800	0.00	0.00	3	0	-3
0014	3T	11_3	126	21	1	2100	1170	-930	0.05	0.56	3	2	-1
0014	3T	11_3	132	22	0	2200	0	-2200	0.00	0.00	3	0	-3
0014	3T	11_3	134	22	1	2200	360	-1840	0.05	0.16	3	0	-3
0014	3T	11_3	135	17	2	1700	4240	2540	0.12	2.49	3	7	4
0014	3T	11_3	136	11	0	1100	0	-1100	0.00	0.00	1	0	-1
0014	3T	11_3	142	22	0	2200	0	-2200	0.00	0.00	3	0	-3
0014	3T	11_3	143	13	1	1300	1420	120	0.08	1.09	2	2	0
0014	3T	11_3	145	5	0	500	0	-500	0.00	0.00	0	0	0
0014	3T	11_3	146	5	1	500	1260	760	0.20	2.52	0	2	2
0014	3T	11_3	152	2	0	200	0	-200	0.00	0.00	0	0	0
0014	3T	11_3	153	11	0	1100	0	-1100	0.00	0.00	1	0	-1
0014	3T	11_3	154	4	0	400	0	-400	0.00	0.00	0	0	0
0014	3T	11_3	156	2	0	200	0	-200	0.00	0.00	0	0	0
0014	3T	11_3	162	4	0	400	0	-400	0.00	0.00	0	0	0
0014	3T	11_3	163	4	0	400	0	-400	0.00	0.00	0	0	0
0014	3T	11_3	164	1	0	100	0	-100	0.00	0.00	0	0	0
0014	3T	11_3	165	1	0	100	0	-100	0.00	0.00	0	0	0
0014	3T	11_3	213	10	1	1000	4260	3260	0.10	4.26	1	7	6
0014	3T	11_3	214	1	0	100	0	-100	0.00	0.00	0	0	0
0014	3T	11_3	215	2	0	200	0	-200	0.00	0.00	0	0	0
0014	3T	11_3	216	2	0	200	0	-200	0.00	0.00	0	0	0
0014	3T	11_3	231	2	0	200	0	-200	0.00	0.00	0	0	0
0014	3T	11_3	234	2	0	200	0	-200	0.00	0.00	0	0	0
0014	3T	11_3	235	3	0	300	0	-300	0.00	0.00	0	0	0
0014	3T	11_3	236	2	0	200	0	-200	0.00	0.00	0	0	0
0014	3T	11_3	241	1	0	100	0	-100	0.00	0.00	0	0	0
0014	3T	11_3	243	1	0	100	0	-100	0.00	0.00	0	0	0
0014	3T	11_3	245	1	0	100	0	-100	0.00	0.00	0	0	0
0014	3T	11_3	246	1	0	100	0	-100	0.00	0.00	0	0	0
0014	3T	11_3	251	1	0	100	0	-100	0.00	0.00	0	0	0
0014	3T	11_3	253	2	0	200	0	-200	0.00	0.00	0	0	0
0014	3T	11_3	254	2	0	200	0	-200	0.00	0.00	0	0	0
0014	3T	11_3	263	1	0	100	0	-100	0.00	0.00	0	0	0
0014	3T	11_3	264	1	0	100	0	-100	0.00	0.00	0	0	0
0014	3T	11_4	123	49	4	4900	4050	-850	0.08	0.83	8	7	-1
0014	3T	11_4	124	39	3	3900	2450	-1450	0.08	0.63	6	4	-2
0014	3T	11_4	125	27	0	2700	0	-2700	0.00	0.00	4	0	-4
0014	3T	11_4	126	10	0	1000	0	-1000	0.00	0.00	1	0	-1
0014	3T	11_4	132	23	2	2300	1530	-770	0.09	0.67	4	2	-2
0014	3T	11_4	134	24	3	2400	2320	-80	0.13	0.97	4	4	0
0014	3T	11_4	135	11	0	1100	0	-1100	0.00	0.00	1	0	-1
0014	3T	11_4	136	8	1	800	4400	3600	0.13	5.50	1	7	6
0014	3T	11_4	142	12	1	1200	1010	-190	0.08	0.84	2	1	-1
0014	3T	11_4	143	8	0	800	0	-800	0.00	0.00	1	0	-1
0014	3T	11_4	145	10	1	1000	3740	2740	0.10	3.74	1	6	5
0014	3T	11_4	146	2	0	200	0	-200	0.00	0.00	0	0	0
0014	3T	11_4	152	4	0	400	0	-400	0.00	0.00	0	0	0
0014	3T	11_4	153	11	0	1100	0	-1100	0.00	0.00	1	0	-1
0014	3T	11_4	154	3	0	300	0	-300	0.00	0.00	0	0	0
0014	3T	11_4	156	3	0	300	0	-300	0.00	0.00	0	0	0
0014	3T	11_4	162	1	0	100	0	-100	0.00	0.00	0	0	0
0014	3T	11_4	165	3	0	300	0	-300	0.00	0.00	0	0	0
0014	3T	11_4	213	7	0	700	0	-700	0.00	0.00	1	0	-1
0014	3T	11_4	214	4	0	400	0	-400	0.00	0.00	0	0	0
0014	3T	11_4	215	1	0	100	0	-100	0.00	0.00	0	0	0
0014	3T	11_4	216	3	0	300	0	-300	0.00	0.00	0	0	0
0014	3T	11_4	231	1	0	100	0	-100	0.00	0.00	0	0	0
0014	3T	11_4	234	2	0	200	0	-200	0.00	0.00	0	0	0
0014	3T	11_4	235	1	0	100	0	-100	0.00	0.00	0	0	0
0014	3T	11_4	241	2	0	200	0	-200	0.00	0.00	0	0	0
0014	3T	11_4	245	1	0	100	0	-100	0.00	0.00	0	0	0
0014	3T	11_4	246	3	0	300	0	-300	0.00	0.00	0	0	0
0014	3T	11_4	251	1	0	100	0	-100	0.00	0.00	0	0	0
0014	3T	11_4	253	3	0	300	0	-300	0.00	0.00	0	0	0
0014	3T	11_4	254	1	0	100	0	-100	0.00	0.00	0	0	0
0014	3T	11_4	264	1	0	100	0	-100	0.00	0.00	0	0	0
0014	3T	11_5	123	35	6	3500	6220	2720	0.17	1.78	6	11	5
0014	3T	11_5	124	41	5	4100	7170	3070	0.12	1.75	7	12	5
0014	3T	11_5	125	20	1	2000	1140	-860	0.05	0.57	3	2	-1
0014	3T	11_5	126	20	0	2000	0	-2000	0.00	0.00	3	0	-3
0014	3T	11_5	132	21	2	2100	1500	-600	0.10	0.71	3	2	-1
0014	3T	11_5	134	17	2	1700	5740	4040	0.12	3.38	3	10	7
0014	3T	11_5	135	10	0	1000	0	-1000	0.00	0.00	1	0	-1
0014	3T	11_5	136	12	0	1200	0	-1200	0.00	0.00	2	0	-2
0014	3T	11_5	142	13	0	1300	0	-1300	0.00	0.00	2	0	-2
0014	3T	11_5	143	18	0	1800	0	-1800	0.00	0.00	3	0	-3
0014	3T	11_5	145	4	0	400	0	-400	0.00	0.00	0	0	0
0014	3T	11_5	146	12	0	1200	0	-1200	0.00	0.00	2	0	-2
0014	3T	11_5	152	5	0	500	0	-500	0.00	0.00	0	0	0
0014	3T	11_5	153	4	0	400	0	-400	0.00	0.00	0	0	0
0014	3T	11_5	154	1	0	100	0	-100	0.00	0.00	0	0	0
0014	3T	11_5	162	1	0	100	0	-100	0.00	0.00	0	0	0
0014	3T	11_5	163	2	0	200	0	-200	0.00	0.00	0	0	0
0014	3T	11_5	164	1	0	100	0	-100	0.00	0.00	0	0	0
0014	3T	11_5	213	1	0	100	0	-100	0.00	0.00	0	0	0
0014	3T	11_5	214	1	0	100	0	-100	0.00	0.00	0	0	0
0014	3T	11_5	215	1	0	100	0	-100	0.00	0.00	0	0	0
0014	3T	11_5	216	3	0	300	0	-300	0.00	0.00	0	0	0
0014	3T	11_5	234	2	0	200	0	-200	0.00	0.00	0	0	0
0014	3T	11_5	235	1	0	100	0	-100	0.00	0.00	0	0	0
0014	3T	11_5	236	1	0	100	0	-100	0.00	0.00	0	0	0
0014	3T	11_5	241	1	0	100	0	-100	0.00	0.00	0	0	0
0014	3T	11_5	243	1	0	100	0	-100	0.00	0.00	0	0	0
0014	3T	11_5	246	1	0	100	0	-100	0.00	0.00	0	0	0
0014	3T	11_5	264	1	0	100	0	-100	0.00	0.00	0	0	0
0014	3T	11_7	123	65	8	6500	7670	1170	0.12	1.18	11	13	2
0014	3T	11_7	124	36	4	3600	3490	-110	0.11	0.97	6	6	0
0014	3T	11_7	125	34	2	3400	2230	-1170	0.06	0.66	6	3	-3
0014	3T	11_7	126	20	1	2000	2170	170	0.05	1.09	3	3	0
0014	3T	11_7	132	19	1	1900	690	-1210	0.05	0.36	3	1	-2
0014	3T	11_7	134	26	3	2600	3100	500	0.12	1.19	4	5	1
0014	3T	11_7	135	12	1	1200	1670	470	0.08	1.39	2	2	0
0014	3T	11_7	136	7	0	700	0	-700	0.00	0.00	1	0	-1
0014	3T	11_7	142	19	0	1900	0	-1900	0.00	0.00	3	0	-3
0014	3T	11_7	143	9	1	900	1440	540	0.11	1.60	1	2	1
0014	3T	11_7	145	7	0	700	0	-700	0.00	0.00	1	0	-1
0014	3T	11_7	146	8	1	800	1510	710	0.13	1.89	1	2	1
0014	3T	11_7	152	4	0	400	0	-400	0.00	0.00	0	0	0
0014	3T	11_7	153	7	0	700	0	-700	0.00	0.00	1	0	-1
0014	3T	11_7	154	1	0	100	0	-100	0.00	0.00	0	0	0
0014	3T	11_7	156	3	0	300	0	-300	0.00	0.00	0	0	0
0014	3T	11_7	162	3	0	300	0	-300	0.00	0.00	0	0	0
0014	3T	11_7	163	3	1	300	2230	1930	0.33	7.43	0	3	3
0014	3T	11_7	164	1	0	100	0	-100	0.00	0.00	0	0	0
0014	3T	11_7	213	2	0	200	0	-200	0.00	0.00	0	0	0
0014	3T	11_7	214	5	0	500	0	-500	0.00	0.00	0	0	0
0014	3T	11_7	215	2	0	200	0	-200	0.00	0.00	0	0	0
0014	3T	11_7	231	1	0	100	0	-100	0.00	0.00	0	0	0
0014	3T	11_7	235	1	0	100	0	-100	0.00	0.00	0	0	0
0014	3T	11_7	241	1	0	100	0	-100	0.00	0.00	0	0	0
0014	3T	11_7	243	1	0	100	0	-100	0.00	0.00	0	0	0
0014	3T	11_7	245	2	0	200	0	-200	0.00	0.00	0	0	0
0014	3T	11_7	254	2	0	200	0	-200	0.00	0.00	0	0	0
0014	3T	11_7	256	1	0	100	0	-100	0.00	0.00	0	0	0
0014	3T	11_7	261	1	0	100	0	-100	0.00	0.00	0	0	0
0014	3T	12_1	123	45	4	4500	4280	-220	0.09	0.95	7	7	0
0014	3T	12_1	124	40	2	4000	1600	-2400	0.05	0.40	7	2	-5
0014	3T	12_1	125	33	2	3300	1670	-1630	0.06	0.51	5	2	-3
0014	3T	12_1	126	28	2	2800	2110	-690	0.07	0.75	4	3	-1
0014	3T	12_1	132	22	0	2200	0	-2200	0.00	0.00	3	0	-3
0014	3T	12_1	134	21	1	2100	850	-1250	0.05	0.40	3	1	-2
0014	3T	12_1	135	22	1	2200	1490	-710	0.05	0.68	3	2	-1
0014	3T	12_1	136	19	0	1900	0	-1900	0.00	0.00	3	0	-3
0014	3T	12_1	142	11	0	1100	0	-1100	0.00	0.00	1	0	-1
0014	3T	12_1	143	12	1	1200	1050	-150	0.08	0.88	2	1	-1
0014	3T	12_1	145	8	0	800	0	-800	0.00	0.00	1	0	-1
0014	3T	12_1	146	7	1	700	3020	2320	0.14	4.31	1	5	4
0014	3T	12_1	152	15	1	1500	1680	180	0.07	1.12	2	2	0
0014	3T	12_1	153	6	0	600	0	-600	0.00	0.00	1	0	-1
0014	3T	12_1	154	3	0	300	0	-300	0.00	0.00	0	0	0
0014	3T	12_1	156	5	2	500	3490	2990	0.40	6.98	0	6	6
0014	3T	12_1	162	3	0	300	0	-300	0.00	0.00	0	0	0
0014	3T	12_1	163	4	0	400	0	-400	0.00	0.00	0	0	0
0014	3T	12_1	164	3	0	300	0	-300	0.00	0.00	0	0	0
0014	3T	12_1	165	5	0	500	0	-500	0.00	0.00	0	0	0
0014	3T	12_1	214	3	0	300	0	-300	0.00	0.00	0	0	0
0014	3T	12_1	215	1	0	100	0	-100	0.00	0.00	0	0	0
0014	3T	12_1	216	4	0	400	0	-400	0.00	0.00	0	0	0
0014	3T	12_1	231	1	0	100	0	-100	0.00	0.00	0	0	0
0014	3T	12_1	234	2	0	200	0	-200	0.00	0.00	0	0	0
0014	3T	12_1	236	1	0	100	0	-100	0.00	0.00	0	0	0
0014	3T	12_1	246	1	0	100	0	-100	0.00	0.00	0	0	0
0014	3T	12_1	254	1	0	100	0	-100	0.00	0.00	0	0	0
0014	3T	12_1	256	1	0	100	0	-100	0.00	0.00	0	0	0
0014	3T	12_2	123	34	5	3400	4320	920	0.15	1.27	6	7	1
0014	3T	12_2	124	30	3	3000	2290	-710	0.10	0.76	5	4	-1
0014	3T	12_2	125	25	0	2500	0	-2500	0.00	0.00	4	0	-4
0014	3T	12_2	126	32	1	3200	760	-2440	0.03	0.24	5	1	-4
0014	3T	12_2	132	23	4	2300	5570	3270	0.17	2.42	4	9	5
0014	3T	12_2	134	25	2	2500	1460	-1040	0.08	0.58	4	2	-2
0014	3T	12_2	135	19	0	1900	0	-1900	0.00	0.00	3	0	-3
0014	3T	12_2	136	16	0	1600	0	-1600	0.00	0.00	2	0	-2
0014	3T	12_2	142	15	1	1500	1220	-280	0.07	0.81	2	2	0
0014	3T	12_2	143	17	3	1700	3770	2070	0.18	2.22	3	6	3
0014	3T	12_2	145	6	0	600	0	-600	0.00	0.00	1	0	-1
0014	3T	12_2	146	6	0	600	0	-600	0.00	0.00	1	0	-1
0014	3T	12_2	152	6	0	600	0	-600	0.00	0.00	1	0	-1
0014	3T	12_2	153	5	1	500	3010	2510	0.20	6.02	0	5	5
0014	3T	12_2	154	3	0	300	0	-300	0.00	0.00	0	0	0
0014	3T	12_2	156	3	0	300	0	-300	0.00	0.00	0	0	0
0014	3T	12_2	162	2	0	200	0	-200	0.00	0.00	0	0	0
0014	3T	12_2	163	4	0	400	0	-400	0.00	0.00	0	0	0
0014	3T	12_2	164	7	0	700	0	-700	0.00	0.00	1	0	-1
0014	3T	12_2	165	5	1	500	1080	580	0.20	2.16	0	1	1
0014	3T	12_2	213	6	1	600	840	240	0.17	1.40	1	1	0
0014	3T	12_2	214	3	0	300	0	-300	0.00	0.00	0	0	0
0014	3T	12_2	215	1	0	100	0	-100	0.00	0.00	0	0	0
0014	3T	12_2	216	4	0	400	0	-400	0.00	0.00	0	0	0
0014	3T	12_2	231	3	0	300	0	-300	0.00	0.00	0	0	0
0014	3T	12_2	234	2	0	200	0	-200	0.00	0.00	0	0	0
0014	3T	12_2	236	1	0	100	0	-100	0.00	0.00	0	0	0
0014	3T	12_2	241	2	0	200	0	-200	0.00	0.00	0	0	0
0014	3T	12_2	243	4	0	400	0	-400	0.00	0.00	0	0	0
0014	3T	12_2	245	1	0	100	0	-100	0.00	0.00	0	0	0
0014	3T	12_2	246	1	0	100	0	-100	0.00	0.00	0	0	0
0014	3T	12_2	251	1	0	100	0	-100	0.00	0.00	0	0	0
0014	3T	12_2	253	1	0	100	0	-100	0.00	0.00	0	0	0
0014	3T	12_2	256	2	0	200	0	-200	0.00	0.00	0	0	0
0014	3T	12_3	123	34	3	3400	2140	-1260	0.09	0.63	6	3	-3
0014	3T	12_3	124	50	4	5000	5670	670	0.08	1.13	8	10	2
0014	3T	12_3	125	25	1	2500	500	-2000	0.04	0.20	4	0	-4
0014	3T	12_3	126	22	1	2200	2620	420	0.05	1.19	3	4	1
0014	3T	12_3	132	17	1	1700	1040	-660	0.06	0.61	3	1	-2
0014	3T	12_3	134	23	3	2300	1810	-490	0.13	0.79	4	3	-1
0014	3T	12_3	135	20	0	2000	0	-2000	0.00	0.00	3	0	-3
0014	3T	12_3	136	13	0	1300	0	-1300	0.00	0.00	2	0	-2
0014	3T	12_3	142	12	0	1200	0	-1200	0.00	0.00	2	0	-2
0014	3T	12_3	143	13	0	1300	0	-1300	0.00	0.00	2	0	-2
0014	3T	12_3	145	8	0	800	0	-800	0.00	0.00	1	0	-1
0014	3T	12_3	146	9	0	900	0	-900	0.00	0.00	1	0	-1
0014	3T	12_3	152	6	0	600	0	-600	0.00	0.00	1	0	-1
0014	3T	12_3	153	6	0	600	0	-600	0.00	0.00	1	0	-1
0014	3T	12_3	154	8	0	800	0	-800	0.00	0.00	1	0	-1
0014	3T	12_3	156	5	0	500	0	-500	0.00	0.00	0	0	0
0014	3T	12_3	162	5	0	500	0	-500	0.00	0.00	0	0	0
0014	3T	12_3	163	6	0	600	0	-600	0.00	0.00	1	0	-1
0014	3T	12_3	164	3	0	300	0	-300	0.00	0.00	0	0	0
0014	3T	12_3	165	3	0	300	0	-300	0.00	0.00	0	0	0
0014	3T	12_3	213	9	1	900	3430	2530	0.11	3.81	1	6	5
0014	3T	12_3	214	4	0	400	0	-400	0.00	0.00	0	0	0
0014	3T	12_3	215	2	0	200	0	-200	0.00	0.00	0	0	0
0014	3T	12_3	216	3	0	300	0	-300	0.00	0.00	0	0	0
0014	3T	12_3	231	2	0	200	0	-200	0.00	0.00	0	0	0
0014	3T	12_3	234	6	0	600	0	-600	0.00	0.00	1	0	-1
0014	3T	12_3	235	3	0	300	0	-300	0.00	0.00	0	0	0
0014	3T	12_3	241	3	1	300	3630	3330	0.33	12.10	0	6	6
0014	3T	12_3	243	1	0	100	0	-100	0.00	0.00	0	0	0
0014	3T	12_3	251	1	0	100	0	-100	0.00	0.00	0	0	0
0014	3T	12_3	256	2	0	200	0	-200	0.00	0.00	0	0	0
0014	3T	12_3	265	1	0	100	0	-100	0.00	0.00	0	0	0
0014	3T	12_4	123	46	8	4600	9230	4630	0.17	2.01	8	16	8
0014	3T	12_4	124	34	5	3400	3240	-160	0.15	0.95	6	5	-1
0014	3T	12_4	125	21	1	2100	2790	690	0.05	1.33	3	4	1
0014	3T	12_4	126	24	0	2400	0	-2400	0.00	0.00	4	0	-4
0014	3T	12_4	132	19	2	1900	3660	1760	0.11	1.93	3	6	3
0014	3T	12_4	134	17	1	1700	590	-1110	0.06	0.35	3	1	-2
0014	3T	12_4	135	13	0	1300	0	-1300	0.00	0.00	2	0	-2
0014	3T	12_4	136	13	0	1300	0	-1300	0.00	0.00	2	0	-2
0014	3T	12_4	142	12	0	1200	0	-1200	0.00	0.00	2	0	-2
0014	3T	12_4	143	7	0	700	0	-700	0.00	0.00	1	0	-1
0014	3T	12_4	145	10	0	1000	0	-1000	0.00	0.00	1	0	-1
0014	3T	12_4	146	6	0	600	0	-600	0.00	0.00	1	0	-1
0014	3T	12_4	152	10	0	1000	0	-1000	0.00	0.00	1	0	-1
0014	3T	12_4	153	6	0	600	0	-600	0.00	0.00	1	0	-1
0014	3T	12_4	154	2	0	200	0	-200	0.00	0.00	0	0	0
0014	3T	12_4	156	4	1	400	910	510	0.25	2.28	0	1	1
0014	3T	12_4	163	2	0	200	0	-200	0.00	0.00	0	0	0
0014	3T	12_4	164	2	0	200	0	-200	0.00	0.00	0	0	0
0014	3T	12_4	165	3	0	300	0	-300	0.00	0.00	0	0	0
0014	3T	12_4	213	2	0	200	0	-200	0.00	0.00	0	0	0
0014	3T	12_4	214	3	0	300	0	-300	0.00	0.00	0	0	0
0014	3T	12_4	215	2	0	200	0	-200	0.00	0.00	0	0	0
0014	3T	12_4	216	2	0	200	0	-200	0.00	0.00	0	0	0
0014	3T	12_4	231	1	0	100	0	-100	0.00	0.00	0	0	0
0014	3T	12_4	234	2	0	200	0	-200	0.00	0.00	0	0	0
0014	3T	12_4	235	2	0	200	0	-200	0.00	0.00	0	0	0
0014	3T	12_4	236	2	0	200	0	-200	0.00	0.00	0	0	0
0014	3T	12_4	241	1	0	100	0	-100	0.00	0.00	0	0	0
0014	3T	12_4	245	1	0	100	0	-100	0.00	0.00	0	0	0
0014	3T	12_4	246	2	0	200	0	-200	0.00	0.00	0	0	0
0014	3T	12_4	251	1	0	100	0	-100	0.00	0.00	0	0	0
0014	3T	12_4	253	1	0	100	0	-100	0.00	0.00	0	0	0
0014	3T	12_4	254	4	0	400	0	-400	0.00	0.00	0	0	0
0014	3T	12_4	256	1	0	100	0	-100	0.00	0.00	0	0	0
0014	3T	12_4	264	1	0	100	0	-100	0.00	0.00	0	0	0
0014	3T	12_4	265	1	0	100	0	-100	0.00	0.00	0	0	0
0014	3T	12_5	123	31	4	3100	2570	-530	0.13	0.83	5	4	-1
0014	3T	12_5	124	45	4	4500	4210	-290	0.09	0.94	7	7	0
0014	3T	12_5	125	26	1	2600	510	-2090	0.04	0.20	4	0	-4
0014	3T	12_5	126	17	0	1700	0	-1700	0.00	0.00	3	0	-3
0014	3T	12_5	132	19	3	1900	1730	-170	0.16	0.91	3	3	0
0014	3T	12_5	134	16	2	1600	2610	1010	0.13	1.63	2	4	2
0014	3T	12_5	135	13	1	1300	660	-640	0.08	0.51	2	1	-1
0014	3T	12_5	136	9	1	900	1000	100	0.11	1.11	1	1	0
0014	3T	12_5	142	11	0	1100	0	-1100	0.00	0.00	1	0	-1
0014	3T	12_5	143	9	1	900	1760	860	0.11	1.96	1	3	2
0014	3T	12_5	145	13	1	1300	2710	1410	0.08	2.08	2	4	2
0014	3T	12_5	146	4	0	400	0	-400	0.00	0.00	0	0	0
0014	3T	12_5	152	6	0	600	0	-600	0.00	0.00	1	0	-1
0014	3T	12_5	153	7	0	700	0	-700	0.00	0.00	1	0	-1
0014	3T	12_5	154	4	0	400	0	-400	0.00	0.00	0	0	0
0014	3T	12_5	156	2	0	200	0	-200	0.00	0.00	0	0	0
0014	3T	12_5	162	5	0	500	0	-500	0.00	0.00	0	0	0
0014	3T	12_5	163	4	0	400	0	-400	0.00	0.00	0	0	0
0014	3T	12_5	164	5	0	500	0	-500	0.00	0.00	0	0	0
0014	3T	12_5	213	2	0	200	0	-200	0.00	0.00	0	0	0
0014	3T	12_5	215	2	0	200	0	-200	0.00	0.00	0	0	0
0014	3T	12_5	231	1	0	100	0	-100	0.00	0.00	0	0	0
0014	3T	12_5	243	2	0	200	0	-200	0.00	0.00	0	0	0
0014	3T	12_5	253	1	0	100	0	-100	0.00	0.00	0	0	0
0014	3T	12_6	123	6	0	600	0	-600	0.00	0.00	1	0	-1
0014	3T	12_6	124	5	0	500	0	-500	0.00	0.00	0	0	0
0014	3T	12_6	125	1	0	100	0	-100	0.00	0.00	0	0	0
0014	3T	12_6	126	2	0	200	0	-200	0.00	0.00	0	0	0
0014	3T	12_6	132	2	0	200	0	-200	0.00	0.00	0	0	0
0014	3T	12_6	134	2	1	200	430	230	0.50	2.15	0	0	0
0014	3T	12_6	135	1	0	100	0	-100	0.00	0.00	0	0	0
0014	3T	12_6	142	3	0	300	0	-300	0.00	0.00	0	0	0
0014	3T	12_6	152	1	0	100	0	-100	0.00	0.00	0	0	0
0014	3T	12_6	153	1	0	100	0	-100	0.00	0.00	0	0	0
0014	3T	12_6	163	1	0	100	0	-100	0.00	0.00	0	0	0
0014	3T	12_6	213	1	0	100	0	-100	0.00	0.00	0	0	0
0014	3T	12_7	123	55	8	5500	8020	2520	0.15	1.46	9	14	5
0014	3T	12_7	124	53	4	5300	5510	210	0.08	1.04	9	9	0
0014	3T	12_7	125	28	1	2800	1080	-1720	0.04	0.39	4	1	-3
0014	3T	12_7	126	27	3	2700	4660	1960	0.11	1.73	4	8	4
0014	3T	12_7	132	25	1	2500	570	-1930	0.04	0.23	4	1	-3
0014	3T	12_7	134	23	1	2300	920	-1380	0.04	0.40	4	1	-3
0014	3T	12_7	135	18	0	1800	0	-1800	0.00	0.00	3	0	-3
0014	3T	12_7	136	16	0	1600	0	-1600	0.00	0.00	2	0	-2
0014	3T	12_7	142	10	0	1000	0	-1000	0.00	0.00	1	0	-1
0014	3T	12_7	143	16	2	1600	2950	1350	0.13	1.84	2	5	3
0014	3T	12_7	145	9	0	900	0	-900	0.00	0.00	1	0	-1
0014	3T	12_7	146	4	0	400	0	-400	0.00	0.00	0	0	0
0014	3T	12_7	152	6	1	600	2480	1880	0.17	4.13	1	4	3
0014	3T	12_7	153	8	0	800	0	-800	0.00	0.00	1	0	-1
0014	3T	12_7	154	5	0	500	0	-500	0.00	0.00	0	0	0
0014	3T	12_7	156	3	0	300	0	-300	0.00	0.00	0	0	0
0014	3T	12_7	162	2	0	200	0	-200	0.00	0.00	0	0	0
0014	3T	12_7	163	3	0	300	0	-300	0.00	0.00	0	0	0
0014	3T	12_7	164	2	0	200	0	-200	0.00	0.00	0	0	0
0014	3T	12_7	213	6	1	600	2630	2030	0.17	4.38	1	4	3
0014	3T	12_7	214	3	0	300	0	-300	0.00	0.00	0	0	0
0014	3T	12_7	215	4	0	400	0	-400	0.00	0.00	0	0	0
0014	3T	12_7	216	1	0	100	0	-100	0.00	0.00	0	0	0
0014	3T	12_7	231	1	0	100	0	-100	0.00	0.00	0	0	0
0014	3T	12_7	235	5	0	500	0	-500	0.00	0.00	0	0	0
0014	3T	12_7	241	1	0	100	0	-100	0.00	0.00	0	0	0
0014	3T	12_7	243	1	0	100	0	-100	0.00	0.00	0	0	0
0014	3T	12_7	245	1	0	100	0	-100	0.00	0.00	0	0	0
0014	3T	12_7	251	1	0	100	0	-100	0.00	0.00	0	0	0
0014	3T	12_7	256	1	0	100	0	-100	0.00	0.00	0	0	0
0014	3T	13_1	123	40	6	4000	4570	570	0.15	1.14	7	8	1
0014	3T	13_1	124	55	6	5500	7250	1750	0.11	1.32	9	12	3
0014	3T	13_1	125	20	2	2000	3510	1510	0.10	1.76	3	6	3
0014	3T	13_1	126	16	2	1600	5290	3690	0.13	3.31	2	9	7
0014	3T	13_1	132	33	3	3300	4920	1620	0.09	1.49	5	8	3
0014	3T	13_1	134	26	2	2600	1410	-1190	0.08	0.54	4	2	-2
0014	3T	13_1	135	18	0	1800	0	-1800	0.00	0.00	3	0	-3
0014	3T	13_1	136	11	0	1100	0	-1100	0.00	0.00	1	0	-1
0014	3T	13_1	142	23	1	2300	500	-1800	0.04	0.22	4	0	-4
0014	3T	13_1	143	17	2	1700	1800	100	0.12	1.06	3	3	0
0014	3T	13_1	145	10	0	1000	0	-1000	0.00	0.00	1	0	-1
0014	3T	13_1	146	10	2	1000	8220	7220	0.20	8.22	1	14	13
0014	3T	13_1	152	7	0	700	0	-700	0.00	0.00	1	0	-1
0014	3T	13_1	153	7	0	700	0	-700	0.00	0.00	1	0	-1
0014	3T	13_1	154	4	0	400	0	-400	0.00	0.00	0	0	0
0014	3T	13_1	156	2	0	200	0	-200	0.00	0.00	0	0	0
0014	3T	13_1	162	3	0	300	0	-300	0.00	0.00	0	0	0
0014	3T	13_1	163	3	0	300	0	-300	0.00	0.00	0	0	0
0014	3T	13_1	164	4	0	400	0	-400	0.00	0.00	0	0	0
0014	3T	13_1	165	1	0	100	0	-100	0.00	0.00	0	0	0
0014	3T	13_1	213	6	0	600	0	-600	0.00	0.00	1	0	-1
0014	3T	13_1	214	8	0	800	0	-800	0.00	0.00	1	0	-1
0014	3T	13_1	215	3	1	300	1560	1260	0.33	5.20	0	2	2
0014	3T	13_1	216	2	0	200	0	-200	0.00	0.00	0	0	0
0014	3T	13_1	231	3	0	300	0	-300	0.00	0.00	0	0	0
0014	3T	13_1	234	2	0	200	0	-200	0.00	0.00	0	0	0
0014	3T	13_1	235	2	0	200	0	-200	0.00	0.00	0	0	0
0014	3T	13_1	236	1	1	100	7070	6970	1.00	70.70	0	12	12
0014	3T	13_1	243	4	0	400	0	-400	0.00	0.00	0	0	0
0014	3T	13_1	245	1	0	100	0	-100	0.00	0.00	0	0	0
0014	3T	13_1	246	2	0	200	0	-200	0.00	0.00	0	0	0
0014	3T	13_1	251	1	0	100	0	-100	0.00	0.00	0	0	0
0014	3T	13_1	254	1	0	100	0	-100	0.00	0.00	0	0	0
0014	3T	13_1	256	1	0	100	0	-100	0.00	0.00	0	0	0
0014	3T	13_2	123	48	5	4800	6190	1390	0.10	1.29	8	10	2
0014	3T	13_2	124	28	2	2800	4120	1320	0.07	1.47	4	7	3
0014	3T	13_2	125	26	4	2600	23040	20440	0.15	8.86	4	40	36
0014	3T	13_2	126	19	1	1900	1450	-450	0.05	0.76	3	2	-1
0014	3T	13_2	132	26	0	2600	0	-2600	0.00	0.00	4	0	-4
0014	3T	13_2	134	17	1	1700	1440	-260	0.06	0.85	3	2	-1
0014	3T	13_2	135	20	1	2000	650	-1350	0.05	0.33	3	1	-2
0014	3T	13_2	136	9	0	900	0	-900	0.00	0.00	1	0	-1
0014	3T	13_2	142	18	1	1800	920	-880	0.06	0.51	3	1	-2
0014	3T	13_2	143	21	1	2100	2520	420	0.05	1.20	3	4	1
0014	3T	13_2	145	3	0	300	0	-300	0.00	0.00	0	0	0
0014	3T	13_2	146	8	0	800	0	-800	0.00	0.00	1	0	-1
0014	3T	13_2	152	9	0	900	0	-900	0.00	0.00	1	0	-1
0014	3T	13_2	153	11	1	1100	3460	2360	0.09	3.15	1	6	5
0014	3T	13_2	154	6	0	600	0	-600	0.00	0.00	1	0	-1
0014	3T	13_2	156	2	0	200	0	-200	0.00	0.00	0	0	0
0014	3T	13_2	162	2	0	200	0	-200	0.00	0.00	0	0	0
0014	3T	13_2	163	3	0	300	0	-300	0.00	0.00	0	0	0
0014	3T	13_2	164	2	0	200	0	-200	0.00	0.00	0	0	0
0014	3T	13_2	165	1	0	100	0	-100	0.00	0.00	0	0	0
0014	3T	13_2	213	6	1	600	1210	610	0.17	2.02	1	2	1
0014	3T	13_2	214	3	0	300	0	-300	0.00	0.00	0	0	0
0014	3T	13_2	215	7	0	700	0	-700	0.00	0.00	1	0	-1
0014	3T	13_2	216	5	0	500	0	-500	0.00	0.00	0	0	0
0014	3T	13_2	231	1	0	100	0	-100	0.00	0.00	0	0	0
0014	3T	13_2	234	1	0	100	0	-100	0.00	0.00	0	0	0
0014	3T	13_2	235	3	0	300	0	-300	0.00	0.00	0	0	0
0014	3T	13_2	236	1	0	100	0	-100	0.00	0.00	0	0	0
0014	3T	13_2	241	3	0	300	0	-300	0.00	0.00	0	0	0
0014	3T	13_2	243	2	0	200	0	-200	0.00	0.00	0	0	0
0014	3T	13_2	245	2	0	200	0	-200	0.00	0.00	0	0	0
0014	3T	13_2	246	1	0	100	0	-100	0.00	0.00	0	0	0
0014	3T	13_2	251	2	0	200	0	-200	0.00	0.00	0	0	0
0014	3T	13_2	253	1	0	100	0	-100	0.00	0.00	0	0	0
0014	3T	13_2	254	2	0	200	0	-200	0.00	0.00	0	0	0
0014	3T	13_2	263	1	0	100	0	-100	0.00	0.00	0	0	0
0014	3T	13_2	265	3	0	300	0	-300	0.00	0.00	0	0	0
0014	3T	13_3	123	32	1	3200	660	-2540	0.03	0.21	5	1	-4
0014	3T	13_3	124	27	4	2700	3740	1040	0.15	1.39	4	6	2
0014	3T	13_3	125	27	2	2700	2190	-510	0.07	0.81	4	3	-1
0014	3T	13_3	126	11	0	1100	0	-1100	0.00	0.00	1	0	-1
0014	3T	13_3	132	24	2	2400	3050	650	0.08	1.27	4	5	1
0014	3T	13_3	134	20	2	2000	1180	-820	0.10	0.59	3	2	-1
0014	3T	13_3	135	19	0	1900	0	-1900	0.00	0.00	3	0	-3
0014	3T	13_3	136	15	0	1500	0	-1500	0.00	0.00	2	0	-2
0014	3T	13_3	142	14	0	1400	0	-1400	0.00	0.00	2	0	-2
0014	3T	13_3	143	14	0	1400	0	-1400	0.00	0.00	2	0	-2
0014	3T	13_3	145	6	0	600	0	-600	0.00	0.00	1	0	-1
0014	3T	13_3	146	5	1	500	1710	1210	0.20	3.42	0	3	3
0014	3T	13_3	152	10	2	1000	2220	1220	0.20	2.22	1	3	2
0014	3T	13_3	153	3	0	300	0	-300	0.00	0.00	0	0	0
0014	3T	13_3	154	9	0	900	0	-900	0.00	0.00	1	0	-1
0014	3T	13_3	156	7	1	700	3480	2780	0.14	4.97	1	6	5
0014	3T	13_3	162	6	1	600	1280	680	0.17	2.13	1	2	1
0014	3T	13_3	163	3	0	300	0	-300	0.00	0.00	0	0	0
0014	3T	13_3	164	2	0	200	0	-200	0.00	0.00	0	0	0
0014	3T	13_3	165	3	0	300	0	-300	0.00	0.00	0	0	0
0014	3T	13_3	213	7	1	700	1080	380	0.14	1.54	1	1	0
0014	3T	13_3	214	9	1	900	1120	220	0.11	1.24	1	1	0
0014	3T	13_3	215	4	0	400	0	-400	0.00	0.00	0	0	0
0014	3T	13_3	216	6	0	600	0	-600	0.00	0.00	1	0	-1
0014	3T	13_3	234	2	0	200	0	-200	0.00	0.00	0	0	0
0014	3T	13_3	235	2	0	200	0	-200	0.00	0.00	0	0	0
0014	3T	13_3	241	2	0	200	0	-200	0.00	0.00	0	0	0
0014	3T	13_3	243	2	0	200	0	-200	0.00	0.00	0	0	0
0014	3T	13_3	246	1	0	100	0	-100	0.00	0.00	0	0	0
0014	3T	13_3	253	1	0	100	0	-100	0.00	0.00	0	0	0
0014	3T	13_3	254	2	0	200	0	-200	0.00	0.00	0	0	0
0014	3T	13_3	263	2	0	200	0	-200	0.00	0.00	0	0	0
0014	3T	13_3	265	1	0	100	0	-100	0.00	0.00	0	0	0
0014	3T	13_4	123	45	7	4500	6790	2290	0.16	1.51	7	12	5
0014	3T	13_4	124	41	4	4100	2960	-1140	0.10	0.72	7	5	-2
0014	3T	13_4	125	21	2	2100	1850	-250	0.10	0.88	3	3	0
0014	3T	13_4	126	12	1	1200	650	-550	0.08	0.54	2	1	-1
0014	3T	13_4	132	22	1	2200	3930	1730	0.05	1.79	3	6	3
0014	3T	13_4	134	18	3	1800	2130	330	0.17	1.18	3	3	0
0014	3T	13_4	135	21	2	2100	1760	-340	0.10	0.84	3	3	0
0014	3T	13_4	136	15	1	1500	650	-850	0.07	0.43	2	1	-1
0014	3T	13_4	142	11	1	1100	1290	190	0.09	1.17	1	2	1
0014	3T	13_4	143	19	1	1900	1040	-860	0.05	0.55	3	1	-2
0014	3T	13_4	145	12	0	1200	0	-1200	0.00	0.00	2	0	-2
0014	3T	13_4	146	6	0	600	0	-600	0.00	0.00	1	0	-1
0014	3T	13_4	152	5	0	500	0	-500	0.00	0.00	0	0	0
0014	3T	13_4	153	4	0	400	0	-400	0.00	0.00	0	0	0
0014	3T	13_4	154	3	0	300	0	-300	0.00	0.00	0	0	0
0014	3T	13_4	162	2	0	200	0	-200	0.00	0.00	0	0	0
0014	3T	13_4	163	4	0	400	0	-400	0.00	0.00	0	0	0
0014	3T	13_4	165	2	0	200	0	-200	0.00	0.00	0	0	0
0014	3T	13_4	213	3	0	300	0	-300	0.00	0.00	0	0	0
0014	3T	13_4	214	3	1	300	1910	1610	0.33	6.37	0	3	3
0014	3T	13_4	216	6	0	600	0	-600	0.00	0.00	1	0	-1
0014	3T	13_4	231	2	0	200	0	-200	0.00	0.00	0	0	0
0014	3T	13_4	235	1	0	100	0	-100	0.00	0.00	0	0	0
0014	3T	13_4	236	4	0	400	0	-400	0.00	0.00	0	0	0
0014	3T	13_4	241	3	0	300	0	-300	0.00	0.00	0	0	0
0014	3T	13_4	245	1	0	100	0	-100	0.00	0.00	0	0	0
0014	3T	13_4	246	2	0	200	0	-200	0.00	0.00	0	0	0
0014	3T	13_4	253	1	0	100	0	-100	0.00	0.00	0	0	0
0014	3T	13_4	254	1	0	100	0	-100	0.00	0.00	0	0	0
0014	3T	13_4	256	1	0	100	0	-100	0.00	0.00	0	0	0
0014	3T	13_4	263	1	0	100	0	-100	0.00	0.00	0	0	0
0014	3T	13_4	264	1	0	100	0	-100	0.00	0.00	0	0	0
0014	3T	13_5	123	34	4	3400	2270	-1130	0.12	0.67	6	4	-2
0014	3T	13_5	124	38	4	3800	3870	70	0.11	1.02	6	6	0
0014	3T	13_5	125	33	1	3300	870	-2430	0.03	0.26	5	1	-4
0014	3T	13_5	126	12	1	1200	780	-420	0.08	0.65	2	1	-1
0014	3T	13_5	132	26	2	2600	2290	-310	0.08	0.88	4	4	0
0014	3T	13_5	134	25	3	2500	1470	-1030	0.12	0.59	4	2	-2
0014	3T	13_5	135	11	1	1100	540	-560	0.09	0.49	1	0	-1
0014	3T	13_5	136	15	1	1500	900	-600	0.07	0.60	2	1	-1
0014	3T	13_5	142	13	0	1300	0	-1300	0.00	0.00	2	0	-2
0014	3T	13_5	143	11	0	1100	0	-1100	0.00	0.00	1	0	-1
0014	3T	13_5	145	6	1	600	1210	610	0.17	2.02	1	2	1
0014	3T	13_5	146	4	0	400	0	-400	0.00	0.00	0	0	0
0014	3T	13_5	152	5	0	500	0	-500	0.00	0.00	0	0	0
0014	3T	13_5	153	9	0	900	0	-900	0.00	0.00	1	0	-1
0014	3T	13_5	154	3	0	300	0	-300	0.00	0.00	0	0	0
0014	3T	13_5	156	4	0	400	0	-400	0.00	0.00	0	0	0
0014	3T	13_5	162	4	0	400	0	-400	0.00	0.00	0	0	0
0014	3T	13_5	163	2	0	200	0	-200	0.00	0.00	0	0	0
0014	3T	13_5	164	2	0	200	0	-200	0.00	0.00	0	0	0
0014	3T	13_5	214	1	0	100	0	-100	0.00	0.00	0	0	0
0014	3T	13_5	231	1	0	100	0	-100	0.00	0.00	0	0	0
0014	3T	13_5	234	3	0	300	0	-300	0.00	0.00	0	0	0
0014	3T	13_5	241	1	0	100	0	-100	0.00	0.00	0	0	0
0014	3T	13_5	254	1	0	100	0	-100	0.00	0.00	0	0	0
0014	3T	13_5	263	1	0	100	0	-100	0.00	0.00	0	0	0
0014	3T	13_6	123	4	0	400	0	-400	0.00	0.00	0	0	0
0014	3T	13_6	124	5	0	500	0	-500	0.00	0.00	0	0	0
0014	3T	13_6	125	5	0	500	0	-500	0.00	0.00	0	0	0
0014	3T	13_6	126	1	0	100	0	-100	0.00	0.00	0	0	0
0014	3T	13_6	132	3	0	300	0	-300	0.00	0.00	0	0	0
0014	3T	13_6	134	4	0	400	0	-400	0.00	0.00	0	0	0
0014	3T	13_6	135	2	0	200	0	-200	0.00	0.00	0	0	0
0014	3T	13_6	136	3	0	300	0	-300	0.00	0.00	0	0	0
0014	3T	13_6	142	1	0	100	0	-100	0.00	0.00	0	0	0
0014	3T	13_6	143	3	0	300	0	-300	0.00	0.00	0	0	0
0014	3T	13_6	146	2	0	200	0	-200	0.00	0.00	0	0	0
0014	3T	13_6	153	1	0	100	0	-100	0.00	0.00	0	0	0
0014	3T	13_6	154	1	0	100	0	-100	0.00	0.00	0	0	0
0014	3T	13_6	162	1	0	100	0	-100	0.00	0.00	0	0	0
0014	3T	13_6	214	1	0	100	0	-100	0.00	0.00	0	0	0
0014	3T	13_6	215	1	0	100	0	-100	0.00	0.00	0	0	0
0014	3T	13_7	123	48	6	4800	4600	-200	0.13	0.96	8	8	0
0014	3T	13_7	124	47	3	4700	2240	-2460	0.06	0.48	8	3	-5
0014	3T	13_7	125	17	0	1700	0	-1700	0.00	0.00	3	0	-3
0014	3T	13_7	126	16	0	1600	0	-1600	0.00	0.00	2	0	-2
0014	3T	13_7	132	33	0	3300	0	-3300	0.00	0.00	5	0	-5
0014	3T	13_7	134	21	1	2100	1740	-360	0.05	0.83	3	3	0
0014	3T	13_7	135	23	0	2300	0	-2300	0.00	0.00	4	0	-4
0014	3T	13_7	136	8	1	800	1040	240	0.13	1.30	1	1	0
0014	3T	13_7	142	25	4	2500	3730	1230	0.16	1.49	4	6	2
0014	3T	13_7	143	25	3	2500	3960	1460	0.12	1.58	4	7	3
0014	3T	13_7	145	9	0	900	0	-900	0.00	0.00	1	0	-1
0014	3T	13_7	146	10	1	1000	700	-300	0.10	0.70	1	1	0
0014	3T	13_7	152	5	0	500	0	-500	0.00	0.00	0	0	0
0014	3T	13_7	153	7	0	700	0	-700	0.00	0.00	1	0	-1
0014	3T	13_7	154	8	0	800	0	-800	0.00	0.00	1	0	-1
0014	3T	13_7	156	1	0	100	0	-100	0.00	0.00	0	0	0
0014	3T	13_7	162	2	0	200	0	-200	0.00	0.00	0	0	0
0014	3T	13_7	163	2	0	200	0	-200	0.00	0.00	0	0	0
0014	3T	13_7	164	1	0	100	0	-100	0.00	0.00	0	0	0
0014	3T	13_7	165	1	0	100	0	-100	0.00	0.00	0	0	0
0014	3T	13_7	213	3	0	300	0	-300	0.00	0.00	0	0	0
0014	3T	13_7	214	3	0	300	0	-300	0.00	0.00	0	0	0
0014	3T	13_7	215	2	0	200	0	-200	0.00	0.00	0	0	0
0014	3T	13_7	216	4	0	400	0	-400	0.00	0.00	0	0	0
0014	3T	13_7	231	1	0	100	0	-100	0.00	0.00	0	0	0
0014	3T	13_7	235	1	0	100	0	-100	0.00	0.00	0	0	0
0014	3T	13_7	236	1	0	100	0	-100	0.00	0.00	0	0	0
0014	3T	13_7	243	1	0	100	0	-100	0.00	0.00	0	0	0
0014	3T	13_7	245	2	0	200	0	-200	0.00	0.00	0	0	0
0014	3T	13_7	246	1	0	100	0	-100	0.00	0.00	0	0	0
0014	3T	13_7	251	1	0	100	0	-100	0.00	0.00	0	0	0
0014	3T	13_7	253	2	0	200	0	-200	0.00	0.00	0	0	0
0014	3T	13_7	254	1	0	100	0	-100	0.00	0.00	0	0	0
0014	3T	14_1	123	55	5	5500	7160	1660	0.09	1.30	9	12	3
0014	3T	14_1	124	36	0	3600	0	-3600	0.00	0.00	6	0	-6
0014	3T	14_1	125	22	0	2200	0	-2200	0.00	0.00	3	0	-3
0014	3T	14_1	126	21	0	2100	0	-2100	0.00	0.00	3	0	-3
0014	3T	14_1	132	29	0	2900	0	-2900	0.00	0.00	5	0	-5
0014	3T	14_1	134	17	1	1700	920	-780	0.06	0.54	3	1	-2
0014	3T	14_1	135	20	2	2000	1850	-150	0.10	0.93	3	3	0
0014	3T	14_1	136	12	0	1200	0	-1200	0.00	0.00	2	0	-2
0014	3T	14_1	142	24	2	2400	1930	-470	0.08	0.80	4	3	-1
0014	3T	14_1	143	23	1	2300	540	-1760	0.04	0.23	4	0	-4
0014	3T	14_1	145	10	1	1000	1310	310	0.10	1.31	1	2	1
0014	3T	14_1	146	7	0	700	0	-700	0.00	0.00	1	0	-1
0014	3T	14_1	152	8	0	800	0	-800	0.00	0.00	1	0	-1
0014	3T	14_1	153	5	0	500	0	-500	0.00	0.00	0	0	0
0014	3T	14_1	154	5	0	500	0	-500	0.00	0.00	0	0	0
0014	3T	14_1	156	1	0	100	0	-100	0.00	0.00	0	0	0
0014	3T	14_1	162	4	0	400	0	-400	0.00	0.00	0	0	0
0014	3T	14_1	163	1	0	100	0	-100	0.00	0.00	0	0	0
0014	3T	14_1	164	2	0	200	0	-200	0.00	0.00	0	0	0
0014	3T	14_1	165	1	0	100	0	-100	0.00	0.00	0	0	0
0014	3T	14_1	213	6	0	600	0	-600	0.00	0.00	1	0	-1
0014	3T	14_1	214	7	0	700	0	-700	0.00	0.00	1	0	-1
0014	3T	14_1	215	9	0	900	0	-900	0.00	0.00	1	0	-1
0014	3T	14_1	216	1	0	100	0	-100	0.00	0.00	0	0	0
0014	3T	14_1	231	1	0	100	0	-100	0.00	0.00	0	0	0
0014	3T	14_1	234	2	0	200	0	-200	0.00	0.00	0	0	0
0014	3T	14_1	235	4	0	400	0	-400	0.00	0.00	0	0	0
0014	3T	14_1	243	2	0	200	0	-200	0.00	0.00	0	0	0
0014	3T	14_1	245	3	0	300	0	-300	0.00	0.00	0	0	0
0014	3T	14_1	246	2	0	200	0	-200	0.00	0.00	0	0	0
0014	3T	14_1	251	1	0	100	0	-100	0.00	0.00	0	0	0
0014	3T	14_1	253	2	0	200	0	-200	0.00	0.00	0	0	0
0014	3T	14_1	254	1	0	100	0	-100	0.00	0.00	0	0	0
0014	3T	14_1	256	1	0	100	0	-100	0.00	0.00	0	0	0
0014	3T	14_1	263	1	0	100	0	-100	0.00	0.00	0	0	0
0014	3T	14_2	123	33	0	3300	0	-3300	0.00	0.00	5	0	-5
0014	3T	14_2	124	35	1	3500	780	-2720	0.03	0.22	6	1	-5
0014	3T	14_2	125	14	0	1400	0	-1400	0.00	0.00	2	0	-2
0014	3T	14_2	126	16	2	1600	9910	8310	0.13	6.19	2	17	15
0014	3T	14_2	132	19	0	1900	0	-1900	0.00	0.00	3	0	-3
0014	3T	14_2	134	26	3	2600	7030	4430	0.12	2.70	4	12	8
0014	3T	14_2	135	22	0	2200	0	-2200	0.00	0.00	3	0	-3
0014	3T	14_2	136	12	0	1200	0	-1200	0.00	0.00	2	0	-2
0014	3T	14_2	142	25	0	2500	0	-2500	0.00	0.00	4	0	-4
0014	3T	14_2	143	18	0	1800	0	-1800	0.00	0.00	3	0	-3
0014	3T	14_2	145	12	0	1200	0	-1200	0.00	0.00	2	0	-2
0014	3T	14_2	146	13	1	1300	950	-350	0.08	0.73	2	1	-1
0014	3T	14_2	152	4	0	400	0	-400	0.00	0.00	0	0	0
0014	3T	14_2	153	5	1	500	1780	1280	0.20	3.56	0	3	3
0014	3T	14_2	154	6	0	600	0	-600	0.00	0.00	1	0	-1
0014	3T	14_2	156	4	0	400	0	-400	0.00	0.00	0	0	0
0014	3T	14_2	162	4	0	400	0	-400	0.00	0.00	0	0	0
0014	3T	14_2	164	2	0	200	0	-200	0.00	0.00	0	0	0
0014	3T	14_2	165	2	0	200	0	-200	0.00	0.00	0	0	0
0014	3T	14_2	213	9	0	900	0	-900	0.00	0.00	1	0	-1
0014	3T	14_2	214	14	0	1400	0	-1400	0.00	0.00	2	0	-2
0014	3T	14_2	215	8	0	800	0	-800	0.00	0.00	1	0	-1
0014	3T	14_2	216	6	0	600	0	-600	0.00	0.00	1	0	-1
0014	3T	14_2	231	1	0	100	0	-100	0.00	0.00	0	0	0
0014	3T	14_2	234	3	0	300	0	-300	0.00	0.00	0	0	0
0014	3T	14_2	235	2	1	200	13350	13150	0.50	66.75	0	23	23
0014	3T	14_2	236	2	0	200	0	-200	0.00	0.00	0	0	0
0014	3T	14_2	241	2	0	200	0	-200	0.00	0.00	0	0	0
0014	3T	14_2	243	3	0	300	0	-300	0.00	0.00	0	0	0
0014	3T	14_2	245	2	0	200	0	-200	0.00	0.00	0	0	0
0014	3T	14_2	253	1	0	100	0	-100	0.00	0.00	0	0	0
0014	3T	14_2	256	1	0	100	0	-100	0.00	0.00	0	0	0
0014	3T	14_2	261	1	0	100	0	-100	0.00	0.00	0	0	0
0014	3T	14_3	123	33	2	3300	1990	-1310	0.06	0.60	5	3	-2
0014	3T	14_3	124	34	1	3400	930	-2470	0.03	0.27	6	1	-5
0014	3T	14_3	125	36	3	3600	7890	4290	0.08	2.19	6	13	7
0014	3T	14_3	126	21	0	2100	0	-2100	0.00	0.00	3	0	-3
0014	3T	14_3	132	22	1	2200	2170	-30	0.05	0.99	3	3	0
0014	3T	14_3	134	29	0	2900	0	-2900	0.00	0.00	5	0	-5
0014	3T	14_3	135	17	2	1700	11750	10050	0.12	6.91	3	20	17
0014	3T	14_3	136	13	0	1300	0	-1300	0.00	0.00	2	0	-2
0014	3T	14_3	142	33	1	3300	1740	-1560	0.03	0.53	5	3	-2
0014	3T	14_3	143	21	0	2100	0	-2100	0.00	0.00	3	0	-3
0014	3T	14_3	145	15	0	1500	0	-1500	0.00	0.00	2	0	-2
0014	3T	14_3	146	12	0	1200	0	-1200	0.00	0.00	2	0	-2
0014	3T	14_3	152	6	0	600	0	-600	0.00	0.00	1	0	-1
0014	3T	14_3	153	15	1	1500	6620	5120	0.07	4.41	2	11	9
0014	3T	14_3	154	7	0	700	0	-700	0.00	0.00	1	0	-1
0014	3T	14_3	156	6	0	600	0	-600	0.00	0.00	1	0	-1
0014	3T	14_3	162	3	0	300	0	-300	0.00	0.00	0	0	0
0014	3T	14_3	164	1	0	100	0	-100	0.00	0.00	0	0	0
0014	3T	14_3	213	6	1	600	1940	1340	0.17	3.23	1	3	2
0014	3T	14_3	214	6	0	600	0	-600	0.00	0.00	1	0	-1
0014	3T	14_3	215	4	0	400	0	-400	0.00	0.00	0	0	0
0014	3T	14_3	216	4	0	400	0	-400	0.00	0.00	0	0	0
0014	3T	14_3	234	5	0	500	0	-500	0.00	0.00	0	0	0
0014	3T	14_3	235	1	0	100	0	-100	0.00	0.00	0	0	0
0014	3T	14_3	236	4	0	400	0	-400	0.00	0.00	0	0	0
0014	3T	14_3	241	1	0	100	0	-100	0.00	0.00	0	0	0
0014	3T	14_3	243	4	0	400	0	-400	0.00	0.00	0	0	0
0014	3T	14_3	245	2	0	200	0	-200	0.00	0.00	0	0	0
0014	3T	14_3	251	1	0	100	0	-100	0.00	0.00	0	0	0
0014	3T	14_3	253	3	0	300	0	-300	0.00	0.00	0	0	0
0014	3T	14_3	254	1	0	100	0	-100	0.00	0.00	0	0	0
0014	3T	14_4	123	31	1	3100	1160	-1940	0.03	0.37	5	2	-3
0014	3T	14_4	124	37	1	3700	1530	-2170	0.03	0.41	6	2	-4
0014	3T	14_4	125	29	3	2900	3060	160	0.10	1.06	5	5	0
0014	3T	14_4	126	17	0	1700	0	-1700	0.00	0.00	3	0	-3
0014	3T	14_4	132	16	2	1600	2500	900	0.13	1.56	2	4	2
0014	3T	14_4	134	31	1	3100	5740	2640	0.03	1.85	5	10	5
0014	3T	14_4	135	11	0	1100	0	-1100	0.00	0.00	1	0	-1
0014	3T	14_4	136	11	1	1100	370	-730	0.09	0.34	1	0	-1
0014	3T	14_4	142	12	2	1200	8570	7370	0.17	7.14	2	15	13
0014	3T	14_4	143	22	0	2200	0	-2200	0.00	0.00	3	0	-3
0014	3T	14_4	145	11	1	1100	1480	380	0.09	1.35	1	2	1
0014	3T	14_4	146	10	0	1000	0	-1000	0.00	0.00	1	0	-1
0014	3T	14_4	152	3	0	300	0	-300	0.00	0.00	0	0	0
0014	3T	14_4	153	5	0	500	0	-500	0.00	0.00	0	0	0
0014	3T	14_4	154	4	0	400	0	-400	0.00	0.00	0	0	0
0014	3T	14_4	156	1	0	100	0	-100	0.00	0.00	0	0	0
0014	3T	14_4	162	5	0	500	0	-500	0.00	0.00	0	0	0
0014	3T	14_4	163	3	0	300	0	-300	0.00	0.00	0	0	0
0014	3T	14_4	165	1	0	100	0	-100	0.00	0.00	0	0	0
0014	3T	14_4	213	3	0	300	0	-300	0.00	0.00	0	0	0
0014	3T	14_4	214	3	0	300	0	-300	0.00	0.00	0	0	0
0014	3T	14_4	215	3	0	300	0	-300	0.00	0.00	0	0	0
0014	3T	14_4	216	4	0	400	0	-400	0.00	0.00	0	0	0
0014	3T	14_4	231	5	0	500	0	-500	0.00	0.00	0	0	0
0014	3T	14_4	234	3	0	300	0	-300	0.00	0.00	0	0	0
0014	3T	14_4	236	1	0	100	0	-100	0.00	0.00	0	0	0
0014	3T	14_4	241	1	0	100	0	-100	0.00	0.00	0	0	0
0014	3T	14_4	243	2	0	200	0	-200	0.00	0.00	0	0	0
0014	3T	14_4	245	2	0	200	0	-200	0.00	0.00	0	0	0
0014	3T	14_4	251	1	0	100	0	-100	0.00	0.00	0	0	0
0014	3T	14_4	253	1	0	100	0	-100	0.00	0.00	0	0	0
0014	3T	14_4	256	1	0	100	0	-100	0.00	0.00	0	0	0
0014	3T	14_4	264	1	0	100	0	-100	0.00	0.00	0	0	0
0014	3T	14_5	123	33	1	3300	510	-2790	0.03	0.15	5	0	-5
0014	3T	14_5	124	16	2	1600	1910	310	0.13	1.19	2	3	1
0014	3T	14_5	125	15	2	1500	3860	2360	0.13	2.57	2	6	4
0014	3T	14_5	126	12	1	1200	1230	30	0.08	1.03	2	2	0
0014	3T	14_5	132	12	0	1200	0	-1200	0.00	0.00	2	0	-2
0014	3T	14_5	134	12	0	1200	0	-1200	0.00	0.00	2	0	-2
0014	3T	14_5	135	11	0	1100	0	-1100	0.00	0.00	1	0	-1
0014	3T	14_5	136	12	0	1200	0	-1200	0.00	0.00	2	0	-2
0014	3T	14_5	142	9	0	900	0	-900	0.00	0.00	1	0	-1
0014	3T	14_5	143	9	0	900	0	-900	0.00	0.00	1	0	-1
0014	3T	14_5	145	5	0	500	0	-500	0.00	0.00	0	0	0
0014	3T	14_5	146	4	0	400	0	-400	0.00	0.00	0	0	0
0014	3T	14_5	152	3	0	300	0	-300	0.00	0.00	0	0	0
0014	3T	14_5	153	5	0	500	0	-500	0.00	0.00	0	0	0
0014	3T	14_5	154	2	0	200	0	-200	0.00	0.00	0	0	0
0014	3T	14_5	156	2	0	200	0	-200	0.00	0.00	0	0	0
0014	3T	14_5	163	1	0	100	0	-100	0.00	0.00	0	0	0
0014	3T	14_5	213	1	0	100	0	-100	0.00	0.00	0	0	0
0014	3T	14_5	214	5	0	500	0	-500	0.00	0.00	0	0	0
0014	3T	14_5	215	1	0	100	0	-100	0.00	0.00	0	0	0
0014	3T	14_5	216	1	0	100	0	-100	0.00	0.00	0	0	0
0014	3T	14_5	231	1	0	100	0	-100	0.00	0.00	0	0	0
0014	3T	14_5	234	1	0	100	0	-100	0.00	0.00	0	0	0
0014	3T	14_5	236	2	0	200	0	-200	0.00	0.00	0	0	0
0014	3T	14_5	241	1	0	100	0	-100	0.00	0.00	0	0	0
0014	3T	14_5	243	1	0	100	0	-100	0.00	0.00	0	0	0
0014	3T	14_5	253	2	0	200	0	-200	0.00	0.00	0	0	0
0014	3T	14_5	264	1	0	100	0	-100	0.00	0.00	0	0	0
0014	3T	14_6	123	3	1	300	1180	880	0.33	3.93	0	2	2
0014	3T	14_6	124	3	0	300	0	-300	0.00	0.00	0	0	0
0014	3T	14_6	125	1	0	100	0	-100	0.00	0.00	0	0	0
0014	3T	14_6	132	1	0	100	0	-100	0.00	0.00	0	0	0
0014	3T	14_6	134	1	0	100	0	-100	0.00	0.00	0	0	0
0014	3T	14_6	143	1	0	100	0	-100	0.00	0.00	0	0	0
0014	3T	14_6	146	1	0	100	0	-100	0.00	0.00	0	0	0
0014	3T	14_6	153	1	0	100	0	-100	0.00	0.00	0	0	0
0014	3T	14_6	154	1	0	100	0	-100	0.00	0.00	0	0	0
0014	3T	14_6	216	2	0	200	0	-200	0.00	0.00	0	0	0
0014	3T	14_6	243	1	0	100	0	-100	0.00	0.00	0	0	0
0014	3T	14_7	123	53	4	5300	3220	-2080	0.08	0.61	9	5	-4
0014	3T	14_7	124	49	3	4900	1850	-3050	0.06	0.38	8	3	-5
0014	3T	14_7	125	31	0	3100	0	-3100	0.00	0.00	5	0	-5
0014	3T	14_7	126	13	0	1300	0	-1300	0.00	0.00	2	0	-2
0014	3T	14_7	132	21	3	2100	4030	1930	0.14	1.92	3	7	4
0014	3T	14_7	134	29	0	2900	0	-2900	0.00	0.00	5	0	-5
0014	3T	14_7	135	24	1	2400	3020	620	0.04	1.26	4	5	1
0014	3T	14_7	136	12	2	1200	8050	6850	0.17	6.71	2	14	12
0014	3T	14_7	142	21	4	2100	3600	1500	0.19	1.71	3	6	3
0014	3T	14_7	143	19	0	1900	0	-1900	0.00	0.00	3	0	-3
0014	3T	14_7	145	13	0	1300	0	-1300	0.00	0.00	2	0	-2
0014	3T	14_7	146	9	0	900	0	-900	0.00	0.00	1	0	-1
0014	3T	14_7	152	7	0	700	0	-700	0.00	0.00	1	0	-1
0014	3T	14_7	153	8	0	800	0	-800	0.00	0.00	1	0	-1
0014	3T	14_7	154	7	0	700	0	-700	0.00	0.00	1	0	-1
0014	3T	14_7	156	4	0	400	0	-400	0.00	0.00	0	0	0
0014	3T	14_7	163	2	0	200	0	-200	0.00	0.00	0	0	0
0014	3T	14_7	164	1	0	100	0	-100	0.00	0.00	0	0	0
0014	3T	14_7	213	5	0	500	0	-500	0.00	0.00	0	0	0
0014	3T	14_7	214	4	0	400	0	-400	0.00	0.00	0	0	0
0014	3T	14_7	215	5	0	500	0	-500	0.00	0.00	0	0	0
0014	3T	14_7	216	4	0	400	0	-400	0.00	0.00	0	0	0
0014	3T	14_7	231	2	0	200	0	-200	0.00	0.00	0	0	0
0014	3T	14_7	235	1	0	100	0	-100	0.00	0.00	0	0	0
0014	3T	14_7	236	2	0	200	0	-200	0.00	0.00	0	0	0
0014	3T	14_7	241	1	0	100	0	-100	0.00	0.00	0	0	0
0014	3T	14_7	243	2	0	200	0	-200	0.00	0.00	0	0	0
0014	3T	14_7	245	1	0	100	0	-100	0.00	0.00	0	0	0
0014	3T	14_7	246	1	0	100	0	-100	0.00	0.00	0	0	0
0014	3T	14_7	253	2	0	200	0	-200	0.00	0.00	0	0	0
0014	3T	14_7	254	2	0	200	0	-200	0.00	0.00	0	0	0
0014	3T	14_7	261	1	0	100	0	-100	0.00	0.00	0	0	0
0014	3T	14_7	263	2	0	200	0	-200	0.00	0.00	0	0	0
0014	3T	14_7	264	1	0	100	0	-100	0.00	0.00	0	0	0
0014	3T	15_1	123	46	2	4600	1940	-2660	0.04	0.42	8	3	-5
0014	3T	15_1	124	50	3	5000	1670	-3330	0.06	0.33	8	2	-6
0014	3T	15_1	125	24	1	2400	870	-1530	0.04	0.36	4	1	-3
0014	3T	15_1	126	30	3	3000	11170	8170	0.10	3.72	5	19	14
0014	3T	15_1	132	25	0	2500	0	-2500	0.00	0.00	4	0	-4
0014	3T	15_1	134	28	3	2800	9880	7080	0.11	3.53	4	17	13
0014	3T	15_1	135	24	0	2400	0	-2400	0.00	0.00	4	0	-4
0014	3T	15_1	136	17	2	1700	2810	1110	0.12	1.65	3	4	1
0014	3T	15_1	142	20	2	2000	1990	-10	0.10	1.00	3	3	0
0014	3T	15_1	143	19	1	1900	1630	-270	0.05	0.86	3	2	-1
0014	3T	15_1	145	7	0	700	0	-700	0.00	0.00	1	0	-1
0014	3T	15_1	146	5	0	500	0	-500	0.00	0.00	0	0	0
0014	3T	15_1	152	6	0	600	0	-600	0.00	0.00	1	0	-1
0014	3T	15_1	153	9	1	900	3980	3080	0.11	4.42	1	7	6
0014	3T	15_1	154	3	1	300	1140	840	0.33	3.80	0	2	2
0014	3T	15_1	156	2	0	200	0	-200	0.00	0.00	0	0	0
0014	3T	15_1	162	2	1	200	1210	1010	0.50	6.05	0	2	2
0014	3T	15_1	163	4	0	400	0	-400	0.00	0.00	0	0	0
0014	3T	15_1	164	2	0	200	0	-200	0.00	0.00	0	0	0
0014	3T	15_1	165	3	0	300	0	-300	0.00	0.00	0	0	0
0014	3T	15_1	213	5	0	500	0	-500	0.00	0.00	0	0	0
0014	3T	15_1	214	3	0	300	0	-300	0.00	0.00	0	0	0
0014	3T	15_1	215	5	0	500	0	-500	0.00	0.00	0	0	0
0014	3T	15_1	216	3	0	300	0	-300	0.00	0.00	0	0	0
0014	3T	15_1	231	2	1	200	1160	960	0.50	5.80	0	2	2
0014	3T	15_1	234	4	0	400	0	-400	0.00	0.00	0	0	0
0014	3T	15_1	235	1	0	100	0	-100	0.00	0.00	0	0	0
0014	3T	15_1	236	1	0	100	0	-100	0.00	0.00	0	0	0
0014	3T	15_1	241	1	0	100	0	-100	0.00	0.00	0	0	0
0014	3T	15_1	243	1	0	100	0	-100	0.00	0.00	0	0	0
0014	3T	15_1	245	2	0	200	0	-200	0.00	0.00	0	0	0
0014	3T	15_1	254	1	0	100	0	-100	0.00	0.00	0	0	0
0014	3T	15_1	261	1	0	100	0	-100	0.00	0.00	0	0	0
0014	3T	15_1	263	1	0	100	0	-100	0.00	0.00	0	0	0
0014	3T	15_1	265	1	0	100	0	-100	0.00	0.00	0	0	0
0014	3T	15_2	123	53	7	5300	7980	2680	0.13	1.51	9	14	5
0014	3T	15_2	124	55	8	5500	7970	2470	0.15	1.45	9	14	5
0014	3T	15_2	125	31	0	3100	0	-3100	0.00	0.00	5	0	-5
0014	3T	15_2	126	20	2	2000	4340	2340	0.10	2.17	3	7	4
0014	3T	15_2	132	28	3	2800	3790	990	0.11	1.35	4	6	2
0014	3T	15_2	134	25	3	2500	8100	5600	0.12	3.24	4	14	10
0014	3T	15_2	135	16	2	1600	1620	20	0.13	1.01	2	2	0
0014	3T	15_2	136	21	2	2100	2360	260	0.10	1.12	3	4	1
0014	3T	15_2	142	24	0	2400	0	-2400	0.00	0.00	4	0	-4
0014	3T	15_2	143	17	0	1700	0	-1700	0.00	0.00	3	0	-3
0014	3T	15_2	145	14	0	1400	0	-1400	0.00	0.00	2	0	-2
0014	3T	15_2	146	12	0	1200	0	-1200	0.00	0.00	2	0	-2
0014	3T	15_2	152	7	1	700	6310	5610	0.14	9.01	1	11	10
0014	3T	15_2	153	4	0	400	0	-400	0.00	0.00	0	0	0
0014	3T	15_2	154	5	0	500	0	-500	0.00	0.00	0	0	0
0014	3T	15_2	156	7	1	700	4000	3300	0.14	5.71	1	7	6
0014	3T	15_2	162	4	0	400	0	-400	0.00	0.00	0	0	0
0014	3T	15_2	163	1	0	100	0	-100	0.00	0.00	0	0	0
0014	3T	15_2	164	3	0	300	0	-300	0.00	0.00	0	0	0
0014	3T	15_2	165	4	0	400	0	-400	0.00	0.00	0	0	0
0014	3T	15_2	213	6	2	600	2610	2010	0.33	4.35	1	4	3
0014	3T	15_2	214	4	0	400	0	-400	0.00	0.00	0	0	0
0014	3T	15_2	215	4	1	400	1260	860	0.25	3.15	0	2	2
0014	3T	15_2	216	3	0	300	0	-300	0.00	0.00	0	0	0
0014	3T	15_2	234	1	0	100	0	-100	0.00	0.00	0	0	0
0014	3T	15_2	235	5	0	500	0	-500	0.00	0.00	0	0	0
0014	3T	15_2	236	4	0	400	0	-400	0.00	0.00	0	0	0
0014	3T	15_2	253	2	0	200	0	-200	0.00	0.00	0	0	0
0014	3T	15_2	256	1	0	100	0	-100	0.00	0.00	0	0	0
0014	3T	15_2	265	1	0	100	0	-100	0.00	0.00	0	0	0
0014	3T	15_3	123	55	5	5500	2990	-2510	0.09	0.54	9	5	-4
0014	3T	15_3	124	55	5	5500	3610	-1890	0.09	0.66	9	6	-3
0014	3T	15_3	125	35	1	3500	940	-2560	0.03	0.27	6	1	-5
0014	3T	15_3	126	25	0	2500	0	-2500	0.00	0.00	4	0	-4
0014	3T	15_3	132	23	1	2300	830	-1470	0.04	0.36	4	1	-3
0014	3T	15_3	134	21	2	2100	2030	-70	0.10	0.97	3	3	0
0014	3T	15_3	135	15	2	1500	1990	490	0.13	1.33	2	3	1
0014	3T	15_3	136	16	1	1600	1160	-440	0.06	0.73	2	2	0
0014	3T	15_3	142	13	2	1300	3570	2270	0.15	2.75	2	6	4
0014	3T	15_3	143	20	1	2000	1130	-870	0.05	0.57	3	2	-1
0014	3T	15_3	145	13	1	1300	890	-410	0.08	0.68	2	1	-1
0014	3T	15_3	146	10	0	1000	0	-1000	0.00	0.00	1	0	-1
0014	3T	15_3	152	6	0	600	0	-600	0.00	0.00	1	0	-1
0014	3T	15_3	153	13	0	1300	0	-1300	0.00	0.00	2	0	-2
0014	3T	15_3	154	9	0	900	0	-900	0.00	0.00	1	0	-1
0014	3T	15_3	156	1	0	100	0	-100	0.00	0.00	0	0	0
0014	3T	15_3	162	2	0	200	0	-200	0.00	0.00	0	0	0
0014	3T	15_3	164	2	0	200	0	-200	0.00	0.00	0	0	0
0014	3T	15_3	213	4	1	400	920	520	0.25	2.30	0	1	1
0014	3T	15_3	214	3	0	300	0	-300	0.00	0.00	0	0	0
0014	3T	15_3	215	4	0	400	0	-400	0.00	0.00	0	0	0
0014	3T	15_3	216	5	1	500	1740	1240	0.20	3.48	0	3	3
0014	3T	15_3	231	1	0	100	0	-100	0.00	0.00	0	0	0
0014	3T	15_3	234	3	0	300	0	-300	0.00	0.00	0	0	0
0014	3T	15_3	236	1	0	100	0	-100	0.00	0.00	0	0	0
0014	3T	15_3	243	1	0	100	0	-100	0.00	0.00	0	0	0
0014	3T	15_3	246	2	1	200	1310	1110	0.50	6.55	0	2	2
0014	3T	15_3	253	2	1	200	2090	1890	0.50	10.45	0	3	3
0014	3T	15_3	256	2	0	200	0	-200	0.00	0.00	0	0	0
0014	3T	15_3	264	1	0	100	0	-100	0.00	0.00	0	0	0
0014	3T	15_4	123	36	4	3600	5080	1480	0.11	1.41	6	8	2
0014	3T	15_4	124	45	4	4500	2900	-1600	0.09	0.64	7	5	-2
0014	3T	15_4	125	22	0	2200	0	-2200	0.00	0.00	3	0	-3
0014	3T	15_4	126	17	1	1700	6070	4370	0.06	3.57	3	10	7
0014	3T	15_4	132	23	3	2300	1630	-670	0.13	0.71	4	2	-2
0014	3T	15_4	134	27	2	2700	1620	-1080	0.07	0.60	4	2	-2
0014	3T	15_4	135	15	2	1500	1550	50	0.13	1.03	2	2	0
0014	3T	15_4	136	18	0	1800	0	-1800	0.00	0.00	3	0	-3
0014	3T	15_4	142	21	4	2100	3980	1880	0.19	1.90	3	7	4
0014	3T	15_4	143	22	1	2200	1680	-520	0.05	0.76	3	2	-1
0014	3T	15_4	145	10	1	1000	620	-380	0.10	0.62	1	1	0
0014	3T	15_4	146	5	0	500	0	-500	0.00	0.00	0	0	0
0014	3T	15_4	152	4	0	400	0	-400	0.00	0.00	0	0	0
0014	3T	15_4	153	6	0	600	0	-600	0.00	0.00	1	0	-1
0014	3T	15_4	154	1	0	100	0	-100	0.00	0.00	0	0	0
0014	3T	15_4	156	5	0	500	0	-500	0.00	0.00	0	0	0
0014	3T	15_4	162	2	0	200	0	-200	0.00	0.00	0	0	0
0014	3T	15_4	163	1	0	100	0	-100	0.00	0.00	0	0	0
0014	3T	15_4	164	6	0	600	0	-600	0.00	0.00	1	0	-1
0014	3T	15_4	165	3	0	300	0	-300	0.00	0.00	0	0	0
0014	3T	15_4	213	5	0	500	0	-500	0.00	0.00	0	0	0
0014	3T	15_4	214	6	0	600	0	-600	0.00	0.00	1	0	-1
0014	3T	15_4	215	1	0	100	0	-100	0.00	0.00	0	0	0
0014	3T	15_4	216	2	0	200	0	-200	0.00	0.00	0	0	0
0014	3T	15_4	234	3	0	300	0	-300	0.00	0.00	0	0	0
0014	3T	15_4	235	3	1	300	1340	1040	0.33	4.47	0	2	2
0014	3T	15_4	241	1	0	100	0	-100	0.00	0.00	0	0	0
0014	3T	15_4	245	3	0	300	0	-300	0.00	0.00	0	0	0
0014	3T	15_4	253	1	0	100	0	-100	0.00	0.00	0	0	0
0014	3T	15_4	254	2	0	200	0	-200	0.00	0.00	0	0	0
0014	3T	15_4	264	1	0	100	0	-100	0.00	0.00	0	0	0
0014	3T	15_5	123	43	8	4300	7650	3350	0.19	1.78	7	13	6
0014	3T	15_5	124	44	1	4400	300	-4100	0.02	0.07	7	0	-7
0014	3T	15_5	125	24	1	2400	1350	-1050	0.04	0.56	4	2	-2
0014	3T	15_5	126	25	0	2500	0	-2500	0.00	0.00	4	0	-4
0014	3T	15_5	132	16	2	1600	1350	-250	0.13	0.84	2	2	0
0014	3T	15_5	134	16	1	1600	690	-910	0.06	0.43	2	1	-1
0014	3T	15_5	135	13	1	1300	1180	-120	0.08	0.91	2	2	0
0014	3T	15_5	136	11	1	1100	2200	1100	0.09	2.00	1	3	2
0014	3T	15_5	142	12	1	1200	770	-430	0.08	0.64	2	1	-1
0014	3T	15_5	143	11	1	1100	1070	-30	0.09	0.97	1	1	0
0014	3T	15_5	145	5	0	500	0	-500	0.00	0.00	0	0	0
0014	3T	15_5	146	1	1	100	700	600	1.00	7.00	0	1	1
0014	3T	15_5	152	6	0	600	0	-600	0.00	0.00	1	0	-1
0014	3T	15_5	153	5	1	500	930	430	0.20	1.86	0	1	1
0014	3T	15_5	154	3	0	300	0	-300	0.00	0.00	0	0	0
0014	3T	15_5	156	3	1	300	1370	1070	0.33	4.57	0	2	2
0014	3T	15_5	162	2	0	200	0	-200	0.00	0.00	0	0	0
0014	3T	15_5	163	3	0	300	0	-300	0.00	0.00	0	0	0
0014	3T	15_5	164	1	0	100	0	-100	0.00	0.00	0	0	0
0014	3T	15_5	165	3	0	300	0	-300	0.00	0.00	0	0	0
0014	3T	15_5	213	1	0	100	0	-100	0.00	0.00	0	0	0
0014	3T	15_5	214	2	0	200	0	-200	0.00	0.00	0	0	0
0014	3T	15_5	215	1	0	100	0	-100	0.00	0.00	0	0	0
0014	3T	15_5	216	2	0	200	0	-200	0.00	0.00	0	0	0
0014	3T	15_5	243	1	0	100	0	-100	0.00	0.00	0	0	0
0014	3T	15_5	253	1	0	100	0	-100	0.00	0.00	0	0	0
0014	3T	15_5	254	2	0	200	0	-200	0.00	0.00	0	0	0
0014	3T	15_5	261	3	0	300	0	-300	0.00	0.00	0	0	0
0014	3T	15_6	123	13	0	1300	0	-1300	0.00	0.00	2	0	-2
0014	3T	15_6	124	8	1	800	830	30	0.13	1.04	1	1	0
0014	3T	15_6	125	2	1	200	2970	2770	0.50	14.85	0	5	5
0014	3T	15_6	126	1	0	100	0	-100	0.00	0.00	0	0	0
0014	3T	15_6	132	1	0	100	0	-100	0.00	0.00	0	0	0
0014	3T	15_6	134	7	0	700	0	-700	0.00	0.00	1	0	-1
0014	3T	15_6	135	4	0	400	0	-400	0.00	0.00	0	0	0
0014	3T	15_6	136	2	0	200	0	-200	0.00	0.00	0	0	0
0014	3T	15_6	142	2	0	200	0	-200	0.00	0.00	0	0	0
0014	3T	15_6	143	1	0	100	0	-100	0.00	0.00	0	0	0
0014	3T	15_6	146	2	0	200	0	-200	0.00	0.00	0	0	0
0014	3T	15_6	153	1	0	100	0	-100	0.00	0.00	0	0	0
0014	3T	15_6	154	2	0	200	0	-200	0.00	0.00	0	0	0
0014	3T	15_6	156	1	0	100	0	-100	0.00	0.00	0	0	0
0014	3T	15_6	216	1	0	100	0	-100	0.00	0.00	0	0	0
0014	3T	15_6	245	1	0	100	0	-100	0.00	0.00	0	0	0
0014	3T	15_7	123	70	8	7000	6680	-320	0.11	0.95	12	11	-1
0014	3T	15_7	124	63	10	6300	6430	130	0.16	1.02	11	11	0
0014	3T	15_7	125	32	2	3200	1950	-1250	0.06	0.61	5	3	-2
0014	3T	15_7	126	31	4	3100	5250	2150	0.13	1.69	5	9	4
0014	3T	15_7	132	29	2	2900	1430	-1470	0.07	0.49	5	2	-3
0014	3T	15_7	134	28	1	2800	1070	-1730	0.04	0.38	4	1	-3
0014	3T	15_7	135	12	1	1200	2600	1400	0.08	2.17	2	4	2
0014	3T	15_7	136	14	0	1400	0	-1400	0.00	0.00	2	0	-2
0014	3T	15_7	142	15	2	1500	1550	50	0.13	1.03	2	2	0
0014	3T	15_7	143	20	2	2000	2260	260	0.10	1.13	3	4	1
0014	3T	15_7	145	13	1	1300	3230	1930	0.08	2.48	2	5	3
0014	3T	15_7	146	9	0	900	0	-900	0.00	0.00	1	0	-1
0014	3T	15_7	152	7	0	700	0	-700	0.00	0.00	1	0	-1
0014	3T	15_7	153	8	0	800	0	-800	0.00	0.00	1	0	-1
0014	3T	15_7	154	6	0	600	0	-600	0.00	0.00	1	0	-1
0014	3T	15_7	156	7	0	700	0	-700	0.00	0.00	1	0	-1
0014	3T	15_7	162	8	0	800	0	-800	0.00	0.00	1	0	-1
0014	3T	15_7	163	4	0	400	0	-400	0.00	0.00	0	0	0
0014	3T	15_7	164	6	0	600	0	-600	0.00	0.00	1	0	-1
0014	3T	15_7	165	1	0	100	0	-100	0.00	0.00	0	0	0
0014	3T	15_7	213	5	0	500	0	-500	0.00	0.00	0	0	0
0014	3T	15_7	214	1	0	100	0	-100	0.00	0.00	0	0	0
0014	3T	15_7	215	3	0	300	0	-300	0.00	0.00	0	0	0
0014	3T	15_7	216	2	0	200	0	-200	0.00	0.00	0	0	0
0014	3T	15_7	234	1	0	100	0	-100	0.00	0.00	0	0	0
0014	3T	15_7	236	1	0	100	0	-100	0.00	0.00	0	0	0
0014	3T	15_7	251	1	0	100	0	-100	0.00	0.00	0	0	0
0014	3T	15_7	261	1	0	100	0	-100	0.00	0.00	0	0	0
0014	3T	16_1	123	66	5	6600	7530	930	0.08	1.14	11	13	2
0014	3T	16_1	124	52	2	5200	2170	-3030	0.04	0.42	9	3	-6
0014	3T	16_1	125	31	1	3100	750	-2350	0.03	0.24	5	1	-4
0014	3T	16_1	126	25	3	2500	4920	2420	0.12	1.97	4	8	4
0014	3T	16_1	132	22	2	2200	1710	-490	0.09	0.78	3	3	0
0014	3T	16_1	134	34	1	3400	860	-2540	0.03	0.25	6	1	-5
0014	3T	16_1	135	24	1	2400	830	-1570	0.04	0.35	4	1	-3
0014	3T	16_1	136	18	0	1800	0	-1800	0.00	0.00	3	0	-3
0014	3T	16_1	142	17	2	1700	4640	2940	0.12	2.73	3	8	5
0014	3T	16_1	143	24	4	2400	3770	1370	0.17	1.57	4	6	2
0014	3T	16_1	145	16	0	1600	0	-1600	0.00	0.00	2	0	-2
0014	3T	16_1	146	10	3	1000	2880	1880	0.30	2.88	1	5	4
0014	3T	16_1	152	9	0	900	0	-900	0.00	0.00	1	0	-1
0014	3T	16_1	153	6	1	600	2240	1640	0.17	3.73	1	3	2
0014	3T	16_1	154	3	0	300	0	-300	0.00	0.00	0	0	0
0014	3T	16_1	156	9	0	900	0	-900	0.00	0.00	1	0	-1
0014	3T	16_1	162	2	0	200	0	-200	0.00	0.00	0	0	0
0014	3T	16_1	163	4	0	400	0	-400	0.00	0.00	0	0	0
0014	3T	16_1	164	3	1	300	2030	1730	0.33	6.77	0	3	3
0014	3T	16_1	165	3	0	300	0	-300	0.00	0.00	0	0	0
0014	3T	16_1	213	7	0	700	0	-700	0.00	0.00	1	0	-1
0014	3T	16_1	214	7	0	700	0	-700	0.00	0.00	1	0	-1
0014	3T	16_1	215	1	0	100	0	-100	0.00	0.00	0	0	0
0014	3T	16_1	216	9	0	900	0	-900	0.00	0.00	1	0	-1
0014	3T	16_1	231	2	0	200	0	-200	0.00	0.00	0	0	0
0014	3T	16_1	235	1	0	100	0	-100	0.00	0.00	0	0	0
0014	3T	16_1	243	1	0	100	0	-100	0.00	0.00	0	0	0
0014	3T	16_1	245	1	0	100	0	-100	0.00	0.00	0	0	0
0014	3T	16_1	246	2	0	200	0	-200	0.00	0.00	0	0	0
0014	3T	16_1	251	1	0	100	0	-100	0.00	0.00	0	0	0
0014	3T	16_2	123	50	4	5000	3220	-1780	0.08	0.64	8	5	-3
0014	3T	16_2	124	65	6	6500	7380	880	0.09	1.14	11	13	2
0014	3T	16_2	125	25	2	2500	3130	630	0.08	1.25	4	5	1
0014	3T	16_2	126	22	2	2200	5020	2820	0.09	2.28	3	8	5
0014	3T	16_2	132	21	1	2100	510	-1590	0.05	0.24	3	0	-3
0014	3T	16_2	134	24	0	2400	0	-2400	0.00	0.00	4	0	-4
0014	3T	16_2	135	15	1	1500	790	-710	0.07	0.53	2	1	-1
0014	3T	16_2	136	15	0	1500	0	-1500	0.00	0.00	2	0	-2
0014	3T	16_2	142	14	1	1400	1230	-170	0.07	0.88	2	2	0
0014	3T	16_2	143	21	1	2100	1660	-440	0.05	0.79	3	2	-1
0014	3T	16_2	145	15	2	1500	1930	430	0.13	1.29	2	3	1
0014	3T	16_2	146	7	0	700	0	-700	0.00	0.00	1	0	-1
0014	3T	16_2	152	12	1	1200	790	-410	0.08	0.66	2	1	-1
0014	3T	16_2	153	4	1	400	1310	910	0.25	3.28	0	2	2
0014	3T	16_2	154	5	0	500	0	-500	0.00	0.00	0	0	0
0014	3T	16_2	156	3	0	300	0	-300	0.00	0.00	0	0	0
0014	3T	16_2	162	2	0	200	0	-200	0.00	0.00	0	0	0
0014	3T	16_2	163	5	0	500	0	-500	0.00	0.00	0	0	0
0014	3T	16_2	164	6	0	600	0	-600	0.00	0.00	1	0	-1
0014	3T	16_2	165	2	0	200	0	-200	0.00	0.00	0	0	0
0014	3T	16_2	213	6	0	600	0	-600	0.00	0.00	1	0	-1
0014	3T	16_2	214	4	0	400	0	-400	0.00	0.00	0	0	0
0014	3T	16_2	215	1	0	100	0	-100	0.00	0.00	0	0	0
0014	3T	16_2	216	5	1	500	3420	2920	0.20	6.84	0	6	6
0014	3T	16_2	231	2	0	200	0	-200	0.00	0.00	0	0	0
0014	3T	16_2	234	2	0	200	0	-200	0.00	0.00	0	0	0
0014	3T	16_2	235	1	0	100	0	-100	0.00	0.00	0	0	0
0014	3T	16_2	236	5	0	500	0	-500	0.00	0.00	0	0	0
0014	3T	16_2	241	1	0	100	0	-100	0.00	0.00	0	0	0
0014	3T	16_2	245	4	0	400	0	-400	0.00	0.00	0	0	0
0014	3T	16_2	246	2	0	200	0	-200	0.00	0.00	0	0	0
0014	3T	16_2	251	1	0	100	0	-100	0.00	0.00	0	0	0
0014	3T	16_2	254	3	0	300	0	-300	0.00	0.00	0	0	0
0014	3T	16_2	256	2	0	200	0	-200	0.00	0.00	0	0	0
0014	3T	16_2	261	2	0	200	0	-200	0.00	0.00	0	0	0
0014	3T	16_2	263	3	0	300	0	-300	0.00	0.00	0	0	0
0014	3T	16_2	264	2	0	200	0	-200	0.00	0.00	0	0	0
0014	3T	16_3	123	43	3	4300	3390	-910	0.07	0.79	7	6	-1
0014	3T	16_3	124	51	5	5100	7100	2000	0.10	1.39	9	12	3
0014	3T	16_3	125	32	3	3200	1620	-1580	0.09	0.51	5	2	-3
0014	3T	16_3	126	13	1	1300	1010	-290	0.08	0.78	2	1	-1
0014	3T	16_3	132	30	2	3000	1130	-1870	0.07	0.38	5	2	-3
0014	3T	16_3	134	26	3	2600	3510	910	0.12	1.35	4	6	2
0014	3T	16_3	135	20	1	2000	920	-1080	0.05	0.46	3	1	-2
0014	3T	16_3	136	24	2	2400	5570	3170	0.08	2.32	4	9	5
0014	3T	16_3	142	16	4	1600	4890	3290	0.25	3.06	2	8	6
0014	3T	16_3	143	16	2	1600	2740	1140	0.13	1.71	2	4	2
0014	3T	16_3	145	7	0	700	0	-700	0.00	0.00	1	0	-1
0014	3T	16_3	146	8	0	800	0	-800	0.00	0.00	1	0	-1
0014	3T	16_3	152	12	0	1200	0	-1200	0.00	0.00	2	0	-2
0014	3T	16_3	153	7	0	700	0	-700	0.00	0.00	1	0	-1
0014	3T	16_3	154	4	0	400	0	-400	0.00	0.00	0	0	0
0014	3T	16_3	156	2	0	200	0	-200	0.00	0.00	0	0	0
0014	3T	16_3	162	5	0	500	0	-500	0.00	0.00	0	0	0
0014	3T	16_3	163	1	0	100	0	-100	0.00	0.00	0	0	0
0014	3T	16_3	164	1	0	100	0	-100	0.00	0.00	0	0	0
0014	3T	16_3	165	2	0	200	0	-200	0.00	0.00	0	0	0
0014	3T	16_3	213	6	1	600	5180	4580	0.17	8.63	1	9	8
0014	3T	16_3	214	5	0	500	0	-500	0.00	0.00	0	0	0
0014	3T	16_3	215	6	0	600	0	-600	0.00	0.00	1	0	-1
0014	3T	16_3	216	1	0	100	0	-100	0.00	0.00	0	0	0
0014	3T	16_3	231	6	0	600	0	-600	0.00	0.00	1	0	-1
0014	3T	16_3	234	1	0	100	0	-100	0.00	0.00	0	0	0
0014	3T	16_3	235	3	1	300	780	480	0.33	2.60	0	1	1
0014	3T	16_3	236	4	0	400	0	-400	0.00	0.00	0	0	0
0014	3T	16_3	246	2	0	200	0	-200	0.00	0.00	0	0	0
0014	3T	16_3	251	2	0	200	0	-200	0.00	0.00	0	0	0
0014	3T	16_3	253	1	0	100	0	-100	0.00	0.00	0	0	0
0014	3T	16_3	256	1	0	100	0	-100	0.00	0.00	0	0	0
0014	3T	16_3	263	2	0	200	0	-200	0.00	0.00	0	0	0
0014	3T	16_4	123	57	7	5700	5920	220	0.12	1.04	10	10	0
0014	3T	16_4	124	38	1	3800	920	-2880	0.03	0.24	6	1	-5
0014	3T	16_4	125	27	2	2700	1390	-1310	0.07	0.51	4	2	-2
0014	3T	16_4	126	22	3	2200	3740	1540	0.14	1.70	3	6	3
0014	3T	16_4	132	29	3	2900	4110	1210	0.10	1.42	5	7	2
0014	3T	16_4	134	32	3	3200	7820	4620	0.09	2.44	5	13	8
0014	3T	16_4	135	20	1	2000	3030	1030	0.05	1.52	3	5	2
0014	3T	16_4	136	15	0	1500	0	-1500	0.00	0.00	2	0	-2
0014	3T	16_4	142	17	2	1700	1930	230	0.12	1.14	3	3	0
0014	3T	16_4	143	10	1	1000	890	-110	0.10	0.89	1	1	0
0014	3T	16_4	145	10	0	1000	0	-1000	0.00	0.00	1	0	-1
0014	3T	16_4	146	7	0	700	0	-700	0.00	0.00	1	0	-1
0014	3T	16_4	152	7	0	700	0	-700	0.00	0.00	1	0	-1
0014	3T	16_4	153	5	1	500	4020	3520	0.20	8.04	0	7	7
0014	3T	16_4	154	4	0	400	0	-400	0.00	0.00	0	0	0
0014	3T	16_4	156	2	0	200	0	-200	0.00	0.00	0	0	0
0014	3T	16_4	162	6	0	600	0	-600	0.00	0.00	1	0	-1
0014	3T	16_4	163	2	0	200	0	-200	0.00	0.00	0	0	0
0014	3T	16_4	164	2	0	200	0	-200	0.00	0.00	0	0	0
0014	3T	16_4	213	5	0	500	0	-500	0.00	0.00	0	0	0
0014	3T	16_4	214	3	0	300	0	-300	0.00	0.00	0	0	0
0014	3T	16_4	215	3	0	300	0	-300	0.00	0.00	0	0	0
0014	3T	16_4	216	2	0	200	0	-200	0.00	0.00	0	0	0
0014	3T	16_4	231	1	0	100	0	-100	0.00	0.00	0	0	0
0014	3T	16_4	234	2	0	200	0	-200	0.00	0.00	0	0	0
0014	3T	16_4	235	3	0	300	0	-300	0.00	0.00	0	0	0
0014	3T	16_4	236	1	0	100	0	-100	0.00	0.00	0	0	0
0014	3T	16_4	241	1	0	100	0	-100	0.00	0.00	0	0	0
0014	3T	16_4	243	2	0	200	0	-200	0.00	0.00	0	0	0
0014	3T	16_4	245	4	0	400	0	-400	0.00	0.00	0	0	0
0014	3T	16_4	246	1	0	100	0	-100	0.00	0.00	0	0	0
0014	3T	16_4	251	1	0	100	0	-100	0.00	0.00	0	0	0
0014	3T	16_4	253	4	1	400	2810	2410	0.25	7.03	0	4	4
0014	3T	16_4	263	1	0	100	0	-100	0.00	0.00	0	0	0
0014	3T	16_5	123	63	5	6300	3060	-3240	0.08	0.49	11	5	-6
0014	3T	16_5	124	47	4	4700	4730	30	0.09	1.01	8	8	0
0014	3T	16_5	125	27	2	2700	5330	2630	0.07	1.97	4	9	5
0014	3T	16_5	126	23	2	2300	5490	3190	0.09	2.39	4	9	5
0014	3T	16_5	132	27	1	2700	470	-2230	0.04	0.17	4	0	-4
0014	3T	16_5	134	26	1	2600	1950	-650	0.04	0.75	4	3	-1
0014	3T	16_5	135	15	1	1500	1080	-420	0.07	0.72	2	1	-1
0014	3T	16_5	136	16	1	1600	5150	3550	0.06	3.22	2	9	7
0014	3T	16_5	142	16	1	1600	1420	-180	0.06	0.89	2	2	0
0014	3T	16_5	143	19	0	1900	0	-1900	0.00	0.00	3	0	-3
0014	3T	16_5	145	15	0	1500	0	-1500	0.00	0.00	2	0	-2
0014	3T	16_5	146	10	0	1000	0	-1000	0.00	0.00	1	0	-1
0014	3T	16_5	152	4	0	400	0	-400	0.00	0.00	0	0	0
0014	3T	16_5	153	1	0	100	0	-100	0.00	0.00	0	0	0
0014	3T	16_5	154	6	0	600	0	-600	0.00	0.00	1	0	-1
0014	3T	16_5	156	1	0	100	0	-100	0.00	0.00	0	0	0
0014	3T	16_5	162	2	0	200	0	-200	0.00	0.00	0	0	0
0014	3T	16_5	163	2	0	200	0	-200	0.00	0.00	0	0	0
0014	3T	16_5	164	2	0	200	0	-200	0.00	0.00	0	0	0
0014	3T	16_5	165	1	0	100	0	-100	0.00	0.00	0	0	0
0014	3T	16_5	214	2	1	200	3010	2810	0.50	15.05	0	5	5
0014	3T	16_5	215	1	0	100	0	-100	0.00	0.00	0	0	0
0014	3T	16_5	231	1	0	100	0	-100	0.00	0.00	0	0	0
0014	3T	16_5	235	2	0	200	0	-200	0.00	0.00	0	0	0
0014	3T	16_5	236	1	0	100	0	-100	0.00	0.00	0	0	0
0014	3T	16_5	246	1	0	100	0	-100	0.00	0.00	0	0	0
0014	3T	16_5	251	1	0	100	0	-100	0.00	0.00	0	0	0
0014	3T	16_7	123	62	5	6200	2740	-3460	0.08	0.44	10	4	-6
0014	3T	16_7	124	52	3	5200	2160	-3040	0.06	0.42	9	3	-6
0014	3T	16_7	125	40	4	4000	6990	2990	0.10	1.75	7	12	5
0014	3T	16_7	126	27	2	2700	4780	2080	0.07	1.77	4	8	4
0014	3T	16_7	132	27	1	2700	630	-2070	0.04	0.23	4	1	-3
0014	3T	16_7	134	31	1	3100	1450	-1650	0.03	0.47	5	2	-3
0014	3T	16_7	135	26	1	2600	1450	-1150	0.04	0.56	4	2	-2
0014	3T	16_7	136	16	0	1600	0	-1600	0.00	0.00	2	0	-2
0014	3T	16_7	142	20	1	2000	680	-1320	0.05	0.34	3	1	-2
0014	3T	16_7	143	25	1	2500	640	-1860	0.04	0.26	4	1	-3
0014	3T	16_7	145	13	1	1300	2040	740	0.08	1.57	2	3	1
0014	3T	16_7	146	10	1	1000	1120	120	0.10	1.12	1	1	0
0014	3T	16_7	152	11	1	1100	1960	860	0.09	1.78	1	3	2
0014	3T	16_7	153	4	0	400	0	-400	0.00	0.00	0	0	0
0014	3T	16_7	154	5	0	500	0	-500	0.00	0.00	0	0	0
0014	3T	16_7	156	3	0	300	0	-300	0.00	0.00	0	0	0
0014	3T	16_7	162	3	0	300	0	-300	0.00	0.00	0	0	0
0014	3T	16_7	163	10	2	1000	1880	880	0.20	1.88	1	3	2
0014	3T	16_7	164	5	0	500	0	-500	0.00	0.00	0	0	0
0014	3T	16_7	165	1	0	100	0	-100	0.00	0.00	0	0	0
0014	3T	16_7	213	2	0	200	0	-200	0.00	0.00	0	0	0
0014	3T	16_7	214	1	0	100	0	-100	0.00	0.00	0	0	0
0014	3T	16_7	215	1	0	100	0	-100	0.00	0.00	0	0	0
0014	3T	16_7	216	3	0	300	0	-300	0.00	0.00	0	0	0
0014	3T	16_7	231	1	0	100	0	-100	0.00	0.00	0	0	0
0014	3T	16_7	234	1	0	100	0	-100	0.00	0.00	0	0	0
0014	3T	16_7	236	3	0	300	0	-300	0.00	0.00	0	0	0
0014	3T	16_7	241	1	0	100	0	-100	0.00	0.00	0	0	0
0014	3T	16_7	264	1	0	100	0	-100	0.00	0.00	0	0	0
0014	3T	17_1	123	59	6	5900	5190	-710	0.10	0.88	10	9	-1
0014	3T	17_1	124	44	1	4400	2930	-1470	0.02	0.67	7	5	-2
0014	3T	17_1	125	24	1	2400	420	-1980	0.04	0.18	4	0	-4
0014	3T	17_1	126	26	1	2600	1090	-1510	0.04	0.42	4	1	-3
0014	3T	17_1	132	38	2	3800	2220	-1580	0.05	0.58	6	3	-3
0014	3T	17_1	134	35	3	3500	3030	-470	0.09	0.87	6	5	-1
0014	3T	17_1	135	24	1	2400	520	-1880	0.04	0.22	4	0	-4
0014	3T	17_1	136	12	0	1200	0	-1200	0.00	0.00	2	0	-2
0014	3T	17_1	142	22	1	2200	1020	-1180	0.05	0.46	3	1	-2
0014	3T	17_1	143	16	1	1600	920	-680	0.06	0.58	2	1	-1
0014	3T	17_1	145	11	2	1100	3540	2440	0.18	3.22	1	6	5
0014	3T	17_1	146	5	0	500	0	-500	0.00	0.00	0	0	0
0014	3T	17_1	152	8	0	800	0	-800	0.00	0.00	1	0	-1
0014	3T	17_1	153	14	0	1400	0	-1400	0.00	0.00	2	0	-2
0014	3T	17_1	154	6	0	600	0	-600	0.00	0.00	1	0	-1
0014	3T	17_1	156	1	0	100	0	-100	0.00	0.00	0	0	0
0014	3T	17_1	162	1	0	100	0	-100	0.00	0.00	0	0	0
0014	3T	17_1	164	1	0	100	0	-100	0.00	0.00	0	0	0
0014	3T	17_1	165	1	0	100	0	-100	0.00	0.00	0	0	0
0014	3T	17_1	213	3	0	300	0	-300	0.00	0.00	0	0	0
0014	3T	17_1	214	3	0	300	0	-300	0.00	0.00	0	0	0
0014	3T	17_1	215	4	0	400	0	-400	0.00	0.00	0	0	0
0014	3T	17_1	216	5	0	500	0	-500	0.00	0.00	0	0	0
0014	3T	17_1	234	4	0	400	0	-400	0.00	0.00	0	0	0
0014	3T	17_1	235	4	0	400	0	-400	0.00	0.00	0	0	0
0014	3T	17_1	236	1	0	100	0	-100	0.00	0.00	0	0	0
0014	3T	17_1	243	1	0	100	0	-100	0.00	0.00	0	0	0
0014	3T	17_1	246	2	0	200	0	-200	0.00	0.00	0	0	0
0014	3T	17_1	253	2	0	200	0	-200	0.00	0.00	0	0	0
0014	3T	17_1	261	1	0	100	0	-100	0.00	0.00	0	0	0
0014	3T	17_1	263	1	0	100	0	-100	0.00	0.00	0	0	0
0014	3T	17_1	265	1	0	100	0	-100	0.00	0.00	0	0	0
0014	3T	17_2	123	57	6	5700	4950	-750	0.11	0.87	10	8	-2
0014	3T	17_2	124	52	7	5200	6180	980	0.13	1.19	9	10	1
0014	3T	17_2	125	35	2	3500	7770	4270	0.06	2.22	6	13	7
0014	3T	17_2	126	19	1	1900	4780	2880	0.05	2.52	3	8	5
0014	3T	17_2	132	34	4	3400	3330	-70	0.12	0.98	6	5	-1
0014	3T	17_2	134	31	2	3100	1310	-1790	0.06	0.42	5	2	-3
0014	3T	17_2	135	20	0	2000	0	-2000	0.00	0.00	3	0	-3
0014	3T	17_2	136	15	0	1500	0	-1500	0.00	0.00	2	0	-2
0014	3T	17_2	142	18	1	1800	1020	-780	0.06	0.57	3	1	-2
0014	3T	17_2	143	19	0	1900	0	-1900	0.00	0.00	3	0	-3
0014	3T	17_2	145	13	0	1300	0	-1300	0.00	0.00	2	0	-2
0014	3T	17_2	146	10	0	1000	0	-1000	0.00	0.00	1	0	-1
0014	3T	17_2	152	6	0	600	0	-600	0.00	0.00	1	0	-1
0014	3T	17_2	153	4	0	400	0	-400	0.00	0.00	0	0	0
0014	3T	17_2	154	2	0	200	0	-200	0.00	0.00	0	0	0
0014	3T	17_2	156	4	0	400	0	-400	0.00	0.00	0	0	0
0014	3T	17_2	162	3	0	300	0	-300	0.00	0.00	0	0	0
0014	3T	17_2	163	1	0	100	0	-100	0.00	0.00	0	0	0
0014	3T	17_2	164	2	0	200	0	-200	0.00	0.00	0	0	0
0014	3T	17_2	165	1	0	100	0	-100	0.00	0.00	0	0	0
0014	3T	17_2	213	6	1	600	1910	1310	0.17	3.18	1	3	2
0014	3T	17_2	214	6	0	600	0	-600	0.00	0.00	1	0	-1
0014	3T	17_2	215	4	0	400	0	-400	0.00	0.00	0	0	0
0014	3T	17_2	216	3	0	300	0	-300	0.00	0.00	0	0	0
0014	3T	17_2	231	2	0	200	0	-200	0.00	0.00	0	0	0
0014	3T	17_2	234	1	0	100	0	-100	0.00	0.00	0	0	0
0014	3T	17_2	235	4	0	400	0	-400	0.00	0.00	0	0	0
0014	3T	17_2	236	1	0	100	0	-100	0.00	0.00	0	0	0
0014	3T	17_2	241	1	0	100	0	-100	0.00	0.00	0	0	0
0014	3T	17_2	243	3	0	300	0	-300	0.00	0.00	0	0	0
0014	3T	17_2	245	1	0	100	0	-100	0.00	0.00	0	0	0
0014	3T	17_2	251	2	1	200	2380	2180	0.50	11.90	0	4	4
0014	3T	17_2	253	2	0	200	0	-200	0.00	0.00	0	0	0
0014	3T	17_2	261	1	0	100	0	-100	0.00	0.00	0	0	0
0014	3T	17_2	263	1	1	100	5270	5170	1.00	52.70	0	9	9
0014	3T	17_3	123	52	8	5200	10940	5740	0.15	2.10	9	19	10
0014	3T	17_3	124	57	4	5700	4670	-1030	0.07	0.82	10	8	-2
0014	3T	17_3	125	28	4	2800	4150	1350	0.14	1.48	4	7	3
0014	3T	17_3	126	22	0	2200	0	-2200	0.00	0.00	3	0	-3
0014	3T	17_3	132	29	3	2900	1900	-1000	0.10	0.66	5	3	-2
0014	3T	17_3	134	26	2	2600	1720	-880	0.08	0.66	4	3	-1
0014	3T	17_3	135	24	2	2400	4840	2440	0.08	2.02	4	8	4
0014	3T	17_3	136	15	0	1500	0	-1500	0.00	0.00	2	0	-2
0014	3T	17_3	142	16	1	1600	1880	280	0.06	1.18	2	3	1
0014	3T	17_3	143	19	1	1900	4600	2700	0.05	2.42	3	8	5
0014	3T	17_3	145	8	1	800	1940	1140	0.13	2.43	1	3	2
0014	3T	17_3	146	12	1	1200	1920	720	0.08	1.60	2	3	1
0014	3T	17_3	152	8	1	800	4090	3290	0.13	5.11	1	7	6
0014	3T	17_3	153	7	1	700	2370	1670	0.14	3.39	1	4	3
0014	3T	17_3	154	5	0	500	0	-500	0.00	0.00	0	0	0
0014	3T	17_3	156	3	0	300	0	-300	0.00	0.00	0	0	0
0014	3T	17_3	162	2	0	200	0	-200	0.00	0.00	0	0	0
0014	3T	17_3	163	4	0	400	0	-400	0.00	0.00	0	0	0
0014	3T	17_3	164	2	0	200	0	-200	0.00	0.00	0	0	0
0014	3T	17_3	213	9	0	900	0	-900	0.00	0.00	1	0	-1
0014	3T	17_3	214	5	0	500	0	-500	0.00	0.00	0	0	0
0014	3T	17_3	215	4	1	400	1690	1290	0.25	4.23	0	2	2
0014	3T	17_3	216	5	0	500	0	-500	0.00	0.00	0	0	0
0014	3T	17_3	231	3	0	300	0	-300	0.00	0.00	0	0	0
0014	3T	17_3	234	1	0	100	0	-100	0.00	0.00	0	0	0
0014	3T	17_3	235	4	0	400	0	-400	0.00	0.00	0	0	0
0014	3T	17_3	241	2	0	200	0	-200	0.00	0.00	0	0	0
0014	3T	17_3	243	3	0	300	0	-300	0.00	0.00	0	0	0
0014	3T	17_3	245	1	0	100	0	-100	0.00	0.00	0	0	0
0014	3T	17_3	246	1	0	100	0	-100	0.00	0.00	0	0	0
0014	3T	17_3	253	1	0	100	0	-100	0.00	0.00	0	0	0
0014	3T	17_3	254	2	0	200	0	-200	0.00	0.00	0	0	0
0014	3T	17_3	263	1	0	100	0	-100	0.00	0.00	0	0	0
0014	3T	17_3	264	2	0	200	0	-200	0.00	0.00	0	0	0
0014	3T	17_4	123	46	4	4600	3910	-690	0.09	0.85	8	6	-2
0014	3T	17_4	124	35	4	3500	5790	2290	0.11	1.65	6	10	4
0014	3T	17_4	125	32	1	3200	480	-2720	0.03	0.15	5	0	-5
0014	3T	17_4	126	13	1	1300	1150	-150	0.08	0.88	2	2	0
0014	3T	17_4	132	34	3	3400	6250	2850	0.09	1.84	6	11	5
0014	3T	17_4	134	31	3	3100	1900	-1200	0.10	0.61	5	3	-2
0014	3T	17_4	135	16	1	1600	660	-940	0.06	0.41	2	1	-1
0014	3T	17_4	136	11	1	1100	1150	50	0.09	1.05	1	2	1
0014	3T	17_4	142	16	1	1600	800	-800	0.06	0.50	2	1	-1
0014	3T	17_4	143	19	2	1900	3700	1800	0.11	1.95	3	6	3
0014	3T	17_4	145	7	0	700	0	-700	0.00	0.00	1	0	-1
0014	3T	17_4	146	8	1	800	780	-20	0.13	0.98	1	1	0
0014	3T	17_4	152	7	0	700	0	-700	0.00	0.00	1	0	-1
0014	3T	17_4	153	8	1	800	1900	1100	0.13	2.38	1	3	2
0014	3T	17_4	154	4	0	400	0	-400	0.00	0.00	0	0	0
0014	3T	17_4	156	2	0	200	0	-200	0.00	0.00	0	0	0
0014	3T	17_4	162	2	0	200	0	-200	0.00	0.00	0	0	0
0014	3T	17_4	163	1	0	100	0	-100	0.00	0.00	0	0	0
0014	3T	17_4	164	2	0	200	0	-200	0.00	0.00	0	0	0
0014	3T	17_4	213	5	1	500	500	0	0.20	1.00	0	0	0
0014	3T	17_4	214	2	0	200	0	-200	0.00	0.00	0	0	0
0014	3T	17_4	215	1	0	100	0	-100	0.00	0.00	0	0	0
0014	3T	17_4	216	3	0	300	0	-300	0.00	0.00	0	0	0
0014	3T	17_4	231	4	0	400	0	-400	0.00	0.00	0	0	0
0014	3T	17_4	234	4	1	400	1420	1020	0.25	3.55	0	2	2
0014	3T	17_4	235	1	0	100	0	-100	0.00	0.00	0	0	0
0014	3T	17_4	236	2	0	200	0	-200	0.00	0.00	0	0	0
0014	3T	17_4	243	1	0	100	0	-100	0.00	0.00	0	0	0
0014	3T	17_4	245	2	0	200	0	-200	0.00	0.00	0	0	0
0014	3T	17_4	246	3	0	300	0	-300	0.00	0.00	0	0	0
0014	3T	17_4	253	1	0	100	0	-100	0.00	0.00	0	0	0
0014	3T	17_4	254	1	0	100	0	-100	0.00	0.00	0	0	0
0014	3T	17_4	256	1	0	100	0	-100	0.00	0.00	0	0	0
0014	3T	17_4	261	1	0	100	0	-100	0.00	0.00	0	0	0
0014	3T	17_5	123	53	5	5300	2840	-2460	0.09	0.54	9	5	-4
0014	3T	17_5	124	57	4	5700	2370	-3330	0.07	0.42	10	4	-6
0014	3T	17_5	125	23	1	2300	5070	2770	0.04	2.20	4	8	4
0014	3T	17_5	126	15	0	1500	0	-1500	0.00	0.00	2	0	-2
0014	3T	17_5	132	24	4	2400	3350	950	0.17	1.40	4	5	1
0014	3T	17_5	134	11	0	1100	0	-1100	0.00	0.00	1	0	-1
0014	3T	17_5	135	20	2	2000	2580	580	0.10	1.29	3	4	1
0014	3T	17_5	136	6	0	600	0	-600	0.00	0.00	1	0	-1
0014	3T	17_5	142	17	5	1700	6710	5010	0.29	3.95	3	11	8
0014	3T	17_5	143	12	0	1200	0	-1200	0.00	0.00	2	0	-2
0014	3T	17_5	145	6	0	600	0	-600	0.00	0.00	1	0	-1
0014	3T	17_5	146	5	0	500	0	-500	0.00	0.00	0	0	0
0014	3T	17_5	152	5	1	500	3610	3110	0.20	7.22	0	6	6
0014	3T	17_5	153	8	0	800	0	-800	0.00	0.00	1	0	-1
0014	3T	17_5	154	4	0	400	0	-400	0.00	0.00	0	0	0
0014	3T	17_5	156	4	0	400	0	-400	0.00	0.00	0	0	0
0014	3T	17_5	163	3	1	300	630	330	0.33	2.10	0	1	1
0014	3T	17_5	165	1	0	100	0	-100	0.00	0.00	0	0	0
0014	3T	17_5	213	3	0	300	0	-300	0.00	0.00	0	0	0
0014	3T	17_5	214	4	0	400	0	-400	0.00	0.00	0	0	0
0014	3T	17_5	234	2	0	200	0	-200	0.00	0.00	0	0	0
0014	3T	17_5	241	1	0	100	0	-100	0.00	0.00	0	0	0
0014	3T	17_5	246	1	0	100	0	-100	0.00	0.00	0	0	0
0014	3T	17_5	253	1	0	100	0	-100	0.00	0.00	0	0	0
0014	3T	17_5	256	1	0	100	0	-100	0.00	0.00	0	0	0
0014	3T	17_7	123	67	4	6700	5480	-1220	0.06	0.82	11	9	-2
0014	3T	17_7	124	60	0	6000	0	-6000	0.00	0.00	10	0	-10
0014	3T	17_7	125	45	2	4500	4470	-30	0.04	0.99	7	7	0
0014	3T	17_7	126	23	0	2300	0	-2300	0.00	0.00	4	0	-4
0014	3T	17_7	132	26	1	2600	1450	-1150	0.04	0.56	4	2	-2
0014	3T	17_7	134	32	1	3200	2340	-860	0.03	0.73	5	4	-1
0014	3T	17_7	135	25	0	2500	0	-2500	0.00	0.00	4	0	-4
0014	3T	17_7	136	13	0	1300	0	-1300	0.00	0.00	2	0	-2
0014	3T	17_7	142	15	0	1500	0	-1500	0.00	0.00	2	0	-2
0014	3T	17_7	143	20	2	2000	3040	1040	0.10	1.52	3	5	2
0014	3T	17_7	145	12	0	1200	0	-1200	0.00	0.00	2	0	-2
0014	3T	17_7	146	6	0	600	0	-600	0.00	0.00	1	0	-1
0014	3T	17_7	152	5	0	500	0	-500	0.00	0.00	0	0	0
0014	3T	17_7	153	4	0	400	0	-400	0.00	0.00	0	0	0
0014	3T	17_7	154	6	1	600	6280	5680	0.17	10.47	1	11	10
0014	3T	17_7	156	1	0	100	0	-100	0.00	0.00	0	0	0
0014	3T	17_7	162	3	0	300	0	-300	0.00	0.00	0	0	0
0014	3T	17_7	163	1	0	100	0	-100	0.00	0.00	0	0	0
0014	3T	17_7	164	2	0	200	0	-200	0.00	0.00	0	0	0
0014	3T	17_7	213	5	0	500	0	-500	0.00	0.00	0	0	0
0014	3T	17_7	214	2	0	200	0	-200	0.00	0.00	0	0	0
0014	3T	17_7	215	3	0	300	0	-300	0.00	0.00	0	0	0
0014	3T	17_7	216	5	0	500	0	-500	0.00	0.00	0	0	0
0014	3T	17_7	234	3	0	300	0	-300	0.00	0.00	0	0	0
0014	3T	17_7	235	2	0	200	0	-200	0.00	0.00	0	0	0
0014	3T	17_7	236	2	0	200	0	-200	0.00	0.00	0	0	0
0014	3T	17_7	243	1	0	100	0	-100	0.00	0.00	0	0	0
0014	3T	17_7	245	2	0	200	0	-200	0.00	0.00	0	0	0
0014	3T	17_7	256	1	0	100	0	-100	0.00	0.00	0	0	0
0014	3T	17_7	261	1	0	100	0	-100	0.00	0.00	0	0	0
0014	3T	17_7	263	1	0	100	0	-100	0.00	0.00	0	0	0
0014	3T	18_1	123	48	3	4800	2960	-1840	0.06	0.62	8	5	-3
0014	3T	18_1	124	48	7	4800	9090	4290	0.15	1.89	8	16	8
0014	3T	18_1	125	33	5	3300	4960	1660	0.15	1.50	5	8	3
0014	3T	18_1	126	27	0	2700	0	-2700	0.00	0.00	4	0	-4
0014	3T	18_1	132	29	4	2900	6420	3520	0.14	2.21	5	11	6
0014	3T	18_1	134	41	4	4100	4520	420	0.10	1.10	7	8	1
0014	3T	18_1	135	20	1	2000	3090	1090	0.05	1.55	3	5	2
0014	3T	18_1	136	15	0	1500	0	-1500	0.00	0.00	2	0	-2
0014	3T	18_1	142	32	1	3200	4080	880	0.03	1.28	5	7	2
0014	3T	18_1	143	19	1	1900	1660	-240	0.05	0.87	3	2	-1
0014	3T	18_1	145	10	0	1000	0	-1000	0.00	0.00	1	0	-1
0014	3T	18_1	146	6	1	600	870	270	0.17	1.45	1	1	0
0014	3T	18_1	152	11	2	1100	4810	3710	0.18	4.37	1	8	7
0014	3T	18_1	153	4	0	400	0	-400	0.00	0.00	0	0	0
0014	3T	18_1	154	4	0	400	0	-400	0.00	0.00	0	0	0
0014	3T	18_1	156	2	0	200	0	-200	0.00	0.00	0	0	0
0014	3T	18_1	163	3	0	300	0	-300	0.00	0.00	0	0	0
0014	3T	18_1	164	3	0	300	0	-300	0.00	0.00	0	0	0
0014	3T	18_1	165	1	0	100	0	-100	0.00	0.00	0	0	0
0014	3T	18_1	213	10	0	1000	0	-1000	0.00	0.00	1	0	-1
0014	3T	18_1	214	6	1	600	2130	1530	0.17	3.55	1	3	2
0014	3T	18_1	215	4	0	400	0	-400	0.00	0.00	0	0	0
0014	3T	18_1	216	3	0	300	0	-300	0.00	0.00	0	0	0
0014	3T	18_1	231	1	0	100	0	-100	0.00	0.00	0	0	0
0014	3T	18_1	234	6	0	600	0	-600	0.00	0.00	1	0	-1
0014	3T	18_1	235	4	1	400	650	250	0.25	1.63	0	1	1
0014	3T	18_1	236	3	0	300	0	-300	0.00	0.00	0	0	0
0014	3T	18_1	243	5	0	500	0	-500	0.00	0.00	0	0	0
0014	3T	18_1	245	2	0	200	0	-200	0.00	0.00	0	0	0
0014	3T	18_1	246	6	0	600	0	-600	0.00	0.00	1	0	-1
0014	3T	18_1	251	1	0	100	0	-100	0.00	0.00	0	0	0
0014	3T	18_1	253	2	1	200	1620	1420	0.50	8.10	0	2	2
0014	3T	18_1	264	3	0	300	0	-300	0.00	0.00	0	0	0
0014	3T	18_2	123	54	6	5400	6710	1310	0.11	1.24	9	11	2
0014	3T	18_2	124	60	3	6000	6100	100	0.05	1.02	10	10	0
0014	3T	18_2	125	35	0	3500	0	-3500	0.00	0.00	6	0	-6
0014	3T	18_2	126	21	3	2100	6360	4260	0.14	3.03	3	11	8
0014	3T	18_2	132	34	0	3400	0	-3400	0.00	0.00	6	0	-6
0014	3T	18_2	134	23	1	2300	670	-1630	0.04	0.29	4	1	-3
0014	3T	18_2	135	16	0	1600	0	-1600	0.00	0.00	2	0	-2
0014	3T	18_2	136	12	0	1200	0	-1200	0.00	0.00	2	0	-2
0014	3T	18_2	142	27	1	2700	1440	-1260	0.04	0.53	4	2	-2
0014	3T	18_2	143	27	0	2700	0	-2700	0.00	0.00	4	0	-4
0014	3T	18_2	145	20	1	2000	1910	-90	0.05	0.96	3	3	0
0014	3T	18_2	146	8	0	800	0	-800	0.00	0.00	1	0	-1
0014	3T	18_2	152	8	0	800	0	-800	0.00	0.00	1	0	-1
0014	3T	18_2	153	5	0	500	0	-500	0.00	0.00	0	0	0
0014	3T	18_2	154	5	1	500	4400	3900	0.20	8.80	0	7	7
0014	3T	18_2	156	2	1	200	5330	5130	0.50	26.65	0	9	9
0014	3T	18_2	162	1	0	100	0	-100	0.00	0.00	0	0	0
0014	3T	18_2	163	1	0	100	0	-100	0.00	0.00	0	0	0
0014	3T	18_2	165	2	0	200	0	-200	0.00	0.00	0	0	0
0014	3T	18_2	213	4	0	400	0	-400	0.00	0.00	0	0	0
0014	3T	18_2	214	9	0	900	0	-900	0.00	0.00	1	0	-1
0014	3T	18_2	215	5	0	500	0	-500	0.00	0.00	0	0	0
0014	3T	18_2	216	2	0	200	0	-200	0.00	0.00	0	0	0
0014	3T	18_2	231	2	0	200	0	-200	0.00	0.00	0	0	0
0014	3T	18_2	234	2	0	200	0	-200	0.00	0.00	0	0	0
0014	3T	18_2	235	3	0	300	0	-300	0.00	0.00	0	0	0
0014	3T	18_2	236	1	0	100	0	-100	0.00	0.00	0	0	0
0014	3T	18_2	241	2	0	200	0	-200	0.00	0.00	0	0	0
0014	3T	18_2	243	1	0	100	0	-100	0.00	0.00	0	0	0
0014	3T	18_2	251	1	0	100	0	-100	0.00	0.00	0	0	0
0014	3T	18_2	253	3	1	300	1520	1220	0.33	5.07	0	2	2
0014	3T	18_2	256	1	0	100	0	-100	0.00	0.00	0	0	0
0014	3T	18_2	261	1	0	100	0	-100	0.00	0.00	0	0	0
0014	3T	18_2	264	1	0	100	0	-100	0.00	0.00	0	0	0
0014	3T	18_3	123	65	6	6500	6010	-490	0.09	0.92	11	10	-1
0014	3T	18_3	124	44	3	4400	1660	-2740	0.07	0.38	7	2	-5
0014	3T	18_3	125	37	3	3700	3460	-240	0.08	0.94	6	6	0
0014	3T	18_3	126	13	0	1300	0	-1300	0.00	0.00	2	0	-2
0014	3T	18_3	132	38	4	3800	4860	1060	0.11	1.28	6	8	2
0014	3T	18_3	134	24	1	2400	1260	-1140	0.04	0.53	4	2	-2
0014	3T	18_3	135	21	1	2100	4830	2730	0.05	2.30	3	8	5
0014	3T	18_3	136	16	0	1600	0	-1600	0.00	0.00	2	0	-2
0014	3T	18_3	142	18	0	1800	0	-1800	0.00	0.00	3	0	-3
0014	3T	18_3	143	20	0	2000	0	-2000	0.00	0.00	3	0	-3
0014	3T	18_3	145	12	1	1200	1150	-50	0.08	0.96	2	2	0
0014	3T	18_3	146	6	0	600	0	-600	0.00	0.00	1	0	-1
0014	3T	18_3	152	10	0	1000	0	-1000	0.00	0.00	1	0	-1
0014	3T	18_3	153	6	0	600	0	-600	0.00	0.00	1	0	-1
0014	3T	18_3	154	4	0	400	0	-400	0.00	0.00	0	0	0
0014	3T	18_3	156	5	0	500	0	-500	0.00	0.00	0	0	0
0014	3T	18_3	162	1	0	100	0	-100	0.00	0.00	0	0	0
0014	3T	18_3	163	6	0	600	0	-600	0.00	0.00	1	0	-1
0014	3T	18_3	165	3	0	300	0	-300	0.00	0.00	0	0	0
0014	3T	18_3	213	8	0	800	0	-800	0.00	0.00	1	0	-1
0014	3T	18_3	214	4	0	400	0	-400	0.00	0.00	0	0	0
0014	3T	18_3	215	4	1	400	980	580	0.25	2.45	0	1	1
0014	3T	18_3	216	4	0	400	0	-400	0.00	0.00	0	0	0
0014	3T	18_3	231	3	1	300	3810	3510	0.33	12.70	0	6	6
0014	3T	18_3	234	3	0	300	0	-300	0.00	0.00	0	0	0
0014	3T	18_3	235	2	1	200	15050	14850	0.50	75.25	0	26	26
0014	3T	18_3	236	2	0	200	0	-200	0.00	0.00	0	0	0
0014	3T	18_3	243	2	0	200	0	-200	0.00	0.00	0	0	0
0014	3T	18_3	245	3	0	300	0	-300	0.00	0.00	0	0	0
0014	3T	18_3	246	1	0	100	0	-100	0.00	0.00	0	0	0
0014	3T	18_3	251	1	0	100	0	-100	0.00	0.00	0	0	0
0014	3T	18_3	253	1	0	100	0	-100	0.00	0.00	0	0	0
0014	3T	18_3	261	1	0	100	0	-100	0.00	0.00	0	0	0
0014	3T	18_3	263	1	0	100	0	-100	0.00	0.00	0	0	0
0014	3T	18_3	264	1	0	100	0	-100	0.00	0.00	0	0	0
0014	3T	18_3	265	1	0	100	0	-100	0.00	0.00	0	0	0
0014	3T	18_4	123	62	10	6200	9960	3760	0.16	1.61	10	17	7
0014	3T	18_4	124	54	2	5400	1560	-3840	0.04	0.29	9	2	-7
0014	3T	18_4	125	32	6	3200	7260	4060	0.19	2.27	5	12	7
0014	3T	18_4	126	23	0	2300	0	-2300	0.00	0.00	4	0	-4
0014	3T	18_4	132	38	1	3800	1640	-2160	0.03	0.43	6	2	-4
0014	3T	18_4	134	21	0	2100	0	-2100	0.00	0.00	3	0	-3
0014	3T	18_4	135	21	0	2100	0	-2100	0.00	0.00	3	0	-3
0014	3T	18_4	136	15	1	1500	870	-630	0.07	0.58	2	1	-1
0014	3T	18_4	142	23	0	2300	0	-2300	0.00	0.00	4	0	-4
0014	3T	18_4	143	21	0	2100	0	-2100	0.00	0.00	3	0	-3
0014	3T	18_4	145	11	0	1100	0	-1100	0.00	0.00	1	0	-1
0014	3T	18_4	146	9	1	900	730	-170	0.11	0.81	1	1	0
0014	3T	18_4	152	10	0	1000	0	-1000	0.00	0.00	1	0	-1
0014	3T	18_4	153	7	0	700	0	-700	0.00	0.00	1	0	-1
0014	3T	18_4	154	10	0	1000	0	-1000	0.00	0.00	1	0	-1
0014	3T	18_4	156	2	0	200	0	-200	0.00	0.00	0	0	0
0014	3T	18_4	162	2	0	200	0	-200	0.00	0.00	0	0	0
0014	3T	18_4	163	4	0	400	0	-400	0.00	0.00	0	0	0
0014	3T	18_4	165	1	0	100	0	-100	0.00	0.00	0	0	0
0014	3T	18_4	213	4	0	400	0	-400	0.00	0.00	0	0	0
0014	3T	18_4	214	5	0	500	0	-500	0.00	0.00	0	0	0
0014	3T	18_4	216	5	0	500	0	-500	0.00	0.00	0	0	0
0014	3T	18_4	231	1	0	100	0	-100	0.00	0.00	0	0	0
0014	3T	18_4	234	7	0	700	0	-700	0.00	0.00	1	0	-1
0014	3T	18_4	236	1	0	100	0	-100	0.00	0.00	0	0	0
0014	3T	18_4	241	1	0	100	0	-100	0.00	0.00	0	0	0
0014	3T	18_4	243	2	0	200	0	-200	0.00	0.00	0	0	0
0014	3T	18_4	245	2	0	200	0	-200	0.00	0.00	0	0	0
0014	3T	18_4	246	3	0	300	0	-300	0.00	0.00	0	0	0
0014	3T	18_4	254	1	0	100	0	-100	0.00	0.00	0	0	0
0014	3T	18_4	263	1	0	100	0	-100	0.00	0.00	0	0	0
0014	3T	18_4	264	3	0	300	0	-300	0.00	0.00	0	0	0
0014	3T	18_5	123	56	7	5600	10720	5120	0.13	1.91	9	18	9
0014	3T	18_5	124	59	5	5900	9470	3570	0.08	1.61	10	16	6
0014	3T	18_5	125	39	3	3900	4120	220	0.08	1.06	6	7	1
0014	3T	18_5	126	11	0	1100	0	-1100	0.00	0.00	1	0	-1
0014	3T	18_5	132	29	4	2900	10170	7270	0.14	3.51	5	18	13
0014	3T	18_5	134	23	0	2300	0	-2300	0.00	0.00	4	0	-4
0014	3T	18_5	135	22	1	2200	1120	-1080	0.05	0.51	3	1	-2
0014	3T	18_5	136	9	0	900	0	-900	0.00	0.00	1	0	-1
0014	3T	18_5	142	14	0	1400	0	-1400	0.00	0.00	2	0	-2
0014	3T	18_5	143	26	2	2600	2990	390	0.08	1.15	4	5	1
0014	3T	18_5	145	17	0	1700	0	-1700	0.00	0.00	3	0	-3
0014	3T	18_5	146	10	0	1000	0	-1000	0.00	0.00	1	0	-1
0014	3T	18_5	152	8	0	800	0	-800	0.00	0.00	1	0	-1
0014	3T	18_5	153	10	0	1000	0	-1000	0.00	0.00	1	0	-1
0014	3T	18_5	154	3	0	300	0	-300	0.00	0.00	0	0	0
0014	3T	18_5	156	1	0	100	0	-100	0.00	0.00	0	0	0
0014	3T	18_5	162	2	0	200	0	-200	0.00	0.00	0	0	0
0014	3T	18_5	163	1	0	100	0	-100	0.00	0.00	0	0	0
0014	3T	18_5	165	1	0	100	0	-100	0.00	0.00	0	0	0
0014	3T	18_5	213	1	0	100	0	-100	0.00	0.00	0	0	0
0014	3T	18_5	215	1	0	100	0	-100	0.00	0.00	0	0	0
0014	3T	18_5	234	2	0	200	0	-200	0.00	0.00	0	0	0
0014	3T	18_5	235	2	0	200	0	-200	0.00	0.00	0	0	0
0014	3T	18_5	236	2	0	200	0	-200	0.00	0.00	0	0	0
0014	3T	18_5	243	2	0	200	0	-200	0.00	0.00	0	0	0
0014	3T	18_5	245	1	0	100	0	-100	0.00	0.00	0	0	0
0014	3T	18_5	253	1	0	100	0	-100	0.00	0.00	0	0	0
0014	3T	18_5	256	1	0	100	0	-100	0.00	0.00	0	0	0
0014	3T	18_6	123	5	0	500	0	-500	0.00	0.00	0	0	0
0014	3T	18_6	124	9	2	900	1170	270	0.22	1.30	1	2	1
0014	3T	18_6	125	3	1	300	670	370	0.33	2.23	0	1	1
0014	3T	18_6	126	1	1	100	600	500	1.00	6.00	0	1	1
0014	3T	18_6	132	3	0	300	0	-300	0.00	0.00	0	0	0
0014	3T	18_6	134	3	0	300	0	-300	0.00	0.00	0	0	0
0014	3T	18_6	135	3	0	300	0	-300	0.00	0.00	0	0	0
0014	3T	18_6	136	1	0	100	0	-100	0.00	0.00	0	0	0
0014	3T	18_6	142	2	0	200	0	-200	0.00	0.00	0	0	0
0014	3T	18_6	143	2	0	200	0	-200	0.00	0.00	0	0	0
0014	3T	18_6	146	2	0	200	0	-200	0.00	0.00	0	0	0
0014	3T	18_6	152	1	0	100	0	-100	0.00	0.00	0	0	0
0014	3T	18_6	153	1	0	100	0	-100	0.00	0.00	0	0	0
0014	3T	18_6	154	1	0	100	0	-100	0.00	0.00	0	0	0
0014	3T	18_6	156	3	0	300	0	-300	0.00	0.00	0	0	0
0014	3T	18_6	214	1	0	100	0	-100	0.00	0.00	0	0	0
0014	3T	18_7	123	60	7	6000	5170	-830	0.12	0.86	10	9	-1
0014	3T	18_7	124	41	5	4100	4320	220	0.12	1.05	7	7	0
0014	3T	18_7	125	52	5	5200	5050	-150	0.10	0.97	9	8	-1
0014	3T	18_7	126	20	0	2000	0	-2000	0.00	0.00	3	0	-3
0014	3T	18_7	132	36	1	3600	680	-2920	0.03	0.19	6	1	-5
0014	3T	18_7	134	32	2	3200	1870	-1330	0.06	0.58	5	3	-2
0014	3T	18_7	135	29	3	2900	4600	1700	0.10	1.59	5	8	3
0014	3T	18_7	136	15	0	1500	0	-1500	0.00	0.00	2	0	-2
0014	3T	18_7	142	20	0	2000	0	-2000	0.00	0.00	3	0	-3
0014	3T	18_7	143	25	1	2500	680	-1820	0.04	0.27	4	1	-3
0014	3T	18_7	145	14	1	1400	1580	180	0.07	1.13	2	2	0
0014	3T	18_7	146	7	0	700	0	-700	0.00	0.00	1	0	-1
0014	3T	18_7	152	7	0	700	0	-700	0.00	0.00	1	0	-1
0014	3T	18_7	153	3	0	300	0	-300	0.00	0.00	0	0	0
0014	3T	18_7	154	6	0	600	0	-600	0.00	0.00	1	0	-1
0014	3T	18_7	156	5	0	500	0	-500	0.00	0.00	0	0	0
0014	3T	18_7	163	2	0	200	0	-200	0.00	0.00	0	0	0
0014	3T	18_7	213	3	0	300	0	-300	0.00	0.00	0	0	0
0014	3T	18_7	214	2	0	200	0	-200	0.00	0.00	0	0	0
0014	3T	18_7	215	3	0	300	0	-300	0.00	0.00	0	0	0
0014	3T	18_7	216	1	0	100	0	-100	0.00	0.00	0	0	0
0014	3T	18_7	234	3	0	300	0	-300	0.00	0.00	0	0	0
0014	3T	18_7	235	2	0	200	0	-200	0.00	0.00	0	0	0
0014	3T	18_7	236	1	0	100	0	-100	0.00	0.00	0	0	0
0014	3T	18_7	243	1	0	100	0	-100	0.00	0.00	0	0	0
0014	3T	18_7	245	2	0	200	0	-200	0.00	0.00	0	0	0
0014	3T	18_7	254	2	0	200	0	-200	0.00	0.00	0	0	0
0014	3T	18_7	263	1	0	100	0	-100	0.00	0.00	0	0	0
0014	3T	18_7	264	2	0	200	0	-200	0.00	0.00	0	0	0
0014	3T	18_7	265	2	0	200	0	-200	0.00	0.00	0	0	0
0014	3T	19_1	123	42	3	4200	3180	-1020	0.07	0.76	7	5	-2
0014	3T	19_1	124	52	8	5200	8220	3020	0.15	1.58	9	14	5
0014	3T	19_1	125	25	3	2500	6370	3870	0.12	2.55	4	11	7
0014	3T	19_1	126	16	0	1600	0	-1600	0.00	0.00	2	0	-2
0014	3T	19_1	132	34	1	3400	510	-2890	0.03	0.15	6	0	-6
0014	3T	19_1	134	30	2	3000	2570	-430	0.07	0.86	5	4	-1
0014	3T	19_1	135	20	0	2000	0	-2000	0.00	0.00	3	0	-3
0014	3T	19_1	136	19	0	1900	0	-1900	0.00	0.00	3	0	-3
0014	3T	19_1	142	26	3	2600	2020	-580	0.12	0.78	4	3	-1
0014	3T	19_1	143	20	2	2000	1440	-560	0.10	0.72	3	2	-1
0014	3T	19_1	145	9	1	900	3720	2820	0.11	4.13	1	6	5
0014	3T	19_1	146	8	0	800	0	-800	0.00	0.00	1	0	-1
0014	3T	19_1	152	1	0	100	0	-100	0.00	0.00	0	0	0
0014	3T	19_1	153	5	0	500	0	-500	0.00	0.00	0	0	0
0014	3T	19_1	154	2	0	200	0	-200	0.00	0.00	0	0	0
0014	3T	19_1	156	1	0	100	0	-100	0.00	0.00	0	0	0
0014	3T	19_1	162	4	0	400	0	-400	0.00	0.00	0	0	0
0014	3T	19_1	163	8	0	800	0	-800	0.00	0.00	1	0	-1
0014	3T	19_1	165	1	0	100	0	-100	0.00	0.00	0	0	0
0014	3T	19_1	213	2	0	200	0	-200	0.00	0.00	0	0	0
0014	3T	19_1	214	1	0	100	0	-100	0.00	0.00	0	0	0
0014	3T	19_1	215	1	0	100	0	-100	0.00	0.00	0	0	0
0014	3T	19_1	216	5	0	500	0	-500	0.00	0.00	0	0	0
0014	3T	19_1	231	1	0	100	0	-100	0.00	0.00	0	0	0
0014	3T	19_1	235	1	0	100	0	-100	0.00	0.00	0	0	0
0014	3T	19_1	236	1	0	100	0	-100	0.00	0.00	0	0	0
0014	3T	19_1	241	1	0	100	0	-100	0.00	0.00	0	0	0
0014	3T	19_1	243	1	0	100	0	-100	0.00	0.00	0	0	0
0014	3T	19_1	261	1	0	100	0	-100	0.00	0.00	0	0	0
0014	3T	19_1	263	1	0	100	0	-100	0.00	0.00	0	0	0
0014	3T	19_1	264	1	0	100	0	-100	0.00	0.00	0	0	0
0014	3T	19_2	123	36	3	3600	3140	-460	0.08	0.87	6	5	-1
0014	3T	19_2	124	38	2	3800	1200	-2600	0.05	0.32	6	2	-4
0014	3T	19_2	125	18	0	1800	0	-1800	0.00	0.00	3	0	-3
0014	3T	19_2	126	17	1	1700	1490	-210	0.06	0.88	3	2	-1
0014	3T	19_2	132	30	1	3000	1150	-1850	0.03	0.38	5	2	-3
0014	3T	19_2	134	17	3	1700	7680	5980	0.18	4.52	3	13	10
0014	3T	19_2	135	23	1	2300	440	-1860	0.04	0.19	4	0	-4
0014	3T	19_2	136	16	1	1600	600	-1000	0.06	0.38	2	1	-1
0014	3T	19_2	142	33	0	3300	0	-3300	0.00	0.00	5	0	-5
0014	3T	19_2	143	19	0	1900	0	-1900	0.00	0.00	3	0	-3
0014	3T	19_2	145	10	0	1000	0	-1000	0.00	0.00	1	0	-1
0014	3T	19_2	146	10	0	1000	0	-1000	0.00	0.00	1	0	-1
0014	3T	19_2	152	3	0	300	0	-300	0.00	0.00	0	0	0
0014	3T	19_2	153	5	0	500	0	-500	0.00	0.00	0	0	0
0014	3T	19_2	154	3	0	300	0	-300	0.00	0.00	0	0	0
0014	3T	19_2	156	2	0	200	0	-200	0.00	0.00	0	0	0
0014	3T	19_2	162	5	1	500	2230	1730	0.20	4.46	0	3	3
0014	3T	19_2	163	8	3	800	4700	3900	0.38	5.88	1	8	7
0014	3T	19_2	164	5	0	500	0	-500	0.00	0.00	0	0	0
0014	3T	19_2	165	2	0	200	0	-200	0.00	0.00	0	0	0
0014	3T	19_2	213	2	1	200	6340	6140	0.50	31.70	0	11	11
0014	3T	19_2	214	1	1	100	6720	6620	1.00	67.20	0	11	11
0014	3T	19_2	215	3	0	300	0	-300	0.00	0.00	0	0	0
0014	3T	19_2	216	4	2	400	3690	3290	0.50	9.23	0	6	6
0014	3T	19_2	231	1	0	100	0	-100	0.00	0.00	0	0	0
0014	3T	19_2	236	2	0	200	0	-200	0.00	0.00	0	0	0
0014	3T	19_2	241	1	0	100	0	-100	0.00	0.00	0	0	0
0014	3T	19_2	246	1	0	100	0	-100	0.00	0.00	0	0	0
0014	3T	19_2	253	1	0	100	0	-100	0.00	0.00	0	0	0
0014	3T	19_2	263	1	0	100	0	-100	0.00	0.00	0	0	0
0014	3T	19_2	264	2	0	200	0	-200	0.00	0.00	0	0	0
0014	3T	19_2	265	1	0	100	0	-100	0.00	0.00	0	0	0
0014	3T	19_3	123	68	2	6800	1700	-5100	0.03	0.25	12	3	-9
0014	3T	19_3	124	46	1	4600	640	-3960	0.02	0.14	8	1	-7
0014	3T	19_3	125	35	3	3500	2110	-1390	0.09	0.60	6	3	-3
0014	3T	19_3	126	24	2	2400	4030	1630	0.08	1.68	4	7	3
0014	3T	19_3	132	20	1	2000	600	-1400	0.05	0.30	3	1	-2
0014	3T	19_3	134	22	1	2200	3170	970	0.05	1.44	3	5	2
0014	3T	19_3	135	14	1	1400	960	-440	0.07	0.69	2	1	-1
0014	3T	19_3	136	18	1	1800	1290	-510	0.06	0.72	3	2	-1
0014	3T	19_3	142	28	0	2800	0	-2800	0.00	0.00	4	0	-4
0014	3T	19_3	143	14	0	1400	0	-1400	0.00	0.00	2	0	-2
0014	3T	19_3	145	12	1	1200	420	-780	0.08	0.35	2	0	-2
0014	3T	19_3	146	7	0	700	0	-700	0.00	0.00	1	0	-1
0014	3T	19_3	152	7	0	700	0	-700	0.00	0.00	1	0	-1
0014	3T	19_3	153	5	0	500	0	-500	0.00	0.00	0	0	0
0014	3T	19_3	154	6	1	600	1860	1260	0.17	3.10	1	3	2
0014	3T	19_3	156	2	0	200	0	-200	0.00	0.00	0	0	0
0014	3T	19_3	162	2	0	200	0	-200	0.00	0.00	0	0	0
0014	3T	19_3	163	2	0	200	0	-200	0.00	0.00	0	0	0
0014	3T	19_3	165	3	0	300	0	-300	0.00	0.00	0	0	0
0014	3T	19_3	213	2	0	200	0	-200	0.00	0.00	0	0	0
0014	3T	19_3	214	7	1	700	1390	690	0.14	1.99	1	2	1
0014	3T	19_3	215	2	0	200	0	-200	0.00	0.00	0	0	0
0014	3T	19_3	216	2	0	200	0	-200	0.00	0.00	0	0	0
0014	3T	19_3	236	3	0	300	0	-300	0.00	0.00	0	0	0
0014	3T	19_3	241	1	0	100	0	-100	0.00	0.00	0	0	0
0014	3T	19_3	246	1	0	100	0	-100	0.00	0.00	0	0	0
0014	3T	19_3	263	1	0	100	0	-100	0.00	0.00	0	0	0
0014	3T	19_3	264	1	0	100	0	-100	0.00	0.00	0	0	0
0014	3T	19_4	123	49	9	4900	5330	430	0.18	1.09	8	9	1
0014	3T	19_4	124	45	5	4500	4170	-330	0.11	0.93	7	7	0
0014	3T	19_4	125	21	1	2100	3410	1310	0.05	1.62	3	6	3
0014	3T	19_4	126	10	0	1000	0	-1000	0.00	0.00	1	0	-1
0014	3T	19_4	132	24	2	2400	2440	40	0.08	1.02	4	4	0
0014	3T	19_4	134	27	4	2700	3800	1100	0.15	1.41	4	6	2
0014	3T	19_4	135	16	0	1600	0	-1600	0.00	0.00	2	0	-2
0014	3T	19_4	136	11	1	1100	2780	1680	0.09	2.53	1	4	3
0014	3T	19_4	142	20	1	2000	600	-1400	0.05	0.30	3	1	-2
0014	3T	19_4	143	16	1	1600	1640	40	0.06	1.03	2	2	0
0014	3T	19_4	145	9	0	900	0	-900	0.00	0.00	1	0	-1
0014	3T	19_4	146	5	0	500	0	-500	0.00	0.00	0	0	0
0014	3T	19_4	152	2	0	200	0	-200	0.00	0.00	0	0	0
0014	3T	19_4	153	2	0	200	0	-200	0.00	0.00	0	0	0
0014	3T	19_4	154	4	0	400	0	-400	0.00	0.00	0	0	0
0014	3T	19_4	156	1	0	100	0	-100	0.00	0.00	0	0	0
0014	3T	19_4	162	1	0	100	0	-100	0.00	0.00	0	0	0
0014	3T	19_4	163	2	0	200	0	-200	0.00	0.00	0	0	0
0014	3T	19_4	164	4	0	400	0	-400	0.00	0.00	0	0	0
0014	3T	19_4	213	1	0	100	0	-100	0.00	0.00	0	0	0
0014	3T	19_4	214	4	0	400	0	-400	0.00	0.00	0	0	0
0014	3T	19_4	215	1	0	100	0	-100	0.00	0.00	0	0	0
0014	3T	19_4	216	1	0	100	0	-100	0.00	0.00	0	0	0
0014	3T	19_4	231	1	0	100	0	-100	0.00	0.00	0	0	0
0014	3T	19_4	234	6	0	600	0	-600	0.00	0.00	1	0	-1
0014	3T	19_4	235	2	0	200	0	-200	0.00	0.00	0	0	0
0014	3T	19_4	236	1	0	100	0	-100	0.00	0.00	0	0	0
0014	3T	19_4	241	1	0	100	0	-100	0.00	0.00	0	0	0
0014	3T	19_4	245	1	0	100	0	-100	0.00	0.00	0	0	0
0014	3T	19_4	261	1	0	100	0	-100	0.00	0.00	0	0	0
0014	3T	19_4	264	1	0	100	0	-100	0.00	0.00	0	0	0
0014	3T	19_5	123	30	0	3000	0	-3000	0.00	0.00	5	0	-5
0014	3T	19_5	124	32	1	3200	680	-2520	0.03	0.21	5	1	-4
0014	3T	19_5	125	16	1	1600	1600	0	0.06	1.00	2	2	0
0014	3T	19_5	126	9	0	900	0	-900	0.00	0.00	1	0	-1
0014	3T	19_5	132	31	3	3100	10750	7650	0.10	3.47	5	19	14
0014	3T	19_5	134	16	4	1600	3400	1800	0.25	2.13	2	6	4
0014	3T	19_5	135	12	0	1200	0	-1200	0.00	0.00	2	0	-2
0014	3T	19_5	136	9	0	900	0	-900	0.00	0.00	1	0	-1
0014	3T	19_5	142	14	2	1400	4680	3280	0.14	3.34	2	8	6
0014	3T	19_5	143	12	1	1200	8440	7240	0.08	7.03	2	14	12
0014	3T	19_5	145	10	0	1000	0	-1000	0.00	0.00	1	0	-1
0014	3T	19_5	146	5	0	500	0	-500	0.00	0.00	0	0	0
0014	3T	19_5	152	1	0	100	0	-100	0.00	0.00	0	0	0
0014	3T	19_5	153	4	2	400	6830	6430	0.50	17.08	0	12	12
0014	3T	19_5	154	2	0	200	0	-200	0.00	0.00	0	0	0
0014	3T	19_5	162	1	0	100	0	-100	0.00	0.00	0	0	0
0014	3T	19_5	163	1	0	100	0	-100	0.00	0.00	0	0	0
0014	3T	19_5	164	2	0	200	0	-200	0.00	0.00	0	0	0
0014	3T	19_5	213	3	2	300	5470	5170	0.67	18.23	0	9	9
0014	3T	19_5	214	1	0	100	0	-100	0.00	0.00	0	0	0
0014	3T	19_5	215	1	0	100	0	-100	0.00	0.00	0	0	0
0014	3T	19_5	216	1	0	100	0	-100	0.00	0.00	0	0	0
0014	3T	19_5	231	1	0	100	0	-100	0.00	0.00	0	0	0
0014	3T	19_5	234	2	0	200	0	-200	0.00	0.00	0	0	0
0014	3T	19_5	235	2	0	200	0	-200	0.00	0.00	0	0	0
0014	3T	19_5	236	3	0	300	0	-300	0.00	0.00	0	0	0
0014	3T	19_5	246	1	0	100	0	-100	0.00	0.00	0	0	0
0014	3T	19_5	251	2	0	200	0	-200	0.00	0.00	0	0	0
0014	3T	19_5	256	1	0	100	0	-100	0.00	0.00	0	0	0
0014	3T	19_5	265	2	0	200	0	-200	0.00	0.00	0	0	0
0014	3T	19_6	123	6	1	600	1240	640	0.17	2.07	1	2	1
0014	3T	19_6	124	3	0	300	0	-300	0.00	0.00	0	0	0
0014	3T	19_6	125	3	0	300	0	-300	0.00	0.00	0	0	0
0014	3T	19_6	126	1	0	100	0	-100	0.00	0.00	0	0	0
0014	3T	19_6	132	2	0	200	0	-200	0.00	0.00	0	0	0
0014	3T	19_6	134	7	2	700	2220	1520	0.29	3.17	1	3	2
0014	3T	19_6	135	1	0	100	0	-100	0.00	0.00	0	0	0
0014	3T	19_6	142	1	0	100	0	-100	0.00	0.00	0	0	0
0014	3T	19_6	143	1	0	100	0	-100	0.00	0.00	0	0	0
0014	3T	19_6	152	1	0	100	0	-100	0.00	0.00	0	0	0
0014	3T	19_6	153	1	0	100	0	-100	0.00	0.00	0	0	0
0014	3T	19_6	154	1	0	100	0	-100	0.00	0.00	0	0	0
0014	3T	19_6	156	1	0	100	0	-100	0.00	0.00	0	0	0
0014	3T	19_6	162	1	0	100	0	-100	0.00	0.00	0	0	0
0014	3T	19_6	246	1	0	100	0	-100	0.00	0.00	0	0	0
0014	3T	19_6	253	1	0	100	0	-100	0.00	0.00	0	0	0
0014	3T	19_6	256	1	0	100	0	-100	0.00	0.00	0	0	0
0014	3T	19_7	123	56	5	5600	3410	-2190	0.09	0.61	9	6	-3
0014	3T	19_7	124	52	5	5200	6970	1770	0.10	1.34	9	12	3
0014	3T	19_7	125	24	0	2400	0	-2400	0.00	0.00	4	0	-4
0014	3T	19_7	126	13	0	1300	0	-1300	0.00	0.00	2	0	-2
0014	3T	19_7	132	29	2	2900	1950	-950	0.07	0.67	5	3	-2
0014	3T	19_7	134	33	0	3300	0	-3300	0.00	0.00	5	0	-5
0014	3T	19_7	135	19	4	1900	3240	1340	0.21	1.71	3	5	2
0014	3T	19_7	136	17	1	1700	760	-940	0.06	0.45	3	1	-2
0014	3T	19_7	142	17	1	1700	1080	-620	0.06	0.64	3	1	-2
0014	3T	19_7	143	16	2	1600	3530	1930	0.13	2.21	2	6	4
0014	3T	19_7	145	16	1	1600	3270	1670	0.06	2.04	2	5	3
0014	3T	19_7	146	10	1	1000	2090	1090	0.10	2.09	1	3	2
0014	3T	19_7	152	2	0	200	0	-200	0.00	0.00	0	0	0
0014	3T	19_7	153	1	0	100	0	-100	0.00	0.00	0	0	0
0014	3T	19_7	154	6	0	600	0	-600	0.00	0.00	1	0	-1
0014	3T	19_7	156	5	0	500	0	-500	0.00	0.00	0	0	0
0014	3T	19_7	162	2	0	200	0	-200	0.00	0.00	0	0	0
0014	3T	19_7	163	3	0	300	0	-300	0.00	0.00	0	0	0
0014	3T	19_7	164	1	0	100	0	-100	0.00	0.00	0	0	0
0014	3T	19_7	213	4	0	400	0	-400	0.00	0.00	0	0	0
0014	3T	19_7	214	3	0	300	0	-300	0.00	0.00	0	0	0
0014	3T	19_7	215	2	0	200	0	-200	0.00	0.00	0	0	0
0014	3T	19_7	216	1	0	100	0	-100	0.00	0.00	0	0	0
0014	3T	19_7	231	2	1	200	2230	2030	0.50	11.15	0	3	3
0014	3T	19_7	234	2	0	200	0	-200	0.00	0.00	0	0	0
0014	3T	19_7	235	3	0	300	0	-300	0.00	0.00	0	0	0
0014	3T	19_7	236	2	0	200	0	-200	0.00	0.00	0	0	0
0014	3T	19_7	254	1	0	100	0	-100	0.00	0.00	0	0	0
0014	3T	20_1	123	61	6	6100	4620	-1480	0.10	0.76	10	8	-2
0014	3T	20_1	124	60	6	6000	5320	-680	0.10	0.89	10	9	-1
0014	3T	20_1	125	14	1	1400	2490	1090	0.07	1.78	2	4	2
0014	3T	20_1	126	16	1	1600	2090	490	0.06	1.31	2	3	1
0014	3T	20_1	132	34	4	3400	5610	2210	0.12	1.65	6	9	3
0014	3T	20_1	134	35	2	3500	1520	-1980	0.06	0.43	6	2	-4
0014	3T	20_1	135	21	1	2100	4440	2340	0.05	2.11	3	7	4
0014	3T	20_1	136	19	0	1900	0	-1900	0.00	0.00	3	0	-3
0014	3T	20_1	142	25	0	2500	0	-2500	0.00	0.00	4	0	-4
0014	3T	20_1	143	25	2	2500	3170	670	0.08	1.27	4	5	1
0014	3T	20_1	145	6	2	600	8220	7620	0.33	13.70	1	14	13
0014	3T	20_1	146	9	1	900	980	80	0.11	1.09	1	1	0
0014	3T	20_1	152	3	0	300	0	-300	0.00	0.00	0	0	0
0014	3T	20_1	153	4	0	400	0	-400	0.00	0.00	0	0	0
0014	3T	20_1	154	7	0	700	0	-700	0.00	0.00	1	0	-1
0014	3T	20_1	156	1	0	100	0	-100	0.00	0.00	0	0	0
0014	3T	20_1	162	3	0	300	0	-300	0.00	0.00	0	0	0
0014	3T	20_1	163	1	0	100	0	-100	0.00	0.00	0	0	0
0014	3T	20_1	164	4	0	400	0	-400	0.00	0.00	0	0	0
0014	3T	20_1	165	3	0	300	0	-300	0.00	0.00	0	0	0
0014	3T	20_1	213	5	1	500	1280	780	0.20	2.56	0	2	2
0014	3T	20_1	214	4	1	400	540	140	0.25	1.35	0	0	0
0014	3T	20_1	215	2	0	200	0	-200	0.00	0.00	0	0	0
0014	3T	20_1	231	1	0	100	0	-100	0.00	0.00	0	0	0
0014	3T	20_1	234	1	0	100	0	-100	0.00	0.00	0	0	0
0014	3T	20_1	243	1	0	100	0	-100	0.00	0.00	0	0	0
0014	3T	20_1	261	1	0	100	0	-100	0.00	0.00	0	0	0
0014	3T	20_1	264	1	0	100	0	-100	0.00	0.00	0	0	0
0014	3T	20_2	123	55	8	5500	7340	1840	0.15	1.33	9	12	3
0014	3T	20_2	124	35	0	3500	0	-3500	0.00	0.00	6	0	-6
0014	3T	20_2	125	28	1	2800	1490	-1310	0.04	0.53	4	2	-2
0014	3T	20_2	126	25	0	2500	0	-2500	0.00	0.00	4	0	-4
0014	3T	20_2	132	26	2	2600	1270	-1330	0.08	0.49	4	2	-2
0014	3T	20_2	134	19	0	1900	0	-1900	0.00	0.00	3	0	-3
0014	3T	20_2	135	14	0	1400	0	-1400	0.00	0.00	2	0	-2
0014	3T	20_2	136	13	1	1300	1840	540	0.08	1.42	2	3	1
0014	3T	20_2	142	20	1	2000	670	-1330	0.05	0.34	3	1	-2
0014	3T	20_2	143	14	1	1400	3880	2480	0.07	2.77	2	6	4
0014	3T	20_2	145	13	0	1300	0	-1300	0.00	0.00	2	0	-2
0014	3T	20_2	146	11	2	1100	4280	3180	0.18	3.89	1	7	6
0014	3T	20_2	152	3	0	300	0	-300	0.00	0.00	0	0	0
0014	3T	20_2	153	8	1	800	660	-140	0.13	0.83	1	1	0
0014	3T	20_2	154	3	0	300	0	-300	0.00	0.00	0	0	0
0014	3T	20_2	156	4	0	400	0	-400	0.00	0.00	0	0	0
0014	3T	20_2	162	9	0	900	0	-900	0.00	0.00	1	0	-1
0014	3T	20_2	163	8	0	800	0	-800	0.00	0.00	1	0	-1
0014	3T	20_2	164	4	0	400	0	-400	0.00	0.00	0	0	0
0014	3T	20_2	165	3	0	300	0	-300	0.00	0.00	0	0	0
0014	3T	20_2	213	4	0	400	0	-400	0.00	0.00	0	0	0
0014	3T	20_2	214	4	1	400	2030	1630	0.25	5.08	0	3	3
0014	3T	20_2	215	1	0	100	0	-100	0.00	0.00	0	0	0
0014	3T	20_2	216	1	0	100	0	-100	0.00	0.00	0	0	0
0014	3T	20_2	234	1	0	100	0	-100	0.00	0.00	0	0	0
0014	3T	20_2	236	2	0	200	0	-200	0.00	0.00	0	0	0
0014	3T	20_2	261	1	0	100	0	-100	0.00	0.00	0	0	0
0014	3T	20_3	123	49	6	4900	4260	-640	0.12	0.87	8	7	-1
0014	3T	20_3	124	39	4	3900	4430	530	0.10	1.14	6	7	1
0014	3T	20_3	125	44	1	4400	1130	-3270	0.02	0.26	7	2	-5
0014	3T	20_3	126	27	1	2700	3470	770	0.04	1.29	4	6	2
0014	3T	20_3	132	22	3	2200	2710	510	0.14	1.23	3	4	1
0014	3T	20_3	134	23	1	2300	1720	-580	0.04	0.75	4	3	-1
0014	3T	20_3	135	24	2	2400	1730	-670	0.08	0.72	4	3	-1
0014	3T	20_3	136	20	2	2000	6220	4220	0.10	3.11	3	11	8
0014	3T	20_3	142	13	0	1300	0	-1300	0.00	0.00	2	0	-2
0014	3T	20_3	143	15	1	1500	4400	2900	0.07	2.93	2	7	5
0014	3T	20_3	145	11	1	1100	340	-760	0.09	0.31	1	0	-1
0014	3T	20_3	146	13	0	1300	0	-1300	0.00	0.00	2	0	-2
0014	3T	20_3	152	6	0	600	0	-600	0.00	0.00	1	0	-1
0014	3T	20_3	153	7	0	700	0	-700	0.00	0.00	1	0	-1
0014	3T	20_3	154	4	0	400	0	-400	0.00	0.00	0	0	0
0014	3T	20_3	156	7	0	700	0	-700	0.00	0.00	1	0	-1
0014	3T	20_3	162	2	0	200	0	-200	0.00	0.00	0	0	0
0014	3T	20_3	163	4	0	400	0	-400	0.00	0.00	0	0	0
0014	3T	20_3	164	2	0	200	0	-200	0.00	0.00	0	0	0
0014	3T	20_3	165	2	0	200	0	-200	0.00	0.00	0	0	0
0014	3T	20_3	213	2	0	200	0	-200	0.00	0.00	0	0	0
0014	3T	20_3	214	1	0	100	0	-100	0.00	0.00	0	0	0
0014	3T	20_3	215	2	0	200	0	-200	0.00	0.00	0	0	0
0014	3T	20_3	216	1	0	100	0	-100	0.00	0.00	0	0	0
0014	3T	20_3	234	2	0	200	0	-200	0.00	0.00	0	0	0
0014	3T	20_3	235	1	0	100	0	-100	0.00	0.00	0	0	0
0014	3T	20_3	236	2	0	200	0	-200	0.00	0.00	0	0	0
0014	3T	20_3	241	1	0	100	0	-100	0.00	0.00	0	0	0
0014	3T	20_3	246	1	0	100	0	-100	0.00	0.00	0	0	0
0014	3T	20_3	265	1	0	100	0	-100	0.00	0.00	0	0	0
0014	3T	20_4	123	50	4	5000	2960	-2040	0.08	0.59	8	5	-3
0014	3T	20_4	124	39	2	3900	1240	-2660	0.05	0.32	6	2	-4
0014	3T	20_4	125	16	2	1600	3250	1650	0.13	2.03	2	5	3
0014	3T	20_4	126	9	0	900	0	-900	0.00	0.00	1	0	-1
0014	3T	20_4	132	23	2	2300	1830	-470	0.09	0.80	4	3	-1
0014	3T	20_4	134	21	3	2100	3350	1250	0.14	1.60	3	5	2
0014	3T	20_4	135	14	0	1400	0	-1400	0.00	0.00	2	0	-2
0014	3T	20_4	136	11	1	1100	540	-560	0.09	0.49	1	0	-1
0014	3T	20_4	142	11	0	1100	0	-1100	0.00	0.00	1	0	-1
0014	3T	20_4	143	20	2	2000	2650	650	0.10	1.33	3	4	1
0014	3T	20_4	145	20	1	2000	1530	-470	0.05	0.77	3	2	-1
0014	3T	20_4	146	8	0	800	0	-800	0.00	0.00	1	0	-1
0014	3T	20_4	152	7	0	700	0	-700	0.00	0.00	1	0	-1
0014	3T	20_4	153	5	1	500	5210	4710	0.20	10.42	0	9	9
0014	3T	20_4	154	8	0	800	0	-800	0.00	0.00	1	0	-1
0014	3T	20_4	156	2	1	200	4920	4720	0.50	24.60	0	8	8
0014	3T	20_4	162	2	0	200	0	-200	0.00	0.00	0	0	0
0014	3T	20_4	163	2	0	200	0	-200	0.00	0.00	0	0	0
0014	3T	20_4	164	4	0	400	0	-400	0.00	0.00	0	0	0
0014	3T	20_4	213	2	0	200	0	-200	0.00	0.00	0	0	0
0014	3T	20_4	214	2	0	200	0	-200	0.00	0.00	0	0	0
0014	3T	20_4	215	5	1	500	1420	920	0.20	2.84	0	2	2
0014	3T	20_4	216	1	0	100	0	-100	0.00	0.00	0	0	0
0014	3T	20_4	231	1	0	100	0	-100	0.00	0.00	0	0	0
0014	3T	20_4	234	1	0	100	0	-100	0.00	0.00	0	0	0
0014	3T	20_4	235	1	0	100	0	-100	0.00	0.00	0	0	0
0014	3T	20_4	236	2	0	200	0	-200	0.00	0.00	0	0	0
0014	3T	20_4	243	1	0	100	0	-100	0.00	0.00	0	0	0
0014	3T	20_4	253	1	0	100	0	-100	0.00	0.00	0	0	0
0014	3T	20_4	256	1	0	100	0	-100	0.00	0.00	0	0	0
0014	3T	20_5	123	45	4	4500	3180	-1320	0.09	0.71	7	5	-2
0014	3T	20_5	124	26	5	2600	3180	580	0.19	1.22	4	5	1
0014	3T	20_5	125	24	2	2400	3500	1100	0.08	1.46	4	6	2
0014	3T	20_5	126	19	0	1900	0	-1900	0.00	0.00	3	0	-3
0014	3T	20_5	132	15	0	1500	0	-1500	0.00	0.00	2	0	-2
0014	3T	20_5	134	30	0	3000	0	-3000	0.00	0.00	5	0	-5
0014	3T	20_5	135	6	0	600	0	-600	0.00	0.00	1	0	-1
0014	3T	20_5	136	6	0	600	0	-600	0.00	0.00	1	0	-1
0014	3T	20_5	142	20	0	2000	0	-2000	0.00	0.00	3	0	-3
0014	3T	20_5	143	18	0	1800	0	-1800	0.00	0.00	3	0	-3
0014	3T	20_5	145	8	0	800	0	-800	0.00	0.00	1	0	-1
0014	3T	20_5	146	4	0	400	0	-400	0.00	0.00	0	0	0
0014	3T	20_5	152	5	0	500	0	-500	0.00	0.00	0	0	0
0014	3T	20_5	153	8	0	800	0	-800	0.00	0.00	1	0	-1
0014	3T	20_5	154	4	0	400	0	-400	0.00	0.00	0	0	0
0014	3T	20_5	156	1	0	100	0	-100	0.00	0.00	0	0	0
0014	3T	20_5	163	1	0	100	0	-100	0.00	0.00	0	0	0
0014	3T	20_5	165	3	0	300	0	-300	0.00	0.00	0	0	0
0014	3T	20_5	213	2	0	200	0	-200	0.00	0.00	0	0	0
0014	3T	20_5	214	3	0	300	0	-300	0.00	0.00	0	0	0
0014	3T	20_5	216	3	0	300	0	-300	0.00	0.00	0	0	0
0014	3T	20_5	231	3	0	300	0	-300	0.00	0.00	0	0	0
0014	3T	20_5	234	1	0	100	0	-100	0.00	0.00	0	0	0
0014	3T	20_5	235	2	0	200	0	-200	0.00	0.00	0	0	0
0014	3T	20_5	236	1	0	100	0	-100	0.00	0.00	0	0	0
0014	3T	20_5	241	1	0	100	0	-100	0.00	0.00	0	0	0
0014	3T	20_5	246	1	0	100	0	-100	0.00	0.00	0	0	0
0014	3T	20_5	253	1	0	100	0	-100	0.00	0.00	0	0	0
0014	3T	20_6	123	6	1	600	560	-40	0.17	0.93	1	0	-1
0014	3T	20_6	124	8	1	800	440	-360	0.13	0.55	1	0	-1
0014	3T	20_6	125	3	0	300	0	-300	0.00	0.00	0	0	0
0014	3T	20_6	126	10	0	1000	0	-1000	0.00	0.00	1	0	-1
0014	3T	20_6	132	7	1	700	450	-250	0.14	0.64	1	0	-1
0014	3T	20_6	134	2	0	200	0	-200	0.00	0.00	0	0	0
0014	3T	20_6	135	1	1	100	3960	3860	1.00	39.60	0	7	7
0014	3T	20_6	136	2	0	200	0	-200	0.00	0.00	0	0	0
0014	3T	20_6	142	1	0	100	0	-100	0.00	0.00	0	0	0
0014	3T	20_6	143	3	0	300	0	-300	0.00	0.00	0	0	0
0014	3T	20_6	145	2	0	200	0	-200	0.00	0.00	0	0	0
0014	3T	20_6	146	3	0	300	0	-300	0.00	0.00	0	0	0
0014	3T	20_6	162	2	0	200	0	-200	0.00	0.00	0	0	0
0014	3T	20_6	165	1	0	100	0	-100	0.00	0.00	0	0	0
0014	3T	20_6	215	1	0	100	0	-100	0.00	0.00	0	0	0
0014	3T	20_7	123	60	6	6000	4730	-1270	0.10	0.79	10	8	-2
0014	3T	20_7	124	46	2	4600	1030	-3570	0.04	0.22	8	1	-7
0014	3T	20_7	125	24	1	2400	640	-1760	0.04	0.27	4	1	-3
0014	3T	20_7	126	17	0	1700	0	-1700	0.00	0.00	3	0	-3
0014	3T	20_7	132	23	0	2300	0	-2300	0.00	0.00	4	0	-4
0014	3T	20_7	134	29	5	2900	14370	11470	0.17	4.96	5	25	20
0014	3T	20_7	135	24	4	2400	4310	1910	0.17	1.80	4	7	3
0014	3T	20_7	136	12	1	1200	890	-310	0.08	0.74	2	1	-1
0014	3T	20_7	142	20	2	2000	4420	2420	0.10	2.21	3	7	4
0014	3T	20_7	143	19	1	1900	2040	140	0.05	1.07	3	3	0
0014	3T	20_7	145	15	0	1500	0	-1500	0.00	0.00	2	0	-2
0014	3T	20_7	146	15	0	1500	0	-1500	0.00	0.00	2	0	-2
0014	3T	20_7	152	10	0	1000	0	-1000	0.00	0.00	1	0	-1
0014	3T	20_7	153	8	0	800	0	-800	0.00	0.00	1	0	-1
0014	3T	20_7	154	7	0	700	0	-700	0.00	0.00	1	0	-1
0014	3T	20_7	156	1	0	100	0	-100	0.00	0.00	0	0	0
0014	3T	20_7	162	3	0	300	0	-300	0.00	0.00	0	0	0
0014	3T	20_7	163	3	1	300	1030	730	0.33	3.43	0	1	1
0014	3T	20_7	164	4	0	400	0	-400	0.00	0.00	0	0	0
0014	3T	20_7	213	6	0	600	0	-600	0.00	0.00	1	0	-1
0014	3T	20_7	214	5	1	500	2980	2480	0.20	5.96	0	5	5
0014	3T	20_7	215	1	0	100	0	-100	0.00	0.00	0	0	0
0014	3T	20_7	216	3	0	300	0	-300	0.00	0.00	0	0	0
0014	3T	20_7	231	2	0	200	0	-200	0.00	0.00	0	0	0
0014	3T	20_7	235	1	0	100	0	-100	0.00	0.00	0	0	0
0014	3T	20_7	243	1	0	100	0	-100	0.00	0.00	0	0	0
0014	3T	20_7	245	1	0	100	0	-100	0.00	0.00	0	0	0
0014	3T	20_7	253	2	0	200	0	-200	0.00	0.00	0	0	0
0014	3T	20_7	265	1	0	100	0	-100	0.00	0.00	0	0	0
0014	3T	21_1	123	58	3	5800	2070	-3730	0.05	0.36	10	3	-7
0014	3T	21_1	124	50	5	5000	8300	3300	0.10	1.66	8	14	6
0014	3T	21_1	125	29	3	2900	7810	4910	0.10	2.69	5	13	8
0014	3T	21_1	126	23	1	2300	1320	-980	0.04	0.57	4	2	-2
0014	3T	21_1	132	21	2	2100	1460	-640	0.10	0.70	3	2	-1
0014	3T	21_1	134	27	1	2700	1610	-1090	0.04	0.60	4	2	-2
0014	3T	21_1	135	21	0	2100	0	-2100	0.00	0.00	3	0	-3
0014	3T	21_1	136	7	0	700	0	-700	0.00	0.00	1	0	-1
0014	3T	21_1	142	23	2	2300	2300	0	0.09	1.00	4	4	0
0014	3T	21_1	143	25	3	2500	1880	-620	0.12	0.75	4	3	-1
0014	3T	21_1	145	16	0	1600	0	-1600	0.00	0.00	2	0	-2
0014	3T	21_1	146	11	0	1100	0	-1100	0.00	0.00	1	0	-1
0014	3T	21_1	152	4	0	400	0	-400	0.00	0.00	0	0	0
0014	3T	21_1	153	6	0	600	0	-600	0.00	0.00	1	0	-1
0014	3T	21_1	154	7	0	700	0	-700	0.00	0.00	1	0	-1
0014	3T	21_1	156	6	0	600	0	-600	0.00	0.00	1	0	-1
0014	3T	21_1	162	4	0	400	0	-400	0.00	0.00	0	0	0
0014	3T	21_1	165	1	0	100	0	-100	0.00	0.00	0	0	0
0014	3T	21_1	214	5	0	500	0	-500	0.00	0.00	0	0	0
0014	3T	21_1	215	4	0	400	0	-400	0.00	0.00	0	0	0
0014	3T	21_1	216	1	0	100	0	-100	0.00	0.00	0	0	0
0014	3T	21_1	234	2	0	200	0	-200	0.00	0.00	0	0	0
0014	3T	21_1	236	3	0	300	0	-300	0.00	0.00	0	0	0
0014	3T	21_1	241	1	0	100	0	-100	0.00	0.00	0	0	0
0014	3T	21_1	243	1	0	100	0	-100	0.00	0.00	0	0	0
0014	3T	21_1	245	1	0	100	0	-100	0.00	0.00	0	0	0
0014	3T	21_1	246	1	0	100	0	-100	0.00	0.00	0	0	0
0014	3T	21_1	264	2	0	200	0	-200	0.00	0.00	0	0	0
0014	3T	21_2	123	63	9	6300	6530	230	0.14	1.04	11	11	0
0014	3T	21_2	124	45	3	4500	2980	-1520	0.07	0.66	7	5	-2
0014	3T	21_2	125	34	2	3400	1560	-1840	0.06	0.46	6	2	-4
0014	3T	21_2	126	18	0	1800	0	-1800	0.00	0.00	3	0	-3
0014	3T	21_2	132	38	3	3800	2940	-860	0.08	0.77	6	5	-1
0014	3T	21_2	134	39	2	3900	1830	-2070	0.05	0.47	6	3	-3
0014	3T	21_2	135	18	3	1800	3390	1590	0.17	1.88	3	6	3
0014	3T	21_2	136	13	0	1300	0	-1300	0.00	0.00	2	0	-2
0014	3T	21_2	142	18	0	1800	0	-1800	0.00	0.00	3	0	-3
0014	3T	21_2	143	16	2	1600	2280	680	0.13	1.43	2	4	2
0014	3T	21_2	145	12	0	1200	0	-1200	0.00	0.00	2	0	-2
0014	3T	21_2	146	6	1	600	740	140	0.17	1.23	1	1	0
0014	3T	21_2	152	10	1	1000	760	-240	0.10	0.76	1	1	0
0014	3T	21_2	153	9	0	900	0	-900	0.00	0.00	1	0	-1
0014	3T	21_2	154	10	0	1000	0	-1000	0.00	0.00	1	0	-1
0014	3T	21_2	156	2	0	200	0	-200	0.00	0.00	0	0	0
0014	3T	21_2	162	1	0	100	0	-100	0.00	0.00	0	0	0
0014	3T	21_2	163	2	0	200	0	-200	0.00	0.00	0	0	0
0014	3T	21_2	164	4	0	400	0	-400	0.00	0.00	0	0	0
0014	3T	21_2	165	3	0	300	0	-300	0.00	0.00	0	0	0
0014	3T	21_2	213	2	0	200	0	-200	0.00	0.00	0	0	0
0014	3T	21_2	214	2	0	200	0	-200	0.00	0.00	0	0	0
0014	3T	21_2	215	6	0	600	0	-600	0.00	0.00	1	0	-1
0014	3T	21_2	216	3	0	300	0	-300	0.00	0.00	0	0	0
0014	3T	21_2	234	2	0	200	0	-200	0.00	0.00	0	0	0
0014	3T	21_2	235	3	0	300	0	-300	0.00	0.00	0	0	0
0014	3T	21_2	236	2	0	200	0	-200	0.00	0.00	0	0	0
0014	3T	21_2	241	1	0	100	0	-100	0.00	0.00	0	0	0
0014	3T	21_2	246	2	0	200	0	-200	0.00	0.00	0	0	0
0014	3T	21_2	251	3	0	300	0	-300	0.00	0.00	0	0	0
0014	3T	21_2	254	1	0	100	0	-100	0.00	0.00	0	0	0
0014	3T	21_2	265	1	0	100	0	-100	0.00	0.00	0	0	0
0014	3T	21_3	123	66	4	6600	4870	-1730	0.06	0.74	11	8	-3
0014	3T	21_3	124	47	2	4700	1640	-3060	0.04	0.35	8	2	-6
0014	3T	21_3	125	32	4	3200	5950	2750	0.13	1.86	5	10	5
0014	3T	21_3	126	19	2	1900	2740	840	0.11	1.44	3	4	1
0014	3T	21_3	132	30	2	3000	1120	-1880	0.07	0.37	5	1	-4
0014	3T	21_3	134	36	5	3600	5540	1940	0.14	1.54	6	9	3
0014	3T	21_3	135	23	0	2300	0	-2300	0.00	0.00	4	0	-4
0014	3T	21_3	136	17	1	1700	1010	-690	0.06	0.59	3	1	-2
0014	3T	21_3	142	15	0	1500	0	-1500	0.00	0.00	2	0	-2
0014	3T	21_3	143	23	1	2300	1280	-1020	0.04	0.56	4	2	-2
0014	3T	21_3	145	12	0	1200	0	-1200	0.00	0.00	2	0	-2
0014	3T	21_3	146	5	0	500	0	-500	0.00	0.00	0	0	0
0014	3T	21_3	152	5	0	500	0	-500	0.00	0.00	0	0	0
0014	3T	21_3	153	5	0	500	0	-500	0.00	0.00	0	0	0
0014	3T	21_3	154	10	0	1000	0	-1000	0.00	0.00	1	0	-1
0014	3T	21_3	156	4	0	400	0	-400	0.00	0.00	0	0	0
0014	3T	21_3	162	2	0	200	0	-200	0.00	0.00	0	0	0
0014	3T	21_3	163	1	0	100	0	-100	0.00	0.00	0	0	0
0014	3T	21_3	164	1	1	100	1820	1720	1.00	18.20	0	3	3
0014	3T	21_3	165	1	0	100	0	-100	0.00	0.00	0	0	0
0014	3T	21_3	213	7	0	700	0	-700	0.00	0.00	1	0	-1
0014	3T	21_3	214	3	0	300	0	-300	0.00	0.00	0	0	0
0014	3T	21_3	215	3	0	300	0	-300	0.00	0.00	0	0	0
0014	3T	21_3	216	3	0	300	0	-300	0.00	0.00	0	0	0
0014	3T	21_3	234	1	0	100	0	-100	0.00	0.00	0	0	0
0014	3T	21_3	236	2	0	200	0	-200	0.00	0.00	0	0	0
0014	3T	21_3	245	1	0	100	0	-100	0.00	0.00	0	0	0
0014	3T	21_3	256	1	0	100	0	-100	0.00	0.00	0	0	0
0014	3T	21_3	265	1	0	100	0	-100	0.00	0.00	0	0	0
0014	3T	21_4	123	41	2	4100	2610	-1490	0.05	0.64	7	4	-3
0014	3T	21_4	124	59	2	5900	3700	-2200	0.03	0.63	10	6	-4
0014	3T	21_4	125	32	2	3200	1210	-1990	0.06	0.38	5	2	-3
0014	3T	21_4	126	16	0	1600	0	-1600	0.00	0.00	2	0	-2
0014	3T	21_4	132	28	2	2800	2550	-250	0.07	0.91	4	4	0
0014	3T	21_4	134	31	3	3100	1310	-1790	0.10	0.42	5	2	-3
0014	3T	21_4	135	17	0	1700	0	-1700	0.00	0.00	3	0	-3
0014	3T	21_4	136	10	2	1000	2550	1550	0.20	2.55	1	4	3
0014	3T	21_4	142	18	0	1800	0	-1800	0.00	0.00	3	0	-3
0014	3T	21_4	143	22	1	2200	770	-1430	0.05	0.35	3	1	-2
0014	3T	21_4	145	11	1	1100	490	-610	0.09	0.45	1	0	-1
0014	3T	21_4	146	6	0	600	0	-600	0.00	0.00	1	0	-1
0014	3T	21_4	152	6	0	600	0	-600	0.00	0.00	1	0	-1
0014	3T	21_4	153	11	0	1100	0	-1100	0.00	0.00	1	0	-1
0014	3T	21_4	154	4	0	400	0	-400	0.00	0.00	0	0	0
0014	3T	21_4	156	1	0	100	0	-100	0.00	0.00	0	0	0
0014	3T	21_4	162	4	0	400	0	-400	0.00	0.00	0	0	0
0014	3T	21_4	163	1	0	100	0	-100	0.00	0.00	0	0	0
0014	3T	21_4	164	2	0	200	0	-200	0.00	0.00	0	0	0
0014	3T	21_4	213	3	1	300	1040	740	0.33	3.47	0	1	1
0014	3T	21_4	214	6	0	600	0	-600	0.00	0.00	1	0	-1
0014	3T	21_4	215	3	1	300	550	250	0.33	1.83	0	0	0
0014	3T	21_4	216	1	0	100	0	-100	0.00	0.00	0	0	0
0014	3T	21_4	231	1	0	100	0	-100	0.00	0.00	0	0	0
0014	3T	21_4	235	2	0	200	0	-200	0.00	0.00	0	0	0
0014	3T	21_4	236	1	0	100	0	-100	0.00	0.00	0	0	0
0014	3T	21_4	241	2	0	200	0	-200	0.00	0.00	0	0	0
0014	3T	21_4	253	1	0	100	0	-100	0.00	0.00	0	0	0
0014	3T	21_4	256	1	0	100	0	-100	0.00	0.00	0	0	0
0014	3T	21_4	261	1	0	100	0	-100	0.00	0.00	0	0	0
0014	3T	21_5	123	42	2	4200	2050	-2150	0.05	0.49	7	3	-4
0014	3T	21_5	124	36	2	3600	7110	3510	0.06	1.98	6	12	6
0014	3T	21_5	125	32	2	3200	1780	-1420	0.06	0.56	5	3	-2
0014	3T	21_5	126	16	0	1600	0	-1600	0.00	0.00	2	0	-2
0014	3T	21_5	132	30	1	3000	1130	-1870	0.03	0.38	5	2	-3
0014	3T	21_5	134	30	1	3000	800	-2200	0.03	0.27	5	1	-4
0014	3T	21_5	135	17	2	1700	1080	-620	0.12	0.64	3	1	-2
0014	3T	21_5	136	10	2	1000	2090	1090	0.20	2.09	1	3	2
0014	3T	21_5	142	16	0	1600	0	-1600	0.00	0.00	2	0	-2
0014	3T	21_5	143	17	1	1700	1510	-190	0.06	0.89	3	2	-1
0014	3T	21_5	145	9	0	900	0	-900	0.00	0.00	1	0	-1
0014	3T	21_5	146	3	0	300	0	-300	0.00	0.00	0	0	0
0014	3T	21_5	152	4	0	400	0	-400	0.00	0.00	0	0	0
0014	3T	21_5	153	9	0	900	0	-900	0.00	0.00	1	0	-1
0014	3T	21_5	154	5	0	500	0	-500	0.00	0.00	0	0	0
0014	3T	21_5	162	2	0	200	0	-200	0.00	0.00	0	0	0
0014	3T	21_5	163	1	0	100	0	-100	0.00	0.00	0	0	0
0014	3T	21_5	164	3	0	300	0	-300	0.00	0.00	0	0	0
0014	3T	21_5	213	2	0	200	0	-200	0.00	0.00	0	0	0
0014	3T	21_5	214	2	0	200	0	-200	0.00	0.00	0	0	0
0014	3T	21_5	215	1	0	100	0	-100	0.00	0.00	0	0	0
0014	3T	21_5	216	1	0	100	0	-100	0.00	0.00	0	0	0
0014	3T	21_5	235	4	0	400	0	-400	0.00	0.00	0	0	0
0014	3T	21_5	241	1	0	100	0	-100	0.00	0.00	0	0	0
0014	3T	21_5	246	1	0	100	0	-100	0.00	0.00	0	0	0
0014	3T	21_5	254	1	0	100	0	-100	0.00	0.00	0	0	0
0014	3T	21_6	123	4	0	400	0	-400	0.00	0.00	0	0	0
0014	3T	21_6	124	2	0	200	0	-200	0.00	0.00	0	0	0
0014	3T	21_6	125	1	0	100	0	-100	0.00	0.00	0	0	0
0014	3T	21_6	132	4	2	400	1760	1360	0.50	4.40	0	3	3
0014	3T	21_6	134	2	0	200	0	-200	0.00	0.00	0	0	0
0014	3T	21_6	135	2	0	200	0	-200	0.00	0.00	0	0	0
0014	3T	21_6	136	1	0	100	0	-100	0.00	0.00	0	0	0
0014	3T	21_6	142	2	0	200	0	-200	0.00	0.00	0	0	0
0014	3T	21_6	143	2	0	200	0	-200	0.00	0.00	0	0	0
0014	3T	21_6	145	1	0	100	0	-100	0.00	0.00	0	0	0
0014	3T	21_6	152	2	0	200	0	-200	0.00	0.00	0	0	0
0014	3T	21_6	154	1	0	100	0	-100	0.00	0.00	0	0	0
0014	3T	21_6	164	1	0	100	0	-100	0.00	0.00	0	0	0
0014	3T	21_6	215	1	0	100	0	-100	0.00	0.00	0	0	0
0014	3T	21_7	123	53	3	5300	1610	-3690	0.06	0.30	9	2	-7
0014	3T	21_7	124	64	7	6400	8730	2330	0.11	1.36	11	15	4
0014	3T	21_7	125	40	3	4000	1260	-2740	0.08	0.32	7	2	-5
0014	3T	21_7	126	23	1	2300	880	-1420	0.04	0.38	4	1	-3
0014	3T	21_7	132	34	1	3400	970	-2430	0.03	0.29	6	1	-5
0014	3T	21_7	134	31	1	3100	640	-2460	0.03	0.21	5	1	-4
0014	3T	21_7	135	27	1	2700	820	-1880	0.04	0.30	4	1	-3
0014	3T	21_7	136	11	0	1100	0	-1100	0.00	0.00	1	0	-1
0014	3T	21_7	142	17	0	1700	0	-1700	0.00	0.00	3	0	-3
0014	3T	21_7	143	23	0	2300	0	-2300	0.00	0.00	4	0	-4
0014	3T	21_7	145	18	1	1800	850	-950	0.06	0.47	3	1	-2
0014	3T	21_7	146	9	0	900	0	-900	0.00	0.00	1	0	-1
0014	3T	21_7	152	9	0	900	0	-900	0.00	0.00	1	0	-1
0014	3T	21_7	153	4	0	400	0	-400	0.00	0.00	0	0	0
0014	3T	21_7	154	3	0	300	0	-300	0.00	0.00	0	0	0
0014	3T	21_7	156	5	0	500	0	-500	0.00	0.00	0	0	0
0014	3T	21_7	163	1	1	100	3400	3300	1.00	34.00	0	6	6
0014	3T	21_7	164	5	0	500	0	-500	0.00	0.00	0	0	0
0014	3T	21_7	214	2	0	200	0	-200	0.00	0.00	0	0	0
0014	3T	21_7	215	4	1	400	540	140	0.25	1.35	0	0	0
0014	3T	21_7	234	1	0	100	0	-100	0.00	0.00	0	0	0
0014	3T	21_7	235	4	0	400	0	-400	0.00	0.00	0	0	0
0014	3T	21_7	236	1	0	100	0	-100	0.00	0.00	0	0	0
0014	3T	21_7	243	1	0	100	0	-100	0.00	0.00	0	0	0
0014	3T	21_7	245	2	0	200	0	-200	0.00	0.00	0	0	0
0014	3T	21_7	254	1	0	100	0	-100	0.00	0.00	0	0	0
0014	3T	21_7	263	1	0	100	0	-100	0.00	0.00	0	0	0
0014	3T	22_1	123	49	3	4900	4730	-170	0.06	0.97	8	8	0
0014	3T	22_1	124	47	2	4700	1180	-3520	0.04	0.25	8	2	-6
0014	3T	22_1	125	33	0	3300	0	-3300	0.00	0.00	5	0	-5
0014	3T	22_1	126	20	1	2000	3810	1810	0.05	1.91	3	6	3
0014	3T	22_1	132	28	3	2800	3940	1140	0.11	1.41	4	6	2
0014	3T	22_1	134	23	3	2300	2140	-160	0.13	0.93	4	3	-1
0014	3T	22_1	135	21	2	2100	3080	980	0.10	1.47	3	5	2
0014	3T	22_1	136	14	1	1400	1110	-290	0.07	0.79	2	1	-1
0014	3T	22_1	142	22	1	2200	860	-1340	0.05	0.39	3	1	-2
0014	3T	22_1	143	16	1	1600	1030	-570	0.06	0.64	2	1	-1
0014	3T	22_1	145	9	1	900	3690	2790	0.11	4.10	1	6	5
0014	3T	22_1	146	8	0	800	0	-800	0.00	0.00	1	0	-1
0014	3T	22_1	152	5	0	500	0	-500	0.00	0.00	0	0	0
0014	3T	22_1	153	6	1	600	1040	440	0.17	1.73	1	1	0
0014	3T	22_1	154	3	0	300	0	-300	0.00	0.00	0	0	0
0014	3T	22_1	156	1	0	100	0	-100	0.00	0.00	0	0	0
0014	3T	22_1	162	1	0	100	0	-100	0.00	0.00	0	0	0
0014	3T	22_1	163	6	1	600	1500	900	0.17	2.50	1	2	1
0014	3T	22_1	164	2	0	200	0	-200	0.00	0.00	0	0	0
0014	3T	22_1	213	3	0	300	0	-300	0.00	0.00	0	0	0
0014	3T	22_1	214	2	0	200	0	-200	0.00	0.00	0	0	0
0014	3T	22_1	215	1	1	100	1330	1230	1.00	13.30	0	2	2
0014	3T	22_1	216	4	0	400	0	-400	0.00	0.00	0	0	0
0014	3T	22_1	231	1	0	100	0	-100	0.00	0.00	0	0	0
0014	3T	22_1	234	1	0	100	0	-100	0.00	0.00	0	0	0
0014	3T	22_1	251	2	0	200	0	-200	0.00	0.00	0	0	0
0014	3T	22_1	253	2	0	200	0	-200	0.00	0.00	0	0	0
0014	3T	22_1	256	1	0	100	0	-100	0.00	0.00	0	0	0
0014	3T	22_1	263	1	0	100	0	-100	0.00	0.00	0	0	0
0014	3T	22_2	123	46	4	4600	2430	-2170	0.09	0.53	8	4	-4
0014	3T	22_2	124	38	7	3800	10210	6410	0.18	2.69	6	18	12
0014	3T	22_2	125	28	3	2800	3210	410	0.11	1.15	4	5	1
0014	3T	22_2	126	25	0	2500	0	-2500	0.00	0.00	4	0	-4
0014	3T	22_2	132	19	1	1900	970	-930	0.05	0.51	3	1	-2
0014	3T	22_2	134	21	1	2100	730	-1370	0.05	0.35	3	1	-2
0014	3T	22_2	135	8	0	800	0	-800	0.00	0.00	1	0	-1
0014	3T	22_2	136	18	0	1800	0	-1800	0.00	0.00	3	0	-3
0014	3T	22_2	142	20	0	2000	0	-2000	0.00	0.00	3	0	-3
0014	3T	22_2	143	19	1	1900	900	-1000	0.05	0.47	3	1	-2
0014	3T	22_2	145	9	0	900	0	-900	0.00	0.00	1	0	-1
0014	3T	22_2	146	9	0	900	0	-900	0.00	0.00	1	0	-1
0014	3T	22_2	152	8	0	800	0	-800	0.00	0.00	1	0	-1
0014	3T	22_2	153	4	0	400	0	-400	0.00	0.00	0	0	0
0014	3T	22_2	154	2	0	200	0	-200	0.00	0.00	0	0	0
0014	3T	22_2	156	2	0	200	0	-200	0.00	0.00	0	0	0
0014	3T	22_2	162	5	0	500	0	-500	0.00	0.00	0	0	0
0014	3T	22_2	163	1	0	100	0	-100	0.00	0.00	0	0	0
0014	3T	22_2	164	3	0	300	0	-300	0.00	0.00	0	0	0
0014	3T	22_2	165	1	0	100	0	-100	0.00	0.00	0	0	0
0014	3T	22_2	213	5	0	500	0	-500	0.00	0.00	0	0	0
0014	3T	22_2	214	3	0	300	0	-300	0.00	0.00	0	0	0
0014	3T	22_2	215	5	1	500	1920	1420	0.20	3.84	0	3	3
0014	3T	22_2	216	1	0	100	0	-100	0.00	0.00	0	0	0
0014	3T	22_2	231	2	0	200	0	-200	0.00	0.00	0	0	0
0014	3T	22_2	235	1	1	100	5000	4900	1.00	50.00	0	8	8
0014	3T	22_2	236	1	0	100	0	-100	0.00	0.00	0	0	0
0014	3T	22_2	241	1	1	100	1010	910	1.00	10.10	0	1	1
0014	3T	22_2	243	1	0	100	0	-100	0.00	0.00	0	0	0
0014	3T	22_2	245	1	0	100	0	-100	0.00	0.00	0	0	0
0014	3T	22_2	246	2	0	200	0	-200	0.00	0.00	0	0	0
0014	3T	22_2	253	2	0	200	0	-200	0.00	0.00	0	0	0
0014	3T	22_2	254	1	0	100	0	-100	0.00	0.00	0	0	0
0014	3T	22_2	261	2	1	200	1500	1300	0.50	7.50	0	2	2
0014	3T	22_2	263	1	0	100	0	-100	0.00	0.00	0	0	0
0014	3T	22_2	265	1	0	100	0	-100	0.00	0.00	0	0	0
0014	3T	22_3	123	41	6	4100	5940	1840	0.15	1.45	7	10	3
0014	3T	22_3	124	30	3	3000	2350	-650	0.10	0.78	5	4	-1
0014	3T	22_3	125	20	1	2000	540	-1460	0.05	0.27	3	0	-3
0014	3T	22_3	126	24	1	2400	770	-1630	0.04	0.32	4	1	-3
0014	3T	22_3	132	25	1	2500	670	-1830	0.04	0.27	4	1	-3
0014	3T	22_3	134	19	2	1900	3430	1530	0.11	1.81	3	6	3
0014	3T	22_3	135	16	0	1600	0	-1600	0.00	0.00	2	0	-2
0014	3T	22_3	136	10	0	1000	0	-1000	0.00	0.00	1	0	-1
0014	3T	22_3	142	15	0	1500	0	-1500	0.00	0.00	2	0	-2
0014	3T	22_3	143	11	1	1100	610	-490	0.09	0.55	1	1	0
0014	3T	22_3	145	8	1	800	1030	230	0.13	1.29	1	1	0
0014	3T	22_3	146	7	1	700	730	30	0.14	1.04	1	1	0
0014	3T	22_3	152	4	0	400	0	-400	0.00	0.00	0	0	0
0014	3T	22_3	153	7	1	700	2880	2180	0.14	4.11	1	5	4
0014	3T	22_3	154	5	0	500	0	-500	0.00	0.00	0	0	0
0014	3T	22_3	156	4	0	400	0	-400	0.00	0.00	0	0	0
0014	3T	22_3	162	3	0	300	0	-300	0.00	0.00	0	0	0
0014	3T	22_3	163	4	0	400	0	-400	0.00	0.00	0	0	0
0014	3T	22_3	164	2	0	200	0	-200	0.00	0.00	0	0	0
0014	3T	22_3	165	2	0	200	0	-200	0.00	0.00	0	0	0
0014	3T	22_3	213	3	0	300	0	-300	0.00	0.00	0	0	0
0014	3T	22_3	214	4	0	400	0	-400	0.00	0.00	0	0	0
0014	3T	22_3	215	5	0	500	0	-500	0.00	0.00	0	0	0
0014	3T	22_3	216	3	0	300	0	-300	0.00	0.00	0	0	0
0014	3T	22_3	235	2	0	200	0	-200	0.00	0.00	0	0	0
0014	3T	22_3	243	3	0	300	0	-300	0.00	0.00	0	0	0
0014	3T	22_3	253	3	0	300	0	-300	0.00	0.00	0	0	0
0014	3T	22_3	256	1	1	100	1590	1490	1.00	15.90	0	2	2
0014	3T	22_3	261	1	0	100	0	-100	0.00	0.00	0	0	0
0014	3T	22_4	123	44	1	4400	340	-4060	0.02	0.08	7	0	-7
0014	3T	22_4	124	42	4	4200	5670	1470	0.10	1.35	7	10	3
0014	3T	22_4	125	26	0	2600	0	-2600	0.00	0.00	4	0	-4
0014	3T	22_4	126	16	1	1600	2920	1320	0.06	1.83	2	5	3
0014	3T	22_4	132	19	0	1900	0	-1900	0.00	0.00	3	0	-3
0014	3T	22_4	134	22	0	2200	0	-2200	0.00	0.00	3	0	-3
0014	3T	22_4	135	14	1	1400	370	-1030	0.07	0.26	2	0	-2
0014	3T	22_4	136	19	3	1900	2100	200	0.16	1.11	3	3	0
0014	3T	22_4	142	13	1	1300	490	-810	0.08	0.38	2	0	-2
0014	3T	22_4	143	13	0	1300	0	-1300	0.00	0.00	2	0	-2
0014	3T	22_4	145	8	0	800	0	-800	0.00	0.00	1	0	-1
0014	3T	22_4	146	5	0	500	0	-500	0.00	0.00	0	0	0
0014	3T	22_4	152	6	0	600	0	-600	0.00	0.00	1	0	-1
0014	3T	22_4	153	4	0	400	0	-400	0.00	0.00	0	0	0
0014	3T	22_4	154	2	0	200	0	-200	0.00	0.00	0	0	0
0014	3T	22_4	156	2	0	200	0	-200	0.00	0.00	0	0	0
0014	3T	22_4	162	2	0	200	0	-200	0.00	0.00	0	0	0
0014	3T	22_4	163	3	0	300	0	-300	0.00	0.00	0	0	0
0014	3T	22_4	164	3	1	300	2480	2180	0.33	8.27	0	4	4
0014	3T	22_4	165	1	0	100	0	-100	0.00	0.00	0	0	0
0014	3T	22_4	213	5	0	500	0	-500	0.00	0.00	0	0	0
0014	3T	22_4	214	2	0	200	0	-200	0.00	0.00	0	0	0
0014	3T	22_4	215	1	0	100	0	-100	0.00	0.00	0	0	0
0014	3T	22_4	216	2	0	200	0	-200	0.00	0.00	0	0	0
0014	3T	22_4	234	2	0	200	0	-200	0.00	0.00	0	0	0
0014	3T	22_4	235	2	0	200	0	-200	0.00	0.00	0	0	0
0014	3T	22_4	243	2	0	200	0	-200	0.00	0.00	0	0	0
0014	3T	22_4	245	2	0	200	0	-200	0.00	0.00	0	0	0
0014	3T	22_4	246	1	0	100	0	-100	0.00	0.00	0	0	0
0014	3T	22_4	253	1	0	100	0	-100	0.00	0.00	0	0	0
0014	3T	22_4	254	2	0	200	0	-200	0.00	0.00	0	0	0
0014	3T	22_4	256	1	0	100	0	-100	0.00	0.00	0	0	0
0014	3T	22_4	261	1	0	100	0	-100	0.00	0.00	0	0	0
0014	3T	22_4	263	1	0	100	0	-100	0.00	0.00	0	0	0
0014	3T	22_4	264	2	0	200	0	-200	0.00	0.00	0	0	0
0014	3T	22_4	265	1	0	100	0	-100	0.00	0.00	0	0	0
0014	3T	22_5	123	46	4	4600	6080	1480	0.09	1.32	8	10	2
0014	3T	22_5	124	46	4	4600	3010	-1590	0.09	0.65	8	5	-3
0014	3T	22_5	125	13	0	1300	0	-1300	0.00	0.00	2	0	-2
0014	3T	22_5	126	14	0	1400	0	-1400	0.00	0.00	2	0	-2
0014	3T	22_5	132	26	3	2600	3290	690	0.12	1.27	4	5	1
0014	3T	22_5	134	24	1	2400	1080	-1320	0.04	0.45	4	1	-3
0014	3T	22_5	135	18	2	1800	3260	1460	0.11	1.81	3	5	2
0014	3T	22_5	136	11	0	1100	0	-1100	0.00	0.00	1	0	-1
0014	3T	22_5	142	16	1	1600	3200	1600	0.06	2.00	2	5	3
0014	3T	22_5	143	14	1	1400	1580	180	0.07	1.13	2	2	0
0014	3T	22_5	145	8	0	800	0	-800	0.00	0.00	1	0	-1
0014	3T	22_5	146	1	0	100	0	-100	0.00	0.00	0	0	0
0014	3T	22_5	152	1	0	100	0	-100	0.00	0.00	0	0	0
0014	3T	22_5	154	1	0	100	0	-100	0.00	0.00	0	0	0
0014	3T	22_5	163	1	0	100	0	-100	0.00	0.00	0	0	0
0014	3T	22_5	213	2	1	200	4540	4340	0.50	22.70	0	8	8
0014	3T	22_5	214	3	0	300	0	-300	0.00	0.00	0	0	0
0014	3T	22_5	215	1	0	100	0	-100	0.00	0.00	0	0	0
0014	3T	22_5	216	2	0	200	0	-200	0.00	0.00	0	0	0
0014	3T	22_5	231	1	0	100	0	-100	0.00	0.00	0	0	0
0014	3T	22_5	234	2	0	200	0	-200	0.00	0.00	0	0	0
0014	3T	22_5	241	1	0	100	0	-100	0.00	0.00	0	0	0
0014	3T	22_5	243	1	0	100	0	-100	0.00	0.00	0	0	0
0014	3T	22_5	246	1	0	100	0	-100	0.00	0.00	0	0	0
0014	3T	22_5	251	1	0	100	0	-100	0.00	0.00	0	0	0
0014	3T	22_5	253	1	0	100	0	-100	0.00	0.00	0	0	0
0014	3T	22_5	256	1	0	100	0	-100	0.00	0.00	0	0	0
0014	3T	22_7	123	59	6	5900	4590	-1310	0.10	0.78	10	8	-2
0014	3T	22_7	124	38	2	3800	1690	-2110	0.05	0.44	6	2	-4
0014	3T	22_7	125	39	7	3900	10940	7040	0.18	2.81	6	19	13
0014	3T	22_7	126	18	0	1800	0	-1800	0.00	0.00	3	0	-3
0014	3T	22_7	132	26	1	2600	1220	-1380	0.04	0.47	4	2	-2
0014	3T	22_7	134	29	2	2900	1070	-1830	0.07	0.37	5	1	-4
0014	3T	22_7	135	17	0	1700	0	-1700	0.00	0.00	3	0	-3
0014	3T	22_7	136	10	0	1000	0	-1000	0.00	0.00	1	0	-1
0014	3T	22_7	142	15	1	1500	620	-880	0.07	0.41	2	1	-1
0014	3T	22_7	143	13	0	1300	0	-1300	0.00	0.00	2	0	-2
0014	3T	22_7	145	10	0	1000	0	-1000	0.00	0.00	1	0	-1
0014	3T	22_7	146	3	0	300	0	-300	0.00	0.00	0	0	0
0014	3T	22_7	152	1	0	100	0	-100	0.00	0.00	0	0	0
0014	3T	22_7	153	5	0	500	0	-500	0.00	0.00	0	0	0
0014	3T	22_7	154	3	0	300	0	-300	0.00	0.00	0	0	0
0014	3T	22_7	156	1	1	100	6310	6210	1.00	63.10	0	11	11
0014	3T	22_7	162	2	0	200	0	-200	0.00	0.00	0	0	0
0014	3T	22_7	163	2	0	200	0	-200	0.00	0.00	0	0	0
0014	3T	22_7	164	3	0	300	0	-300	0.00	0.00	0	0	0
0014	3T	22_7	165	1	0	100	0	-100	0.00	0.00	0	0	0
0014	3T	22_7	213	4	0	400	0	-400	0.00	0.00	0	0	0
0014	3T	22_7	214	1	0	100	0	-100	0.00	0.00	0	0	0
0014	3T	22_7	215	2	0	200	0	-200	0.00	0.00	0	0	0
0014	3T	22_7	216	1	0	100	0	-100	0.00	0.00	0	0	0
0014	3T	22_7	231	2	0	200	0	-200	0.00	0.00	0	0	0
0014	3T	22_7	234	1	0	100	0	-100	0.00	0.00	0	0	0
0014	3T	22_7	235	2	0	200	0	-200	0.00	0.00	0	0	0
0014	3T	22_7	243	2	0	200	0	-200	0.00	0.00	0	0	0
0014	3T	22_7	246	1	0	100	0	-100	0.00	0.00	0	0	0
0014	3T	22_7	264	1	0	100	0	-100	0.00	0.00	0	0	0
0014	3T	23_1	123	66	6	6600	4580	-2020	0.09	0.69	11	8	-3
0014	3T	23_1	124	33	3	3300	3920	620	0.09	1.19	5	6	1
0014	3T	23_1	125	30	1	3000	1700	-1300	0.03	0.57	5	3	-2
0014	3T	23_1	126	21	0	2100	0	-2100	0.00	0.00	3	0	-3
0014	3T	23_1	132	24	2	2400	1450	-950	0.08	0.60	4	2	-2
0014	3T	23_1	134	30	2	3000	1730	-1270	0.07	0.58	5	3	-2
0014	3T	23_1	135	18	2	1800	2730	930	0.11	1.52	3	4	1
0014	3T	23_1	136	17	2	1700	4620	2920	0.12	2.72	3	8	5
0014	3T	23_1	142	13	2	1300	9500	8200	0.15	7.31	2	16	14
0014	3T	23_1	143	14	1	1400	3090	1690	0.07	2.21	2	5	3
0014	3T	23_1	145	12	0	1200	0	-1200	0.00	0.00	2	0	-2
0014	3T	23_1	146	10	0	1000	0	-1000	0.00	0.00	1	0	-1
0014	3T	23_1	152	3	0	300	0	-300	0.00	0.00	0	0	0
0014	3T	23_1	153	7	1	700	2310	1610	0.14	3.30	1	4	3
0014	3T	23_1	154	2	0	200	0	-200	0.00	0.00	0	0	0
0014	3T	23_1	156	1	0	100	0	-100	0.00	0.00	0	0	0
0014	3T	23_1	162	2	0	200	0	-200	0.00	0.00	0	0	0
0014	3T	23_1	163	3	0	300	0	-300	0.00	0.00	0	0	0
0014	3T	23_1	164	1	0	100	0	-100	0.00	0.00	0	0	0
0014	3T	23_1	165	2	0	200	0	-200	0.00	0.00	0	0	0
0014	3T	23_1	213	6	0	600	0	-600	0.00	0.00	1	0	-1
0014	3T	23_1	214	1	0	100	0	-100	0.00	0.00	0	0	0
0014	3T	23_1	215	1	0	100	0	-100	0.00	0.00	0	0	0
0014	3T	23_1	216	2	0	200	0	-200	0.00	0.00	0	0	0
0014	3T	23_1	234	2	0	200	0	-200	0.00	0.00	0	0	0
0014	3T	23_1	235	2	0	200	0	-200	0.00	0.00	0	0	0
0014	3T	23_1	241	1	0	100	0	-100	0.00	0.00	0	0	0
0014	3T	23_1	243	1	0	100	0	-100	0.00	0.00	0	0	0
0014	3T	23_1	245	1	0	100	0	-100	0.00	0.00	0	0	0
0014	3T	23_1	251	1	0	100	0	-100	0.00	0.00	0	0	0
0014	3T	23_1	253	1	0	100	0	-100	0.00	0.00	0	0	0
0014	3T	23_1	256	1	0	100	0	-100	0.00	0.00	0	0	0
0014	3T	23_1	261	1	0	100	0	-100	0.00	0.00	0	0	0
0014	3T	23_2	123	55	2	5500	1650	-3850	0.04	0.30	9	2	-7
0014	3T	23_2	124	54	5	5400	6600	1200	0.09	1.22	9	11	2
0014	3T	23_2	125	31	4	3100	2850	-250	0.13	0.92	5	5	0
0014	3T	23_2	126	25	1	2500	1260	-1240	0.04	0.50	4	2	-2
0014	3T	23_2	132	23	0	2300	0	-2300	0.00	0.00	4	0	-4
0014	3T	23_2	134	22	3	2200	3450	1250	0.14	1.57	3	6	3
0014	3T	23_2	135	18	0	1800	0	-1800	0.00	0.00	3	0	-3
0014	3T	23_2	136	13	0	1300	0	-1300	0.00	0.00	2	0	-2
0014	3T	23_2	142	16	0	1600	0	-1600	0.00	0.00	2	0	-2
0014	3T	23_2	143	13	0	1300	0	-1300	0.00	0.00	2	0	-2
0014	3T	23_2	145	11	0	1100	0	-1100	0.00	0.00	1	0	-1
0014	3T	23_2	146	6	0	600	0	-600	0.00	0.00	1	0	-1
0014	3T	23_2	152	9	2	900	2360	1460	0.22	2.62	1	4	3
0014	3T	23_2	153	2	0	200	0	-200	0.00	0.00	0	0	0
0014	3T	23_2	154	6	0	600	0	-600	0.00	0.00	1	0	-1
0014	3T	23_2	156	4	0	400	0	-400	0.00	0.00	0	0	0
0014	3T	23_2	162	3	0	300	0	-300	0.00	0.00	0	0	0
0014	3T	23_2	163	2	0	200	0	-200	0.00	0.00	0	0	0
0014	3T	23_2	164	2	0	200	0	-200	0.00	0.00	0	0	0
0014	3T	23_2	165	3	0	300	0	-300	0.00	0.00	0	0	0
0014	3T	23_2	213	3	0	300	0	-300	0.00	0.00	0	0	0
0014	3T	23_2	214	5	0	500	0	-500	0.00	0.00	0	0	0
0014	3T	23_2	216	1	0	100	0	-100	0.00	0.00	0	0	0
0014	3T	23_2	231	3	0	300	0	-300	0.00	0.00	0	0	0
0014	3T	23_2	234	1	0	100	0	-100	0.00	0.00	0	0	0
0014	3T	23_2	235	2	0	200	0	-200	0.00	0.00	0	0	0
0014	3T	23_2	243	3	0	300	0	-300	0.00	0.00	0	0	0
0014	3T	23_2	245	1	0	100	0	-100	0.00	0.00	0	0	0
0014	3T	23_2	246	1	0	100	0	-100	0.00	0.00	0	0	0
0014	3T	23_2	251	1	0	100	0	-100	0.00	0.00	0	0	0
0014	3T	23_2	254	1	0	100	0	-100	0.00	0.00	0	0	0
0014	3T	23_2	263	1	0	100	0	-100	0.00	0.00	0	0	0
0014	3T	23_3	123	60	7	6000	9640	3640	0.12	1.61	10	17	7
0014	3T	23_3	124	35	0	3500	0	-3500	0.00	0.00	6	0	-6
0014	3T	23_3	125	20	0	2000	0	-2000	0.00	0.00	3	0	-3
0014	3T	23_3	126	16	2	1600	8500	6900	0.13	5.31	2	15	13
0014	3T	23_3	132	24	5	2400	4140	1740	0.21	1.73	4	7	3
0014	3T	23_3	134	25	1	2500	1060	-1440	0.04	0.42	4	1	-3
0014	3T	23_3	135	19	1	1900	3320	1420	0.05	1.75	3	5	2
0014	3T	23_3	136	12	1	1200	6170	4970	0.08	5.14	2	10	8
0014	3T	23_3	142	15	2	1500	3050	1550	0.13	2.03	2	5	3
0014	3T	23_3	143	14	0	1400	0	-1400	0.00	0.00	2	0	-2
0014	3T	23_3	145	8	0	800	0	-800	0.00	0.00	1	0	-1
0014	3T	23_3	146	8	0	800	0	-800	0.00	0.00	1	0	-1
0014	3T	23_3	152	6	0	600	0	-600	0.00	0.00	1	0	-1
0014	3T	23_3	153	7	1	700	7410	6710	0.14	10.59	1	13	12
0014	3T	23_3	154	8	0	800	0	-800	0.00	0.00	1	0	-1
0014	3T	23_3	156	4	1	400	3530	3130	0.25	8.83	0	6	6
0014	3T	23_3	162	2	0	200	0	-200	0.00	0.00	0	0	0
0014	3T	23_3	163	2	0	200	0	-200	0.00	0.00	0	0	0
0014	3T	23_3	213	5	2	500	2310	1810	0.40	4.62	0	4	4
0014	3T	23_3	214	3	1	300	730	430	0.33	2.43	0	1	1
0014	3T	23_3	215	2	0	200	0	-200	0.00	0.00	0	0	0
0014	3T	23_3	216	2	0	200	0	-200	0.00	0.00	0	0	0
0014	3T	23_3	231	2	0	200	0	-200	0.00	0.00	0	0	0
0014	3T	23_3	234	2	0	200	0	-200	0.00	0.00	0	0	0
0014	3T	23_3	235	1	0	100	0	-100	0.00	0.00	0	0	0
0014	3T	23_3	236	1	0	100	0	-100	0.00	0.00	0	0	0
0014	3T	23_3	243	1	0	100	0	-100	0.00	0.00	0	0	0
0014	3T	23_3	245	3	0	300	0	-300	0.00	0.00	0	0	0
0014	3T	23_3	246	3	1	300	1310	1010	0.33	4.37	0	2	2
0014	3T	23_3	253	1	0	100	0	-100	0.00	0.00	0	0	0
0014	3T	23_3	254	1	0	100	0	-100	0.00	0.00	0	0	0
0014	3T	23_3	261	1	0	100	0	-100	0.00	0.00	0	0	0
0014	3T	23_3	263	1	0	100	0	-100	0.00	0.00	0	0	0
0014	3T	23_4	123	70	7	7000	4280	-2720	0.10	0.61	12	7	-5
0014	3T	23_4	124	46	4	4600	2030	-2570	0.09	0.44	8	3	-5
0014	3T	23_4	125	34	2	3400	8840	5440	0.06	2.60	6	15	9
0014	3T	23_4	126	14	0	1400	0	-1400	0.00	0.00	2	0	-2
0014	3T	23_4	132	37	2	3700	2350	-1350	0.05	0.64	6	4	-2
0014	3T	23_4	134	28	1	2800	1110	-1690	0.04	0.40	4	1	-3
0014	3T	23_4	135	27	2	2700	1200	-1500	0.07	0.44	4	2	-2
0014	3T	23_4	136	12	0	1200	0	-1200	0.00	0.00	2	0	-2
0014	3T	23_4	142	11	0	1100	0	-1100	0.00	0.00	1	0	-1
0014	3T	23_4	143	10	0	1000	0	-1000	0.00	0.00	1	0	-1
0014	3T	23_4	145	6	0	600	0	-600	0.00	0.00	1	0	-1
0014	3T	23_4	146	5	0	500	0	-500	0.00	0.00	0	0	0
0014	3T	23_4	153	10	1	1000	1990	990	0.10	1.99	1	3	2
0014	3T	23_4	154	4	0	400	0	-400	0.00	0.00	0	0	0
0014	3T	23_4	156	2	0	200	0	-200	0.00	0.00	0	0	0
0014	3T	23_4	162	1	0	100	0	-100	0.00	0.00	0	0	0
0014	3T	23_4	163	2	1	200	9510	9310	0.50	47.55	0	16	16
0014	3T	23_4	164	1	0	100	0	-100	0.00	0.00	0	0	0
0014	3T	23_4	165	3	0	300	0	-300	0.00	0.00	0	0	0
0014	3T	23_4	213	3	0	300	0	-300	0.00	0.00	0	0	0
0014	3T	23_4	215	3	0	300	0	-300	0.00	0.00	0	0	0
0014	3T	23_4	231	1	0	100	0	-100	0.00	0.00	0	0	0
0014	3T	23_4	234	4	0	400	0	-400	0.00	0.00	0	0	0
0014	3T	23_4	236	2	0	200	0	-200	0.00	0.00	0	0	0
0014	3T	23_4	253	1	0	100	0	-100	0.00	0.00	0	0	0
0014	3T	23_5	123	42	4	4200	3130	-1070	0.10	0.75	7	5	-2
0014	3T	23_5	124	44	7	4400	4680	280	0.16	1.06	7	8	1
0014	3T	23_5	125	32	2	3200	2800	-400	0.06	0.88	5	4	-1
0014	3T	23_5	126	12	0	1200	0	-1200	0.00	0.00	2	0	-2
0014	3T	23_5	132	23	1	2300	770	-1530	0.04	0.33	4	1	-3
0014	3T	23_5	134	19	1	1900	1080	-820	0.05	0.57	3	1	-2
0014	3T	23_5	135	8	0	800	0	-800	0.00	0.00	1	0	-1
0014	3T	23_5	136	6	0	600	0	-600	0.00	0.00	1	0	-1
0014	3T	23_5	142	10	0	1000	0	-1000	0.00	0.00	1	0	-1
0014	3T	23_5	143	8	0	800	0	-800	0.00	0.00	1	0	-1
0014	3T	23_5	145	12	0	1200	0	-1200	0.00	0.00	2	0	-2
0014	3T	23_5	146	5	1	500	830	330	0.20	1.66	0	1	1
0014	3T	23_5	152	8	1	800	2400	1600	0.13	3.00	1	4	3
0014	3T	23_5	153	4	0	400	0	-400	0.00	0.00	0	0	0
0014	3T	23_5	154	5	0	500	0	-500	0.00	0.00	0	0	0
0014	3T	23_5	156	3	1	300	1010	710	0.33	3.37	0	1	1
0014	3T	23_5	162	4	0	400	0	-400	0.00	0.00	0	0	0
0014	3T	23_5	163	2	0	200	0	-200	0.00	0.00	0	0	0
0014	3T	23_5	164	3	0	300	0	-300	0.00	0.00	0	0	0
0014	3T	23_5	165	1	0	100	0	-100	0.00	0.00	0	0	0
0014	3T	23_5	213	1	0	100	0	-100	0.00	0.00	0	0	0
0014	3T	23_5	214	2	0	200	0	-200	0.00	0.00	0	0	0
0014	3T	23_5	215	2	0	200	0	-200	0.00	0.00	0	0	0
0014	3T	23_5	216	1	0	100	0	-100	0.00	0.00	0	0	0
0014	3T	23_5	231	1	0	100	0	-100	0.00	0.00	0	0	0
0014	3T	23_5	235	1	0	100	0	-100	0.00	0.00	0	0	0
0014	3T	23_5	236	1	0	100	0	-100	0.00	0.00	0	0	0
0014	3T	23_5	264	1	0	100	0	-100	0.00	0.00	0	0	0
0014	3T	23_6	123	2	0	200	0	-200	0.00	0.00	0	0	0
0014	3T	23_6	124	4	0	400	0	-400	0.00	0.00	0	0	0
0014	3T	23_6	125	4	0	400	0	-400	0.00	0.00	0	0	0
0014	3T	23_6	126	1	0	100	0	-100	0.00	0.00	0	0	0
0014	3T	23_6	132	2	0	200	0	-200	0.00	0.00	0	0	0
0014	3T	23_6	134	1	0	100	0	-100	0.00	0.00	0	0	0
0014	3T	23_6	135	2	0	200	0	-200	0.00	0.00	0	0	0
0014	3T	23_6	136	1	0	100	0	-100	0.00	0.00	0	0	0
0014	3T	23_6	142	3	0	300	0	-300	0.00	0.00	0	0	0
0014	3T	23_6	143	2	0	200	0	-200	0.00	0.00	0	0	0
0014	3T	23_6	145	2	1	200	820	620	0.50	4.10	0	1	1
0014	3T	23_6	146	1	0	100	0	-100	0.00	0.00	0	0	0
0014	3T	23_7	123	69	7	6900	5160	-1740	0.10	0.75	12	9	-3
0014	3T	23_7	124	54	1	5400	480	-4920	0.02	0.09	9	0	-9
0014	3T	23_7	125	25	1	2500	3130	630	0.04	1.25	4	5	1
0014	3T	23_7	126	21	2	2100	4880	2780	0.10	2.32	3	8	5
0014	3T	23_7	132	26	1	2600	390	-2210	0.04	0.15	4	0	-4
0014	3T	23_7	134	31	2	3100	3170	70	0.06	1.02	5	5	0
0014	3T	23_7	135	22	4	2200	7670	5470	0.18	3.49	3	13	10
0014	3T	23_7	136	14	2	1400	1670	270	0.14	1.19	2	2	0
0014	3T	23_7	142	26	0	2600	0	-2600	0.00	0.00	4	0	-4
0014	3T	23_7	143	21	0	2100	0	-2100	0.00	0.00	3	0	-3
0014	3T	23_7	145	11	1	1100	750	-350	0.09	0.68	1	1	0
0014	3T	23_7	146	7	0	700	0	-700	0.00	0.00	1	0	-1
0014	3T	23_7	152	10	1	1000	1560	560	0.10	1.56	1	2	1
0014	3T	23_7	153	3	0	300	0	-300	0.00	0.00	0	0	0
0014	3T	23_7	154	4	0	400	0	-400	0.00	0.00	0	0	0
0014	3T	23_7	156	6	0	600	0	-600	0.00	0.00	1	0	-1
0014	3T	23_7	162	2	0	200	0	-200	0.00	0.00	0	0	0
0014	3T	23_7	163	2	0	200	0	-200	0.00	0.00	0	0	0
0014	3T	23_7	164	1	0	100	0	-100	0.00	0.00	0	0	0
0014	3T	23_7	213	1	0	100	0	-100	0.00	0.00	0	0	0
0014	3T	23_7	214	1	0	100	0	-100	0.00	0.00	0	0	0
0014	3T	23_7	215	2	0	200	0	-200	0.00	0.00	0	0	0
0014	3T	23_7	216	2	1	200	1700	1500	0.50	8.50	0	3	3
0014	3T	23_7	234	1	0	100	0	-100	0.00	0.00	0	0	0
0014	3T	23_7	235	1	1	100	28650	28550	1.00	286.50	0	50	50
0014	3T	23_7	241	1	0	100	0	-100	0.00	0.00	0	0	0
0014	3T	23_7	243	1	0	100	0	-100	0.00	0.00	0	0	0
0014	3T	23_7	253	1	0	100	0	-100	0.00	0.00	0	0	0
0014	3T	23_7	263	2	0	200	0	-200	0.00	0.00	0	0	0
0014	3T	24_1	123	58	6	5800	3320	-2480	0.10	0.57	10	5	-5
0014	3T	24_1	124	56	3	5600	1450	-4150	0.05	0.26	9	2	-7
0014	3T	24_1	125	38	7	3800	14740	10940	0.18	3.88	6	26	20
0014	3T	24_1	126	26	1	2600	2490	-110	0.04	0.96	4	4	0
0014	3T	24_1	132	36	4	3600	6500	2900	0.11	1.81	6	11	5
0014	3T	24_1	134	42	4	4200	6020	1820	0.10	1.43	7	10	3
0014	3T	24_1	135	23	2	2300	4610	2310	0.09	2.00	4	8	4
0014	3T	24_1	136	20	1	2000	630	-1370	0.05	0.32	3	1	-2
0014	3T	24_1	142	21	0	2100	0	-2100	0.00	0.00	3	0	-3
0014	3T	24_1	143	14	1	1400	2660	1260	0.07	1.90	2	4	2
0014	3T	24_1	145	9	0	900	0	-900	0.00	0.00	1	0	-1
0014	3T	24_1	146	10	0	1000	0	-1000	0.00	0.00	1	0	-1
0014	3T	24_1	152	5	0	500	0	-500	0.00	0.00	0	0	0
0014	3T	24_1	153	5	1	500	4380	3880	0.20	8.76	0	7	7
0014	3T	24_1	154	5	0	500	0	-500	0.00	0.00	0	0	0
0014	3T	24_1	156	5	0	500	0	-500	0.00	0.00	0	0	0
0014	3T	24_1	162	4	0	400	0	-400	0.00	0.00	0	0	0
0014	3T	24_1	163	4	0	400	0	-400	0.00	0.00	0	0	0
0014	3T	24_1	213	5	0	500	0	-500	0.00	0.00	0	0	0
0014	3T	24_1	214	3	0	300	0	-300	0.00	0.00	0	0	0
0014	3T	24_1	215	3	1	300	830	530	0.33	2.77	0	1	1
0014	3T	24_1	216	3	0	300	0	-300	0.00	0.00	0	0	0
0014	3T	24_1	231	1	0	100	0	-100	0.00	0.00	0	0	0
0014	3T	24_1	234	2	0	200	0	-200	0.00	0.00	0	0	0
0014	3T	24_1	235	1	0	100	0	-100	0.00	0.00	0	0	0
0014	3T	24_1	236	1	0	100	0	-100	0.00	0.00	0	0	0
0014	3T	24_1	243	1	0	100	0	-100	0.00	0.00	0	0	0
0014	3T	24_1	251	1	0	100	0	-100	0.00	0.00	0	0	0
0014	3T	24_1	253	1	0	100	0	-100	0.00	0.00	0	0	0
0014	3T	24_1	254	1	0	100	0	-100	0.00	0.00	0	0	0
0014	3T	24_1	256	1	0	100	0	-100	0.00	0.00	0	0	0
0014	3T	24_1	265	1	0	100	0	-100	0.00	0.00	0	0	0
0014	3T	24_2	123	46	10	4600	7930	3330	0.22	1.72	8	14	6
0014	3T	24_2	124	54	3	5400	2030	-3370	0.06	0.38	9	3	-6
0014	3T	24_2	125	34	2	3400	1970	-1430	0.06	0.58	6	3	-3
0014	3T	24_2	126	30	3	3000	3280	280	0.10	1.09	5	5	0
0014	3T	24_2	132	43	4	4300	3070	-1230	0.09	0.71	7	5	-2
0014	3T	24_2	134	44	4	4400	3280	-1120	0.09	0.75	7	5	-2
0014	3T	24_2	135	20	2	2000	11190	9190	0.10	5.60	3	19	16
0014	3T	24_2	136	26	1	2600	670	-1930	0.04	0.26	4	1	-3
0014	3T	24_2	142	19	3	1900	2950	1050	0.16	1.55	3	5	2
0014	3T	24_2	143	19	2	1900	3650	1750	0.11	1.92	3	6	3
0014	3T	24_2	145	11	0	1100	0	-1100	0.00	0.00	1	0	-1
0014	3T	24_2	146	6	0	600	0	-600	0.00	0.00	1	0	-1
0014	3T	24_2	152	8	0	800	0	-800	0.00	0.00	1	0	-1
0014	3T	24_2	153	6	1	600	770	170	0.17	1.28	1	1	0
0014	3T	24_2	154	2	0	200	0	-200	0.00	0.00	0	0	0
0014	3T	24_2	156	1	0	100	0	-100	0.00	0.00	0	0	0
0014	3T	24_2	162	8	0	800	0	-800	0.00	0.00	1	0	-1
0014	3T	24_2	163	9	0	900	0	-900	0.00	0.00	1	0	-1
0014	3T	24_2	164	2	0	200	0	-200	0.00	0.00	0	0	0
0014	3T	24_2	213	1	1	100	1470	1370	1.00	14.70	0	2	2
0014	3T	24_2	214	4	0	400	0	-400	0.00	0.00	0	0	0
0014	3T	24_2	215	4	0	400	0	-400	0.00	0.00	0	0	0
0014	3T	24_2	216	3	0	300	0	-300	0.00	0.00	0	0	0
0014	3T	24_2	231	1	0	100	0	-100	0.00	0.00	0	0	0
0014	3T	24_2	234	2	1	200	1640	1440	0.50	8.20	0	2	2
0014	3T	24_2	236	3	1	300	8950	8650	0.33	29.83	0	15	15
0014	3T	24_2	241	1	0	100	0	-100	0.00	0.00	0	0	0
0014	3T	24_2	243	4	1	400	810	410	0.25	2.03	0	1	1
0014	3T	24_2	246	1	0	100	0	-100	0.00	0.00	0	0	0
0014	3T	24_2	254	1	0	100	0	-100	0.00	0.00	0	0	0
0014	3T	24_2	263	2	0	200	0	-200	0.00	0.00	0	0	0
0014	3T	24_2	264	1	0	100	0	-100	0.00	0.00	0	0	0
0014	3T	24_2	265	1	0	100	0	-100	0.00	0.00	0	0	0
0014	3T	24_3	123	79	13	7900	13500	5600	0.16	1.71	13	23	10
0014	3T	24_3	124	51	7	5100	6450	1350	0.14	1.26	9	11	2
0014	3T	24_3	125	30	2	3000	1400	-1600	0.07	0.47	5	2	-3
0014	3T	24_3	126	19	0	1900	0	-1900	0.00	0.00	3	0	-3
0014	3T	24_3	132	52	8	5200	11740	6540	0.15	2.26	9	20	11
0014	3T	24_3	134	36	3	3600	3220	-380	0.08	0.89	6	5	-1
0014	3T	24_3	135	28	2	2800	1200	-1600	0.07	0.43	4	2	-2
0014	3T	24_3	136	19	1	1900	1050	-850	0.05	0.55	3	1	-2
0014	3T	24_3	142	34	1	3400	1030	-2370	0.03	0.30	6	1	-5
0014	3T	24_3	143	19	0	1900	0	-1900	0.00	0.00	3	0	-3
0014	3T	24_3	145	15	0	1500	0	-1500	0.00	0.00	2	0	-2
0014	3T	24_3	146	4	0	400	0	-400	0.00	0.00	0	0	0
0014	3T	24_3	152	4	0	400	0	-400	0.00	0.00	0	0	0
0014	3T	24_3	153	8	0	800	0	-800	0.00	0.00	1	0	-1
0014	3T	24_3	154	5	0	500	0	-500	0.00	0.00	0	0	0
0014	3T	24_3	156	1	0	100	0	-100	0.00	0.00	0	0	0
0014	3T	24_3	162	2	0	200	0	-200	0.00	0.00	0	0	0
0014	3T	24_3	164	2	0	200	0	-200	0.00	0.00	0	0	0
0014	3T	24_3	165	2	0	200	0	-200	0.00	0.00	0	0	0
0014	3T	24_3	213	2	0	200	0	-200	0.00	0.00	0	0	0
0014	3T	24_3	214	4	0	400	0	-400	0.00	0.00	0	0	0
0014	3T	24_3	234	3	0	300	0	-300	0.00	0.00	0	0	0
0014	3T	24_3	236	2	0	200	0	-200	0.00	0.00	0	0	0
0014	3T	24_3	243	1	1	100	760	660	1.00	7.60	0	1	1
0014	3T	24_3	246	1	0	100	0	-100	0.00	0.00	0	0	0
0014	3T	24_3	256	2	0	200	0	-200	0.00	0.00	0	0	0
0014	3T	24_3	264	1	0	100	0	-100	0.00	0.00	0	0	0
0014	3T	24_4	123	44	7	4400	3760	-640	0.16	0.85	7	6	-1
0014	3T	24_4	124	43	4	4300	4400	100	0.09	1.02	7	7	0
0014	3T	24_4	125	19	1	1900	650	-1250	0.05	0.34	3	1	-2
0014	3T	24_4	126	18	1	1800	1940	140	0.06	1.08	3	3	0
0014	3T	24_4	132	25	2	2500	1840	-660	0.08	0.74	4	3	-1
0014	3T	24_4	134	34	5	3400	6960	3560	0.15	2.05	6	12	6
0014	3T	24_4	135	23	5	2300	7800	5500	0.22	3.39	4	13	9
0014	3T	24_4	136	4	0	400	0	-400	0.00	0.00	0	0	0
0014	3T	24_4	142	22	4	2200	2320	120	0.18	1.05	3	4	1
0014	3T	24_4	143	12	0	1200	0	-1200	0.00	0.00	2	0	-2
0014	3T	24_4	145	14	0	1400	0	-1400	0.00	0.00	2	0	-2
0014	3T	24_4	146	7	0	700	0	-700	0.00	0.00	1	0	-1
0014	3T	24_4	152	7	0	700	0	-700	0.00	0.00	1	0	-1
0014	3T	24_4	153	11	1	1100	1850	750	0.09	1.68	1	3	2
0014	3T	24_4	154	6	0	600	0	-600	0.00	0.00	1	0	-1
0014	3T	24_4	156	2	0	200	0	-200	0.00	0.00	0	0	0
0014	3T	24_4	163	2	0	200	0	-200	0.00	0.00	0	0	0
0014	3T	24_4	164	2	0	200	0	-200	0.00	0.00	0	0	0
0014	3T	24_4	213	2	0	200	0	-200	0.00	0.00	0	0	0
0014	3T	24_4	214	3	0	300	0	-300	0.00	0.00	0	0	0
0014	3T	24_4	231	1	0	100	0	-100	0.00	0.00	0	0	0
0014	3T	24_4	234	1	0	100	0	-100	0.00	0.00	0	0	0
0014	3T	24_4	236	1	0	100	0	-100	0.00	0.00	0	0	0
0014	3T	24_4	243	1	0	100	0	-100	0.00	0.00	0	0	0
0014	3T	24_4	245	1	0	100	0	-100	0.00	0.00	0	0	0
0014	3T	24_4	246	2	0	200	0	-200	0.00	0.00	0	0	0
0014	3T	24_5	123	25	3	2500	2080	-420	0.12	0.83	4	3	-1
0014	3T	24_5	124	26	2	2600	820	-1780	0.08	0.32	4	1	-3
0014	3T	24_5	125	15	1	1500	590	-910	0.07	0.39	2	1	-1
0014	3T	24_5	126	3	0	300	0	-300	0.00	0.00	0	0	0
0014	3T	24_5	132	16	1	1600	420	-1180	0.06	0.26	2	0	-2
0014	3T	24_5	134	17	0	1700	0	-1700	0.00	0.00	3	0	-3
0014	3T	24_5	135	11	0	1100	0	-1100	0.00	0.00	1	0	-1
0014	3T	24_5	136	7	0	700	0	-700	0.00	0.00	1	0	-1
0014	3T	24_5	142	8	1	800	1380	580	0.13	1.73	1	2	1
0014	3T	24_5	143	7	0	700	0	-700	0.00	0.00	1	0	-1
0014	3T	24_5	145	2	0	200	0	-200	0.00	0.00	0	0	0
0014	3T	24_5	146	1	0	100	0	-100	0.00	0.00	0	0	0
0014	3T	24_5	152	1	1	100	1610	1510	1.00	16.10	0	2	2
0014	3T	24_5	153	6	1	600	1720	1120	0.17	2.87	1	3	2
0014	3T	24_5	154	1	0	100	0	-100	0.00	0.00	0	0	0
0014	3T	24_5	156	2	0	200	0	-200	0.00	0.00	0	0	0
0014	3T	24_5	162	1	0	100	0	-100	0.00	0.00	0	0	0
0014	3T	24_5	163	1	0	100	0	-100	0.00	0.00	0	0	0
0014	3T	24_5	235	1	0	100	0	-100	0.00	0.00	0	0	0
0014	3T	24_5	236	1	0	100	0	-100	0.00	0.00	0	0	0
0014	3T	24_5	253	1	0	100	0	-100	0.00	0.00	0	0	0
0014	3T	24_5	254	1	0	100	0	-100	0.00	0.00	0	0	0
0014	3T	24_5	265	1	0	100	0	-100	0.00	0.00	0	0	0
0014	3T	24_6	123	7	0	700	0	-700	0.00	0.00	1	0	-1
0014	3T	24_6	124	10	2	1000	2220	1220	0.20	2.22	1	3	2
0014	3T	24_6	125	6	2	600	1830	1230	0.33	3.05	1	3	2
0014	3T	24_6	132	7	0	700	0	-700	0.00	0.00	1	0	-1
0014	3T	24_6	134	4	1	400	750	350	0.25	1.88	0	1	1
0014	3T	24_6	136	1	0	100	0	-100	0.00	0.00	0	0	0
0014	3T	24_6	142	2	0	200	0	-200	0.00	0.00	0	0	0
0014	3T	24_6	143	1	0	100	0	-100	0.00	0.00	0	0	0
0014	3T	24_6	145	2	0	200	0	-200	0.00	0.00	0	0	0
0014	3T	24_6	153	1	0	100	0	-100	0.00	0.00	0	0	0
0014	3T	24_6	154	1	0	100	0	-100	0.00	0.00	0	0	0
0014	3T	24_6	163	1	0	100	0	-100	0.00	0.00	0	0	0
0014	3T	24_7	123	85	10	8500	5200	-3300	0.12	0.61	15	9	-6
0014	3T	24_7	124	53	4	5300	2620	-2680	0.08	0.49	9	4	-5
0014	3T	24_7	125	42	4	4200	3740	-460	0.10	0.89	7	6	-1
0014	3T	24_7	126	22	2	2200	2370	170	0.09	1.08	3	4	1
0014	3T	24_7	132	26	3	2600	1580	-1020	0.12	0.61	4	2	-2
0014	3T	24_7	134	42	1	4200	930	-3270	0.02	0.22	7	1	-6
0014	3T	24_7	135	27	1	2700	740	-1960	0.04	0.27	4	1	-3
0014	3T	24_7	136	19	2	1900	4590	2690	0.11	2.42	3	8	5
0014	3T	24_7	142	26	3	2600	3220	620	0.12	1.24	4	5	1
0014	3T	24_7	143	22	2	2200	3950	1750	0.09	1.80	3	6	3
0014	3T	24_7	145	14	0	1400	0	-1400	0.00	0.00	2	0	-2
0014	3T	24_7	146	6	0	600	0	-600	0.00	0.00	1	0	-1
0014	3T	24_7	152	8	1	800	530	-270	0.13	0.66	1	0	-1
0014	3T	24_7	153	13	1	1300	1640	340	0.08	1.26	2	2	0
0014	3T	24_7	154	6	0	600	0	-600	0.00	0.00	1	0	-1
0014	3T	24_7	156	1	0	100	0	-100	0.00	0.00	0	0	0
0014	3T	24_7	162	3	0	300	0	-300	0.00	0.00	0	0	0
0014	3T	24_7	163	4	0	400	0	-400	0.00	0.00	0	0	0
0014	3T	24_7	164	1	0	100	0	-100	0.00	0.00	0	0	0
0014	3T	24_7	165	4	0	400	0	-400	0.00	0.00	0	0	0
0014	3T	24_7	213	6	0	600	0	-600	0.00	0.00	1	0	-1
0014	3T	24_7	215	2	0	200	0	-200	0.00	0.00	0	0	0
0014	3T	24_7	216	1	0	100	0	-100	0.00	0.00	0	0	0
0014	3T	24_7	231	1	0	100	0	-100	0.00	0.00	0	0	0
0014	3T	24_7	235	1	0	100	0	-100	0.00	0.00	0	0	0
0014	3T	24_7	236	1	0	100	0	-100	0.00	0.00	0	0	0
0014	3T	24_7	243	2	0	200	0	-200	0.00	0.00	0	0	0
0014	3T	24_7	245	1	0	100	0	-100	0.00	0.00	0	0	0
0014	3T	24_7	263	1	0	100	0	-100	0.00	0.00	0	0	0
0014	3T	24_7	265	3	0	300	0	-300	0.00	0.00	0	0	0
0005	2F	15	13	570	164	57000	59730	2730	0.29	1.05	100	105	5
0005	2F	15	14	493	101	49300	43360	-5940	0.20	0.88	87	76	-11
0005	2F	15	15	178	21	17800	19350	1550	0.12	1.09	31	34	3
0005	2F	15	16	86	12	8600	7550	-1050	0.14	0.88	15	13	-2
0005	2F	15	23	60	8	6000	8170	2170	0.13	1.36	10	14	4
0005	2F	15	24	38	4	3800	2530	-1270	0.11	0.67	6	4	-2
0005	2F	15	25	21	1	2100	180	-1920	0.05	0.09	3	0	-3
0005	2F	15	26	22	1	2200	600	-1600	0.05	0.27	3	1	-2
0005	2F	16	12	1272	413	127200	114720	-12480	0.32	0.90	225	203	-22
0005	2F	16	13	634	151	63400	52250	-11150	0.24	0.82	112	92	-20
0005	2F	16	14	451	107	45100	33200	-11900	0.24	0.74	79	58	-21
0005	2F	16	15	159	27	15900	18680	2780	0.17	1.17	28	33	5
0005	2F	16	16	89	8	8900	5010	-3890	0.09	0.56	15	8	-7
0005	2F	16	23	55	7	5500	3840	-1660	0.13	0.70	9	6	-3
0005	2F	16	24	29	4	2900	2770	-130	0.14	0.96	5	4	-1
0005	2F	16	25	21	3	2100	2320	220	0.14	1.10	3	4	1
0005	2F	16	26	13	1	1300	1250	-50	0.08	0.96	2	2	0
0005	2F	17	12	1224	348	122400	91730	-30670	0.28	0.75	216	162	-54
0005	2F	17	13	652	204	65200	62950	-2250	0.31	0.97	115	111	-4
0005	2F	17	14	416	77	41600	31870	-9730	0.19	0.77	73	56	-17
0005	2F	17	15	127	20	12700	8130	-4570	0.16	0.64	22	14	-8
0005	2F	17	16	66	4	6600	3880	-2720	0.06	0.59	11	6	-5
0005	2F	17	23	63	12	6300	6560	260	0.19	1.04	11	11	0
0005	2F	17	24	35	5	3500	1680	-1820	0.14	0.48	6	2	-4
0005	2F	17	25	16	1	1600	1300	-300	0.06	0.81	2	2	0
0005	2F	17	26	19	1	1900	560	-1340	0.05	0.29	3	0	-3
0005	2F	18	12	1289	474	128900	114060	-14840	0.37	0.88	228	201	-27
0005	2F	18	13	730	177	73000	57400	-15600	0.24	0.79	129	101	-28
0005	2F	18	14	457	96	45700	34250	-11450	0.21	0.75	80	60	-20
0005	2F	18	15	184	35	18400	16340	-2060	0.19	0.89	32	28	-4
0005	2F	18	16	80	9	8000	6060	-1940	0.11	0.76	14	10	-4
0019	1T	1	1	22237	10738	2223700	2076280	-147420	0.48	0.93	3935	3674	-261
0019	1T	1	2	5058	1755	505800	492720	-13080	0.35	0.97	895	872	-23
0019	1T	2	1	3742	2359	374200	343640	-30560	0.63	0.92	662	608	-54
0019	1T	2	2	188	47	18800	20080	1280	0.25	1.07	33	35	2
0019	1T	3	1	14450	8288	1445000	1368930	-76070	0.57	0.95	2557	2422	-135
0019	1T	3	2	1589	447	158900	147440	-11460	0.28	0.93	281	260	-21
0019	1T	4	1	4499	2981	449900	410290	-39610	0.66	0.91	796	726	-70
0019	1T	4	2	158	36	15800	27490	11690	0.23	1.74	27	48	21
0019	1T	5	1	2274	1386	227400	205860	-21540	0.61	0.91	402	364	-38
0019	1T	5	2	116	36	11600	9250	-2350	0.31	0.80	20	16	-4
0019	1T	6	1	3000	2165	300000	272080	-27920	0.72	0.91	530	481	-49
0019	1T	6	2	82	21	8200	8320	120	0.26	1.01	14	14	0
0019	1T	7	1	1106	770	110600	96940	-13660	0.70	0.88	195	171	-24
0019	1T	7	2	22	3	2200	1300	-900	0.14	0.59	3	2	-1
0019	1T	else	1	11049	7557	1104900	1009450	-95450	0.68	0.91	1955	1786	-169
0019	1T	else	2	311	74	31100	20780	-10320	0.24	0.67	55	36	-19
0019	2F	1	12	8667	2311	866700	779870	-86830	0.27	0.90	1533	1380	-153
0019	2F	1	13	5543	1297	554300	471060	-83240	0.23	0.85	981	833	-148
0019	2F	1	14	3328	691	332800	266130	-66670	0.21	0.80	589	471	-118
0019	2F	1	15	1672	227	167200	131630	-35570	0.14	0.79	295	232	-63
0019	2F	1	16	986	129	98600	95720	-2880	0.13	0.97	174	169	-5
0019	2F	1	23	1024	155	102400	94660	-7740	0.15	0.92	181	167	-14
0019	2F	1	24	566	83	56600	43900	-12700	0.15	0.78	100	77	-23
0019	2F	1	25	363	42	36300	27680	-8620	0.12	0.76	64	48	-16
0019	2F	1	26	256	25	25600	12290	-13310	0.10	0.48	45	21	-24
0019	2F	2	12	1238	373	123800	108860	-14940	0.30	0.88	219	192	-27
0019	2F	2	13	1039	262	103900	82680	-21220	0.25	0.80	183	146	-37
0019	2F	2	14	576	103	57600	43020	-14580	0.18	0.75	101	76	-25
0019	2F	2	15	283	49	28300	25240	-3060	0.17	0.89	50	44	-6
0019	2F	2	16	128	11	12800	12600	-200	0.09	0.98	22	22	0
0019	2F	2	23	32	4	3200	3020	-180	0.13	0.94	5	5	0
0019	2F	2	24	23	1	2300	1180	-1120	0.04	0.51	4	2	-2
0019	2F	2	25	11	0	1100	0	-1100	0.00	0.00	1	0	-1
0019	2F	2	26	4	0	400	0	-400	0.00	0.00	0	0	0
0019	2F	3	12	5292	1520	529200	463610	-65590	0.29	0.88	936	820	-116
0019	2F	3	13	3514	856	351400	294880	-56520	0.24	0.84	621	521	-100
0019	2F	3	14	2356	534	235600	180230	-55370	0.23	0.76	416	318	-98
0019	2F	3	15	976	137	97600	71590	-26010	0.14	0.73	172	126	-46
0019	2F	3	16	512	78	51200	45680	-5520	0.15	0.89	90	80	-10
0019	2F	3	23	320	28	32000	15880	-16120	0.09	0.50	56	28	-28
0019	2F	3	24	214	26	21400	13120	-8280	0.12	0.61	37	23	-14
0019	2F	3	25	143	16	14300	11080	-3220	0.11	0.77	25	19	-6
0019	2F	3	26	72	6	7200	11230	4030	0.08	1.56	12	19	7
0019	2F	4	12	1817	608	181700	162580	-19120	0.33	0.89	321	287	-34
0019	2F	4	13	1124	284	112400	91080	-21320	0.25	0.81	198	161	-37
0019	2F	4	14	693	137	69300	55380	-13920	0.20	0.80	122	98	-24
0019	2F	4	15	270	29	27000	15360	-11640	0.11	0.57	47	27	-20
0019	2F	4	16	85	3	8500	3290	-5210	0.04	0.39	15	5	-10
0019	2F	4	23	33	2	3300	1260	-2040	0.06	0.38	5	2	-3
0019	2F	4	24	21	2	2100	1820	-280	0.10	0.87	3	3	0
0019	2F	4	25	8	1	800	1410	610	0.13	1.76	1	2	1
0019	2F	4	26	4	0	400	0	-400	0.00	0.00	0	0	0
0019	2F	5	12	933	302	93300	86260	-7040	0.32	0.92	165	152	-13
0019	2F	5	13	601	153	60100	49370	-10730	0.25	0.82	106	87	-19
0019	2F	5	14	361	80	36100	32280	-3820	0.22	0.89	63	57	-6
0019	2F	5	15	120	18	12000	10250	-1750	0.15	0.85	21	18	-3
0019	2F	5	16	34	8	3400	4260	860	0.24	1.25	6	7	1
0019	2F	5	23	23	5	2300	2860	560	0.22	1.24	4	5	1
0019	2F	5	24	8	3	800	2510	1710	0.38	3.14	1	4	3
0019	2F	5	25	5	0	500	0	-500	0.00	0.00	0	0	0
0019	2F	5	26	4	0	400	0	-400	0.00	0.00	0	0	0
0019	2F	6	12	1454	581	145400	118370	-27030	0.40	0.81	257	209	-48
0019	2F	6	13	783	204	78300	70470	-7830	0.26	0.90	138	124	-14
0019	2F	6	14	328	50	32800	25540	-7260	0.15	0.78	58	45	-13
0019	2F	6	15	111	4	11100	4620	-6480	0.04	0.42	19	8	-11
0019	2F	6	16	32	1	3200	740	-2460	0.03	0.23	5	1	-4
0019	2F	6	23	18	0	1800	0	-1800	0.00	0.00	3	0	-3
0019	2F	6	24	8	0	800	0	-800	0.00	0.00	1	0	-1
0019	2F	6	25	3	0	300	0	-300	0.00	0.00	0	0	0
0019	2F	6	26	1	0	100	0	-100	0.00	0.00	0	0	0
0019	2F	7	12	494	161	49400	37130	-12270	0.33	0.75	87	65	-22
0019	2F	7	13	251	53	25100	19520	-5580	0.21	0.78	44	34	-10
0019	2F	7	14	171	31	17100	15590	-1510	0.18	0.91	30	27	-3
0019	2F	7	15	49	6	4900	4370	-530	0.12	0.89	8	7	-1
0019	2F	7	16	11	0	1100	0	-1100	0.00	0.00	1	0	-1
0019	2F	7	23	4	0	400	0	-400	0.00	0.00	0	0	0
0019	2F	7	24	3	0	300	0	-300	0.00	0.00	0	0	0
0019	2F	7	25	2	0	200	0	-200	0.00	0.00	0	0	0
0019	2F	else	12	4791	1664	479100	399160	-79940	0.35	0.83	847	706	-141
0019	2F	else	13	2759	772	275900	236990	-38910	0.28	0.86	488	419	-69
0019	2F	else	14	1636	379	163600	141230	-22370	0.23	0.86	289	249	-40
0019	2F	else	15	458	68	45800	46390	590	0.15	1.01	81	82	1
0019	2F	else	16	187	24	18700	15520	-3180	0.13	0.83	33	27	-6
0019	2F	else	23	54	7	5400	6040	640	0.13	1.12	9	10	1
0019	2F	else	24	38	5	3800	4860	1060	0.13	1.28	6	8	2
0019	2F	else	25	19	1	1900	1150	-750	0.05	0.61	3	2	-1
0019	2F	else	26	11	1	1100	720	-380	0.09	0.65	1	1	0
0019	2T	1	12	6955	1217	695500	589120	-106380	0.17	0.85	1230	1042	-188
0019	2T	1	13	5543	947	554300	475330	-78970	0.17	0.86	981	841	-140
0019	2T	1	14	3328	502	332800	264090	-68710	0.15	0.79	589	467	-122
0019	2T	1	15	1672	164	167200	137860	-29340	0.10	0.82	295	244	-51
0019	2T	1	16	986	90	98600	94580	-4020	0.09	0.96	174	167	-7
0019	2T	1	21	1712	249	171200	171390	190	0.15	1.00	303	303	0
0019	2T	1	23	1024	91	102400	89870	-12530	0.09	0.88	181	159	-22
0019	2T	1	24	566	57	56600	43410	-13190	0.10	0.77	100	76	-24
0019	2T	1	25	363	27	36300	32890	-3410	0.07	0.91	64	58	-6
0019	2T	1	26	256	22	25600	15870	-9730	0.09	0.62	45	28	-17
0019	2T	2	12	1165	264	116500	97720	-18780	0.23	0.84	206	172	-34
0019	2T	2	13	1039	206	103900	85030	-18870	0.20	0.82	183	150	-33
0019	2T	2	14	576	87	57600	49180	-8420	0.15	0.85	101	87	-14
0019	2T	2	15	283	41	28300	25930	-2370	0.14	0.92	50	45	-5
0019	2T	2	16	128	10	12800	13080	280	0.08	1.02	22	23	1
0019	2T	2	21	73	8	7300	5550	-1750	0.11	0.76	12	9	-3
0019	2T	2	23	32	2	3200	1310	-1890	0.06	0.41	5	2	-3
0019	2T	2	24	23	0	2300	0	-2300	0.00	0.00	4	0	-4
0019	2T	2	25	11	0	1100	0	-1100	0.00	0.00	1	0	-1
0019	2T	2	26	4	0	400	0	-400	0.00	0.00	0	0	0
0019	2T	3	12	4826	1064	482600	413520	-69080	0.22	0.86	854	731	-123
0019	2T	3	13	3514	660	351400	288060	-63340	0.19	0.82	621	509	-112
0019	2T	3	14	2356	391	235600	187020	-48580	0.17	0.79	416	331	-85
0019	2T	3	15	976	102	97600	69390	-28210	0.10	0.71	172	122	-50
0019	2T	3	16	512	63	51200	50720	-480	0.12	0.99	90	89	-1
0019	2T	3	21	466	55	46600	43240	-3360	0.12	0.93	82	76	-6
0019	2T	3	23	320	16	32000	15650	-16350	0.05	0.49	56	27	-29
0019	2T	3	24	214	12	21400	9340	-12060	0.06	0.44	37	16	-21
0019	2T	3	25	143	14	14300	16710	2410	0.10	1.17	25	29	4
0019	2T	3	26	72	4	7200	16910	9710	0.06	2.35	12	29	17
0019	2T	4	12	1754	478	175400	155070	-20330	0.27	0.88	310	274	-36
0019	2T	4	13	1124	218	112400	80680	-31720	0.19	0.72	198	142	-56
0019	2T	4	14	693	115	69300	55990	-13310	0.17	0.81	122	99	-23
0019	2T	4	15	270	26	27000	17710	-9290	0.10	0.66	47	31	-16
0019	2T	4	16	85	3	8500	5110	-3390	0.04	0.60	15	9	-6
0019	2T	4	21	63	8	6300	6490	190	0.13	1.03	11	11	0
0019	2T	4	23	33	1	3300	1150	-2150	0.03	0.35	5	2	-3
0019	2T	4	24	21	1	2100	860	-1240	0.05	0.41	3	1	-2
0019	2T	4	25	8	0	800	0	-800	0.00	0.00	1	0	-1
0019	2T	4	26	4	0	400	0	-400	0.00	0.00	0	0	0
0019	2T	5	12	887	220	88700	80870	-7830	0.25	0.91	156	143	-13
0019	2T	5	13	601	119	60100	47200	-12900	0.20	0.79	106	83	-23
0019	2T	5	14	361	64	36100	30340	-5760	0.18	0.84	63	53	-10
0019	2T	5	15	120	12	12000	9230	-2770	0.10	0.77	21	16	-5
0019	2T	5	16	34	5	3400	4270	870	0.15	1.26	6	7	1
0019	2T	5	21	46	5	4600	2220	-2380	0.11	0.48	8	3	-5
0019	2T	5	23	23	4	2300	3240	940	0.17	1.41	4	5	1
0019	2T	5	24	8	2	800	2770	1970	0.25	3.46	1	4	3
0019	2T	5	25	5	0	500	0	-500	0.00	0.00	0	0	0
0019	2T	5	26	4	0	400	0	-400	0.00	0.00	0	0	0
0019	2T	6	12	1417	468	141700	113460	-28240	0.33	0.80	250	200	-50
0019	2T	6	13	783	191	78300	71410	-6890	0.24	0.91	138	126	-12
0019	2T	6	14	328	45	32800	27430	-5370	0.14	0.84	58	48	-10
0019	2T	6	15	111	3	11100	2590	-8510	0.03	0.23	19	4	-15
0019	2T	6	16	32	1	3200	700	-2500	0.03	0.22	5	1	-4
0019	2T	6	21	37	5	3700	3750	50	0.14	1.01	6	6	0
0019	2T	6	23	18	0	1800	0	-1800	0.00	0.00	3	0	-3
0019	2T	6	24	8	0	800	0	-800	0.00	0.00	1	0	-1
0019	2T	6	25	3	0	300	0	-300	0.00	0.00	0	0	0
0019	2T	6	26	1	0	100	0	-100	0.00	0.00	0	0	0
0019	2T	7	12	483	137	48300	39150	-9150	0.28	0.81	85	69	-16
0019	2T	7	13	251	44	25100	19040	-6060	0.18	0.76	44	33	-11
0019	2T	7	14	171	28	17100	15980	-1120	0.16	0.93	30	28	-2
0019	2T	7	15	49	5	4900	4680	-220	0.10	0.96	8	8	0
0019	2T	7	16	11	0	1100	0	-1100	0.00	0.00	1	0	-1
0019	2T	7	21	11	0	1100	0	-1100	0.00	0.00	1	0	-1
0019	2T	7	23	4	0	400	0	-400	0.00	0.00	0	0	0
0019	2T	7	24	3	0	300	0	-300	0.00	0.00	0	0	0
0019	2T	7	25	2	0	200	0	-200	0.00	0.00	0	0	0
0019	2T	else	12	4671	1318	467100	383800	-83300	0.28	0.82	826	679	-147
0019	2T	else	13	2759	618	275900	230500	-45400	0.22	0.84	488	407	-81
0019	2T	else	14	1636	310	163600	141550	-22050	0.19	0.87	289	250	-39
0019	2T	else	15	458	55	45800	44220	-1580	0.12	0.97	81	78	-3
0019	2T	else	16	187	14	18700	9740	-8960	0.07	0.52	33	17	-16
0019	2T	else	21	120	10	12000	5960	-6040	0.08	0.50	21	10	-11
0019	2T	else	23	54	3	5400	4020	-1380	0.06	0.74	9	7	-2
0019	2T	else	24	38	4	3800	10030	6230	0.11	2.64	6	17	11
0019	2T	else	25	19	0	1900	0	-1900	0.00	0.00	3	0	-3
0019	2T	else	26	11	0	1100	0	-1100	0.00	0.00	1	0	-1
0019	3F	1	123	3676	675	367600	308770	-58830	0.18	0.84	650	546	-104
0019	3F	1	124	2899	458	289900	227120	-62780	0.16	0.78	513	401	-112
0019	3F	1	125	1827	263	182700	168130	-14570	0.14	0.92	323	297	-26
0019	3F	1	126	1697	192	169700	149890	-19810	0.11	0.88	300	265	-35
0019	3F	1	134	1977	276	197700	135880	-61820	0.14	0.69	349	240	-109
0019	3F	1	135	1357	157	135700	112250	-23450	0.12	0.83	240	198	-42
0019	3F	1	136	1139	128	113900	104790	-9110	0.11	0.92	201	185	-16
0019	3F	1	145	862	75	86200	58200	-28000	0.09	0.68	152	103	-49
0019	3F	1	146	640	45	64000	31220	-32780	0.07	0.49	113	55	-58
0019	3F	1	156	404	33	40400	42600	2200	0.08	1.05	71	75	4
0019	3F	1	234	347	49	34700	41270	6570	0.14	1.19	61	73	12
0019	3F	1	235	252	24	25200	24470	-730	0.10	0.97	44	43	-1
0019	3F	1	236	255	19	25500	16360	-9140	0.07	0.64	45	28	-17
0019	3F	1	245	171	11	17100	9380	-7720	0.06	0.55	30	16	-14
0019	3F	1	246	130	12	13000	14340	1340	0.09	1.10	23	25	2
0019	3F	1	256	97	8	9700	10310	610	0.08	1.06	17	18	1
0019	3F	2	123	565	114	56500	48060	-8440	0.20	0.85	100	85	-15
0019	3F	2	124	448	87	44800	42770	-2030	0.19	0.95	79	75	-4
0019	3F	2	125	275	33	27500	21250	-6250	0.12	0.77	48	37	-11
0019	3F	2	126	241	20	24100	17010	-7090	0.08	0.71	42	30	-12
0019	3F	2	134	397	59	39700	29180	-10520	0.15	0.74	70	51	-19
0019	3F	2	135	257	17	25700	12150	-13550	0.07	0.47	45	21	-24
0019	3F	2	136	196	13	19600	13100	-6500	0.07	0.67	34	23	-11
0019	3F	2	145	173	12	17300	15040	-2260	0.07	0.87	30	26	-4
0019	3F	2	146	110	8	11000	10310	-690	0.07	0.94	19	18	-1
0019	3F	2	156	65	2	6500	1230	-5270	0.03	0.19	11	2	-9
0019	3F	2	234	13	1	1300	300	-1000	0.08	0.23	2	0	-2
0019	3F	2	235	11	0	1100	0	-1100	0.00	0.00	1	0	-1
0019	3F	2	236	9	0	900	0	-900	0.00	0.00	1	0	-1
0019	3F	2	245	10	0	1000	0	-1000	0.00	0.00	1	0	-1
0019	3F	2	246	1	0	100	0	-100	0.00	0.00	0	0	0
0019	3F	2	256	2	0	200	0	-200	0.00	0.00	0	0	0
0019	3F	3	123	2350	458	235000	207810	-27190	0.19	0.88	415	367	-48
0019	3F	3	124	1908	368	190800	151120	-39680	0.19	0.79	337	267	-70
0019	3F	3	125	1164	131	116400	83020	-33380	0.11	0.71	206	146	-60
0019	3F	3	126	779	94	77900	85130	7230	0.12	1.09	137	150	13
0019	3F	3	134	1397	218	139700	115030	-24670	0.16	0.82	247	203	-44
0019	3F	3	135	858	101	85800	53470	-32330	0.12	0.62	151	94	-57
0019	3F	3	136	599	66	59900	57640	-2260	0.11	0.96	106	102	-4
0019	3F	3	145	567	45	56700	35590	-21110	0.08	0.63	100	62	-38
0019	3F	3	146	370	35	37000	27800	-9200	0.09	0.75	65	49	-16
0019	3F	3	156	189	19	18900	15340	-3560	0.10	0.81	33	27	-6
0019	3F	3	234	100	10	10000	5940	-4060	0.10	0.59	17	10	-7
0019	3F	3	235	108	16	10800	14890	4090	0.15	1.38	19	26	7
0019	3F	3	236	71	4	7100	2450	-4650	0.06	0.35	12	4	-8
0019	3F	3	245	58	7	5800	5620	-180	0.12	0.97	10	9	-1
0019	3F	3	246	35	3	3500	7410	3910	0.09	2.12	6	13	7
0019	3F	3	256	26	0	2600	0	-2600	0.00	0.00	4	0	-4
0019	3F	4	123	763	169	76300	65670	-10630	0.22	0.86	135	116	-19
0019	3F	4	124	651	113	65100	49630	-15470	0.17	0.76	115	87	-28
0019	3F	4	125	394	34	39400	27450	-11950	0.09	0.70	69	48	-21
0019	3F	4	126	275	22	27500	27830	330	0.08	1.01	48	49	1
0019	3F	4	134	459	67	45900	38690	-7210	0.15	0.84	81	68	-13
0019	3F	4	135	286	17	28600	13720	-14880	0.06	0.48	50	24	-26
0019	3F	4	136	169	16	16900	15310	-1590	0.09	0.91	29	27	-2
0019	3F	4	145	177	13	17700	11290	-6410	0.07	0.64	31	19	-12
0019	3F	4	146	132	13	13200	18750	5550	0.10	1.42	23	33	10
0019	3F	4	156	64	0	6400	0	-6400	0.00	0.00	11	0	-11
0019	3F	4	234	19	1	1900	2810	910	0.05	1.48	3	4	1
0019	3F	4	235	5	0	500	0	-500	0.00	0.00	0	0	0
0019	3F	4	236	7	0	700	0	-700	0.00	0.00	1	0	-1
0019	3F	4	245	3	0	300	0	-300	0.00	0.00	0	0	0
0019	3F	4	246	1	0	100	0	-100	0.00	0.00	0	0	0
0019	3F	4	256	4	0	400	0	-400	0.00	0.00	0	0	0
0019	3F	5	123	366	63	36600	25670	-10930	0.17	0.70	64	45	-19
0019	3F	5	124	354	72	35400	30270	-5130	0.20	0.86	62	53	-9
0019	3F	5	125	206	24	20600	12490	-8110	0.12	0.61	36	22	-14
0019	3F	5	126	127	9	12700	8100	-4600	0.07	0.64	22	14	-8
0019	3F	5	134	250	40	25000	23620	-1380	0.16	0.94	44	41	-3
0019	3F	5	135	134	21	13400	13300	-100	0.16	0.99	23	23	0
0019	3F	5	136	103	9	10300	13140	2840	0.09	1.28	18	23	5
0019	3F	5	145	83	6	8300	3780	-4520	0.07	0.46	14	6	-8
0019	3F	5	146	59	5	5900	3900	-2000	0.08	0.66	10	6	-4
0019	3F	5	156	17	1	1700	1290	-410	0.06	0.76	3	2	-1
0019	3F	5	234	11	2	1100	4860	3760	0.18	4.42	1	8	7
0019	3F	5	235	3	1	300	920	620	0.33	3.07	0	1	1
0019	3F	5	236	4	1	400	480	80	0.25	1.20	0	0	0
0019	3F	5	245	1	0	100	0	-100	0.00	0.00	0	0	0
0019	3F	5	246	1	0	100	0	-100	0.00	0.00	0	0	0
0019	3F	5	256	3	0	300	0	-300	0.00	0.00	0	0	0
0019	3F	6	123	628	132	62800	37190	-25610	0.21	0.59	111	65	-46
0019	3F	6	124	517	86	51700	35030	-16670	0.17	0.68	91	62	-29
0019	3F	6	125	242	27	24200	21350	-2850	0.11	0.88	42	37	-5
0019	3F	6	126	163	11	16300	11030	-5270	0.07	0.68	28	19	-9
0019	3F	6	134	317	41	31700	24360	-7340	0.13	0.77	56	43	-13
0019	3F	6	135	158	11	15800	8910	-6890	0.07	0.56	27	15	-12
0019	3F	6	136	87	1	8700	1890	-6810	0.01	0.22	15	3	-12
0019	3F	6	145	76	3	7600	2640	-4960	0.04	0.35	13	4	-9
0019	3F	6	146	41	0	4100	0	-4100	0.00	0.00	7	0	-7
0019	3F	6	156	24	1	2400	5000	2600	0.04	2.08	4	8	4
0019	3F	6	234	6	2	600	1210	610	0.33	2.02	1	2	1
0019	3F	6	235	2	0	200	0	-200	0.00	0.00	0	0	0
0019	3F	6	236	3	0	300	0	-300	0.00	0.00	0	0	0
0019	3F	6	245	2	1	200	1790	1590	0.50	8.95	0	3	3
0019	3F	6	246	2	0	200	0	-200	0.00	0.00	0	0	0
0019	3F	6	256	1	0	100	0	-100	0.00	0.00	0	0	0
0019	3F	7	123	211	58	21100	21510	410	0.27	1.02	37	38	1
0019	3F	7	124	179	25	17900	10640	-7260	0.14	0.59	31	18	-13
0019	3F	7	125	90	8	9000	4720	-4280	0.09	0.52	15	8	-7
0019	3F	7	126	66	0	6600	0	-6600	0.00	0.00	11	0	-11
0019	3F	7	134	127	29	12700	15610	2910	0.23	1.23	22	27	5
0019	3F	7	135	53	1	5300	1250	-4050	0.02	0.24	9	2	-7
0019	3F	7	136	42	2	4200	2830	-1370	0.05	0.67	7	5	-2
0019	3F	7	145	38	3	3800	2780	-1020	0.08	0.73	6	4	-2
0019	3F	7	146	23	0	2300	0	-2300	0.00	0.00	4	0	-4
0019	3F	7	156	11	0	1100	0	-1100	0.00	0.00	1	0	-1
0019	3F	7	234	1	0	100	0	-100	0.00	0.00	0	0	0
0019	3F	7	236	2	0	200	0	-200	0.00	0.00	0	0	0
0019	3F	7	245	3	0	300	0	-300	0.00	0.00	0	0	0
0019	3F	7	246	1	0	100	0	-100	0.00	0.00	0	0	0
0019	3F	else	123	2175	515	217500	173940	-43560	0.24	0.80	384	307	-77
0019	3F	else	124	1685	310	168500	124180	-44320	0.18	0.74	298	219	-79
0019	3F	else	125	846	106	84600	60660	-23940	0.13	0.72	149	107	-42
0019	3F	else	126	557	47	55700	34100	-21600	0.08	0.61	98	60	-38
0019	3F	else	134	1162	193	116200	89400	-26800	0.17	0.77	205	158	-47
0019	3F	else	135	539	58	53900	37190	-16710	0.11	0.69	95	65	-30
0019	3F	else	136	386	45	38600	30840	-7760	0.12	0.80	68	54	-14
0019	3F	else	145	365	35	36500	25740	-10760	0.10	0.71	64	45	-19
0019	3F	else	146	198	14	19800	10440	-9360	0.07	0.53	35	18	-17
0019	3F	else	156	71	3	7100	2520	-4580	0.04	0.35	12	4	-8
0019	3F	else	234	24	2	2400	5120	2720	0.08	2.13	4	9	5
0019	3F	else	235	7	1	700	1370	670	0.14	1.96	1	2	1
0019	3F	else	236	8	2	800	2360	1560	0.25	2.95	1	4	3
0019	3F	else	245	3	0	300	0	-300	0.00	0.00	0	0	0
0019	3F	else	246	3	0	300	0	-300	0.00	0.00	0	0	0
0019	3F	else	256	9	0	900	0	-900	0.00	0.00	1	0	-1
0019	3T	1	123	1851	141	185100	165280	-19820	0.08	0.89	327	292	-35
0019	3T	1	124	1634	93	163400	126820	-36580	0.06	0.78	289	224	-65
0019	3T	1	125	1120	60	112000	125300	13300	0.05	1.12	198	221	23
0019	3T	1	126	1106	34	110600	74980	-35620	0.03	0.68	195	132	-63
0019	3T	1	132	1289	97	128900	138080	9180	0.08	1.07	228	244	16
0019	3T	1	134	1179	53	117900	79790	-38110	0.04	0.68	208	141	-67
0019	3T	1	135	972	50	97200	90700	-6500	0.05	0.93	172	160	-12
0019	3T	1	136	915	53	91500	109370	17870	0.06	1.20	161	193	32
0019	3T	1	142	831	37	83100	57200	-25900	0.04	0.69	147	101	-46
0019	3T	1	143	798	36	79800	48290	-31510	0.05	0.61	141	85	-56
0019	3T	1	145	565	22	56500	37260	-19240	0.04	0.66	100	65	-35
0019	3T	1	146	442	15	44200	24870	-19330	0.03	0.56	78	44	-34
0019	3T	1	152	376	16	37600	39560	1960	0.04	1.05	66	70	4
0019	3T	1	153	385	5	38500	6770	-31730	0.01	0.18	68	11	-57
0019	3T	1	154	297	6	29700	17480	-12220	0.02	0.59	52	30	-22
0019	3T	1	156	286	9	28600	41790	13190	0.03	1.46	50	73	23
0019	3T	1	162	208	8	20800	21780	980	0.04	1.05	36	38	2
0019	3T	1	163	224	4	22400	11670	-10730	0.02	0.52	39	20	-19
0019	3T	1	164	198	1	19800	1780	-18020	0.01	0.09	35	3	-32
0019	3T	1	165	118	0	11800	0	-11800	0.00	0.00	20	0	-20
0019	3T	1	213	404	31	40400	66790	26390	0.08	1.65	71	118	47
0019	3T	1	214	366	17	36600	23790	-12810	0.05	0.65	64	42	-22
0019	3T	1	215	287	12	28700	35520	6820	0.04	1.24	50	62	12
0019	3T	1	216	347	13	34700	31980	-2720	0.04	0.92	61	56	-5
0019	3T	1	231	132	1	13200	1300	-11900	0.01	0.10	23	2	-21
0019	3T	1	234	225	7	22500	12390	-10110	0.03	0.55	39	21	-18
0019	3T	1	235	176	3	17600	6270	-11330	0.02	0.36	31	11	-20
0019	3T	1	236	189	1	18900	2110	-16790	0.01	0.11	33	3	-30
0019	3T	1	241	68	2	6800	6410	-390	0.03	0.94	12	11	-1
0019	3T	1	243	122	5	12200	8800	-3400	0.04	0.72	21	15	-6
0019	3T	1	245	103	1	10300	1580	-8720	0.01	0.15	18	2	-16
0019	3T	1	246	89	1	8900	1190	-7710	0.01	0.13	15	2	-13
0019	3T	1	251	44	4	4400	72420	68020	0.09	16.46	7	128	121
0019	3T	1	253	76	1	7600	460	-7140	0.01	0.06	13	0	-13
0019	3T	1	254	68	1	6800	2530	-4270	0.01	0.37	12	4	-8
0019	3T	1	256	66	1	6600	2420	-4180	0.02	0.37	11	4	-7
0019	3T	1	261	36	2	3600	5710	2110	0.06	1.59	6	10	4
0019	3T	1	263	66	1	6600	1310	-5290	0.02	0.20	11	2	-9
0019	3T	1	264	41	1	4100	1330	-2770	0.02	0.32	7	2	-5
0019	3T	1	265	31	0	3100	0	-3100	0.00	0.00	5	0	-5
0019	3T	2	123	310	37	31000	47050	16050	0.12	1.52	54	83	29
0019	3T	2	124	290	20	29000	27770	-1230	0.07	0.96	51	49	-2
0019	3T	2	125	197	13	19700	18920	-780	0.07	0.96	34	33	-1
0019	3T	2	126	194	10	19400	16360	-3040	0.05	0.84	34	28	-6
0019	3T	2	132	237	11	23700	9990	-13710	0.05	0.42	41	17	-24
0019	3T	2	134	256	19	25600	22450	-3150	0.07	0.88	45	39	-6
0019	3T	2	135	195	6	19500	13730	-5770	0.03	0.70	34	24	-10
0019	3T	2	136	169	5	16900	9920	-6980	0.03	0.59	29	17	-12
0019	3T	2	142	134	8	13400	14030	630	0.06	1.05	23	24	1
0019	3T	2	143	141	4	14100	6390	-7710	0.03	0.45	24	11	-13
0019	3T	2	145	106	2	10600	2340	-8260	0.02	0.22	18	4	-14
0019	3T	2	146	83	5	8300	19780	11480	0.06	2.38	14	35	21
0019	3T	2	152	65	3	6500	6600	100	0.05	1.02	11	11	0
0019	3T	2	153	62	1	6200	860	-5340	0.02	0.14	10	1	-9
0019	3T	2	154	67	2	6700	10750	4050	0.03	1.60	11	19	8
0019	3T	2	156	47	0	4700	0	-4700	0.00	0.00	8	0	-8
0019	3T	2	162	32	0	3200	0	-3200	0.00	0.00	5	0	-5
0019	3T	2	163	27	0	2700	0	-2700	0.00	0.00	4	0	-4
0019	3T	2	164	27	0	2700	0	-2700	0.00	0.00	4	0	-4
0019	3T	2	165	18	0	1800	0	-1800	0.00	0.00	3	0	-3
0019	3T	2	213	15	1	1500	1390	-110	0.07	0.93	2	2	0
0019	3T	2	214	22	2	2200	2280	80	0.09	1.04	3	4	1
0019	3T	2	215	12	0	1200	0	-1200	0.00	0.00	2	0	-2
0019	3T	2	216	14	0	1400	0	-1400	0.00	0.00	2	0	-2
0019	3T	2	231	3	0	300	0	-300	0.00	0.00	0	0	0
0019	3T	2	234	8	0	800	0	-800	0.00	0.00	1	0	-1
0019	3T	2	235	8	0	800	0	-800	0.00	0.00	1	0	-1
0019	3T	2	236	7	0	700	0	-700	0.00	0.00	1	0	-1
0019	3T	2	241	2	0	200	0	-200	0.00	0.00	0	0	0
0019	3T	2	243	5	0	500	0	-500	0.00	0.00	0	0	0
0019	3T	2	245	8	0	800	0	-800	0.00	0.00	1	0	-1
0019	3T	2	246	1	0	100	0	-100	0.00	0.00	0	0	0
0019	3T	2	251	1	0	100	0	-100	0.00	0.00	0	0	0
0019	3T	2	253	3	0	300	0	-300	0.00	0.00	0	0	0
0019	3T	2	254	2	0	200	0	-200	0.00	0.00	0	0	0
0019	3T	2	256	2	0	200	0	-200	0.00	0.00	0	0	0
0019	3T	2	261	1	0	100	0	-100	0.00	0.00	0	0	0
0019	3T	2	263	2	0	200	0	-200	0.00	0.00	0	0	0
0019	3T	3	123	1346	130	134600	130160	-4440	0.10	0.97	238	230	-8
0019	3T	3	124	1216	94	121600	90820	-30780	0.08	0.75	215	160	-55
0019	3T	3	125	832	42	83200	63910	-19290	0.05	0.77	147	113	-34
0019	3T	3	126	582	26	58200	62820	4620	0.04	1.08	103	111	8
0019	3T	3	132	844	64	84400	80900	-3500	0.08	0.96	149	143	-6
0019	3T	3	134	853	58	85300	71240	-14060	0.07	0.84	150	126	-24
0019	3T	3	135	626	38	62600	43990	-18610	0.06	0.70	110	77	-33
0019	3T	3	136	481	23	48100	39900	-8200	0.05	0.83	85	70	-15
0019	3T	3	142	558	40	55800	47170	-8630	0.07	0.85	98	83	-15
0019	3T	3	143	544	26	54400	44650	-9750	0.05	0.82	96	79	-17
0019	3T	3	145	403	11	40300	19630	-20670	0.03	0.49	71	34	-37
0019	3T	3	146	277	10	27700	21190	-6510	0.04	0.76	49	37	-12
0019	3T	3	152	237	6	23700	16060	-7640	0.03	0.68	41	28	-13
0019	3T	3	153	232	8	23200	13600	-9600	0.03	0.59	41	24	-17
0019	3T	3	154	164	3	16400	5350	-11050	0.02	0.33	29	9	-20
0019	3T	3	156	128	7	12800	18330	5530	0.05	1.43	22	32	10
0019	3T	3	162	116	5	11600	4970	-6630	0.04	0.43	20	8	-12
0019	3T	3	163	118	2	11800	3970	-7830	0.02	0.34	20	7	-13
0019	3T	3	164	93	3	9300	4970	-4330	0.03	0.53	16	8	-8
0019	3T	3	165	61	1	6100	4020	-2080	0.02	0.66	10	7	-3
0019	3T	3	213	117	7	11700	17030	5330	0.06	1.46	20	30	10
0019	3T	3	214	113	3	11300	3560	-7740	0.03	0.32	20	6	-14
0019	3T	3	215	77	1	7700	1390	-6310	0.01	0.18	13	2	-11
0019	3T	3	216	70	2	7000	1830	-5170	0.03	0.26	12	3	-9
0019	3T	3	231	43	1	4300	2230	-2070	0.02	0.52	7	3	-4
0019	3T	3	234	55	0	5500	0	-5500	0.00	0.00	9	0	-9
0019	3T	3	235	67	0	6700	0	-6700	0.00	0.00	11	0	-11
0019	3T	3	236	51	0	5100	0	-5100	0.00	0.00	9	0	-9
0019	3T	3	241	21	0	2100	0	-2100	0.00	0.00	3	0	-3
0019	3T	3	243	45	0	4500	0	-4500	0.00	0.00	7	0	-7
0019	3T	3	245	34	0	3400	0	-3400	0.00	0.00	6	0	-6
0019	3T	3	246	29	1	2900	3920	1020	0.03	1.35	5	6	1
0019	3T	3	251	18	0	1800	0	-1800	0.00	0.00	3	0	-3
0019	3T	3	253	41	3	4100	5230	1130	0.07	1.28	7	9	2
0019	3T	3	254	24	0	2400	0	-2400	0.00	0.00	4	0	-4
0019	3T	3	256	18	0	1800	0	-1800	0.00	0.00	3	0	-3
0019	3T	3	261	11	0	1100	0	-1100	0.00	0.00	1	0	-1
0019	3T	3	263	20	1	2000	680	-1320	0.05	0.34	3	1	-2
0019	3T	3	264	6	0	600	0	-600	0.00	0.00	1	0	-1
0019	3T	3	265	8	0	800	0	-800	0.00	0.00	1	0	-1
0019	3T	4	123	478	55	47800	49040	1240	0.12	1.03	84	86	2
0019	3T	4	124	470	38	47000	33410	-13590	0.08	0.71	83	59	-24
0019	3T	4	125	330	12	33000	18280	-14720	0.04	0.55	58	32	-26
0019	3T	4	126	244	11	24400	24510	110	0.05	1.00	43	43	0
0019	3T	4	132	270	14	27000	17040	-9960	0.05	0.63	47	30	-17
0019	3T	4	134	304	21	30400	22410	-7990	0.07	0.74	53	39	-14
0019	3T	4	135	224	7	22400	10350	-12050	0.03	0.46	39	18	-21
0019	3T	4	136	153	4	15300	8230	-7070	0.03	0.54	27	14	-13
0019	3T	4	142	160	16	16000	19840	3840	0.10	1.24	28	35	7
0019	3T	4	143	155	6	15500	12850	-2650	0.04	0.83	27	22	-5
0019	3T	4	145	120	5	12000	14890	2890	0.04	1.24	21	26	5
0019	3T	4	146	112	8	11200	20540	9340	0.07	1.83	19	36	17
0019	3T	4	152	53	3	5300	4140	-1160	0.06	0.78	9	7	-2
0019	3T	4	153	62	1	6200	6260	60	0.02	1.01	10	11	1
0019	3T	4	154	57	1	5700	2410	-3290	0.02	0.42	10	4	-6
0019	3T	4	156	48	0	4800	0	-4800	0.00	0.00	8	0	-8
0019	3T	4	162	24	0	2400	0	-2400	0.00	0.00	4	0	-4
0019	3T	4	163	16	1	1600	7960	6360	0.06	4.98	2	14	12
0019	3T	4	164	20	0	2000	0	-2000	0.00	0.00	3	0	-3
0019	3T	4	165	16	0	1600	0	-1600	0.00	0.00	2	0	-2
0019	3T	4	213	14	0	1400	0	-1400	0.00	0.00	2	0	-2
0019	3T	4	214	19	1	1900	2880	980	0.05	1.52	3	5	2
0019	3T	4	215	8	0	800	0	-800	0.00	0.00	1	0	-1
0019	3T	4	216	7	0	700	0	-700	0.00	0.00	1	0	-1
0019	3T	4	231	1	0	100	0	-100	0.00	0.00	0	0	0
0019	3T	4	234	11	0	1100	0	-1100	0.00	0.00	1	0	-1
0019	3T	4	235	4	0	400	0	-400	0.00	0.00	0	0	0
0019	3T	4	236	6	0	600	0	-600	0.00	0.00	1	0	-1
0019	3T	4	241	2	0	200	0	-200	0.00	0.00	0	0	0
0019	3T	4	243	8	0	800	0	-800	0.00	0.00	1	0	-1
0019	3T	4	245	2	0	200	0	-200	0.00	0.00	0	0	0
0019	3T	4	246	1	0	100	0	-100	0.00	0.00	0	0	0
0019	3T	4	251	3	0	300	0	-300	0.00	0.00	0	0	0
0019	3T	4	253	1	0	100	0	-100	0.00	0.00	0	0	0
0019	3T	4	254	1	0	100	0	-100	0.00	0.00	0	0	0
0019	3T	4	256	2	0	200	0	-200	0.00	0.00	0	0	0
0019	3T	4	263	1	0	100	0	-100	0.00	0.00	0	0	0
0019	3T	4	265	2	0	200	0	-200	0.00	0.00	0	0	0
0019	3T	5	123	223	18	22300	19020	-3280	0.08	0.85	39	33	-6
0019	3T	5	124	256	25	25600	27870	2270	0.10	1.09	45	49	4
0019	3T	5	125	163	9	16300	12860	-3440	0.06	0.79	28	22	-6
0019	3T	5	126	112	5	11200	8670	-2530	0.04	0.77	19	15	-4
0019	3T	5	132	130	5	13000	6170	-6830	0.04	0.47	23	10	-13
0019	3T	5	134	155	13	15500	14210	-1290	0.08	0.92	27	25	-2
0019	3T	5	135	107	8	10700	11660	960	0.07	1.09	18	20	2
0019	3T	5	136	91	3	9100	10780	1680	0.03	1.18	16	19	3
0019	3T	5	142	84	5	8400	6860	-1540	0.06	0.82	14	12	-2
0019	3T	5	143	95	6	9500	6640	-2860	0.06	0.70	16	11	-5
0019	3T	5	145	54	2	5400	3650	-1750	0.04	0.68	9	6	-3
0019	3T	5	146	53	3	5300	4290	-1010	0.06	0.81	9	7	-2
0019	3T	5	152	34	0	3400	0	-3400	0.00	0.00	6	0	-6
0019	3T	5	153	27	0	2700	0	-2700	0.00	0.00	4	0	-4
0019	3T	5	154	29	0	2900	0	-2900	0.00	0.00	5	0	-5
0019	3T	5	156	17	1	1700	3440	1740	0.06	2.02	3	6	3
0019	3T	5	162	7	0	700	0	-700	0.00	0.00	1	0	-1
0019	3T	5	163	12	1	1200	2010	810	0.08	1.68	2	3	1
0019	3T	5	164	6	1	600	4330	3730	0.17	7.22	1	7	6
0019	3T	5	213	10	1	1000	1510	510	0.10	1.51	1	2	1
0019	3T	5	214	14	1	1400	980	-420	0.07	0.70	2	1	-1
0019	3T	5	215	9	0	900	0	-900	0.00	0.00	1	0	-1
0019	3T	5	216	8	0	800	0	-800	0.00	0.00	1	0	-1
0019	3T	5	231	3	0	300	0	-300	0.00	0.00	0	0	0
0019	3T	5	234	8	0	800	0	-800	0.00	0.00	1	0	-1
0019	3T	5	235	3	1	300	1940	1640	0.33	6.47	0	3	3
0019	3T	5	236	3	1	300	870	570	0.33	2.90	0	1	1
0019	3T	5	243	3	1	300	11270	10970	0.33	37.57	0	19	19
0019	3T	5	245	1	0	100	0	-100	0.00	0.00	0	0	0
0019	3T	5	246	1	0	100	0	-100	0.00	0.00	0	0	0
0019	3T	5	256	2	0	200	0	-200	0.00	0.00	0	0	0
0019	3T	5	263	1	0	100	0	-100	0.00	0.00	0	0	0
0019	3T	5	265	1	0	100	0	-100	0.00	0.00	0	0	0
0019	3T	6	123	431	51	43100	27480	-15620	0.12	0.64	76	48	-28
0019	3T	6	124	435	37	43500	26580	-16920	0.09	0.61	76	47	-29
0019	3T	6	125	215	16	21500	22750	1250	0.07	1.06	38	40	2
0019	3T	6	126	153	8	15300	16080	780	0.05	1.05	27	28	1
0019	3T	6	132	179	12	17900	12190	-5710	0.07	0.68	31	21	-10
0019	3T	6	134	230	16	23000	18330	-4670	0.07	0.80	40	32	-8
0019	3T	6	135	137	2	13700	4150	-9550	0.01	0.30	24	7	-17
0019	3T	6	136	78	1	7800	2830	-4970	0.01	0.36	13	5	-8
0019	3T	6	142	77	3	7700	5550	-2150	0.04	0.72	13	9	-4
0019	3T	6	143	87	3	8700	4950	-3750	0.03	0.57	15	8	-7
0019	3T	6	145	47	1	4700	1210	-3490	0.02	0.26	8	2	-6
0019	3T	6	146	36	0	3600	0	-3600	0.00	0.00	6	0	-6
0019	3T	6	152	21	0	2100	0	-2100	0.00	0.00	3	0	-3
0019	3T	6	153	21	0	2100	0	-2100	0.00	0.00	3	0	-3
0019	3T	6	154	29	0	2900	0	-2900	0.00	0.00	5	0	-5
0019	3T	6	156	16	0	1600	0	-1600	0.00	0.00	2	0	-2
0019	3T	6	162	5	1	500	1680	1180	0.20	3.36	0	2	2
0019	3T	6	163	9	0	900	0	-900	0.00	0.00	1	0	-1
0019	3T	6	164	5	0	500	0	-500	0.00	0.00	0	0	0
0019	3T	6	165	8	0	800	0	-800	0.00	0.00	1	0	-1
0019	3T	6	213	15	0	1500	0	-1500	0.00	0.00	2	0	-2
0019	3T	6	214	4	0	400	0	-400	0.00	0.00	0	0	0
0019	3T	6	215	6	1	600	2310	1710	0.17	3.85	1	4	3
0019	3T	6	216	4	0	400	0	-400	0.00	0.00	0	0	0
0019	3T	6	231	3	0	300	0	-300	0.00	0.00	0	0	0
0019	3T	6	234	4	0	400	0	-400	0.00	0.00	0	0	0
0019	3T	6	235	2	0	200	0	-200	0.00	0.00	0	0	0
0019	3T	6	236	3	0	300	0	-300	0.00	0.00	0	0	0
0019	3T	6	241	1	0	100	0	-100	0.00	0.00	0	0	0
0019	3T	6	243	2	0	200	0	-200	0.00	0.00	0	0	0
0019	3T	6	245	1	0	100	0	-100	0.00	0.00	0	0	0
0019	3T	6	246	2	0	200	0	-200	0.00	0.00	0	0	0
0019	3T	6	254	1	0	100	0	-100	0.00	0.00	0	0	0
0019	3T	6	256	1	0	100	0	-100	0.00	0.00	0	0	0
0019	3T	6	261	1	0	100	0	-100	0.00	0.00	0	0	0
0019	3T	7	123	149	21	14900	16050	1150	0.14	1.08	26	28	2
0019	3T	7	124	138	13	13800	10590	-3210	0.09	0.77	24	18	-6
0019	3T	7	125	79	5	7900	5530	-2370	0.06	0.70	13	9	-4
0019	3T	7	126	63	0	6300	0	-6300	0.00	0.00	11	0	-11
0019	3T	7	132	58	7	5800	6650	850	0.12	1.15	10	11	1
0019	3T	7	134	65	6	6500	5920	-580	0.09	0.91	11	10	-1
0019	3T	7	135	38	1	3800	2720	-1080	0.03	0.72	6	4	-2
0019	3T	7	136	40	0	4000	0	-4000	0.00	0.00	7	0	-7
0019	3T	7	142	40	1	4000	4450	450	0.03	1.11	7	7	0
0019	3T	7	143	62	3	6200	5600	-600	0.05	0.90	10	9	-1
0019	3T	7	145	24	1	2400	2040	-360	0.04	0.85	4	3	-1
0019	3T	7	146	20	0	2000	0	-2000	0.00	0.00	3	0	-3
0019	3T	7	152	8	0	800	0	-800	0.00	0.00	1	0	-1
0019	3T	7	153	15	0	1500	0	-1500	0.00	0.00	2	0	-2
0019	3T	7	154	14	0	1400	0	-1400	0.00	0.00	2	0	-2
0019	3T	7	156	9	0	900	0	-900	0.00	0.00	1	0	-1
0019	3T	7	162	3	0	300	0	-300	0.00	0.00	0	0	0
0019	3T	7	163	2	0	200	0	-200	0.00	0.00	0	0	0
0019	3T	7	164	3	0	300	0	-300	0.00	0.00	0	0	0
0019	3T	7	165	2	0	200	0	-200	0.00	0.00	0	0	0
0019	3T	7	213	4	0	400	0	-400	0.00	0.00	0	0	0
0019	3T	7	214	1	0	100	0	-100	0.00	0.00	0	0	0
0019	3T	7	215	3	0	300	0	-300	0.00	0.00	0	0	0
0019	3T	7	234	1	0	100	0	-100	0.00	0.00	0	0	0
0019	3T	7	236	2	0	200	0	-200	0.00	0.00	0	0	0
0019	3T	7	245	2	0	200	0	-200	0.00	0.00	0	0	0
0019	3T	7	246	1	0	100	0	-100	0.00	0.00	0	0	0
0019	3T	7	254	1	0	100	0	-100	0.00	0.00	0	0	0
0019	3T	else	123	1430	154	143000	114800	-28200	0.11	0.80	253	203	-50
0019	3T	else	124	1225	101	122500	88030	-34470	0.08	0.72	216	155	-61
0019	3T	else	125	714	45	71400	48900	-22500	0.06	0.68	126	86	-40
0019	3T	else	126	492	15	49200	21790	-27410	0.03	0.44	87	38	-49
0019	3T	else	132	707	68	70700	73760	3060	0.10	1.04	125	130	5
0019	3T	else	134	718	64	71800	59160	-12640	0.09	0.82	127	104	-23
0019	3T	else	135	424	22	42400	31900	-10500	0.05	0.75	75	56	-19
0019	3T	else	136	337	19	33700	33540	-160	0.06	1.00	59	59	0
0019	3T	else	142	416	35	41600	46200	4600	0.08	1.11	73	81	8
0019	3T	else	143	444	21	44400	35120	-9280	0.05	0.79	78	62	-16
0019	3T	else	145	269	5	26900	6430	-20470	0.02	0.24	47	11	-36
0019	3T	else	146	172	7	17200	12690	-4510	0.04	0.74	30	22	-8
0019	3T	else	152	112	4	11200	12090	890	0.04	1.08	19	21	2
0019	3T	else	153	115	5	11500	7660	-3840	0.04	0.67	20	13	-7
0019	3T	else	154	96	3	9600	10830	1230	0.03	1.13	16	19	3
0019	3T	else	156	53	1	5300	1790	-3510	0.02	0.34	9	3	-6
0019	3T	else	162	53	1	5300	5140	-160	0.02	0.97	9	9	0
0019	3T	else	163	49	2	4900	3330	-1570	0.04	0.68	8	5	-3
0019	3T	else	164	26	0	2600	0	-2600	0.00	0.00	4	0	-4
0019	3T	else	165	18	0	1800	0	-1800	0.00	0.00	3	0	-3
0019	3T	else	213	28	1	2800	730	-2070	0.04	0.26	4	1	-3
0019	3T	else	214	35	1	3500	2760	-740	0.03	0.79	6	4	-2
0019	3T	else	215	16	1	1600	1510	-90	0.06	0.94	2	2	0
0019	3T	else	216	11	0	1100	0	-1100	0.00	0.00	1	0	-1
0019	3T	else	231	10	0	1000	0	-1000	0.00	0.00	1	0	-1
0019	3T	else	234	9	0	900	0	-900	0.00	0.00	1	0	-1
0019	3T	else	235	6	0	600	0	-600	0.00	0.00	1	0	-1
0019	3T	else	236	6	1	600	3920	3320	0.17	6.53	1	6	5
0019	3T	else	241	9	1	900	2940	2040	0.11	3.27	1	5	4
0019	3T	else	243	15	2	1500	43540	42040	0.13	29.03	2	77	75
0019	3T	else	245	2	0	200	0	-200	0.00	0.00	0	0	0
0019	3T	else	246	2	0	200	0	-200	0.00	0.00	0	0	0
0019	3T	else	251	4	0	400	0	-400	0.00	0.00	0	0	0
0019	3T	else	253	1	0	100	0	-100	0.00	0.00	0	0	0
0019	3T	else	254	1	0	100	0	-100	0.00	0.00	0	0	0
0019	3T	else	256	5	0	500	0	-500	0.00	0.00	0	0	0
0019	3T	else	261	1	0	100	0	-100	0.00	0.00	0	0	0
0019	3T	else	263	2	0	200	0	-200	0.00	0.00	0	0	0
0019	3T	else	264	1	0	100	0	-100	0.00	0.00	0	0	0
0019	3T	else	265	4	0	400	0	-400	0.00	0.00	0	0	0
0005	2F	18	23	49	7	4900	5150	250	0.14	1.05	8	9	1
0005	2F	18	24	35	6	3500	4570	1070	0.17	1.31	6	8	2
0005	2F	18	25	20	5	2000	3400	1400	0.25	1.70	3	6	3
0005	2F	18	26	22	2	2200	970	-1230	0.09	0.44	3	1	-2
0005	2F	19	12	1097	319	109700	89960	-19740	0.29	0.82	194	159	-35
0005	2F	19	13	642	169	64200	50010	-14190	0.26	0.78	113	88	-25
0005	2F	19	14	436	114	43600	37360	-6240	0.26	0.86	77	66	-11
0005	2F	19	15	103	17	10300	11300	1000	0.17	1.10	18	20	2
0005	2F	19	16	61	9	6100	4180	-1920	0.15	0.69	10	7	-3
0005	2F	19	23	65	8	6500	4100	-2400	0.12	0.63	11	7	-4
0005	2F	19	24	27	4	2700	8820	6120	0.15	3.27	4	15	11
0005	2F	19	25	12	0	1200	0	-1200	0.00	0.00	2	0	-2
0005	2F	19	26	24	4	2400	3750	1350	0.17	1.56	4	6	2
0005	2F	20	12	1141	381	114100	98710	-15390	0.33	0.87	201	174	-27
0005	2F	20	13	626	187	62600	54130	-8470	0.30	0.86	110	95	-15
0005	2F	20	14	400	104	40000	36200	-3800	0.26	0.91	70	64	-6
0005	2F	20	15	165	31	16500	14130	-2370	0.19	0.86	29	25	-4
0005	2F	20	16	102	25	10200	13990	3790	0.25	1.37	18	24	6
0005	2F	20	23	34	5	3400	3130	-270	0.15	0.92	6	5	-1
0005	2F	20	24	18	3	1800	2600	800	0.17	1.44	3	4	1
0005	2F	20	25	17	1	1700	1920	220	0.06	1.13	3	3	0
0005	2F	20	26	11	2	1100	2320	1220	0.18	2.11	1	4	3
0005	2F	21	12	1233	406	123300	101660	-21640	0.33	0.82	218	179	-39
0005	2F	21	13	769	247	76900	70240	-6660	0.32	0.91	136	124	-12
0005	2F	21	14	449	125	44900	33080	-11820	0.28	0.74	79	58	-21
0005	2F	21	15	139	26	13900	12320	-1580	0.19	0.89	24	21	-3
0005	2F	21	16	68	5	6800	2310	-4490	0.07	0.34	12	4	-8
0005	2F	21	23	32	3	3200	1550	-1650	0.09	0.48	5	2	-3
0005	2F	21	24	15	4	1500	2610	1110	0.27	1.74	2	4	2
0005	2F	21	25	7	1	700	390	-310	0.14	0.56	1	0	-1
0005	2F	21	26	6	0	600	0	-600	0.00	0.00	1	0	-1
0005	2F	22	12	1047	303	104700	92120	-12580	0.29	0.88	185	163	-22
0005	2F	22	13	514	116	51400	39770	-11630	0.23	0.77	90	70	-20
0005	2F	22	14	336	49	33600	36840	3240	0.15	1.10	59	65	6
0005	2F	22	15	118	9	11800	5600	-6200	0.08	0.47	20	9	-11
0005	2F	22	16	39	3	3900	2360	-1540	0.08	0.61	6	4	-2
0005	2F	22	23	68	4	6800	2230	-4570	0.06	0.33	12	3	-9
0005	2F	22	24	43	4	4300	1440	-2860	0.09	0.33	7	2	-5
0005	2F	22	25	26	1	2600	680	-1920	0.04	0.26	4	1	-3
0005	2F	22	26	16	0	1600	0	-1600	0.00	0.00	2	0	-2
0005	2F	23	12	1053	314	105300	89660	-15640	0.30	0.85	186	158	-28
0005	2F	23	13	632	159	63200	56720	-6480	0.25	0.90	111	100	-11
0005	2F	23	14	372	72	37200	32150	-5050	0.19	0.86	65	56	-9
0005	2F	23	15	137	13	13700	4430	-9270	0.09	0.32	24	7	-17
0005	2F	23	16	33	4	3300	3450	150	0.12	1.05	5	6	1
0005	2F	23	23	65	11	6500	7100	600	0.17	1.09	11	12	1
0005	2F	23	24	56	8	5600	4880	-720	0.14	0.87	9	8	-1
0005	2F	23	25	20	1	2000	460	-1540	0.05	0.23	3	0	-3
0005	2F	23	26	9	1	900	3830	2930	0.11	4.26	1	6	5
0005	2F	24	12	1299	407	129900	105620	-24280	0.31	0.81	229	186	-43
0005	2F	24	13	706	204	70600	63760	-6840	0.29	0.90	124	112	-12
0005	2F	24	14	398	87	39800	36070	-3730	0.22	0.91	70	63	-7
0005	2F	24	15	126	17	12600	10180	-2420	0.13	0.81	22	18	-4
0005	2F	24	16	74	9	7400	3230	-4170	0.12	0.44	13	5	-8
0005	2F	24	23	42	5	4200	4060	-140	0.12	0.97	7	7	0
0005	2F	24	24	25	6	2500	6260	3760	0.24	2.50	4	11	7
0005	2F	24	25	13	3	1300	1380	80	0.23	1.06	2	2	0
0005	2F	24	26	7	1	700	850	150	0.14	1.21	1	1	0
0005	2T	01	12	976	196	97600	78460	-19140	0.20	0.80	172	138	-34
0005	2T	01	13	524	81	52400	50580	-1820	0.15	0.97	92	89	-3
0005	2T	01	14	358	30	35800	16110	-19690	0.08	0.45	63	28	-35
0005	2T	01	15	183	20	18300	10410	-7890	0.11	0.57	32	18	-14
0005	2T	01	16	39	6	3900	5780	1880	0.15	1.48	6	10	4
0005	2T	01	21	125	9	12500	12440	-60	0.07	1.00	22	22	0
0005	2T	01	23	64	4	6400	2400	-4000	0.06	0.38	11	4	-7
0005	2T	01	24	36	1	3600	4120	520	0.03	1.14	6	7	1
0005	2T	01	25	25	1	2500	2220	-280	0.04	0.89	4	3	-1
0005	2T	01	26	9	0	900	0	-900	0.00	0.00	1	0	-1
0005	2T	02	12	943	189	94300	91260	-3040	0.20	0.97	166	161	-5
0005	2T	02	13	569	74	56900	44770	-12130	0.13	0.79	100	79	-21
0005	2T	02	14	334	30	33400	20380	-13020	0.09	0.61	59	36	-23
0005	2T	02	15	184	22	18400	28780	10380	0.12	1.56	32	50	18
0005	2T	02	16	71	4	7100	4750	-2350	0.06	0.67	12	8	-4
0005	2T	02	21	119	10	11900	9930	-1970	0.08	0.83	21	17	-4
0005	2T	02	23	67	4	6700	2030	-4670	0.06	0.30	11	3	-8
0005	2T	02	24	41	3	4100	2180	-1920	0.07	0.53	7	3	-4
0005	2T	02	25	33	2	3300	1500	-1800	0.06	0.45	5	2	-3
0005	2T	02	26	16	0	1600	0	-1600	0.00	0.00	2	0	-2
0005	2T	03	12	648	124	64800	57630	-7170	0.19	0.89	114	102	-12
0005	2T	03	13	411	64	41100	31510	-9590	0.16	0.77	72	55	-17
0005	2T	03	14	253	30	25300	19860	-5440	0.12	0.78	44	35	-9
0005	2T	03	15	142	13	14200	21750	7550	0.09	1.53	25	38	13
0005	2T	03	16	75	6	7500	9780	2280	0.08	1.30	13	17	4
0005	2T	03	21	96	13	9600	7700	-1900	0.14	0.80	16	13	-3
0005	2T	03	23	67	5	6700	3920	-2780	0.07	0.59	11	6	-5
0005	2T	03	24	37	1	3700	610	-3090	0.03	0.16	6	1	-5
0005	2T	03	25	35	0	3500	0	-3500	0.00	0.00	6	0	-6
0005	2T	03	26	15	0	1500	0	-1500	0.00	0.00	2	0	-2
0005	2T	04	12	735	128	73500	55940	-17560	0.17	0.76	130	99	-31
0005	2T	04	13	471	79	47100	35440	-11660	0.17	0.75	83	62	-21
0005	2T	04	14	312	44	31200	32550	1350	0.14	1.04	55	57	2
0005	2T	04	15	171	14	17100	12000	-5100	0.08	0.70	30	21	-9
0005	2T	04	16	112	10	11200	12480	1280	0.09	1.11	19	22	3
0005	2T	04	21	103	15	10300	11180	880	0.15	1.09	18	19	1
0005	2T	04	23	63	7	6300	8750	2450	0.11	1.39	11	15	4
0005	2T	04	24	42	2	4200	1160	-3040	0.05	0.28	7	2	-5
0005	2T	04	25	27	1	2700	1680	-1020	0.04	0.62	4	2	-2
0005	2T	04	26	15	1	1500	850	-650	0.07	0.57	2	1	-1
0005	2T	05	12	850	187	85000	78910	-6090	0.22	0.93	150	139	-11
0005	2T	05	13	545	103	54500	49950	-4550	0.19	0.92	96	88	-8
0005	2T	05	14	379	68	37900	38950	1050	0.18	1.03	67	68	1
0005	2T	05	15	171	14	17100	11530	-5570	0.08	0.67	30	20	-10
0005	2T	05	16	88	6	8800	4970	-3830	0.07	0.56	15	8	-7
0005	2T	05	21	109	8	10900	4860	-6040	0.07	0.45	19	8	-11
0005	2T	05	23	85	6	8500	4140	-4360	0.07	0.49	15	7	-8
0005	2T	05	24	46	4	4600	2480	-2120	0.09	0.54	8	4	-4
0005	2T	05	25	26	3	2600	2310	-290	0.12	0.89	4	4	0
0005	2T	05	26	21	0	2100	0	-2100	0.00	0.00	3	0	-3
0005	2T	06	12	952	213	95200	85250	-9950	0.22	0.90	168	150	-18
0005	2T	06	13	653	101	65300	49000	-16300	0.15	0.75	115	86	-29
0005	2T	06	14	351	52	35100	27760	-7340	0.15	0.79	62	49	-13
0005	2T	06	15	203	24	20300	16310	-3990	0.12	0.80	35	28	-7
0005	2T	06	16	118	12	11800	9660	-2140	0.10	0.82	20	17	-3
0005	2T	06	21	106	10	10600	7210	-3390	0.09	0.68	18	12	-6
0005	2T	06	23	58	4	5800	5320	-480	0.07	0.92	10	9	-1
0005	2T	06	24	35	4	3500	9670	6170	0.11	2.76	6	17	11
0005	2T	06	25	35	4	3500	6390	2890	0.11	1.83	6	11	5
0005	2T	06	26	18	1	1800	380	-1420	0.06	0.21	3	0	-3
0005	2T	07	12	962	214	96200	82900	-13300	0.22	0.86	170	146	-24
0005	2T	07	13	647	131	64700	55240	-9460	0.20	0.85	114	97	-17
0005	2T	07	14	382	65	38200	30700	-7500	0.17	0.80	67	54	-13
0005	2T	07	15	201	30	20100	19240	-860	0.15	0.96	35	34	-1
0005	2T	07	16	104	10	10400	9880	-520	0.10	0.95	18	17	-1
0005	2T	07	21	88	8	8800	7320	-1480	0.09	0.83	15	12	-3
0005	2T	07	23	55	3	5500	3050	-2450	0.05	0.55	9	5	-4
0005	2T	07	24	33	3	3300	1710	-1590	0.09	0.52	5	3	-2
0005	2T	07	25	28	2	2800	1180	-1620	0.07	0.42	4	2	-2
0005	2T	07	26	34	6	3400	10970	7570	0.18	3.23	6	19	13
0005	2T	08	12	1007	254	100700	93490	-7210	0.25	0.93	178	165	-13
0005	2T	08	13	596	110	59600	46990	-12610	0.18	0.79	105	83	-22
0005	2T	08	14	366	59	36600	26920	-9680	0.16	0.74	64	47	-17
0005	2T	08	15	153	17	15300	12390	-2910	0.11	0.81	27	21	-6
0005	2T	08	16	135	20	13500	17320	3820	0.15	1.28	23	30	7
0005	2T	08	21	69	13	6900	6380	-520	0.19	0.92	12	11	-1
0005	2T	08	23	34	3	3400	2130	-1270	0.09	0.63	6	3	-3
0005	2T	08	24	28	4	2800	4950	2150	0.14	1.77	4	8	4
0005	2T	08	25	26	7	2600	8980	6380	0.27	3.45	4	15	11
0005	2T	08	26	22	1	2200	2160	-40	0.05	0.98	3	3	0
0005	2T	09	12	1094	294	109400	87960	-21440	0.27	0.80	193	155	-38
0005	2T	09	13	642	142	64200	61320	-2880	0.22	0.96	113	108	-5
0005	2T	09	14	382	63	38200	33290	-4910	0.16	0.87	67	58	-9
0005	2T	09	15	166	17	16600	11330	-5270	0.10	0.68	29	20	-9
0005	2T	09	16	90	8	9000	7180	-1820	0.09	0.80	15	12	-3
0005	2T	09	21	105	18	10500	9860	-640	0.17	0.94	18	17	-1
0005	2T	09	23	55	5	5500	4320	-1180	0.09	0.79	9	7	-2
0005	2T	09	24	26	3	2600	2080	-520	0.12	0.80	4	3	-1
0005	2T	09	25	29	0	2900	0	-2900	0.00	0.00	5	0	-5
0005	2T	09	26	19	2	1900	1920	20	0.11	1.01	3	3	0
0005	2T	10	12	1039	258	103900	79600	-24300	0.25	0.77	183	140	-43
0005	2T	10	13	642	114	64200	43040	-21160	0.18	0.67	113	76	-37
0005	2T	10	14	324	70	32400	36810	4410	0.22	1.14	57	65	8
0005	2T	10	15	117	14	11700	9680	-2020	0.12	0.83	20	17	-3
0005	2T	10	16	74	10	7400	11690	4290	0.14	1.58	13	20	7
0005	2T	10	21	89	11	8900	8690	-210	0.12	0.98	15	15	0
0005	2T	10	23	46	6	4600	3640	-960	0.13	0.79	8	6	-2
0005	2T	10	24	31	9	3100	5440	2340	0.29	1.75	5	9	4
0005	2T	10	25	19	1	1900	530	-1370	0.05	0.28	3	0	-3
0005	2T	10	26	26	5	2600	3010	410	0.19	1.16	4	5	1
0005	2T	11	12	946	188	94600	90110	-4490	0.20	0.95	167	159	-8
0005	2T	11	13	408	55	40800	33870	-6930	0.13	0.83	72	59	-13
0005	2T	11	14	352	37	35200	21090	-14110	0.11	0.60	62	37	-25
0005	2T	11	15	130	4	13000	5010	-7990	0.03	0.39	23	8	-15
0005	2T	11	16	45	2	4500	3290	-1210	0.04	0.73	7	5	-2
0005	2T	11	21	179	25	17900	29280	11380	0.14	1.64	31	51	20
0005	2T	11	23	51	2	5100	1770	-3330	0.04	0.35	9	3	-6
0005	2T	11	24	55	0	5500	0	-5500	0.00	0.00	9	0	-9
0005	2T	11	25	29	0	2900	0	-2900	0.00	0.00	5	0	-5
0005	2T	11	26	13	0	1300	0	-1300	0.00	0.00	2	0	-2
0005	2T	12	12	957	208	95700	77740	-17960	0.22	0.81	169	137	-32
0005	2T	12	13	564	107	56400	43840	-12560	0.19	0.78	99	77	-22
0005	2T	12	14	315	38	31500	18550	-12950	0.12	0.59	55	32	-23
0005	2T	12	15	152	12	15200	11070	-4130	0.08	0.73	26	19	-7
0005	2T	12	16	66	6	6600	3020	-3580	0.09	0.46	11	5	-6
0005	2T	12	21	98	10	9800	9480	-320	0.10	0.97	17	16	-1
0005	2T	12	23	72	7	7200	5480	-1720	0.10	0.76	12	9	-3
0005	2T	12	24	42	1	4200	3100	-1100	0.02	0.74	7	5	-2
0005	2T	12	25	19	0	1900	0	-1900	0.00	0.00	3	0	-3
0005	2T	12	26	9	1	900	8280	7380	0.11	9.20	1	14	13
0005	2T	13	12	941	231	94100	81020	-13080	0.25	0.86	166	143	-23
0005	2T	13	13	565	97	56500	48650	-7850	0.17	0.86	100	86	-14
0005	2T	13	14	432	78	43200	39720	-3480	0.18	0.92	76	70	-6
0005	2T	13	15	144	15	14400	9300	-5100	0.10	0.65	25	16	-9
0005	2T	13	16	80	9	8000	6820	-1180	0.11	0.85	14	12	-2
0005	2T	13	21	83	12	8300	9820	1520	0.14	1.18	14	17	3
0005	2T	13	23	61	5	6100	9860	3760	0.08	1.62	10	17	7
0005	2T	13	24	37	1	3700	870	-2830	0.03	0.24	6	1	-5
0005	2T	13	25	28	1	2800	370	-2430	0.04	0.13	4	0	-4
0005	2T	13	26	11	1	1100	980	-120	0.09	0.89	1	1	0
0005	2T	14	12	782	169	78200	63410	-14790	0.22	0.81	138	112	-26
0005	2T	14	13	525	86	52500	40910	-11590	0.16	0.78	92	72	-20
0005	2T	14	14	405	68	40500	28630	-11870	0.17	0.71	71	50	-21
0005	2T	14	15	153	9	15300	8390	-6910	0.06	0.55	27	14	-13
0005	2T	14	16	65	6	6500	4340	-2160	0.09	0.67	11	7	-4
0005	2T	14	21	120	14	12000	10400	-1600	0.12	0.87	21	18	-3
0005	2T	14	23	69	8	6900	7070	170	0.12	1.02	12	12	0
0005	2T	14	24	40	2	4000	1370	-2630	0.05	0.34	7	2	-5
0005	2T	14	25	27	0	2700	0	-2700	0.00	0.00	4	0	-4
0005	2T	14	26	11	0	1100	0	-1100	0.00	0.00	1	0	-1
0005	2T	15	12	1109	238	110900	86840	-24060	0.21	0.78	196	153	-43
0005	2T	15	13	570	121	57000	56890	-110	0.21	1.00	100	100	0
0005	2T	15	14	493	71	49300	39040	-10260	0.14	0.79	87	69	-18
0005	2T	15	15	178	12	17800	8650	-9150	0.07	0.49	31	15	-16
0005	2T	15	16	86	9	8600	9460	860	0.10	1.10	15	16	1
0005	2T	15	21	97	16	9700	11340	1640	0.16	1.17	17	20	3
0005	2T	15	23	60	3	6000	3690	-2310	0.05	0.62	10	6	-4
0005	2T	15	24	38	2	3800	940	-2860	0.05	0.25	6	1	-5
0005	2T	15	25	21	1	2100	450	-1650	0.05	0.21	3	0	-3
0005	2T	15	26	22	0	2200	0	-2200	0.00	0.00	3	0	-3
0005	2T	16	12	1176	301	117600	104050	-13550	0.26	0.88	208	184	-24
0005	2T	16	13	634	117	63400	49290	-14110	0.18	0.78	112	87	-25
0005	2T	16	14	451	82	45100	31990	-13110	0.18	0.71	79	56	-23
0005	2T	16	15	159	20	15900	18730	2830	0.13	1.18	28	33	5
0005	2T	16	16	89	6	8900	5240	-3660	0.07	0.59	15	9	-6
0005	2T	16	21	96	10	9600	5510	-4090	0.10	0.57	16	9	-7
0005	2T	16	23	55	4	5500	5790	290	0.07	1.05	9	10	1
0005	2T	16	24	29	2	2900	1230	-1670	0.07	0.42	5	2	-3
0005	2T	16	25	21	3	2100	3770	1670	0.14	1.80	3	6	3
0005	2T	16	26	13	0	1300	0	-1300	0.00	0.00	2	0	-2
0005	2T	17	12	1129	251	112900	83880	-29020	0.22	0.74	199	148	-51
0005	2T	17	13	652	160	65200	60290	-4910	0.25	0.92	115	106	-9
0005	2T	17	14	416	59	41600	31180	-10420	0.14	0.75	73	55	-18
0005	2T	17	15	127	13	12700	7190	-5510	0.10	0.57	22	12	-10
0005	2T	17	16	66	2	6600	2310	-4290	0.03	0.35	11	4	-7
0005	2T	17	21	95	13	9500	6820	-2680	0.14	0.72	16	12	-4
0005	2T	17	23	63	9	6300	7860	1560	0.14	1.25	11	13	2
0005	2T	17	24	35	2	3500	1290	-2210	0.06	0.37	6	2	-4
0005	2T	17	25	16	1	1600	1360	-240	0.06	0.85	2	2	0
0005	2T	17	26	19	0	1900	0	-1900	0.00	0.00	3	0	-3
0005	2T	18	12	1203	358	120300	103120	-17180	0.30	0.86	212	182	-30
0005	2T	18	13	730	144	73000	55600	-17400	0.20	0.76	129	98	-31
0005	2T	18	14	457	88	45700	40670	-5030	0.19	0.89	80	71	-9
0005	2T	18	15	184	29	18400	17010	-1390	0.16	0.92	32	30	-2
0005	2T	18	16	80	9	8000	8800	800	0.11	1.10	14	15	1
0005	2T	18	21	86	15	8600	14360	5760	0.17	1.67	15	25	10
0005	2T	18	23	49	6	4900	9760	4860	0.12	1.99	8	17	9
0005	2T	18	24	35	4	3500	4560	1060	0.11	1.30	6	8	2
0005	2T	18	25	20	3	2000	1700	-300	0.15	0.85	3	3	0
0005	2T	18	26	22	1	2200	970	-1230	0.05	0.44	3	1	-2
0005	2T	19	12	1017	232	101700	80710	-20990	0.23	0.79	180	142	-38
0005	2T	19	13	642	135	64200	50660	-13540	0.21	0.79	113	89	-24
0005	2T	19	14	436	94	43600	42530	-1070	0.22	0.98	77	75	-2
0005	2T	19	15	103	12	10300	14200	3900	0.12	1.38	18	25	7
0005	2T	19	16	61	7	6100	3770	-2330	0.11	0.62	10	6	-4
0005	2T	19	21	80	11	8000	10790	2790	0.14	1.35	14	19	5
0005	2T	19	23	65	2	6500	1400	-5100	0.03	0.22	11	2	-9
0005	2T	19	24	27	4	2700	16470	13770	0.15	6.10	4	29	25
0005	2T	19	25	12	0	1200	0	-1200	0.00	0.00	2	0	-2
0005	2T	19	26	24	2	2400	4080	1680	0.08	1.70	4	7	3
0005	2T	20	12	1066	268	106600	89510	-17090	0.25	0.84	188	158	-30
0005	2T	20	13	626	135	62600	52250	-10350	0.22	0.83	110	92	-18
0005	2T	20	14	400	79	40000	35740	-4260	0.20	0.89	70	63	-7
0005	2T	20	15	165	26	16500	15960	-540	0.16	0.97	29	28	-1
0005	2T	20	16	102	18	10200	12730	2530	0.18	1.25	18	22	4
0005	2T	20	21	75	14	7500	8250	750	0.19	1.10	13	14	1
0005	2T	20	23	34	5	3400	5920	2520	0.15	1.74	6	10	4
0005	2T	20	24	18	1	1800	2120	320	0.06	1.18	3	3	0
0005	2T	20	25	17	1	1700	4240	2540	0.06	2.49	3	7	4
0005	2T	20	26	11	1	1100	670	-430	0.09	0.61	1	1	0
0005	2T	21	12	1175	316	117500	98960	-18540	0.27	0.84	207	175	-32
0005	2T	21	13	769	211	76900	75340	-1560	0.27	0.98	136	133	-3
0005	2T	21	14	449	92	44900	30410	-14490	0.20	0.68	79	53	-26
0005	2T	21	15	139	18	13900	12460	-1440	0.13	0.90	24	22	-2
0005	2T	21	16	68	4	6800	2400	-4400	0.06	0.35	12	4	-8
0005	2T	21	21	58	11	5800	4510	-1290	0.19	0.78	10	7	-3
0005	2T	21	23	32	1	3200	310	-2890	0.03	0.10	5	0	-5
0005	2T	21	24	15	3	1500	2360	860	0.20	1.57	2	4	2
0005	2T	21	25	7	0	700	0	-700	0.00	0.00	1	0	-1
0005	2T	21	26	6	0	600	0	-600	0.00	0.00	1	0	-1
0005	2T	22	12	914	189	91400	76230	-15170	0.21	0.83	161	134	-27
0005	2T	22	13	514	82	51400	38890	-12510	0.16	0.76	90	68	-22
0005	2T	22	14	336	36	33600	25870	-7730	0.11	0.77	59	45	-14
0005	2T	22	15	118	7	11800	5140	-6660	0.06	0.44	20	9	-11
0005	2T	22	16	39	2	3900	1700	-2200	0.05	0.44	6	3	-3
0005	2T	22	21	133	10	13300	4930	-8370	0.08	0.37	23	8	-15
0005	2T	22	23	68	1	6800	970	-5830	0.01	0.14	12	1	-11
0005	2T	22	24	43	3	4300	1420	-2880	0.07	0.33	7	2	-5
0005	2T	22	25	26	1	2600	1550	-1050	0.04	0.60	4	2	-2
0005	2T	22	26	16	0	1600	0	-1600	0.00	0.00	2	0	-2
0005	2T	23	12	937	208	93700	83020	-10680	0.22	0.89	165	146	-19
0005	2T	23	13	632	123	63200	58930	-4270	0.19	0.93	111	104	-7
0005	2T	23	14	372	51	37200	32430	-4770	0.14	0.87	65	57	-8
0005	2T	23	15	137	11	13700	6490	-7210	0.08	0.47	24	11	-13
0005	2T	23	16	33	2	3300	3060	-240	0.06	0.93	5	5	0
0005	2T	23	21	116	12	11600	6700	-4900	0.10	0.58	20	11	-9
0005	2T	23	23	65	7	6500	4510	-1990	0.11	0.69	11	7	-4
0005	2T	23	24	56	8	5600	11000	5400	0.14	1.96	9	19	10
0005	2T	23	25	20	0	2000	0	-2000	0.00	0.00	3	0	-3
0005	2T	23	26	9	0	900	0	-900	0.00	0.00	1	0	-1
0005	2T	24	12	1215	319	121500	96170	-25330	0.26	0.79	215	170	-45
0005	2T	24	13	706	169	70600	66910	-3690	0.24	0.95	124	118	-6
0005	2T	24	14	398	76	39800	37340	-2460	0.19	0.94	70	66	-4
0005	2T	24	15	126	13	12600	10910	-1690	0.10	0.87	22	19	-3
0005	2T	24	16	74	7	7400	4670	-2730	0.09	0.63	13	8	-5
0005	2T	24	21	84	16	8400	10020	1620	0.19	1.19	14	17	3
0005	2T	24	23	42	3	4200	4510	310	0.07	1.07	7	7	0
0005	2T	24	24	25	5	2500	19450	16950	0.20	7.78	4	34	30
0005	2T	24	25	13	3	1300	2100	800	0.23	1.62	2	3	1
0005	2T	24	26	7	1	700	1180	480	0.14	1.69	1	2	1
0005	3F	01	123	467	81	46700	37270	-9430	0.17	0.80	82	65	-17
0005	3F	01	124	358	35	35800	21360	-14440	0.10	0.60	63	37	-26
0005	3F	01	125	238	21	23800	12020	-11780	0.09	0.51	42	21	-21
0005	3F	01	126	129	13	12900	16370	3470	0.10	1.27	22	28	6
0005	3F	01	134	220	25	22000	13850	-8150	0.11	0.63	38	24	-14
0005	3F	01	135	127	15	12700	8080	-4620	0.12	0.64	22	14	-8
0005	3F	01	136	83	4	8300	4860	-3440	0.05	0.59	14	8	-6
0005	3F	01	145	98	6	9800	5790	-4010	0.06	0.59	17	10	-7
0005	3F	01	146	56	2	5600	2530	-3070	0.04	0.45	9	4	-5
0005	3F	01	156	36	1	3600	620	-2980	0.03	0.17	6	1	-5
0005	3F	01	234	28	2	2800	3710	910	0.07	1.33	4	6	2
0005	3F	01	235	17	2	1700	670	-1030	0.12	0.39	3	1	-2
0005	3F	01	236	5	0	500	0	-500	0.00	0.00	0	0	0
0005	3F	01	245	12	0	1200	0	-1200	0.00	0.00	2	0	-2
0005	3F	01	246	3	0	300	0	-300	0.00	0.00	0	0	0
0005	3F	01	256	4	0	400	0	-400	0.00	0.00	0	0	0
0005	3F	02	123	404	58	40400	27270	-13130	0.14	0.68	71	48	-23
0005	3F	02	124	341	33	34100	25580	-8520	0.10	0.75	60	45	-15
0005	3F	02	125	235	27	23500	24510	1010	0.11	1.04	41	43	2
0005	3F	02	126	181	14	18100	17780	-320	0.08	0.98	32	31	-1
0005	3F	02	134	219	28	21900	16550	-5350	0.13	0.76	38	29	-9
0005	3F	02	135	151	15	15100	14190	-910	0.10	0.94	26	25	-1
0005	3F	02	136	115	15	11500	14830	3330	0.13	1.29	20	26	6
0005	3F	02	145	105	10	10500	7570	-2930	0.10	0.72	18	13	-5
0005	3F	02	146	56	2	5600	910	-4690	0.04	0.16	9	1	-8
0005	3F	02	156	44	1	4400	800	-3600	0.02	0.18	7	1	-6
0005	3F	02	234	20	1	2000	400	-1600	0.05	0.20	3	0	-3
0005	3F	02	235	21	1	2100	870	-1230	0.05	0.41	3	1	-2
0005	3F	02	236	11	0	1100	0	-1100	0.00	0.00	1	0	-1
0005	3F	02	245	15	1	1500	1480	-20	0.07	0.99	2	2	0
0005	3F	02	246	10	0	1000	0	-1000	0.00	0.00	1	0	-1
0005	3F	02	256	7	1	700	650	-50	0.14	0.93	1	1	0
0005	3F	03	123	324	75	32400	35100	2700	0.23	1.08	57	62	5
0005	3F	03	124	233	28	23300	12440	-10860	0.12	0.53	41	22	-19
0005	3F	03	125	186	24	18600	11890	-6710	0.13	0.64	32	21	-11
0005	3F	03	126	132	16	13200	16340	3140	0.12	1.24	23	28	5
0005	3F	03	134	149	24	14900	15560	660	0.16	1.04	26	27	1
0005	3F	03	135	107	15	10700	12130	1430	0.14	1.13	18	21	3
0005	3F	03	136	71	5	7100	3790	-3310	0.07	0.53	12	6	-6
0005	3F	03	145	70	10	7000	7130	130	0.14	1.02	12	12	0
0005	3F	03	146	43	4	4300	3360	-940	0.09	0.78	7	5	-2
0005	3F	03	156	29	1	2900	670	-2230	0.03	0.23	5	1	-4
0005	3F	03	234	12	0	1200	0	-1200	0.00	0.00	2	0	-2
0005	3F	03	235	19	0	1900	0	-1900	0.00	0.00	3	0	-3
0005	3F	03	236	16	0	1600	0	-1600	0.00	0.00	2	0	-2
0005	3F	03	245	23	3	2300	1890	-410	0.13	0.82	4	3	-1
0005	3F	03	246	9	0	900	0	-900	0.00	0.00	1	0	-1
0005	3F	03	256	5	0	500	0	-500	0.00	0.00	0	0	0
0005	3F	04	123	358	62	35800	26140	-9660	0.17	0.73	63	46	-17
0005	3F	04	124	277	40	27700	20010	-7690	0.14	0.72	49	35	-14
0005	3F	04	125	189	22	18900	21640	2740	0.12	1.14	33	38	5
0005	3F	04	126	164	13	16400	12770	-3630	0.08	0.78	29	22	-7
0005	3F	04	134	175	31	17500	20240	2740	0.18	1.16	30	35	5
0005	3F	04	135	122	13	12200	9720	-2480	0.11	0.80	21	17	-4
0005	3F	04	136	107	13	10700	9570	-1130	0.12	0.89	18	16	-2
0005	3F	04	145	84	3	8400	3260	-5140	0.04	0.39	14	5	-9
0005	3F	04	146	66	6	6600	6820	220	0.09	1.03	11	12	1
0005	3F	04	156	41	3	4100	1250	-2850	0.07	0.30	7	2	-5
0005	3F	04	234	18	4	1800	4090	2290	0.22	2.27	3	7	4
0005	3F	04	235	16	1	1600	970	-630	0.06	0.61	2	1	-1
0005	3F	04	236	7	1	700	530	-170	0.14	0.76	1	0	-1
0005	3F	04	245	10	0	1000	0	-1000	0.00	0.00	1	0	-1
0005	3F	04	246	10	0	1000	0	-1000	0.00	0.00	1	0	-1
0005	3F	04	256	7	1	700	820	120	0.14	1.17	1	1	0
0005	3F	05	123	411	84	41100	34610	-6490	0.20	0.84	72	61	-11
0005	3F	05	124	290	52	29000	27450	-1550	0.18	0.95	51	48	-3
0005	3F	05	125	201	20	20100	12950	-7150	0.10	0.64	35	22	-13
0005	3F	05	126	198	24	19800	21230	1430	0.12	1.07	35	37	2
0005	3F	05	134	187	28	18700	20850	2150	0.15	1.11	33	36	3
0005	3F	05	135	124	11	12400	5100	-7300	0.09	0.41	21	9	-12
0005	3F	05	136	113	12	11300	12070	770	0.11	1.07	20	21	1
0005	3F	05	145	99	13	9900	8100	-1800	0.13	0.82	17	14	-3
0005	3F	05	146	61	5	6100	6390	290	0.08	1.05	10	11	1
0005	3F	05	156	42	5	4200	3900	-300	0.12	0.93	7	6	-1
0005	3F	05	234	32	3	3200	1610	-1590	0.09	0.50	5	2	-3
0005	3F	05	235	23	4	2300	1840	-460	0.17	0.80	4	3	-1
0005	3F	05	236	12	1	1200	140	-1060	0.08	0.12	2	0	-2
0005	3F	05	245	10	0	1000	0	-1000	0.00	0.00	1	0	-1
0005	3F	05	246	14	0	1400	0	-1400	0.00	0.00	2	0	-2
0005	3F	05	256	7	1	700	420	-280	0.14	0.60	1	0	-1
0005	3F	06	123	419	76	41900	30100	-11800	0.18	0.72	74	53	-21
0005	3F	06	124	331	54	33100	25230	-7870	0.16	0.76	58	44	-14
0005	3F	06	125	232	34	23200	23730	530	0.15	1.02	41	42	1
0005	3F	06	126	215	25	21500	19350	-2150	0.12	0.90	38	34	-4
0005	3F	06	134	232	31	23200	16520	-6680	0.13	0.71	41	29	-12
0005	3F	06	135	170	19	17000	11010	-5990	0.11	0.65	30	19	-11
0005	3F	06	136	133	15	13300	11420	-1880	0.11	0.86	23	20	-3
0005	3F	06	145	80	3	8000	1860	-6140	0.04	0.23	14	3	-11
0005	3F	06	146	76	10	7600	5630	-1970	0.13	0.74	13	9	-4
0005	3F	06	156	41	6	4100	4460	360	0.15	1.09	7	7	0
0005	3F	06	234	23	5	2300	3110	810	0.22	1.35	4	5	1
0005	3F	06	235	20	3	2000	1720	-280	0.15	0.86	3	3	0
0005	3F	06	236	11	0	1100	0	-1100	0.00	0.00	1	0	-1
0005	3F	06	245	8	1	800	490	-310	0.13	0.61	1	0	-1
0005	3F	06	246	5	0	500	0	-500	0.00	0.00	0	0	0
0005	3F	06	256	13	0	1300	0	-1300	0.00	0.00	2	0	-2
0005	3F	07	123	435	74	43500	32100	-11400	0.17	0.74	76	56	-20
0005	3F	07	124	348	57	34800	26910	-7890	0.16	0.77	61	47	-14
0005	3F	07	125	212	24	21200	17510	-3690	0.11	0.83	37	30	-7
0005	3F	07	126	202	28	20200	20000	-200	0.14	0.99	35	35	0
0005	3F	07	134	248	42	24800	16060	-8740	0.17	0.65	43	28	-15
0005	3F	07	135	152	20	15200	15410	210	0.13	1.01	26	27	1
0005	3F	07	136	118	13	11800	14390	2590	0.11	1.22	20	25	5
0005	3F	07	145	118	17	11800	11120	-680	0.14	0.94	20	19	-1
0005	3F	07	146	61	3	6100	1970	-4130	0.05	0.32	10	3	-7
0005	3F	07	156	46	9	4600	4750	150	0.20	1.03	8	8	0
0005	3F	07	234	20	1	2000	630	-1370	0.05	0.32	3	1	-2
0005	3F	07	235	18	3	1800	7160	5360	0.17	3.98	3	12	9
0005	3F	07	236	19	3	1900	2540	640	0.16	1.34	3	4	1
0005	3F	07	245	8	0	800	0	-800	0.00	0.00	1	0	-1
0005	3F	07	246	10	1	1000	2150	1150	0.10	2.15	1	3	2
0005	3F	07	256	9	1	900	2800	1900	0.11	3.11	1	4	3
0005	3F	08	123	431	83	43100	33340	-9760	0.19	0.77	76	59	-17
0005	3F	08	124	326	60	32600	23810	-8790	0.18	0.73	57	42	-15
0005	3F	08	125	240	24	24000	19130	-4870	0.10	0.80	42	33	-9
0005	3F	08	126	208	33	20800	17430	-3370	0.16	0.84	36	30	-6
0005	3F	08	134	256	46	25600	21780	-3820	0.18	0.85	45	38	-7
0005	3F	08	135	144	15	14400	9230	-5170	0.10	0.64	25	16	-9
0005	3F	08	136	116	19	11600	12620	1020	0.16	1.09	20	22	2
0005	3F	08	145	83	11	8300	5980	-2320	0.13	0.72	14	10	-4
0005	3F	08	146	68	8	6800	3900	-2900	0.12	0.57	12	6	-6
0005	3F	08	156	30	5	3000	3650	650	0.17	1.22	5	6	1
0005	3F	08	234	17	2	1700	1460	-240	0.12	0.86	3	2	-1
0005	3F	08	235	9	1	900	1700	800	0.11	1.89	1	3	2
0005	3F	08	236	5	0	500	0	-500	0.00	0.00	0	0	0
0005	3F	08	245	10	1	1000	1200	200	0.10	1.20	1	2	1
0005	3F	08	246	14	2	1400	1830	430	0.14	1.31	2	3	1
0005	3F	08	256	4	0	400	0	-400	0.00	0.00	0	0	0
0005	3F	09	123	496	109	49600	38570	-11030	0.22	0.78	87	68	-19
0005	3F	09	124	396	76	39600	33580	-6020	0.19	0.85	70	59	-11
0005	3F	09	125	206	23	20600	11170	-9430	0.11	0.54	36	19	-17
0005	3F	09	126	183	18	18300	13720	-4580	0.10	0.75	32	24	-8
0005	3F	09	134	230	33	23000	15510	-7490	0.14	0.67	40	27	-13
0005	3F	09	135	167	27	16700	15260	-1440	0.16	0.91	29	27	-2
0005	3F	09	136	123	16	12300	8020	-4280	0.13	0.65	21	14	-7
0005	3F	09	145	99	6	9900	7700	-2200	0.06	0.78	17	13	-4
0005	3F	09	146	67	6	6700	8330	1630	0.09	1.24	11	14	3
0005	3F	09	156	35	3	3500	5960	2460	0.09	1.70	6	10	4
0005	3F	09	234	20	7	2000	3860	1860	0.35	1.93	3	6	3
0005	3F	09	235	17	2	1700	2380	680	0.12	1.40	3	4	1
0005	3F	09	236	8	0	800	0	-800	0.00	0.00	1	0	-1
0005	3F	09	245	13	2	1300	1290	-10	0.15	0.99	2	2	0
0005	3F	09	246	12	2	1200	820	-380	0.17	0.68	2	1	-1
0005	3F	09	256	7	1	700	1740	1040	0.14	2.49	1	3	2
0005	3F	10	123	511	129	51100	41010	-10090	0.25	0.80	90	72	-18
0005	3F	10	124	411	76	41100	32450	-8650	0.18	0.79	72	57	-15
0005	3F	10	125	224	33	22400	16750	-5650	0.15	0.75	39	29	-10
0005	3F	10	126	129	10	12900	9650	-3250	0.08	0.75	22	17	-5
0005	3F	10	134	217	36	21700	16820	-4880	0.17	0.78	38	29	-9
0005	3F	10	135	128	16	12800	6770	-6030	0.13	0.53	22	11	-11
0005	3F	10	136	87	12	8700	10360	1660	0.14	1.19	15	18	3
0005	3F	10	145	78	10	7800	8940	1140	0.13	1.15	13	15	2
0005	3F	10	146	56	4	5600	2330	-3270	0.07	0.42	9	4	-5
0005	3F	10	156	21	4	2100	11430	9330	0.19	5.44	3	20	17
0005	3F	10	234	15	3	1500	2450	950	0.20	1.63	2	4	2
0005	3F	10	235	11	2	1100	1890	790	0.18	1.72	1	3	2
0005	3F	10	236	11	1	1100	350	-750	0.09	0.32	1	0	-1
0005	3F	10	245	7	2	700	720	20	0.29	1.03	1	1	0
0005	3F	10	246	12	1	1200	190	-1010	0.08	0.16	2	0	-2
0005	3F	10	256	8	0	800	0	-800	0.00	0.00	1	0	-1
0005	3F	11	123	466	92	46600	41940	-4660	0.20	0.90	82	74	-8
0005	3F	11	124	385	58	38500	34530	-3970	0.15	0.90	68	61	-7
0005	3F	11	125	166	13	16600	9370	-7230	0.08	0.56	29	16	-13
0005	3F	11	126	172	13	17200	12850	-4350	0.08	0.75	30	22	-8
0005	3F	11	134	202	27	20200	11900	-8300	0.13	0.59	35	21	-14
0005	3F	11	135	91	6	9100	8910	-190	0.07	0.98	16	15	-1
0005	3F	11	136	59	4	5900	8780	2880	0.07	1.49	10	15	5
0005	3F	11	145	69	2	6900	1230	-5670	0.03	0.18	12	2	-10
0005	3F	11	146	77	3	7700	2860	-4840	0.04	0.37	13	5	-8
0005	3F	11	156	32	1	3200	1700	-1500	0.03	0.53	5	3	-2
0005	3F	11	234	35	1	3500	1960	-1540	0.03	0.56	6	3	-3
0005	3F	11	235	9	0	900	0	-900	0.00	0.00	1	0	-1
0005	3F	11	236	14	1	1400	820	-580	0.07	0.59	2	1	-1
0005	3F	11	245	16	1	1600	570	-1030	0.06	0.36	2	1	-1
0005	3F	11	246	10	1	1000	1090	90	0.10	1.09	1	1	0
0005	3F	11	256	11	0	1100	0	-1100	0.00	0.00	1	0	-1
0005	3F	12	123	446	86	44600	40330	-4270	0.19	0.90	78	71	-7
0005	3F	12	124	343	48	34300	19830	-14470	0.14	0.58	60	35	-25
0005	3F	12	125	201	19	20100	11280	-8820	0.09	0.56	35	19	-16
0005	3F	12	126	146	17	14600	11880	-2720	0.12	0.81	25	21	-4
0005	3F	12	134	242	30	24200	19380	-4820	0.12	0.80	42	34	-8
0005	3F	12	135	119	15	11900	10010	-1890	0.13	0.84	21	17	-4
0005	3F	12	136	96	11	9600	10330	730	0.11	1.08	16	18	2
0005	3F	12	145	93	6	9300	3760	-5540	0.06	0.40	16	6	-10
0005	3F	12	146	48	6	4800	5040	240	0.13	1.05	8	8	0
0005	3F	12	156	33	3	3300	2730	-570	0.09	0.83	5	4	-1
0005	3F	12	234	30	4	3000	1570	-1430	0.13	0.52	5	2	-3
0005	3F	12	235	20	4	2000	6670	4670	0.20	3.34	3	11	8
0005	3F	12	236	12	0	1200	0	-1200	0.00	0.00	2	0	-2
0005	3F	12	245	8	0	800	0	-800	0.00	0.00	1	0	-1
0005	3F	12	246	8	0	800	0	-800	0.00	0.00	1	0	-1
0005	3F	12	256	4	0	400	0	-400	0.00	0.00	0	0	0
0005	3F	13	123	410	71	41000	40850	-150	0.17	1.00	72	72	0
0005	3F	13	124	376	68	37600	35830	-1770	0.18	0.95	66	63	-3
0005	3F	13	125	232	30	23200	19890	-3310	0.13	0.86	41	35	-6
0005	3F	13	126	156	14	15600	9400	-6200	0.09	0.60	27	16	-11
0005	3F	13	134	269	37	26900	19300	-7600	0.14	0.72	47	34	-13
0005	3F	13	135	118	17	11800	14000	2200	0.14	1.19	20	24	4
0005	3F	13	136	77	11	7700	5000	-2700	0.14	0.65	13	8	-5
0005	3F	13	145	103	11	10300	7740	-2560	0.11	0.75	18	13	-5
0005	3F	13	146	67	4	6700	2090	-4610	0.06	0.31	11	3	-8
0005	3F	13	156	34	0	3400	0	-3400	0.00	0.00	6	0	-6
0005	3F	13	234	26	5	2600	5190	2590	0.19	2.00	4	9	5
0005	3F	13	235	15	1	1500	3680	2180	0.07	2.45	2	6	4
0005	3F	13	236	13	1	1300	460	-840	0.08	0.35	2	0	-2
0005	3F	13	245	15	0	1500	0	-1500	0.00	0.00	2	0	-2
0005	3F	13	246	8	0	800	0	-800	0.00	0.00	1	0	-1
0005	3F	13	256	7	0	700	0	-700	0.00	0.00	1	0	-1
0005	3F	14	123	394	65	39400	30600	-8800	0.16	0.78	69	54	-15
0005	3F	14	124	304	56	30400	24640	-5760	0.18	0.81	53	43	-10
0005	3F	14	125	191	25	19100	15320	-3780	0.13	0.80	33	27	-6
0005	3F	14	126	126	13	12600	8250	-4350	0.10	0.65	22	14	-8
0005	3F	14	134	244	32	24400	17110	-7290	0.13	0.70	43	30	-13
0005	3F	14	135	113	14	11300	14190	2890	0.12	1.26	20	25	5
0005	3F	14	136	82	9	8200	7460	-740	0.11	0.91	14	13	-1
0005	3F	14	145	103	10	10300	12310	2010	0.10	1.20	18	21	3
0005	3F	14	146	71	5	7100	4920	-2180	0.07	0.69	12	8	-4
0005	3F	14	156	38	1	3800	360	-3440	0.03	0.09	6	0	-6
0005	3F	14	234	21	2	2100	1400	-700	0.10	0.67	3	2	-1
0005	3F	14	235	15	0	1500	0	-1500	0.00	0.00	2	0	-2
0005	3F	14	236	14	2	1400	630	-770	0.14	0.45	2	1	-1
0005	3F	14	245	18	1	1800	920	-880	0.06	0.51	3	1	-2
0005	3F	14	246	7	0	700	0	-700	0.00	0.00	1	0	-1
0005	3F	14	256	4	0	400	0	-400	0.00	0.00	0	0	0
0005	3F	15	123	467	94	46700	39190	-7510	0.20	0.84	82	69	-13
0005	3F	15	124	469	93	46900	37940	-8960	0.20	0.81	83	67	-16
0005	3F	15	125	230	35	23000	24510	1510	0.15	1.07	40	43	3
0005	3F	15	126	200	22	20000	19620	-380	0.11	0.98	35	34	-1
0005	3F	15	134	286	46	28600	23170	-5430	0.16	0.81	50	41	-9
0005	3F	15	135	119	10	11900	9450	-2450	0.08	0.79	21	16	-5
0005	3F	15	136	100	10	10000	8210	-1790	0.10	0.82	17	14	-3
0005	3F	15	145	113	9	11300	8070	-3230	0.08	0.71	20	14	-6
0005	3F	15	146	70	11	7000	18590	11590	0.16	2.66	12	32	20
0005	3F	15	156	45	4	4500	7660	3160	0.09	1.70	7	13	6
0005	3F	15	234	17	1	1700	450	-1250	0.06	0.26	3	0	-3
0005	3F	15	235	20	1	2000	330	-1670	0.05	0.17	3	0	-3
0005	3F	15	236	15	3	1500	2850	1350	0.20	1.90	2	5	3
0005	3F	15	245	11	0	1100	0	-1100	0.00	0.00	1	0	-1
0005	3F	15	246	10	1	1000	440	-560	0.10	0.44	1	0	-1
0005	3F	15	256	4	1	400	1410	1010	0.25	3.53	0	2	2
0005	3F	16	123	520	107	52000	33220	-18780	0.21	0.64	92	58	-34
0005	3F	16	124	460	75	46000	35370	-10630	0.16	0.77	81	62	-19
0005	3F	16	125	227	31	22700	22160	-540	0.14	0.98	40	39	-1
0005	3F	16	126	191	22	19100	13090	-6010	0.12	0.69	33	23	-10
0005	3F	16	134	278	38	27800	19310	-8490	0.14	0.69	49	34	-15
0005	3F	16	135	117	16	11700	8910	-2790	0.14	0.76	20	15	-5
0005	3F	16	136	116	14	11600	16060	4460	0.12	1.38	20	28	8
0005	3F	16	145	112	16	11200	13740	2540	0.14	1.23	19	24	5
0005	3F	16	146	71	4	7100	3070	-4030	0.06	0.43	12	5	-7
0005	3F	16	156	32	5	3200	8370	5170	0.16	2.62	5	14	9
0005	3F	16	234	19	2	1900	470	-1430	0.11	0.25	3	0	-3
0005	3F	16	235	14	0	1400	0	-1400	0.00	0.00	2	0	-2
0005	3F	16	236	9	0	900	0	-900	0.00	0.00	1	0	-1
0005	3F	16	245	8	1	800	1180	380	0.13	1.48	1	2	1
0005	3F	16	246	8	1	800	660	-140	0.13	0.83	1	1	0
0005	3F	16	256	1	0	100	0	-100	0.00	0.00	0	0	0
0005	3F	17	123	554	137	55400	50570	-4830	0.25	0.91	98	89	-9
0005	3F	17	124	413	68	41300	29140	-12160	0.16	0.71	73	51	-22
0005	3F	17	125	240	24	24000	16390	-7610	0.10	0.68	42	29	-13
0005	3F	17	126	184	12	18400	13510	-4890	0.07	0.73	32	23	-9
0005	3F	17	134	266	41	26600	20700	-5900	0.15	0.78	47	36	-11
0005	3F	17	135	117	11	11700	11290	-410	0.09	0.96	20	19	-1
0005	3F	17	136	103	9	10300	7710	-2590	0.09	0.75	18	13	-5
0005	3F	17	145	90	7	9000	5440	-3560	0.08	0.60	15	9	-6
0005	3F	17	146	58	7	5800	5030	-770	0.12	0.87	10	8	-2
0005	3F	17	156	24	3	2400	1900	-500	0.13	0.79	4	3	-1
0005	3F	17	234	24	2	2400	1100	-1300	0.08	0.46	4	1	-3
0005	3F	17	235	8	0	800	0	-800	0.00	0.00	1	0	-1
0005	3F	17	236	9	0	900	0	-900	0.00	0.00	1	0	-1
0005	3F	17	245	3	0	300	0	-300	0.00	0.00	0	0	0
0005	3F	17	246	13	0	1300	0	-1300	0.00	0.00	2	0	-2
0005	3F	17	256	5	0	500	0	-500	0.00	0.00	0	0	0
0005	3F	18	123	521	113	52100	45440	-6660	0.22	0.87	92	80	-12
0005	3F	18	124	433	97	43300	39800	-3500	0.22	0.92	76	70	-6
0005	3F	18	125	275	48	27500	22850	-4650	0.17	0.83	48	40	-8
0005	3F	18	126	182	23	18200	19190	990	0.13	1.05	32	33	1
0005	3F	18	134	284	50	28400	27580	-820	0.18	0.97	50	48	-2
0005	3F	18	135	218	28	21800	15840	-5960	0.13	0.73	38	28	-10
0005	3F	18	136	121	6	12100	2500	-9600	0.05	0.21	21	4	-17
0005	3F	18	145	125	14	12500	7570	-4930	0.11	0.61	22	13	-9
0005	3F	18	146	67	10	6700	8540	1840	0.15	1.27	11	15	4
0005	3F	18	156	26	1	2600	2150	-450	0.04	0.83	4	3	-1
0005	3F	18	234	15	2	1500	750	-750	0.13	0.50	2	1	-1
0005	3F	18	235	10	2	1000	930	-70	0.20	0.93	1	1	0
0005	3F	18	236	12	1	1200	1070	-130	0.08	0.89	2	1	-1
0005	3F	18	245	10	0	1000	0	-1000	0.00	0.00	1	0	-1
0005	3F	18	246	12	3	1200	2640	1440	0.25	2.20	2	4	2
0005	3F	18	256	5	1	500	790	290	0.20	1.58	0	1	1
0005	3F	19	123	492	106	49200	46610	-2590	0.22	0.95	87	82	-5
0005	3F	19	124	405	83	40500	33980	-6520	0.20	0.84	71	60	-11
0005	3F	19	125	171	25	17100	15920	-1180	0.15	0.93	30	28	-2
0005	3F	19	126	140	16	14000	14520	520	0.11	1.04	24	25	1
0005	3F	19	134	247	56	24700	25800	1100	0.23	1.04	43	45	2
0005	3F	19	135	120	14	12000	6330	-5670	0.12	0.53	21	11	-10
0005	3F	19	136	123	20	12300	11020	-1280	0.16	0.90	21	19	-2
0005	3F	19	145	62	9	6200	4600	-1600	0.15	0.74	10	8	-2
0005	3F	19	146	67	5	6700	3630	-3070	0.07	0.54	11	6	-5
0005	3F	19	156	19	1	1900	510	-1390	0.05	0.27	3	0	-3
0005	3F	19	234	15	2	1500	960	-540	0.13	0.64	2	1	-1
0005	3F	19	235	6	0	600	0	-600	0.00	0.00	1	0	-1
0005	3F	19	236	22	1	2200	380	-1820	0.05	0.17	3	0	-3
0005	3F	19	245	3	0	300	0	-300	0.00	0.00	0	0	0
0005	3F	19	246	5	0	500	0	-500	0.00	0.00	0	0	0
0005	3F	19	256	5	0	500	0	-500	0.00	0.00	0	0	0
0005	3F	20	123	486	121	48600	46050	-2550	0.25	0.95	86	81	-5
0005	3F	20	124	412	90	41200	30190	-11010	0.22	0.73	72	53	-19
0005	3F	20	125	224	20	22400	14790	-7610	0.09	0.66	39	26	-13
0005	3F	20	126	161	18	16100	19180	3080	0.11	1.19	28	33	5
0005	3F	20	134	258	38	25800	19260	-6540	0.15	0.75	45	34	-11
0005	3F	20	135	126	22	12600	12150	-450	0.17	0.96	22	21	-1
0005	3F	20	136	117	21	11700	15850	4150	0.18	1.35	20	28	8
0005	3F	20	145	85	10	8500	6720	-1780	0.12	0.79	15	11	-4
0005	3F	20	146	71	8	7100	3910	-3190	0.11	0.55	12	6	-6
0005	3F	20	156	30	5	3000	3490	490	0.17	1.16	5	6	1
0005	3F	20	234	12	1	1200	500	-700	0.08	0.42	2	0	-2
0005	3F	20	235	4	0	400	0	-400	0.00	0.00	0	0	0
0005	3F	20	236	10	0	1000	0	-1000	0.00	0.00	1	0	-1
0005	3F	20	245	4	0	400	0	-400	0.00	0.00	0	0	0
0005	3F	20	246	6	1	600	2190	1590	0.17	3.65	1	3	2
0005	3F	20	256	3	0	300	0	-300	0.00	0.00	0	0	0
0005	3F	21	123	533	127	53300	44420	-8880	0.24	0.83	94	78	-16
0005	3F	21	124	429	63	42900	21830	-21070	0.15	0.51	75	38	-37
0005	3F	21	125	260	43	26000	20440	-5560	0.17	0.79	46	36	-10
0005	3F	21	126	154	19	15400	16390	990	0.12	1.06	27	29	2
0005	3F	21	134	290	58	29000	23590	-5410	0.20	0.81	51	41	-10
0005	3F	21	135	179	38	17900	19580	1680	0.21	1.09	31	34	3
0005	3F	21	136	104	10	10400	23460	13060	0.10	2.26	18	41	23
0005	3F	21	145	98	12	9800	6000	-3800	0.12	0.61	17	10	-7
0005	3F	21	146	48	7	4800	4540	-260	0.15	0.95	8	8	0
0005	3F	21	156	18	0	1800	0	-1800	0.00	0.00	3	0	-3
0005	3F	21	234	11	1	1100	380	-720	0.09	0.35	1	0	-1
0005	3F	21	235	3	0	300	0	-300	0.00	0.00	0	0	0
0005	3F	21	236	4	1	400	670	270	0.25	1.68	0	1	1
0005	3F	21	245	5	0	500	0	-500	0.00	0.00	0	0	0
0005	3F	21	246	1	0	100	0	-100	0.00	0.00	0	0	0
0005	3F	21	256	2	1	200	640	440	0.50	3.20	0	1	1
0005	3F	22	123	442	94	44200	39550	-4650	0.21	0.89	78	70	-8
0005	3F	22	124	394	80	39400	43980	4580	0.20	1.12	69	77	8
0005	3F	22	125	177	19	17700	11540	-6160	0.11	0.65	31	20	-11
0005	3F	22	126	133	7	13300	12090	-1210	0.05	0.91	23	21	-2
0005	3F	22	134	240	31	24000	17890	-6110	0.13	0.75	42	31	-11
0005	3F	22	135	123	7	12300	5530	-6770	0.06	0.45	21	9	-12
0005	3F	22	136	64	1	6400	2020	-4380	0.02	0.32	11	3	-8
0005	3F	22	145	61	3	6100	3350	-2750	0.05	0.55	10	5	-5
0005	3F	22	146	39	1	3900	1930	-1970	0.03	0.49	6	3	-3
0005	3F	22	156	26	3	2600	3050	450	0.12	1.17	4	5	1
0005	3F	22	234	25	1	2500	650	-1850	0.04	0.26	4	1	-3
0005	3F	22	235	16	0	1600	0	-1600	0.00	0.00	2	0	-2
0005	3F	22	236	16	0	1600	0	-1600	0.00	0.00	2	0	-2
0005	3F	22	245	11	0	1100	0	-1100	0.00	0.00	1	0	-1
0005	3F	22	246	6	0	600	0	-600	0.00	0.00	1	0	-1
0005	3F	22	256	5	0	500	0	-500	0.00	0.00	0	0	0
0005	3F	23	123	490	106	49000	40410	-8590	0.22	0.82	86	71	-15
0005	3F	23	124	366	53	36600	24070	-12530	0.14	0.66	64	42	-22
0005	3F	23	125	217	25	21700	18420	-3280	0.12	0.85	38	32	-6
0005	3F	23	126	138	11	13800	13280	-520	0.08	0.96	24	23	-1
0005	3F	23	134	233	31	23300	17310	-5990	0.13	0.74	41	30	-11
0005	3F	23	135	158	21	15800	19900	4100	0.13	1.26	27	35	8
0005	3F	23	136	87	8	8700	8040	-660	0.09	0.92	15	14	-1
0005	3F	23	145	87	9	8700	6730	-1970	0.10	0.77	15	11	-4
0005	3F	23	146	39	2	3900	1350	-2550	0.05	0.35	6	2	-4
0005	3F	23	156	27	1	2700	2560	-140	0.04	0.95	4	4	0
0005	3F	23	234	26	2	2600	1550	-1050	0.08	0.60	4	2	-2
0005	3F	23	235	12	0	1200	0	-1200	0.00	0.00	2	0	-2
0005	3F	23	236	7	0	700	0	-700	0.00	0.00	1	0	-1
0005	3F	23	245	10	1	1000	480	-520	0.10	0.48	1	0	-1
0005	3F	23	246	9	1	900	600	-300	0.11	0.67	1	1	0
0005	3F	23	256	6	0	600	0	-600	0.00	0.00	1	0	-1
0005	3F	24	123	562	133	56200	47760	-8440	0.24	0.85	99	84	-15
0005	3F	24	124	449	77	44900	37620	-7280	0.17	0.84	79	66	-13
0005	3F	24	125	247	33	24700	17060	-7640	0.13	0.69	43	30	-13
0005	3F	24	126	133	15	13300	5530	-7770	0.11	0.42	23	9	-14
0005	3F	24	134	305	52	30500	24350	-6150	0.17	0.80	53	43	-10
0005	3F	24	135	147	14	14700	10400	-4300	0.10	0.71	26	18	-8
0005	3F	24	136	98	10	9800	6670	-3130	0.10	0.68	17	11	-6
0005	3F	24	145	85	5	8500	7670	-830	0.06	0.90	15	13	-2
0005	3F	24	146	62	4	6200	6750	550	0.06	1.09	10	11	1
0005	3F	24	156	26	2	2600	1630	-970	0.08	0.63	4	2	-2
0005	3F	24	234	14	2	1400	860	-540	0.14	0.61	2	1	-1
0005	3F	24	235	13	1	1300	640	-660	0.08	0.49	2	1	-1
0005	3F	24	236	5	1	500	3390	2890	0.20	6.78	0	6	6
0005	3F	24	245	9	0	900	0	-900	0.00	0.00	1	0	-1
0005	3F	24	246	3	2	300	8650	8350	0.67	28.83	0	15	15
0005	3F	24	256	2	0	200	0	-200	0.00	0.00	0	0	0
0005	3T	01	123	302	27	30200	28830	-1370	0.09	0.95	53	51	-2
0005	3T	01	124	227	9	22700	17160	-5540	0.04	0.76	40	30	-10
0005	3T	01	125	166	4	16600	5080	-11520	0.02	0.31	29	8	-21
0005	3T	01	126	103	6	10300	18880	8580	0.06	1.83	18	33	15
0005	3T	01	132	127	6	12700	9090	-3610	0.05	0.72	22	16	-6
0005	3T	01	134	141	8	14100	13040	-1060	0.06	0.92	24	23	-1
0005	3T	01	135	85	5	8500	6600	-1900	0.06	0.78	15	11	-4
0005	3T	01	136	72	3	7200	11320	4120	0.04	1.57	12	20	8
0005	3T	01	142	96	2	9600	3910	-5690	0.02	0.41	16	6	-10
0005	3T	01	143	79	2	7900	2510	-5390	0.03	0.32	13	4	-9
0005	3T	01	145	64	3	6400	7320	920	0.05	1.14	11	12	1
0005	3T	01	146	50	0	5000	0	-5000	0.00	0.00	8	0	-8
0005	3T	01	152	45	2	4500	2370	-2130	0.04	0.53	7	4	-3
0005	3T	01	153	42	1	4200	1130	-3070	0.02	0.27	7	2	-5
0005	3T	01	154	34	0	3400	0	-3400	0.00	0.00	6	0	-6
0005	3T	01	156	30	0	3000	0	-3000	0.00	0.00	5	0	-5
0005	3T	01	162	8	0	800	0	-800	0.00	0.00	1	0	-1
0005	3T	01	163	11	0	1100	0	-1100	0.00	0.00	1	0	-1
0005	3T	01	164	6	0	600	0	-600	0.00	0.00	1	0	-1
0005	3T	01	165	6	0	600	0	-600	0.00	0.00	1	0	-1
0005	3T	01	213	30	1	3000	1380	-1620	0.03	0.46	5	2	-3
0005	3T	01	214	28	0	2800	0	-2800	0.00	0.00	4	0	-4
0005	3T	01	215	21	1	2100	9400	7300	0.05	4.48	3	16	13
0005	3T	01	216	18	0	1800	0	-1800	0.00	0.00	3	0	-3
0005	3T	01	231	8	0	800	0	-800	0.00	0.00	1	0	-1
0005	3T	01	234	15	0	1500	0	-1500	0.00	0.00	2	0	-2
0005	3T	01	235	13	1	1300	1220	-80	0.08	0.94	2	2	0
0005	3T	01	236	2	0	200	0	-200	0.00	0.00	0	0	0
0005	3T	01	241	7	0	700	0	-700	0.00	0.00	1	0	-1
0005	3T	01	243	13	0	1300	0	-1300	0.00	0.00	2	0	-2
0005	3T	01	245	5	0	500	0	-500	0.00	0.00	0	0	0
0005	3T	01	246	2	0	200	0	-200	0.00	0.00	0	0	0
0005	3T	01	251	6	0	600	0	-600	0.00	0.00	1	0	-1
0005	3T	01	253	4	0	400	0	-400	0.00	0.00	0	0	0
0005	3T	01	254	7	0	700	0	-700	0.00	0.00	1	0	-1
0005	3T	01	256	1	0	100	0	-100	0.00	0.00	0	0	0
0005	3T	01	263	3	0	300	0	-300	0.00	0.00	0	0	0
0005	3T	01	264	1	0	100	0	-100	0.00	0.00	0	0	0
0005	3T	01	265	3	0	300	0	-300	0.00	0.00	0	0	0
0005	3T	02	123	239	13	23900	15070	-8830	0.05	0.63	42	26	-16
0005	3T	02	124	228	7	22800	13640	-9160	0.03	0.60	40	24	-16
0005	3T	02	125	166	10	16600	30700	14100	0.06	1.85	29	54	25
0005	3T	02	126	149	2	14900	4630	-10270	0.01	0.31	26	8	-18
0005	3T	02	132	129	4	12900	5100	-7800	0.03	0.40	22	9	-13
0005	3T	02	134	148	7	14800	12890	-1910	0.05	0.87	26	22	-4
0005	3T	02	135	105	3	10500	5600	-4900	0.03	0.53	18	9	-9
0005	3T	02	136	93	3	9300	4420	-4880	0.03	0.48	16	7	-9
0005	3T	02	142	80	2	8000	2180	-5820	0.03	0.27	14	3	-11
0005	3T	02	143	71	2	7100	4780	-2320	0.03	0.67	12	8	-4
0005	3T	02	145	69	0	6900	0	-6900	0.00	0.00	12	0	-12
0005	3T	02	146	46	1	4600	1470	-3130	0.02	0.32	8	2	-6
0005	3T	02	152	45	1	4500	1060	-3440	0.02	0.24	7	1	-6
0005	3T	02	153	46	2	4600	3700	-900	0.04	0.80	8	6	-2
0005	3T	02	154	36	2	3600	3910	310	0.06	1.09	6	6	0
0005	3T	02	156	30	0	3000	0	-3000	0.00	0.00	5	0	-5
0005	3T	02	162	13	0	1300	0	-1300	0.00	0.00	2	0	-2
0005	3T	02	163	22	0	2200	0	-2200	0.00	0.00	3	0	-3
0005	3T	02	164	10	0	1000	0	-1000	0.00	0.00	1	0	-1
0005	3T	02	165	14	0	1400	0	-1400	0.00	0.00	2	0	-2
0005	3T	02	213	25	1	2500	3470	970	0.04	1.39	4	6	2
0005	3T	02	214	27	0	2700	0	-2700	0.00	0.00	4	0	-4
0005	3T	02	215	22	3	2200	8680	6480	0.14	3.95	3	15	12
0005	3T	02	216	16	0	1600	0	-1600	0.00	0.00	2	0	-2
0005	3T	02	231	11	0	1100	0	-1100	0.00	0.00	1	0	-1
0005	3T	02	234	15	1	1500	1220	-280	0.07	0.81	2	2	0
0005	3T	02	235	10	0	1000	0	-1000	0.00	0.00	1	0	-1
0005	3T	02	236	6	0	600	0	-600	0.00	0.00	1	0	-1
0005	3T	02	241	6	0	600	0	-600	0.00	0.00	1	0	-1
0005	3T	02	243	5	0	500	0	-500	0.00	0.00	0	0	0
0005	3T	02	245	9	0	900	0	-900	0.00	0.00	1	0	-1
0005	3T	02	246	5	0	500	0	-500	0.00	0.00	0	0	0
0005	3T	02	251	2	0	200	0	-200	0.00	0.00	0	0	0
0005	3T	02	253	11	0	1100	0	-1100	0.00	0.00	1	0	-1
0005	3T	02	254	6	0	600	0	-600	0.00	0.00	1	0	-1
0005	3T	02	256	5	0	500	0	-500	0.00	0.00	0	0	0
0005	3T	02	261	3	0	300	0	-300	0.00	0.00	0	0	0
0005	3T	02	263	5	0	500	0	-500	0.00	0.00	0	0	0
0005	3T	02	264	5	0	500	0	-500	0.00	0.00	0	0	0
0005	3T	02	265	2	0	200	0	-200	0.00	0.00	0	0	0
0005	3T	03	123	175	11	17500	14150	-3350	0.06	0.81	30	25	-5
0005	3T	03	124	137	8	13700	7920	-5780	0.06	0.58	24	14	-10
0005	3T	03	125	129	7	12900	7120	-5780	0.05	0.55	22	12	-10
0005	3T	03	126	86	6	8600	20510	11910	0.07	2.38	15	36	21
0005	3T	03	132	116	8	11600	23260	11660	0.07	2.01	20	41	21
0005	3T	03	134	88	2	8800	2290	-6510	0.02	0.26	15	4	-11
0005	3T	03	135	76	7	7600	11630	4030	0.09	1.53	13	20	7
0005	3T	03	136	59	0	5900	0	-5900	0.00	0.00	10	0	-10
0005	3T	03	142	77	2	7700	7790	90	0.03	1.01	13	13	0
0005	3T	03	143	61	5	6100	24410	18310	0.08	4.00	10	43	33
0005	3T	03	145	41	1	4100	3610	-490	0.02	0.88	7	6	-1
0005	3T	03	146	31	0	3100	0	-3100	0.00	0.00	5	0	-5
0005	3T	03	152	35	2	3500	7540	4040	0.06	2.15	6	13	7
0005	3T	03	153	31	2	3100	25440	22340	0.06	8.21	5	45	40
0005	3T	03	154	29	0	2900	0	-2900	0.00	0.00	5	0	-5
0005	3T	03	156	20	1	2000	1500	-500	0.05	0.75	3	2	-1
0005	3T	03	162	22	0	2200	0	-2200	0.00	0.00	3	0	-3
0005	3T	03	163	12	1	1200	2280	1080	0.08	1.90	2	4	2
0005	3T	03	164	12	0	1200	0	-1200	0.00	0.00	2	0	-2
0005	3T	03	165	9	0	900	0	-900	0.00	0.00	1	0	-1
0005	3T	03	213	22	2	2200	3310	1110	0.09	1.50	3	5	2
0005	3T	03	214	15	0	1500	0	-1500	0.00	0.00	2	0	-2
0005	3T	03	215	19	0	1900	0	-1900	0.00	0.00	3	0	-3
0005	3T	03	216	22	0	2200	0	-2200	0.00	0.00	3	0	-3
0005	3T	03	231	11	0	1100	0	-1100	0.00	0.00	1	0	-1
0005	3T	03	234	7	0	700	0	-700	0.00	0.00	1	0	-1
0005	3T	03	235	13	0	1300	0	-1300	0.00	0.00	2	0	-2
0005	3T	03	236	13	0	1300	0	-1300	0.00	0.00	2	0	-2
0005	3T	03	241	4	0	400	0	-400	0.00	0.00	0	0	0
0005	3T	03	243	5	0	500	0	-500	0.00	0.00	0	0	0
0005	3T	03	245	12	0	1200	0	-1200	0.00	0.00	2	0	-2
0005	3T	03	246	6	0	600	0	-600	0.00	0.00	1	0	-1
0005	3T	03	251	3	0	300	0	-300	0.00	0.00	0	0	0
0005	3T	03	253	6	0	600	0	-600	0.00	0.00	1	0	-1
0005	3T	03	254	11	0	1100	0	-1100	0.00	0.00	1	0	-1
0005	3T	03	256	3	0	300	0	-300	0.00	0.00	0	0	0
0005	3T	03	261	2	0	200	0	-200	0.00	0.00	0	0	0
0005	3T	03	263	3	0	300	0	-300	0.00	0.00	0	0	0
0005	3T	03	264	3	0	300	0	-300	0.00	0.00	0	0	0
0005	3T	03	265	2	0	200	0	-200	0.00	0.00	0	0	0
0005	3T	04	123	211	13	21100	12210	-8890	0.06	0.58	37	21	-16
0005	3T	04	124	180	10	18000	13840	-4160	0.06	0.77	31	24	-7
0005	3T	04	125	135	8	13500	22460	8960	0.06	1.66	23	39	16
0005	3T	04	126	108	4	10800	17570	6770	0.04	1.63	19	31	12
0005	3T	04	132	114	10	11400	13150	1750	0.09	1.15	20	23	3
0005	3T	04	134	109	7	10900	8840	-2060	0.06	0.81	19	15	-4
0005	3T	04	135	89	7	8900	12210	3310	0.08	1.37	15	21	6
0005	3T	04	136	85	4	8500	7800	-700	0.05	0.92	15	13	-2
0005	3T	04	142	67	3	6700	3700	-3000	0.04	0.55	11	6	-5
0005	3T	04	143	66	5	6600	7810	1210	0.08	1.18	11	13	2
0005	3T	04	145	53	1	5300	1380	-3920	0.02	0.26	9	2	-7
0005	3T	04	146	52	1	5200	1270	-3930	0.02	0.24	9	2	-7
0005	3T	04	152	39	2	3900	4950	1050	0.05	1.27	6	8	2
0005	3T	04	153	33	0	3300	0	-3300	0.00	0.00	5	0	-5
0005	3T	04	154	31	2	3100	10370	7270	0.06	3.35	5	18	13
0005	3T	04	156	29	0	2900	0	-2900	0.00	0.00	5	0	-5
0005	3T	04	162	31	0	3100	0	-3100	0.00	0.00	5	0	-5
0005	3T	04	163	22	1	2200	11580	9380	0.05	5.26	3	20	17
0005	3T	04	164	14	1	1400	3560	2160	0.07	2.54	2	6	4
0005	3T	04	165	12	0	1200	0	-1200	0.00	0.00	2	0	-2
0005	3T	04	213	26	3	2600	4690	2090	0.12	1.80	4	8	4
0005	3T	04	214	21	1	2100	1250	-850	0.05	0.60	3	2	-1
0005	3T	04	215	13	0	1300	0	-1300	0.00	0.00	2	0	-2
0005	3T	04	216	21	0	2100	0	-2100	0.00	0.00	3	0	-3
0005	3T	04	231	7	2	700	18640	17940	0.29	26.63	1	32	31
0005	3T	04	234	12	1	1200	1790	590	0.08	1.49	2	3	1
0005	3T	04	235	11	1	1100	5770	4670	0.09	5.25	1	10	9
0005	3T	04	236	6	0	600	0	-600	0.00	0.00	1	0	-1
0005	3T	04	241	9	0	900	0	-900	0.00	0.00	1	0	-1
0005	3T	04	243	6	0	600	0	-600	0.00	0.00	1	0	-1
0005	3T	04	245	6	0	600	0	-600	0.00	0.00	1	0	-1
0005	3T	04	246	6	0	600	0	-600	0.00	0.00	1	0	-1
0005	3T	04	251	2	0	200	0	-200	0.00	0.00	0	0	0
0005	3T	04	253	5	0	500	0	-500	0.00	0.00	0	0	0
0005	3T	04	254	4	0	400	0	-400	0.00	0.00	0	0	0
0005	3T	04	256	6	0	600	0	-600	0.00	0.00	1	0	-1
0005	3T	04	261	4	0	400	0	-400	0.00	0.00	0	0	0
0005	3T	04	263	1	0	100	0	-100	0.00	0.00	0	0	0
0005	3T	04	264	4	0	400	0	-400	0.00	0.00	0	0	0
0005	3T	04	265	1	0	100	0	-100	0.00	0.00	0	0	0
0005	3T	05	123	238	21	23800	26730	2930	0.09	1.12	42	47	5
0005	3T	05	124	180	9	18000	9050	-8950	0.05	0.50	31	16	-15
0005	3T	05	125	140	4	14000	4130	-9870	0.03	0.30	24	7	-17
0005	3T	05	126	147	8	14700	10060	-4640	0.05	0.68	26	17	-9
0005	3T	05	132	143	13	14300	14590	290	0.09	1.02	25	25	0
0005	3T	05	134	116	7	11600	9920	-1680	0.06	0.86	20	17	-3
0005	3T	05	135	88	2	8800	3240	-5560	0.02	0.37	15	5	-10
0005	3T	05	136	94	5	9400	9250	-150	0.05	0.98	16	16	0
0005	3T	05	142	83	11	8300	29090	20790	0.13	3.50	14	51	37
0005	3T	05	143	71	2	7100	6180	-920	0.03	0.87	12	10	-2
0005	3T	05	145	71	3	7100	2950	-4150	0.04	0.42	12	5	-7
0005	3T	05	146	54	4	5400	6600	1200	0.07	1.22	9	11	2
0005	3T	05	152	39	1	3900	3240	-660	0.03	0.83	6	5	-1
0005	3T	05	153	36	0	3600	0	-3600	0.00	0.00	6	0	-6
0005	3T	05	154	28	1	2800	2410	-390	0.04	0.86	4	4	0
0005	3T	05	156	32	2	3200	5890	2690	0.06	1.84	5	10	5
0005	3T	05	162	24	2	2400	2710	310	0.08	1.13	4	4	0
0005	3T	05	163	19	1	1900	2590	690	0.05	1.36	3	4	1
0005	3T	05	164	7	0	700	0	-700	0.00	0.00	1	0	-1
0005	3T	05	165	10	1	1000	4010	3010	0.10	4.01	1	7	6
0005	3T	05	213	19	1	1900	750	-1150	0.05	0.39	3	1	-2
0005	3T	05	214	22	2	2200	4280	2080	0.09	1.95	3	7	4
0005	3T	05	215	18	0	1800	0	-1800	0.00	0.00	3	0	-3
0005	3T	05	216	24	0	2400	0	-2400	0.00	0.00	4	0	-4
0005	3T	05	231	11	0	1100	0	-1100	0.00	0.00	1	0	-1
0005	3T	05	234	19	1	1900	1520	-380	0.05	0.80	3	2	-1
0005	3T	05	235	17	1	1700	1610	-90	0.06	0.95	3	2	-1
0005	3T	05	236	11	0	1100	0	-1100	0.00	0.00	1	0	-1
0005	3T	05	241	5	0	500	0	-500	0.00	0.00	0	0	0
0005	3T	05	243	13	0	1300	0	-1300	0.00	0.00	2	0	-2
0005	3T	05	245	8	0	800	0	-800	0.00	0.00	1	0	-1
0005	3T	05	246	9	0	900	0	-900	0.00	0.00	1	0	-1
0005	3T	05	251	4	0	400	0	-400	0.00	0.00	0	0	0
0005	3T	05	253	6	0	600	0	-600	0.00	0.00	1	0	-1
0005	3T	05	254	2	0	200	0	-200	0.00	0.00	0	0	0
0005	3T	05	256	4	1	400	1170	770	0.25	2.93	0	2	2
0005	3T	05	261	3	0	300	0	-300	0.00	0.00	0	0	0
0005	3T	05	263	1	0	100	0	-100	0.00	0.00	0	0	0
0005	3T	05	264	5	0	500	0	-500	0.00	0.00	0	0	0
0005	3T	05	265	3	0	300	0	-300	0.00	0.00	0	0	0
0005	3T	06	123	247	22	24700	21750	-2950	0.09	0.88	43	38	-5
0005	3T	06	124	232	14	23200	15730	-7470	0.06	0.68	41	27	-14
0005	3T	06	125	158	5	15800	7820	-7980	0.03	0.49	27	13	-14
0005	3T	06	126	168	11	16800	20800	4000	0.07	1.24	29	36	7
0005	3T	06	132	141	7	14100	6430	-7670	0.05	0.46	24	11	-13
0005	3T	06	134	150	7	15000	16790	1790	0.05	1.12	26	29	3
0005	3T	06	135	124	2	12400	2090	-10310	0.02	0.17	21	3	-18
0005	3T	06	136	102	2	10200	9310	-890	0.02	0.91	18	16	-2
0005	3T	06	142	76	5	7600	11220	3620	0.07	1.48	13	19	6
0005	3T	06	143	82	6	8200	7630	-570	0.07	0.93	14	13	-1
0005	3T	06	145	52	1	5200	2430	-2770	0.02	0.47	9	4	-5
0005	3T	06	146	52	3	5200	3600	-1600	0.06	0.69	9	6	-3
0005	3T	06	152	47	0	4700	0	-4700	0.00	0.00	8	0	-8
0005	3T	06	153	46	2	4600	8910	4310	0.04	1.94	8	15	7
0005	3T	06	154	28	0	2800	0	-2800	0.00	0.00	4	0	-4
0005	3T	06	156	32	1	3200	2070	-1130	0.03	0.65	5	3	-2
0005	3T	06	162	27	0	2700	0	-2700	0.00	0.00	4	0	-4
0005	3T	06	163	31	2	3100	6680	3580	0.06	2.15	5	11	6
0005	3T	06	164	24	0	2400	0	-2400	0.00	0.00	4	0	-4
0005	3T	06	165	9	0	900	0	-900	0.00	0.00	1	0	-1
0005	3T	06	213	26	0	2600	0	-2600	0.00	0.00	4	0	-4
0005	3T	06	214	19	1	1900	1220	-680	0.05	0.64	3	2	-1
0005	3T	06	215	23	3	2300	4160	1860	0.13	1.81	4	7	3
0005	3T	06	216	17	0	1700	0	-1700	0.00	0.00	3	0	-3
0005	3T	06	231	5	0	500	0	-500	0.00	0.00	0	0	0
0005	3T	06	234	15	0	1500	0	-1500	0.00	0.00	2	0	-2
0005	3T	06	235	16	0	1600	0	-1600	0.00	0.00	2	0	-2
0005	3T	06	236	8	0	800	0	-800	0.00	0.00	1	0	-1
0005	3T	06	241	4	0	400	0	-400	0.00	0.00	0	0	0
0005	3T	06	243	8	2	800	3490	2690	0.25	4.36	1	6	5
0005	3T	06	245	3	0	300	0	-300	0.00	0.00	0	0	0
0005	3T	06	246	4	0	400	0	-400	0.00	0.00	0	0	0
0005	3T	06	251	4	0	400	0	-400	0.00	0.00	0	0	0
0005	3T	06	253	4	0	400	0	-400	0.00	0.00	0	0	0
0005	3T	06	254	5	0	500	0	-500	0.00	0.00	0	0	0
0005	3T	06	256	10	0	1000	0	-1000	0.00	0.00	1	0	-1
0005	3T	06	261	3	0	300	0	-300	0.00	0.00	0	0	0
0005	3T	06	263	3	0	300	0	-300	0.00	0.00	0	0	0
0005	3T	06	264	1	0	100	0	-100	0.00	0.00	0	0	0
0005	3T	06	265	3	0	300	0	-300	0.00	0.00	0	0	0
0005	3T	07	123	254	13	25400	12330	-13070	0.05	0.49	44	21	-23
0005	3T	07	124	245	18	24500	18930	-5570	0.07	0.77	43	33	-10
0005	3T	07	125	157	7	15700	8920	-6780	0.04	0.57	27	15	-12
0005	3T	07	126	155	6	15500	10280	-5220	0.04	0.66	27	18	-9
0005	3T	07	132	153	8	15300	11760	-3540	0.05	0.77	27	20	-7
0005	3T	07	134	158	14	15800	13110	-2690	0.09	0.83	27	23	-4
0005	3T	07	135	118	6	11800	8490	-3310	0.05	0.72	20	15	-5
0005	3T	07	136	93	3	9300	4560	-4740	0.03	0.49	16	8	-8
0005	3T	07	142	84	6	8400	9660	1260	0.07	1.15	14	17	3
0005	3T	07	143	90	2	9000	2620	-6380	0.02	0.29	15	4	-11
0005	3T	07	145	78	3	7800	1990	-5810	0.04	0.26	13	3	-10
0005	3T	07	146	51	1	5100	1860	-3240	0.02	0.36	9	3	-6
0005	3T	07	152	44	0	4400	0	-4400	0.00	0.00	7	0	-7
0005	3T	07	153	34	0	3400	0	-3400	0.00	0.00	6	0	-6
0005	3T	07	154	40	1	4000	4020	20	0.03	1.01	7	7	0
0005	3T	07	156	35	0	3500	0	-3500	0.00	0.00	6	0	-6
0005	3T	07	162	24	1	2400	1950	-450	0.04	0.81	4	3	-1
0005	3T	07	163	25	2	2500	1970	-530	0.08	0.79	4	3	-1
0005	3T	07	164	10	0	1000	0	-1000	0.00	0.00	1	0	-1
0005	3T	07	165	11	0	1100	0	-1100	0.00	0.00	1	0	-1
0005	3T	07	213	21	2	2100	2250	150	0.10	1.07	3	3	0
0005	3T	07	214	18	1	1800	1330	-470	0.06	0.74	3	2	-1
0005	3T	07	215	10	1	1000	3380	2380	0.10	3.38	1	5	4
0005	3T	07	216	16	0	1600	0	-1600	0.00	0.00	2	0	-2
0005	3T	07	231	7	0	700	0	-700	0.00	0.00	1	0	-1
0005	3T	07	234	12	0	1200	0	-1200	0.00	0.00	2	0	-2
0005	3T	07	235	12	1	1200	7880	6680	0.08	6.57	2	13	11
0005	3T	07	236	5	0	500	0	-500	0.00	0.00	0	0	0
0005	3T	07	241	1	0	100	0	-100	0.00	0.00	0	0	0
0005	3T	07	243	8	0	800	0	-800	0.00	0.00	1	0	-1
0005	3T	07	245	3	0	300	0	-300	0.00	0.00	0	0	0
0005	3T	07	246	6	0	600	0	-600	0.00	0.00	1	0	-1
0005	3T	07	251	1	0	100	0	-100	0.00	0.00	0	0	0
0005	3T	07	253	6	0	600	0	-600	0.00	0.00	1	0	-1
0005	3T	07	254	5	0	500	0	-500	0.00	0.00	0	0	0
0005	3T	07	256	6	0	600	0	-600	0.00	0.00	1	0	-1
0005	3T	07	261	7	1	700	1410	710	0.14	2.01	1	2	1
0005	3T	07	263	14	1	1400	680	-720	0.07	0.49	2	1	-1
0005	3T	07	264	4	1	400	15650	15250	0.25	39.13	0	27	27
0005	3T	07	265	3	1	300	8860	8560	0.33	29.53	0	15	15
0005	3T	08	123	269	27	26900	23320	-3580	0.10	0.87	47	41	-6
0005	3T	08	124	237	20	23700	17590	-6110	0.08	0.74	41	31	-10
0005	3T	08	125	185	6	18500	9980	-8520	0.03	0.54	32	17	-15
0005	3T	08	126	157	10	15700	16040	340	0.06	1.02	27	28	1
0005	3T	08	132	139	9	13900	11790	-2110	0.06	0.85	24	20	-4
0005	3T	08	134	164	14	16400	17180	780	0.09	1.05	29	30	1
0005	3T	08	135	109	5	10900	5450	-5450	0.05	0.50	19	9	-10
0005	3T	08	136	90	5	9000	5110	-3890	0.06	0.57	15	9	-6
0005	3T	08	142	77	4	7700	4470	-3230	0.05	0.58	13	7	-6
0005	3T	08	143	92	7	9200	9850	650	0.08	1.07	16	17	1
0005	3T	08	145	57	3	5700	4140	-1560	0.05	0.73	10	7	-3
0005	3T	08	146	52	3	5200	2850	-2350	0.06	0.55	9	5	-4
0005	3T	08	152	43	3	4300	15950	11650	0.07	3.71	7	28	21
0005	3T	08	153	35	0	3500	0	-3500	0.00	0.00	6	0	-6
0005	3T	08	154	26	3	2600	7690	5090	0.12	2.96	4	13	9
0005	3T	08	156	15	1	1500	930	-570	0.07	0.62	2	1	-1
0005	3T	08	162	28	2	2800	6390	3590	0.07	2.28	4	11	7
0005	3T	08	163	26	1	2600	1360	-1240	0.04	0.52	4	2	-2
0005	3T	08	164	16	1	1600	3440	1840	0.06	2.15	2	6	4
0005	3T	08	165	15	0	1500	0	-1500	0.00	0.00	2	0	-2
0005	3T	08	213	19	3	1900	5100	3200	0.16	2.68	3	9	6
0005	3T	08	214	12	1	1200	590	-610	0.08	0.49	2	1	-1
0005	3T	08	215	9	0	900	0	-900	0.00	0.00	1	0	-1
0005	3T	08	216	17	1	1700	2600	900	0.06	1.53	3	4	1
0005	3T	08	231	4	1	400	1760	1360	0.25	4.40	0	3	3
0005	3T	08	234	9	0	900	0	-900	0.00	0.00	1	0	-1
0005	3T	08	235	4	0	400	0	-400	0.00	0.00	0	0	0
0005	3T	08	236	4	0	400	0	-400	0.00	0.00	0	0	0
0005	3T	08	243	8	2	800	4160	3360	0.25	5.20	1	7	6
0005	3T	08	245	2	0	200	0	-200	0.00	0.00	0	0	0
0005	3T	08	246	11	0	1100	0	-1100	0.00	0.00	1	0	-1
0005	3T	08	251	3	0	300	0	-300	0.00	0.00	0	0	0
0005	3T	08	253	5	0	500	0	-500	0.00	0.00	0	0	0
0005	3T	08	254	8	1	800	5630	4830	0.13	7.04	1	9	8
0005	3T	08	256	1	0	100	0	-100	0.00	0.00	0	0	0
0005	3T	08	261	6	0	600	0	-600	0.00	0.00	1	0	-1
0005	3T	08	263	1	0	100	0	-100	0.00	0.00	0	0	0
0005	3T	08	264	3	0	300	0	-300	0.00	0.00	0	0	0
0005	3T	08	265	3	0	300	0	-300	0.00	0.00	0	0	0
0005	3T	09	123	313	37	31300	26360	-4940	0.12	0.84	55	46	-9
0005	3T	09	124	284	30	28400	25290	-3110	0.11	0.89	50	44	-6
0005	3T	09	125	155	3	15500	2970	-12530	0.02	0.19	27	5	-22
0005	3T	09	126	156	3	15600	9540	-6060	0.02	0.61	27	16	-11
0005	3T	09	132	135	12	13500	14280	780	0.09	1.06	23	25	2
0005	3T	09	134	147	10	14700	8580	-6120	0.07	0.58	26	15	-11
0005	3T	09	135	128	12	12800	17870	5070	0.09	1.40	22	31	9
0005	3T	09	136	99	5	9900	6490	-3410	0.05	0.66	17	11	-6
0005	3T	09	142	81	5	8100	8470	370	0.06	1.05	14	14	0
0005	3T	09	143	83	2	8300	2750	-5550	0.02	0.33	14	4	-10
0005	3T	09	145	68	1	6800	2290	-4510	0.01	0.34	12	4	-8
0005	3T	09	146	55	3	5500	14290	8790	0.05	2.60	9	25	16
0005	3T	09	152	37	3	3700	2160	-1540	0.08	0.58	6	3	-3
0005	3T	09	153	39	1	3900	3140	-760	0.03	0.81	6	5	-1
0005	3T	09	154	31	2	3100	3520	420	0.06	1.14	5	6	1
0005	3T	09	156	31	0	3100	0	-3100	0.00	0.00	5	0	-5
0005	3T	09	162	15	1	1500	3410	1910	0.07	2.27	2	6	4
0005	3T	09	163	24	2	2400	3230	830	0.08	1.35	4	5	1
0005	3T	09	164	12	0	1200	0	-1200	0.00	0.00	2	0	-2
0005	3T	09	165	4	1	400	6720	6320	0.25	16.80	0	11	11
0005	3T	09	213	37	2	3700	3870	170	0.05	1.05	6	6	0
0005	3T	09	214	27	1	2700	1200	-1500	0.04	0.44	4	2	-2
0005	3T	09	215	13	0	1300	0	-1300	0.00	0.00	2	0	-2
0005	3T	09	216	10	1	1000	2160	1160	0.10	2.16	1	3	2
0005	3T	09	231	11	0	1100	0	-1100	0.00	0.00	1	0	-1
0005	3T	09	234	15	3	1500	8220	6720	0.20	5.48	2	14	12
0005	3T	09	235	12	0	1200	0	-1200	0.00	0.00	2	0	-2
0005	3T	09	236	5	0	500	0	-500	0.00	0.00	0	0	0
0005	3T	09	241	4	0	400	0	-400	0.00	0.00	0	0	0
0005	3T	09	243	5	0	500	0	-500	0.00	0.00	0	0	0
0005	3T	09	245	6	0	600	0	-600	0.00	0.00	1	0	-1
0005	3T	09	246	9	1	900	1270	370	0.11	1.41	1	2	1
0005	3T	09	251	1	0	100	0	-100	0.00	0.00	0	0	0
0005	3T	09	253	5	0	500	0	-500	0.00	0.00	0	0	0
0005	3T	09	254	7	0	700	0	-700	0.00	0.00	1	0	-1
0005	3T	09	256	5	0	500	0	-500	0.00	0.00	0	0	0
0005	3T	09	261	2	0	200	0	-200	0.00	0.00	0	0	0
0005	3T	09	263	3	0	300	0	-300	0.00	0.00	0	0	0
0005	3T	09	264	3	0	300	0	-300	0.00	0.00	0	0	0
0005	3T	09	265	2	0	200	0	-200	0.00	0.00	0	0	0
0005	3T	10	123	313	40	31300	26080	-5220	0.13	0.83	55	46	-9
0005	3T	10	124	294	19	29400	25020	-4380	0.06	0.85	52	44	-8
0005	3T	10	125	168	9	16800	9650	-7150	0.05	0.57	29	17	-12
0005	3T	10	126	96	5	9600	9620	20	0.05	1.00	16	17	1
0005	3T	10	132	168	12	16800	14060	-2740	0.07	0.84	29	24	-5
0005	3T	10	134	152	10	15200	9020	-6180	0.07	0.59	26	15	-11
0005	3T	10	135	106	4	10600	2960	-7640	0.04	0.28	18	5	-13
0005	3T	10	136	66	2	6600	2980	-3620	0.03	0.45	11	5	-6
0005	3T	10	142	93	7	9300	9110	-190	0.08	0.98	16	16	0
0005	3T	10	143	65	3	6500	5130	-1370	0.05	0.79	11	9	-2
0005	3T	10	145	61	5	6100	15520	9420	0.08	2.54	10	27	17
0005	3T	10	146	42	3	4200	4540	340	0.07	1.08	7	8	1
0005	3T	10	152	37	2	3700	2950	-750	0.05	0.80	6	5	-1
0005	3T	10	153	22	2	2200	2720	520	0.09	1.24	3	4	1
0005	3T	10	154	17	0	1700	0	-1700	0.00	0.00	3	0	-3
0005	3T	10	156	12	2	1200	17920	16720	0.17	14.93	2	31	29
0005	3T	10	162	13	0	1300	0	-1300	0.00	0.00	2	0	-2
0005	3T	10	163	21	1	2100	3610	1510	0.05	1.72	3	6	3
0005	3T	10	164	14	0	1400	0	-1400	0.00	0.00	2	0	-2
0005	3T	10	165	9	0	900	0	-900	0.00	0.00	1	0	-1
0005	3T	10	213	21	1	2100	810	-1290	0.05	0.39	3	1	-2
0005	3T	10	214	20	2	2000	3830	1830	0.10	1.92	3	6	3
0005	3T	10	215	18	2	1800	5670	3870	0.11	3.15	3	10	7
0005	3T	10	216	15	0	1500	0	-1500	0.00	0.00	2	0	-2
0005	3T	10	231	9	1	900	2320	1420	0.11	2.58	1	4	3
0005	3T	10	234	6	0	600	0	-600	0.00	0.00	1	0	-1
0005	3T	10	235	8	1	800	630	-170	0.13	0.79	1	1	0
0005	3T	10	236	5	0	500	0	-500	0.00	0.00	0	0	0
0005	3T	10	241	4	2	400	4430	4030	0.50	11.08	0	7	7
0005	3T	10	243	9	0	900	0	-900	0.00	0.00	1	0	-1
0005	3T	10	245	4	0	400	0	-400	0.00	0.00	0	0	0
0005	3T	10	246	6	0	600	0	-600	0.00	0.00	1	0	-1
0005	3T	10	251	1	0	100	0	-100	0.00	0.00	0	0	0
0005	3T	10	253	3	0	300	0	-300	0.00	0.00	0	0	0
0005	3T	10	254	3	0	300	0	-300	0.00	0.00	0	0	0
0005	3T	10	256	7	0	700	0	-700	0.00	0.00	1	0	-1
0005	3T	10	261	5	0	500	0	-500	0.00	0.00	0	0	0
0005	3T	10	263	6	0	600	0	-600	0.00	0.00	1	0	-1
0005	3T	10	264	6	1	600	1050	450	0.17	1.75	1	1	0
0005	3T	10	265	1	0	100	0	-100	0.00	0.00	0	0	0
0005	3T	11	123	318	29	31800	36350	4550	0.09	1.14	56	64	8
0005	3T	11	124	246	11	24600	17540	-7060	0.04	0.71	43	31	-12
0005	3T	11	125	108	3	10800	2690	-8110	0.03	0.25	19	4	-15
0005	3T	11	126	134	4	13400	10660	-2740	0.03	0.80	23	18	-5
0005	3T	11	132	104	4	10400	5770	-4630	0.04	0.55	18	10	-8
0005	3T	11	134	106	5	10600	5340	-5260	0.05	0.50	18	9	-9
0005	3T	11	135	58	2	5800	17230	11430	0.03	2.97	10	30	20
0005	3T	11	136	48	3	4800	18500	13700	0.06	3.85	8	32	24
0005	3T	11	142	88	4	8800	8410	-390	0.05	0.96	15	14	-1
0005	3T	11	143	96	4	9600	7190	-2410	0.04	0.75	16	12	-4
0005	3T	11	145	40	0	4000	0	-4000	0.00	0.00	7	0	-7
0005	3T	11	146	64	0	6400	0	-6400	0.00	0.00	11	0	-11
0005	3T	11	152	26	0	2600	0	-2600	0.00	0.00	4	0	-4
0005	3T	11	153	33	1	3300	3870	570	0.03	1.17	5	6	1
0005	3T	11	154	29	0	2900	0	-2900	0.00	0.00	5	0	-5
0005	3T	11	156	25	0	2500	0	-2500	0.00	0.00	4	0	-4
0005	3T	11	162	7	0	700	0	-700	0.00	0.00	1	0	-1
0005	3T	11	163	11	1	1100	6360	5260	0.09	5.78	1	11	10
0005	3T	11	164	13	0	1300	0	-1300	0.00	0.00	2	0	-2
0005	3T	11	165	7	0	700	0	-700	0.00	0.00	1	0	-1
0005	3T	11	213	41	2	4100	2690	-1410	0.05	0.66	7	4	-3
0005	3T	11	214	48	2	4800	4260	-540	0.04	0.89	8	7	-1
0005	3T	11	215	26	0	2600	0	-2600	0.00	0.00	4	0	-4
0005	3T	11	216	29	2	2900	9470	6570	0.07	3.27	5	16	11
0005	3T	11	231	3	0	300	0	-300	0.00	0.00	0	0	0
0005	3T	11	234	16	0	1600	0	-1600	0.00	0.00	2	0	-2
0005	3T	11	235	5	0	500	0	-500	0.00	0.00	0	0	0
0005	3T	11	236	11	1	1100	1860	760	0.09	1.69	1	3	2
0005	3T	11	241	3	0	300	0	-300	0.00	0.00	0	0	0
0005	3T	11	243	19	0	1900	0	-1900	0.00	0.00	3	0	-3
0005	3T	11	245	11	0	1100	0	-1100	0.00	0.00	1	0	-1
0005	3T	11	246	7	0	700	0	-700	0.00	0.00	1	0	-1
0005	3T	11	251	6	0	600	0	-600	0.00	0.00	1	0	-1
0005	3T	11	253	4	0	400	0	-400	0.00	0.00	0	0	0
0005	3T	11	254	5	0	500	0	-500	0.00	0.00	0	0	0
0005	3T	11	256	7	0	700	0	-700	0.00	0.00	1	0	-1
0005	3T	11	261	2	0	200	0	-200	0.00	0.00	0	0	0
0005	3T	11	263	3	0	300	0	-300	0.00	0.00	0	0	0
0005	3T	11	264	3	0	300	0	-300	0.00	0.00	0	0	0
0005	3T	11	265	4	0	400	0	-400	0.00	0.00	0	0	0
0005	3T	12	123	281	27	28100	33260	5160	0.10	1.18	49	58	9
0005	3T	12	124	243	10	24300	13130	-11170	0.04	0.54	43	23	-20
0005	3T	12	125	142	5	14200	5840	-8360	0.04	0.41	25	10	-15
0005	3T	12	126	118	8	11800	10270	-1530	0.07	0.87	20	18	-2
0005	3T	12	132	130	8	13000	14170	1170	0.06	1.09	23	25	2
0005	3T	12	134	168	10	16800	18890	2090	0.06	1.12	29	33	4
0005	3T	12	135	87	1	8700	850	-7850	0.01	0.10	15	1	-14
0005	3T	12	136	74	3	7400	3800	-3600	0.04	0.51	13	6	-7
0005	3T	12	142	77	7	7700	7740	40	0.09	1.01	13	13	0
0005	3T	12	143	74	4	7400	5320	-2080	0.05	0.72	13	9	-4
0005	3T	12	145	53	1	5300	850	-4450	0.02	0.16	9	1	-8
0005	3T	12	146	39	2	3900	1810	-2090	0.05	0.46	6	3	-3
0005	3T	12	152	35	2	3500	2680	-820	0.06	0.77	6	4	-2
0005	3T	12	153	32	1	3200	1320	-1880	0.03	0.41	5	2	-3
0005	3T	12	154	40	0	4000	0	-4000	0.00	0.00	7	0	-7
0005	3T	12	156	24	0	2400	0	-2400	0.00	0.00	4	0	-4
0005	3T	12	162	14	0	1400	0	-1400	0.00	0.00	2	0	-2
0005	3T	12	163	22	1	2200	690	-1510	0.05	0.31	3	1	-2
0005	3T	12	164	9	1	900	700	-200	0.11	0.78	1	1	0
0005	3T	12	165	9	0	900	0	-900	0.00	0.00	1	0	-1
0005	3T	12	213	24	0	2400	0	-2400	0.00	0.00	4	0	-4
0005	3T	12	214	16	0	1600	0	-1600	0.00	0.00	2	0	-2
0005	3T	12	215	20	0	2000	0	-2000	0.00	0.00	3	0	-3
0005	3T	12	216	14	0	1400	0	-1400	0.00	0.00	2	0	-2
0005	3T	12	231	11	0	1100	0	-1100	0.00	0.00	1	0	-1
0005	3T	12	234	22	1	2200	1020	-1180	0.05	0.46	3	1	-2
0005	3T	12	235	13	2	1300	6970	5670	0.15	5.36	2	12	10
0005	3T	12	236	8	0	800	0	-800	0.00	0.00	1	0	-1
0005	3T	12	241	7	1	700	6920	6220	0.14	9.89	1	12	11
0005	3T	12	243	8	0	800	0	-800	0.00	0.00	1	0	-1
0005	3T	12	245	7	0	700	0	-700	0.00	0.00	1	0	-1
0005	3T	12	246	6	0	600	0	-600	0.00	0.00	1	0	-1
0005	3T	12	251	4	0	400	0	-400	0.00	0.00	0	0	0
0005	3T	12	253	7	0	700	0	-700	0.00	0.00	1	0	-1
0005	3T	12	254	1	0	100	0	-100	0.00	0.00	0	0	0
0005	3T	12	256	3	0	300	0	-300	0.00	0.00	0	0	0
0005	3T	12	263	4	0	400	0	-400	0.00	0.00	0	0	0
0005	3T	12	264	2	0	200	0	-200	0.00	0.00	0	0	0
0005	3T	12	265	1	0	100	0	-100	0.00	0.00	0	0	0
0005	3T	13	123	236	19	23600	18230	-5370	0.08	0.77	41	32	-9
0005	3T	13	124	242	27	24200	33180	8980	0.11	1.37	42	58	16
0005	3T	13	125	174	9	17400	15580	-1820	0.05	0.90	30	27	-3
0005	3T	13	126	124	4	12400	5970	-6430	0.03	0.48	21	10	-11
0005	3T	13	132	154	10	15400	12000	-3400	0.06	0.78	27	21	-6
0005	3T	13	134	160	8	16000	8220	-7780	0.05	0.51	28	14	-14
0005	3T	13	135	93	4	9300	17270	7970	0.04	1.86	16	30	14
0005	3T	13	136	58	7	5800	6650	850	0.12	1.15	10	11	1
0005	3T	13	142	113	7	11300	12970	1670	0.06	1.15	20	22	2
0005	3T	13	143	109	6	10900	16790	5890	0.06	1.54	19	29	10
0005	3T	13	145	76	4	7600	10640	3040	0.05	1.40	13	18	5
0005	3T	13	146	50	2	5000	4070	-930	0.04	0.81	8	7	-1
0005	3T	13	152	37	2	3700	2640	-1060	0.05	0.71	6	4	-2
0005	3T	13	153	25	0	2500	0	-2500	0.00	0.00	4	0	-4
0005	3T	13	154	27	0	2700	0	-2700	0.00	0.00	4	0	-4
0005	3T	13	156	21	0	2100	0	-2100	0.00	0.00	3	0	-3
0005	3T	13	162	15	0	1500	0	-1500	0.00	0.00	2	0	-2
0005	3T	13	163	19	1	1900	1120	-780	0.05	0.59	3	1	-2
0005	3T	13	164	17	0	1700	0	-1700	0.00	0.00	3	0	-3
0005	3T	13	165	13	0	1300	0	-1300	0.00	0.00	2	0	-2
0005	3T	13	213	14	3	1400	19410	18010	0.21	13.86	2	34	32
0005	3T	13	214	17	1	1700	920	-780	0.06	0.54	3	1	-2
0005	3T	13	215	16	1	1600	3190	1590	0.06	1.99	2	5	3
0005	3T	13	216	16	0	1600	0	-1600	0.00	0.00	2	0	-2
0005	3T	13	231	6	0	600	0	-600	0.00	0.00	1	0	-1
0005	3T	13	234	18	1	1800	3840	2040	0.06	2.13	3	6	3
0005	3T	13	235	10	0	1000	0	-1000	0.00	0.00	1	0	-1
0005	3T	13	236	8	0	800	0	-800	0.00	0.00	1	0	-1
0005	3T	13	241	4	0	400	0	-400	0.00	0.00	0	0	0
0005	3T	13	243	8	0	800	0	-800	0.00	0.00	1	0	-1
0005	3T	13	245	11	0	1100	0	-1100	0.00	0.00	1	0	-1
0005	3T	13	246	7	0	700	0	-700	0.00	0.00	1	0	-1
0005	3T	13	251	5	0	500	0	-500	0.00	0.00	0	0	0
0005	3T	13	253	5	0	500	0	-500	0.00	0.00	0	0	0
0005	3T	13	254	4	0	400	0	-400	0.00	0.00	0	0	0
0005	3T	13	256	7	0	700	0	-700	0.00	0.00	1	0	-1
0005	3T	13	261	1	0	100	0	-100	0.00	0.00	0	0	0
0005	3T	13	263	5	1	500	1870	1370	0.20	3.74	0	3	3
0005	3T	13	264	1	0	100	0	-100	0.00	0.00	0	0	0
0005	3T	14	123	240	14	24000	12550	-11450	0.06	0.52	42	22	-20
0005	3T	14	124	183	14	18300	10440	-7860	0.08	0.57	32	18	-14
0005	3T	14	125	126	8	12600	11160	-1440	0.06	0.89	22	19	-3
0005	3T	14	126	90	2	9000	1760	-7240	0.02	0.20	15	3	-12
0005	3T	14	132	122	5	12200	10400	-1800	0.04	0.85	21	18	-3
0005	3T	14	134	149	7	14900	7210	-7690	0.05	0.48	26	12	-14
0005	3T	14	135	86	4	8600	11730	3130	0.05	1.36	15	20	5
0005	3T	14	136	70	2	7000	3820	-3180	0.03	0.55	12	6	-6
0005	3T	14	142	89	5	8900	6680	-2220	0.06	0.75	15	11	-4
0005	3T	14	143	95	5	9500	7360	-2140	0.05	0.77	16	13	-3
0005	3T	14	145	67	1	6700	6300	-400	0.01	0.94	11	11	0
0005	3T	14	146	59	3	5900	9690	3790	0.05	1.64	10	17	7
0005	3T	14	152	38	1	3800	910	-2890	0.03	0.24	6	1	-5
0005	3T	14	153	27	1	2700	3350	650	0.04	1.24	4	5	1
0005	3T	14	154	36	0	3600	0	-3600	0.00	0.00	6	0	-6
0005	3T	14	156	24	0	2400	0	-2400	0.00	0.00	4	0	-4
0005	3T	14	162	13	0	1300	0	-1300	0.00	0.00	2	0	-2
0005	3T	14	163	12	0	1200	0	-1200	0.00	0.00	2	0	-2
0005	3T	14	164	12	0	1200	0	-1200	0.00	0.00	2	0	-2
0005	3T	14	165	14	0	1400	0	-1400	0.00	0.00	2	0	-2
0005	3T	14	213	26	0	2600	0	-2600	0.00	0.00	4	0	-4
0005	3T	14	214	25	1	2500	1120	-1380	0.04	0.45	4	1	-3
0005	3T	14	215	22	0	2200	0	-2200	0.00	0.00	3	0	-3
0005	3T	14	216	19	0	1900	0	-1900	0.00	0.00	3	0	-3
0005	3T	14	231	6	0	600	0	-600	0.00	0.00	1	0	-1
0005	3T	14	234	15	1	1500	3410	1910	0.07	2.27	2	6	4
0005	3T	14	235	10	0	1000	0	-1000	0.00	0.00	1	0	-1
0005	3T	14	236	13	0	1300	0	-1300	0.00	0.00	2	0	-2
0005	3T	14	241	7	0	700	0	-700	0.00	0.00	1	0	-1
0005	3T	14	243	6	0	600	0	-600	0.00	0.00	1	0	-1
0005	3T	14	245	13	0	1300	0	-1300	0.00	0.00	2	0	-2
0005	3T	14	246	4	0	400	0	-400	0.00	0.00	0	0	0
0005	3T	14	251	5	0	500	0	-500	0.00	0.00	0	0	0
0005	3T	14	253	5	0	500	0	-500	0.00	0.00	0	0	0
0005	3T	14	254	5	0	500	0	-500	0.00	0.00	0	0	0
0005	3T	14	256	4	0	400	0	-400	0.00	0.00	0	0	0
0005	3T	14	261	4	0	400	0	-400	0.00	0.00	0	0	0
0005	3T	14	263	1	0	100	0	-100	0.00	0.00	0	0	0
0005	3T	14	264	3	0	300	0	-300	0.00	0.00	0	0	0
0005	3T	15	123	306	24	30600	20980	-9620	0.08	0.69	54	37	-17
0005	3T	15	124	320	26	32000	22040	-9960	0.08	0.69	56	39	-17
0005	3T	15	125	162	8	16200	9490	-6710	0.05	0.59	28	16	-12
0005	3T	15	126	153	10	15300	20340	5040	0.07	1.33	27	36	9
0005	3T	15	132	133	12	13300	12330	-970	0.09	0.93	23	21	-2
0005	3T	15	134	157	14	15700	22830	7130	0.09	1.45	27	40	13
0005	3T	15	135	85	4	8500	9630	1130	0.05	1.13	15	17	2
0005	3T	15	136	78	4	7800	4530	-3270	0.05	0.58	13	8	-5
0005	3T	15	142	126	9	12600	9080	-3520	0.07	0.72	22	16	-6
0005	3T	15	143	129	9	12900	9120	-3780	0.07	0.71	22	16	-6
0005	3T	15	145	71	2	7100	5590	-1510	0.03	0.79	12	9	-3
0005	3T	15	146	60	4	6000	16450	10450	0.07	2.74	10	29	19
0005	3T	15	152	46	1	4600	1400	-3200	0.02	0.30	8	2	-6
0005	3T	15	153	34	0	3400	0	-3400	0.00	0.00	6	0	-6
0005	3T	15	154	42	0	4200	0	-4200	0.00	0.00	7	0	-7
0005	3T	15	156	37	2	3700	5200	1500	0.05	1.41	6	9	3
0005	3T	15	162	21	1	2100	4190	2090	0.05	2.00	3	7	4
0005	3T	15	163	22	0	2200	0	-2200	0.00	0.00	3	0	-3
0005	3T	15	164	10	0	1000	0	-1000	0.00	0.00	1	0	-1
0005	3T	15	165	8	0	800	0	-800	0.00	0.00	1	0	-1
0005	3T	15	213	23	2	2300	4020	1720	0.09	1.75	4	7	3
0005	3T	15	214	20	2	2000	3320	1320	0.10	1.66	3	5	2
0005	3T	15	215	17	0	1700	0	-1700	0.00	0.00	3	0	-3
0005	3T	15	216	23	1	2300	1020	-1280	0.04	0.44	4	1	-3
0005	3T	15	231	5	0	500	0	-500	0.00	0.00	0	0	0
0005	3T	15	234	12	1	1200	2330	1130	0.08	1.94	2	4	2
0005	3T	15	235	12	0	1200	0	-1200	0.00	0.00	2	0	-2
0005	3T	15	236	9	0	900	0	-900	0.00	0.00	1	0	-1
0005	3T	15	241	3	0	300	0	-300	0.00	0.00	0	0	0
0005	3T	15	243	5	0	500	0	-500	0.00	0.00	0	0	0
0005	3T	15	245	10	0	1000	0	-1000	0.00	0.00	1	0	-1
0005	3T	15	246	7	1	700	1540	840	0.14	2.20	1	2	1
0005	3T	15	251	5	0	500	0	-500	0.00	0.00	0	0	0
0005	3T	15	253	8	0	800	0	-800	0.00	0.00	1	0	-1
0005	3T	15	254	1	0	100	0	-100	0.00	0.00	0	0	0
0005	3T	15	256	1	0	100	0	-100	0.00	0.00	0	0	0
0005	3T	15	261	3	0	300	0	-300	0.00	0.00	0	0	0
0005	3T	15	263	6	0	600	0	-600	0.00	0.00	1	0	-1
0005	3T	15	264	3	0	300	0	-300	0.00	0.00	0	0	0
0005	3T	15	265	3	0	300	0	-300	0.00	0.00	0	0	0
0005	3T	16	123	335	36	33500	21170	-12330	0.11	0.63	59	37	-22
0005	3T	16	124	330	22	33000	29340	-3660	0.07	0.89	58	51	-7
0005	3T	16	125	164	9	16400	10700	-5700	0.05	0.65	29	18	-11
0005	3T	16	126	156	8	15600	9490	-6110	0.05	0.61	27	16	-11
0005	3T	16	132	151	12	15100	11620	-3480	0.08	0.77	26	20	-6
0005	3T	16	134	175	10	17500	10400	-7100	0.06	0.59	30	18	-12
0005	3T	16	135	91	7	9100	7160	-1940	0.08	0.79	16	12	-4
0005	3T	16	136	100	2	10000	5160	-4840	0.02	0.52	17	9	-8
0005	3T	16	142	108	9	10800	8750	-2050	0.08	0.81	19	15	-4
0005	3T	16	143	103	3	10300	3860	-6440	0.03	0.37	18	6	-12
0005	3T	16	145	76	4	7600	2750	-4850	0.05	0.36	13	4	-9
0005	3T	16	146	55	2	5500	2310	-3190	0.04	0.42	9	4	-5
0005	3T	16	152	39	1	3900	2730	-1170	0.03	0.70	6	4	-2
0005	3T	16	153	26	0	2600	0	-2600	0.00	0.00	4	0	-4
0005	3T	16	154	36	1	3600	670	-2930	0.03	0.19	6	1	-5
0005	3T	16	156	20	1	2000	7190	5190	0.05	3.60	3	12	9
0005	3T	16	162	18	1	1800	2080	280	0.06	1.16	3	3	0
0005	3T	16	163	16	1	1600	9700	8100	0.06	6.06	2	17	15
0005	3T	16	164	16	0	1600	0	-1600	0.00	0.00	2	0	-2
0005	3T	16	165	12	0	1200	0	-1200	0.00	0.00	2	0	-2
0005	3T	16	213	25	1	2500	550	-1950	0.04	0.22	4	0	-4
0005	3T	16	214	20	0	2000	0	-2000	0.00	0.00	3	0	-3
0005	3T	16	215	21	1	2100	800	-1300	0.05	0.38	3	1	-2
0005	3T	16	216	13	0	1300	0	-1300	0.00	0.00	2	0	-2
0005	3T	16	231	9	0	900	0	-900	0.00	0.00	1	0	-1
0005	3T	16	234	12	0	1200	0	-1200	0.00	0.00	2	0	-2
0005	3T	16	235	10	0	1000	0	-1000	0.00	0.00	1	0	-1
0005	3T	16	236	7	0	700	0	-700	0.00	0.00	1	0	-1
0005	3T	16	241	2	0	200	0	-200	0.00	0.00	0	0	0
0005	3T	16	243	7	0	700	0	-700	0.00	0.00	1	0	-1
0005	3T	16	245	4	0	400	0	-400	0.00	0.00	0	0	0
0005	3T	16	246	5	0	500	0	-500	0.00	0.00	0	0	0
0005	3T	16	251	3	0	300	0	-300	0.00	0.00	0	0	0
0005	3T	16	253	4	0	400	0	-400	0.00	0.00	0	0	0
0005	3T	16	254	4	1	400	9050	8650	0.25	22.63	0	16	16
0005	3T	16	261	4	0	400	0	-400	0.00	0.00	0	0	0
0005	3T	16	263	2	0	200	0	-200	0.00	0.00	0	0	0
0005	3T	16	264	3	0	300	0	-300	0.00	0.00	0	0	0
0005	3T	16	265	1	0	100	0	-100	0.00	0.00	0	0	0
0005	3T	17	123	344	39	34400	35960	1560	0.11	1.05	60	63	3
0005	3T	17	124	271	23	27100	19010	-8090	0.08	0.70	47	33	-14
0005	3T	17	125	196	12	19600	16970	-2630	0.06	0.87	34	30	-4
0005	3T	17	126	154	5	15400	5420	-9980	0.03	0.35	27	9	-18
0005	3T	17	132	176	20	17600	19250	1650	0.11	1.09	31	34	3
0005	3T	17	134	170	12	17000	9390	-7610	0.07	0.55	30	16	-14
0005	3T	17	135	90	4	9000	5280	-3720	0.04	0.59	15	9	-6
0005	3T	17	136	82	5	8200	5900	-2300	0.06	0.72	14	10	-4
0005	3T	17	142	115	7	11500	9580	-1920	0.06	0.83	20	16	-4
0005	3T	17	143	96	1	9600	2790	-6810	0.01	0.29	16	4	-12
0005	3T	17	145	64	2	6400	2490	-3910	0.03	0.39	11	4	-7
0005	3T	17	146	51	1	5100	1570	-3530	0.02	0.31	9	2	-7
0005	3T	17	152	28	0	2800	0	-2800	0.00	0.00	4	0	-4
0005	3T	17	153	27	0	2700	0	-2700	0.00	0.00	4	0	-4
0005	3T	17	154	26	0	2600	0	-2600	0.00	0.00	4	0	-4
0005	3T	17	156	19	1	1900	890	-1010	0.05	0.47	3	1	-2
0005	3T	17	162	14	0	1400	0	-1400	0.00	0.00	2	0	-2
0005	3T	17	163	21	1	2100	630	-1470	0.05	0.30	3	1	-2
0005	3T	17	164	7	1	700	3240	2540	0.14	4.63	1	5	4
0005	3T	17	165	5	0	500	0	-500	0.00	0.00	0	0	0
0005	3T	17	213	27	2	2700	5190	2490	0.07	1.92	4	9	5
0005	3T	17	214	21	2	2100	2300	200	0.10	1.10	3	4	1
0005	3T	17	215	13	0	1300	0	-1300	0.00	0.00	2	0	-2
0005	3T	17	216	15	0	1500	0	-1500	0.00	0.00	2	0	-2
0005	3T	17	231	7	0	700	0	-700	0.00	0.00	1	0	-1
0005	3T	17	234	20	1	2000	830	-1170	0.05	0.42	3	1	-2
0005	3T	17	235	5	0	500	0	-500	0.00	0.00	0	0	0
0005	3T	17	236	5	0	500	0	-500	0.00	0.00	0	0	0
0005	3T	17	241	6	0	600	0	-600	0.00	0.00	1	0	-1
0005	3T	17	243	4	0	400	0	-400	0.00	0.00	0	0	0
0005	3T	17	245	3	0	300	0	-300	0.00	0.00	0	0	0
0005	3T	17	246	7	0	700	0	-700	0.00	0.00	1	0	-1
0005	3T	17	251	3	0	300	0	-300	0.00	0.00	0	0	0
0005	3T	17	253	3	0	300	0	-300	0.00	0.00	0	0	0
0005	3T	17	256	3	0	300	0	-300	0.00	0.00	0	0	0
0005	3T	17	261	1	0	100	0	-100	0.00	0.00	0	0	0
0005	3T	17	263	4	0	400	0	-400	0.00	0.00	0	0	0
0005	3T	17	264	6	0	600	0	-600	0.00	0.00	1	0	-1
0005	3T	17	265	2	0	200	0	-200	0.00	0.00	0	0	0
0005	3T	18	123	329	39	32900	32520	-380	0.12	0.99	58	57	-1
0005	3T	18	124	308	34	30800	27960	-2840	0.11	0.91	54	49	-5
0005	3T	18	125	211	17	21100	15350	-5750	0.08	0.73	37	27	-10
0005	3T	18	126	153	14	15300	20180	4880	0.09	1.32	27	35	8
0005	3T	18	132	167	13	16700	18030	1330	0.08	1.08	29	31	2
0005	3T	18	134	173	13	17300	12550	-4750	0.08	0.73	30	22	-8
0005	3T	18	135	173	12	17300	15910	-1390	0.07	0.92	30	28	-2
0005	3T	18	136	98	2	9800	1620	-8180	0.02	0.17	17	2	-15
0005	3T	18	142	101	7	10100	7100	-3000	0.07	0.70	17	12	-5
0005	3T	18	143	111	8	11100	16620	5520	0.07	1.50	19	29	10
0005	3T	18	145	87	2	8700	4560	-4140	0.02	0.52	15	8	-7
0005	3T	18	146	54	5	5400	9280	3880	0.09	1.72	9	16	7
0005	3T	18	152	43	2	4300	1930	-2370	0.05	0.45	7	3	-4
0005	3T	18	153	45	2	4500	2240	-2260	0.04	0.50	7	3	-4
0005	3T	18	154	38	1	3800	3430	-370	0.03	0.90	6	6	0
0005	3T	18	156	17	0	1700	0	-1700	0.00	0.00	3	0	-3
0005	3T	18	162	10	0	1000	0	-1000	0.00	0.00	1	0	-1
0005	3T	18	163	23	0	2300	0	-2300	0.00	0.00	4	0	-4
0005	3T	18	164	13	1	1300	2120	820	0.08	1.63	2	3	1
0005	3T	18	165	9	1	900	9210	8310	0.11	10.23	1	16	15
0005	3T	18	213	19	2	1900	3380	1480	0.11	1.78	3	5	2
0005	3T	18	214	20	1	2000	1950	-50	0.05	0.98	3	3	0
0005	3T	18	215	19	2	1900	5000	3100	0.11	2.63	3	8	5
0005	3T	18	216	16	1	1600	18580	16980	0.06	11.61	2	32	30
0005	3T	18	231	6	0	600	0	-600	0.00	0.00	1	0	-1
0005	3T	18	234	12	1	1200	1210	10	0.08	1.01	2	2	0
0005	3T	18	235	5	0	500	0	-500	0.00	0.00	0	0	0
0005	3T	18	236	8	1	800	4080	3280	0.13	5.10	1	7	6
0005	3T	18	241	4	0	400	0	-400	0.00	0.00	0	0	0
0005	3T	18	243	3	0	300	0	-300	0.00	0.00	0	0	0
0005	3T	18	245	6	0	600	0	-600	0.00	0.00	1	0	-1
0005	3T	18	246	7	1	700	7010	6310	0.14	10.01	1	12	11
0005	3T	18	251	2	0	200	0	-200	0.00	0.00	0	0	0
0005	3T	18	253	5	0	500	0	-500	0.00	0.00	0	0	0
0005	3T	18	254	4	0	400	0	-400	0.00	0.00	0	0	0
0005	3T	18	256	4	1	400	1130	730	0.25	2.83	0	2	2
0005	3T	18	261	3	0	300	0	-300	0.00	0.00	0	0	0
0005	3T	18	263	4	0	400	0	-400	0.00	0.00	0	0	0
0005	3T	18	264	5	0	500	0	-500	0.00	0.00	0	0	0
0005	3T	18	265	1	0	100	0	-100	0.00	0.00	0	0	0
0005	3T	19	123	319	26	31900	21610	-10290	0.08	0.68	56	38	-18
0005	3T	19	124	288	26	28800	26180	-2620	0.09	0.91	50	46	-4
0005	3T	19	125	127	10	12700	11050	-1650	0.08	0.87	22	19	-3
0005	3T	19	126	105	7	10500	15780	5280	0.07	1.50	18	27	9
0005	3T	19	132	149	10	14900	17900	3000	0.07	1.20	26	31	5
0005	3T	19	134	150	14	15000	15060	60	0.09	1.00	26	26	0
0005	3T	19	135	91	5	9100	4180	-4920	0.05	0.46	16	7	-9
0005	3T	19	136	107	6	10700	7900	-2800	0.06	0.74	18	13	-5
0005	3T	19	142	102	9	10200	6070	-4130	0.09	0.60	18	10	-8
0005	3T	19	143	97	9	9700	10550	850	0.09	1.09	17	18	1
0005	3T	19	145	47	3	4700	6830	2130	0.06	1.45	8	12	4
0005	3T	19	146	61	1	6100	1250	-4850	0.02	0.20	10	2	-8
0005	3T	19	152	26	3	2600	6850	4250	0.12	2.63	4	12	8
0005	3T	19	153	29	2	2900	6830	3930	0.07	2.36	5	12	7
0005	3T	19	154	15	0	1500	0	-1500	0.00	0.00	2	0	-2
0005	3T	19	156	14	0	1400	0	-1400	0.00	0.00	2	0	-2
0005	3T	19	162	16	1	1600	5140	3540	0.06	3.21	2	9	7
0005	3T	19	163	16	0	1600	0	-1600	0.00	0.00	2	0	-2
0005	3T	19	164	6	0	600	0	-600	0.00	0.00	1	0	-1
0005	3T	19	165	5	0	500	0	-500	0.00	0.00	0	0	0
0005	3T	19	213	19	1	1900	6340	4440	0.05	3.34	3	11	8
0005	3T	19	214	10	1	1000	6720	5720	0.10	6.72	1	11	10
0005	3T	19	215	14	0	1400	0	-1400	0.00	0.00	2	0	-2
0005	3T	19	216	16	1	1600	920	-680	0.06	0.58	2	1	-1
0005	3T	19	231	5	1	500	2230	1730	0.20	4.46	0	3	3
0005	3T	19	234	11	0	1100	0	-1100	0.00	0.00	1	0	-1
0005	3T	19	235	6	0	600	0	-600	0.00	0.00	1	0	-1
0005	3T	19	236	16	0	1600	0	-1600	0.00	0.00	2	0	-2
0005	3T	19	241	5	0	500	0	-500	0.00	0.00	0	0	0
0005	3T	19	243	4	0	400	0	-400	0.00	0.00	0	0	0
0005	3T	19	245	2	0	200	0	-200	0.00	0.00	0	0	0
0005	3T	19	246	2	0	200	0	-200	0.00	0.00	0	0	0
0005	3T	19	251	4	0	400	0	-400	0.00	0.00	0	0	0
0005	3T	19	254	1	0	100	0	-100	0.00	0.00	0	0	0
0005	3T	19	256	4	0	400	0	-400	0.00	0.00	0	0	0
0005	3T	19	261	3	0	300	0	-300	0.00	0.00	0	0	0
0005	3T	19	263	6	0	600	0	-600	0.00	0.00	1	0	-1
0005	3T	19	264	3	0	300	0	-300	0.00	0.00	0	0	0
0005	3T	19	265	1	0	100	0	-100	0.00	0.00	0	0	0
0005	3T	20	123	317	41	31700	35660	3960	0.13	1.12	56	63	7
0005	3T	20	124	294	21	29400	19840	-9560	0.07	0.67	52	35	-17
0005	3T	20	125	160	7	16000	9560	-6440	0.04	0.60	28	16	-12
0005	3T	20	126	130	7	13000	16020	3020	0.05	1.23	23	28	5
0005	3T	20	132	146	9	14600	6970	-7630	0.06	0.48	25	12	-13
0005	3T	20	134	167	12	16700	12990	-3710	0.07	0.78	29	22	-7
0005	3T	20	135	92	4	9200	4020	-5180	0.04	0.44	16	7	-9
0005	3T	20	136	89	8	8900	19730	10830	0.09	2.22	15	34	19
0005	3T	20	142	95	13	9500	15660	6160	0.14	1.65	16	27	11
0005	3T	20	143	91	5	9100	9390	290	0.05	1.03	16	16	0
0005	3T	20	145	55	3	5500	3270	-2230	0.05	0.59	9	5	-4
0005	3T	20	146	59	5	5900	5750	-150	0.08	0.97	10	10	0
0005	3T	20	152	41	1	4100	1150	-2950	0.02	0.28	7	2	-5
0005	3T	20	153	34	1	3400	1020	-2380	0.03	0.30	6	1	-5
0005	3T	20	154	30	0	3000	0	-3000	0.00	0.00	5	0	-5
0005	3T	20	156	20	2	2000	3630	1630	0.10	1.82	3	6	3
0005	3T	20	162	19	2	1900	8630	6730	0.11	4.54	3	15	12
0005	3T	20	163	28	2	2800	2050	-750	0.07	0.73	4	3	-1
0005	3T	20	164	12	0	1200	0	-1200	0.00	0.00	2	0	-2
0005	3T	20	165	10	2	1000	2880	1880	0.20	2.88	1	5	4
0005	3T	20	213	15	0	1500	0	-1500	0.00	0.00	2	0	-2
0005	3T	20	214	20	0	2000	0	-2000	0.00	0.00	3	0	-3
0005	3T	20	215	18	0	1800	0	-1800	0.00	0.00	3	0	-3
0005	3T	20	216	9	1	900	1080	180	0.11	1.20	1	1	0
0005	3T	20	231	8	0	800	0	-800	0.00	0.00	1	0	-1
0005	3T	20	234	7	0	700	0	-700	0.00	0.00	1	0	-1
0005	3T	20	235	3	0	300	0	-300	0.00	0.00	0	0	0
0005	3T	20	236	8	0	800	0	-800	0.00	0.00	1	0	-1
0005	3T	20	241	3	0	300	0	-300	0.00	0.00	0	0	0
0005	3T	20	243	5	0	500	0	-500	0.00	0.00	0	0	0
0005	3T	20	245	3	0	300	0	-300	0.00	0.00	0	0	0
0005	3T	20	246	2	0	200	0	-200	0.00	0.00	0	0	0
0005	3T	20	251	5	0	500	0	-500	0.00	0.00	0	0	0
0005	3T	20	253	1	0	100	0	-100	0.00	0.00	0	0	0
0005	3T	20	254	1	0	100	0	-100	0.00	0.00	0	0	0
0005	3T	20	256	3	0	300	0	-300	0.00	0.00	0	0	0
0005	3T	20	261	3	0	300	0	-300	0.00	0.00	0	0	0
0005	3T	20	263	2	0	200	0	-200	0.00	0.00	0	0	0
0005	3T	20	264	4	0	400	0	-400	0.00	0.00	0	0	0
0005	3T	21	123	331	35	33100	33010	-90	0.11	1.00	58	58	0
0005	3T	21	124	303	23	30300	19010	-11290	0.08	0.63	53	33	-20
0005	3T	21	125	217	21	21700	21170	-530	0.10	0.98	38	37	-1
0005	3T	21	126	127	7	12700	8950	-3750	0.06	0.70	22	15	-7
0005	3T	21	132	183	15	18300	19230	930	0.08	1.05	32	34	2
0005	3T	21	134	190	19	19000	18100	-900	0.10	0.95	33	32	-1
0005	3T	21	135	134	12	13400	7660	-5740	0.09	0.57	23	13	-10
0005	3T	21	136	87	8	8700	19850	11150	0.09	2.28	15	35	20
0005	3T	21	142	114	4	11400	2700	-8700	0.04	0.24	20	4	-16
0005	3T	21	143	100	6	10000	6780	-3220	0.06	0.68	17	12	-5
0005	3T	21	145	83	9	8300	7520	-780	0.11	0.91	14	13	-1
0005	3T	21	146	33	7	3300	8270	4970	0.21	2.51	5	14	9
0005	3T	21	152	30	1	3000	4410	1410	0.03	1.47	5	7	2
0005	3T	21	153	45	3	4500	9650	5150	0.07	2.14	7	17	10
0005	3T	21	154	15	0	1500	0	-1500	0.00	0.00	2	0	-2
0005	3T	21	156	14	0	1400	0	-1400	0.00	0.00	2	0	-2
0005	3T	21	162	16	0	1600	0	-1600	0.00	0.00	2	0	-2
0005	3T	21	163	17	0	1700	0	-1700	0.00	0.00	3	0	-3
0005	3T	21	164	15	0	1500	0	-1500	0.00	0.00	2	0	-2
0005	3T	21	165	4	0	400	0	-400	0.00	0.00	0	0	0
0005	3T	21	213	12	0	1200	0	-1200	0.00	0.00	2	0	-2
0005	3T	21	214	8	0	800	0	-800	0.00	0.00	1	0	-1
0005	3T	21	215	12	0	1200	0	-1200	0.00	0.00	2	0	-2
0005	3T	21	216	9	2	900	2520	1620	0.22	2.80	1	4	3
0005	3T	21	231	7	0	700	0	-700	0.00	0.00	1	0	-1
0005	3T	21	234	9	0	900	0	-900	0.00	0.00	1	0	-1
0005	3T	21	235	1	0	100	0	-100	0.00	0.00	0	0	0
0005	3T	21	236	4	0	400	0	-400	0.00	0.00	0	0	0
0005	3T	21	241	4	1	400	3620	3220	0.25	9.05	0	6	6
0005	3T	21	243	2	0	200	0	-200	0.00	0.00	0	0	0
0005	3T	21	245	2	0	200	0	-200	0.00	0.00	0	0	0
0005	3T	21	246	1	0	100	0	-100	0.00	0.00	0	0	0
0005	3T	21	251	1	0	100	0	-100	0.00	0.00	0	0	0
0005	3T	21	253	2	0	200	0	-200	0.00	0.00	0	0	0
0005	3T	21	254	3	0	300	0	-300	0.00	0.00	0	0	0
0005	3T	21	256	1	0	100	0	-100	0.00	0.00	0	0	0
0005	3T	21	261	2	0	200	0	-200	0.00	0.00	0	0	0
0005	3T	21	265	1	0	100	0	-100	0.00	0.00	0	0	0
0005	3T	22	123	261	25	26100	25180	-920	0.10	0.96	46	44	-2
0005	3T	22	124	268	18	26800	23750	-3050	0.07	0.89	47	42	-5
0005	3T	22	125	120	3	12000	3010	-8990	0.03	0.25	21	5	-16
0005	3T	22	126	103	2	10300	5010	-5290	0.02	0.49	18	8	-10
0005	3T	22	132	139	8	13900	8670	-5230	0.06	0.62	24	15	-9
0005	3T	22	134	129	8	12900	15120	2220	0.06	1.17	22	26	4
0005	3T	22	135	89	1	8900	2040	-6860	0.01	0.23	15	3	-12
0005	3T	22	136	52	1	5200	3590	-1610	0.02	0.69	9	6	-3
0005	3T	22	142	85	7	8500	15430	6930	0.08	1.82	15	27	12
0005	3T	22	143	111	4	11100	7040	-4060	0.04	0.63	19	12	-7
0005	3T	22	145	45	0	4500	0	-4500	0.00	0.00	7	0	-7
0005	3T	22	146	31	0	3100	0	-3100	0.00	0.00	5	0	-5
0005	3T	22	152	33	0	3300	0	-3300	0.00	0.00	5	0	-5
0005	3T	22	153	34	0	3400	0	-3400	0.00	0.00	6	0	-6
0005	3T	22	154	16	1	1600	1350	-250	0.06	0.84	2	2	0
0005	3T	22	156	19	1	1900	2570	670	0.05	1.35	3	4	1
0005	3T	22	162	8	0	800	0	-800	0.00	0.00	1	0	-1
0005	3T	22	163	12	0	1200	0	-1200	0.00	0.00	2	0	-2
0005	3T	22	164	8	0	800	0	-800	0.00	0.00	1	0	-1
0005	3T	22	165	7	0	700	0	-700	0.00	0.00	1	0	-1
0005	3T	22	213	36	2	3600	2240	-1360	0.06	0.62	6	3	-3
0005	3T	22	214	35	2	3500	2030	-1470	0.06	0.58	6	3	-3
0005	3T	22	215	21	1	2100	1330	-770	0.05	0.63	3	2	-1
0005	3T	22	216	18	0	1800	0	-1800	0.00	0.00	3	0	-3
0005	3T	22	231	6	0	600	0	-600	0.00	0.00	1	0	-1
0005	3T	22	234	15	0	1500	0	-1500	0.00	0.00	2	0	-2
0005	3T	22	235	10	0	1000	0	-1000	0.00	0.00	1	0	-1
0005	3T	22	236	12	0	1200	0	-1200	0.00	0.00	2	0	-2
0005	3T	22	241	6	0	600	0	-600	0.00	0.00	1	0	-1
0005	3T	22	243	10	0	1000	0	-1000	0.00	0.00	1	0	-1
0005	3T	22	245	7	0	700	0	-700	0.00	0.00	1	0	-1
0005	3T	22	246	2	0	200	0	-200	0.00	0.00	0	0	0
0005	3T	22	251	3	0	300	0	-300	0.00	0.00	0	0	0
0005	3T	22	253	6	0	600	0	-600	0.00	0.00	1	0	-1
0005	3T	22	254	4	0	400	0	-400	0.00	0.00	0	0	0
0005	3T	22	256	3	0	300	0	-300	0.00	0.00	0	0	0
0005	3T	22	261	4	0	400	0	-400	0.00	0.00	0	0	0
0005	3T	22	263	4	0	400	0	-400	0.00	0.00	0	0	0
0005	3T	22	264	4	0	400	0	-400	0.00	0.00	0	0	0
0005	3T	22	265	2	0	200	0	-200	0.00	0.00	0	0	0
0005	3T	23	123	296	25	29600	19530	-10070	0.08	0.66	52	34	-18
0005	3T	23	124	217	12	21700	18900	-2800	0.06	0.87	38	33	-5
0005	3T	23	125	166	9	16600	21920	5320	0.05	1.32	29	38	9
0005	3T	23	126	112	6	11200	14210	3010	0.05	1.27	19	25	6
0005	3T	23	132	151	13	15100	16290	1190	0.09	1.08	26	28	2
0005	3T	23	134	146	9	14600	15930	1330	0.06	1.09	25	28	3
0005	3T	23	135	125	8	12500	11460	-1040	0.06	0.92	22	20	-2
0005	3T	23	136	81	2	8100	1900	-6200	0.02	0.23	14	3	-11
0005	3T	23	142	111	6	11100	9370	-1730	0.05	0.84	19	16	-3
0005	3T	23	143	87	4	8700	6640	-2060	0.05	0.76	15	11	-4
0005	3T	23	145	63	1	6300	3570	-2730	0.02	0.57	11	6	-5
0005	3T	23	146	35	1	3500	830	-2670	0.03	0.24	6	1	-5
0005	3T	23	152	33	1	3300	1120	-2180	0.03	0.34	5	1	-4
0005	3T	23	153	33	1	3300	4100	800	0.03	1.24	5	7	2
0005	3T	23	154	24	0	2400	0	-2400	0.00	0.00	4	0	-4
0005	3T	23	156	23	1	2300	7210	4910	0.04	3.13	4	12	8
0005	3T	23	162	8	0	800	0	-800	0.00	0.00	1	0	-1
0005	3T	23	163	6	0	600	0	-600	0.00	0.00	1	0	-1
0005	3T	23	164	4	0	400	0	-400	0.00	0.00	0	0	0
0005	3T	23	165	4	0	400	0	-400	0.00	0.00	0	0	0
0005	3T	23	213	28	1	2800	970	-1830	0.04	0.35	4	1	-3
0005	3T	23	214	31	1	3100	1510	-1590	0.03	0.49	5	2	-3
0005	3T	23	215	18	0	1800	0	-1800	0.00	0.00	3	0	-3
0005	3T	23	216	16	0	1600	0	-1600	0.00	0.00	2	0	-2
0005	3T	23	231	15	1	1500	4200	2700	0.07	2.80	2	7	5
0005	3T	23	234	13	1	1300	880	-420	0.08	0.68	2	1	-1
0005	3T	23	235	8	0	800	0	-800	0.00	0.00	1	0	-1
0005	3T	23	236	7	0	700	0	-700	0.00	0.00	1	0	-1
0005	3T	23	241	7	0	700	0	-700	0.00	0.00	1	0	-1
0005	3T	23	243	13	1	1300	4700	3400	0.08	3.62	2	8	6
0005	3T	23	245	7	1	700	1070	370	0.14	1.53	1	1	0
0005	3T	23	246	6	1	600	1310	710	0.17	2.18	1	2	1
0005	3T	23	253	4	0	400	0	-400	0.00	0.00	0	0	0
0005	3T	23	254	3	0	300	0	-300	0.00	0.00	0	0	0
0005	3T	23	256	3	0	300	0	-300	0.00	0.00	0	0	0
0005	3T	23	261	2	0	200	0	-200	0.00	0.00	0	0	0
0005	3T	23	264	3	0	300	0	-300	0.00	0.00	0	0	0
0005	3T	23	265	3	0	300	0	-300	0.00	0.00	0	0	0
0005	3T	24	123	374	58	37400	42110	4710	0.16	1.13	66	74	8
0005	3T	24	124	328	22	32800	15280	-17520	0.07	0.47	58	27	-31
0005	3T	24	125	195	14	19500	14520	-4980	0.07	0.74	34	25	-9
0005	3T	24	126	114	7	11400	6210	-5190	0.06	0.54	20	10	-10
0005	3T	24	132	161	15	16100	15360	-740	0.09	0.95	28	27	-1
0005	3T	24	134	197	20	19700	20330	630	0.10	1.03	34	35	1
0005	3T	24	135	117	5	11700	10470	-1230	0.04	0.89	20	18	-2
0005	3T	24	136	79	4	7900	8310	410	0.05	1.05	13	14	1
0005	3T	24	142	104	10	10400	15460	5060	0.10	1.49	18	27	9
0005	3T	24	143	108	5	10800	9580	-1220	0.05	0.89	19	16	-3
0005	3T	24	145	58	2	5800	8500	2700	0.03	1.47	10	15	5
0005	3T	24	146	50	2	5000	7020	2020	0.04	1.40	8	12	4
0005	3T	24	152	35	2	3500	2490	-1010	0.06	0.71	6	4	-2
0005	3T	24	153	30	0	3000	0	-3000	0.00	0.00	5	0	-5
0005	3T	24	154	27	0	2700	0	-2700	0.00	0.00	4	0	-4
0005	3T	24	156	11	1	1100	3140	2040	0.09	2.85	1	5	4
0005	3T	24	162	11	0	1100	0	-1100	0.00	0.00	1	0	-1
0005	3T	24	163	19	1	1900	1910	10	0.05	1.01	3	3	0
0005	3T	24	164	12	0	1200	0	-1200	0.00	0.00	2	0	-2
0005	3T	24	165	15	0	1500	0	-1500	0.00	0.00	2	0	-2
0005	3T	24	213	20	0	2000	0	-2000	0.00	0.00	3	0	-3
0005	3T	24	214	15	0	1500	0	-1500	0.00	0.00	2	0	-2
0005	3T	24	215	16	2	1600	2080	480	0.13	1.30	2	3	1
0005	3T	24	216	8	0	800	0	-800	0.00	0.00	1	0	-1
0005	3T	24	231	7	0	700	0	-700	0.00	0.00	1	0	-1
0005	3T	24	234	11	0	1100	0	-1100	0.00	0.00	1	0	-1
0005	3T	24	235	11	0	1100	0	-1100	0.00	0.00	1	0	-1
0005	3T	24	236	5	0	500	0	-500	0.00	0.00	0	0	0
0005	3T	24	241	2	0	200	0	-200	0.00	0.00	0	0	0
0005	3T	24	243	3	1	300	810	510	0.33	2.70	0	1	1
0005	3T	24	245	6	0	600	0	-600	0.00	0.00	1	0	-1
0005	3T	24	246	2	2	200	56440	56240	1.00	282.20	0	99	99
0005	3T	24	251	1	0	100	0	-100	0.00	0.00	0	0	0
0005	3T	24	253	2	0	200	0	-200	0.00	0.00	0	0	0
0005	3T	24	254	3	0	300	0	-300	0.00	0.00	0	0	0
0005	3T	24	256	2	0	200	0	-200	0.00	0.00	0	0	0
0005	3T	24	264	1	0	100	0	-100	0.00	0.00	0	0	0
0023	2T	01_4	12	80	11	8000	4090	-3910	0.14	0.51	14	7	-7
0023	2T	01_4	13	62	6	6200	2500	-3700	0.10	0.40	10	4	-6
0023	2T	01_4	14	27	7	2700	3280	580	0.26	1.21	4	5	1
0023	2T	01_4	15	10	0	1000	0	-1000	0.00	0.00	1	0	-1
0023	2T	01_4	16	13	0	1300	0	-1300	0.00	0.00	2	0	-2
0023	2T	01_4	21	1	0	100	0	-100	0.00	0.00	0	0	0
0023	2T	01_4	23	4	0	400	0	-400	0.00	0.00	0	0	0
0023	2T	01_4	24	4	1	400	500	100	0.25	1.25	0	0	0
0023	2T	01_4	25	1	0	100	0	-100	0.00	0.00	0	0	0
0023	2T	01_4	26	2	0	200	0	-200	0.00	0.00	0	0	0
0023	2T	01_5	12	103	17	10300	6740	-3560	0.17	0.65	18	11	-7
0023	2T	01_5	13	71	13	7100	5930	-1170	0.18	0.84	12	10	-2
0023	2T	01_5	14	19	4	1900	1710	-190	0.21	0.90	3	3	0
0023	2T	01_5	15	7	0	700	0	-700	0.00	0.00	1	0	-1
0023	2T	01_5	16	11	1	1100	750	-350	0.09	0.68	1	1	0
0023	2T	01_5	23	6	0	600	0	-600	0.00	0.00	1	0	-1
0023	2T	01_5	24	3	0	300	0	-300	0.00	0.00	0	0	0
0023	2T	01_5	25	2	0	200	0	-200	0.00	0.00	0	0	0
0023	2T	01_5	26	1	0	100	0	-100	0.00	0.00	0	0	0
0023	2T	01_6	12	182	51	18200	12900	-5300	0.28	0.71	32	22	-10
0023	2T	01_6	13	59	26	5900	6180	280	0.44	1.05	10	10	0
0023	2T	01_6	14	27	7	2700	1780	-920	0.26	0.66	4	3	-1
0023	2T	01_6	15	3	1	300	350	50	0.33	1.17	0	0	0
0023	2T	01_7	12	129	40	12900	13600	700	0.31	1.05	22	24	2
0023	2T	01_7	13	39	9	3900	2780	-1120	0.23	0.71	6	4	-2
0023	2T	01_7	14	27	3	2700	1440	-1260	0.11	0.53	4	2	-2
0023	2T	01_7	15	9	2	900	460	-440	0.22	0.51	1	0	-1
0023	2T	01_7	16	7	1	700	350	-350	0.14	0.50	1	0	-1
0023	2T	01_7	23	1	1	100	250	150	1.00	2.50	0	0	0
0023	2T	01_7	24	1	0	100	0	-100	0.00	0.00	0	0	0
0023	2T	01_7	26	2	0	200	0	-200	0.00	0.00	0	0	0
0023	2T	01_8	12	86	21	8600	9120	520	0.24	1.06	15	16	1
0023	2T	01_8	13	28	6	2800	2090	-710	0.21	0.75	4	3	-1
0023	2T	01_8	14	11	2	1100	930	-170	0.18	0.85	1	1	0
0023	2T	01_8	15	143	40	14300	13560	-740	0.28	0.95	25	24	-1
0023	2T	01_9	12	180	53	18000	16400	-1600	0.29	0.91	31	29	-2
0023	2T	01_9	13	49	12	4900	5010	110	0.24	1.02	8	8	0
0023	2T	01_9	14	9	1	900	320	-580	0.11	0.36	1	0	-1
0023	2T	01_9	15	5	0	500	0	-500	0.00	0.00	0	0	0
0023	2T	01_9	16	3	0	300	0	-300	0.00	0.00	0	0	0
0023	2T	01_9	24	2	0	200	0	-200	0.00	0.00	0	0	0
0023	2T	02_1	12	89	17	8900	8300	-600	0.19	0.93	15	14	-1
0023	2T	02_1	13	50	6	5000	3160	-1840	0.12	0.63	8	5	-3
0023	2T	02_1	14	15	1	1500	340	-1160	0.07	0.23	2	0	-2
0023	2T	02_1	15	13	1	1300	580	-720	0.08	0.45	2	1	-1
0023	2T	02_1	16	10	3	1000	2040	1040	0.30	2.04	1	3	2
0023	2T	02_1	23	5	0	500	0	-500	0.00	0.00	0	0	0
0023	2T	02_1	25	1	0	100	0	-100	0.00	0.00	0	0	0
0023	2T	02_10	12	159	31	15900	12590	-3310	0.19	0.79	28	22	-6
0023	2T	02_10	13	71	10	7100	4710	-2390	0.14	0.66	12	8	-4
0023	2T	02_10	14	15	2	1500	1080	-420	0.13	0.72	2	1	-1
0023	2T	02_10	15	4	1	400	410	10	0.25	1.03	0	0	0
0023	2T	02_10	16	5	1	500	1210	710	0.20	2.42	0	2	2
0023	2T	02_10	21	1	0	100	0	-100	0.00	0.00	0	0	0
0023	2T	02_10	23	2	0	200	0	-200	0.00	0.00	0	0	0
0023	2T	02_10	25	1	0	100	0	-100	0.00	0.00	0	0	0
0023	2T	02_11	12	172	35	17200	13320	-3880	0.20	0.77	30	23	-7
0023	2T	02_11	13	67	16	6700	6950	250	0.24	1.04	11	12	1
0023	2T	02_11	14	22	2	2200	1030	-1170	0.09	0.47	3	1	-2
0023	2T	02_11	15	3	1	300	790	490	0.33	2.63	0	1	1
0023	2T	02_11	16	1	0	100	0	-100	0.00	0.00	0	0	0
0023	2T	02_12	12	205	58	20500	21090	590	0.28	1.03	36	37	1
0023	2T	02_12	13	45	13	4500	4720	220	0.29	1.05	7	8	1
0023	2T	02_12	14	13	2	1300	800	-500	0.15	0.62	2	1	-1
0023	2T	02_12	15	1	1	100	410	310	1.00	4.10	0	0	0
0023	2T	02_12	21	1	0	100	0	-100	0.00	0.00	0	0	0
0015	1T	nopattern	1	66613	38477	6661300	6119050	-542250	0.58	0.92	11789	10830	-959
0015	1T	nopattern	2	5871	2335	587100	528120	-58980	0.40	0.90	1039	934	-105
0015	2F	nopattern	12	36615	12155	3661500	3094380	-567120	0.33	0.85	6480	5476	-1004
0015	2F	nopattern	13	16177	5051	1617700	1293910	-323790	0.31	0.80	2863	2290	-573
0015	2F	nopattern	14	8437	2389	843700	644870	-198830	0.28	0.76	1493	1141	-352
0015	2F	nopattern	15	2364	491	236400	196410	-39990	0.21	0.83	418	347	-71
0015	2F	nopattern	16	1923	374	192300	174950	-17350	0.19	0.91	340	309	-31
0015	2F	nopattern	23	339	74	33900	24900	-9000	0.22	0.73	60	44	-16
0015	2F	nopattern	24	258	56	25800	20740	-5060	0.22	0.80	45	36	-9
0015	2F	nopattern	25	218	26	21800	10340	-11460	0.12	0.47	38	18	-20
0015	2F	nopattern	26	398	69	39800	32030	-7770	0.17	0.80	70	56	-14
0015	2T	nopattern	12	36542	9146	3654200	2982390	-671810	0.25	0.82	6467	5278	-1189
0015	2T	nopattern	13	16177	3583	1617700	1238550	-379150	0.22	0.77	2863	2192	-671
0015	2T	nopattern	14	8437	1708	843700	661780	-181920	0.20	0.78	1493	1171	-322
0015	2T	nopattern	15	2364	333	236400	196400	-40000	0.14	0.83	418	347	-71
0015	2T	nopattern	16	1923	258	192300	177420	-14880	0.13	0.92	340	314	-26
0015	2T	nopattern	21	73	7	7300	6920	-380	0.10	0.95	12	12	0
0015	2T	nopattern	23	339	41	33900	22890	-11010	0.12	0.68	60	40	-20
0015	2T	nopattern	24	258	30	25800	19890	-5910	0.12	0.77	45	35	-10
0015	2T	nopattern	25	218	15	21800	11760	-10040	0.07	0.54	38	20	-18
0015	2T	nopattern	26	398	39	39800	28550	-11250	0.10	0.72	70	50	-20
0015	3F	nopattern	123	9261	2507	926100	759690	-166410	0.27	0.82	1639	1344	-295
0015	3F	nopattern	124	14966	3182	1496600	1123640	-372960	0.21	0.75	2648	1988	-660
0015	3F	nopattern	125	5400	1045	540000	463520	-76480	0.19	0.86	955	820	-135
0015	3F	nopattern	126	5206	750	520600	449020	-71580	0.14	0.86	921	794	-127
0015	3F	nopattern	134	5098	1155	509800	386330	-123470	0.23	0.76	902	683	-219
0015	3F	nopattern	135	3353	641	335300	243770	-91530	0.19	0.73	593	431	-162
0015	3F	nopattern	136	3466	519	346600	268370	-78230	0.15	0.77	613	474	-139
0015	3F	nopattern	145	1307	235	130700	90720	-39980	0.18	0.69	231	160	-71
0015	3F	nopattern	146	1292	176	129200	97090	-32110	0.14	0.75	228	171	-57
0015	3F	nopattern	156	537	71	53700	44290	-9410	0.13	0.82	95	78	-17
0015	3F	nopattern	234	76	11	7600	3420	-4180	0.14	0.45	13	6	-7
0015	3F	nopattern	235	65	10	6500	2780	-3720	0.15	0.43	11	4	-7
0015	3F	nopattern	236	104	17	10400	8830	-1570	0.16	0.85	18	15	-3
0015	3F	nopattern	245	36	6	3600	2500	-1100	0.17	0.69	6	4	-2
0015	3F	nopattern	246	66	12	6600	5190	-1410	0.18	0.79	11	9	-2
0015	3F	nopattern	256	53	6	5300	2200	-3100	0.11	0.42	9	3	-6
0015	3T	nopattern	123	9183	1120	918300	806310	-111990	0.12	0.88	1625	1427	-198
0015	3T	nopattern	124	14882	1337	1488200	1106650	-381550	0.09	0.74	2633	1958	-675
0015	3T	nopattern	125	5381	420	538100	468310	-69790	0.08	0.87	952	828	-124
0015	3T	nopattern	126	5161	310	516100	462810	-53290	0.06	0.90	913	819	-94
0015	3T	nopattern	132	77	3	7700	2390	-5310	0.04	0.31	13	4	-9
0015	3T	nopattern	134	4973	476	497300	399320	-97980	0.10	0.80	880	706	-174
0015	3T	nopattern	135	3303	259	330300	237000	-93300	0.08	0.72	584	419	-165
0015	3T	nopattern	136	3435	214	343500	290030	-53470	0.06	0.84	607	513	-94
0015	3T	nopattern	142	62	9	6200	7620	1420	0.15	1.23	10	13	3
0015	3T	nopattern	143	125	7	12500	7690	-4810	0.06	0.62	22	13	-9
0015	3T	nopattern	145	1269	78	126900	88300	-38600	0.06	0.70	224	156	-68
0015	3T	nopattern	146	1250	58	125000	83890	-41110	0.05	0.67	221	148	-73
0015	3T	nopattern	152	17	0	1700	0	-1700	0.00	0.00	3	0	-3
0015	3T	nopattern	153	50	1	5000	660	-4340	0.02	0.13	8	1	-7
0015	3T	nopattern	154	38	4	3800	4480	680	0.11	1.18	6	7	1
0015	3T	nopattern	156	523	22	52300	49690	-2610	0.04	0.95	92	87	-5
0015	3T	nopattern	162	5	0	500	0	-500	0.00	0.00	0	0	0
0015	3T	nopattern	163	31	1	3100	2860	-240	0.03	0.92	5	5	0
0015	3T	nopattern	164	42	2	4200	3050	-1150	0.05	0.73	7	5	-2
0015	3T	nopattern	165	14	2	1400	2930	1530	0.14	2.09	2	5	3
0015	3T	nopattern	213	1	0	100	0	-100	0.00	0.00	0	0	0
0015	3T	nopattern	214	22	0	2200	0	-2200	0.00	0.00	3	0	-3
0015	3T	nopattern	215	2	0	200	0	-200	0.00	0.00	0	0	0
0015	3T	nopattern	216	40	1	4000	2990	-1010	0.03	0.75	7	5	-2
0015	3T	nopattern	234	75	3	7500	4940	-2560	0.04	0.66	13	8	-5
0015	3T	nopattern	235	62	3	6200	2780	-3420	0.05	0.45	10	4	-6
0015	3T	nopattern	236	102	6	10200	9800	-400	0.06	0.96	18	17	-1
0015	3T	nopattern	243	1	0	100	0	-100	0.00	0.00	0	0	0
0015	3T	nopattern	245	33	2	3300	2210	-1090	0.06	0.67	5	3	-2
0015	3T	nopattern	246	63	3	6300	2680	-3620	0.05	0.43	11	4	-7
0015	3T	nopattern	253	3	0	300	0	-300	0.00	0.00	0	0	0
0015	3T	nopattern	254	3	0	300	0	-300	0.00	0.00	0	0	0
0015	3T	nopattern	256	51	1	5100	1450	-3650	0.02	0.28	9	2	-7
0015	3T	nopattern	263	2	0	200	0	-200	0.00	0.00	0	0	0
0015	3T	nopattern	264	3	0	300	0	-300	0.00	0.00	0	0	0
0015	3T	nopattern	265	2	1	200	1980	1780	0.50	9.90	0	3	3
0023	2T	02_12	24	1	0	100	0	-100	0.00	0.00	0	0	0
0023	2T	02_2	12	35	6	3500	3710	210	0.17	1.06	6	6	0
0023	2T	02_2	13	9	0	900	0	-900	0.00	0.00	1	0	-1
0023	2T	02_2	14	98	12	9800	6120	-3680	0.12	0.62	17	10	-7
0023	2T	02_2	15	1	0	100	0	-100	0.00	0.00	0	0	0
0023	2T	02_2	16	2	0	200	0	-200	0.00	0.00	0	0	0
0023	2T	02_2	23	2	0	200	0	-200	0.00	0.00	0	0	0
0023	2T	02_2	24	2	0	200	0	-200	0.00	0.00	0	0	0
0023	2T	02_2	26	1	0	100	0	-100	0.00	0.00	0	0	0
0023	2T	02_3	12	94	12	9400	8680	-720	0.13	0.92	16	15	-1
0020	1T	01	1	2512	1470	251200	228180	-23020	0.59	0.91	444	403	-41
0020	1T	01	2	288	114	28800	30340	1540	0.40	1.05	50	53	3
0020	1T	02	1	2570	1249	257000	225240	-31760	0.49	0.88	454	398	-56
0020	1T	02	2	308	116	30800	24140	-6660	0.38	0.78	54	42	-12
0020	1T	03	1	1907	957	190700	179340	-11360	0.50	0.94	337	317	-20
0020	1T	03	2	265	89	26500	20550	-5950	0.34	0.78	46	36	-10
0020	1T	04	1	2213	1123	221300	201700	-19600	0.51	0.91	391	356	-35
0020	1T	04	2	265	94	26500	22920	-3580	0.35	0.86	46	40	-6
0020	1T	05	1	2527	1482	252700	246220	-6480	0.59	0.97	447	435	-12
0020	1T	05	2	365	134	36500	31780	-4720	0.37	0.87	64	56	-8
0020	1T	06	1	2810	1507	281000	248660	-32340	0.54	0.88	497	440	-57
0020	1T	06	2	350	139	35000	31280	-3720	0.40	0.89	61	55	-6
0020	1T	07	1	2898	1714	289800	275900	-13900	0.59	0.95	512	488	-24
0020	1T	07	2	308	113	30800	28550	-2250	0.37	0.93	54	50	-4
0020	1T	08	1	2793	1689	279300	264200	-15100	0.60	0.95	494	467	-27
0020	1T	08	2	245	82	24500	19270	-5230	0.33	0.79	43	34	-9
0020	1T	09	1	2884	1781	288400	276410	-11990	0.62	0.96	510	489	-21
0020	1T	09	2	320	132	32000	27630	-4370	0.41	0.86	56	48	-8
0020	1T	10	1	2630	1532	263000	234870	-28130	0.58	0.89	465	415	-50
0020	1T	10	2	308	125	30800	26470	-4330	0.41	0.86	54	46	-8
0020	1T	11	1	2343	1263	234300	206190	-28110	0.54	0.88	414	364	-50
0020	1T	11	2	332	116	33200	31080	-2120	0.35	0.94	58	55	-3
0020	1T	12	1	2553	1541	255300	229920	-25380	0.60	0.90	451	406	-45
0020	1T	12	2	245	98	24500	24510	10	0.40	1.00	43	43	0
0020	1T	13	1	2479	1526	247900	232140	-15760	0.62	0.94	438	410	-28
0020	1T	13	2	260	95	26000	20420	-5580	0.37	0.79	46	36	-10
0020	1T	14	1	2382	1264	238200	206850	-31350	0.53	0.87	421	366	-55
0020	1T	14	2	289	118	28900	28480	-420	0.41	0.99	51	50	-1
0020	1T	15	1	2929	1653	292900	258480	-34420	0.56	0.88	518	457	-61
0020	1T	15	2	264	89	26400	23310	-3090	0.34	0.88	46	41	-5
0020	1T	16	1	2934	1777	293400	275020	-18380	0.61	0.94	519	486	-33
0020	1T	16	2	311	107	31100	24970	-6130	0.34	0.80	55	44	-11
0020	1T	17	1	2839	1724	283900	273260	-10640	0.61	0.96	502	483	-19
0020	1T	17	2	282	123	28200	28390	190	0.44	1.01	49	50	1
0020	1T	18	1	3013	2081	301300	287180	-14120	0.69	0.95	533	508	-25
0020	1T	18	2	352	155	35200	30160	-5040	0.44	0.86	62	53	-9
0020	1T	19	1	2586	1591	258600	238720	-19880	0.62	0.92	457	422	-35
0020	1T	19	2	251	104	25100	25630	530	0.41	1.02	44	45	1
0020	1T	20	1	2908	1681	290800	264930	-25870	0.58	0.91	514	468	-46
0020	1T	20	2	152	67	15200	19660	4460	0.44	1.29	26	34	8
0020	1T	21	1	3053	1948	305300	276260	-29040	0.64	0.90	540	488	-52
0020	1T	21	2	136	62	13600	13740	140	0.46	1.01	24	24	0
0020	1T	22	1	2282	1324	228200	213320	-14880	0.58	0.93	403	377	-26
0020	1T	22	2	385	136	38500	30980	-7520	0.35	0.80	68	54	-14
0020	1T	23	1	2611	1519	261100	238160	-22940	0.58	0.91	462	421	-41
0020	1T	23	2	215	77	21500	16940	-4560	0.36	0.79	38	29	-9
0020	1T	24	1	2880	2056	288000	282630	-5370	0.71	0.98	509	500	-9
0020	1T	24	2	168	85	16800	23090	6290	0.51	1.37	29	40	11
0020	2F	01	12	1603	493	160300	135520	-24780	0.31	0.85	283	239	-44
0020	2F	01	13	305	104	30500	27140	-3360	0.34	0.89	53	48	-5
0020	2F	01	14	251	53	25100	14650	-10450	0.21	0.58	44	25	-19
0020	2F	01	15	230	73	23000	17350	-5650	0.32	0.75	40	30	-10
0020	2F	01	16	29	2	2900	910	-1990	0.07	0.31	5	1	-4
0020	2F	01	23	13	3	1300	1620	320	0.23	1.25	2	2	0
0020	2F	01	24	6	2	600	570	-30	0.33	0.95	1	1	0
0020	2F	01	25	2	0	200	0	-200	0.00	0.00	0	0	0
0020	2F	01	26	7	2	700	1180	480	0.29	1.69	1	2	1
0020	2F	02	12	1589	432	158900	136570	-22330	0.27	0.86	281	241	-40
0020	2F	02	13	442	120	44200	37130	-7070	0.27	0.84	78	65	-13
0020	2F	02	14	256	58	25600	21980	-3620	0.23	0.86	45	38	-7
0020	2F	02	15	70	11	7000	6320	-680	0.16	0.90	12	11	-1
0020	2F	02	16	50	6	5000	4620	-380	0.12	0.92	8	8	0
0020	2F	02	23	26	6	2600	2130	-470	0.23	0.82	4	3	-1
0020	2F	02	24	5	1	500	390	-110	0.20	0.78	0	0	0
0020	2F	02	25	4	0	400	0	-400	0.00	0.00	0	0	0
0020	2F	02	26	6	0	600	0	-600	0.00	0.00	1	0	-1
0020	2F	03	12	1013	336	101300	90680	-10620	0.33	0.90	179	160	-19
0020	2F	03	13	381	108	38100	31380	-6720	0.28	0.82	67	55	-12
0020	2F	03	14	222	40	22200	12660	-9540	0.18	0.57	39	22	-17
0020	2F	03	15	114	21	11400	10070	-1330	0.18	0.88	20	17	-3
0020	2F	03	16	46	10	4600	5090	490	0.22	1.11	8	9	1
0020	2F	03	23	27	7	2700	3250	550	0.26	1.20	4	5	1
0020	2F	03	24	8	2	800	810	10	0.25	1.01	1	1	0
0020	2F	03	25	12	3	1200	940	-260	0.25	0.78	2	1	-1
0020	2F	03	26	6	0	600	0	-600	0.00	0.00	1	0	-1
0020	2F	04	12	1172	361	117200	115300	-1900	0.31	0.98	207	204	-3
0020	2F	04	13	517	140	51700	38210	-13490	0.27	0.74	91	67	-24
0020	2F	04	14	250	48	25000	16060	-8940	0.19	0.64	44	28	-16
0020	2F	04	15	125	26	12500	11100	-1400	0.21	0.89	22	19	-3
0020	2F	04	16	82	17	8200	7220	-980	0.21	0.88	14	12	-2
0020	2F	04	23	24	9	2400	3130	730	0.38	1.30	4	5	1
0020	2F	04	24	6	1	600	320	-280	0.17	0.53	1	0	-1
0020	2F	04	25	11	2	1100	840	-260	0.18	0.76	1	1	0
0020	2F	04	26	16	3	1600	2780	1180	0.19	1.74	2	4	2
0020	2F	05	12	1395	425	139500	118620	-20880	0.30	0.85	246	209	-37
0020	2F	05	13	518	156	51800	43400	-8400	0.30	0.84	91	76	-15
0020	2F	05	14	347	116	34700	29210	-5490	0.33	0.84	61	51	-10
0020	2F	05	15	114	20	11400	7330	-4070	0.18	0.64	20	12	-8
0020	2F	05	16	69	12	6900	7930	1030	0.17	1.15	12	14	2
0020	2F	05	23	35	11	3500	2670	-830	0.31	0.76	6	4	-2
0020	2F	05	24	14	4	1400	1020	-380	0.29	0.73	2	1	-1
0020	2F	05	25	20	3	2000	1380	-620	0.15	0.69	3	2	-1
0020	2F	05	26	11	3	1100	890	-210	0.27	0.81	1	1	0
0020	2F	06	12	1481	475	148100	136970	-11130	0.32	0.92	262	242	-20
0020	2F	06	13	705	197	70500	50560	-19940	0.28	0.72	124	89	-35
0020	2F	06	14	325	89	32500	27400	-5100	0.27	0.84	57	48	-9
0020	2F	06	15	124	30	12400	9840	-2560	0.24	0.79	21	17	-4
0020	2F	06	16	73	18	7300	8530	1230	0.25	1.17	12	15	3
0020	2F	06	23	28	8	2800	2140	-660	0.29	0.76	4	3	-1
0020	2F	06	24	11	1	1100	910	-190	0.09	0.83	1	1	0
0020	2F	06	25	20	3	2000	1800	-200	0.15	0.90	3	3	0
0020	2F	06	26	14	4	1400	2870	1470	0.29	2.05	2	5	3
0020	2F	07	12	1452	439	145200	120660	-24540	0.30	0.83	256	213	-43
0020	2F	07	13	741	252	74100	62820	-11280	0.34	0.85	131	111	-20
0020	2F	07	14	394	116	39400	31620	-7780	0.29	0.80	69	55	-14
0020	2F	07	15	118	23	11800	8760	-3040	0.19	0.74	20	15	-5
0020	2F	07	16	63	19	6300	7550	1250	0.30	1.20	11	13	2
0020	2F	07	23	37	6	3700	2460	-1240	0.16	0.66	6	4	-2
0020	2F	07	24	8	2	800	820	20	0.25	1.03	1	1	0
0020	2F	07	25	16	2	1600	940	-660	0.13	0.59	2	1	-1
0020	2F	07	26	12	2	1200	670	-530	0.17	0.56	2	1	-1
0020	2F	08	12	1507	493	150700	130020	-20680	0.33	0.86	266	230	-36
0020	2F	08	13	625	183	62500	47010	-15490	0.29	0.75	110	83	-27
0020	2F	08	14	318	91	31800	24780	-7020	0.29	0.78	56	43	-13
0020	2F	08	15	116	25	11600	10030	-1570	0.22	0.86	20	17	-3
0020	2F	08	16	130	32	13000	12150	-850	0.25	0.93	23	21	-2
0020	2F	08	23	14	5	1400	2090	690	0.36	1.49	2	3	1
0020	2F	08	24	13	1	1300	240	-1060	0.08	0.18	2	0	-2
0020	2F	08	25	9	2	900	1050	150	0.22	1.17	1	1	0
0020	2F	08	26	12	0	1200	0	-1200	0.00	0.00	2	0	-2
0020	2F	09	12	1777	636	177700	152790	-24910	0.36	0.86	314	270	-44
0020	2F	09	13	603	184	60300	47620	-12680	0.31	0.79	106	84	-22
0020	2F	09	14	256	64	25600	20880	-4720	0.25	0.82	45	36	-9
0020	2F	09	15	95	17	9500	6930	-2570	0.18	0.73	16	12	-4
0020	2F	09	16	76	13	7600	5270	-2330	0.17	0.69	13	9	-4
0020	2F	09	23	27	9	2700	2810	110	0.33	1.04	4	4	0
0020	2F	09	24	8	2	800	650	-150	0.25	0.81	1	1	0
0020	2F	09	25	14	1	1400	220	-1180	0.07	0.16	2	0	-2
0020	2F	09	26	31	2	3100	950	-2150	0.06	0.31	5	1	-4
0020	2F	10	12	1494	568	149400	123330	-26070	0.38	0.83	264	218	-46
0020	2F	10	13	688	240	68800	55200	-13600	0.35	0.80	121	97	-24
0020	2F	10	14	287	84	28700	22710	-5990	0.29	0.79	50	40	-10
0020	2F	10	15	75	12	7500	4430	-3070	0.16	0.59	13	7	-6
0020	2F	10	16	61	10	6100	4520	-1580	0.16	0.74	10	8	-2
0020	2F	10	23	14	6	1400	1490	90	0.43	1.06	2	2	0
0020	2F	10	24	12	4	1200	1020	-180	0.33	0.85	2	1	-1
0020	2F	10	25	27	6	2700	1910	-790	0.22	0.71	4	3	-1
0020	2F	10	26	22	8	2200	3290	1090	0.36	1.50	3	5	2
0020	2F	11	12	1676	569	167600	165150	-2450	0.34	0.99	296	292	-4
0020	2F	11	13	409	101	40900	27690	-13210	0.25	0.68	72	49	-23
0020	2F	11	14	165	41	16500	14950	-1550	0.25	0.91	29	26	-3
0020	2F	11	15	24	4	2400	1960	-440	0.17	0.82	4	3	-1
0020	2F	11	16	21	3	2100	2390	290	0.14	1.14	3	4	1
0020	2F	11	23	68	11	6800	4710	-2090	0.16	0.69	12	8	-4
0020	2F	11	24	26	5	2600	1920	-680	0.19	0.74	4	3	-1
0020	2F	11	25	14	2	1400	480	-920	0.14	0.34	2	0	-2
0020	2F	12	12	1630	526	163000	134560	-28440	0.32	0.83	288	238	-50
0020	2F	12	13	401	132	40100	31690	-8410	0.33	0.79	70	56	-14
0020	2F	12	14	258	55	25800	17540	-8260	0.21	0.68	45	31	-14
0020	2F	12	15	126	30	12600	12110	-490	0.24	0.96	22	21	-1
0020	2F	12	16	73	19	7300	6560	-740	0.26	0.90	12	11	-1
0020	2F	12	23	17	6	1700	1770	70	0.35	1.04	3	3	0
0020	2F	12	24	13	3	1300	1310	10	0.23	1.01	2	2	0
0020	2F	12	25	11	2	1100	810	-290	0.18	0.74	1	1	0
0020	2F	12	26	7	1	700	1640	940	0.14	2.34	1	2	1
0020	2F	13	12	1383	459	138300	118750	-19550	0.33	0.86	244	210	-34
0020	2F	13	13	516	173	51600	42540	-9060	0.34	0.82	91	75	-16
0020	2F	13	14	309	108	30900	27500	-3400	0.35	0.89	54	48	-6
0020	2F	13	15	115	31	11500	9670	-1830	0.27	0.84	20	17	-3
0020	2F	13	16	74	20	7400	7120	-280	0.27	0.96	13	12	-1
0020	2F	13	23	18	4	1800	1100	-700	0.22	0.61	3	1	-2
0020	2F	13	24	11	1	1100	640	-460	0.09	0.58	1	1	0
0020	2F	13	25	7	0	700	0	-700	0.00	0.00	1	0	-1
0020	2F	13	26	7	0	700	0	-700	0.00	0.00	1	0	-1
0020	2F	14	12	1360	411	136000	111160	-24840	0.30	0.82	240	196	-44
0020	2F	14	13	393	103	39300	27230	-12070	0.26	0.69	69	48	-21
0020	2F	14	14	357	84	35700	23750	-11950	0.24	0.67	63	42	-21
0020	2F	14	15	103	21	10300	9750	-550	0.20	0.95	18	17	-1
0020	2F	14	16	64	15	6400	5600	-800	0.23	0.88	11	9	-2
0020	2F	14	23	25	7	2500	2930	430	0.28	1.17	4	5	1
0020	2F	14	24	22	6	2200	2190	-10	0.27	1.00	3	3	0
0020	2F	14	25	8	2	800	840	40	0.25	1.05	1	1	0
0020	2F	14	26	10	2	1000	620	-380	0.20	0.62	1	1	0
0020	2F	15	12	1675	524	167500	132250	-35250	0.31	0.79	296	234	-62
0020	2F	15	13	608	194	60800	49850	-10950	0.32	0.82	107	88	-19
0020	2F	15	14	322	86	32200	27240	-4960	0.27	0.85	56	48	-8
0020	2F	15	15	117	25	11700	10690	-1010	0.21	0.91	20	18	-2
0020	2F	15	16	84	25	8400	10590	2190	0.30	1.26	14	18	4
0020	2F	15	23	33	8	3300	2230	-1070	0.24	0.68	5	3	-2
0020	2F	15	24	8	1	800	700	-100	0.13	0.88	1	1	0
0020	2F	15	25	14	2	1400	560	-840	0.14	0.40	2	0	-2
0020	2F	15	26	18	2	1800	980	-820	0.11	0.54	3	1	-2
0020	2F	16	12	1603	564	160300	139990	-20310	0.35	0.87	283	247	-36
0020	2F	16	13	543	159	54300	40730	-13570	0.29	0.75	96	72	-24
0020	2F	16	14	463	169	46300	42030	-4270	0.37	0.91	81	74	-7
0020	2F	16	15	105	18	10500	8410	-2090	0.17	0.80	18	14	-4
0020	2F	16	16	99	12	9900	6350	-3550	0.12	0.64	17	11	-6
0020	2F	16	23	18	5	1800	2360	560	0.28	1.31	3	4	1
0020	2F	16	24	11	2	1100	740	-360	0.18	0.67	1	1	0
0020	2F	16	25	20	6	2000	3400	1400	0.30	1.70	3	6	3
0020	2F	16	26	19	1	1900	330	-1570	0.05	0.17	3	0	-3
0020	2F	17	12	1634	518	163400	124980	-38420	0.32	0.76	289	221	-68
0020	2F	17	13	654	240	65400	55800	-9600	0.37	0.85	115	98	-17
0020	2F	17	14	320	92	32000	25260	-6740	0.29	0.79	56	44	-12
0020	2F	17	15	85	17	8500	6520	-1980	0.20	0.77	15	11	-4
0020	2F	17	16	24	5	2400	3020	620	0.21	1.26	4	5	1
0020	2F	17	23	25	2	2500	680	-1820	0.08	0.27	4	1	-3
0020	2F	17	24	13	3	1300	990	-310	0.23	0.76	2	1	-1
0020	2F	17	25	19	7	1900	2880	980	0.37	1.52	3	5	2
0020	2F	17	26	3	2	300	1020	720	0.67	3.40	0	1	1
0020	2F	18	12	1810	719	181000	163760	-17240	0.40	0.90	320	289	-31
0020	2F	18	13	582	195	58200	52490	-5710	0.34	0.90	103	92	-11
0020	2F	18	14	345	106	34500	29390	-5110	0.31	0.85	61	52	-9
0020	2F	18	15	135	38	13500	13750	250	0.28	1.02	23	24	1
0020	2F	18	16	81	15	8100	8020	-80	0.19	0.99	14	14	0
0020	2F	18	23	21	4	2100	1230	-870	0.19	0.59	3	2	-1
0020	2F	18	24	9	1	900	210	-690	0.11	0.23	1	0	-1
0020	2F	18	25	10	0	1000	0	-1000	0.00	0.00	1	0	-1
0020	2F	18	26	27	4	2700	2090	-610	0.15	0.77	4	3	-1
0020	2F	19	12	1282	419	128200	107560	-20640	0.33	0.84	226	190	-36
0020	2F	19	13	664	228	66400	49460	-16940	0.34	0.74	117	87	-30
0020	2F	19	14	414	141	41400	32290	-9110	0.34	0.78	73	57	-16
0020	2F	19	15	48	4	4800	1690	-3110	0.08	0.35	8	2	-6
0020	2F	19	16	66	13	6600	6760	160	0.20	1.02	11	11	0
0020	2F	19	23	13	2	1300	820	-480	0.15	0.63	2	1	-1
0020	2F	19	24	15	3	1500	1060	-440	0.20	0.71	2	1	-1
0020	2F	19	25	8	0	800	0	-800	0.00	0.00	1	0	-1
0020	2F	19	26	20	5	2000	1940	-60	0.25	0.97	3	3	0
0020	2F	20	12	1587	549	158700	131510	-27190	0.35	0.83	280	232	-48
0020	2F	20	13	642	218	64200	52190	-12010	0.34	0.81	113	92	-21
0020	2F	20	14	369	110	36900	27180	-9720	0.30	0.74	65	48	-17
0020	2F	20	15	133	34	13300	11550	-1750	0.26	0.87	23	20	-3
0020	2F	20	16	83	18	8300	6380	-1920	0.22	0.77	14	11	-3
0020	2F	20	23	11	2	1100	590	-510	0.18	0.54	1	1	0
0020	2F	20	24	3	0	300	0	-300	0.00	0.00	0	0	0
0020	2F	20	25	7	1	700	250	-450	0.14	0.36	1	0	-1
0020	2F	20	26	6	1	600	240	-360	0.17	0.40	1	0	-1
0020	2F	21	12	1687	578	168700	132920	-35780	0.34	0.79	298	235	-63
0020	2F	21	13	770	308	77000	70020	-6980	0.40	0.91	136	123	-13
0020	2F	21	14	443	172	44300	35930	-8370	0.39	0.81	78	63	-15
0020	2F	21	15	77	22	7700	6580	-1120	0.29	0.85	13	11	-2
0020	2F	21	16	30	5	3000	2450	-550	0.17	0.82	5	4	-1
0020	2F	21	23	6	3	600	570	-30	0.50	0.95	1	1	0
0020	2F	21	24	4	1	400	610	210	0.25	1.53	0	1	1
0020	2F	21	25	4	0	400	0	-400	0.00	0.00	0	0	0
0020	2F	21	26	8	1	800	330	-470	0.13	0.41	1	0	-1
0020	2F	22	12	1441	501	144100	139000	-5100	0.35	0.96	255	246	-9
0020	2F	22	13	343	107	34300	25200	-9100	0.31	0.73	60	44	-16
0020	2F	22	14	329	80	32900	23360	-9540	0.24	0.71	58	41	-17
0020	2F	22	15	39	12	3900	5270	1370	0.31	1.35	6	9	3
0020	2F	22	16	22	6	2200	3140	940	0.27	1.43	3	5	2
0020	2F	22	23	7	2	700	930	230	0.29	1.33	1	1	0
0020	2F	22	24	11	3	1100	1790	690	0.27	1.63	1	3	2
0020	2F	22	25	6	2	600	540	-60	0.33	0.90	1	0	-1
0020	2F	22	26	2	0	200	0	-200	0.00	0.00	0	0	0
0020	2F	23	12	1604	534	160400	134350	-26050	0.33	0.84	283	237	-46
0020	2F	23	13	534	185	53400	40920	-12480	0.35	0.77	94	72	-22
0020	2F	23	14	275	68	27500	18390	-9110	0.25	0.67	48	32	-16
0020	2F	23	15	63	13	6300	4580	-1720	0.21	0.73	11	8	-3
0020	2F	23	16	18	3	1800	1120	-680	0.17	0.62	3	1	-2
0020	2F	23	23	12	2	1200	1110	-90	0.17	0.93	2	1	-1
0020	2F	23	24	5	0	500	0	-500	0.00	0.00	0	0	0
0020	2F	23	25	11	3	1100	1330	230	0.27	1.21	1	2	1
0020	2F	23	26	1	0	100	0	-100	0.00	0.00	0	0	0
0020	2F	24	12	1741	609	174100	141960	-32140	0.35	0.82	308	251	-57
0020	2F	24	13	558	223	55800	50010	-5790	0.40	0.90	98	88	-10
0020	2F	24	14	298	98	29800	23490	-6310	0.33	0.79	52	41	-11
0020	2F	24	15	74	29	7400	8320	920	0.39	1.12	13	14	1
0020	2F	24	16	79	24	7900	5140	-2760	0.30	0.65	13	9	-4
0020	2F	24	23	10	1	1000	690	-310	0.10	0.69	1	1	0
0020	2F	24	24	5	1	500	420	-80	0.20	0.84	0	0	0
0020	2F	24	25	1	0	100	0	-100	0.00	0.00	0	0	0
0020	2F	24	26	8	1	800	420	-380	0.13	0.53	1	0	-1
0020	2T	01	12	1602	385	160200	134190	-26010	0.24	0.84	283	237	-46
0020	2T	01	13	305	70	30500	22160	-8340	0.23	0.73	53	39	-14
0020	2T	01	14	251	34	25100	12600	-12500	0.14	0.50	44	22	-22
0020	2T	01	15	230	51	23000	17700	-5300	0.22	0.77	40	31	-9
0020	2T	01	16	29	1	2900	980	-1920	0.03	0.34	5	1	-4
0020	2T	01	21	1	0	100	0	-100	0.00	0.00	0	0	0
0020	2T	01	23	13	1	1300	600	-700	0.08	0.46	2	1	-1
0020	2T	01	24	6	1	600	440	-160	0.17	0.73	1	0	-1
0020	2T	01	25	2	0	200	0	-200	0.00	0.00	0	0	0
0020	2T	01	26	7	1	700	1330	630	0.14	1.90	1	2	1
0020	2T	02	12	1584	322	158400	145170	-13230	0.20	0.92	280	256	-24
0020	2T	02	13	442	79	44200	33660	-10540	0.18	0.76	78	59	-19
0020	2T	02	14	256	37	25600	22380	-3220	0.14	0.87	45	39	-6
0020	2T	02	15	70	8	7000	6120	-880	0.11	0.87	12	10	-2
0020	2T	02	16	50	6	5000	7020	2020	0.12	1.40	8	12	4
0020	2T	02	21	5	1	500	480	-20	0.20	0.96	0	0	0
0020	2T	02	23	26	5	2600	3060	460	0.19	1.18	4	5	1
0020	2T	02	24	5	1	500	580	80	0.20	1.16	0	1	1
0020	2T	02	25	4	0	400	0	-400	0.00	0.00	0	0	0
0020	2T	02	26	6	0	600	0	-600	0.00	0.00	1	0	-1
0020	2T	03	12	1011	222	101100	85780	-15320	0.22	0.85	178	151	-27
0020	2T	03	13	381	84	38100	35850	-2250	0.22	0.94	67	63	-4
0020	2T	03	14	222	27	22200	11220	-10980	0.12	0.51	39	19	-20
0020	2T	03	15	114	14	11400	10950	-450	0.12	0.96	20	19	-1
0020	2T	03	16	46	5	4600	3590	-1010	0.11	0.78	8	6	-2
0020	2T	03	21	2	0	200	0	-200	0.00	0.00	0	0	0
0020	2T	03	23	27	5	2700	3450	750	0.19	1.28	4	6	2
0020	2T	03	24	8	1	800	390	-410	0.13	0.49	1	0	-1
0020	2T	03	25	12	2	1200	970	-230	0.17	0.81	2	1	-1
0020	2T	03	26	6	0	600	0	-600	0.00	0.00	1	0	-1
0020	2T	04	12	1170	242	117000	106270	-10730	0.21	0.91	207	188	-19
0020	2T	04	13	517	105	51700	42080	-9620	0.20	0.81	91	74	-17
0020	2T	04	14	250	30	25000	14830	-10170	0.12	0.59	44	26	-18
0020	2T	04	15	125	14	12500	8910	-3590	0.11	0.71	22	15	-7
0020	2T	04	16	82	13	8200	8490	290	0.16	1.04	14	15	1
0020	2T	04	21	2	1	200	540	340	0.50	2.70	0	0	0
0020	2T	04	23	24	5	2400	2540	140	0.21	1.06	4	4	0
0020	2T	04	24	6	1	600	510	-90	0.17	0.85	1	0	-1
0020	2T	04	25	11	2	1100	1800	700	0.18	1.64	1	3	2
0020	2T	04	26	16	1	1600	450	-1150	0.06	0.28	2	0	-2
0020	2T	05	12	1395	319	139500	123140	-16360	0.23	0.88	246	217	-29
0020	2T	05	13	518	106	51800	39260	-12540	0.20	0.76	91	69	-22
0020	2T	05	14	347	80	34700	29520	-5180	0.23	0.85	61	52	-9
0020	2T	05	15	114	13	11400	6910	-4490	0.11	0.61	20	12	-8
0020	2T	05	16	69	9	6900	8810	1910	0.13	1.28	12	15	3
0020	2T	05	23	35	7	3500	3350	-150	0.20	0.96	6	5	-1
0020	2T	05	24	14	4	1400	1650	250	0.29	1.18	2	2	0
0020	2T	05	25	20	2	2000	1530	-470	0.10	0.77	3	2	-1
0020	2T	05	26	11	2	1100	910	-190	0.18	0.83	1	1	0
0020	2T	06	12	1477	341	147700	131900	-15800	0.23	0.89	261	233	-28
0020	2T	06	13	705	134	70500	48370	-22130	0.19	0.69	124	85	-39
0020	2T	06	14	325	66	32500	28070	-4430	0.20	0.86	57	49	-8
0020	2T	06	15	124	20	12400	9730	-2670	0.16	0.78	21	17	-4
0020	2T	06	16	73	14	7300	9770	2470	0.19	1.34	12	17	5
0020	2T	06	21	4	1	400	1210	810	0.25	3.03	0	2	2
0020	2T	06	23	28	3	2800	1320	-1480	0.11	0.47	4	2	-2
0020	2T	06	24	11	1	1100	1510	410	0.09	1.37	1	2	1
0020	2T	06	25	20	2	2000	3210	1210	0.10	1.61	3	5	2
0020	2T	06	26	14	1	1400	810	-590	0.07	0.58	2	1	-1
0020	2T	07	12	1448	338	144800	123060	-21740	0.23	0.85	256	217	-39
0020	2T	07	13	741	174	74100	60140	-13960	0.23	0.81	131	106	-25
0020	2T	07	14	394	87	39400	31300	-8100	0.22	0.79	69	55	-14
0020	2T	07	15	118	16	11800	8120	-3680	0.14	0.69	20	14	-6
0020	2T	07	16	63	14	6300	7880	1580	0.22	1.25	11	13	2
0020	2T	07	21	4	1	400	1870	1470	0.25	4.68	0	3	3
0020	2T	07	23	37	3	3700	2460	-1240	0.08	0.66	6	4	-2
0020	2T	07	24	8	2	800	1920	1120	0.25	2.40	1	3	2
0020	2T	07	25	16	0	1600	0	-1600	0.00	0.00	2	0	-2
0020	2T	07	26	12	1	1200	240	-960	0.08	0.20	2	0	-2
0020	2T	08	12	1501	392	150100	128780	-21320	0.26	0.86	265	227	-38
0020	2T	08	13	625	134	62500	47730	-14770	0.21	0.76	110	84	-26
0020	2T	08	14	318	66	31800	25560	-6240	0.21	0.80	56	45	-11
0020	2T	08	15	116	16	11600	9440	-2160	0.14	0.81	20	16	-4
0020	2T	08	16	130	25	13000	12040	-960	0.19	0.93	23	21	-2
0020	2T	08	21	6	0	600	0	-600	0.00	0.00	1	0	-1
0020	2T	08	23	14	3	1400	3160	1760	0.21	2.26	2	5	3
0020	2T	08	24	13	1	1300	480	-820	0.08	0.37	2	0	-2
0020	2T	08	25	9	1	900	520	-380	0.11	0.58	1	0	-1
0020	2T	08	26	12	0	1200	0	-1200	0.00	0.00	2	0	-2
0020	2T	09	12	1772	477	177200	140470	-36730	0.27	0.79	313	248	-65
0020	2T	09	13	603	133	60300	48610	-11690	0.22	0.81	106	86	-20
0020	2T	09	14	256	46	25600	19730	-5870	0.18	0.77	45	34	-11
0020	2T	09	15	95	12	9500	6610	-2890	0.13	0.70	16	11	-5
0020	2T	09	16	76	7	7600	5290	-2310	0.09	0.70	13	9	-4
0020	2T	09	21	5	1	500	580	80	0.20	1.16	0	1	1
0020	2T	09	23	27	3	2700	1680	-1020	0.11	0.62	4	2	-2
0020	2T	09	24	8	1	800	560	-240	0.13	0.70	1	0	-1
0020	2T	09	25	14	1	1400	430	-970	0.07	0.31	2	0	-2
0020	2T	09	26	31	0	3100	0	-3100	0.00	0.00	5	0	-5
0020	2T	10	12	1492	414	149200	115580	-33620	0.28	0.77	264	204	-60
0020	2T	10	13	688	170	68800	55670	-13130	0.25	0.81	121	98	-23
0020	2T	10	14	287	64	28700	23960	-4740	0.22	0.83	50	42	-8
0020	2T	10	15	75	7	7500	5000	-2500	0.09	0.67	13	8	-5
0020	2T	10	16	61	4	6100	4840	-1260	0.07	0.79	10	8	-2
0020	2T	10	21	2	0	200	0	-200	0.00	0.00	0	0	0
0020	2T	10	23	14	2	1400	1130	-270	0.14	0.81	2	2	0
0020	2T	10	24	12	3	1200	990	-210	0.25	0.83	2	1	-1
0020	2T	10	25	27	3	2700	1600	-1100	0.11	0.59	4	2	-2
0020	2T	10	26	22	6	2200	3520	1320	0.27	1.60	3	6	3
0020	2T	11	12	1659	401	165900	150380	-15520	0.24	0.91	293	266	-27
0020	2T	11	13	409	69	40900	25940	-14960	0.17	0.63	72	45	-27
0020	2T	11	14	165	23	16500	12030	-4470	0.14	0.73	29	21	-8
0020	2T	11	15	24	2	2400	870	-1530	0.08	0.36	4	1	-3
0020	2T	11	16	21	3	2100	3420	1320	0.14	1.63	3	6	3
0020	2T	11	21	17	4	1700	4220	2520	0.24	2.48	3	7	4
0020	2T	11	23	68	6	6800	4620	-2180	0.09	0.68	12	8	-4
0020	2T	11	24	26	2	2600	2400	-200	0.08	0.92	4	4	0
0020	2T	11	25	14	1	1400	440	-960	0.07	0.31	2	0	-2
0020	2T	12	12	1627	402	162700	130540	-32160	0.25	0.80	287	231	-56
0020	2T	12	13	401	94	40100	30190	-9910	0.23	0.75	70	53	-17
0020	2T	12	14	258	37	25800	15550	-10250	0.14	0.60	45	27	-18
0020	2T	12	15	126	24	12600	13050	450	0.19	1.04	22	23	1
0020	2T	12	16	73	15	7300	6650	-650	0.21	0.91	12	11	-1
0020	2T	12	21	3	0	300	0	-300	0.00	0.00	0	0	0
0020	2T	12	23	17	3	1700	1060	-640	0.18	0.62	3	1	-2
0020	2T	12	24	13	3	1300	2740	1440	0.23	2.11	2	4	2
0020	2T	12	25	11	1	1100	460	-640	0.09	0.42	1	0	-1
0020	2T	12	26	7	1	700	1930	1230	0.14	2.76	1	3	2
0020	2T	13	12	1383	357	138300	114810	-23490	0.26	0.83	244	203	-41
0020	2T	13	13	516	117	51600	37450	-14150	0.23	0.73	91	66	-25
0020	2T	13	14	309	87	30900	28750	-2150	0.28	0.93	54	50	-4
0020	2T	13	15	115	21	11500	10000	-1500	0.18	0.87	20	17	-3
0020	2T	13	16	74	13	7400	7090	-310	0.18	0.96	13	12	-1
0020	2T	13	23	18	2	1800	850	-950	0.11	0.47	3	1	-2
0020	2T	13	24	11	0	1100	0	-1100	0.00	0.00	1	0	-1
0020	2T	13	25	7	0	700	0	-700	0.00	0.00	1	0	-1
0020	2T	13	26	7	0	700	0	-700	0.00	0.00	1	0	-1
0020	2T	14	12	1359	281	135900	94030	-41870	0.21	0.69	240	166	-74
0020	2T	14	13	393	73	39300	26430	-12870	0.19	0.67	69	46	-23
0020	2T	14	14	357	63	35700	23500	-12200	0.18	0.66	63	41	-22
0020	2T	14	15	103	15	10300	8960	-1340	0.15	0.87	18	15	-3
0020	2T	14	16	64	7	6400	4480	-1920	0.11	0.70	11	7	-4
0020	2T	14	21	1	0	100	0	-100	0.00	0.00	0	0	0
0020	2T	14	23	25	5	2500	2900	400	0.20	1.16	4	5	1
0020	2T	14	24	22	2	2200	1540	-660	0.09	0.70	3	2	-1
0020	2T	14	25	8	2	800	2060	1260	0.25	2.58	1	3	2
0020	2T	14	26	10	2	1000	1060	60	0.20	1.06	1	1	0
0020	2T	15	12	1674	386	167400	120370	-47030	0.23	0.72	296	213	-83
0020	2T	15	13	608	131	60800	44940	-15860	0.22	0.74	107	79	-28
0020	2T	15	14	322	59	32200	23820	-8380	0.18	0.74	56	42	-14
0020	2T	15	15	117	16	11700	10760	-940	0.14	0.92	20	19	-1
0020	2T	15	16	84	22	8400	12680	4280	0.26	1.51	14	22	8
0020	2T	15	21	1	0	100	0	-100	0.00	0.00	0	0	0
0020	2T	15	23	33	5	3300	2550	-750	0.15	0.77	5	4	-1
0020	2T	15	24	8	1	800	1640	840	0.13	2.05	1	2	1
0020	2T	15	25	14	0	1400	0	-1400	0.00	0.00	2	0	-2
0020	2T	15	26	18	1	1800	620	-1180	0.06	0.34	3	1	-2
0020	2T	16	12	1600	437	160000	136060	-23940	0.27	0.85	283	240	-43
0020	2T	16	13	543	109	54300	36770	-17530	0.20	0.68	96	65	-31
0020	2T	16	14	463	126	46300	44370	-1930	0.27	0.96	81	78	-3
0020	2T	16	15	105	13	10500	7620	-2880	0.12	0.73	18	13	-5
0020	2T	16	16	99	10	9900	8290	-1610	0.10	0.84	17	14	-3
0020	2T	16	21	3	1	300	900	600	0.33	3.00	0	1	1
0020	2T	16	23	18	4	1800	2480	680	0.22	1.38	3	4	1
0020	2T	16	24	11	2	1100	1020	-80	0.18	0.93	1	1	0
0020	2T	16	25	20	5	2000	5250	3250	0.25	2.63	3	9	6
0020	2T	16	26	19	0	1900	0	-1900	0.00	0.00	3	0	-3
0020	2T	17	12	1633	401	163300	119150	-44150	0.25	0.73	289	210	-79
0020	2T	17	13	654	186	65400	55060	-10340	0.28	0.84	115	97	-18
0020	2T	17	14	320	67	32000	27050	-4950	0.21	0.85	56	47	-9
0020	2T	17	15	85	11	8500	6680	-1820	0.13	0.79	15	11	-4
0020	2T	17	16	24	2	2400	1560	-840	0.08	0.65	4	2	-2
0020	2T	17	21	1	0	100	0	-100	0.00	0.00	0	0	0
0020	2T	17	23	25	1	2500	1160	-1340	0.04	0.46	4	2	-2
0020	2T	17	24	13	2	1300	1000	-300	0.15	0.77	2	1	-1
0020	2T	17	25	19	5	1900	3220	1320	0.26	1.69	3	5	2
0020	2T	17	26	3	2	300	2370	2070	0.67	7.90	0	4	4
0020	2T	18	12	1808	577	180800	157430	-23370	0.32	0.87	320	278	-42
0020	2T	18	13	582	143	58200	47690	-10510	0.25	0.82	103	84	-19
0020	2T	18	14	345	90	34500	30940	-3560	0.26	0.90	61	54	-7
0020	2T	18	15	135	26	13500	12000	-1500	0.19	0.89	23	21	-2
0020	2T	18	16	81	13	8100	10290	2190	0.16	1.27	14	18	4
0020	2T	18	21	2	0	200	0	-200	0.00	0.00	0	0	0
0020	2T	18	23	21	3	2100	1690	-410	0.14	0.80	3	2	-1
0020	2T	18	24	9	0	900	0	-900	0.00	0.00	1	0	-1
0020	2T	18	25	10	0	1000	0	-1000	0.00	0.00	1	0	-1
0020	2T	18	26	27	3	2700	2080	-620	0.11	0.77	4	3	-1
0020	2T	19	12	1278	319	127800	99360	-28440	0.25	0.78	226	175	-51
0020	2T	19	13	664	163	66400	49780	-16620	0.25	0.75	117	88	-29
0020	2T	19	14	414	109	41400	33800	-7600	0.26	0.82	73	59	-14
0020	2T	19	15	48	2	4800	1230	-3570	0.04	0.26	8	2	-6
0020	2T	19	16	66	7	6600	3370	-3230	0.11	0.51	11	5	-6
0020	2T	19	21	4	0	400	0	-400	0.00	0.00	0	0	0
0020	2T	19	23	13	2	1300	2170	870	0.15	1.67	2	3	1
0020	2T	19	24	15	2	1500	1510	10	0.13	1.01	2	2	0
0020	2T	19	25	8	0	800	0	-800	0.00	0.00	1	0	-1
0020	2T	19	26	20	1	2000	310	-1690	0.05	0.16	3	0	-3
0020	2T	20	12	1584	408	158400	127720	-30680	0.26	0.81	280	226	-54
0020	2T	20	13	642	161	64200	52040	-12160	0.25	0.81	113	92	-21
0020	2T	20	14	369	75	36900	26670	-10230	0.20	0.72	65	47	-18
0020	2T	20	15	133	29	13300	14710	1410	0.22	1.11	23	26	3
0020	2T	20	16	83	11	8300	6430	-1870	0.13	0.77	14	11	-3
0020	2T	20	21	3	0	300	0	-300	0.00	0.00	0	0	0
0020	2T	20	23	11	1	1100	480	-620	0.09	0.44	1	0	-1
0020	2T	20	24	3	0	300	0	-300	0.00	0.00	0	0	0
0020	2T	20	25	7	1	700	360	-340	0.14	0.51	1	0	-1
0020	2T	20	26	6	1	600	650	50	0.17	1.08	1	1	0
0020	2T	21	12	1686	448	168600	131450	-37150	0.27	0.78	298	232	-66
0020	2T	21	13	770	244	77000	70740	-6260	0.32	0.92	136	125	-11
0020	2T	21	14	443	121	44300	34650	-9650	0.27	0.78	78	61	-17
0020	2T	21	15	77	14	7700	5860	-1840	0.18	0.76	13	10	-3
0020	2T	21	16	30	5	3000	3010	10	0.17	1.00	5	5	0
0020	2T	21	21	1	0	100	0	-100	0.00	0.00	0	0	0
0020	2T	21	23	6	0	600	0	-600	0.00	0.00	1	0	-1
0020	2T	21	24	4	0	400	0	-400	0.00	0.00	0	0	0
0020	2T	21	25	4	0	400	0	-400	0.00	0.00	0	0	0
0020	2T	21	26	8	1	800	540	-260	0.13	0.68	1	0	-1
0020	2T	22	12	1436	372	143600	132430	-11170	0.26	0.92	254	234	-20
0020	2T	22	13	343	80	34300	28240	-6060	0.23	0.82	60	49	-11
0020	2T	22	14	329	61	32900	23900	-9000	0.19	0.73	58	42	-16
0020	2T	22	15	39	7	3900	4000	100	0.18	1.03	6	7	1
0020	2T	22	16	22	5	2200	2890	690	0.23	1.31	3	5	2
0020	2T	22	21	5	0	500	0	-500	0.00	0.00	0	0	0
0020	2T	22	23	7	0	700	0	-700	0.00	0.00	1	0	-1
0020	2T	22	24	11	1	1100	2420	1320	0.09	2.20	1	4	3
0020	2T	22	25	6	1	600	590	-10	0.17	0.98	1	1	0
0020	2T	22	26	2	0	200	0	-200	0.00	0.00	0	0	0
0020	2T	23	12	1603	367	160300	113590	-46710	0.23	0.71	283	201	-82
0020	2T	23	13	534	124	53400	37510	-15890	0.23	0.70	94	66	-28
0020	2T	23	14	275	49	27500	21530	-5970	0.18	0.78	48	38	-10
0020	2T	23	15	63	8	6300	3400	-2900	0.13	0.54	11	6	-5
0020	2T	23	16	18	2	1800	1070	-730	0.11	0.59	3	1	-2
0020	2T	23	21	1	0	100	0	-100	0.00	0.00	0	0	0
0020	2T	23	23	12	0	1200	0	-1200	0.00	0.00	2	0	-2
0020	2T	23	24	5	0	500	0	-500	0.00	0.00	0	0	0
0020	2T	23	25	11	1	1100	2070	970	0.09	1.88	1	3	2
0020	2T	23	26	1	0	100	0	-100	0.00	0.00	0	0	0
0020	2T	24	12	1739	519	173900	144270	-29630	0.30	0.83	307	255	-52
0020	2T	24	13	558	164	55800	46610	-9190	0.29	0.84	98	82	-16
0020	2T	24	14	298	79	29800	27150	-2650	0.27	0.91	52	48	-4
0020	2T	24	15	74	23	7400	7950	550	0.31	1.07	13	14	1
0020	2T	24	16	79	14	7900	4680	-3220	0.18	0.59	13	8	-5
0020	2T	24	21	2	0	200	0	-200	0.00	0.00	0	0	0
0020	2T	24	23	10	1	1000	820	-180	0.10	0.82	1	1	0
0020	2T	24	24	5	1	500	710	210	0.20	1.42	0	1	1
0020	2T	24	25	1	0	100	0	-100	0.00	0.00	0	0	0
0020	2T	24	26	8	1	800	920	120	0.13	1.15	1	1	0
0020	3F	01	123	181	47	18100	12920	-5180	0.26	0.71	32	22	-10
0020	3F	01	124	957	160	95700	72450	-23250	0.17	0.76	169	128	-41
0020	3F	01	125	247	43	24700	16880	-7820	0.17	0.68	43	29	-14
0020	3F	01	126	214	30	21400	15910	-5490	0.14	0.74	37	28	-9
0020	3F	01	134	115	21	11500	8560	-2940	0.18	0.74	20	15	-5
0020	3F	01	135	83	19	8300	9350	1050	0.23	1.13	14	16	2
0020	3F	01	136	59	10	5900	3510	-2390	0.17	0.59	10	6	-4
0020	3F	01	145	69	4	6900	1780	-5120	0.06	0.26	12	3	-9
0020	3F	01	146	42	8	4200	5110	910	0.19	1.22	7	9	2
0020	3F	01	156	14	2	1400	1020	-380	0.14	0.73	2	1	-1
0020	3F	01	234	8	4	800	1180	380	0.50	1.48	1	2	1
0020	3F	01	235	2	1	200	550	350	0.50	2.75	0	0	0
0020	3F	01	246	2	0	200	0	-200	0.00	0.00	0	0	0
0020	3F	02	123	231	66	23100	21940	-1160	0.29	0.95	40	38	-2
0020	3F	02	124	713	95	71300	46360	-24940	0.13	0.65	126	82	-44
0020	3F	02	125	265	30	26500	16340	-10160	0.11	0.62	46	28	-18
0020	3F	02	126	342	36	34200	26420	-7780	0.11	0.77	60	46	-14
0020	3F	02	134	145	23	14500	10220	-4280	0.16	0.70	25	18	-7
0020	3F	02	135	88	14	8800	7040	-1760	0.16	0.80	15	12	-3
0020	3F	02	136	141	26	14100	17500	3400	0.18	1.24	24	30	6
0020	3F	02	145	48	7	4800	5650	850	0.15	1.18	8	10	2
0020	3F	02	146	76	14	7600	11620	4020	0.18	1.53	13	20	7
0020	3F	02	156	13	4	1300	3910	2610	0.31	3.01	2	6	4
0020	3F	02	234	12	2	1200	620	-580	0.17	0.52	2	1	-1
0020	3F	02	235	3	0	300	0	-300	0.00	0.00	0	0	0
0020	3F	02	236	7	0	700	0	-700	0.00	0.00	1	0	-1
0020	3F	02	245	3	1	300	360	60	0.33	1.20	0	0	0
0020	3F	02	246	1	0	100	0	-100	0.00	0.00	0	0	0
0020	3F	02	256	1	0	100	0	-100	0.00	0.00	0	0	0
0020	3F	03	123	162	47	16200	14320	-1880	0.29	0.88	28	25	-3
0020	3F	03	124	423	69	42300	31130	-11170	0.16	0.74	74	55	-19
0020	3F	03	125	210	34	21000	18610	-2390	0.16	0.89	37	32	-5
0020	3F	03	126	192	30	19200	21800	2600	0.16	1.14	33	38	5
0020	3F	03	134	142	29	14200	10960	-3240	0.20	0.77	25	19	-6
0020	3F	03	135	97	17	9700	9690	-10	0.18	1.00	17	17	0
0020	3F	03	136	84	10	8400	4900	-3500	0.12	0.58	14	8	-6
0020	3F	03	145	52	9	5200	4230	-970	0.17	0.81	9	7	-2
0020	3F	03	146	50	3	5000	1120	-3880	0.06	0.22	8	1	-7
0020	3F	03	156	27	3	2700	1960	-740	0.11	0.73	4	3	-1
0020	3F	03	234	8	1	800	240	-560	0.13	0.30	1	0	-1
0020	3F	03	235	6	0	600	0	-600	0.00	0.00	1	0	-1
0020	3F	03	236	5	1	500	410	-90	0.20	0.82	0	0	0
0020	3F	03	245	2	0	200	0	-200	0.00	0.00	0	0	0
0020	3F	03	256	2	0	200	0	-200	0.00	0.00	0	0	0
0020	3F	04	123	136	30	13600	9330	-4270	0.22	0.69	24	16	-8
0020	3F	04	124	478	90	47800	37560	-10240	0.19	0.79	84	66	-18
0020	3F	04	125	228	39	22800	20570	-2230	0.17	0.90	40	36	-4
0020	3F	04	126	293	40	29300	21130	-8170	0.14	0.72	51	37	-14
0020	3F	04	134	179	36	17900	13500	-4400	0.20	0.75	31	23	-8
0020	3F	04	135	119	14	11900	5540	-6360	0.12	0.47	21	9	-12
0020	3F	04	136	127	16	12700	9270	-3430	0.13	0.73	22	16	-6
0020	3F	04	145	56	6	5600	2700	-2900	0.11	0.48	9	4	-5
0020	3F	04	146	65	8	6500	3510	-2990	0.12	0.54	11	6	-5
0020	3F	04	156	27	5	2700	3020	320	0.19	1.12	4	5	1
0020	3F	04	234	7	1	700	210	-490	0.14	0.30	1	0	-1
0020	3F	04	235	5	2	500	430	-70	0.40	0.86	0	0	0
0020	3F	04	236	6	2	600	1740	1140	0.33	2.90	1	3	2
0020	3F	04	246	3	0	300	0	-300	0.00	0.00	0	0	0
0020	3F	05	123	161	46	16100	16090	-10	0.29	1.00	28	28	0
0020	3F	05	124	580	116	58000	43700	-14300	0.20	0.75	102	77	-25
0020	3F	05	125	205	34	20500	16400	-4100	0.17	0.80	36	29	-7
0020	3F	05	126	384	47	38400	33530	-4870	0.12	0.87	67	59	-8
0020	3F	05	134	143	26	14300	10040	-4260	0.18	0.70	25	17	-8
0020	3F	05	135	123	26	12300	9420	-2880	0.21	0.77	21	16	-5
0020	3F	05	136	163	26	16300	16200	-100	0.16	0.99	28	28	0
0020	3F	05	145	45	9	4500	5690	1190	0.20	1.26	7	10	3
0020	3F	05	146	41	3	4100	1370	-2730	0.07	0.33	7	2	-5
0020	3F	05	156	32	7	3200	3980	780	0.22	1.24	5	7	2
0020	3F	05	234	8	1	800	280	-520	0.13	0.35	1	0	-1
0020	3F	05	235	7	1	700	310	-390	0.14	0.44	1	0	-1
0020	3F	05	236	11	1	1100	140	-960	0.09	0.13	1	0	-1
0020	3F	05	245	4	1	400	240	-160	0.25	0.60	0	0	0
0020	3F	05	246	4	0	400	0	-400	0.00	0.00	0	0	0
0020	3F	05	256	4	0	400	0	-400	0.00	0.00	0	0	0
0020	3F	06	123	213	73	21300	22400	1100	0.34	1.05	37	39	2
0020	3F	06	124	584	126	58400	43300	-15100	0.22	0.74	103	76	-27
0020	3F	06	125	234	48	23400	18260	-5140	0.21	0.78	41	32	-9
0020	3F	06	126	373	53	37300	32700	-4600	0.14	0.88	66	57	-9
0020	3F	06	134	192	34	19200	9570	-9630	0.18	0.50	33	16	-17
0020	3F	06	135	146	35	14600	12570	-2030	0.24	0.86	25	22	-3
0020	3F	06	136	217	30	21700	13390	-8310	0.14	0.62	38	23	-15
0020	3F	06	145	51	14	5100	6010	910	0.27	1.18	9	10	1
0020	3F	06	146	65	8	6500	2780	-3720	0.12	0.43	11	4	-7
0020	3F	06	156	40	9	4000	3960	-40	0.23	0.99	7	7	0
0020	3F	06	234	5	2	500	570	70	0.40	1.14	0	1	1
0020	3F	06	235	11	4	1100	1960	860	0.36	1.78	1	3	2
0020	3F	06	236	8	0	800	0	-800	0.00	0.00	1	0	-1
0020	3F	06	245	3	1	300	440	140	0.33	1.47	0	0	0
0020	3F	06	246	2	1	200	160	-40	0.50	0.80	0	0	0
0020	3F	06	256	3	0	300	0	-300	0.00	0.00	0	0	0
0020	3F	07	123	210	44	21000	13230	-7770	0.21	0.63	37	23	-14
0020	3F	07	124	585	113	58500	39690	-18810	0.19	0.68	103	70	-33
0020	3F	07	125	296	52	29600	25570	-4030	0.18	0.86	52	45	-7
0020	3F	07	126	314	51	31400	33750	2350	0.16	1.07	55	59	4
0020	3F	07	134	321	87	32100	28330	-3770	0.27	0.88	56	50	-6
0020	3F	07	135	159	25	15900	8570	-7330	0.16	0.54	28	15	-13
0020	3F	07	136	127	22	12700	9430	-3270	0.17	0.74	22	16	-6
0020	3F	07	145	118	27	11800	9070	-2730	0.23	0.77	20	16	-4
0020	3F	07	146	41	8	4100	5600	1500	0.20	1.37	7	9	2
0020	3F	07	156	29	9	2900	3960	1060	0.31	1.37	5	7	2
0020	3F	07	234	4	0	400	0	-400	0.00	0.00	0	0	0
0020	3F	07	235	10	2	1000	460	-540	0.20	0.46	1	0	-1
0020	3F	07	236	11	1	1100	400	-700	0.09	0.36	1	0	-1
0020	3F	07	245	1	0	100	0	-100	0.00	0.00	0	0	0
0020	3F	07	256	3	1	300	460	160	0.33	1.53	0	0	0
0020	3F	08	123	199	55	19900	14220	-5680	0.28	0.71	35	25	-10
0020	3F	08	124	681	153	68100	59570	-8530	0.22	0.87	120	105	-15
0020	3F	08	125	306	43	30600	17950	-12650	0.14	0.59	54	31	-23
0020	3F	08	126	285	51	28500	22720	-5780	0.18	0.80	50	40	-10
0020	3F	08	134	229	56	22900	17510	-5390	0.24	0.76	40	30	-10
0020	3F	08	135	145	20	14500	7300	-7200	0.14	0.50	25	12	-13
0020	3F	08	136	142	23	14200	7010	-7190	0.16	0.49	25	12	-13
0020	3F	08	145	77	18	7700	6010	-1690	0.23	0.78	13	10	-3
0020	3F	08	146	57	10	5700	3100	-2600	0.18	0.54	10	5	-5
0020	3F	08	156	25	2	2500	790	-1710	0.08	0.32	4	1	-3
0020	3F	08	234	3	0	300	0	-300	0.00	0.00	0	0	0
0020	3F	08	236	5	2	500	740	240	0.40	1.48	0	1	1
0020	3F	08	245	1	0	100	0	-100	0.00	0.00	0	0	0
0020	3F	09	123	348	103	34800	28210	-6590	0.30	0.81	61	49	-12
0020	3F	09	124	797	176	79700	66520	-13180	0.22	0.83	141	117	-24
0020	3F	09	125	275	64	27500	25540	-1960	0.23	0.93	48	45	-3
0020	3F	09	126	259	38	25900	23180	-2720	0.15	0.89	45	41	-4
0020	3F	09	134	220	53	22000	16970	-5030	0.24	0.77	38	30	-8
0020	3F	09	135	140	28	14000	12570	-1430	0.20	0.90	24	22	-2
0020	3F	09	136	131	16	13100	12660	-440	0.12	0.97	23	22	-1
0020	3F	09	145	39	3	3900	1450	-2450	0.08	0.37	6	2	-4
0020	3F	09	146	48	8	4800	6810	2010	0.17	1.42	8	12	4
0020	3F	09	156	27	2	2700	550	-2150	0.07	0.20	4	0	-4
0020	3F	09	234	9	1	900	440	-460	0.11	0.49	1	0	-1
0020	3F	09	235	9	1	900	280	-620	0.11	0.31	1	0	-1
0020	3F	09	236	6	0	600	0	-600	0.00	0.00	1	0	-1
0020	3F	09	245	2	0	200	0	-200	0.00	0.00	0	0	0
0020	3F	09	246	2	1	200	380	180	0.50	1.90	0	0	0
0020	3F	09	256	5	1	500	380	-120	0.20	0.76	0	0	0
0020	3F	10	123	460	153	46000	36520	-9480	0.33	0.79	81	64	-17
0020	3F	10	124	592	143	59200	49490	-9710	0.24	0.84	104	87	-17
0020	3F	10	125	222	45	22200	20070	-2130	0.20	0.90	39	35	-4
0020	3F	10	126	157	19	15700	14220	-1480	0.12	0.91	27	25	-2
0020	3F	10	134	187	41	18700	13630	-5070	0.22	0.73	33	24	-9
0020	3F	10	135	136	19	13600	8630	-4970	0.14	0.63	24	15	-9
0020	3F	10	136	94	11	9400	5950	-3450	0.12	0.63	16	10	-6
0020	3F	10	145	55	10	5500	4530	-970	0.18	0.82	9	8	-1
0020	3F	10	146	40	4	4000	2050	-1950	0.10	0.51	7	3	-4
0020	3F	10	156	18	4	1800	2720	920	0.22	1.51	3	4	1
0020	3F	10	234	2	0	200	0	-200	0.00	0.00	0	0	0
0020	3F	10	235	5	0	500	0	-500	0.00	0.00	0	0	0
0020	3F	10	236	3	0	300	0	-300	0.00	0.00	0	0	0
0020	3F	10	245	5	0	500	0	-500	0.00	0.00	0	0	0
0020	3F	10	246	2	0	200	0	-200	0.00	0.00	0	0	0
0020	3F	10	256	3	0	300	0	-300	0.00	0.00	0	0	0
0020	3F	11	123	568	144	56800	52630	-4170	0.25	0.93	100	93	-7
0020	3F	11	124	640	105	64000	50610	-13390	0.16	0.79	113	89	-24
0020	3F	11	125	8	1	800	210	-590	0.13	0.26	1	0	-1
0020	3F	11	126	460	58	46000	55890	9890	0.13	1.22	81	98	17
0020	3F	11	134	196	27	19600	9990	-9610	0.14	0.51	34	17	-17
0020	3F	11	135	14	1	1400	320	-1080	0.07	0.23	2	0	-2
0020	3F	11	136	148	7	14800	4290	-10510	0.05	0.29	26	7	-19
0020	3F	11	145	4	0	400	0	-400	0.00	0.00	0	0	0
0020	3F	11	146	70	15	7000	8730	1730	0.21	1.25	12	15	3
0020	3F	11	156	8	1	800	1490	690	0.13	1.86	1	2	1
0020	3F	11	234	31	4	3100	2510	-590	0.13	0.81	5	4	-1
0020	3F	11	235	1	0	100	0	-100	0.00	0.00	0	0	0
0020	3F	11	236	39	4	3900	5820	1920	0.10	1.49	6	10	4
0020	3F	11	245	3	1	300	610	310	0.33	2.03	0	1	1
0020	3F	11	246	18	2	1800	3000	1200	0.11	1.67	3	5	2
0020	3F	11	256	11	2	1100	500	-600	0.18	0.45	1	0	-1
0020	3F	12	123	163	47	16300	15460	-840	0.29	0.95	28	27	-1
0020	3F	12	124	1098	180	109800	77790	-32010	0.16	0.71	194	137	-57
0020	3F	12	125	121	18	12100	10030	-2070	0.15	0.83	21	17	-4
0020	3F	12	126	233	37	23300	17850	-5450	0.16	0.77	41	31	-10
0020	3F	12	134	181	36	18100	16040	-2060	0.20	0.89	32	28	-4
0020	3F	12	135	77	17	7700	5730	-1970	0.22	0.74	13	10	-3
0020	3F	12	136	103	21	10300	9500	-800	0.20	0.92	18	16	-2
0020	3F	12	145	66	16	6600	9580	2980	0.24	1.45	11	16	5
0020	3F	12	146	58	4	5800	3940	-1860	0.07	0.68	10	6	-4
0020	3F	12	156	22	4	2200	1510	-690	0.18	0.69	3	2	-1
0020	3F	12	234	8	3	800	1480	680	0.38	1.85	1	2	1
0020	3F	12	235	6	0	600	0	-600	0.00	0.00	1	0	-1
0020	3F	12	236	1	0	100	0	-100	0.00	0.00	0	0	0
0020	3F	12	245	3	0	300	0	-300	0.00	0.00	0	0	0
0020	3F	12	246	1	0	100	0	-100	0.00	0.00	0	0	0
0020	3F	13	123	139	33	13900	9410	-4490	0.24	0.68	24	16	-8
0020	3F	13	124	722	149	72200	56710	-15490	0.21	0.79	127	100	-27
0020	3F	13	125	274	42	27400	17010	-10390	0.15	0.62	48	30	-18
0020	3F	13	126	240	48	24000	29900	5900	0.20	1.25	42	52	10
0020	3F	13	134	219	57	21900	18150	-3750	0.26	0.83	38	32	-6
0020	3F	13	135	121	28	12100	11090	-1010	0.23	0.92	21	19	-2
0020	3F	13	136	105	23	10500	8410	-2090	0.22	0.80	18	14	-4
0020	3F	13	145	61	9	6100	3340	-2760	0.15	0.55	10	5	-5
0020	3F	13	146	58	8	5800	3870	-1930	0.14	0.67	10	6	-4
0020	3F	13	156	15	4	1500	2220	720	0.27	1.48	2	3	1
0020	3F	13	234	10	1	1000	250	-750	0.10	0.25	1	0	-1
0020	3F	13	235	2	1	200	290	90	0.50	1.45	0	0	0
0020	3F	13	236	2	0	200	0	-200	0.00	0.00	0	0	0
0020	3F	13	245	2	1	200	380	180	0.50	1.90	0	0	0
0020	3F	13	246	1	0	100	0	-100	0.00	0.00	0	0	0
0020	3F	14	123	177	56	17700	18080	380	0.32	1.02	31	32	1
0020	3F	14	124	611	122	61100	41890	-19210	0.20	0.69	108	74	-34
0020	3F	14	125	228	38	22800	18510	-4290	0.17	0.81	40	32	-8
0020	3F	14	126	279	30	27900	20740	-7160	0.11	0.74	49	36	-13
0020	3F	14	134	125	24	12500	9080	-3420	0.19	0.73	22	16	-6
0020	3F	14	135	94	15	9400	6220	-3180	0.16	0.66	16	11	-5
0020	3F	14	136	108	14	10800	8510	-2290	0.13	0.79	19	15	-4
0020	3F	14	145	66	6	6600	2860	-3740	0.09	0.43	11	5	-6
0020	3F	14	146	74	4	7400	2220	-5180	0.05	0.30	13	3	-10
0020	3F	14	156	37	9	3700	4770	1070	0.24	1.29	6	8	2
0020	3F	14	234	10	1	1000	550	-450	0.10	0.55	1	0	-1
0020	3F	14	235	4	1	400	500	100	0.25	1.25	0	0	0
0020	3F	14	236	7	3	700	1990	1290	0.43	2.84	1	3	2
0020	3F	14	245	1	0	100	0	-100	0.00	0.00	0	0	0
0020	3F	14	246	1	0	100	0	-100	0.00	0.00	0	0	0
0020	3F	15	123	217	57	21700	16570	-5130	0.26	0.76	38	29	-9
0020	3F	15	124	808	203	80800	59450	-21350	0.25	0.74	143	105	-38
0020	3F	15	125	244	42	24400	22190	-2210	0.17	0.91	43	39	-4
0020	3F	15	126	365	50	36500	32540	-3960	0.14	0.89	64	57	-7
0020	3F	15	134	252	67	25200	19870	-5330	0.27	0.79	44	35	-9
0020	3F	15	135	110	21	11000	9250	-1750	0.19	0.84	19	16	-3
0020	3F	15	136	163	25	16300	13380	-2920	0.15	0.82	28	23	-5
0020	3F	15	145	30	3	3000	1100	-1900	0.10	0.37	5	1	-4
0020	3F	15	146	39	6	3900	6970	3070	0.15	1.79	6	12	6
0020	3F	15	156	45	8	4500	5160	660	0.18	1.15	7	9	2
0020	3F	15	234	9	3	900	1010	110	0.33	1.12	1	1	0
0020	3F	15	235	4	0	400	0	-400	0.00	0.00	0	0	0
0020	3F	15	236	10	0	1000	0	-1000	0.00	0.00	1	0	-1
0020	3F	15	246	1	0	100	0	-100	0.00	0.00	0	0	0
0020	3F	15	256	7	0	700	0	-700	0.00	0.00	1	0	-1
0020	3F	16	123	318	111	31800	22890	-8910	0.35	0.72	56	40	-16
0020	3F	16	124	681	142	68100	56520	-11580	0.21	0.83	120	100	-20
0020	3F	16	125	205	35	20500	13700	-6800	0.17	0.67	36	24	-12
0020	3F	16	126	317	51	31700	25890	-5810	0.16	0.82	56	45	-11
0020	3F	16	134	160	32	16000	10250	-5750	0.20	0.64	28	18	-10
0020	3F	16	135	88	18	8800	6370	-2430	0.20	0.72	15	11	-4
0020	3F	16	136	149	20	14900	11120	-3780	0.13	0.75	26	19	-7
0020	3F	16	145	70	16	7000	7220	220	0.23	1.03	12	12	0
0020	3F	16	146	50	8	5000	4360	-640	0.16	0.87	8	7	-1
0020	3F	16	156	38	8	3800	5700	1900	0.21	1.50	6	10	4
0020	3F	16	234	3	0	300	0	-300	0.00	0.00	0	0	0
0020	3F	16	235	6	1	600	240	-360	0.17	0.40	1	0	-1
0020	3F	16	236	6	3	600	1140	540	0.50	1.90	1	2	1
0020	3F	16	245	2	0	200	0	-200	0.00	0.00	0	0	0
0020	3F	16	246	2	0	200	0	-200	0.00	0.00	0	0	0
0020	3F	16	256	11	2	1100	450	-650	0.18	0.41	1	0	-1
0020	3F	17	123	340	115	34000	29690	-4310	0.34	0.87	60	52	-8
0020	3F	17	124	676	121	67600	43000	-24600	0.18	0.64	119	76	-43
0020	3F	17	125	235	45	23500	17900	-5600	0.19	0.76	41	31	-10
0020	3F	17	126	286	30	28600	21250	-7350	0.10	0.74	50	37	-13
0020	3F	17	134	225	41	22500	13390	-9110	0.18	0.60	39	23	-16
0020	3F	17	135	109	15	10900	5920	-4980	0.14	0.54	19	10	-9
0020	3F	17	136	105	18	10500	12790	2290	0.17	1.22	18	22	4
0020	3F	17	145	48	8	4800	3140	-1660	0.17	0.65	8	5	-3
0020	3F	17	146	39	7	3900	5010	1110	0.18	1.28	6	8	2
0020	3F	17	156	16	1	1600	440	-1160	0.06	0.28	2	0	-2
0020	3F	17	234	4	0	400	0	-400	0.00	0.00	0	0	0
0020	3F	17	235	7	3	700	1130	430	0.43	1.61	1	2	1
0020	3F	17	236	7	1	700	570	-130	0.14	0.81	1	1	0
0020	3F	17	246	3	1	300	460	160	0.33	1.53	0	0	0
0020	3F	17	256	4	0	400	0	-400	0.00	0.00	0	0	0
0020	3F	18	123	219	57	21900	19110	-2790	0.26	0.87	38	33	-5
0020	3F	18	124	804	179	80400	62030	-18370	0.22	0.77	142	109	-33
0020	3F	18	125	398	84	39800	33290	-6510	0.21	0.84	70	58	-12
0020	3F	18	126	242	43	24200	23790	-410	0.18	0.98	42	42	0
0020	3F	18	134	184	47	18400	15480	-2920	0.26	0.84	32	27	-5
0020	3F	18	135	175	40	17500	13310	-4190	0.23	0.76	30	23	-7
0020	3F	18	136	137	23	13700	9940	-3760	0.17	0.73	24	17	-7
0020	3F	18	145	91	17	9100	9120	20	0.19	1.00	16	16	0
0020	3F	18	146	45	10	4500	3450	-1050	0.22	0.77	7	6	-1
0020	3F	18	156	16	1	1600	750	-850	0.06	0.47	2	1	-1
0020	3F	18	234	7	3	700	1200	500	0.43	1.71	1	2	1
0020	3F	18	235	4	1	400	190	-210	0.25	0.48	0	0	0
0020	3F	18	236	8	1	800	540	-260	0.13	0.68	1	0	-1
0020	3F	18	245	3	0	300	0	-300	0.00	0.00	0	0	0
0020	3F	18	246	2	0	200	0	-200	0.00	0.00	0	0	0
0020	3F	19	123	165	40	16500	12600	-3900	0.24	0.76	29	22	-7
0020	3F	19	124	689	154	68900	49080	-19820	0.22	0.71	121	86	-35
0020	3F	19	125	196	35	19600	17610	-1990	0.18	0.90	34	31	-3
0020	3F	19	126	183	24	18300	13850	-4450	0.13	0.76	32	24	-8
0020	3F	19	134	240	69	24000	21270	-2730	0.29	0.89	42	37	-5
0020	3F	19	135	129	29	12900	10440	-2460	0.22	0.81	22	18	-4
0020	3F	19	136	142	27	14200	9620	-4580	0.19	0.68	25	17	-8
0020	3F	19	145	52	11	5200	3340	-1860	0.21	0.64	9	5	-4
0020	3F	19	146	25	3	2500	1810	-690	0.12	0.72	4	3	-1
0020	3F	19	156	9	0	900	0	-900	0.00	0.00	1	0	-1
0020	3F	19	234	2	1	200	480	280	0.50	2.40	0	0	0
0020	3F	19	235	2	0	200	0	-200	0.00	0.00	0	0	0
0020	3F	19	236	7	1	700	690	-10	0.14	0.99	1	1	0
0020	3F	19	245	1	1	100	500	400	1.00	5.00	0	0	0
0020	3F	19	246	7	1	700	230	-470	0.14	0.33	1	0	-1
0020	3F	19	256	1	0	100	0	-100	0.00	0.00	0	0	0
0020	3F	20	123	365	105	36500	27440	-9060	0.29	0.75	64	48	-16
0020	3F	20	124	772	181	77200	50920	-26280	0.23	0.66	136	90	-46
0020	3F	20	125	240	46	24000	17820	-6180	0.19	0.74	42	31	-11
0020	3F	20	126	171	22	17100	11500	-5600	0.13	0.67	30	20	-10
0020	3F	20	134	190	45	19000	15580	-3420	0.24	0.82	33	27	-6
0020	3F	20	135	159	39	15900	13890	-2010	0.25	0.87	28	24	-4
0020	3F	20	136	125	22	12500	7740	-4760	0.18	0.62	22	13	-9
0020	3F	20	145	67	13	6700	5470	-1230	0.19	0.82	11	9	-2
0020	3F	20	146	40	7	4000	4730	730	0.18	1.18	7	8	1
0020	3F	20	156	27	2	2700	1160	-1540	0.07	0.43	4	2	-2
0020	3F	20	234	3	0	300	0	-300	0.00	0.00	0	0	0
0020	3F	20	235	1	0	100	0	-100	0.00	0.00	0	0	0
0020	3F	20	236	1	0	100	0	-100	0.00	0.00	0	0	0
0020	3F	21	123	346	109	34600	31840	-2760	0.32	0.92	61	56	-5
0020	3F	21	124	793	161	79300	53890	-25410	0.20	0.68	140	95	-45
0020	3F	21	125	315	58	31500	23670	-7830	0.18	0.75	55	41	-14
0020	3F	21	126	168	24	16800	10580	-6220	0.14	0.63	29	18	-11
0020	3F	21	134	230	53	23000	16090	-6910	0.23	0.70	40	28	-12
0020	3F	21	135	295	76	29500	22090	-7410	0.26	0.75	52	39	-13
0020	3F	21	136	60	9	6000	4870	-1130	0.15	0.81	10	8	-2
0020	3F	21	145	38	2	3800	580	-3220	0.05	0.15	6	1	-5
0020	3F	21	146	28	6	2800	2660	-140	0.21	0.95	4	4	0
0020	3F	21	156	8	1	800	460	-340	0.13	0.58	1	0	-1
0020	3F	21	234	2	0	200	0	-200	0.00	0.00	0	0	0
0020	3F	21	235	1	0	100	0	-100	0.00	0.00	0	0	0
0020	3F	21	236	2	1	200	420	220	0.50	2.10	0	0	0
0020	3F	22	123	180	62	18000	17670	-330	0.34	0.98	31	31	0
0020	3F	22	124	988	199	98800	88890	-9910	0.20	0.90	174	157	-17
0020	3F	22	125	158	27	15800	10920	-4880	0.17	0.69	27	19	-8
0020	3F	22	126	115	13	11500	8830	-2670	0.11	0.77	20	15	-5
0020	3F	22	134	193	32	19300	15200	-4100	0.17	0.79	34	26	-8
0020	3F	22	135	68	16	6800	5140	-1660	0.24	0.76	12	9	-3
0020	3F	22	136	38	5	3800	2460	-1340	0.13	0.65	6	4	-2
0020	3F	22	145	34	2	3400	680	-2720	0.06	0.20	6	1	-5
0020	3F	22	146	10	0	1000	0	-1000	0.00	0.00	1	0	-1
0020	3F	22	156	3	0	300	0	-300	0.00	0.00	0	0	0
0020	3F	22	234	3	1	300	510	210	0.33	1.70	0	0	0
0020	3F	22	235	3	0	300	0	-300	0.00	0.00	0	0	0
0020	3F	22	236	1	0	100	0	-100	0.00	0.00	0	0	0
0020	3F	22	245	4	0	400	0	-400	0.00	0.00	0	0	0
0020	3F	23	123	265	70	26500	17510	-8990	0.26	0.66	46	30	-16
0020	3F	23	124	928	139	92800	52940	-39860	0.15	0.57	164	93	-71
0020	3F	23	125	218	36	21800	23910	2110	0.17	1.10	38	42	4
0020	3F	23	126	146	14	14600	13590	-1010	0.10	0.93	25	24	-1
0020	3F	23	134	196	35	19600	12510	-7090	0.18	0.64	34	22	-12
0020	3F	23	135	109	17	10900	6010	-4890	0.16	0.55	19	10	-9
0020	3F	23	136	53	8	5300	4610	-690	0.15	0.87	9	8	-1
0020	3F	23	145	89	22	8900	7430	-1470	0.25	0.83	15	13	-2
0020	3F	23	146	42	2	4200	590	-3610	0.05	0.14	7	1	-6
0020	3F	23	156	10	2	1000	680	-320	0.20	0.68	1	1	0
0020	3F	23	234	5	2	500	560	60	0.40	1.12	0	0	0
0020	3F	23	235	3	1	300	360	60	0.33	1.20	0	0	0
0020	3F	23	236	2	0	200	0	-200	0.00	0.00	0	0	0
0020	3F	23	245	1	0	100	0	-100	0.00	0.00	0	0	0
0020	3F	23	256	1	0	100	0	-100	0.00	0.00	0	0	0
0020	3F	24	123	248	91	24800	23530	-1270	0.37	0.95	43	41	-2
0020	3F	24	124	996	187	99600	75570	-24030	0.19	0.76	176	133	-43
0020	3F	24	125	225	38	22500	23710	1210	0.17	1.05	39	41	2
0020	3F	24	126	212	36	21200	14530	-6670	0.17	0.69	37	25	-12
0020	3F	24	134	244	69	24400	22470	-1930	0.28	0.92	43	39	-4
0020	3F	24	135	117	19	11700	9640	-2060	0.16	0.82	20	17	-3
0020	3F	24	136	82	13	8200	4360	-3840	0.16	0.53	14	7	-7
0020	3F	24	145	65	13	6500	5360	-1140	0.20	0.82	11	9	-2
0020	3F	24	146	34	3	3400	850	-2550	0.09	0.25	6	1	-5
0020	3F	24	156	6	2	600	630	30	0.33	1.05	1	1	0
0020	3F	24	234	3	1	300	280	-20	0.33	0.93	0	0	0
0020	3F	24	235	1	0	100	0	-100	0.00	0.00	0	0	0
0020	3F	24	236	3	0	300	0	-300	0.00	0.00	0	0	0
0020	3F	24	245	2	0	200	0	-200	0.00	0.00	0	0	0
0020	3F	24	246	1	0	100	0	-100	0.00	0.00	0	0	0
0020	3T	01	123	177	19	17700	11700	-6000	0.11	0.66	31	20	-11
0020	3T	01	124	936	63	93600	63610	-29990	0.07	0.68	165	112	-53
0020	3T	01	125	239	19	23900	18400	-5500	0.08	0.77	42	32	-10
0020	3T	01	126	213	12	21300	17680	-3620	0.06	0.83	37	31	-6
0020	3T	01	132	4	0	400	0	-400	0.00	0.00	0	0	0
0020	3T	01	134	115	6	11500	6500	-5000	0.05	0.57	20	11	-9
0020	3T	01	135	75	6	7500	5210	-2290	0.08	0.69	13	9	-4
0020	3T	01	136	58	4	5800	3880	-1920	0.07	0.67	10	6	-4
0020	3T	01	142	21	1	2100	660	-1440	0.05	0.31	3	1	-2
0020	3T	01	145	60	1	6000	1480	-4520	0.02	0.25	10	2	-8
0020	3T	01	146	41	0	4100	0	-4100	0.00	0.00	7	0	-7
0020	3T	01	152	8	0	800	0	-800	0.00	0.00	1	0	-1
0020	3T	01	153	8	1	800	2380	1580	0.13	2.98	1	4	3
0020	3T	01	154	9	0	900	0	-900	0.00	0.00	1	0	-1
0020	3T	01	156	14	1	1400	750	-650	0.07	0.54	2	1	-1
0020	3T	01	163	1	0	100	0	-100	0.00	0.00	0	0	0
0020	3T	01	164	1	0	100	0	-100	0.00	0.00	0	0	0
0020	3T	01	216	1	0	100	0	-100	0.00	0.00	0	0	0
0020	3T	01	234	8	0	800	0	-800	0.00	0.00	1	0	-1
0020	3T	01	235	2	0	200	0	-200	0.00	0.00	0	0	0
0020	3T	01	246	2	0	200	0	-200	0.00	0.00	0	0	0
0020	3T	02	123	212	22	21200	20110	-1090	0.10	0.95	37	35	-2
0020	3T	02	124	699	39	69900	46730	-23170	0.06	0.67	123	82	-41
0020	3T	02	125	260	15	26000	24250	-1750	0.06	0.93	46	42	-4
0020	3T	02	126	341	16	34100	30730	-3370	0.05	0.90	60	54	-6
0020	3T	02	132	16	0	1600	0	-1600	0.00	0.00	2	0	-2
0020	3T	02	134	144	11	14400	12640	-1760	0.08	0.88	25	22	-3
0020	3T	02	135	85	3	8500	3890	-4610	0.04	0.46	15	6	-9
0020	3T	02	136	140	10	14000	13070	-930	0.07	0.93	24	23	-1
0020	3T	02	142	13	1	1300	520	-780	0.08	0.40	2	0	-2
0020	3T	02	143	1	0	100	0	-100	0.00	0.00	0	0	0
0020	3T	02	145	45	4	4500	11560	7060	0.09	2.57	7	20	13
0020	3T	02	146	72	5	7200	14690	7490	0.07	2.04	12	26	14
0020	3T	02	152	5	0	500	0	-500	0.00	0.00	0	0	0
0020	3T	02	153	3	0	300	0	-300	0.00	0.00	0	0	0
0020	3T	02	154	3	0	300	0	-300	0.00	0.00	0	0	0
0020	3T	02	156	12	2	1200	3940	2740	0.17	3.28	2	6	4
0020	3T	02	162	1	0	100	0	-100	0.00	0.00	0	0	0
0020	3T	02	163	1	0	100	0	-100	0.00	0.00	0	0	0
0020	3T	02	164	4	0	400	0	-400	0.00	0.00	0	0	0
0020	3T	02	165	1	0	100	0	-100	0.00	0.00	0	0	0
0020	3T	02	213	3	0	300	0	-300	0.00	0.00	0	0	0
0020	3T	02	214	1	0	100	0	-100	0.00	0.00	0	0	0
0020	3T	02	234	11	2	1100	1680	580	0.18	1.53	1	2	1
0020	3T	02	235	3	0	300	0	-300	0.00	0.00	0	0	0
0020	3T	02	236	5	0	500	0	-500	0.00	0.00	0	0	0
0020	3T	02	243	1	0	100	0	-100	0.00	0.00	0	0	0
0020	3T	02	245	3	1	300	1390	1090	0.33	4.63	0	2	2
0020	3T	02	246	1	0	100	0	-100	0.00	0.00	0	0	0
0020	3T	02	256	1	0	100	0	-100	0.00	0.00	0	0	0
0020	3T	02	263	2	0	200	0	-200	0.00	0.00	0	0	0
0020	3T	03	123	161	23	16100	20840	4740	0.14	1.29	28	36	8
0020	3T	03	124	421	21	42100	25420	-16680	0.05	0.60	74	44	-30
0020	3T	03	125	209	11	20900	15780	-5120	0.05	0.76	36	27	-9
0020	3T	03	126	191	12	19100	23990	4890	0.06	1.26	33	42	9
0020	3T	03	134	141	12	14100	10580	-3520	0.09	0.75	24	18	-6
0020	3T	03	135	94	12	9400	17940	8540	0.13	1.91	16	31	15
0020	3T	03	136	83	5	8300	6290	-2010	0.06	0.76	14	11	-3
0020	3T	03	142	2	0	200	0	-200	0.00	0.00	0	0	0
0020	3T	03	143	1	0	100	0	-100	0.00	0.00	0	0	0
0020	3T	03	145	50	1	5000	1150	-3850	0.02	0.23	8	2	-6
0020	3T	03	146	49	2	4900	2770	-2130	0.04	0.57	8	4	-4
0020	3T	03	152	1	0	100	0	-100	0.00	0.00	0	0	0
0020	3T	03	153	3	0	300	0	-300	0.00	0.00	0	0	0
0020	3T	03	154	2	1	200	3120	2920	0.50	15.60	0	5	5
0020	3T	03	156	27	0	2700	0	-2700	0.00	0.00	4	0	-4
0020	3T	03	163	1	0	100	0	-100	0.00	0.00	0	0	0
0020	3T	03	164	1	0	100	0	-100	0.00	0.00	0	0	0
0020	3T	03	213	1	0	100	0	-100	0.00	0.00	0	0	0
0020	3T	03	216	1	0	100	0	-100	0.00	0.00	0	0	0
0020	3T	03	234	8	0	800	0	-800	0.00	0.00	1	0	-1
0020	3T	03	235	6	0	600	0	-600	0.00	0.00	1	0	-1
0020	3T	03	236	5	0	500	0	-500	0.00	0.00	0	0	0
0020	3T	03	245	2	0	200	0	-200	0.00	0.00	0	0	0
0020	3T	03	256	2	0	200	0	-200	0.00	0.00	0	0	0
0020	3T	04	123	134	10	13400	10780	-2620	0.07	0.80	23	19	-4
0020	3T	04	124	475	38	47500	42880	-4620	0.08	0.90	84	75	-9
0020	3T	04	125	227	10	22700	19500	-3200	0.04	0.86	40	34	-6
0020	3T	04	126	293	16	29300	23610	-5690	0.05	0.81	51	41	-10
0020	3T	04	132	2	0	200	0	-200	0.00	0.00	0	0	0
0020	3T	04	134	179	14	17900	12030	-5870	0.08	0.67	31	21	-10
0020	3T	04	135	115	5	11500	6750	-4750	0.04	0.59	20	11	-9
0020	3T	04	136	126	7	12600	9670	-2930	0.06	0.77	22	17	-5
0020	3T	04	142	2	0	200	0	-200	0.00	0.00	0	0	0
0020	3T	04	145	53	2	5300	3390	-1910	0.04	0.64	9	6	-3
0020	3T	04	146	63	2	6300	2820	-3480	0.03	0.45	11	4	-7
0020	3T	04	153	4	0	400	0	-400	0.00	0.00	0	0	0
0020	3T	04	154	3	0	300	0	-300	0.00	0.00	0	0	0
0020	3T	04	156	26	1	2600	1350	-1250	0.04	0.52	4	2	-2
0020	3T	04	163	1	0	100	0	-100	0.00	0.00	0	0	0
0020	3T	04	164	2	0	200	0	-200	0.00	0.00	0	0	0
0020	3T	04	165	1	1	100	1080	980	1.00	10.80	0	1	1
0020	3T	04	214	1	1	100	1250	1150	1.00	12.50	0	2	2
0020	3T	04	215	1	0	100	0	-100	0.00	0.00	0	0	0
0020	3T	04	234	7	0	700	0	-700	0.00	0.00	1	0	-1
0020	3T	04	235	5	1	500	400	-100	0.20	0.80	0	0	0
0020	3T	04	236	6	0	600	0	-600	0.00	0.00	1	0	-1
0020	3T	04	246	2	0	200	0	-200	0.00	0.00	0	0	0
0020	3T	04	264	1	0	100	0	-100	0.00	0.00	0	0	0
0020	3T	05	123	159	17	15900	13770	-2130	0.11	0.87	28	24	-4
0020	3T	05	124	569	48	56900	50680	-6220	0.08	0.89	100	89	-11
0020	3T	05	125	205	14	20500	17800	-2700	0.07	0.87	36	31	-5
0020	3T	05	126	384	22	38400	33640	-4760	0.06	0.88	67	59	-8
0020	3T	05	132	2	0	200	0	-200	0.00	0.00	0	0	0
0020	3T	05	134	142	8	14200	7800	-6400	0.06	0.55	25	13	-12
0020	3T	05	135	121	7	12100	8000	-4100	0.06	0.66	21	14	-7
0020	3T	05	136	163	10	16300	14250	-2050	0.06	0.87	28	25	-3
0020	3T	05	142	11	1	1100	360	-740	0.09	0.33	1	0	-1
0020	3T	05	143	1	0	100	0	-100	0.00	0.00	0	0	0
0020	3T	05	145	43	3	4300	3250	-1050	0.07	0.76	7	5	-2
0020	3T	05	146	41	2	4100	1690	-2410	0.05	0.41	7	2	-5
0020	3T	05	153	2	0	200	0	-200	0.00	0.00	0	0	0
0020	3T	05	154	2	0	200	0	-200	0.00	0.00	0	0	0
0020	3T	05	156	32	3	3200	5540	2340	0.09	1.73	5	9	4
0020	3T	05	234	8	0	800	0	-800	0.00	0.00	1	0	-1
0020	3T	05	235	7	1	700	1100	400	0.14	1.57	1	1	0
0020	3T	05	236	11	0	1100	0	-1100	0.00	0.00	1	0	-1
0020	3T	05	245	4	1	400	860	460	0.25	2.15	0	1	1
0020	3T	05	246	4	0	400	0	-400	0.00	0.00	0	0	0
0020	3T	05	256	4	0	400	0	-400	0.00	0.00	0	0	0
0020	3T	06	123	209	39	20900	27420	6520	0.19	1.31	36	48	12
0020	3T	06	124	581	53	58100	43340	-14760	0.09	0.75	102	76	-26
0020	3T	06	125	234	12	23400	9070	-14330	0.05	0.39	41	16	-25
0020	3T	06	126	371	19	37100	38630	1530	0.05	1.04	65	68	3
0020	3T	06	132	4	0	400	0	-400	0.00	0.00	0	0	0
0020	3T	06	134	189	17	18900	11860	-7040	0.09	0.63	33	20	-13
0020	3T	06	135	145	11	14500	11770	-2730	0.08	0.81	25	20	-5
0020	3T	06	136	217	14	21700	12520	-9180	0.06	0.58	38	22	-16
0020	3T	06	142	3	0	300	0	-300	0.00	0.00	0	0	0
0020	3T	06	143	3	0	300	0	-300	0.00	0.00	0	0	0
0020	3T	06	145	50	3	5000	4530	-470	0.06	0.91	8	8	0
0020	3T	06	146	63	1	6300	660	-5640	0.02	0.10	11	1	-10
0020	3T	06	153	1	0	100	0	-100	0.00	0.00	0	0	0
0020	3T	06	154	1	0	100	0	-100	0.00	0.00	0	0	0
0020	3T	06	156	40	3	4000	3240	-760	0.08	0.81	7	5	-2
0020	3T	06	164	2	0	200	0	-200	0.00	0.00	0	0	0
0020	3T	06	216	2	0	200	0	-200	0.00	0.00	0	0	0
0020	3T	06	234	5	0	500	0	-500	0.00	0.00	0	0	0
0020	3T	06	235	11	1	1100	1510	410	0.09	1.37	1	2	1
0020	3T	06	236	8	0	800	0	-800	0.00	0.00	1	0	-1
0020	3T	06	245	2	0	200	0	-200	0.00	0.00	0	0	0
0020	3T	06	246	2	0	200	0	-200	0.00	0.00	0	0	0
0020	3T	06	254	1	0	100	0	-100	0.00	0.00	0	0	0
0020	3T	06	256	3	0	300	0	-300	0.00	0.00	0	0	0
0020	3T	07	123	208	17	20800	12840	-7960	0.08	0.62	36	22	-14
0020	3T	07	124	583	42	58300	34570	-23730	0.07	0.59	103	61	-42
0020	3T	07	125	294	17	29400	19730	-9670	0.06	0.67	52	34	-18
0020	3T	07	126	314	22	31400	37670	6270	0.07	1.20	55	66	11
0020	3T	07	132	1	0	100	0	-100	0.00	0.00	0	0	0
0020	3T	07	134	317	40	31700	31940	240	0.13	1.01	56	56	0
0020	3T	07	135	158	7	15800	7030	-8770	0.04	0.44	27	12	-15
0020	3T	07	136	127	11	12700	16110	3410	0.09	1.27	22	28	6
0020	3T	07	142	2	0	200	0	-200	0.00	0.00	0	0	0
0020	3T	07	143	4	1	400	1100	700	0.25	2.75	0	1	1
0020	3T	07	145	115	6	11500	4370	-7130	0.05	0.38	20	7	-13
0020	3T	07	146	41	0	4100	0	-4100	0.00	0.00	7	0	-7
0020	3T	07	152	2	0	200	0	-200	0.00	0.00	0	0	0
0020	3T	07	153	1	0	100	0	-100	0.00	0.00	0	0	0
0020	3T	07	154	3	0	300	0	-300	0.00	0.00	0	0	0
0020	3T	07	156	29	4	2900	5710	2810	0.14	1.97	5	10	5
0020	3T	07	213	1	0	100	0	-100	0.00	0.00	0	0	0
0020	3T	07	234	4	0	400	0	-400	0.00	0.00	0	0	0
0020	3T	07	235	9	0	900	0	-900	0.00	0.00	1	0	-1
0020	3T	07	236	11	1	1100	1260	160	0.09	1.15	1	2	1
0020	3T	07	245	1	0	100	0	-100	0.00	0.00	0	0	0
0020	3T	07	253	1	0	100	0	-100	0.00	0.00	0	0	0
0020	3T	07	256	3	0	300	0	-300	0.00	0.00	0	0	0
0020	3T	08	123	194	24	19400	13280	-6120	0.12	0.68	34	23	-11
0020	3T	08	124	679	71	67900	60600	-7300	0.10	0.89	120	107	-13
0020	3T	08	125	305	21	30500	23540	-6960	0.07	0.77	53	41	-12
0020	3T	08	126	284	17	28400	16650	-11750	0.06	0.59	50	29	-21
0020	3T	08	132	4	0	400	0	-400	0.00	0.00	0	0	0
0020	3T	08	134	226	22	22600	15870	-6730	0.10	0.70	40	28	-12
0020	3T	08	135	140	7	14000	5720	-8280	0.05	0.41	24	10	-14
0020	3T	08	136	142	10	14200	9270	-4930	0.07	0.65	25	16	-9
0020	3T	08	142	2	0	200	0	-200	0.00	0.00	0	0	0
0020	3T	08	143	3	0	300	0	-300	0.00	0.00	0	0	0
0020	3T	08	145	75	5	7500	5050	-2450	0.07	0.67	13	8	-5
0020	3T	08	146	57	5	5700	4290	-1410	0.09	0.75	10	7	-3
0020	3T	08	152	1	0	100	0	-100	0.00	0.00	0	0	0
0020	3T	08	153	5	0	500	0	-500	0.00	0.00	0	0	0
0020	3T	08	154	2	0	200	0	-200	0.00	0.00	0	0	0
0020	3T	08	156	24	1	2400	1350	-1050	0.04	0.56	4	2	-2
0020	3T	08	165	1	0	100	0	-100	0.00	0.00	0	0	0
0020	3T	08	213	1	0	100	0	-100	0.00	0.00	0	0	0
0020	3T	08	216	1	0	100	0	-100	0.00	0.00	0	0	0
0020	3T	08	234	3	0	300	0	-300	0.00	0.00	0	0	0
0020	3T	08	236	5	1	500	700	200	0.20	1.40	0	1	1
0020	3T	08	245	1	0	100	0	-100	0.00	0.00	0	0	0
0020	3T	09	123	346	53	34600	28790	-5810	0.15	0.83	61	50	-11
0020	3T	09	124	794	84	79400	59450	-19950	0.11	0.75	140	105	-35
0020	3T	09	125	273	29	27300	28060	760	0.11	1.03	48	49	1
0020	3T	09	126	256	12	25600	19130	-6470	0.05	0.75	45	33	-12
0020	3T	09	132	2	0	200	0	-200	0.00	0.00	0	0	0
0020	3T	09	134	219	19	21900	14500	-7400	0.09	0.66	38	25	-13
0020	3T	09	135	138	16	13800	15760	1960	0.12	1.14	24	27	3
0020	3T	09	136	131	7	13100	11490	-1610	0.05	0.88	23	20	-3
0020	3T	09	142	1	0	100	0	-100	0.00	0.00	0	0	0
0020	3T	09	143	1	0	100	0	-100	0.00	0.00	0	0	0
0020	3T	09	145	37	3	3700	5680	1980	0.08	1.54	6	10	4
0020	3T	09	146	48	5	4800	5040	240	0.10	1.05	8	8	0
0020	3T	09	152	2	0	200	0	-200	0.00	0.00	0	0	0
0020	3T	09	153	2	0	200	0	-200	0.00	0.00	0	0	0
0020	3T	09	154	2	0	200	0	-200	0.00	0.00	0	0	0
0020	3T	09	156	27	1	2700	710	-1990	0.04	0.26	4	1	-3
0020	3T	09	214	2	0	200	0	-200	0.00	0.00	0	0	0
0020	3T	09	216	3	0	300	0	-300	0.00	0.00	0	0	0
0020	3T	09	234	9	0	900	0	-900	0.00	0.00	1	0	-1
0020	3T	09	235	9	1	900	1120	220	0.11	1.24	1	1	0
0020	3T	09	236	6	0	600	0	-600	0.00	0.00	1	0	-1
0020	3T	09	245	2	0	200	0	-200	0.00	0.00	0	0	0
0020	3T	09	246	2	1	200	1100	900	0.50	5.50	0	1	1
0020	3T	09	256	5	0	500	0	-500	0.00	0.00	0	0	0
0020	3T	10	123	459	70	45900	38350	-7550	0.15	0.84	81	67	-14
0020	3T	10	124	592	64	59200	49770	-9430	0.11	0.84	104	88	-16
0020	3T	10	125	221	20	22100	19490	-2610	0.09	0.88	39	34	-5
0020	3T	10	126	155	10	15500	10950	-4550	0.06	0.71	27	19	-8
0020	3T	10	132	1	0	100	0	-100	0.00	0.00	0	0	0
0020	3T	10	134	184	20	18400	17970	-430	0.11	0.98	32	31	-1
0020	3T	10	135	136	9	13600	8880	-4720	0.07	0.65	24	15	-9
0020	3T	10	136	94	8	9400	10910	1510	0.09	1.16	16	19	3
0020	3T	10	143	3	0	300	0	-300	0.00	0.00	0	0	0
0020	3T	10	145	54	3	5400	5600	200	0.06	1.04	9	9	0
0020	3T	10	146	39	2	3900	2670	-1230	0.05	0.68	6	4	-2
0020	3T	10	152	1	0	100	0	-100	0.00	0.00	0	0	0
0020	3T	10	154	1	0	100	0	-100	0.00	0.00	0	0	0
0020	3T	10	156	18	0	1800	0	-1800	0.00	0.00	3	0	-3
0020	3T	10	164	1	0	100	0	-100	0.00	0.00	0	0	0
0020	3T	10	216	2	0	200	0	-200	0.00	0.00	0	0	0
0020	3T	10	234	2	0	200	0	-200	0.00	0.00	0	0	0
0020	3T	10	235	5	0	500	0	-500	0.00	0.00	0	0	0
0020	3T	10	236	3	0	300	0	-300	0.00	0.00	0	0	0
0020	3T	10	245	3	0	300	0	-300	0.00	0.00	0	0	0
0020	3T	10	246	2	0	200	0	-200	0.00	0.00	0	0	0
0020	3T	10	254	2	0	200	0	-200	0.00	0.00	0	0	0
0020	3T	10	256	3	0	300	0	-300	0.00	0.00	0	0	0
0020	3T	11	123	563	66	56300	50280	-6020	0.12	0.89	99	88	-11
0020	3T	11	124	639	47	63900	56350	-7550	0.07	0.88	113	99	-14
0020	3T	11	125	7	1	700	990	290	0.14	1.41	1	1	0
0020	3T	11	126	450	26	45000	64620	19620	0.06	1.44	79	114	35
0020	3T	11	134	165	8	16500	7020	-9480	0.05	0.43	29	12	-17
0020	3T	11	135	2	0	200	0	-200	0.00	0.00	0	0	0
0020	3T	11	136	148	3	14800	8280	-6520	0.02	0.56	26	14	-12
0020	3T	11	143	31	1	3100	420	-2680	0.03	0.14	5	0	-5
0020	3T	11	145	1	0	100	0	-100	0.00	0.00	0	0	0
0020	3T	11	146	69	5	6900	7770	870	0.07	1.13	12	13	1
0020	3T	11	153	12	1	1200	1360	160	0.08	1.13	2	2	0
0020	3T	11	154	3	0	300	0	-300	0.00	0.00	0	0	0
0020	3T	11	156	8	0	800	0	-800	0.00	0.00	1	0	-1
0020	3T	11	164	1	0	100	0	-100	0.00	0.00	0	0	0
0020	3T	11	213	5	1	500	1630	1130	0.20	3.26	0	2	2
0020	3T	11	214	1	0	100	0	-100	0.00	0.00	0	0	0
0020	3T	11	215	1	0	100	0	-100	0.00	0.00	0	0	0
0020	3T	11	216	10	1	1000	2440	1440	0.10	2.44	1	4	3
0020	3T	11	234	27	1	2700	560	-2140	0.04	0.21	4	0	-4
0020	3T	11	236	39	1	3900	1610	-2290	0.03	0.41	6	2	-4
0020	3T	11	243	4	0	400	0	-400	0.00	0.00	0	0	0
0020	3T	11	245	1	0	100	0	-100	0.00	0.00	0	0	0
0020	3T	11	246	18	1	1800	6600	4800	0.06	3.67	3	11	8
0020	3T	11	253	1	0	100	0	-100	0.00	0.00	0	0	0
0020	3T	11	254	2	0	200	0	-200	0.00	0.00	0	0	0
0020	3T	11	256	11	0	1100	0	-1100	0.00	0.00	1	0	-1
0020	3T	12	123	147	17	14700	14760	60	0.12	1.00	26	26	0
0020	3T	12	124	1073	79	107300	65590	-41710	0.07	0.61	189	116	-73
0020	3T	12	125	118	5	11800	6370	-5430	0.04	0.54	20	11	-9
0020	3T	12	126	232	17	23200	20280	-2920	0.07	0.87	41	35	-6
0020	3T	12	132	16	0	1600	0	-1600	0.00	0.00	2	0	-2
0020	3T	12	134	177	19	17700	16920	-780	0.11	0.96	31	29	-2
0020	3T	12	135	72	4	7200	3940	-3260	0.06	0.55	12	6	-6
0020	3T	12	136	103	8	10300	6350	-3950	0.08	0.62	18	11	-7
0020	3T	12	142	25	1	2500	700	-1800	0.04	0.28	4	1	-3
0020	3T	12	143	4	0	400	0	-400	0.00	0.00	0	0	0
0020	3T	12	145	55	7	5500	12450	6950	0.13	2.26	9	22	13
0020	3T	12	146	54	2	5400	2090	-3310	0.04	0.39	9	3	-6
0020	3T	12	152	3	0	300	0	-300	0.00	0.00	0	0	0
0020	3T	12	153	5	0	500	0	-500	0.00	0.00	0	0	0
0020	3T	12	154	11	0	1100	0	-1100	0.00	0.00	1	0	-1
0020	3T	12	156	22	2	2200	1770	-430	0.09	0.80	3	3	0
0020	3T	12	164	4	1	400	14420	14020	0.25	36.05	0	25	25
0020	3T	12	216	1	0	100	0	-100	0.00	0.00	0	0	0
0020	3T	12	234	7	0	700	0	-700	0.00	0.00	1	0	-1
0020	3T	12	235	4	0	400	0	-400	0.00	0.00	0	0	0
0020	3T	12	236	1	0	100	0	-100	0.00	0.00	0	0	0
0020	3T	12	243	1	0	100	0	-100	0.00	0.00	0	0	0
0020	3T	12	245	1	0	100	0	-100	0.00	0.00	0	0	0
0020	3T	12	253	2	0	200	0	-200	0.00	0.00	0	0	0
0020	3T	12	254	2	0	200	0	-200	0.00	0.00	0	0	0
0020	3T	12	264	1	0	100	0	-100	0.00	0.00	0	0	0
0020	3T	13	123	128	11	12800	8370	-4430	0.09	0.65	22	14	-8
0020	3T	13	124	715	68	71500	56310	-15190	0.10	0.79	126	99	-27
0020	3T	13	125	272	14	27200	12730	-14470	0.05	0.47	48	22	-26
0020	3T	13	126	240	14	24000	15200	-8800	0.06	0.63	42	26	-16
0020	3T	13	132	11	2	1100	1220	120	0.18	1.11	1	2	1
0020	3T	13	134	219	25	21900	19300	-2600	0.11	0.88	38	34	-4
0020	3T	13	135	120	7	12000	5930	-6070	0.06	0.49	21	10	-11
0020	3T	13	136	105	7	10500	6520	-3980	0.07	0.62	18	11	-7
0020	3T	13	142	7	1	700	570	-130	0.14	0.81	1	1	0
0020	3T	13	145	59	6	5900	6240	340	0.10	1.06	10	11	1
0020	3T	13	146	52	3	5200	5690	490	0.06	1.09	9	10	1
0020	3T	13	152	2	0	200	0	-200	0.00	0.00	0	0	0
0020	3T	13	153	1	0	100	0	-100	0.00	0.00	0	0	0
0020	3T	13	154	2	0	200	0	-200	0.00	0.00	0	0	0
0020	3T	13	156	12	0	1200	0	-1200	0.00	0.00	2	0	-2
0020	3T	13	164	6	0	600	0	-600	0.00	0.00	1	0	-1
0020	3T	13	165	3	0	300	0	-300	0.00	0.00	0	0	0
0020	3T	13	234	10	0	1000	0	-1000	0.00	0.00	1	0	-1
0020	3T	13	235	2	0	200	0	-200	0.00	0.00	0	0	0
0020	3T	13	236	2	0	200	0	-200	0.00	0.00	0	0	0
0020	3T	13	245	2	0	200	0	-200	0.00	0.00	0	0	0
0020	3T	13	246	1	0	100	0	-100	0.00	0.00	0	0	0
0020	3T	14	123	173	17	17300	10190	-7110	0.10	0.59	30	18	-12
0020	3T	14	124	610	46	61000	37100	-23900	0.08	0.61	107	65	-42
0020	3T	14	125	227	19	22700	26760	4060	0.08	1.18	40	47	7
0020	3T	14	126	279	12	27900	25980	-1920	0.04	0.93	49	45	-4
0020	3T	14	132	4	0	400	0	-400	0.00	0.00	0	0	0
0020	3T	14	134	125	6	12500	6040	-6460	0.05	0.48	22	10	-12
0020	3T	14	135	92	9	9200	9640	440	0.10	1.05	16	17	1
0020	3T	14	136	108	4	10800	7700	-3100	0.04	0.71	19	13	-6
0020	3T	14	142	1	1	100	410	310	1.00	4.10	0	0	0
0020	3T	14	145	65	3	6500	3720	-2780	0.05	0.57	11	6	-5
0020	3T	14	146	74	1	7400	1590	-5810	0.01	0.21	13	2	-11
0020	3T	14	153	2	0	200	0	-200	0.00	0.00	0	0	0
0020	3T	14	154	1	0	100	0	-100	0.00	0.00	0	0	0
0020	3T	14	156	37	3	3700	5620	1920	0.08	1.52	6	9	3
0020	3T	14	215	1	0	100	0	-100	0.00	0.00	0	0	0
0020	3T	14	234	10	0	1000	0	-1000	0.00	0.00	1	0	-1
0020	3T	14	235	4	0	400	0	-400	0.00	0.00	0	0	0
0020	3T	14	236	7	2	700	3200	2500	0.29	4.57	1	5	4
0020	3T	14	245	1	0	100	0	-100	0.00	0.00	0	0	0
0020	3T	14	246	1	0	100	0	-100	0.00	0.00	0	0	0
0020	3T	15	123	214	23	21400	17840	-3560	0.11	0.83	37	31	-6
0020	3T	15	124	802	91	80200	56130	-24070	0.11	0.70	141	99	-42
0020	3T	15	125	244	14	24400	17820	-6580	0.06	0.73	43	31	-12
0020	3T	15	126	364	19	36400	26950	-9450	0.05	0.74	64	47	-17
0020	3T	15	132	3	0	300	0	-300	0.00	0.00	0	0	0
0020	3T	15	134	246	27	24600	23160	-1440	0.11	0.94	43	40	-3
0020	3T	15	135	110	8	11000	10860	-140	0.07	0.99	19	19	0
0020	3T	15	136	161	12	16100	14230	-1870	0.07	0.88	28	25	-3
0020	3T	15	142	6	0	600	0	-600	0.00	0.00	1	0	-1
0020	3T	15	143	6	0	600	0	-600	0.00	0.00	1	0	-1
0020	3T	15	145	30	0	3000	0	-3000	0.00	0.00	5	0	-5
0020	3T	15	146	38	0	3800	0	-3800	0.00	0.00	6	0	-6
0020	3T	15	156	42	2	4200	5980	1780	0.05	1.42	7	10	3
0020	3T	15	163	2	0	200	0	-200	0.00	0.00	0	0	0
0020	3T	15	164	1	0	100	0	-100	0.00	0.00	0	0	0
0020	3T	15	165	3	0	300	0	-300	0.00	0.00	0	0	0
0020	3T	15	216	1	0	100	0	-100	0.00	0.00	0	0	0
0020	3T	15	234	9	2	900	2260	1360	0.22	2.51	1	4	3
0020	3T	15	235	4	0	400	0	-400	0.00	0.00	0	0	0
0020	3T	15	236	10	0	1000	0	-1000	0.00	0.00	1	0	-1
0020	3T	15	246	1	0	100	0	-100	0.00	0.00	0	0	0
0020	3T	15	256	6	0	600	0	-600	0.00	0.00	1	0	-1
0020	3T	15	265	1	0	100	0	-100	0.00	0.00	0	0	0
0020	3T	16	123	313	52	31300	26310	-4990	0.17	0.84	55	46	-9
0020	3T	16	124	671	61	67100	56800	-10300	0.09	0.85	118	100	-18
0020	3T	16	125	202	12	20200	12310	-7890	0.06	0.61	35	21	-14
0020	3T	16	126	317	24	31700	34660	2960	0.08	1.09	56	61	5
0020	3T	16	132	5	0	500	0	-500	0.00	0.00	0	0	0
0020	3T	16	134	150	10	15000	8750	-6250	0.07	0.58	26	15	-11
0020	3T	16	135	88	5	8800	3580	-5220	0.06	0.41	15	6	-9
0020	3T	16	136	148	8	14800	10730	-4070	0.05	0.73	26	18	-8
0020	3T	16	142	9	0	900	0	-900	0.00	0.00	1	0	-1
0020	3T	16	143	10	2	1000	2980	1980	0.20	2.98	1	5	4
0020	3T	16	145	67	5	6700	7350	650	0.07	1.10	11	13	2
0020	3T	16	146	50	4	5000	6560	1560	0.08	1.31	8	11	3
0020	3T	16	152	2	0	200	0	-200	0.00	0.00	0	0	0
0020	3T	16	154	3	0	300	0	-300	0.00	0.00	0	0	0
0020	3T	16	156	37	1	3700	760	-2940	0.03	0.21	6	1	-5
0020	3T	16	163	1	0	100	0	-100	0.00	0.00	0	0	0
0020	3T	16	165	1	0	100	0	-100	0.00	0.00	0	0	0
0020	3T	16	214	1	0	100	0	-100	0.00	0.00	0	0	0
0020	3T	16	215	1	0	100	0	-100	0.00	0.00	0	0	0
0020	3T	16	234	3	0	300	0	-300	0.00	0.00	0	0	0
0020	3T	16	235	6	0	600	0	-600	0.00	0.00	1	0	-1
0020	3T	16	236	6	2	600	2580	1980	0.33	4.30	1	4	3
0020	3T	16	245	2	0	200	0	-200	0.00	0.00	0	0	0
0020	3T	16	246	2	0	200	0	-200	0.00	0.00	0	0	0
0020	3T	16	256	11	2	1100	1800	700	0.18	1.64	1	3	2
0020	3T	17	123	336	51	33600	26360	-7240	0.15	0.78	59	46	-13
0020	3T	17	124	671	49	67100	35540	-31560	0.07	0.53	118	62	-56
0020	3T	17	125	235	15	23500	11540	-11960	0.06	0.49	41	20	-21
0020	3T	17	126	285	18	28500	24490	-4010	0.06	0.86	50	43	-7
0020	3T	17	132	4	0	400	0	-400	0.00	0.00	0	0	0
0020	3T	17	134	221	23	22100	13720	-8380	0.10	0.62	39	24	-15
0020	3T	17	135	107	7	10700	7160	-3540	0.07	0.67	18	12	-6
0020	3T	17	136	105	11	10500	14570	4070	0.10	1.39	18	25	7
0020	3T	17	142	5	0	500	0	-500	0.00	0.00	0	0	0
0020	3T	17	143	4	0	400	0	-400	0.00	0.00	0	0	0
0020	3T	17	145	47	2	4700	1540	-3160	0.04	0.33	8	2	-6
0020	3T	17	146	39	3	3900	5180	1280	0.08	1.33	6	9	3
0020	3T	17	153	2	0	200	0	-200	0.00	0.00	0	0	0
0020	3T	17	154	1	0	100	0	-100	0.00	0.00	0	0	0
0020	3T	17	156	16	0	1600	0	-1600	0.00	0.00	2	0	-2
0020	3T	17	216	1	0	100	0	-100	0.00	0.00	0	0	0
0020	3T	17	234	4	0	400	0	-400	0.00	0.00	0	0	0
0020	3T	17	235	7	1	700	2190	1490	0.14	3.13	1	3	2
0020	3T	17	236	7	0	700	0	-700	0.00	0.00	1	0	-1
0020	3T	17	246	3	0	300	0	-300	0.00	0.00	0	0	0
0020	3T	17	256	4	0	400	0	-400	0.00	0.00	0	0	0
0020	3T	18	123	216	25	21600	15930	-5670	0.12	0.74	38	28	-10
0020	3T	18	124	802	85	80200	61770	-18430	0.11	0.77	141	109	-32
0020	3T	18	125	397	39	39700	35340	-4360	0.10	0.89	70	62	-8
0020	3T	18	126	241	19	24100	29260	5160	0.08	1.21	42	51	9
0020	3T	18	132	3	0	300	0	-300	0.00	0.00	0	0	0
0020	3T	18	134	183	20	18300	13740	-4560	0.11	0.75	32	24	-8
0020	3T	18	135	174	17	17400	15300	-2100	0.10	0.88	30	27	-3
0020	3T	18	136	137	13	13700	13200	-500	0.09	0.96	24	23	-1
0020	3T	18	142	2	0	200	0	-200	0.00	0.00	0	0	0
0020	3T	18	143	1	0	100	0	-100	0.00	0.00	0	0	0
0020	3T	18	145	86	8	8600	7340	-1260	0.09	0.85	15	12	-3
0020	3T	18	146	44	6	4400	3970	-430	0.14	0.90	7	7	0
0020	3T	18	153	1	0	100	0	-100	0.00	0.00	0	0	0
0020	3T	18	154	5	0	500	0	-500	0.00	0.00	0	0	0
0020	3T	18	156	14	1	1400	1820	420	0.07	1.30	2	3	1
0020	3T	18	164	1	0	100	0	-100	0.00	0.00	0	0	0
0020	3T	18	165	2	0	200	0	-200	0.00	0.00	0	0	0
0020	3T	18	215	1	0	100	0	-100	0.00	0.00	0	0	0
0020	3T	18	216	1	0	100	0	-100	0.00	0.00	0	0	0
0020	3T	18	234	7	1	700	1210	510	0.14	1.73	1	2	1
0020	3T	18	235	3	0	300	0	-300	0.00	0.00	0	0	0
0020	3T	18	236	8	0	800	0	-800	0.00	0.00	1	0	-1
0020	3T	18	245	3	0	300	0	-300	0.00	0.00	0	0	0
0020	3T	18	246	2	0	200	0	-200	0.00	0.00	0	0	0
0020	3T	18	253	1	0	100	0	-100	0.00	0.00	0	0	0
0020	3T	19	123	162	17	16200	12380	-3820	0.10	0.76	28	21	-7
0020	3T	19	124	685	68	68500	54430	-14070	0.10	0.79	121	96	-25
0020	3T	19	125	196	12	19600	12230	-7370	0.06	0.62	34	21	-13
0020	3T	19	126	181	6	18100	11290	-6810	0.03	0.62	32	19	-13
0020	3T	19	132	3	0	300	0	-300	0.00	0.00	0	0	0
0020	3T	19	134	236	28	23600	25180	1580	0.12	1.07	41	44	3
0020	3T	19	135	128	14	12800	9070	-3730	0.11	0.71	22	16	-6
0020	3T	19	136	142	13	14200	11400	-2800	0.09	0.80	25	20	-5
0020	3T	19	142	2	0	200	0	-200	0.00	0.00	0	0	0
0020	3T	19	143	4	0	400	0	-400	0.00	0.00	0	0	0
0020	3T	19	145	50	6	5000	5380	380	0.12	1.08	8	9	1
0020	3T	19	146	25	1	2500	880	-1620	0.04	0.35	4	1	-3
0020	3T	19	153	1	0	100	0	-100	0.00	0.00	0	0	0
0020	3T	19	154	2	0	200	0	-200	0.00	0.00	0	0	0
0020	3T	19	156	9	0	900	0	-900	0.00	0.00	1	0	-1
0020	3T	19	214	2	0	200	0	-200	0.00	0.00	0	0	0
0020	3T	19	216	2	0	200	0	-200	0.00	0.00	0	0	0
0020	3T	19	234	2	1	200	3220	3020	0.50	16.10	0	5	5
0020	3T	19	235	2	0	200	0	-200	0.00	0.00	0	0	0
0020	3T	19	236	7	0	700	0	-700	0.00	0.00	1	0	-1
0020	3T	19	245	1	0	100	0	-100	0.00	0.00	0	0	0
0020	3T	19	246	7	0	700	0	-700	0.00	0.00	1	0	-1
0020	3T	19	256	1	0	100	0	-100	0.00	0.00	0	0	0
0020	3T	20	123	361	52	36100	31570	-4530	0.14	0.87	63	55	-8
0020	3T	20	124	769	76	76900	60290	-16610	0.10	0.78	136	106	-30
0020	3T	20	125	238	19	23800	18580	-5220	0.08	0.78	42	32	-10
0020	3T	20	126	171	10	17100	12420	-4680	0.06	0.73	30	21	-9
0020	3T	20	132	4	1	400	840	440	0.25	2.10	0	1	1
0020	3T	20	134	190	21	19000	16540	-2460	0.11	0.87	33	29	-4
0020	3T	20	135	159	18	15900	16290	390	0.11	1.02	28	28	0
0020	3T	20	136	124	9	12400	9710	-2690	0.07	0.78	21	17	-4
0020	3T	20	142	3	1	300	530	230	0.33	1.77	0	0	0
0020	3T	20	145	63	6	6300	7650	1350	0.10	1.21	11	13	2
0020	3T	20	146	40	2	4000	1460	-2540	0.05	0.37	7	2	-5
0020	3T	20	154	4	1	400	980	580	0.25	2.45	0	1	1
0020	3T	20	156	27	0	2700	0	-2700	0.00	0.00	4	0	-4
0020	3T	20	163	1	0	100	0	-100	0.00	0.00	0	0	0
0020	3T	20	215	2	0	200	0	-200	0.00	0.00	0	0	0
0020	3T	20	234	3	0	300	0	-300	0.00	0.00	0	0	0
0020	3T	20	235	1	0	100	0	-100	0.00	0.00	0	0	0
0020	3T	20	236	1	0	100	0	-100	0.00	0.00	0	0	0
0020	3T	21	123	344	47	34400	32950	-1450	0.14	0.96	60	58	-2
0020	3T	21	124	792	69	79200	51300	-27900	0.09	0.65	140	90	-50
0020	3T	21	125	315	26	31500	27510	-3990	0.08	0.87	55	48	-7
0020	3T	21	126	168	12	16800	12420	-4380	0.07	0.74	29	21	-8
0020	3T	21	132	2	0	200	0	-200	0.00	0.00	0	0	0
0020	3T	21	134	226	25	22600	19780	-2820	0.11	0.88	40	35	-5
0020	3T	21	135	293	45	29300	29910	610	0.15	1.02	51	52	1
0020	3T	21	136	60	5	6000	5010	-990	0.08	0.84	10	8	-2
0020	3T	21	143	4	1	400	570	170	0.25	1.43	0	1	1
0020	3T	21	145	37	0	3700	0	-3700	0.00	0.00	6	0	-6
0020	3T	21	146	28	2	2800	1650	-1150	0.07	0.59	4	2	-2
0020	3T	21	153	2	0	200	0	-200	0.00	0.00	0	0	0
0020	3T	21	154	1	0	100	0	-100	0.00	0.00	0	0	0
0020	3T	21	156	8	0	800	0	-800	0.00	0.00	1	0	-1
0020	3T	21	214	1	0	100	0	-100	0.00	0.00	0	0	0
0020	3T	21	234	2	0	200	0	-200	0.00	0.00	0	0	0
0020	3T	21	235	1	0	100	0	-100	0.00	0.00	0	0	0
0020	3T	21	236	2	0	200	0	-200	0.00	0.00	0	0	0
0020	3T	22	123	180	29	18000	19770	1770	0.16	1.10	31	34	3
0020	3T	22	124	985	83	98500	102220	3720	0.08	1.04	174	180	6
0020	3T	22	125	156	9	15600	10090	-5510	0.06	0.65	27	17	-10
0020	3T	22	126	115	9	11500	14050	2550	0.08	1.22	20	24	4
0020	3T	22	134	193	16	19300	17800	-1500	0.08	0.92	34	31	-3
0020	3T	22	135	63	5	6300	3500	-2800	0.08	0.56	11	6	-5
0020	3T	22	136	38	0	3800	0	-3800	0.00	0.00	6	0	-6
0020	3T	22	145	24	1	2400	910	-1490	0.04	0.38	4	1	-3
0020	3T	22	146	4	0	400	0	-400	0.00	0.00	0	0	0
0020	3T	22	153	5	0	500	0	-500	0.00	0.00	0	0	0
0020	3T	22	154	10	0	1000	0	-1000	0.00	0.00	1	0	-1
0020	3T	22	156	2	0	200	0	-200	0.00	0.00	0	0	0
0020	3T	22	164	6	0	600	0	-600	0.00	0.00	1	0	-1
0020	3T	22	165	1	0	100	0	-100	0.00	0.00	0	0	0
0020	3T	22	214	3	0	300	0	-300	0.00	0.00	0	0	0
0020	3T	22	215	2	0	200	0	-200	0.00	0.00	0	0	0
0020	3T	22	234	3	0	300	0	-300	0.00	0.00	0	0	0
0020	3T	22	235	2	0	200	0	-200	0.00	0.00	0	0	0
0020	3T	22	236	1	0	100	0	-100	0.00	0.00	0	0	0
0020	3T	22	245	4	0	400	0	-400	0.00	0.00	0	0	0
0020	3T	22	253	1	0	100	0	-100	0.00	0.00	0	0	0
0020	3T	23	123	212	20	21200	10620	-10580	0.09	0.50	37	18	-19
0020	3T	23	124	907	55	90700	49340	-41360	0.06	0.54	160	87	-73
0020	3T	23	125	217	11	21700	27530	5830	0.05	1.27	38	48	10
0020	3T	23	126	146	7	14600	11250	-3350	0.05	0.77	25	19	-6
0020	3T	23	132	53	4	5300	2630	-2670	0.08	0.50	9	4	-5
0020	3T	23	134	195	14	19500	13330	-6170	0.07	0.68	34	23	-11
0020	3T	23	135	109	5	10900	3310	-7590	0.05	0.30	19	5	-14
0020	3T	23	136	52	3	5200	3290	-1910	0.06	0.63	9	5	-4
0020	3T	23	142	21	0	2100	0	-2100	0.00	0.00	3	0	-3
0020	3T	23	143	1	0	100	0	-100	0.00	0.00	0	0	0
0020	3T	23	145	89	7	8900	5600	-3300	0.08	0.63	15	9	-6
0020	3T	23	146	41	0	4100	0	-4100	0.00	0.00	7	0	-7
0020	3T	23	152	1	0	100	0	-100	0.00	0.00	0	0	0
0020	3T	23	156	10	1	1000	910	-90	0.10	0.91	1	1	0
0020	3T	23	163	1	0	100	0	-100	0.00	0.00	0	0	0
0020	3T	23	164	1	0	100	0	-100	0.00	0.00	0	0	0
0020	3T	23	234	5	0	500	0	-500	0.00	0.00	0	0	0
0020	3T	23	235	3	0	300	0	-300	0.00	0.00	0	0	0
0020	3T	23	236	2	0	200	0	-200	0.00	0.00	0	0	0
0020	3T	23	245	1	0	100	0	-100	0.00	0.00	0	0	0
0020	3T	23	256	1	0	100	0	-100	0.00	0.00	0	0	0
0020	3T	24	123	238	45	23800	23910	110	0.19	1.00	42	42	0
0020	3T	24	124	981	90	98100	73040	-25060	0.09	0.74	173	129	-44
0020	3T	24	125	224	22	22400	25050	2650	0.10	1.12	39	44	5
0020	3T	24	126	212	12	21200	10050	-11150	0.06	0.47	37	17	-20
0020	3T	24	132	10	1	1000	880	-120	0.10	0.88	1	1	0
0020	3T	24	134	241	36	24100	25050	950	0.15	1.04	42	44	2
0020	3T	24	135	115	10	11500	8920	-2580	0.09	0.78	20	15	-5
0020	3T	24	136	80	4	8000	3840	-4160	0.05	0.48	14	6	-8
0020	3T	24	142	15	2	1500	1150	-350	0.13	0.77	2	2	0
0020	3T	24	143	3	2	300	1760	1460	0.67	5.87	0	3	3
0020	3T	24	145	65	5	6500	5850	-650	0.08	0.90	11	10	-1
0020	3T	24	146	30	0	3000	0	-3000	0.00	0.00	5	0	-5
0020	3T	24	152	1	1	100	1780	1680	1.00	17.80	0	3	3
0020	3T	24	153	2	0	200	0	-200	0.00	0.00	0	0	0
0020	3T	24	156	6	2	600	1480	880	0.33	2.47	1	2	1
0020	3T	24	163	2	0	200	0	-200	0.00	0.00	0	0	0
0020	3T	24	164	4	1	400	860	460	0.25	2.15	0	1	1
0020	3T	24	234	3	0	300	0	-300	0.00	0.00	0	0	0
0020	3T	24	235	1	0	100	0	-100	0.00	0.00	0	0	0
0020	3T	24	236	3	0	300	0	-300	0.00	0.00	0	0	0
0020	3T	24	245	2	0	200	0	-200	0.00	0.00	0	0	0
0020	3T	24	264	1	0	100	0	-100	0.00	0.00	0	0	0
0023	2T	02_3	13	53	9	5300	4670	-630	0.17	0.88	9	8	-1
0023	2T	02_3	14	18	0	1800	0	-1800	0.00	0.00	3	0	-3
0023	2T	02_3	15	7	1	700	2120	1420	0.14	3.03	1	3	2
0023	2T	02_3	16	9	0	900	0	-900	0.00	0.00	1	0	-1
0023	2T	02_3	21	1	0	100	0	-100	0.00	0.00	0	0	0
0023	2T	02_3	23	4	1	400	930	530	0.25	2.33	0	1	1
0023	2T	02_3	24	5	0	500	0	-500	0.00	0.00	0	0	0
0023	2T	02_3	25	3	0	300	0	-300	0.00	0.00	0	0	0
0023	2T	02_3	26	2	0	200	0	-200	0.00	0.00	0	0	0
0023	2T	02_4	12	101	17	10100	8750	-1350	0.17	0.87	17	15	-2
0023	2T	02_4	13	57	8	5700	2610	-3090	0.14	0.46	10	4	-6
0023	2T	02_4	14	22	5	2200	2450	250	0.23	1.11	3	4	1
0023	2T	02_4	15	7	1	700	850	150	0.14	1.21	1	1	0
0023	2T	02_4	16	10	1	1000	1560	560	0.10	1.56	1	2	1
0023	2T	02_4	21	4	0	400	0	-400	0.00	0.00	0	0	0
0023	2T	02_4	23	3	1	300	590	290	0.33	1.97	0	1	1
0023	2T	02_4	24	6	0	600	0	-600	0.00	0.00	1	0	-1
0023	2T	02_4	25	3	0	300	0	-300	0.00	0.00	0	0	0
0023	2T	02_5	12	113	24	11300	10450	-850	0.21	0.92	20	18	-2
0023	2T	02_5	13	41	6	4100	4330	230	0.15	1.06	7	7	0
0023	2T	02_5	14	17	2	1700	770	-930	0.12	0.45	3	1	-2
0023	2T	02_5	15	14	4	1400	3960	2560	0.29	2.83	2	7	5
0023	2T	02_5	16	8	0	800	0	-800	0.00	0.00	1	0	-1
0023	2T	02_5	21	2	0	200	0	-200	0.00	0.00	0	0	0
0023	2T	02_5	23	2	0	200	0	-200	0.00	0.00	0	0	0
0023	2T	02_5	25	2	0	200	0	-200	0.00	0.00	0	0	0
0023	2T	02_6	12	93	17	9300	9480	180	0.18	1.02	16	16	0
0023	2T	02_6	13	47	4	4700	1660	-3040	0.09	0.35	8	2	-6
0023	2T	02_6	14	22	2	2200	1020	-1180	0.09	0.46	3	1	-2
0023	2T	02_6	15	12	2	1200	1080	-120	0.17	0.90	2	1	-1
0023	2T	02_6	16	13	1	1300	580	-720	0.08	0.45	2	1	-1
0023	2T	02_6	21	2	0	200	0	-200	0.00	0.00	0	0	0
0023	2T	02_6	23	3	0	300	0	-300	0.00	0.00	0	0	0
0023	2T	02_6	24	1	0	100	0	-100	0.00	0.00	0	0	0
0023	2T	02_6	25	4	1	400	740	340	0.25	1.85	0	1	1
0023	2T	02_6	26	2	0	200	0	-200	0.00	0.00	0	0	0
0023	2T	02_7	12	176	38	17600	12580	-5020	0.22	0.71	31	22	-9
0023	2T	02_7	13	58	12	5800	3990	-1810	0.21	0.69	10	7	-3
0023	2T	02_7	14	19	3	1900	1300	-600	0.16	0.68	3	2	-1
0023	2T	02_7	15	4	0	400	0	-400	0.00	0.00	0	0	0
0023	2T	02_8	12	104	20	10400	9540	-860	0.19	0.92	18	16	-2
0023	2T	02_8	13	63	13	6300	7850	1550	0.21	1.25	11	13	2
0023	2T	02_8	14	22	5	2200	3320	1120	0.23	1.51	3	5	2
0023	2T	02_8	15	10	0	1000	0	-1000	0.00	0.00	1	0	-1
0023	2T	02_8	16	6	1	600	600	0	0.17	1.00	1	1	0
0011	1T	1_1	1	942	620	94200	87640	-6560	0.66	0.93	166	155	-11
0011	1T	1_1	2	74	11	7400	4700	-2700	0.15	0.64	13	8	-5
0011	1T	1_10	1	1091	634	109100	95500	-13600	0.58	0.88	193	169	-24
0011	1T	1_10	2	39	16	3900	5580	1680	0.41	1.43	6	9	3
0011	1T	1_11	1	1120	718	112000	101390	-10610	0.64	0.91	198	179	-19
0011	1T	1_11	2	17	4	1700	2650	950	0.24	1.56	3	4	1
0011	1T	1_12	1	1146	787	114600	103560	-11040	0.69	0.90	202	183	-19
0011	1T	1_12	2	6	1	600	350	-250	0.17	0.58	1	0	-1
0011	1T	1_2	1	958	439	95800	87530	-8270	0.46	0.91	169	154	-15
0011	1T	1_2	2	92	21	9200	12510	3310	0.23	1.36	16	22	6
0011	1T	1_3	1	975	407	97500	88390	-9110	0.42	0.91	172	156	-16
0011	1T	1_3	2	95	28	9500	10170	670	0.29	1.07	16	18	2
0011	1T	1_4	1	991	454	99100	91370	-7730	0.46	0.92	175	161	-14
0011	1T	1_4	2	91	23	9100	6920	-2180	0.25	0.76	16	12	-4
0011	1T	1_5	1	923	498	92300	85690	-6610	0.54	0.93	163	151	-12
0011	1T	1_5	2	130	46	13000	10910	-2090	0.35	0.84	23	19	-4
0011	1T	1_6	1	831	361	83100	79940	-3160	0.43	0.96	147	141	-6
0011	1T	1_6	2	152	44	15200	14610	-590	0.29	0.96	26	25	-1
0011	1T	1_7	1	885	409	88500	75750	-12750	0.46	0.86	156	134	-22
0011	1T	1_7	2	146	51	14600	12210	-2390	0.35	0.84	25	21	-4
0011	1T	1_8	1	851	442	85100	77150	-7950	0.52	0.91	150	136	-14
0011	1T	1_8	2	138	58	13800	13570	-230	0.42	0.98	24	24	0
0011	1T	1_9	1	966	549	96600	90740	-5860	0.57	0.94	170	160	-10
0011	1T	1_9	2	92	30	9200	8530	-670	0.33	0.93	16	15	-1
0011	1T	2_1	1	917	602	91700	82310	-9390	0.66	0.90	162	145	-17
0011	1T	2_1	2	79	11	7900	4340	-3560	0.14	0.55	13	7	-6
0011	1T	2_10	1	1034	574	103400	98570	-4830	0.56	0.95	183	174	-9
0011	1T	2_10	2	52	16	5200	3090	-2110	0.31	0.59	9	5	-4
0011	1T	2_11	1	1101	644	110100	92850	-17250	0.58	0.84	194	164	-30
0011	1T	2_11	2	18	8	1800	2650	850	0.44	1.47	3	4	1
0011	1T	2_12	1	1138	805	113800	105850	-7950	0.71	0.93	201	187	-14
0011	1T	2_12	2	11	1	1100	320	-780	0.09	0.29	1	0	-1
0011	1T	2_2	1	801	355	80100	78000	-2100	0.44	0.97	141	138	-3
0011	1T	2_2	2	130	45	13000	15500	2500	0.35	1.19	23	27	4
0011	1T	2_3	1	800	344	80000	71120	-8880	0.43	0.89	141	125	-16
0011	1T	2_3	2	153	59	15300	16570	1270	0.39	1.08	27	29	2
0011	1T	2_4	1	835	418	83500	80860	-2640	0.50	0.97	147	143	-4
0011	1T	2_4	2	168	58	16800	18620	1820	0.35	1.11	29	32	3
0011	1T	2_5	1	861	490	86100	81690	-4410	0.57	0.95	152	144	-8
0011	1T	2_5	2	143	58	14300	12630	-1670	0.41	0.88	25	22	-3
0011	1T	2_6	1	795	371	79500	80400	900	0.47	1.01	140	142	2
0011	1T	2_6	2	179	66	17900	15330	-2570	0.37	0.86	31	27	-4
0011	1T	2_7	1	826	408	82600	76760	-5840	0.49	0.93	146	135	-11
0011	1T	2_7	2	160	64	16000	14430	-1570	0.40	0.90	28	25	-3
0011	1T	2_8	1	833	429	83300	75300	-8000	0.52	0.90	147	133	-14
0011	1T	2_8	2	145	63	14500	16950	2450	0.43	1.17	25	30	5
0011	1T	2_9	1	918	478	91800	80180	-11620	0.52	0.87	162	141	-21
0011	1T	2_9	2	127	51	12700	13490	790	0.40	1.06	22	23	1
0011	1T	3_1	1	942	595	94200	85420	-8780	0.63	0.91	166	151	-15
0011	1T	3_1	2	84	12	8400	5900	-2500	0.14	0.70	14	10	-4
0011	1T	3_10	1	1000	575	100000	92340	-7660	0.58	0.92	176	163	-13
0011	1T	3_10	2	85	29	8500	8810	310	0.34	1.04	15	15	0
0011	1T	3_11	1	1101	747	110100	107480	-2620	0.68	0.98	194	190	-4
0011	1T	3_11	2	24	6	2400	1840	-560	0.25	0.77	4	3	-1
0011	1T	3_12	1	1143	800	114300	99690	-14610	0.70	0.87	202	176	-26
0011	1T	3_12	2	15	1	1500	330	-1170	0.07	0.22	2	0	-2
0011	1T	3_2	1	851	384	85100	79400	-5700	0.45	0.93	150	140	-10
0011	1T	3_2	2	134	29	13400	9730	-3670	0.22	0.73	23	17	-6
0011	1T	3_3	1	869	385	86900	80010	-6890	0.44	0.92	153	141	-12
0011	1T	3_3	2	138	36	13800	16350	2550	0.26	1.18	24	28	4
0011	1T	3_4	1	828	389	82800	81780	-1020	0.47	0.99	146	144	-2
0011	1T	3_4	2	159	47	15900	15640	-260	0.30	0.98	28	27	-1
0011	1T	3_5	1	882	500	88200	87020	-1180	0.57	0.99	156	154	-2
0011	1T	3_5	2	138	48	13800	13650	-150	0.35	0.99	24	24	0
0011	1T	3_6	1	774	372	77400	77040	-360	0.48	1.00	136	136	0
0011	1T	3_6	2	213	77	21300	23120	1820	0.36	1.09	37	40	3
0011	1T	3_7	1	840	405	84000	83200	-800	0.48	0.99	148	147	-1
0011	1T	3_7	2	147	50	14700	12200	-2500	0.34	0.83	26	21	-5
0011	1T	3_8	1	806	430	80600	81640	1040	0.53	1.01	142	144	2
0011	1T	3_8	2	165	63	16500	14670	-1830	0.38	0.89	29	25	-4
0011	1T	3_9	1	882	517	88200	88660	460	0.59	1.01	156	156	0
0011	1T	3_9	2	131	38	13100	8850	-4250	0.29	0.68	23	15	-8
0011	1T	4_1	1	736	500	73600	66720	-6880	0.68	0.91	130	118	-12
0011	1T	4_1	2	78	16	7800	5550	-2250	0.21	0.71	13	9	-4
0011	1T	4_10	1	883	529	88300	79290	-9010	0.60	0.90	156	140	-16
0011	1T	4_10	2	37	3	3700	600	-3100	0.08	0.16	6	1	-5
0011	1T	4_11	1	915	634	91500	84120	-7380	0.69	0.92	161	148	-13
0011	1T	4_11	2	21	4	2100	2890	790	0.19	1.38	3	5	2
0011	1T	4_12	1	922	683	92200	86240	-5960	0.74	0.94	163	152	-11
0011	1T	4_12	2	18	1	1800	990	-810	0.06	0.55	3	1	-2
0011	1T	4_2	1	649	319	64900	59280	-5620	0.49	0.91	114	104	-10
0011	1T	4_2	2	131	34	13100	10140	-2960	0.26	0.77	23	17	-6
0011	1T	4_3	1	624	325	62400	66660	4260	0.52	1.07	110	117	7
0011	1T	4_3	2	163	60	16300	14980	-1320	0.37	0.92	28	26	-2
0011	1T	4_4	1	661	344	66100	58360	-7740	0.52	0.88	116	103	-13
0011	1T	4_4	2	135	45	13500	12120	-1380	0.33	0.90	23	21	-2
0011	1T	4_5	1	712	420	71200	66300	-4900	0.59	0.93	126	117	-9
0011	1T	4_5	2	124	46	12400	11830	-570	0.37	0.95	21	20	-1
0011	1T	4_6	1	603	311	60300	58090	-2210	0.52	0.96	106	102	-4
0011	1T	4_6	2	164	68	16400	14750	-1650	0.41	0.90	29	26	-3
0011	1T	4_7	1	681	361	68100	66070	-2030	0.53	0.97	120	116	-4
0011	1T	4_7	2	129	61	12900	16050	3150	0.47	1.24	22	28	6
0011	1T	4_8	1	703	393	70300	64060	-6240	0.56	0.91	124	113	-11
0011	1T	4_8	2	104	45	10400	11090	690	0.43	1.07	18	19	1
0011	1T	4_9	1	774	481	77400	72880	-4520	0.62	0.94	136	128	-8
0011	1T	4_9	2	89	29	8900	7020	-1880	0.33	0.79	15	12	-3
0011	1T	5_1	1	592	407	59200	52390	-6810	0.69	0.88	104	92	-12
0011	1T	5_1	2	53	8	5300	2730	-2570	0.15	0.52	9	4	-5
0011	1T	5_10	1	673	470	67300	60270	-7030	0.70	0.90	119	106	-13
0011	1T	5_10	2	40	12	4000	3550	-450	0.30	0.89	7	6	-1
0011	1T	5_11	1	706	517	70600	63640	-6960	0.73	0.90	124	112	-12
0011	1T	5_11	2	20	3	2000	1190	-810	0.15	0.60	3	2	-1
0011	1T	5_12	1	690	519	69000	63280	-5720	0.75	0.92	122	112	-10
0011	1T	5_12	2	22	8	2200	4100	1900	0.36	1.86	3	7	4
0011	1T	5_2	1	554	304	55400	50560	-4840	0.55	0.91	98	89	-9
0011	1T	5_2	2	66	16	6600	7320	720	0.24	1.11	11	12	1
0011	1T	5_3	1	545	307	54500	55240	740	0.56	1.01	96	97	1
0011	1T	5_3	2	68	19	6800	5450	-1350	0.28	0.80	12	9	-3
0011	1T	5_4	1	557	309	55700	51580	-4120	0.55	0.93	98	91	-7
0011	1T	5_4	2	62	14	6200	6120	-80	0.23	0.99	10	10	0
0011	1T	5_5	1	612	377	61200	57900	-3300	0.62	0.95	108	102	-6
0011	1T	5_5	2	44	7	4400	1450	-2950	0.16	0.33	7	2	-5
0011	1T	5_6	1	550	311	55000	50290	-4710	0.57	0.91	97	89	-8
0011	1T	5_6	2	81	21	8100	5960	-2140	0.26	0.74	14	10	-4
0011	1T	5_7	1	605	371	60500	58750	-1750	0.61	0.97	107	103	-4
0011	1T	5_7	2	46	15	4600	4190	-410	0.33	0.91	8	7	-1
0011	1T	5_8	1	594	347	59400	54880	-4520	0.58	0.92	105	97	-8
0023	2T	02_8	21	1	0	100	0	-100	0.00	0.00	0	0	0
0023	2T	02_8	23	3	0	300	0	-300	0.00	0.00	0	0	0
0023	2T	02_8	24	1	0	100	0	-100	0.00	0.00	0	0	0
0023	2T	02_8	26	3	0	300	0	-300	0.00	0.00	0	0	0
0023	2T	02_9	12	143	32	14300	13520	-780	0.22	0.95	25	23	-2
0023	2T	02_9	13	69	12	6900	6030	-870	0.17	0.87	12	10	-2
0023	2T	02_9	14	20	4	2000	3400	1400	0.20	1.70	3	6	3
0023	2T	02_9	15	8	3	800	2030	1230	0.38	2.54	1	3	2
0023	2T	02_9	16	8	1	800	700	-100	0.13	0.88	1	1	0
0023	2T	02_9	24	1	0	100	0	-100	0.00	0.00	0	0	0
0023	2T	02_9	25	1	1	100	510	410	1.00	5.10	0	0	0
0023	2T	03_1	12	63	11	6300	4160	-2140	0.17	0.66	11	7	-4
0023	2T	03_1	13	39	9	3900	4400	500	0.23	1.13	6	7	1
0023	2T	03_1	14	11	3	1100	1210	110	0.27	1.10	1	2	1
0023	2T	03_1	15	6	1	600	810	210	0.17	1.35	1	1	0
0023	2T	03_1	16	4	0	400	0	-400	0.00	0.00	0	0	0
0023	2T	03_1	23	5	1	500	550	50	0.20	1.10	0	0	0
0023	2T	03_1	26	2	0	200	0	-200	0.00	0.00	0	0	0
0023	2T	03_10	12	111	29	11100	9350	-1750	0.26	0.84	19	16	-3
0023	2T	03_10	13	42	12	4200	4810	610	0.29	1.15	7	8	1
0023	2T	03_10	14	22	3	2200	1070	-1130	0.14	0.49	3	1	-2
0023	2T	03_10	15	8	1	800	440	-360	0.13	0.55	1	0	-1
0023	2T	03_10	16	5	2	500	1980	1480	0.40	3.96	0	3	3
0023	2T	03_11	12	120	32	12000	11190	-810	0.27	0.93	21	19	-2
0023	2T	03_11	13	55	11	5500	4170	-1330	0.20	0.76	9	7	-2
0023	2T	03_11	14	12	2	1200	600	-600	0.17	0.50	2	1	-1
0023	2T	03_11	15	3	1	300	420	120	0.33	1.40	0	0	0
0023	2T	03_11	16	1	0	100	0	-100	0.00	0.00	0	0	0
0023	2T	03_12	12	148	38	14800	13980	-820	0.26	0.94	26	24	-2
0023	2T	03_12	13	28	6	2800	2020	-780	0.21	0.72	4	3	-1
0023	2T	03_12	14	8	2	800	930	130	0.25	1.16	1	1	0
0023	2T	03_12	15	3	0	300	0	-300	0.00	0.00	0	0	0
0023	2T	03_12	24	1	0	100	0	-100	0.00	0.00	0	0	0
0023	2T	03_2	12	61	13	6100	6150	50	0.21	1.01	10	10	0
0023	2T	03_2	13	44	11	4400	7090	2690	0.25	1.61	7	12	5
0023	2T	03_2	14	23	0	2300	0	-2300	0.00	0.00	4	0	-4
0023	2T	03_2	15	8	2	800	1630	830	0.25	2.04	1	2	1
0023	2T	03_2	16	7	0	700	0	-700	0.00	0.00	1	0	-1
0023	2T	03_2	24	2	0	200	0	-200	0.00	0.00	0	0	0
0023	2T	03_2	26	1	0	100	0	-100	0.00	0.00	0	0	0
0023	2T	03_3	12	51	8	5100	3400	-1700	0.16	0.67	9	6	-3
0023	2T	03_3	13	37	9	3700	3930	230	0.24	1.06	6	6	0
0023	2T	03_3	14	20	1	2000	320	-1680	0.05	0.16	3	0	-3
0023	2T	03_3	15	14	2	1400	3280	1880	0.14	2.34	2	5	3
0023	2T	03_3	16	8	1	800	1170	370	0.13	1.46	1	2	1
0023	2T	03_3	23	6	2	600	1000	400	0.33	1.67	1	1	0
0023	2T	03_3	24	3	0	300	0	-300	0.00	0.00	0	0	0
0023	2T	03_3	25	2	1	200	530	330	0.50	2.65	0	0	0
0023	2T	03_3	26	2	0	200	0	-200	0.00	0.00	0	0	0
0023	2T	03_4	12	50	9	5000	3600	-1400	0.18	0.72	8	6	-2
0023	2T	03_4	13	35	6	3500	2830	-670	0.17	0.81	6	5	-1
0023	2T	03_4	14	27	4	2700	1960	-740	0.15	0.73	4	3	-1
0023	2T	03_4	15	16	4	1600	3420	1820	0.25	2.14	2	6	4
0023	2T	03_4	16	10	2	1000	3700	2700	0.20	3.70	1	6	5
0023	2T	03_4	21	1	0	100	0	-100	0.00	0.00	0	0	0
0023	2T	03_4	23	3	0	300	0	-300	0.00	0.00	0	0	0
0023	2T	03_4	24	4	0	400	0	-400	0.00	0.00	0	0	0
0023	2T	03_5	12	50	8	5000	3640	-1360	0.16	0.73	8	6	-2
0023	2T	03_5	13	43	11	4300	5460	1160	0.26	1.27	7	9	2
0023	2T	03_5	14	21	2	2100	1310	-790	0.10	0.62	3	2	-1
0023	2T	03_5	15	8	1	800	1790	990	0.13	2.24	1	3	2
0023	2T	03_5	16	11	0	1100	0	-1100	0.00	0.00	1	0	-1
0023	2T	03_5	23	1	0	100	0	-100	0.00	0.00	0	0	0
0023	2T	03_5	24	4	0	400	0	-400	0.00	0.00	0	0	0
0023	2T	03_5	25	1	0	100	0	-100	0.00	0.00	0	0	0
0023	2T	03_5	26	3	0	300	0	-300	0.00	0.00	0	0	0
0023	2T	03_6	12	51	11	5100	5480	380	0.22	1.07	9	9	0
0023	2T	03_6	13	44	7	4400	3610	-790	0.16	0.82	7	6	-1
0023	2T	03_6	14	25	3	2500	1340	-1160	0.12	0.54	4	2	-2
0023	2T	03_6	15	13	1	1300	520	-780	0.08	0.40	2	0	-2
0023	2T	03_6	16	9	0	900	0	-900	0.00	0.00	1	0	-1
0023	2T	03_6	21	1	0	100	0	-100	0.00	0.00	0	0	0
0023	2T	03_6	23	6	1	600	430	-170	0.17	0.72	1	0	-1
0023	2T	03_6	24	1	0	100	0	-100	0.00	0.00	0	0	0
0023	2T	03_6	25	1	1	100	440	340	1.00	4.40	0	0	0
0023	2T	03_7	12	69	16	6900	5330	-1570	0.23	0.77	12	9	-3
0023	2T	03_7	13	37	7	3700	2480	-1220	0.19	0.67	6	4	-2
0023	2T	03_7	14	26	4	2600	1720	-880	0.15	0.66	4	3	-1
0023	2T	03_7	15	19	5	1900	3340	1440	0.26	1.76	3	5	2
0023	2T	03_7	16	4	0	400	0	-400	0.00	0.00	0	0	0
0023	2T	03_7	23	1	0	100	0	-100	0.00	0.00	0	0	0
0023	2T	03_7	25	2	0	200	0	-200	0.00	0.00	0	0	0
0023	2T	03_7	26	2	0	200	0	-200	0.00	0.00	0	0	0
0023	2T	03_8	12	67	15	6700	5340	-1360	0.22	0.80	11	9	-2
0023	2T	03_8	13	45	8	4500	3710	-790	0.18	0.82	7	6	-1
0023	2T	03_8	14	38	8	3800	3500	-300	0.21	0.92	6	6	0
0023	2T	03_8	15	11	1	1100	480	-620	0.09	0.44	1	0	-1
0023	2T	03_8	16	8	1	800	570	-230	0.13	0.71	1	1	0
0023	2T	03_8	23	2	0	200	0	-200	0.00	0.00	0	0	0
0023	2T	03_8	24	2	0	200	0	-200	0.00	0.00	0	0	0
0023	2T	03_9	12	86	20	8600	6340	-2260	0.23	0.74	15	11	-4
0023	2T	03_9	13	57	10	5700	3380	-2320	0.18	0.59	10	5	-5
0023	2T	03_9	14	19	4	1900	1650	-250	0.21	0.87	3	2	-1
0023	2T	03_9	15	12	2	1200	1050	-150	0.17	0.88	2	1	-1
0023	2T	03_9	16	5	0	500	0	-500	0.00	0.00	0	0	0
0023	2T	04_1	12	45	8	4500	3570	-930	0.18	0.79	7	6	-1
0023	2T	04_1	13	58	11	5800	5840	40	0.19	1.01	10	10	0
0023	2T	04_1	14	35	4	3500	2280	-1220	0.11	0.65	6	4	-2
0023	2T	04_1	15	17	1	1700	630	-1070	0.06	0.37	3	1	-2
0023	2T	04_1	16	5	2	500	1000	500	0.40	2.00	0	1	1
0023	2T	04_1	23	4	0	400	0	-400	0.00	0.00	0	0	0
0023	2T	04_1	25	1	1	100	1120	1020	1.00	11.20	0	1	1
0023	2T	04_10	12	116	25	11600	8850	-2750	0.22	0.76	20	15	-5
0023	2T	04_10	13	69	10	6900	3950	-2950	0.14	0.57	12	6	-6
0023	2T	04_10	14	29	7	2900	3130	230	0.24	1.08	5	5	0
0023	2T	04_10	15	4	1	400	430	30	0.25	1.08	0	0	0
0023	2T	04_10	16	1	1	100	1070	970	1.00	10.70	0	1	1
0023	2T	04_10	21	1	0	100	0	-100	0.00	0.00	0	0	0
0023	2T	04_10	24	1	0	100	0	-100	0.00	0.00	0	0	0
0023	2T	04_11	12	125	25	12500	9380	-3120	0.20	0.75	22	16	-6
0023	2T	04_11	13	66	13	6600	4770	-1830	0.20	0.72	11	8	-3
0023	2T	04_11	14	36	5	3600	2060	-1540	0.14	0.57	6	3	-3
0023	2T	04_11	15	4	0	400	0	-400	0.00	0.00	0	0	0
0023	2T	04_11	16	1	0	100	0	-100	0.00	0.00	0	0	0
0023	2T	04_11	21	1	0	100	0	-100	0.00	0.00	0	0	0
0023	2T	04_12	12	158	34	15800	11660	-4140	0.22	0.74	27	20	-7
0023	2T	04_12	13	51	11	5100	3830	-1270	0.22	0.75	9	6	-3
0023	2T	04_12	14	22	4	2200	1470	-730	0.18	0.67	3	2	-1
0023	2T	04_12	15	2	0	200	0	-200	0.00	0.00	0	0	0
0023	2T	04_12	21	2	1	200	700	500	0.50	3.50	0	1	1
0023	2T	04_2	12	44	7	4400	3140	-1260	0.16	0.71	7	5	-2
0023	2T	04_2	13	40	3	4000	1330	-2670	0.08	0.33	7	2	-5
0023	2T	04_2	14	52	4	5200	2910	-2290	0.08	0.56	9	5	-4
0023	2T	04_2	15	10	1	1000	360	-640	0.10	0.36	1	0	-1
0023	2T	04_2	16	10	2	1000	890	-110	0.20	0.89	1	1	0
0023	2T	04_2	23	3	0	300	0	-300	0.00	0.00	0	0	0
0023	2T	04_2	24	1	1	100	760	660	1.00	7.60	0	1	1
0023	2T	04_2	25	2	0	200	0	-200	0.00	0.00	0	0	0
0023	2T	04_2	26	1	0	100	0	-100	0.00	0.00	0	0	0
0023	2T	04_3	12	76	21	7600	9360	1760	0.28	1.23	13	16	3
0023	2T	04_3	13	39	10	3900	4520	620	0.26	1.16	6	8	2
0023	2T	04_3	14	21	4	2100	1670	-430	0.19	0.80	3	2	-1
0023	2T	04_3	15	15	2	1500	1950	450	0.13	1.30	2	3	1
0023	2T	04_3	16	14	1	1400	1080	-320	0.07	0.77	2	1	-1
0023	2T	04_3	23	1	0	100	0	-100	0.00	0.00	0	0	0
0023	2T	04_3	24	5	0	500	0	-500	0.00	0.00	0	0	0
0023	2T	04_3	25	1	0	100	0	-100	0.00	0.00	0	0	0
0023	2T	04_3	26	2	0	200	0	-200	0.00	0.00	0	0	0
0023	2T	04_4	12	61	10	6100	6300	200	0.16	1.03	10	11	1
0023	2T	04_4	13	37	6	3700	3870	170	0.16	1.05	6	6	0
0023	2T	04_4	14	35	5	3500	4190	690	0.14	1.20	6	7	1
0023	2T	04_4	15	15	0	1500	0	-1500	0.00	0.00	2	0	-2
0023	2T	04_4	16	7	0	700	0	-700	0.00	0.00	1	0	-1
0023	2T	04_4	21	4	0	400	0	-400	0.00	0.00	0	0	0
0023	2T	04_4	23	2	0	200	0	-200	0.00	0.00	0	0	0
0023	2T	04_4	24	3	1	300	510	210	0.33	1.70	0	0	0
0023	2T	04_4	25	1	0	100	0	-100	0.00	0.00	0	0	0
0023	2T	04_4	26	2	0	200	0	-200	0.00	0.00	0	0	0
0023	2T	04_5	12	97	29	9700	10990	1290	0.30	1.13	17	19	2
0023	2T	04_5	13	45	16	4500	6430	1930	0.36	1.43	7	11	4
0023	2T	04_5	14	25	4	2500	2360	-140	0.16	0.94	4	4	0
0023	2T	04_5	15	9	1	900	480	-420	0.11	0.53	1	0	-1
0023	2T	04_5	16	8	0	800	0	-800	0.00	0.00	1	0	-1
0023	2T	04_5	21	1	0	100	0	-100	0.00	0.00	0	0	0
0023	2T	04_5	23	4	0	400	0	-400	0.00	0.00	0	0	0
0023	2T	04_5	24	3	0	300	0	-300	0.00	0.00	0	0	0
0023	2T	04_5	25	2	1	200	940	740	0.50	4.70	0	1	1
0023	2T	04_5	26	2	0	200	0	-200	0.00	0.00	0	0	0
0023	2T	04_6	12	51	12	5100	6520	1420	0.24	1.28	9	11	2
0023	2T	04_6	13	38	10	3800	3750	-50	0.26	0.99	6	6	0
0023	2T	04_6	14	36	3	3600	1240	-2360	0.08	0.34	6	2	-4
0023	2T	04_6	15	7	0	700	0	-700	0.00	0.00	1	0	-1
0023	2T	04_6	16	9	0	900	0	-900	0.00	0.00	1	0	-1
0023	2T	04_6	21	2	0	200	0	-200	0.00	0.00	0	0	0
0023	2T	04_6	23	4	2	400	610	210	0.50	1.53	0	1	1
0023	2T	04_6	24	3	0	300	0	-300	0.00	0.00	0	0	0
0023	2T	04_6	25	3	0	300	0	-300	0.00	0.00	0	0	0
0023	2T	04_6	26	4	0	400	0	-400	0.00	0.00	0	0	0
0023	2T	04_7	12	73	16	7300	6840	-460	0.22	0.94	12	12	0
0023	2T	04_7	13	40	9	4000	3840	-160	0.23	0.96	7	6	-1
0023	2T	04_7	14	29	4	2900	1380	-1520	0.14	0.48	5	2	-3
0023	2T	04_7	15	13	1	1300	700	-600	0.08	0.54	2	1	-1
0023	2T	04_7	16	15	0	1500	0	-1500	0.00	0.00	2	0	-2
0023	2T	04_7	21	1	0	100	0	-100	0.00	0.00	0	0	0
0023	2T	04_7	23	1	0	100	0	-100	0.00	0.00	0	0	0
0023	2T	04_7	24	3	0	300	0	-300	0.00	0.00	0	0	0
0023	2T	04_7	26	1	0	100	0	-100	0.00	0.00	0	0	0
0023	2T	04_8	12	86	16	8600	8780	180	0.19	1.02	15	15	0
0023	2T	04_8	13	60	19	6000	7970	1970	0.32	1.33	10	14	4
0023	2T	04_8	14	32	5	3200	1940	-1260	0.16	0.61	5	3	-2
0023	2T	04_8	15	7	1	700	430	-270	0.14	0.61	1	0	-1
0023	2T	04_8	16	20	5	2000	2680	680	0.25	1.34	3	4	1
0023	2T	04_8	24	2	0	200	0	-200	0.00	0.00	0	0	0
0023	2T	04_8	26	2	0	200	0	-200	0.00	0.00	0	0	0
0023	2T	04_9	12	95	21	9500	10010	510	0.22	1.05	16	17	1
0023	2T	04_9	13	75	11	7500	4700	-2800	0.15	0.63	13	8	-5
0023	2T	04_9	14	32	8	3200	3080	-120	0.25	0.96	5	5	0
0023	2T	04_9	15	9	1	900	260	-640	0.11	0.29	1	0	-1
0023	2T	04_9	16	11	2	1100	1090	-10	0.18	0.99	1	1	0
0023	2T	04_9	26	1	0	100	0	-100	0.00	0.00	0	0	0
0023	2T	05_1	12	80	19	8000	8920	920	0.24	1.12	14	15	1
0023	2T	05_1	13	35	6	3500	2040	-1460	0.17	0.58	6	3	-3
0023	2T	05_1	14	143	45	14300	13760	-540	0.31	0.96	25	24	-1
0023	2T	05_1	16	1	0	100	0	-100	0.00	0.00	0	0	0
0023	2T	05_10	12	126	28	12600	9150	-3450	0.22	0.73	22	16	-6
0023	2T	05_10	13	73	18	7300	5740	-1560	0.25	0.79	12	10	-2
0023	2T	05_10	14	15	3	1500	1280	-220	0.20	0.85	2	2	0
0023	2T	05_10	15	1	0	100	0	-100	0.00	0.00	0	0	0
0023	2T	05_10	16	1	0	100	0	-100	0.00	0.00	0	0	0
0023	2T	05_10	21	6	1	600	640	40	0.17	1.07	1	1	0
0023	2T	05_10	23	1	0	100	0	-100	0.00	0.00	0	0	0
0023	2T	05_10	24	1	0	100	0	-100	0.00	0.00	0	0	0
0023	2T	05_11	12	140	38	14000	12230	-1770	0.27	0.87	24	21	-3
0023	2T	05_11	13	78	19	7800	6320	-1480	0.24	0.81	13	11	-2
0023	2T	05_11	14	23	6	2300	1900	-400	0.26	0.83	4	3	-1
0023	2T	05_11	15	1	0	100	0	-100	0.00	0.00	0	0	0
0023	2T	05_12	12	145	47	14500	14740	240	0.32	1.02	25	26	1
0023	2T	05_12	13	90	15	9000	5470	-3530	0.17	0.61	15	9	-6
0023	2T	05_12	14	11	3	1100	920	-180	0.27	0.84	1	1	0
0023	2T	05_12	16	1	0	100	0	-100	0.00	0.00	0	0	0
0023	2T	05_2	12	57	13	5700	5680	-20	0.23	1.00	10	10	0
0023	2T	05_2	13	61	9	6100	5000	-1100	0.15	0.82	10	8	-2
0023	2T	05_2	14	21	5	2100	4890	2790	0.24	2.33	3	8	5
0023	2T	05_2	15	12	1	1200	2120	920	0.08	1.77	2	3	1
0023	2T	05_2	16	8	1	800	930	130	0.13	1.16	1	1	0
0023	2T	05_2	21	1	0	100	0	-100	0.00	0.00	0	0	0
0023	2T	05_2	23	2	0	200	0	-200	0.00	0.00	0	0	0
0023	2T	05_2	24	3	1	300	510	210	0.33	1.70	0	0	0
0023	2T	05_3	12	67	9	6700	3950	-2750	0.13	0.59	11	6	-5
0023	2T	05_3	13	36	4	3600	1700	-1900	0.11	0.47	6	3	-3
0023	2T	05_3	14	23	6	2300	4440	2140	0.26	1.93	4	7	3
0023	2T	05_3	15	18	0	1800	0	-1800	0.00	0.00	3	0	-3
0023	2T	05_3	16	3	1	300	1150	850	0.33	3.83	0	2	2
0023	2T	05_3	21	3	0	300	0	-300	0.00	0.00	0	0	0
0023	2T	05_3	23	9	1	900	320	-580	0.11	0.36	1	0	-1
0023	2T	05_3	24	7	2	700	1000	300	0.29	1.43	1	1	0
0023	2T	05_3	25	1	0	100	0	-100	0.00	0.00	0	0	0
0023	2T	05_3	26	2	0	200	0	-200	0.00	0.00	0	0	0
0023	2T	05_4	12	58	8	5800	4010	-1790	0.14	0.69	10	7	-3
0023	2T	05_4	13	41	12	4100	5050	950	0.29	1.23	7	8	1
0023	2T	05_4	14	26	4	2600	1820	-780	0.15	0.70	4	3	-1
0023	2T	05_4	15	17	3	1700	1480	-220	0.18	0.87	3	2	-1
0023	2T	05_4	16	5	0	500	0	-500	0.00	0.00	0	0	0
0023	2T	05_4	21	3	0	300	0	-300	0.00	0.00	0	0	0
0023	2T	05_4	23	4	0	400	0	-400	0.00	0.00	0	0	0
0023	2T	05_4	24	6	2	600	1190	590	0.33	1.98	1	2	1
0023	2T	05_4	25	6	0	600	0	-600	0.00	0.00	1	0	-1
0023	2T	05_4	26	4	1	400	510	110	0.25	1.28	0	0	0
0023	2T	05_5	12	66	15	6600	9840	3240	0.23	1.49	11	17	6
0023	2T	05_5	13	37	6	3700	2710	-990	0.16	0.73	6	4	-2
0023	2T	05_5	14	26	4	2600	2820	220	0.15	1.08	4	4	0
0023	2T	05_5	15	15	3	1500	1780	280	0.20	1.19	2	3	1
0023	2T	05_5	16	8	2	800	1210	410	0.25	1.51	1	2	1
0023	2T	05_5	21	8	2	800	2150	1350	0.25	2.69	1	3	2
0023	2T	05_5	23	1	0	100	0	-100	0.00	0.00	0	0	0
0023	2T	05_5	24	2	1	200	390	190	0.50	1.95	0	0	0
0023	2T	05_5	25	4	1	400	430	30	0.25	1.08	0	0	0
0023	2T	05_5	26	2	0	200	0	-200	0.00	0.00	0	0	0
0023	2T	05_6	12	71	13	7100	5840	-1260	0.18	0.82	12	10	-2
0023	2T	05_6	13	41	7	4100	4890	790	0.17	1.19	7	8	1
0023	2T	05_6	14	28	7	2800	3140	340	0.25	1.12	4	5	1
0023	2T	05_6	15	12	3	1200	1310	110	0.25	1.09	2	2	0
0023	2T	05_6	16	8	1	800	1220	420	0.13	1.53	1	2	1
0023	2T	05_6	21	6	0	600	0	-600	0.00	0.00	1	0	-1
0023	2T	05_6	23	8	2	800	2410	1610	0.25	3.01	1	4	3
0023	2T	05_6	24	2	1	200	440	240	0.50	2.20	0	0	0
0023	2T	05_6	25	4	0	400	0	-400	0.00	0.00	0	0	0
0023	2T	05_6	26	3	0	300	0	-300	0.00	0.00	0	0	0
0023	2T	05_7	12	108	24	10800	10800	0	0.22	1.00	19	19	0
0023	2T	05_7	13	57	8	5700	2650	-3050	0.14	0.46	10	4	-6
0023	2T	05_7	14	19	1	1900	490	-1410	0.05	0.26	3	0	-3
0023	2T	05_7	15	10	1	1000	550	-450	0.10	0.55	1	0	-1
0023	2T	05_7	16	5	1	500	1020	520	0.20	2.04	0	1	1
0023	2T	05_7	21	9	2	900	1010	110	0.22	1.12	1	1	0
0023	2T	05_7	23	2	1	200	400	200	0.50	2.00	0	0	0
0023	2T	05_7	24	3	0	300	0	-300	0.00	0.00	0	0	0
0023	2T	05_7	26	1	0	100	0	-100	0.00	0.00	0	0	0
0023	2T	05_8	12	108	30	10800	12670	1870	0.28	1.17	19	22	3
0023	2T	05_8	13	61	15	6100	5350	-750	0.25	0.88	10	9	-1
0023	2T	05_8	14	25	5	2500	2200	-300	0.20	0.88	4	3	-1
0023	2T	05_8	15	5	1	500	420	-80	0.20	0.84	0	0	0
0023	2T	05_8	16	7	1	700	610	-90	0.14	0.87	1	1	0
0023	2T	05_8	21	5	0	500	0	-500	0.00	0.00	0	0	0
0023	2T	05_8	23	7	1	700	740	40	0.14	1.06	1	1	0
0023	2T	05_8	24	1	0	100	0	-100	0.00	0.00	0	0	0
0023	2T	05_8	26	2	0	200	0	-200	0.00	0.00	0	0	0
0023	2T	05_9	12	181	48	18100	13920	-4180	0.27	0.77	32	24	-8
0023	2T	05_9	13	49	8	4900	2160	-2740	0.16	0.44	8	3	-5
0023	2T	05_9	14	22	3	2200	1110	-1090	0.14	0.50	3	1	-2
0023	2T	05_9	15	3	2	300	520	220	0.67	1.73	0	0	0
0023	2T	06_1	12	131	36	13100	15010	1910	0.27	1.15	23	26	3
0023	2T	06_1	13	53	8	5300	3530	-1770	0.15	0.67	9	6	-3
0023	2T	06_1	14	20	2	2000	1440	-560	0.10	0.72	3	2	-1
0023	2T	06_1	15	7	0	700	0	-700	0.00	0.00	1	0	-1
0023	2T	06_1	16	5	1	500	1240	740	0.20	2.48	0	2	2
0023	2T	06_1	23	5	0	500	0	-500	0.00	0.00	0	0	0
0023	2T	06_1	24	6	0	600	0	-600	0.00	0.00	1	0	-1
0023	2T	06_1	25	3	0	300	0	-300	0.00	0.00	0	0	0
0023	2T	06_1	26	2	0	200	0	-200	0.00	0.00	0	0	0
0023	2T	06_10	12	142	37	14200	11830	-2370	0.26	0.83	25	20	-5
0023	2T	06_10	13	89	12	8900	4010	-4890	0.13	0.45	15	7	-8
0023	2T	06_10	14	23	6	2300	2330	30	0.26	1.01	4	4	0
0023	2T	06_10	15	1	0	100	0	-100	0.00	0.00	0	0	0
0023	2T	06_10	16	3	0	300	0	-300	0.00	0.00	0	0	0
0023	2T	06_10	21	1	0	100	0	-100	0.00	0.00	0	0	0
0023	2T	06_10	23	1	0	100	0	-100	0.00	0.00	0	0	0
0023	2T	06_10	25	1	0	100	0	-100	0.00	0.00	0	0	0
0023	2T	06_11	12	140	45	14000	13020	-980	0.32	0.93	24	23	-1
0023	2T	06_11	13	103	27	10300	9760	-540	0.26	0.95	18	17	-1
0023	2T	06_11	14	29	9	2900	2960	60	0.31	1.02	5	5	0
0023	2T	06_11	15	2	0	200	0	-200	0.00	0.00	0	0	0
0023	2T	06_12	12	162	36	16200	11920	-4280	0.22	0.74	28	21	-7
0023	2T	06_12	13	99	24	9900	7450	-2450	0.24	0.75	17	13	-4
0023	2T	06_12	14	15	2	1500	610	-890	0.13	0.41	2	1	-1
0023	2T	06_2	12	75	12	7500	5980	-1520	0.16	0.80	13	10	-3
0023	2T	06_2	13	45	4	4500	1360	-3140	0.09	0.30	7	2	-5
0023	2T	06_2	14	21	2	2100	1180	-920	0.10	0.56	3	2	-1
0023	2T	06_2	15	9	2	900	790	-110	0.22	0.88	1	1	0
0023	2T	06_2	16	8	1	800	680	-120	0.13	0.85	1	1	0
0023	2T	06_2	21	2	0	200	0	-200	0.00	0.00	0	0	0
0023	2T	06_2	23	9	2	900	680	-220	0.22	0.76	1	1	0
0023	2T	06_2	24	3	0	300	0	-300	0.00	0.00	0	0	0
0023	2T	06_2	25	2	0	200	0	-200	0.00	0.00	0	0	0
0023	2T	06_2	26	1	0	100	0	-100	0.00	0.00	0	0	0
0023	2T	06_3	12	58	10	5800	8390	2590	0.17	1.45	10	14	4
0023	2T	06_3	13	46	7	4600	4920	320	0.15	1.07	8	8	0
0023	2T	06_3	14	17	4	1700	3560	1860	0.24	2.09	3	6	3
0023	2T	06_3	15	4	0	400	0	-400	0.00	0.00	0	0	0
0023	2T	06_3	16	2	0	200	0	-200	0.00	0.00	0	0	0
0023	2T	06_3	21	7	1	700	770	70	0.14	1.10	1	1	0
0023	2T	06_3	23	6	0	600	0	-600	0.00	0.00	1	0	-1
0023	2T	06_3	24	10	0	1000	0	-1000	0.00	0.00	1	0	-1
0023	2T	06_3	25	4	0	400	0	-400	0.00	0.00	0	0	0
0023	2T	06_3	26	3	0	300	0	-300	0.00	0.00	0	0	0
0023	2T	06_4	12	177	52	17700	16060	-1640	0.29	0.91	31	28	-3
0023	2T	06_4	13	80	23	8000	6640	-1360	0.29	0.83	14	11	-3
0023	2T	06_4	14	16	2	1600	560	-1040	0.13	0.35	2	0	-2
0023	2T	06_4	15	6	0	600	0	-600	0.00	0.00	1	0	-1
0023	2T	06_5	12	56	9	5600	5170	-430	0.16	0.92	9	9	0
0023	2T	06_5	13	52	7	5200	6770	1570	0.13	1.30	9	11	2
0023	2T	06_5	14	21	3	2100	1400	-700	0.14	0.67	3	2	-1
0023	2T	06_5	15	4	1	400	560	160	0.25	1.40	0	0	0
0023	2T	06_5	16	4	0	400	0	-400	0.00	0.00	0	0	0
0023	2T	06_5	21	6	1	600	730	130	0.17	1.22	1	1	0
0023	2T	06_5	23	6	0	600	0	-600	0.00	0.00	1	0	-1
0023	2T	06_5	24	6	0	600	0	-600	0.00	0.00	1	0	-1
0023	2T	06_5	25	2	1	200	450	250	0.50	2.25	0	0	0
0023	2T	06_5	26	8	1	800	810	10	0.13	1.01	1	1	0
0023	2T	06_6	12	68	14	6800	5730	-1070	0.21	0.84	12	10	-2
0023	2T	06_6	13	46	8	4600	3630	-970	0.17	0.79	8	6	-2
0023	2T	06_6	14	24	2	2400	900	-1500	0.08	0.38	4	1	-3
0023	2T	06_6	15	8	4	800	1780	980	0.50	2.23	1	3	2
0023	2T	06_6	16	3	0	300	0	-300	0.00	0.00	0	0	0
0023	2T	06_6	21	5	0	500	0	-500	0.00	0.00	0	0	0
0023	2T	06_6	23	5	0	500	0	-500	0.00	0.00	0	0	0
0023	2T	06_6	24	3	0	300	0	-300	0.00	0.00	0	0	0
0023	2T	06_6	25	1	1	100	400	300	1.00	4.00	0	0	0
0023	2T	06_6	26	6	0	600	0	-600	0.00	0.00	1	0	-1
0023	2T	06_7	12	111	14	11100	5180	-5920	0.13	0.47	19	9	-10
0023	2T	06_7	13	81	14	8100	4560	-3540	0.17	0.56	14	8	-6
0023	2T	06_7	14	41	7	4100	4020	-80	0.17	0.98	7	7	0
0023	2T	06_7	15	9	1	900	340	-560	0.11	0.38	1	0	-1
0023	2T	06_7	16	8	4	800	1630	830	0.50	2.04	1	2	1
0023	2T	06_7	21	1	0	100	0	-100	0.00	0.00	0	0	0
0023	2T	06_7	23	1	0	100	0	-100	0.00	0.00	0	0	0
0023	2T	06_7	24	3	2	300	1260	960	0.67	4.20	0	2	2
0023	2T	06_8	12	89	16	8900	8120	-780	0.18	0.91	15	14	-1
0023	2T	06_8	13	87	19	8700	6290	-2410	0.22	0.72	15	11	-4
0023	2T	06_8	14	44	13	4400	6090	1690	0.30	1.38	7	10	3
0023	2T	06_8	15	13	4	1300	1590	290	0.31	1.22	2	2	0
0023	2T	06_8	16	7	1	700	640	-60	0.14	0.91	1	1	0
0023	2T	06_8	21	3	0	300	0	-300	0.00	0.00	0	0	0
0023	2T	06_8	23	1	0	100	0	-100	0.00	0.00	0	0	0
0023	2T	06_8	25	1	0	100	0	-100	0.00	0.00	0	0	0
0023	2T	06_8	26	1	0	100	0	-100	0.00	0.00	0	0	0
0023	2T	06_9	12	116	29	11600	9280	-2320	0.25	0.80	20	16	-4
0023	2T	06_9	13	66	10	6600	4040	-2560	0.15	0.61	11	7	-4
0023	2T	06_9	14	46	6	4600	2440	-2160	0.13	0.53	8	4	-4
0023	2T	06_9	15	2	0	200	0	-200	0.00	0.00	0	0	0
0023	2T	06_9	16	1	0	100	0	-100	0.00	0.00	0	0	0
0023	2T	06_9	21	2	0	200	0	-200	0.00	0.00	0	0	0
0023	2T	06_9	23	2	0	200	0	-200	0.00	0.00	0	0	0
0023	2T	07_1	12	82	17	8200	7040	-1160	0.21	0.86	14	12	-2
0023	2T	07_1	13	54	7	5400	2790	-2610	0.13	0.52	9	4	-5
0023	2T	07_1	14	14	1	1400	490	-910	0.07	0.35	2	0	-2
0023	2T	07_1	15	9	1	900	440	-460	0.11	0.49	1	0	-1
0023	2T	07_1	16	8	1	800	560	-240	0.13	0.70	1	0	-1
0023	2T	07_1	23	1	0	100	0	-100	0.00	0.00	0	0	0
0023	2T	07_1	24	1	0	100	0	-100	0.00	0.00	0	0	0
0023	2T	07_1	25	1	0	100	0	-100	0.00	0.00	0	0	0
0023	2T	07_1	26	1	0	100	0	-100	0.00	0.00	0	0	0
0023	2T	07_10	12	175	54	17500	17950	450	0.31	1.03	30	31	1
0023	2T	07_10	13	69	15	6900	4640	-2260	0.22	0.67	12	8	-4
0023	2T	07_10	14	23	7	2300	1980	-320	0.30	0.86	4	3	-1
0023	2T	07_10	15	4	1	400	460	60	0.25	1.15	0	0	0
0023	2T	07_10	16	2	1	200	460	260	0.50	2.30	0	0	0
0023	2T	07_10	23	1	0	100	0	-100	0.00	0.00	0	0	0
0023	2T	07_11	12	164	47	16400	14280	-2120	0.29	0.87	29	25	-4
0023	2T	07_11	13	95	19	9500	5890	-3610	0.20	0.62	16	10	-6
0023	2T	07_11	14	17	4	1700	1290	-410	0.24	0.76	3	2	-1
0023	2T	07_11	15	3	0	300	0	-300	0.00	0.00	0	0	0
0023	2T	07_11	16	1	0	100	0	-100	0.00	0.00	0	0	0
0023	2T	07_11	24	1	0	100	0	-100	0.00	0.00	0	0	0
0023	2T	07_12	12	181	49	18100	15360	-2740	0.27	0.85	32	27	-5
0023	2T	07_12	13	59	16	5900	5050	-850	0.27	0.86	10	8	-2
0023	2T	07_12	14	32	11	3200	3890	690	0.34	1.22	5	6	1
0023	2T	07_12	26	1	0	100	0	-100	0.00	0.00	0	0	0
0023	2T	07_2	12	85	17	8500	10440	1940	0.20	1.23	15	18	3
0023	2T	07_2	13	40	9	4000	4140	140	0.23	1.04	7	7	0
0023	2T	07_2	14	19	1	1900	420	-1480	0.05	0.22	3	0	-3
0023	2T	07_2	15	18	2	1800	890	-910	0.11	0.49	3	1	-2
0023	2T	07_2	16	4	0	400	0	-400	0.00	0.00	0	0	0
0023	2T	07_2	21	1	0	100	0	-100	0.00	0.00	0	0	0
0023	2T	07_2	23	4	1	400	1250	850	0.25	3.13	0	2	2
0023	2T	07_2	24	2	0	200	0	-200	0.00	0.00	0	0	0
0023	2T	07_2	25	3	0	300	0	-300	0.00	0.00	0	0	0
0023	2T	07_2	26	2	0	200	0	-200	0.00	0.00	0	0	0
0023	2T	07_3	12	83	18	8300	7910	-390	0.22	0.95	14	14	0
0023	2T	07_3	13	50	5	5000	1950	-3050	0.10	0.39	8	3	-5
0023	2T	07_3	14	21	5	2100	3190	1090	0.24	1.52	3	5	2
0023	2T	07_3	15	18	2	1800	1530	-270	0.11	0.85	3	2	-1
0023	2T	07_3	16	7	1	700	1080	380	0.14	1.54	1	1	0
0023	2T	07_3	21	2	0	200	0	-200	0.00	0.00	0	0	0
0023	2T	07_3	23	5	0	500	0	-500	0.00	0.00	0	0	0
0023	2T	07_3	24	2	0	200	0	-200	0.00	0.00	0	0	0
0023	2T	07_3	25	1	0	100	0	-100	0.00	0.00	0	0	0
0023	2T	07_3	26	2	0	200	0	-200	0.00	0.00	0	0	0
0023	2T	07_4	12	102	15	10200	5490	-4710	0.15	0.54	18	9	-9
0023	2T	07_4	13	57	11	5700	5170	-530	0.19	0.91	10	9	-1
0023	2T	07_4	14	19	1	1900	440	-1460	0.05	0.23	3	0	-3
0023	2T	07_4	15	14	0	1400	0	-1400	0.00	0.00	2	0	-2
0023	2T	07_4	16	7	2	700	2660	1960	0.29	3.80	1	4	3
0023	2T	07_4	23	3	0	300	0	-300	0.00	0.00	0	0	0
0023	2T	07_4	24	2	0	200	0	-200	0.00	0.00	0	0	0
0023	2T	07_4	25	3	0	300	0	-300	0.00	0.00	0	0	0
0023	2T	07_4	26	4	0	400	0	-400	0.00	0.00	0	0	0
0023	2T	07_5	12	91	16	9100	6720	-2380	0.18	0.74	16	11	-5
0023	2T	07_5	13	37	9	3700	3000	-700	0.24	0.81	6	5	-1
0023	2T	07_5	14	19	4	1900	1460	-440	0.21	0.77	3	2	-1
0023	2T	07_5	15	17	3	1700	1310	-390	0.18	0.77	3	2	-1
0023	2T	07_5	16	15	4	1500	1740	240	0.27	1.16	2	3	1
0023	2T	07_5	21	2	0	200	0	-200	0.00	0.00	0	0	0
0023	2T	07_5	23	9	1	900	460	-440	0.11	0.51	1	0	-1
0023	2T	07_5	25	6	0	600	0	-600	0.00	0.00	1	0	-1
0023	2T	07_5	26	4	2	400	1220	820	0.50	3.05	0	2	2
0023	2T	07_6	12	107	25	10700	9980	-720	0.23	0.93	18	17	-1
0023	2T	07_6	13	50	14	5000	6700	1700	0.28	1.34	8	11	3
0023	2T	07_6	14	19	5	1900	1550	-350	0.26	0.82	3	2	-1
0023	2T	07_6	15	15	6	1500	3460	1960	0.40	2.31	2	6	4
0023	2T	07_6	16	14	3	1400	1520	120	0.21	1.09	2	2	0
0023	2T	07_6	21	1	1	100	480	380	1.00	4.80	0	0	0
0023	2T	07_6	23	4	0	400	0	-400	0.00	0.00	0	0	0
0023	2T	07_6	24	3	0	300	0	-300	0.00	0.00	0	0	0
0023	2T	07_6	25	4	0	400	0	-400	0.00	0.00	0	0	0
0023	2T	07_6	26	7	0	700	0	-700	0.00	0.00	1	0	-1
0023	2T	07_7	12	49	11	4900	4260	-640	0.22	0.87	8	7	-1
0023	2T	07_7	13	107	34	10700	8820	-1880	0.32	0.82	18	15	-3
0023	2T	07_7	14	118	33	11800	9530	-2270	0.28	0.81	20	16	-4
0023	2T	07_7	15	6	1	600	650	50	0.17	1.08	1	1	0
0023	2T	07_8	12	118	23	11800	8910	-2890	0.19	0.76	20	15	-5
0023	2T	07_8	13	61	18	6100	5840	-260	0.30	0.96	10	10	0
0023	2T	07_8	14	33	4	3300	1610	-1690	0.12	0.49	5	2	-3
0023	2T	07_8	15	8	0	800	0	-800	0.00	0.00	1	0	-1
0023	2T	07_8	16	4	3	400	1820	1420	0.75	4.55	0	3	3
0023	2T	07_8	21	8	2	800	550	-250	0.25	0.69	1	0	-1
0023	2T	07_8	24	2	0	200	0	-200	0.00	0.00	0	0	0
0023	2T	07_9	12	133	36	13300	12560	-740	0.27	0.94	23	22	-1
0023	2T	07_9	13	78	15	7800	4870	-2930	0.19	0.62	13	8	-5
0023	2T	07_9	14	28	5	2800	1440	-1360	0.18	0.51	4	2	-2
0023	2T	07_9	15	5	1	500	300	-200	0.20	0.60	0	0	0
0023	2T	07_9	16	2	1	200	340	140	0.50	1.70	0	0	0
0023	2T	07_9	21	2	0	200	0	-200	0.00	0.00	0	0	0
0023	2T	07_9	26	2	0	200	0	-200	0.00	0.00	0	0	0
0023	2T	08_1	12	83	19	8300	6730	-1570	0.23	0.81	14	11	-3
0023	2T	08_1	13	54	5	5400	1710	-3690	0.09	0.32	9	3	-6
0023	2T	08_1	14	26	7	2600	3680	1080	0.27	1.42	4	6	2
0023	2T	08_1	15	19	5	1900	4710	2810	0.26	2.48	3	8	5
0023	2T	08_1	16	4	0	400	0	-400	0.00	0.00	0	0	0
0023	2T	08_1	23	1	0	100	0	-100	0.00	0.00	0	0	0
0023	2T	08_1	24	2	0	200	0	-200	0.00	0.00	0	0	0
0023	2T	08_1	25	3	1	300	520	220	0.33	1.73	0	0	0
0023	2T	08_1	26	1	0	100	0	-100	0.00	0.00	0	0	0
0023	2T	08_10	12	189	52	18900	14860	-4040	0.28	0.79	33	26	-7
0023	2T	08_10	13	58	12	5800	3710	-2090	0.21	0.64	10	6	-4
0023	2T	08_10	14	23	4	2300	1440	-860	0.17	0.63	4	2	-2
0023	2T	08_10	15	3	0	300	0	-300	0.00	0.00	0	0	0
0023	2T	08_10	21	1	0	100	0	-100	0.00	0.00	0	0	0
0023	2T	08_10	23	1	1	100	300	200	1.00	3.00	0	0	0
0023	2T	08_10	25	1	0	100	0	-100	0.00	0.00	0	0	0
0023	2T	08_11	12	190	57	19000	16290	-2710	0.30	0.86	33	28	-5
0023	2T	08_11	13	49	13	4900	3860	-1040	0.27	0.79	8	6	-2
0023	2T	08_11	14	33	9	3300	2630	-670	0.27	0.80	5	4	-1
0023	2T	08_11	15	1	0	100	0	-100	0.00	0.00	0	0	0
0023	2T	08_11	21	1	0	100	0	-100	0.00	0.00	0	0	0
0023	2T	08_12	12	238	77	23800	21440	-2360	0.32	0.90	42	37	-5
0023	2T	08_12	13	26	2	2600	520	-2080	0.08	0.20	4	0	-4
0023	2T	08_12	14	12	3	1200	780	-420	0.25	0.65	2	1	-1
0023	2T	08_2	12	93	19	9300	7060	-2240	0.20	0.76	16	12	-4
0023	2T	08_2	13	60	6	6000	2330	-3670	0.10	0.39	10	4	-6
0023	2T	08_2	14	28	2	2800	1590	-1210	0.07	0.57	4	2	-2
0023	2T	08_2	15	10	3	1000	1990	990	0.30	1.99	1	3	2
0023	2T	08_2	16	5	1	500	450	-50	0.20	0.90	0	0	0
0023	2T	08_2	21	1	0	100	0	-100	0.00	0.00	0	0	0
0023	2T	08_2	23	2	1	200	300	100	0.50	1.50	0	0	0
0023	2T	08_2	24	1	0	100	0	-100	0.00	0.00	0	0	0
0023	2T	08_2	25	1	0	100	0	-100	0.00	0.00	0	0	0
0023	2T	08_2	26	1	0	100	0	-100	0.00	0.00	0	0	0
0023	2T	08_3	12	95	23	9500	9340	-160	0.24	0.98	16	16	0
0023	2T	08_3	13	53	12	5300	6140	840	0.23	1.16	9	10	1
0023	2T	08_3	14	29	5	2900	3580	680	0.17	1.23	5	6	1
0023	2T	08_3	15	12	1	1200	640	-560	0.08	0.53	2	1	-1
0023	2T	08_3	16	13	1	1300	350	-950	0.08	0.27	2	0	-2
0023	2T	08_3	23	3	0	300	0	-300	0.00	0.00	0	0	0
0023	2T	08_3	24	3	1	300	1210	910	0.33	4.03	0	2	2
0023	2T	08_3	25	2	0	200	0	-200	0.00	0.00	0	0	0
0023	2T	08_3	26	2	0	200	0	-200	0.00	0.00	0	0	0
0023	2T	08_4	12	113	25	11300	8240	-3060	0.22	0.73	20	14	-6
0023	2T	08_4	13	69	14	6900	4080	-2820	0.20	0.59	12	7	-5
0023	2T	08_4	14	33	3	3300	1010	-2290	0.09	0.31	5	1	-4
0023	2T	08_4	15	13	2	1300	900	-400	0.15	0.69	2	1	-1
0023	2T	08_4	16	11	3	1100	690	-410	0.27	0.63	1	1	0
0023	2T	08_4	24	2	0	200	0	-200	0.00	0.00	0	0	0
0023	2T	08_4	26	3	0	300	0	-300	0.00	0.00	0	0	0
0023	2T	08_5	12	112	28	11200	10570	-630	0.25	0.94	19	18	-1
0023	2T	08_5	13	74	16	7400	4740	-2660	0.22	0.64	13	8	-5
0023	2T	08_5	14	36	9	3600	2780	-820	0.25	0.77	6	4	-2
0023	2T	08_5	15	6	0	600	0	-600	0.00	0.00	1	0	-1
0023	2T	08_5	16	12	3	1200	1480	280	0.25	1.23	2	2	0
0023	2T	08_5	24	2	0	200	0	-200	0.00	0.00	0	0	0
0023	2T	08_5	26	2	1	200	720	520	0.50	3.60	0	1	1
0023	2T	08_6	12	81	15	8100	6410	-1690	0.19	0.79	14	11	-3
0023	2T	08_6	13	53	13	5300	4760	-540	0.25	0.90	9	8	-1
0023	2T	08_6	14	30	5	3000	1530	-1470	0.17	0.51	5	2	-3
0023	2T	08_6	15	15	2	1500	690	-810	0.13	0.46	2	1	-1
0023	2T	08_6	16	34	9	3400	4040	640	0.26	1.19	6	7	1
0023	2T	08_6	21	2	1	200	860	660	0.50	4.30	0	1	1
0023	2T	08_6	23	2	0	200	0	-200	0.00	0.00	0	0	0
0023	2T	08_6	24	3	1	300	480	180	0.33	1.60	0	0	0
0023	2T	08_6	26	3	0	300	0	-300	0.00	0.00	0	0	0
0023	2T	08_7	12	88	15	8800	6490	-2310	0.17	0.74	15	11	-4
0023	2T	08_7	13	63	11	6300	5430	-870	0.17	0.86	11	9	-2
0023	2T	08_7	14	29	7	2900	2630	-270	0.24	0.91	5	4	-1
0023	2T	08_7	15	12	0	1200	0	-1200	0.00	0.00	2	0	-2
0023	2T	08_7	16	25	3	2500	1720	-780	0.12	0.69	4	3	-1
0023	2T	08_7	21	3	0	300	0	-300	0.00	0.00	0	0	0
0023	2T	08_7	23	2	1	200	810	610	0.50	4.05	0	1	1
0023	2T	08_7	25	1	0	100	0	-100	0.00	0.00	0	0	0
0023	2T	08_7	26	1	0	100	0	-100	0.00	0.00	0	0	0
0023	2T	08_8	12	51	13	5100	4180	-920	0.25	0.82	9	7	-2
0023	2T	08_8	13	49	18	4900	6420	1520	0.37	1.31	8	11	3
0023	2T	08_8	14	35	11	3500	3730	230	0.31	1.07	6	6	0
0023	2T	08_8	15	8	2	800	600	-200	0.25	0.75	1	1	0
0023	2T	08_8	16	6	1	600	990	390	0.17	1.65	1	1	0
0023	2T	08_8	23	2	0	200	0	-200	0.00	0.00	0	0	0
0023	2T	08_9	12	144	43	14400	14270	-130	0.30	0.99	25	25	0
0023	2T	08_9	13	63	16	6300	5280	-1020	0.25	0.84	11	9	-2
0023	2T	08_9	14	41	9	4100	2990	-1110	0.22	0.73	7	5	-2
0023	2T	08_9	15	11	0	1100	0	-1100	0.00	0.00	1	0	-1
0023	2T	08_9	16	4	1	400	440	40	0.25	1.10	0	0	0
0023	2T	08_9	23	1	0	100	0	-100	0.00	0.00	0	0	0
0023	2T	09_1	12	221	73	22100	17670	-4430	0.33	0.80	39	31	-8
0023	2T	09_1	13	42	11	4200	3040	-1160	0.26	0.72	7	5	-2
0023	2T	09_1	14	15	4	1500	960	-540	0.27	0.64	2	1	-1
0023	2T	09_1	15	3	1	300	290	-10	0.33	0.97	0	0	0
0023	2T	09_1	16	2	0	200	0	-200	0.00	0.00	0	0	0
0023	2T	09_10	12	162	47	16200	14220	-1980	0.29	0.88	28	25	-3
0023	2T	09_10	13	64	15	6400	4920	-1480	0.23	0.77	11	8	-3
0023	2T	09_10	14	33	4	3300	1560	-1740	0.12	0.47	5	2	-3
0023	2T	09_10	15	4	0	400	0	-400	0.00	0.00	0	0	0
0023	2T	09_10	16	1	0	100	0	-100	0.00	0.00	0	0	0
0023	2T	09_10	23	2	0	200	0	-200	0.00	0.00	0	0	0
0023	2T	09_11	12	193	49	19300	12760	-6540	0.25	0.66	34	22	-12
0023	2T	09_11	13	56	11	5600	3510	-2090	0.20	0.63	9	6	-3
0023	2T	09_11	14	15	6	1500	1900	400	0.40	1.27	2	3	1
0023	2T	09_11	21	2	0	200	0	-200	0.00	0.00	0	0	0
0023	2T	09_11	24	2	0	200	0	-200	0.00	0.00	0	0	0
0023	2T	09_12	12	238	69	23800	16990	-6810	0.29	0.71	42	30	-12
0023	2T	09_12	13	28	7	2800	2150	-650	0.25	0.77	4	3	-1
0023	2T	09_12	14	11	1	1100	480	-620	0.09	0.44	1	0	-1
0023	2T	09_12	15	1	0	100	0	-100	0.00	0.00	0	0	0
0023	2T	09_2	12	113	29	11300	10680	-620	0.26	0.95	20	18	-2
0023	2T	09_2	13	52	14	5200	6200	1000	0.27	1.19	9	10	1
0023	2T	09_2	14	20	3	2000	2480	480	0.15	1.24	3	4	1
0023	2T	09_2	15	7	1	700	410	-290	0.14	0.59	1	0	-1
0023	2T	09_2	16	10	0	1000	0	-1000	0.00	0.00	1	0	-1
0023	2T	09_2	23	3	0	300	0	-300	0.00	0.00	0	0	0
0023	2T	09_2	24	1	1	100	580	480	1.00	5.80	0	1	1
0023	2T	09_2	26	3	0	300	0	-300	0.00	0.00	0	0	0
0023	2T	09_3	12	99	16	9900	7620	-2280	0.16	0.77	17	13	-4
0023	2T	09_3	13	42	5	4200	2610	-1590	0.12	0.62	7	4	-3
0023	2T	09_3	14	32	2	3200	1480	-1720	0.06	0.46	5	2	-3
0023	2T	09_3	15	14	2	1400	2180	780	0.14	1.56	2	3	1
0023	2T	09_3	16	9	2	900	1440	540	0.22	1.60	1	2	1
0023	2T	09_3	21	2	0	200	0	-200	0.00	0.00	0	0	0
0023	2T	09_3	23	5	0	500	0	-500	0.00	0.00	0	0	0
0023	2T	09_3	24	3	2	300	960	660	0.67	3.20	0	1	1
0023	2T	09_3	25	2	0	200	0	-200	0.00	0.00	0	0	0
0023	2T	09_3	26	8	0	800	0	-800	0.00	0.00	1	0	-1
0023	2T	09_4	12	83	15	8300	7900	-400	0.18	0.95	14	13	-1
0023	2T	09_4	13	47	10	4700	5030	330	0.21	1.07	8	8	0
0023	2T	09_4	14	24	2	2400	950	-1450	0.08	0.40	4	1	-3
0023	2T	09_4	15	13	2	1300	1060	-240	0.15	0.82	2	1	-1
0023	2T	09_4	16	16	2	1600	2040	440	0.13	1.28	2	3	1
0023	2T	09_4	21	1	1	100	1460	1360	1.00	14.60	0	2	2
0023	2T	09_4	23	4	0	400	0	-400	0.00	0.00	0	0	0
0023	2T	09_4	24	2	0	200	0	-200	0.00	0.00	0	0	0
0023	2T	09_4	25	2	0	200	0	-200	0.00	0.00	0	0	0
0023	2T	09_4	26	15	0	1500	0	-1500	0.00	0.00	2	0	-2
0023	2T	09_5	12	193	60	19300	13560	-5740	0.31	0.70	34	24	-10
0023	2T	09_5	13	67	17	6700	4720	-1980	0.25	0.70	11	8	-3
0023	2T	09_5	14	19	2	1900	470	-1430	0.11	0.25	3	0	-3
0023	2T	09_5	15	3	0	300	0	-300	0.00	0.00	0	0	0
0023	2T	09_5	23	1	0	100	0	-100	0.00	0.00	0	0	0
0023	2T	09_5	26	1	0	100	0	-100	0.00	0.00	0	0	0
0023	2T	09_6	12	70	16	7000	5990	-1010	0.23	0.86	12	10	-2
0023	2T	09_6	13	48	13	4800	5630	830	0.27	1.17	8	9	1
0023	2T	09_6	14	34	5	3400	1680	-1720	0.15	0.49	6	2	-4
0023	2T	09_6	15	18	1	1800	450	-1350	0.06	0.25	3	0	-3
0023	2T	09_6	16	16	2	1600	1220	-380	0.13	0.76	2	2	0
0023	2T	09_6	21	3	0	300	0	-300	0.00	0.00	0	0	0
0023	2T	09_6	23	2	1	200	550	350	0.50	2.75	0	0	0
0023	2T	09_6	25	2	0	200	0	-200	0.00	0.00	0	0	0
0023	2T	09_6	26	6	1	600	660	60	0.17	1.10	1	1	0
0023	2T	09_7	12	92	23	9200	7390	-1810	0.25	0.80	16	13	-3
0023	2T	09_7	13	63	10	6300	3320	-2980	0.16	0.53	11	5	-6
0023	2T	09_7	14	31	6	3100	1820	-1280	0.19	0.59	5	3	-2
0023	2T	09_7	15	11	1	1100	510	-590	0.09	0.46	1	0	-1
0023	2T	09_7	16	7	0	700	0	-700	0.00	0.00	1	0	-1
0023	2T	09_7	21	2	0	200	0	-200	0.00	0.00	0	0	0
0023	2T	09_7	23	6	0	600	0	-600	0.00	0.00	1	0	-1
0023	2T	09_7	24	2	0	200	0	-200	0.00	0.00	0	0	0
0023	2T	09_7	25	1	0	100	0	-100	0.00	0.00	0	0	0
0023	2T	09_7	26	2	0	200	0	-200	0.00	0.00	0	0	0
0023	2T	09_8	12	99	18	9900	4880	-5020	0.18	0.49	17	8	-9
0023	2T	09_8	13	63	13	6300	4550	-1750	0.21	0.72	11	8	-3
0023	2T	09_8	14	13	3	1300	1040	-260	0.23	0.80	2	1	-1
0023	2T	09_8	15	5	1	500	270	-230	0.20	0.54	0	0	0
0023	2T	09_8	16	4	0	400	0	-400	0.00	0.00	0	0	0
0023	2T	09_8	21	4	1	400	580	180	0.25	1.45	0	1	1
0023	2T	09_8	23	3	1	300	420	120	0.33	1.40	0	0	0
0023	2T	09_8	26	1	0	100	0	-100	0.00	0.00	0	0	0
0023	2T	09_9	12	130	38	13000	12360	-640	0.29	0.95	23	21	-2
0023	2T	09_9	13	71	19	7100	5590	-1510	0.27	0.79	12	9	-3
0023	2T	09_9	14	29	5	2900	1380	-1520	0.17	0.48	5	2	-3
0023	2T	09_9	15	8	1	800	220	-580	0.13	0.28	1	0	-1
0023	2T	09_9	16	11	1	1100	320	-780	0.09	0.29	1	0	-1
0023	2T	10_1	12	199	65	19900	14980	-4920	0.33	0.75	35	26	-9
0023	2T	10_1	13	56	11	5600	2780	-2820	0.20	0.50	9	4	-5
0023	2T	10_1	14	8	1	800	380	-420	0.13	0.48	1	0	-1
0023	2T	10_1	16	1	0	100	0	-100	0.00	0.00	0	0	0
0023	2T	10_1	24	1	0	100	0	-100	0.00	0.00	0	0	0
0023	2T	10_10	12	133	25	13300	7820	-5480	0.19	0.59	23	13	-10
0023	2T	10_10	13	44	13	4400	4490	90	0.30	1.02	7	7	0
0023	2T	10_10	14	36	9	3600	3930	330	0.25	1.09	6	6	0
0023	2T	10_10	15	10	2	1000	720	-280	0.20	0.72	1	1	0
0023	2T	10_10	16	5	0	500	0	-500	0.00	0.00	0	0	0
0023	2T	10_10	21	2	0	200	0	-200	0.00	0.00	0	0	0
0023	2T	10_10	24	1	1	100	220	120	1.00	2.20	0	0	0
0023	2T	10_11	12	151	48	15100	13530	-1570	0.32	0.90	26	23	-3
0023	2T	10_11	13	68	9	6800	2970	-3830	0.13	0.44	12	5	-7
0023	2T	10_11	14	34	7	3400	1890	-1510	0.21	0.56	6	3	-3
0023	2T	10_11	15	2	0	200	0	-200	0.00	0.00	0	0	0
0023	2T	10_12	12	178	58	17800	15660	-2140	0.33	0.88	31	27	-4
0023	2T	10_12	13	53	14	5300	3870	-1430	0.26	0.73	9	6	-3
0023	2T	10_12	14	22	4	2200	1410	-790	0.18	0.64	3	2	-1
0023	2T	10_12	21	1	0	100	0	-100	0.00	0.00	0	0	0
0023	2T	10_2	12	194	68	19400	15340	-4060	0.35	0.79	34	27	-7
0023	2T	10_2	13	36	6	3600	3120	-480	0.17	0.87	6	5	-1
0023	2T	10_2	14	8	2	800	810	10	0.25	1.01	1	1	0
0023	2T	10_3	12	30	8	3000	2670	-330	0.27	0.89	5	4	-1
0023	2T	10_3	13	187	44	18700	10820	-7880	0.24	0.58	33	19	-14
0023	2T	10_3	14	3	0	300	0	-300	0.00	0.00	0	0	0
0023	2T	10_3	15	1	0	100	0	-100	0.00	0.00	0	0	0
0023	2T	10_3	16	3	0	300	0	-300	0.00	0.00	0	0	0
0023	2T	10_3	21	1	0	100	0	-100	0.00	0.00	0	0	0
0023	2T	10_3	23	4	0	400	0	-400	0.00	0.00	0	0	0
0023	2T	10_3	24	5	0	500	0	-500	0.00	0.00	0	0	0
0023	2T	10_3	26	1	0	100	0	-100	0.00	0.00	0	0	0
0023	2T	10_4	12	160	44	16000	11730	-4270	0.28	0.73	28	20	-8
0023	2T	10_4	13	57	12	5700	3780	-1920	0.21	0.66	10	6	-4
0023	2T	10_4	14	6	0	600	0	-600	0.00	0.00	1	0	-1
0023	2T	10_4	16	3	0	300	0	-300	0.00	0.00	0	0	0
0023	2T	10_4	21	1	0	100	0	-100	0.00	0.00	0	0	0
0023	2T	10_4	23	8	1	800	600	-200	0.13	0.75	1	1	0
0023	2T	10_4	24	4	0	400	0	-400	0.00	0.00	0	0	0
0023	2T	10_4	26	3	0	300	0	-300	0.00	0.00	0	0	0
0023	2T	10_5	12	30	2	3000	620	-2380	0.07	0.21	5	1	-4
0023	2T	10_5	13	60	22	6000	5770	-230	0.37	0.96	10	10	0
0023	2T	10_5	14	11	3	1100	940	-160	0.27	0.85	1	1	0
0023	2T	10_5	15	8	1	800	2350	1550	0.13	2.94	1	4	3
0023	2T	10_5	16	5	0	500	0	-500	0.00	0.00	0	0	0
0023	2T	10_5	21	3	1	300	720	420	0.33	2.40	0	1	1
0023	2T	10_5	23	12	2	1200	1190	-10	0.17	0.99	2	2	0
0023	2T	10_5	24	33	7	3300	6400	3100	0.21	1.94	5	11	6
0023	2T	10_5	26	18	1	1800	1630	-170	0.06	0.91	3	2	-1
0023	2T	10_6	12	25	2	2500	440	-2060	0.08	0.18	4	0	-4
0023	2T	10_6	13	10	2	1000	800	-200	0.20	0.80	1	1	0
0023	2T	10_6	14	22	5	2200	1850	-350	0.23	0.84	3	3	0
0023	2T	10_6	16	9	1	900	1070	170	0.11	1.19	1	1	0
0023	2T	10_6	21	4	0	400	0	-400	0.00	0.00	0	0	0
0023	2T	10_6	23	25	3	2500	3370	870	0.12	1.35	4	5	1
0023	2T	10_6	24	21	3	2100	4560	2460	0.14	2.17	3	8	5
0023	2T	10_6	25	3	0	300	0	-300	0.00	0.00	0	0	0
0023	2T	10_6	26	30	0	3000	0	-3000	0.00	0.00	5	0	-5
0023	2T	10_7	12	42	12	4200	5190	990	0.29	1.24	7	9	2
0023	2T	10_7	14	5	1	500	380	-120	0.20	0.76	0	0	0
0023	2T	10_7	21	28	1	2800	580	-2220	0.04	0.21	4	1	-3
0023	2T	10_7	24	12	1	1200	390	-810	0.08	0.33	2	0	-2
0023	2T	10_8	12	39	10	3900	5680	1780	0.26	1.46	6	10	4
0023	2T	10_8	13	42	7	4200	2100	-2100	0.17	0.50	7	3	-4
0023	2T	10_8	14	25	3	2500	1110	-1390	0.12	0.44	4	1	-3
0023	2T	10_8	15	5	2	500	1540	1040	0.40	3.08	0	2	2
0023	2T	10_8	16	1	0	100	0	-100	0.00	0.00	0	0	0
0023	2T	10_8	21	19	3	1900	3650	1750	0.16	1.92	3	6	3
0023	2T	10_8	23	8	0	800	0	-800	0.00	0.00	1	0	-1
0023	2T	10_8	24	13	0	1300	0	-1300	0.00	0.00	2	0	-2
0023	2T	10_8	25	1	0	100	0	-100	0.00	0.00	0	0	0
0023	2T	10_8	26	7	1	700	530	-170	0.14	0.76	1	0	-1
0023	2T	10_9	12	57	17	5700	5030	-670	0.30	0.88	10	8	-2
0023	2T	10_9	13	39	5	3900	2260	-1640	0.13	0.58	6	4	-2
0023	2T	10_9	14	34	6	3400	5770	2370	0.18	1.70	6	10	4
0023	2T	10_9	15	6	1	600	530	-70	0.17	0.88	1	0	-1
0023	2T	10_9	16	2	0	200	0	-200	0.00	0.00	0	0	0
0023	2T	10_9	21	14	1	1400	250	-1150	0.07	0.18	2	0	-2
0023	2T	10_9	23	7	0	700	0	-700	0.00	0.00	1	0	-1
0023	2T	10_9	24	7	3	700	2170	1470	0.43	3.10	1	3	2
0023	2T	10_9	25	3	0	300	0	-300	0.00	0.00	0	0	0
0023	2T	10_9	26	6	2	600	1490	890	0.33	2.48	1	2	1
0023	2T	11_1	12	153	45	15300	13090	-2210	0.29	0.86	27	23	-4
0023	2T	11_1	13	52	11	5200	3170	-2030	0.21	0.61	9	5	-4
0023	2T	11_1	14	24	6	2400	1850	-550	0.25	0.77	4	3	-1
0023	2T	11_1	15	8	1	800	400	-400	0.13	0.50	1	0	-1
0023	2T	11_1	16	3	0	300	0	-300	0.00	0.00	0	0	0
0023	2T	11_1	25	1	0	100	0	-100	0.00	0.00	0	0	0
0023	2T	11_10	12	102	18	10200	5720	-4480	0.18	0.56	18	10	-8
0023	2T	11_10	13	76	14	7600	4360	-3240	0.18	0.57	13	7	-6
0023	2T	11_10	14	26	6	2600	2420	-180	0.23	0.93	4	4	0
0023	2T	11_10	15	3	0	300	0	-300	0.00	0.00	0	0	0
0023	2T	11_10	16	3	1	300	1280	980	0.33	4.27	0	2	2
0023	2T	11_10	21	2	0	200	0	-200	0.00	0.00	0	0	0
0023	2T	11_10	23	2	0	200	0	-200	0.00	0.00	0	0	0
0023	2T	11_10	24	2	0	200	0	-200	0.00	0.00	0	0	0
0023	2T	11_11	12	155	49	15500	15720	220	0.32	1.01	27	27	0
0023	2T	11_11	13	64	11	6400	3690	-2710	0.17	0.58	11	6	-5
0023	2T	11_11	14	16	1	1600	450	-1150	0.06	0.28	2	0	-2
0023	2T	11_11	15	2	0	200	0	-200	0.00	0.00	0	0	0
0023	2T	11_12	12	169	40	16900	12420	-4480	0.24	0.73	29	21	-8
0023	2T	11_12	13	56	9	5600	3190	-2410	0.16	0.57	9	5	-4
0023	2T	11_12	14	12	2	1200	880	-320	0.17	0.73	2	1	-1
0023	2T	11_12	15	1	0	100	0	-100	0.00	0.00	0	0	0
0023	2T	11_2	12	68	11	6800	5220	-1580	0.16	0.77	12	9	-3
0023	2T	11_2	13	44	10	4400	5590	1190	0.23	1.27	7	9	2
0023	2T	11_2	14	27	2	2700	1640	-1060	0.07	0.61	4	2	-2
0023	2T	11_2	15	15	2	1500	990	-510	0.13	0.66	2	1	-1
0023	2T	11_2	16	8	0	800	0	-800	0.00	0.00	1	0	-1
0023	2T	11_2	23	5	1	500	460	-40	0.20	0.92	0	0	0
0023	2T	11_2	24	1	0	100	0	-100	0.00	0.00	0	0	0
0023	2T	11_2	25	4	1	400	320	-80	0.25	0.80	0	0	0
0023	2T	11_2	26	1	0	100	0	-100	0.00	0.00	0	0	0
0023	2T	11_3	12	71	12	7100	7660	560	0.17	1.08	12	13	1
0023	2T	11_3	13	43	6	4300	2400	-1900	0.14	0.56	7	4	-3
0023	2T	11_3	14	25	4	2500	1950	-550	0.16	0.78	4	3	-1
0023	2T	11_3	15	10	1	1000	540	-460	0.10	0.54	1	0	-1
0023	2T	11_3	16	12	1	1200	1360	160	0.08	1.13	2	2	0
0023	2T	11_3	23	3	0	300	0	-300	0.00	0.00	0	0	0
0023	2T	11_3	24	2	0	200	0	-200	0.00	0.00	0	0	0
0023	2T	11_3	25	3	0	300	0	-300	0.00	0.00	0	0	0
0023	2T	11_3	26	6	0	600	0	-600	0.00	0.00	1	0	-1
0023	2T	11_4	12	64	11	6400	6240	-160	0.17	0.98	11	11	0
0023	2T	11_4	13	52	11	5200	6750	1550	0.21	1.30	9	11	2
0023	2T	11_4	14	16	1	1600	510	-1090	0.06	0.32	2	0	-2
0023	2T	11_4	15	15	1	1500	1160	-340	0.07	0.77	2	2	0
0023	2T	11_4	16	14	1	1400	1040	-360	0.07	0.74	2	1	-1
0023	2T	11_4	23	3	2	300	520	220	0.67	1.73	0	0	0
0023	2T	11_4	24	1	0	100	0	-100	0.00	0.00	0	0	0
0023	2T	11_4	25	4	0	400	0	-400	0.00	0.00	0	0	0
0023	2T	11_4	26	3	0	300	0	-300	0.00	0.00	0	0	0
0023	2T	11_5	12	241	93	24100	17150	-6950	0.39	0.71	42	30	-12
0023	2T	11_5	13	6	2	600	650	50	0.33	1.08	1	1	0
0023	2T	11_5	14	3	0	300	0	-300	0.00	0.00	0	0	0
0023	2T	11_5	15	2	0	200	0	-200	0.00	0.00	0	0	0
0023	2T	11_5	26	1	0	100	0	-100	0.00	0.00	0	0	0
0023	2T	11_6	12	33	9	3300	3860	560	0.27	1.17	5	6	1
0023	2T	11_6	13	144	35	14400	9630	-4770	0.24	0.67	25	17	-8
0023	2T	11_6	14	55	11	5500	4730	-770	0.20	0.86	9	8	-1
0023	2T	11_6	16	6	0	600	0	-600	0.00	0.00	1	0	-1
0023	2T	11_6	23	1	0	100	0	-100	0.00	0.00	0	0	0
0023	2T	11_6	26	2	0	200	0	-200	0.00	0.00	0	0	0
0023	2T	11_7	12	87	22	8700	9670	970	0.25	1.11	15	17	2
0023	2T	11_7	13	43	9	4300	3590	-710	0.21	0.83	7	6	-1
0023	2T	11_7	14	24	8	2400	2980	580	0.33	1.24	4	5	1
0023	2T	11_7	15	7	1	700	320	-380	0.14	0.46	1	0	-1
0023	2T	11_7	16	12	1	1200	450	-750	0.08	0.38	2	0	-2
0023	2T	11_7	21	2	0	200	0	-200	0.00	0.00	0	0	0
0023	2T	11_7	23	2	0	200	0	-200	0.00	0.00	0	0	0
0023	2T	11_7	24	1	0	100	0	-100	0.00	0.00	0	0	0
0023	2T	11_7	25	2	0	200	0	-200	0.00	0.00	0	0	0
0023	2T	11_7	26	1	0	100	0	-100	0.00	0.00	0	0	0
0023	2T	11_8	12	68	13	6800	6590	-210	0.19	0.97	12	11	-1
0023	2T	11_8	13	50	8	5000	3010	-1990	0.16	0.60	8	5	-3
0023	2T	11_8	14	28	3	2800	960	-1840	0.11	0.34	4	1	-3
0023	2T	11_8	15	12	1	1200	440	-760	0.08	0.37	2	0	-2
0023	2T	11_8	16	4	1	400	680	280	0.25	1.70	0	1	1
0023	2T	11_8	23	4	3	400	1470	1070	0.75	3.68	0	2	2
0023	2T	11_8	24	3	0	300	0	-300	0.00	0.00	0	0	0
0023	2T	11_8	25	2	0	200	0	-200	0.00	0.00	0	0	0
0023	2T	11_8	26	3	1	300	980	680	0.33	3.27	0	1	1
0023	2T	11_9	12	92	20	9200	9490	290	0.22	1.03	16	16	0
0023	2T	11_9	13	57	14	5700	5410	-290	0.25	0.95	10	9	-1
0023	2T	11_9	14	28	4	2800	1970	-830	0.14	0.70	4	3	-1
0023	2T	11_9	15	2	0	200	0	-200	0.00	0.00	0	0	0
0023	2T	11_9	16	7	0	700	0	-700	0.00	0.00	1	0	-1
0023	2T	11_9	21	2	0	200	0	-200	0.00	0.00	0	0	0
0023	2T	11_9	23	3	0	300	0	-300	0.00	0.00	0	0	0
0023	2T	11_9	24	2	0	200	0	-200	0.00	0.00	0	0	0
0023	2T	11_9	25	2	0	200	0	-200	0.00	0.00	0	0	0
0023	2T	11_9	26	3	1	300	410	110	0.33	1.37	0	0	0
0023	2T	12_1	12	94	22	9400	8020	-1380	0.23	0.85	16	14	-2
0023	2T	12_1	13	45	6	4500	2390	-2110	0.13	0.53	7	4	-3
0023	2T	12_1	14	29	4	2900	1520	-1380	0.14	0.52	5	2	-3
0023	2T	12_1	15	8	1	800	370	-430	0.13	0.46	1	0	-1
0023	2T	12_1	16	4	0	400	0	-400	0.00	0.00	0	0	0
0023	2T	12_1	23	4	1	400	370	-30	0.25	0.93	0	0	0
0023	2T	12_1	24	3	0	300	0	-300	0.00	0.00	0	0	0
0023	2T	12_1	25	1	0	100	0	-100	0.00	0.00	0	0	0
0023	2T	12_1	26	1	0	100	0	-100	0.00	0.00	0	0	0
0023	2T	12_10	12	144	38	14400	11250	-3150	0.26	0.78	25	19	-6
0023	2T	12_10	13	72	20	7200	7270	70	0.28	1.01	12	12	0
0023	2T	12_10	14	17	1	1700	260	-1440	0.06	0.15	3	0	-3
0023	2T	12_10	15	1	0	100	0	-100	0.00	0.00	0	0	0
0023	2T	12_10	21	2	0	200	0	-200	0.00	0.00	0	0	0
0023	2T	12_10	24	1	0	100	0	-100	0.00	0.00	0	0	0
0023	2T	12_10	25	1	0	100	0	-100	0.00	0.00	0	0	0
0023	2T	12_11	12	133	38	13300	10780	-2520	0.29	0.81	23	19	-4
0023	2T	12_11	13	99	23	9900	6650	-3250	0.23	0.67	17	11	-6
0023	2T	12_11	14	10	3	1000	910	-90	0.30	0.91	1	1	0
0023	2T	12_11	15	1	0	100	0	-100	0.00	0.00	0	0	0
0023	2T	12_11	21	1	0	100	0	-100	0.00	0.00	0	0	0
0023	2T	12_12	12	133	40	13300	11530	-1770	0.30	0.87	23	20	-3
0023	2T	12_12	13	94	21	9400	7320	-2080	0.22	0.78	16	12	-4
0023	2T	12_12	14	13	2	1300	510	-790	0.15	0.39	2	0	-2
0023	2T	12_12	15	3	0	300	0	-300	0.00	0.00	0	0	0
0023	2T	12_12	16	1	1	100	780	680	1.00	7.80	0	1	1
0023	2T	12_12	24	1	1	100	870	770	1.00	8.70	0	1	1
0023	2T	12_2	12	81	10	8100	4500	-3600	0.12	0.56	14	7	-7
0023	2T	12_2	13	56	12	5600	3540	-2060	0.21	0.63	9	6	-3
0023	2T	12_2	14	26	2	2600	1170	-1430	0.08	0.45	4	2	-2
0023	2T	12_2	15	13	0	1300	0	-1300	0.00	0.00	2	0	-2
0023	2T	12_2	16	7	0	700	0	-700	0.00	0.00	1	0	-1
0023	2T	12_2	23	5	2	500	1130	630	0.40	2.26	0	2	2
0023	2T	12_2	25	1	0	100	0	-100	0.00	0.00	0	0	0
0023	2T	12_2	26	2	0	200	0	-200	0.00	0.00	0	0	0
0023	2T	12_3	12	81	15	8100	5340	-2760	0.19	0.66	14	9	-5
0023	2T	12_3	13	49	3	4900	1520	-3380	0.06	0.31	8	2	-6
0023	2T	12_3	14	24	1	2400	670	-1730	0.04	0.28	4	1	-3
0023	2T	12_3	15	14	3	1400	1830	430	0.21	1.31	2	3	1
0023	2T	12_3	16	4	0	400	0	-400	0.00	0.00	0	0	0
0023	2T	12_3	21	3	0	300	0	-300	0.00	0.00	0	0	0
0023	2T	12_3	23	5	2	500	1060	560	0.40	2.12	0	1	1
0023	2T	12_3	24	2	1	200	220	20	0.50	1.10	0	0	0
0023	2T	12_3	26	3	1	300	740	440	0.33	2.47	0	1	1
0023	2T	12_4	12	80	21	8000	6990	-1010	0.26	0.87	14	12	-2
0023	2T	12_4	13	45	6	4500	2020	-2480	0.13	0.45	7	3	-4
0023	2T	12_4	14	28	5	2800	2680	-120	0.18	0.96	4	4	0
0023	2T	12_4	15	18	1	1800	1000	-800	0.06	0.56	3	1	-2
0023	2T	12_4	16	4	0	400	0	-400	0.00	0.00	0	0	0
0023	2T	12_4	21	3	0	300	0	-300	0.00	0.00	0	0	0
0023	2T	12_4	23	3	1	300	890	590	0.33	2.97	0	1	1
0023	2T	12_4	24	5	1	500	310	-190	0.20	0.62	0	0	0
0023	2T	12_4	25	7	0	700	0	-700	0.00	0.00	1	0	-1
0023	2T	12_4	26	5	0	500	0	-500	0.00	0.00	0	0	0
0023	2T	12_5	12	157	42	15700	15200	-500	0.27	0.97	27	26	-1
0023	2T	12_5	13	34	9	3400	2760	-640	0.26	0.81	6	4	-2
0023	2T	12_5	14	15	2	1500	690	-810	0.13	0.46	2	1	-1
0023	2T	12_5	15	1	0	100	0	-100	0.00	0.00	0	0	0
0023	2T	12_5	16	39	10	3900	2790	-1110	0.26	0.72	6	4	-2
0023	2T	12_5	23	1	0	100	0	-100	0.00	0.00	0	0	0
0023	2T	12_5	25	1	0	100	0	-100	0.00	0.00	0	0	0
0023	2T	12_6	12	90	18	9000	5450	-3550	0.20	0.61	15	9	-6
0023	2T	12_6	13	49	10	4900	4110	-790	0.20	0.84	8	7	-1
0023	2T	12_6	14	19	2	1900	580	-1320	0.11	0.31	3	1	-2
0023	2T	12_6	15	11	1	1100	430	-670	0.09	0.39	1	0	-1
0023	2T	12_6	16	4	1	400	470	70	0.25	1.18	0	0	0
0023	2T	12_6	21	2	0	200	0	-200	0.00	0.00	0	0	0
0023	2T	12_6	23	2	0	200	0	-200	0.00	0.00	0	0	0
0023	2T	12_6	24	3	2	300	1130	830	0.67	3.77	0	2	2
0023	2T	12_6	25	3	0	300	0	-300	0.00	0.00	0	0	0
0023	2T	12_6	26	2	0	200	0	-200	0.00	0.00	0	0	0
0023	2T	12_7	12	111	35	11100	11020	-80	0.32	0.99	19	19	0
0023	2T	12_7	13	50	13	5000	4020	-980	0.26	0.80	8	7	-1
0023	2T	12_7	14	30	6	3000	1870	-1130	0.20	0.62	5	3	-2
0023	2T	12_7	15	10	3	1000	1220	220	0.30	1.22	1	2	1
0023	2T	12_7	16	4	0	400	0	-400	0.00	0.00	0	0	0
0023	2T	12_7	21	2	0	200	0	-200	0.00	0.00	0	0	0
0023	2T	12_7	23	1	0	100	0	-100	0.00	0.00	0	0	0
0023	2T	12_7	24	2	0	200	0	-200	0.00	0.00	0	0	0
0023	2T	12_7	25	3	2	300	1260	960	0.67	4.20	0	2	2
0023	2T	12_7	26	2	0	200	0	-200	0.00	0.00	0	0	0
0023	2T	12_8	12	103	33	10300	10970	670	0.32	1.07	18	19	1
0023	2T	12_8	13	60	11	6000	2810	-3190	0.18	0.47	10	4	-6
0023	2T	12_8	14	55	9	5500	2940	-2560	0.16	0.53	9	5	-4
0023	2T	12_8	15	6	1	600	350	-250	0.17	0.58	1	0	-1
0023	2T	12_8	16	8	1	800	290	-510	0.13	0.36	1	0	-1
0023	2T	12_9	12	157	33	15700	9300	-6400	0.21	0.59	27	16	-11
0023	2T	12_9	13	56	12	5600	3980	-1620	0.21	0.71	9	7	-2
0023	2T	12_9	14	23	5	2300	2160	-140	0.22	0.94	4	3	-1
0023	2T	12_9	15	6	2	600	950	350	0.33	1.58	1	1	0
0023	2T	12_9	16	6	0	600	0	-600	0.00	0.00	1	0	-1
0023	2T	13_1	12	63	20	6300	6710	410	0.32	1.07	11	11	0
0023	2T	13_1	13	55	10	5500	3650	-1850	0.18	0.66	9	6	-3
0023	2T	13_1	14	35	10	3500	4350	850	0.29	1.24	6	7	1
0023	2T	13_1	15	14	1	1400	630	-770	0.07	0.45	2	1	-1
0023	2T	13_1	16	5	0	500	0	-500	0.00	0.00	0	0	0
0023	2T	13_1	23	1	1	100	1730	1630	1.00	17.30	0	3	3
0023	2T	13_1	25	4	0	400	0	-400	0.00	0.00	0	0	0
0023	2T	13_1	26	3	0	300	0	-300	0.00	0.00	0	0	0
0023	2T	13_10	12	160	45	16000	12540	-3460	0.28	0.78	28	22	-6
0023	2T	13_10	13	56	16	5600	4950	-650	0.29	0.88	9	8	-1
0023	2T	13_10	14	23	4	2300	950	-1350	0.17	0.41	4	1	-3
0023	2T	13_10	15	6	2	600	820	220	0.33	1.37	1	1	0
0023	2T	13_10	16	1	0	100	0	-100	0.00	0.00	0	0	0
0023	2T	13_10	21	1	0	100	0	-100	0.00	0.00	0	0	0
0023	2T	13_10	23	1	0	100	0	-100	0.00	0.00	0	0	0
0023	2T	13_11	12	196	63	19600	17620	-1980	0.32	0.90	34	31	-3
0023	2T	13_11	13	38	8	3800	1970	-1830	0.21	0.52	6	3	-3
0023	2T	13_11	14	17	6	1700	1850	150	0.35	1.09	3	3	0
0023	2T	13_11	15	2	1	200	470	270	0.50	2.35	0	0	0
0023	2T	13_11	23	1	0	100	0	-100	0.00	0.00	0	0	0
0023	2T	13_12	12	196	63	19600	18260	-1340	0.32	0.93	34	32	-2
0023	2T	13_12	13	38	6	3800	1570	-2230	0.16	0.41	6	2	-4
0023	2T	13_12	14	8	3	800	1090	290	0.38	1.36	1	1	0
0023	2T	13_12	15	3	0	300	0	-300	0.00	0.00	0	0	0
0023	2T	13_12	16	1	0	100	0	-100	0.00	0.00	0	0	0
0023	2T	13_12	23	1	0	100	0	-100	0.00	0.00	0	0	0
0023	2T	13_2	12	67	17	6700	5310	-1390	0.25	0.79	11	9	-2
0023	2T	13_2	13	46	9	4600	2820	-1780	0.20	0.61	8	4	-4
0023	2T	13_2	14	23	4	2300	1820	-480	0.17	0.79	4	3	-1
0023	2T	13_2	15	17	1	1700	410	-1290	0.06	0.24	3	0	-3
0023	2T	13_2	16	12	4	1200	2560	1360	0.33	2.13	2	4	2
0023	2T	13_2	23	2	0	200	0	-200	0.00	0.00	0	0	0
0023	2T	13_2	24	2	0	200	0	-200	0.00	0.00	0	0	0
0023	2T	13_2	25	5	0	500	0	-500	0.00	0.00	0	0	0
0023	2T	13_2	26	3	0	300	0	-300	0.00	0.00	0	0	0
0023	2T	13_3	12	65	15	6500	5690	-810	0.23	0.88	11	10	-1
0023	2T	13_3	13	41	10	4100	3430	-670	0.24	0.84	7	6	-1
0023	2T	13_3	14	35	2	3500	1580	-1920	0.06	0.45	6	2	-4
0023	2T	13_3	15	11	0	1100	0	-1100	0.00	0.00	1	0	-1
0023	2T	13_3	16	16	1	1600	460	-1140	0.06	0.29	2	0	-2
0023	2T	13_3	21	1	0	100	0	-100	0.00	0.00	0	0	0
0023	2T	13_3	23	5	1	500	500	0	0.20	1.00	0	0	0
0023	2T	13_3	24	2	0	200	0	-200	0.00	0.00	0	0	0
0023	2T	13_3	25	1	0	100	0	-100	0.00	0.00	0	0	0
0023	2T	13_3	26	2	0	200	0	-200	0.00	0.00	0	0	0
0023	2T	13_4	12	71	16	7100	7280	180	0.23	1.03	12	12	0
0023	2T	13_4	13	48	8	4800	3650	-1150	0.17	0.76	8	6	-2
0023	2T	13_4	14	35	4	3500	1580	-1920	0.11	0.45	6	2	-4
0023	2T	13_4	15	10	1	1000	630	-370	0.10	0.63	1	1	0
0023	2T	13_4	16	13	1	1300	390	-910	0.08	0.30	2	0	-2
0023	2T	13_4	23	2	0	200	0	-200	0.00	0.00	0	0	0
0023	2T	13_4	24	4	1	400	400	0	0.25	1.00	0	0	0
0023	2T	13_4	25	4	0	400	0	-400	0.00	0.00	0	0	0
0023	2T	13_4	26	1	0	100	0	-100	0.00	0.00	0	0	0
0023	2T	13_5	12	78	18	7800	5680	-2120	0.23	0.73	13	10	-3
0023	2T	13_5	13	42	10	4200	3660	-540	0.24	0.87	7	6	-1
0023	2T	13_5	14	33	3	3300	1430	-1870	0.09	0.43	5	2	-3
0023	2T	13_5	15	16	3	1600	2090	490	0.19	1.31	2	3	1
0023	2T	13_5	16	14	3	1400	1220	-180	0.21	0.87	2	2	0
0023	2T	13_5	21	1	0	100	0	-100	0.00	0.00	0	0	0
0023	2T	13_5	23	3	0	300	0	-300	0.00	0.00	0	0	0
0023	2T	13_5	24	1	0	100	0	-100	0.00	0.00	0	0	0
0023	2T	13_5	25	1	0	100	0	-100	0.00	0.00	0	0	0
0023	2T	13_5	26	1	0	100	0	-100	0.00	0.00	0	0	0
0023	2T	13_6	12	70	12	7000	4510	-2490	0.17	0.64	12	7	-5
0023	2T	13_6	13	56	15	5600	4810	-790	0.27	0.86	9	8	-1
0023	2T	13_6	14	63	25	6300	6950	650	0.40	1.10	11	12	1
0023	2T	13_6	15	12	1	1200	220	-980	0.08	0.18	2	0	-2
0023	2T	13_6	16	9	1	900	590	-310	0.11	0.66	1	1	0
0023	2T	13_6	23	1	0	100	0	-100	0.00	0.00	0	0	0
0023	2T	13_6	24	1	0	100	0	-100	0.00	0.00	0	0	0
0023	2T	13_6	25	1	0	100	0	-100	0.00	0.00	0	0	0
0023	2T	13_7	12	96	24	9600	8280	-1320	0.25	0.86	16	14	-2
0023	2T	13_7	13	57	10	5700	3130	-2570	0.18	0.55	10	5	-5
0023	2T	13_7	14	48	20	4800	5140	340	0.42	1.07	8	9	1
0023	2T	13_7	15	6	1	600	470	-130	0.17	0.78	1	0	-1
0023	2T	13_7	16	8	1	800	210	-590	0.13	0.26	1	0	-1
0023	2T	13_7	23	2	0	200	0	-200	0.00	0.00	0	0	0
0023	2T	13_7	24	1	0	100	0	-100	0.00	0.00	0	0	0
0023	2T	13_7	25	3	0	300	0	-300	0.00	0.00	0	0	0
0023	2T	13_7	26	1	0	100	0	-100	0.00	0.00	0	0	0
0023	2T	13_8	12	83	23	8300	6420	-1880	0.28	0.77	14	11	-3
0023	2T	13_8	13	74	20	7400	5400	-2000	0.27	0.73	13	9	-4
0023	2T	13_8	14	54	18	5400	5360	-40	0.33	0.99	9	9	0
0023	2T	13_8	15	7	2	700	370	-330	0.29	0.53	1	0	-1
0023	2T	13_8	16	5	1	500	600	100	0.20	1.20	0	1	1
0023	2T	13_8	23	1	0	100	0	-100	0.00	0.00	0	0	0
0023	2T	13_8	25	1	0	100	0	-100	0.00	0.00	0	0	0
0023	2T	13_9	12	113	22	11300	5920	-5380	0.19	0.52	20	10	-10
0023	2T	13_9	13	82	23	8200	7620	-580	0.28	0.93	14	13	-1
0023	2T	13_9	14	28	7	2800	2530	-270	0.25	0.90	4	4	0
0023	2T	13_9	15	9	3	900	1200	300	0.33	1.33	1	2	1
0023	2T	13_9	16	4	0	400	0	-400	0.00	0.00	0	0	0
0023	2T	13_9	24	1	0	100	0	-100	0.00	0.00	0	0	0
0023	2T	14_1	12	91	22	9100	7570	-1530	0.24	0.83	16	13	-3
0023	2T	14_1	13	26	4	2600	1100	-1500	0.15	0.42	4	1	-3
0023	2T	14_1	14	126	31	12600	7970	-4630	0.25	0.63	22	14	-8
0023	2T	14_1	16	1	0	100	0	-100	0.00	0.00	0	0	0
0023	2T	14_10	12	111	24	11100	8820	-2280	0.22	0.79	19	15	-4
0023	2T	14_10	13	47	8	4700	3070	-1630	0.17	0.65	8	5	-3
0023	2T	14_10	14	22	3	2200	1390	-810	0.14	0.63	3	2	-1
0023	2T	14_10	15	6	0	600	0	-600	0.00	0.00	1	0	-1
0023	2T	14_10	16	2	0	200	0	-200	0.00	0.00	0	0	0
0023	2T	14_10	21	1	0	100	0	-100	0.00	0.00	0	0	0
0023	2T	14_10	23	2	0	200	0	-200	0.00	0.00	0	0	0
0023	2T	14_10	24	3	1	300	500	200	0.33	1.67	0	0	0
0023	2T	14_10	25	2	0	200	0	-200	0.00	0.00	0	0	0
0023	2T	14_10	26	5	0	500	0	-500	0.00	0.00	0	0	0
0023	2T	14_11	12	177	45	17700	14380	-3320	0.25	0.81	31	25	-6
0023	2T	14_11	13	44	9	4400	3090	-1310	0.20	0.70	7	5	-2
0023	2T	14_11	14	7	1	700	490	-210	0.14	0.70	1	0	-1
0023	2T	14_11	15	2	0	200	0	-200	0.00	0.00	0	0	0
0023	2T	14_11	16	1	0	100	0	-100	0.00	0.00	0	0	0
0023	2T	14_12	12	219	46	21900	13730	-8170	0.21	0.63	38	24	-14
0023	2T	14_12	13	22	4	2200	1500	-700	0.18	0.68	3	2	-1
0023	2T	14_12	14	4	0	400	0	-400	0.00	0.00	0	0	0
0023	2T	14_2	12	99	26	9900	9850	-50	0.26	0.99	17	17	0
0023	2T	14_2	13	47	2	4700	820	-3880	0.04	0.17	8	1	-7
0023	2T	14_2	14	26	1	2600	420	-2180	0.04	0.16	4	0	-4
0023	2T	14_2	15	15	2	1500	910	-590	0.13	0.61	2	1	-1
0023	2T	14_2	16	9	1	900	420	-480	0.11	0.47	1	0	-1
0023	2T	14_2	21	1	0	100	0	-100	0.00	0.00	0	0	0
0023	2T	14_2	23	3	0	300	0	-300	0.00	0.00	0	0	0
0023	2T	14_2	24	2	0	200	0	-200	0.00	0.00	0	0	0
0023	2T	14_2	25	1	0	100	0	-100	0.00	0.00	0	0	0
0023	2T	14_2	26	2	0	200	0	-200	0.00	0.00	0	0	0
0023	2T	14_3	12	132	35	13200	9440	-3760	0.27	0.72	23	16	-7
0023	2T	14_3	13	68	20	6800	5230	-1570	0.29	0.77	12	9	-3
0023	2T	14_3	14	25	8	2500	2480	-20	0.32	0.99	4	4	0
0023	2T	14_3	15	10	1	1000	310	-690	0.10	0.31	1	0	-1
0023	2T	14_3	16	1	0	100	0	-100	0.00	0.00	0	0	0
0023	2T	14_4	12	82	10	8200	3920	-4280	0.12	0.48	14	6	-8
0023	2T	14_4	13	57	13	5700	5540	-160	0.23	0.97	10	9	-1
0023	2T	14_4	14	33	6	3300	2300	-1000	0.18	0.70	5	4	-1
0023	2T	14_4	15	13	2	1300	1520	220	0.15	1.17	2	2	0
0023	2T	14_4	16	8	1	800	400	-400	0.13	0.50	1	0	-1
0023	2T	14_4	21	1	0	100	0	-100	0.00	0.00	0	0	0
0023	2T	14_4	23	3	0	300	0	-300	0.00	0.00	0	0	0
0023	2T	14_4	24	1	0	100	0	-100	0.00	0.00	0	0	0
0023	2T	14_4	25	1	0	100	0	-100	0.00	0.00	0	0	0
0023	2T	14_4	26	1	0	100	0	-100	0.00	0.00	0	0	0
0023	2T	14_5	12	155	45	15500	12870	-2630	0.29	0.83	27	22	-5
0023	2T	14_5	13	31	8	3100	2560	-540	0.26	0.83	5	4	-1
0023	2T	14_5	14	28	5	2800	2420	-380	0.18	0.86	4	4	0
0023	2T	14_5	15	5	0	500	0	-500	0.00	0.00	0	0	0
0023	2T	14_5	16	2	0	200	0	-200	0.00	0.00	0	0	0
0023	2T	14_5	25	1	0	100	0	-100	0.00	0.00	0	0	0
0023	2T	14_6	12	44	6	4400	2980	-1420	0.14	0.68	7	5	-2
0023	2T	14_6	13	36	6	3600	2230	-1370	0.17	0.62	6	3	-3
0023	2T	14_6	14	24	5	2400	3290	890	0.21	1.37	4	5	1
0023	2T	14_6	15	23	2	2300	2780	480	0.09	1.21	4	4	0
0023	2T	14_6	16	12	1	1200	540	-660	0.08	0.45	2	0	-2
0023	2T	14_6	21	2	0	200	0	-200	0.00	0.00	0	0	0
0023	2T	14_6	23	3	0	300	0	-300	0.00	0.00	0	0	0
0023	2T	14_6	24	4	0	400	0	-400	0.00	0.00	0	0	0
0023	2T	14_6	25	3	1	300	500	200	0.33	1.67	0	0	0
0023	2T	14_6	26	5	0	500	0	-500	0.00	0.00	0	0	0
0023	2T	14_7	12	56	5	5600	1490	-4110	0.09	0.27	9	2	-7
0023	2T	14_7	13	34	5	3400	2100	-1300	0.15	0.62	6	3	-3
0023	2T	14_7	14	22	0	2200	0	-2200	0.00	0.00	3	0	-3
0023	2T	14_7	15	15	2	1500	1560	60	0.13	1.04	2	2	0
0023	2T	14_7	16	19	1	1900	570	-1330	0.05	0.30	3	1	-2
0025	3T	24	136	118	8	11800	8880	-2920	0.07	0.75	20	15	-5
0025	3T	24	142	5	1	500	1020	520	0.20	2.04	0	1	1
0025	3T	24	143	25	2	2500	1480	-1020	0.08	0.59	4	2	-2
0025	3T	24	145	58	3	5800	2720	-3080	0.05	0.47	10	4	-6
0025	3T	24	146	19	2	1900	1590	-310	0.11	0.84	3	2	-1
0025	3T	24	152	4	0	400	0	-400	0.00	0.00	0	0	0
0025	3T	24	153	5	0	500	0	-500	0.00	0.00	0	0	0
0025	3T	24	154	1	0	100	0	-100	0.00	0.00	0	0	0
0025	3T	24	156	5	1	500	730	230	0.20	1.46	0	1	1
0025	3T	24	163	2	0	200	0	-200	0.00	0.00	0	0	0
0025	3T	24	164	1	0	100	0	-100	0.00	0.00	0	0	0
0025	3T	24	234	9	0	900	0	-900	0.00	0.00	1	0	-1
0025	3T	24	235	3	0	300	0	-300	0.00	0.00	0	0	0
0025	3T	24	236	4	0	400	0	-400	0.00	0.00	0	0	0
0025	3T	24	243	1	0	100	0	-100	0.00	0.00	0	0	0
0025	3T	24	245	1	0	100	0	-100	0.00	0.00	0	0	0
0038	1T	1	1	11319	6447	1131900	1048620	-83280	0.57	0.93	2003	1855	-148
0038	1T	1	2	1640	645	164000	156030	-7970	0.39	0.95	290	276	-14
0038	1T	2	1	10826	5984	1082600	981150	-101450	0.55	0.91	1916	1736	-180
0038	1T	2	2	1749	689	174900	168240	-6660	0.39	0.96	309	297	-12
0038	1T	3	1	10939	6298	1093900	1030310	-63590	0.58	0.94	1936	1823	-113
0038	1T	3	2	1781	655	178100	160150	-17950	0.37	0.90	315	283	-32
0038	1T	4	1	8886	5390	888600	824410	-64190	0.61	0.93	1572	1459	-113
0038	1T	4	2	1450	544	145000	124830	-20170	0.38	0.86	256	220	-36
0038	1T	5	1	7729	4918	772900	710670	-62230	0.64	0.92	1367	1257	-110
0038	1T	5	2	476	158	47600	43700	-3900	0.33	0.92	84	77	-7
0038	1T	6	1	622	375	62200	54200	-8000	0.60	0.87	110	95	-15
0038	1T	6	2	36	17	3600	4690	1090	0.47	1.30	6	8	2
0038	1T	7	1	12660	7869	1266000	1161090	-104910	0.62	0.92	2240	2055	-185
0038	1T	7	2	826	274	82600	76020	-6580	0.33	0.92	146	134	-12
0038	2F	1	12	5477	1722	547700	461470	-86230	0.31	0.84	969	816	-153
0038	2F	1	13	3859	1139	385900	316020	-69880	0.30	0.82	683	559	-124
0038	2F	1	14	1080	290	108000	80700	-27300	0.27	0.75	191	142	-49
0038	2F	1	15	139	38	13900	10360	-3540	0.27	0.75	24	18	-6
0038	2F	1	16	230	45	23000	17210	-5790	0.20	0.75	40	30	-10
0038	2F	1	23	156	38	15600	17150	1550	0.24	1.10	27	30	3
0038	2F	1	24	39	6	3900	4460	560	0.15	1.14	6	7	1
0038	2F	1	25	2	0	200	0	-200	0.00	0.00	0	0	0
0038	2F	1	26	36	3	3600	2270	-1330	0.08	0.63	6	4	-2
0038	2F	2	12	4765	1581	476500	401820	-74680	0.33	0.84	843	711	-132
0038	2F	2	13	3211	982	321100	258870	-62230	0.31	0.81	568	458	-110
0038	2F	2	14	1739	529	173900	139710	-34190	0.30	0.80	307	247	-60
0038	2F	2	15	298	91	29800	28930	-870	0.31	0.97	52	51	-1
0038	2F	2	16	291	62	29100	24550	-4550	0.21	0.84	51	43	-8
0038	2F	2	23	105	25	10500	8430	-2070	0.24	0.80	18	14	-4
0038	2F	2	24	96	21	9600	7730	-1870	0.22	0.81	16	13	-3
0038	2F	2	25	34	7	3400	2020	-1380	0.21	0.59	6	3	-3
0038	2F	2	26	91	16	9100	5780	-3320	0.18	0.64	16	10	-6
0038	2F	3	12	5087	1732	508700	444070	-64630	0.34	0.87	900	785	-115
0038	2F	3	13	2945	900	294500	226970	-67530	0.31	0.77	521	401	-120
0038	2F	3	14	1735	431	173500	121120	-52380	0.25	0.70	307	214	-93
0038	2F	3	15	500	118	50000	39570	-10430	0.24	0.79	88	70	-18
0038	2F	3	16	331	62	33100	27920	-5180	0.19	0.84	58	49	-9
0038	2F	3	23	178	41	17800	15290	-2510	0.23	0.86	31	27	-4
0038	2F	3	24	117	25	11700	11430	-270	0.21	0.98	20	20	0
0038	2F	3	25	58	9	5800	3860	-1940	0.16	0.67	10	6	-4
0038	2F	3	26	84	18	8400	7810	-590	0.21	0.93	14	13	-1
0038	2F	4	12	4492	1519	449200	368260	-80940	0.34	0.82	795	651	-144
0038	2F	4	13	2334	761	233400	185890	-47510	0.33	0.80	413	329	-84
0038	2F	4	14	1316	388	131600	107570	-24030	0.29	0.82	232	190	-42
0038	2F	4	15	341	89	34100	28980	-5120	0.26	0.85	60	51	-9
0038	2F	4	16	163	33	16300	14580	-1720	0.20	0.89	28	25	-3
0038	2F	4	23	154	36	15400	11350	-4050	0.23	0.74	27	20	-7
0038	2F	4	24	111	22	11100	7310	-3790	0.20	0.66	19	12	-7
0038	2F	4	25	74	16	7400	7790	390	0.22	1.05	13	13	0
0038	2F	4	26	52	9	5200	4070	-1130	0.17	0.78	9	7	-2
0038	2F	5	12	4204	1513	420400	354750	-65650	0.36	0.84	744	627	-117
0038	2F	5	13	1783	554	178300	143200	-35100	0.31	0.80	315	253	-62
0038	2F	5	14	1065	327	106500	88980	-17520	0.31	0.84	188	157	-31
0038	2F	5	15	233	48	23300	17650	-5650	0.21	0.76	41	31	-10
0038	2F	5	16	175	34	17500	9030	-8470	0.19	0.52	30	15	-15
0038	2F	5	23	31	2	3100	790	-2310	0.06	0.25	5	1	-4
0038	2F	5	24	32	4	3200	1670	-1530	0.13	0.52	5	2	-3
0038	2F	5	25	8	0	800	0	-800	0.00	0.00	1	0	-1
0038	2F	5	26	23	1	2300	660	-1640	0.04	0.29	4	1	-3
0038	2F	6	12	324	113	32400	26770	-5630	0.35	0.83	57	47	-10
0038	2F	6	13	152	43	15200	11430	-3770	0.28	0.75	26	20	-6
0038	2F	6	14	94	22	9400	5800	-3600	0.23	0.62	16	10	-6
0038	2F	6	15	17	4	1700	1920	220	0.24	1.13	3	3	0
0038	2F	6	16	19	5	1900	2430	530	0.26	1.28	3	4	1
0038	2F	6	23	1	0	100	0	-100	0.00	0.00	0	0	0
0038	2F	6	24	3	0	300	0	-300	0.00	0.00	0	0	0
0038	2F	6	25	1	0	100	0	-100	0.00	0.00	0	0	0
0038	2F	7	12	7262	2476	726200	614650	-111550	0.34	0.85	1285	1087	-198
0038	2F	7	13	2816	846	281600	227470	-54130	0.30	0.81	498	402	-96
0038	2F	7	14	1482	407	148200	110390	-37810	0.27	0.74	262	195	-67
0038	2F	7	15	382	78	38200	31100	-7100	0.20	0.81	67	55	-12
0038	2F	7	16	305	60	30500	27440	-3060	0.20	0.90	53	48	-5
0038	2F	7	23	64	13	6400	4450	-1950	0.20	0.70	11	7	-4
0038	2F	7	24	36	7	3600	3910	310	0.19	1.09	6	6	0
0038	2F	7	25	36	4	3600	1410	-2190	0.11	0.39	6	2	-4
0038	2F	7	26	31	6	3100	3500	400	0.19	1.13	5	6	1
0038	2T	1	12	5412	1251	541200	431030	-110170	0.23	0.80	957	762	-195
0038	2T	1	13	3859	786	385900	288250	-97650	0.20	0.75	683	510	-173
0038	2T	1	14	1080	215	108000	80780	-27220	0.20	0.75	191	142	-49
0038	2T	1	15	139	27	13900	10460	-3440	0.19	0.75	24	18	-6
0038	2T	1	16	230	28	23000	15860	-7140	0.12	0.69	40	28	-12
0038	2T	1	21	65	4	6500	3550	-2950	0.06	0.55	11	6	-5
0038	2T	1	23	156	22	15600	18040	2440	0.14	1.16	27	31	4
0038	2T	1	24	39	5	3900	7780	3880	0.13	1.99	6	13	7
0038	2T	1	25	2	0	200	0	-200	0.00	0.00	0	0	0
0038	2T	1	26	36	0	3600	0	-3600	0.00	0.00	6	0	-6
0038	2T	2	12	4732	1125	473200	375570	-97630	0.24	0.79	837	664	-173
0038	2T	2	13	3211	721	321100	253030	-68070	0.22	0.79	568	447	-121
0038	2T	2	14	1739	377	173900	139230	-34670	0.22	0.80	307	246	-61
0038	2T	2	15	298	60	29800	27280	-2520	0.20	0.92	52	48	-4
0038	2T	2	16	291	45	29100	24320	-4780	0.15	0.84	51	43	-8
0038	2T	2	21	33	8	3300	6290	2990	0.24	1.91	5	11	6
0038	2T	2	23	105	13	10500	8700	-1800	0.12	0.83	18	15	-3
0038	2T	2	24	96	15	9600	6480	-3120	0.16	0.68	16	11	-5
0038	2T	2	25	34	6	3400	4400	1000	0.18	1.29	6	7	1
0038	2T	2	26	91	8	9100	4940	-4160	0.09	0.54	16	8	-8
0038	2T	3	12	5038	1299	503800	435370	-68430	0.26	0.86	891	770	-121
0038	2T	3	13	2945	634	294500	220940	-73560	0.22	0.75	521	391	-130
0038	2T	3	14	1735	302	173500	118380	-55120	0.17	0.68	307	209	-98
0038	2T	3	15	500	85	50000	41520	-8480	0.17	0.83	88	73	-15
0038	2T	3	16	331	40	33100	29800	-3300	0.12	0.90	58	52	-6
0038	2T	3	21	49	3	4900	2170	-2730	0.06	0.44	8	3	-5
0038	2T	3	23	178	28	17800	17810	10	0.16	1.00	31	31	0
0038	2T	3	24	117	13	11700	7420	-4280	0.11	0.63	20	13	-7
0038	2T	3	25	58	8	5800	6240	440	0.14	1.08	10	11	1
0038	2T	3	26	84	13	8400	10810	2410	0.15	1.29	14	19	5
0038	2T	4	12	4449	1140	444900	343810	-101090	0.26	0.77	787	608	-179
0038	2T	4	13	2334	568	233400	186140	-47260	0.24	0.80	413	329	-84
0038	2T	4	14	1316	289	131600	110820	-20780	0.22	0.84	232	196	-36
0038	2T	4	15	341	64	34100	33100	-1000	0.19	0.97	60	58	-2
0038	2T	4	16	163	22	16300	14900	-1400	0.13	0.91	28	26	-2
0038	2T	4	21	43	5	4300	5080	780	0.12	1.18	7	8	1
0038	2T	4	23	154	23	15400	12510	-2890	0.15	0.81	27	22	-5
0038	2T	4	24	111	10	11100	4170	-6930	0.09	0.38	19	7	-12
0038	2T	4	25	74	10	7400	7530	130	0.14	1.02	13	13	0
0038	2T	4	26	52	5	5200	3240	-1960	0.10	0.62	9	5	-4
0038	2T	5	12	4184	1190	418400	341870	-76530	0.28	0.82	740	605	-135
0038	2T	5	13	1783	404	178300	136630	-41670	0.23	0.77	315	241	-74
0038	2T	5	14	1065	237	106500	87980	-18520	0.22	0.83	188	155	-33
0038	2T	5	15	233	30	23300	14130	-9170	0.13	0.61	41	25	-16
0038	2T	5	16	175	23	17500	10380	-7120	0.13	0.59	30	18	-12
0038	2T	5	21	20	1	2000	2060	60	0.05	1.03	3	3	0
0038	2T	5	23	31	2	3100	890	-2210	0.06	0.29	5	1	-4
0038	2T	5	24	32	2	3200	3380	180	0.06	1.06	5	5	0
0038	2T	5	25	8	0	800	0	-800	0.00	0.00	1	0	-1
0038	2T	5	26	23	1	2300	1200	-1100	0.04	0.52	4	2	-2
0038	2T	6	12	322	84	32200	24580	-7620	0.26	0.76	56	43	-13
0038	2T	6	13	152	32	15200	10350	-4850	0.21	0.68	26	18	-8
0038	2T	6	14	94	17	9400	6170	-3230	0.18	0.66	16	10	-6
0038	2T	6	15	17	3	1700	1870	170	0.18	1.10	3	3	0
0038	2T	6	16	19	5	1900	3540	1640	0.26	1.86	3	6	3
0038	2T	6	21	2	0	200	0	-200	0.00	0.00	0	0	0
0038	2T	6	23	1	0	100	0	-100	0.00	0.00	0	0	0
0038	2T	6	24	3	0	300	0	-300	0.00	0.00	0	0	0
0038	2T	6	25	1	0	100	0	-100	0.00	0.00	0	0	0
0038	2T	7	12	7253	1946	725300	595860	-129440	0.27	0.82	1283	1054	-229
0038	2T	7	13	2816	624	281600	209970	-71630	0.22	0.75	498	371	-127
0038	2T	7	14	1482	302	148200	110820	-37380	0.20	0.75	262	196	-66
0038	2T	7	15	382	60	38200	30920	-7280	0.16	0.81	67	54	-13
0038	2T	7	16	305	46	30500	31200	700	0.15	1.02	53	55	2
0038	2T	7	21	9	0	900	0	-900	0.00	0.00	1	0	-1
0038	2T	7	23	64	8	6400	4980	-1420	0.13	0.78	11	8	-3
0038	2T	7	24	36	6	3600	6170	2570	0.17	1.71	6	10	4
0038	2T	7	25	36	4	3600	2920	-680	0.11	0.81	6	5	-1
0038	2T	7	26	31	3	3100	3000	-100	0.10	0.97	5	5	0
0038	3F	1	123	477	137	47700	43770	-3930	0.29	0.92	84	77	-7
0038	3F	1	124	1514	371	151400	124520	-26880	0.25	0.82	267	220	-47
0038	3F	1	125	882	155	88200	70600	-17600	0.18	0.80	156	124	-32
0038	3F	1	126	2482	224	248200	205300	-42900	0.09	0.83	439	363	-76
0038	3F	1	134	1247	289	124700	103820	-20880	0.23	0.83	220	183	-37
0038	3F	1	135	762	138	76200	55550	-20650	0.18	0.73	134	98	-36
0038	3F	1	136	1270	137	127000	105620	-21380	0.11	0.83	224	186	-38
0038	3F	1	145	154	36	15400	20840	5440	0.23	1.35	27	36	9
0038	3F	1	146	199	28	19900	17530	-2370	0.14	0.88	35	31	-4
0038	3F	1	156	37	7	3700	2980	-720	0.19	0.81	6	5	-1
0038	3F	1	234	35	6	3500	3040	-460	0.17	0.87	6	5	-1
0038	3F	1	235	47	8	4700	4220	-480	0.17	0.90	8	7	-1
0038	3F	1	236	55	10	5500	4300	-1200	0.18	0.78	9	7	-2
0038	3F	1	245	9	1	900	940	40	0.11	1.04	1	1	0
0038	3F	1	246	6	0	600	0	-600	0.00	0.00	1	0	-1
0038	3F	1	256	2	0	200	0	-200	0.00	0.00	0	0	0
0038	3F	2	123	455	118	45500	32490	-13010	0.26	0.71	80	57	-23
0038	3F	2	124	1364	314	136400	99940	-36460	0.23	0.73	241	176	-65
0038	3F	2	125	1017	191	101700	79250	-22450	0.19	0.78	180	140	-40
0038	3F	2	126	1728	227	172800	143960	-28840	0.13	0.83	305	254	-51
0038	3F	2	134	812	157	81200	55550	-25650	0.19	0.68	143	98	-45
0038	3F	2	135	742	150	74200	58270	-15930	0.20	0.79	131	103	-28
0038	3F	2	136	1209	149	120900	87080	-33820	0.12	0.72	213	154	-59
0038	3F	2	145	374	70	37400	27420	-9980	0.19	0.73	66	48	-18
0038	3F	2	146	443	66	44300	39920	-4380	0.15	0.90	78	70	-8
0038	3F	2	156	72	12	7200	6330	-870	0.17	0.88	12	11	-1
0038	3F	2	234	21	6	2100	2780	680	0.29	1.32	3	4	1
0038	3F	2	235	21	4	2100	2800	700	0.19	1.33	3	4	1
0038	3F	2	236	44	9	4400	4810	410	0.20	1.09	7	8	1
0038	3F	2	245	24	4	2400	1870	-530	0.17	0.78	4	3	-1
0038	3F	2	246	28	1	2800	160	-2640	0.04	0.06	4	0	-4
0038	3F	2	256	9	1	900	420	-480	0.11	0.47	1	0	-1
0038	3F	3	123	656	205	65600	53590	-12010	0.31	0.82	116	94	-22
0038	3F	3	124	1649	358	164900	122790	-42110	0.22	0.74	291	217	-74
0038	3F	3	125	1201	199	120100	78960	-41140	0.17	0.66	212	139	-73
0038	3F	3	126	1431	188	143100	126430	-16670	0.13	0.88	253	223	-30
0038	3F	3	134	740	158	74000	54210	-19790	0.21	0.73	130	95	-35
0038	3F	3	135	883	151	88300	61520	-26780	0.17	0.70	156	108	-48
0038	3F	3	136	831	112	83100	65160	-17940	0.13	0.78	147	115	-32
0038	3F	3	145	483	71	48300	30320	-17980	0.15	0.63	85	53	-32
0038	3F	3	146	286	31	28600	18510	-10090	0.11	0.65	50	32	-18
0038	3F	3	156	85	15	8500	7550	-950	0.18	0.89	15	13	-2
0038	3F	3	234	29	4	2900	1530	-1370	0.14	0.53	5	2	-3
0038	3F	3	235	65	20	6500	8490	1990	0.31	1.31	11	15	4
0038	3F	3	236	50	6	5000	4450	-550	0.12	0.89	8	7	-1
0038	3F	3	245	45	4	4500	1290	-3210	0.09	0.29	7	2	-5
0038	3F	3	246	14	1	1400	240	-1160	0.07	0.17	2	0	-2
0038	3F	3	256	4	0	400	0	-400	0.00	0.00	0	0	0
0038	3F	4	123	817	249	81700	72220	-9480	0.30	0.88	144	127	-17
0038	3F	4	124	1875	397	187500	134480	-53020	0.21	0.72	331	238	-93
0038	3F	4	125	872	179	87200	75400	-11800	0.21	0.86	154	133	-21
0038	3F	4	126	793	92	79300	60070	-19230	0.12	0.76	140	106	-34
0038	3F	4	134	851	202	85100	71050	-14050	0.24	0.83	150	125	-25
0038	3F	4	135	604	130	60400	49470	-10930	0.22	0.82	106	87	-19
0038	3F	4	136	454	66	45400	34800	-10600	0.15	0.77	80	61	-19
0038	3F	4	145	288	47	28800	22130	-6670	0.16	0.77	50	39	-11
0038	3F	4	146	161	20	16100	14110	-1990	0.12	0.88	28	24	-4
0038	3F	4	156	50	11	5000	3460	-1540	0.22	0.69	8	6	-2
0038	3F	4	234	29	9	2900	3170	270	0.31	1.09	5	5	0
0038	3F	4	235	56	8	5600	2710	-2890	0.14	0.48	9	4	-5
0038	3F	4	236	38	5	3800	1920	-1880	0.13	0.51	6	3	-3
0038	3F	4	245	31	5	3100	1840	-1260	0.16	0.59	5	3	-2
0038	3F	4	246	21	2	2100	2080	-20	0.10	0.99	3	3	0
0038	3F	4	256	8	3	800	1180	380	0.38	1.48	1	2	1
0038	3F	5	123	862	235	86200	62660	-23540	0.27	0.73	152	110	-42
0038	3F	5	124	2049	447	204900	156670	-48230	0.22	0.76	362	277	-85
0038	3F	5	125	619	107	61900	51270	-10630	0.17	0.83	109	90	-19
0038	3F	5	126	573	93	57300	62040	4740	0.16	1.08	101	109	8
0038	3F	5	134	639	152	63900	48520	-15380	0.24	0.76	113	85	-28
0038	3F	5	135	386	71	38600	30630	-7970	0.18	0.79	68	54	-14
0038	3F	5	136	334	51	33400	32410	-990	0.15	0.97	59	57	-2
0038	3F	5	145	219	48	21900	18650	-3250	0.22	0.85	38	33	-5
0038	3F	5	146	152	28	15200	14800	-400	0.18	0.97	26	26	0
0038	3F	5	156	34	4	3400	2560	-840	0.12	0.75	6	4	-2
0038	3F	5	234	8	1	800	470	-330	0.13	0.59	1	0	-1
0038	3F	5	235	11	0	1100	0	-1100	0.00	0.00	1	0	-1
0038	3F	5	236	2	0	200	0	-200	0.00	0.00	0	0	0
0038	3F	5	245	9	0	900	0	-900	0.00	0.00	1	0	-1
0038	3F	5	246	11	1	1100	430	-670	0.09	0.39	1	0	-1
0038	3F	5	256	2	1	200	1530	1330	0.50	7.65	0	2	2
0038	3F	6	123	63	18	6300	6390	90	0.29	1.01	11	11	0
0038	3F	6	124	151	30	15100	9530	-5570	0.20	0.63	26	16	-10
0038	3F	6	125	45	11	4500	5460	960	0.24	1.21	7	9	2
0038	3F	6	126	60	9	6000	3650	-2350	0.15	0.61	10	6	-4
0038	3F	6	134	41	6	4100	1570	-2530	0.15	0.38	7	2	-5
0038	3F	6	135	34	10	3400	4680	1280	0.29	1.38	6	8	2
0038	3F	6	136	36	6	3600	4750	1150	0.17	1.32	6	8	2
0038	3F	6	145	16	3	1600	870	-730	0.19	0.54	2	1	-1
0038	3F	6	146	14	2	1400	530	-870	0.14	0.38	2	0	-2
0038	3F	6	156	3	0	300	0	-300	0.00	0.00	0	0	0
0038	3F	6	235	1	0	100	0	-100	0.00	0.00	0	0	0
0038	3F	6	246	1	0	100	0	-100	0.00	0.00	0	0	0
0038	3F	7	123	1671	448	167100	136830	-30270	0.27	0.82	295	242	-53
0038	3F	7	124	3085	650	308500	236310	-72190	0.21	0.77	546	418	-128
0038	3F	7	125	1159	204	115900	91320	-24580	0.18	0.79	205	161	-44
0038	3F	7	126	998	123	99800	73770	-26030	0.12	0.74	176	130	-46
0038	3F	7	134	955	198	95500	75060	-20440	0.21	0.79	169	132	-37
0038	3F	7	135	641	96	64100	43890	-20210	0.15	0.68	113	77	-36
0038	3F	7	136	467	53	46700	29140	-17560	0.11	0.62	82	51	-31
0038	3F	7	145	176	22	17600	8450	-9150	0.13	0.48	31	14	-17
0038	3F	7	146	178	27	17800	17080	-720	0.15	0.96	31	30	-1
0038	3F	7	156	52	8	5200	4560	-640	0.15	0.88	9	8	-1
0038	3F	7	234	15	1	1500	380	-1120	0.07	0.25	2	0	-2
0038	3F	7	235	12	2	1200	940	-260	0.17	0.78	2	1	-1
0038	3F	7	236	10	2	1000	700	-300	0.20	0.70	1	1	0
0038	3F	7	245	4	0	400	0	-400	0.00	0.00	0	0	0
0038	3F	7	246	5	0	500	0	-500	0.00	0.00	0	0	0
0038	3F	7	256	5	1	500	1600	1100	0.20	3.20	0	2	2
0038	3T	1	123	407	51	40700	34480	-6220	0.13	0.85	72	61	-11
0038	3T	1	124	1506	151	150600	120170	-30430	0.10	0.80	266	212	-54
0038	3T	1	125	870	64	87000	79910	-7090	0.07	0.92	153	141	-12
0038	3T	1	126	2433	97	243300	206320	-36980	0.04	0.85	430	365	-65
0038	3T	1	132	68	7	6800	5380	-1420	0.10	0.79	12	9	-3
0038	3T	1	134	1247	118	124700	107080	-17620	0.09	0.86	220	189	-31
0038	3T	1	135	756	58	75600	58870	-16730	0.08	0.78	133	104	-29
0038	3T	1	136	1262	60	126200	100600	-25600	0.05	0.80	223	178	-45
0038	3T	1	145	152	10	15200	12880	-2320	0.07	0.85	26	22	-4
0038	3T	1	146	182	9	18200	10770	-7430	0.05	0.59	32	19	-13
0038	3T	1	152	8	0	800	0	-800	0.00	0.00	1	0	-1
0038	3T	1	153	6	0	600	0	-600	0.00	0.00	1	0	-1
0038	3T	1	154	2	0	200	0	-200	0.00	0.00	0	0	0
0038	3T	1	156	34	1	3400	930	-2470	0.03	0.27	6	1	-5
0038	3T	1	163	8	1	800	1360	560	0.13	1.70	1	2	1
0038	3T	1	164	17	0	1700	0	-1700	0.00	0.00	3	0	-3
0038	3T	1	165	3	1	300	1310	1010	0.33	4.37	0	2	2
0038	3T	1	213	2	0	200	0	-200	0.00	0.00	0	0	0
0038	3T	1	214	8	0	800	0	-800	0.00	0.00	1	0	-1
0038	3T	1	215	4	0	400	0	-400	0.00	0.00	0	0	0
0038	3T	1	216	49	0	4900	0	-4900	0.00	0.00	8	0	-8
0038	3T	1	234	35	2	3500	6800	3300	0.06	1.94	6	12	6
0038	3T	1	235	47	3	4700	10260	5560	0.06	2.18	8	18	10
0038	3T	1	236	55	6	5500	7550	2050	0.11	1.37	9	13	4
0038	3T	1	245	9	1	900	5950	5050	0.11	6.61	1	10	9
0038	3T	1	246	6	0	600	0	-600	0.00	0.00	1	0	-1
0038	3T	1	256	1	0	100	0	-100	0.00	0.00	0	0	0
0038	3T	1	265	1	0	100	0	-100	0.00	0.00	0	0	0
0038	3T	2	123	448	52	44800	36580	-8220	0.12	0.82	79	64	-15
0038	3T	2	124	1353	125	135300	103210	-32090	0.09	0.76	239	182	-57
0038	3T	2	125	1011	74	101100	74010	-27090	0.07	0.73	178	130	-48
0038	3T	2	126	1707	90	170700	145220	-25480	0.05	0.85	302	257	-45
0038	3T	2	132	6	0	600	0	-600	0.00	0.00	1	0	-1
0038	3T	2	134	809	72	80900	59890	-21010	0.09	0.74	143	106	-37
0038	3T	2	135	733	60	73300	57040	-16260	0.08	0.78	129	100	-29
0038	3T	2	136	1207	59	120700	79420	-41280	0.05	0.66	213	140	-73
0038	3T	2	142	3	0	300	0	-300	0.00	0.00	0	0	0
0038	3T	2	143	3	0	300	0	-300	0.00	0.00	0	0	0
0038	3T	2	145	370	15	37000	14910	-22090	0.04	0.40	65	26	-39
0038	3T	2	146	432	32	43200	48860	5660	0.07	1.13	76	86	10
0038	3T	2	152	3	0	300	0	-300	0.00	0.00	0	0	0
0038	3T	2	153	9	1	900	720	-180	0.11	0.80	1	1	0
0038	3T	2	154	4	0	400	0	-400	0.00	0.00	0	0	0
0038	3T	2	156	72	4	7200	8520	1320	0.06	1.18	12	15	3
0038	3T	2	163	2	0	200	0	-200	0.00	0.00	0	0	0
0038	3T	2	164	11	0	1100	0	-1100	0.00	0.00	1	0	-1
0038	3T	2	213	1	0	100	0	-100	0.00	0.00	0	0	0
0038	3T	2	214	8	1	800	1510	710	0.13	1.89	1	2	1
0038	3T	2	215	3	0	300	0	-300	0.00	0.00	0	0	0
0038	3T	2	216	21	7	2100	20170	18070	0.33	9.60	3	35	32
0038	3T	2	234	21	3	2100	3490	1390	0.14	1.66	3	6	3
0038	3T	2	235	20	0	2000	0	-2000	0.00	0.00	3	0	-3
0038	3T	2	236	44	2	4400	3000	-1400	0.05	0.68	7	5	-2
0038	3T	2	245	24	1	2400	1350	-1050	0.04	0.56	4	2	-2
0038	3T	2	246	28	0	2800	0	-2800	0.00	0.00	4	0	-4
0038	3T	2	253	1	0	100	0	-100	0.00	0.00	0	0	0
0038	3T	2	256	9	0	900	0	-900	0.00	0.00	1	0	-1
0038	3T	3	123	654	94	65400	58250	-7150	0.14	0.89	115	103	-12
0038	3T	3	124	1637	153	163700	124240	-39460	0.09	0.76	289	219	-70
0038	3T	3	125	1188	83	118800	83890	-34910	0.07	0.71	210	148	-62
0038	3T	3	126	1405	94	140500	145030	4530	0.07	1.03	248	256	8
0038	3T	3	132	2	0	200	0	-200	0.00	0.00	0	0	0
0038	3T	3	134	730	75	73000	59570	-13430	0.10	0.82	129	105	-24
0038	3T	3	135	875	56	87500	55990	-31510	0.06	0.64	154	99	-55
0038	3T	3	136	827	44	82700	61510	-21190	0.05	0.74	146	108	-38
0038	3T	3	143	10	0	1000	0	-1000	0.00	0.00	1	0	-1
0038	3T	3	145	476	21	47600	22420	-25180	0.04	0.47	84	39	-45
0038	3T	3	146	280	7	28000	8140	-19860	0.03	0.29	49	14	-35
0038	3T	3	152	1	0	100	0	-100	0.00	0.00	0	0	0
0038	3T	3	153	8	0	800	0	-800	0.00	0.00	1	0	-1
0038	3T	3	154	7	0	700	0	-700	0.00	0.00	1	0	-1
0038	3T	3	156	85	5	8500	8280	-220	0.06	0.97	15	14	-1
0038	3T	3	162	1	0	100	0	-100	0.00	0.00	0	0	0
0038	3T	3	163	4	1	400	1660	1260	0.25	4.15	0	2	2
0038	3T	3	164	6	0	600	0	-600	0.00	0.00	1	0	-1
0038	3T	3	214	12	0	1200	0	-1200	0.00	0.00	2	0	-2
0038	3T	3	215	12	0	1200	0	-1200	0.00	0.00	2	0	-2
0038	3T	3	216	25	0	2500	0	-2500	0.00	0.00	4	0	-4
0038	3T	3	234	29	2	2900	2570	-330	0.07	0.89	5	4	-1
0038	3T	3	235	65	5	6500	6630	130	0.08	1.02	11	11	0
0038	3T	3	236	50	0	5000	0	-5000	0.00	0.00	8	0	-8
0038	3T	3	245	44	0	4400	0	-4400	0.00	0.00	7	0	-7
0038	3T	3	246	14	0	1400	0	-1400	0.00	0.00	2	0	-2
0038	3T	3	254	1	0	100	0	-100	0.00	0.00	0	0	0
0038	3T	3	256	4	0	400	0	-400	0.00	0.00	0	0	0
0038	3T	4	123	815	109	81500	73160	-8340	0.13	0.90	144	129	-15
0038	3T	4	124	1861	177	186100	145500	-40600	0.10	0.78	329	257	-72
0038	3T	4	125	860	70	86000	75230	-10770	0.08	0.87	152	133	-19
0038	3T	4	126	777	39	77700	53920	-23780	0.05	0.69	137	95	-42
0038	3T	4	134	838	102	83800	84580	780	0.12	1.01	148	149	1
0038	3T	4	135	599	58	59900	50140	-9760	0.10	0.84	106	88	-18
0038	3T	4	136	454	36	45400	37050	-8350	0.08	0.82	80	65	-15
0038	3T	4	142	1	0	100	0	-100	0.00	0.00	0	0	0
0038	3T	4	143	13	0	1300	0	-1300	0.00	0.00	2	0	-2
0038	3T	4	145	268	19	26800	25430	-1370	0.07	0.95	47	45	-2
0038	3T	4	146	159	8	15900	9370	-6530	0.05	0.59	28	16	-12
0038	3T	4	153	5	1	500	1420	920	0.20	2.84	0	2	2
0038	3T	4	154	20	1	2000	610	-1390	0.05	0.31	3	1	-2
0038	3T	4	156	50	4	5000	3940	-1060	0.08	0.79	8	6	-2
0038	3T	4	164	2	0	200	0	-200	0.00	0.00	0	0	0
0038	3T	4	213	2	0	200	0	-200	0.00	0.00	0	0	0
0038	3T	4	214	13	0	1300	0	-1300	0.00	0.00	2	0	-2
0038	3T	4	215	12	0	1200	0	-1200	0.00	0.00	2	0	-2
0038	3T	4	216	16	2	1600	12950	11350	0.13	8.09	2	22	20
0038	3T	4	234	29	1	2900	2050	-850	0.03	0.71	5	3	-2
0038	3T	4	235	55	2	5500	2120	-3380	0.04	0.39	9	3	-6
0038	3T	4	236	38	4	3800	4760	960	0.11	1.25	6	8	2
0038	3T	4	245	31	0	3100	0	-3100	0.00	0.00	5	0	-5
0038	3T	4	246	21	0	2100	0	-2100	0.00	0.00	3	0	-3
0038	3T	4	253	1	0	100	0	-100	0.00	0.00	0	0	0
0038	3T	4	256	8	1	800	2270	1470	0.13	2.84	1	4	3
0038	3T	5	123	860	117	86000	67700	-18300	0.14	0.79	152	119	-33
0038	3T	5	124	2045	218	204500	155530	-48970	0.11	0.76	361	275	-86
0038	3T	5	125	617	53	61700	55200	-6500	0.09	0.89	109	97	-12
0038	3T	5	126	562	43	56200	70160	13960	0.08	1.25	99	124	25
0038	3T	5	132	1	0	100	0	-100	0.00	0.00	0	0	0
0038	3T	5	134	630	53	63000	41140	-21860	0.08	0.65	111	72	-39
0038	3T	5	135	382	26	38200	24090	-14110	0.07	0.63	67	42	-25
0038	3T	5	136	333	25	33300	29660	-3640	0.08	0.89	58	52	-6
0038	3T	5	142	1	0	100	0	-100	0.00	0.00	0	0	0
0038	3T	5	143	9	1	900	4470	3570	0.11	4.97	1	7	6
0038	3T	5	145	213	15	21300	16260	-5040	0.07	0.76	37	28	-9
0038	3T	5	146	149	8	14900	9100	-5800	0.05	0.61	26	16	-10
0038	3T	5	153	4	0	400	0	-400	0.00	0.00	0	0	0
0038	3T	5	154	6	1	600	890	290	0.17	1.48	1	1	0
0038	3T	5	156	34	3	3400	3960	560	0.09	1.16	6	7	1
0038	3T	5	163	1	0	100	0	-100	0.00	0.00	0	0	0
0038	3T	5	164	3	1	300	1980	1680	0.33	6.60	0	3	3
0038	3T	5	213	1	0	100	0	-100	0.00	0.00	0	0	0
0038	3T	5	214	3	0	300	0	-300	0.00	0.00	0	0	0
0038	3T	5	215	2	0	200	0	-200	0.00	0.00	0	0	0
0038	3T	5	216	11	0	1100	0	-1100	0.00	0.00	1	0	-1
0038	3T	5	234	8	0	800	0	-800	0.00	0.00	1	0	-1
0038	3T	5	235	11	0	1100	0	-1100	0.00	0.00	1	0	-1
0038	3T	5	236	2	0	200	0	-200	0.00	0.00	0	0	0
0038	3T	5	245	9	0	900	0	-900	0.00	0.00	1	0	-1
0038	3T	5	246	11	0	1100	0	-1100	0.00	0.00	1	0	-1
0038	3T	5	256	2	0	200	0	-200	0.00	0.00	0	0	0
0038	3T	6	123	63	8	6300	4920	-1380	0.13	0.78	11	8	-3
0038	3T	6	124	150	14	15000	10120	-4880	0.09	0.67	26	17	-9
0038	3T	6	125	44	5	4400	5740	1340	0.11	1.30	7	10	3
0038	3T	6	126	59	2	5900	1580	-4320	0.03	0.27	10	2	-8
0038	3T	6	134	40	2	4000	1390	-2610	0.05	0.35	7	2	-5
0038	3T	6	135	34	3	3400	2130	-1270	0.09	0.63	6	3	-3
0038	3T	6	136	36	3	3600	5580	1980	0.08	1.55	6	9	3
0038	3T	6	142	1	0	100	0	-100	0.00	0.00	0	0	0
0038	3T	6	143	1	0	100	0	-100	0.00	0.00	0	0	0
0038	3T	6	145	15	1	1500	820	-680	0.07	0.55	2	1	-1
0038	3T	6	146	14	0	1400	0	-1400	0.00	0.00	2	0	-2
0038	3T	6	154	1	1	100	710	610	1.00	7.10	0	1	1
0038	3T	6	156	2	0	200	0	-200	0.00	0.00	0	0	0
0038	3T	6	165	1	0	100	0	-100	0.00	0.00	0	0	0
0038	3T	6	215	1	0	100	0	-100	0.00	0.00	0	0	0
0038	3T	6	216	1	0	100	0	-100	0.00	0.00	0	0	0
0038	3T	6	235	1	0	100	0	-100	0.00	0.00	0	0	0
0038	3T	6	246	1	0	100	0	-100	0.00	0.00	0	0	0
0038	3T	7	123	1666	210	166600	137560	-29040	0.13	0.83	294	243	-51
0038	3T	7	124	3083	275	308300	223420	-84880	0.09	0.72	545	395	-150
0038	3T	7	125	1157	94	115700	91420	-24280	0.08	0.79	204	161	-43
0038	3T	7	126	991	55	99100	77770	-21330	0.06	0.78	175	137	-38
0038	3T	7	132	5	0	500	0	-500	0.00	0.00	0	0	0
0038	3T	7	134	941	82	94100	68060	-26040	0.09	0.72	166	120	-46
0038	3T	7	135	636	41	63600	39450	-24150	0.06	0.62	112	69	-43
0038	3T	7	136	465	21	46500	30910	-15590	0.05	0.66	82	54	-28
0038	3T	7	142	2	0	200	0	-200	0.00	0.00	0	0	0
0038	3T	7	143	14	1	1400	1370	-30	0.07	0.98	2	2	0
0038	3T	7	145	167	7	16700	7520	-9180	0.04	0.45	29	13	-16
0038	3T	7	146	178	15	17800	22070	4270	0.08	1.24	31	39	8
0038	3T	7	152	2	0	200	0	-200	0.00	0.00	0	0	0
0038	3T	7	153	5	1	500	770	270	0.20	1.54	0	1	1
0038	3T	7	154	9	0	900	0	-900	0.00	0.00	1	0	-1
0038	3T	7	156	48	2	4800	3580	-1220	0.04	0.75	8	6	-2
0038	3T	7	163	2	0	200	0	-200	0.00	0.00	0	0	0
0038	3T	7	165	4	0	400	0	-400	0.00	0.00	0	0	0
0038	3T	7	216	7	0	700	0	-700	0.00	0.00	1	0	-1
0038	3T	7	234	14	0	1400	0	-1400	0.00	0.00	2	0	-2
0038	3T	7	235	12	1	1200	2130	930	0.08	1.78	2	3	1
0038	3T	7	236	9	0	900	0	-900	0.00	0.00	1	0	-1
0038	3T	7	243	1	0	100	0	-100	0.00	0.00	0	0	0
0038	3T	7	245	4	0	400	0	-400	0.00	0.00	0	0	0
0038	3T	7	246	5	0	500	0	-500	0.00	0.00	0	0	0
0038	3T	7	256	5	0	500	0	-500	0.00	0.00	0	0	0
0038	3T	7	263	1	0	100	0	-100	0.00	0.00	0	0	0
0026	1T	1	1	11292	6419	1129200	1037560	-91640	0.57	0.92	1998	1836	-162
0026	1T	1	2	1684	652	168400	150280	-18120	0.39	0.89	298	265	-33
0026	1T	2	1	10855	5994	1085500	987520	-97980	0.55	0.91	1921	1747	-174
0026	1T	2	2	1780	692	178000	166830	-11170	0.39	0.94	315	295	-20
0026	1T	3	1	10965	6297	1096500	1034220	-62280	0.57	0.94	1940	1830	-110
0026	1T	3	2	1825	658	182500	170940	-11560	0.36	0.94	323	302	-21
0026	1T	4	1	8893	5372	889300	817120	-72180	0.60	0.92	1573	1446	-127
0026	1T	4	2	1452	539	145200	128870	-16330	0.37	0.89	256	228	-28
0026	1T	5	1	7799	4929	779900	718140	-61760	0.63	0.92	1380	1271	-109
0026	1T	5	2	476	141	47600	36190	-11410	0.30	0.76	84	64	-20
0026	1T	6	1	623	372	62300	52930	-9370	0.60	0.85	110	93	-17
0026	1T	6	2	35	12	3500	2880	-620	0.34	0.82	6	5	-1
0026	1T	7	1	12660	7864	1266000	1162790	-103210	0.62	0.92	2240	2058	-182
0026	1T	7	2	840	274	84000	74290	-9710	0.33	0.88	148	131	-17
0026	2F	1	12	5630	1716	563000	468530	-94470	0.30	0.83	996	829	-167
0026	2F	1	13	3247	1006	324700	268630	-56070	0.31	0.83	574	475	-99
0026	2F	1	14	1465	392	146500	120290	-26210	0.27	0.82	259	212	-47
0026	2F	1	15	235	51	23500	17080	-6420	0.22	0.73	41	30	-11
0026	2F	1	16	224	51	22400	19020	-3380	0.23	0.85	39	33	-6
0026	2F	1	23	167	43	16700	15850	-850	0.26	0.95	29	28	-1
0026	2F	1	24	110	15	11000	7310	-3690	0.14	0.66	19	12	-7
0026	2F	1	25	7	0	700	0	-700	0.00	0.00	1	0	-1
0026	2F	1	26	42	9	4200	4150	-50	0.21	0.99	7	7	0
0026	2F	2	12	4902	1599	490200	409270	-80930	0.33	0.83	867	724	-143
0026	2F	2	13	3180	952	318000	251650	-66350	0.30	0.79	562	445	-117
0026	2F	2	14	1629	484	162900	130240	-32660	0.30	0.80	288	230	-58
0026	2F	2	15	418	103	41800	36000	-5800	0.25	0.86	73	63	-10
0026	2F	2	16	339	66	33900	30940	-2960	0.19	0.91	60	54	-6
0026	2F	2	23	153	39	15300	14250	-1050	0.25	0.93	27	25	-2
0026	2F	2	24	100	18	10000	7110	-2890	0.18	0.71	17	12	-5
0026	2F	2	25	55	9	5500	3280	-2220	0.16	0.60	9	5	-4
0026	2F	2	26	90	18	9000	7300	-1700	0.20	0.81	15	12	-3
0026	2F	3	12	5069	1755	506900	441730	-65170	0.35	0.87	897	781	-116
0026	2F	3	13	2945	908	294500	232040	-62460	0.31	0.79	521	410	-111
0026	2F	3	14	1821	461	182100	134500	-47600	0.25	0.74	322	238	-84
0026	2F	3	15	480	99	48000	35020	-12980	0.21	0.73	84	61	-23
0026	2F	3	16	360	72	36000	36560	560	0.20	1.02	63	64	1
0026	2F	3	23	174	29	17400	12340	-5060	0.17	0.71	30	21	-9
0026	2F	3	24	124	28	12400	14690	2290	0.23	1.18	21	26	5
0026	2F	3	25	77	13	7700	5510	-2190	0.17	0.72	13	9	-4
0026	2F	3	26	94	23	9400	9080	-320	0.24	0.97	16	16	0
0026	2F	4	12	4455	1536	445500	374520	-70980	0.34	0.84	788	662	-126
0026	2F	4	13	2419	798	241900	204890	-37010	0.33	0.85	428	362	-66
0026	2F	4	14	1288	377	128800	102470	-26330	0.29	0.80	227	181	-46
0026	2F	4	15	359	97	35900	34440	-1460	0.27	0.96	63	60	-3
0026	2F	4	16	165	33	16500	15180	-1320	0.20	0.92	29	26	-3
0026	2F	4	23	163	41	16300	13540	-2760	0.25	0.83	28	23	-5
0026	2F	4	24	109	26	10900	8090	-2810	0.24	0.74	19	14	-5
0026	2F	4	25	76	8	7600	4080	-3520	0.11	0.54	13	7	-6
0026	2F	4	26	47	7	4700	1930	-2770	0.15	0.41	8	3	-5
0026	2F	5	12	4158	1510	415800	346100	-69700	0.36	0.83	735	612	-123
0026	2F	5	13	1830	557	183000	144040	-38960	0.30	0.79	323	254	-69
0026	2F	5	14	1130	330	113000	96110	-16890	0.29	0.85	200	170	-30
0026	2F	5	15	251	57	25100	21680	-3420	0.23	0.86	44	38	-6
0026	2F	5	16	173	42	17300	17790	490	0.24	1.03	30	31	1
0026	2F	5	23	46	5	4600	1870	-2730	0.11	0.41	8	3	-5
0026	2F	5	24	28	3	2800	990	-1810	0.11	0.35	4	1	-3
0026	2F	5	25	21	1	2100	370	-1730	0.05	0.18	3	0	-3
0026	2F	5	26	26	0	2600	0	-2600	0.00	0.00	4	0	-4
0026	2F	6	12	323	117	32300	28210	-4090	0.36	0.87	57	49	-8
0026	2F	6	13	145	49	14500	12420	-2080	0.34	0.86	25	21	-4
0026	2F	6	14	88	19	8800	4580	-4220	0.22	0.52	15	8	-7
0026	2F	6	15	27	5	2700	2270	-430	0.19	0.84	4	4	0
0026	2F	6	16	23	7	2300	3320	1020	0.30	1.44	4	5	1
0026	2F	6	23	5	1	500	850	350	0.20	1.70	0	1	1
0026	2F	6	24	2	0	200	0	-200	0.00	0.00	0	0	0
0026	2F	6	25	1	0	100	0	-100	0.00	0.00	0	0	0
0026	2F	6	26	1	0	100	0	-100	0.00	0.00	0	0	0
0026	2F	7	12	7207	2438	720700	597740	-122960	0.34	0.83	1275	1057	-218
0026	2F	7	13	2839	831	283900	216480	-67420	0.29	0.76	502	383	-119
0026	2F	7	14	1544	426	154400	116860	-37540	0.28	0.76	273	206	-67
0026	2F	7	15	412	78	41200	31980	-9220	0.19	0.78	72	56	-16
0026	2F	7	16	338	63	33800	29440	-4360	0.19	0.87	59	52	-7
0026	2F	7	23	69	16	6900	5120	-1780	0.23	0.74	12	9	-3
0026	2F	7	24	34	9	3400	3380	-20	0.26	0.99	6	5	-1
0026	2F	7	25	34	2	3400	720	-2680	0.06	0.21	6	1	-5
0026	2F	7	26	34	5	3400	2780	-620	0.15	0.82	6	4	-2
0026	2T	1	12	5582	1272	558200	444440	-113760	0.23	0.80	987	786	-201
0026	2T	1	13	3247	693	324700	245380	-79320	0.21	0.76	574	434	-140
0026	2T	1	14	1465	286	146500	119400	-27100	0.20	0.82	259	211	-48
0026	2T	1	15	235	38	23500	18530	-4970	0.16	0.79	41	32	-9
0026	2T	1	16	224	34	22400	20020	-2380	0.15	0.89	39	35	-4
0026	2T	1	21	48	4	4800	3040	-1760	0.08	0.63	8	5	-3
0026	2T	1	23	167	23	16700	13180	-3520	0.14	0.79	29	23	-6
0026	2T	1	24	110	8	11000	6120	-4880	0.07	0.56	19	10	-9
0026	2T	1	25	7	0	700	0	-700	0.00	0.00	1	0	-1
0026	2T	1	26	42	3	4200	1680	-2520	0.07	0.40	7	2	-5
0026	2T	2	12	4853	1128	485300	383000	-102300	0.23	0.79	858	677	-181
0026	2T	2	13	3180	687	318000	248820	-69180	0.22	0.78	562	440	-122
0026	2T	2	14	1629	348	162900	130700	-32200	0.21	0.80	288	231	-57
0026	2T	2	15	418	67	41800	32690	-9110	0.16	0.78	73	57	-16
0026	2T	2	16	339	51	33900	32880	-1020	0.15	0.97	60	58	-2
0026	2T	2	21	49	6	4900	5070	170	0.12	1.03	8	8	0
0026	2T	2	23	153	18	15300	10670	-4630	0.12	0.70	27	18	-9
0026	2T	2	24	100	14	10000	11580	1580	0.14	1.16	17	20	3
0026	2T	2	25	55	6	5500	4310	-1190	0.11	0.78	9	7	-2
0026	2T	2	26	90	12	9000	7900	-1100	0.13	0.88	15	13	-2
0026	2T	3	12	5041	1322	504100	442470	-61630	0.26	0.88	892	783	-109
0026	2T	3	13	2945	650	294500	225320	-69180	0.22	0.77	521	398	-123
0026	2T	3	14	1821	327	182100	138440	-43660	0.18	0.76	322	245	-77
0026	2T	3	15	480	68	48000	34020	-13980	0.14	0.71	84	60	-24
0026	2T	3	16	360	47	36000	42770	6770	0.13	1.19	63	75	12
0026	2T	3	21	28	6	2800	4870	2070	0.21	1.74	4	8	4
0026	2T	3	23	174	16	17400	10700	-6700	0.09	0.61	30	18	-12
0026	2T	3	24	124	15	12400	12840	440	0.12	1.04	21	22	1
0026	2T	3	25	77	8	7700	5870	-1830	0.10	0.76	13	10	-3
0026	2T	3	26	94	11	9400	8670	-730	0.12	0.92	16	15	-1
0026	2T	4	12	4430	1157	443000	357940	-85060	0.26	0.81	784	633	-151
0026	2T	4	13	2419	610	241900	199970	-41930	0.25	0.83	428	353	-75
0026	2T	4	14	1288	289	128800	107050	-21750	0.22	0.83	227	189	-38
0026	2T	4	15	359	70	35900	36290	390	0.19	1.01	63	64	1
0026	2T	4	16	165	22	16500	15410	-1090	0.13	0.93	29	27	-2
0026	2T	4	21	25	1	2500	490	-2010	0.04	0.20	4	0	-4
0026	2T	4	23	163	21	16300	10390	-5910	0.13	0.64	28	18	-10
0026	2T	4	24	109	15	10900	7530	-3370	0.14	0.69	19	13	-6
0026	2T	4	25	76	4	7600	2940	-4660	0.05	0.39	13	5	-8
0026	2T	4	26	47	5	4700	2400	-2300	0.11	0.51	8	4	-4
0026	2T	5	12	4150	1180	415000	336100	-78900	0.28	0.81	734	594	-140
0026	2T	5	13	1830	414	183000	141600	-41400	0.23	0.77	323	250	-73
0026	2T	5	14	1130	249	113000	100360	-12640	0.22	0.89	200	177	-23
0026	2T	5	15	251	42	25100	22360	-2740	0.17	0.89	44	39	-5
0026	2T	5	16	173	30	17300	20640	3340	0.17	1.19	30	36	6
0026	2T	5	21	8	0	800	0	-800	0.00	0.00	1	0	-1
0026	2T	5	23	46	2	4600	860	-3740	0.04	0.19	8	1	-7
0026	2T	5	24	28	1	2800	960	-1840	0.04	0.34	4	1	-3
0026	2T	5	25	21	1	2100	700	-1400	0.05	0.33	3	1	-2
0026	2T	5	26	26	0	2600	0	-2600	0.00	0.00	4	0	-4
0026	2T	6	12	321	87	32100	25190	-6910	0.27	0.78	56	44	-12
0026	2T	6	13	145	38	14500	12180	-2320	0.26	0.84	25	21	-4
0026	2T	6	14	88	13	8800	4340	-4460	0.15	0.49	15	7	-8
0026	2T	6	15	27	1	2700	1220	-1480	0.04	0.45	4	2	-2
0026	2T	6	16	23	7	2300	4850	2550	0.30	2.11	4	8	4
0026	2T	6	21	2	1	200	2000	1800	0.50	10.00	0	3	3
0026	2T	6	23	5	1	500	1820	1320	0.20	3.64	0	3	3
0026	2T	6	24	2	0	200	0	-200	0.00	0.00	0	0	0
0026	2T	6	25	1	0	100	0	-100	0.00	0.00	0	0	0
0026	2T	6	26	1	0	100	0	-100	0.00	0.00	0	0	0
0026	2T	7	12	7198	1918	719800	583300	-136500	0.27	0.81	1273	1032	-241
0026	2T	7	13	2839	639	283900	210760	-73140	0.23	0.74	502	373	-129
0026	2T	7	14	1544	324	154400	119550	-34850	0.21	0.77	273	211	-62
0026	2T	7	15	412	62	41200	33890	-7310	0.15	0.82	72	59	-13
0026	2T	7	16	338	49	33800	29580	-4220	0.14	0.88	59	52	-7
0026	2T	7	21	9	0	900	0	-900	0.00	0.00	1	0	-1
0026	2T	7	23	69	9	6900	5110	-1790	0.13	0.74	12	9	-3
0026	2T	7	24	34	4	3400	2660	-740	0.12	0.78	6	4	-2
0026	2T	7	25	34	2	3400	1290	-2110	0.06	0.38	6	2	-4
0026	2T	7	26	34	3	3400	2420	-980	0.09	0.71	6	4	-2
0026	3F	1	123	358	95	35800	27450	-8350	0.27	0.77	63	48	-15
0026	3F	1	124	1553	356	155300	120370	-34930	0.23	0.78	274	213	-61
0026	3F	1	125	1088	205	108800	105130	-3670	0.19	0.97	192	186	-6
0026	3F	1	126	2486	221	248600	224230	-24370	0.09	0.90	440	396	-44
0026	3F	1	134	1072	235	107200	80360	-26840	0.22	0.75	189	142	-47
0026	3F	1	135	633	119	63300	47490	-15810	0.19	0.75	112	84	-28
0026	3F	1	136	1195	123	119500	92150	-27350	0.10	0.77	211	163	-48
0026	3F	1	145	325	48	32500	17290	-15210	0.15	0.53	57	30	-27
0026	3F	1	146	405	41	40500	33750	-6750	0.10	0.83	71	59	-12
0026	3F	1	156	46	4	4600	1890	-2710	0.09	0.41	8	3	-5
0026	3F	1	234	42	5	4200	2170	-2030	0.12	0.52	7	3	-4
0026	3F	1	235	44	9	4400	3710	-690	0.20	0.84	7	6	-1
0026	3F	1	236	66	7	6600	4610	-1990	0.11	0.70	11	8	-3
0026	3F	1	245	33	3	3300	1280	-2020	0.09	0.39	5	2	-3
0026	3F	1	246	28	1	2800	570	-2230	0.04	0.20	4	1	-3
0026	3F	1	256	2	0	200	0	-200	0.00	0.00	0	0	0
0026	3F	2	123	541	156	54100	44520	-9580	0.29	0.82	95	78	-17
0026	3F	2	124	1519	392	151900	127320	-24580	0.26	0.84	268	225	-43
0026	3F	2	125	1111	224	111100	93090	-18010	0.20	0.84	196	164	-32
0026	3F	2	126	1519	210	151900	107560	-44340	0.14	0.71	268	190	-78
0026	3F	2	134	958	186	95800	69880	-25920	0.19	0.73	169	123	-46
0026	3F	2	135	768	138	76800	52930	-23870	0.18	0.69	135	93	-42
0026	3F	2	136	976	156	97600	80000	-17600	0.16	0.82	172	141	-31
0026	3F	2	145	290	55	29000	22890	-6110	0.19	0.79	51	40	-11
0026	3F	2	146	306	44	30600	28200	-2400	0.14	0.92	54	49	-5
0026	3F	2	156	71	21	7100	10200	3100	0.30	1.44	12	18	6
0026	3F	2	234	30	7	3000	2860	-140	0.23	0.95	5	5	0
0026	3F	2	235	48	8	4800	3920	-880	0.17	0.82	8	6	-2
0026	3F	2	236	47	9	4700	5980	1280	0.19	1.27	8	10	2
0026	3F	2	245	26	3	2600	1350	-1250	0.12	0.52	4	2	-2
0026	3F	2	246	18	3	1800	1200	-600	0.17	0.67	3	2	-1
0026	3F	2	256	11	0	1100	0	-1100	0.00	0.00	1	0	-1
0026	3F	3	123	824	265	82400	76960	-5440	0.32	0.93	145	136	-9
0026	3F	3	124	1483	345	148300	112160	-36140	0.23	0.76	262	198	-64
0026	3F	3	125	1224	203	122400	78490	-43910	0.17	0.64	216	138	-78
0026	3F	3	126	1385	204	138500	128350	-10150	0.15	0.93	245	227	-18
0026	3F	3	134	776	175	77600	62270	-15330	0.23	0.80	137	110	-27
0026	3F	3	135	800	146	80000	62310	-17690	0.18	0.78	141	110	-31
0026	3F	3	136	797	103	79700	55020	-24680	0.13	0.69	141	97	-44
0026	3F	3	145	479	80	47900	35490	-12410	0.17	0.74	84	62	-22
0026	3F	3	146	273	28	27300	19420	-7880	0.10	0.71	48	34	-14
0026	3F	3	156	90	13	9000	6740	-2260	0.14	0.75	15	11	-4
0026	3F	3	234	40	9	4000	2980	-1020	0.23	0.75	7	5	-2
0026	3F	3	235	39	5	3900	1370	-2530	0.13	0.35	6	2	-4
0026	3F	3	236	55	6	5500	4000	-1500	0.11	0.73	9	7	-2
0026	3F	3	245	33	4	3300	3890	590	0.12	1.18	5	6	1
0026	3F	3	246	16	2	1600	7190	5590	0.13	4.49	2	12	10
0026	3F	3	256	15	3	1500	1250	-250	0.20	0.83	2	2	0
0026	3F	4	123	880	286	88000	79350	-8650	0.33	0.90	155	140	-15
0026	3F	4	124	1740	361	174000	117130	-56870	0.21	0.67	307	207	-100
0026	3F	4	125	916	175	91600	82310	-9290	0.19	0.90	162	145	-17
0026	3F	4	126	786	104	78600	65510	-13090	0.13	0.83	139	115	-24
0026	3F	4	134	758	172	75800	53900	-21900	0.23	0.71	134	95	-39
0026	3F	4	135	575	95	57500	35360	-22140	0.17	0.61	101	62	-39
0026	3F	4	136	502	77	50200	52830	2630	0.15	1.05	88	93	5
0026	3F	4	145	242	33	24200	14330	-9870	0.14	0.59	42	25	-17
0026	3F	4	146	164	24	16400	13190	-3210	0.15	0.80	29	23	-6
0026	3F	4	156	59	13	5900	7790	1890	0.22	1.32	10	13	3
0026	3F	4	234	28	6	2800	1540	-1260	0.21	0.55	4	2	-2
0026	3F	4	235	60	7	6000	2730	-3270	0.12	0.46	10	4	-6
0026	3F	4	236	46	7	4600	5400	800	0.15	1.17	8	9	1
0026	3F	4	245	36	4	3600	1180	-2420	0.11	0.33	6	2	-4
0026	3F	4	246	16	2	1600	730	-870	0.13	0.46	2	1	-1
0026	3F	4	256	10	2	1000	1000	0	0.20	1.00	1	1	0
0026	3F	5	123	851	256	85100	65600	-19500	0.30	0.77	150	116	-34
0026	3F	5	124	1958	408	195800	135590	-60210	0.21	0.69	346	239	-107
0026	3F	5	125	711	130	71100	51960	-19140	0.18	0.73	125	91	-34
0026	3F	5	126	544	93	54400	53390	-1010	0.17	0.98	96	94	-2
0026	3F	5	134	645	151	64500	52700	-11800	0.23	0.82	114	93	-21
0026	3F	5	135	367	52	36700	21090	-15610	0.14	0.57	64	37	-27
0026	3F	5	136	273	36	27300	18550	-8750	0.13	0.68	48	32	-16
0026	3F	5	145	216	46	21600	15940	-5660	0.21	0.74	38	28	-10
0026	3F	5	146	106	24	10600	11740	1140	0.23	1.11	18	20	2
0026	3F	5	156	21	7	2100	4230	2130	0.33	2.01	3	7	4
0026	3F	5	234	11	1	1100	420	-680	0.09	0.38	1	0	-1
0026	3F	5	235	12	0	1200	0	-1200	0.00	0.00	2	0	-2
0026	3F	5	236	7	1	700	1040	340	0.14	1.49	1	1	0
0026	3F	5	245	5	2	500	720	220	0.40	1.44	0	1	1
0026	3F	5	246	6	0	600	0	-600	0.00	0.00	1	0	-1
0026	3F	5	256	1	0	100	0	-100	0.00	0.00	0	0	0
0026	3F	6	123	57	12	5700	3510	-2190	0.21	0.62	10	6	-4
0026	3F	6	124	153	32	15300	11310	-3990	0.21	0.74	27	20	-7
0026	3F	6	125	55	17	5500	8860	3360	0.31	1.61	9	15	6
0026	3F	6	126	51	13	5100	9190	4090	0.25	1.80	9	16	7
0026	3F	6	134	46	7	4600	1890	-2710	0.15	0.41	8	3	-5
0026	3F	6	135	30	6	3000	1270	-1730	0.20	0.42	5	2	-3
0026	3F	6	136	32	2	3200	1150	-2050	0.06	0.36	5	2	-3
0026	3F	6	145	17	4	1700	1580	-120	0.24	0.93	3	2	-1
0026	3F	6	146	10	1	1000	280	-720	0.10	0.28	1	0	-1
0026	3F	6	235	2	1	200	840	640	0.50	4.20	0	1	1
0026	3F	6	236	1	0	100	0	-100	0.00	0.00	0	0	0
0026	3F	6	245	1	0	100	0	-100	0.00	0.00	0	0	0
0026	3F	6	246	1	0	100	0	-100	0.00	0.00	0	0	0
0026	3F	7	123	1612	461	161200	138630	-22570	0.29	0.86	285	245	-40
0026	3F	7	124	3060	615	306000	220200	-85800	0.20	0.72	541	389	-152
0026	3F	7	125	1215	226	121500	108780	-12720	0.19	0.90	215	192	-23
0026	3F	7	126	981	134	98100	78240	-19860	0.14	0.80	173	138	-35
0026	3F	7	134	844	179	84400	66230	-18170	0.21	0.78	149	117	-32
0026	3F	7	135	642	108	64200	46960	-17240	0.17	0.73	113	83	-30
0026	3F	7	136	413	56	41300	31060	-10240	0.14	0.75	73	54	-19
0026	3F	7	145	252	35	25200	18390	-6810	0.14	0.73	44	32	-12
0026	3F	7	146	174	23	17400	12640	-4760	0.13	0.73	30	22	-8
0026	3F	7	156	54	3	5400	1160	-4240	0.06	0.21	9	2	-7
0026	3F	7	234	18	1	1800	280	-1520	0.06	0.16	3	0	-3
0026	3F	7	235	13	1	1300	450	-850	0.08	0.35	2	0	-2
0026	3F	7	236	6	1	600	410	-190	0.17	0.68	1	0	-1
0026	3F	7	245	8	0	800	0	-800	0.00	0.00	1	0	-1
0026	3F	7	246	5	0	500	0	-500	0.00	0.00	0	0	0
0026	3F	7	256	5	0	500	0	-500	0.00	0.00	0	0	0
0026	3T	1	123	324	37	32400	26190	-6210	0.11	0.81	57	46	-11
0026	3T	1	124	1540	140	154000	104900	-49100	0.09	0.68	272	185	-87
0026	3T	1	125	1072	77	107200	92570	-14630	0.07	0.86	189	163	-26
0026	3T	1	126	2461	104	246100	245740	-360	0.04	1.00	435	434	-1
0026	3T	1	132	31	2	3100	1150	-1950	0.06	0.37	5	2	-3
0026	3T	1	134	1068	94	106800	75800	-31000	0.09	0.71	189	134	-55
0026	3T	1	135	622	49	62200	53170	-9030	0.08	0.85	110	94	-16
0026	3T	1	136	1191	46	119100	75380	-43720	0.04	0.63	210	133	-77
0026	3T	1	143	4	0	400	0	-400	0.00	0.00	0	0	0
0026	3T	1	145	309	15	30900	16510	-14390	0.05	0.53	54	29	-25
0026	3T	1	146	385	14	38500	28000	-10500	0.04	0.73	68	49	-19
0026	3T	1	152	9	0	900	0	-900	0.00	0.00	1	0	-1
0026	3T	1	153	11	0	1100	0	-1100	0.00	0.00	1	0	-1
0026	3T	1	154	16	0	1600	0	-1600	0.00	0.00	2	0	-2
0026	3T	1	156	42	0	4200	0	-4200	0.00	0.00	7	0	-7
0026	3T	1	163	4	1	400	840	440	0.25	2.10	0	1	1
0026	3T	1	164	20	0	2000	0	-2000	0.00	0.00	3	0	-3
0026	3T	1	165	4	1	400	1080	680	0.25	2.70	0	1	1
0026	3T	1	213	3	0	300	0	-300	0.00	0.00	0	0	0
0026	3T	1	214	13	0	1300	0	-1300	0.00	0.00	2	0	-2
0026	3T	1	215	7	0	700	0	-700	0.00	0.00	1	0	-1
0026	3T	1	216	25	0	2500	0	-2500	0.00	0.00	4	0	-4
0026	3T	1	234	41	2	4100	2540	-1560	0.05	0.62	7	4	-3
0026	3T	1	235	44	2	4400	3420	-980	0.05	0.78	7	6	-1
0026	3T	1	236	66	4	6600	6240	-360	0.06	0.95	11	11	0
0026	3T	1	243	1	0	100	0	-100	0.00	0.00	0	0	0
0026	3T	1	245	33	1	3300	1980	-1320	0.03	0.60	5	3	-2
0026	3T	1	246	28	0	2800	0	-2800	0.00	0.00	4	0	-4
0026	3T	1	256	2	0	200	0	-200	0.00	0.00	0	0	0
0026	3T	2	123	531	59	53100	38480	-14620	0.11	0.72	93	68	-25
0026	3T	2	124	1510	162	151000	142600	-8400	0.11	0.94	267	252	-15
0026	3T	2	125	1091	95	109100	98310	-10790	0.09	0.90	193	174	-19
0026	3T	2	126	1498	81	149800	113780	-36020	0.05	0.76	265	201	-64
0026	3T	2	132	6	1	600	660	60	0.17	1.10	1	1	0
0026	3T	2	134	940	83	94000	78350	-15650	0.09	0.83	166	138	-28
0026	3T	2	135	760	59	76000	57100	-18900	0.08	0.75	134	101	-33
0026	3T	2	136	975	67	97500	86050	-11450	0.07	0.88	172	152	-20
0026	3T	2	142	5	0	500	0	-500	0.00	0.00	0	0	0
0026	3T	2	143	18	0	1800	0	-1800	0.00	0.00	3	0	-3
0026	3T	2	145	275	17	27500	19250	-8250	0.06	0.70	48	34	-14
0026	3T	2	146	302	20	30200	28680	-1520	0.07	0.95	53	50	-3
0026	3T	2	152	2	0	200	0	-200	0.00	0.00	0	0	0
0026	3T	2	153	8	0	800	0	-800	0.00	0.00	1	0	-1
0026	3T	2	154	15	1	1500	670	-830	0.07	0.45	2	1	-1
0026	3T	2	156	71	7	7100	12260	5160	0.10	1.73	12	21	9
0026	3T	2	163	1	0	100	0	-100	0.00	0.00	0	0	0
0026	3T	2	164	4	0	400	0	-400	0.00	0.00	0	0	0
0026	3T	2	213	4	0	400	0	-400	0.00	0.00	0	0	0
0026	3T	2	214	4	0	400	0	-400	0.00	0.00	0	0	0
0026	3T	2	215	18	0	1800	0	-1800	0.00	0.00	3	0	-3
0026	3T	2	216	21	2	2100	5630	3530	0.10	2.68	3	9	6
0026	3T	2	234	30	1	3000	830	-2170	0.03	0.28	5	1	-4
0026	3T	2	235	48	2	4800	6390	1590	0.04	1.33	8	11	3
0026	3T	2	236	47	3	4700	9430	4730	0.06	2.01	8	16	8
0026	3T	2	245	26	1	2600	1350	-1250	0.04	0.52	4	2	-2
0026	3T	2	246	18	0	1800	0	-1800	0.00	0.00	3	0	-3
0026	3T	2	256	11	0	1100	0	-1100	0.00	0.00	1	0	-1
0026	3T	3	123	817	123	81700	84890	3190	0.15	1.04	144	150	6
0026	3T	3	124	1476	145	147600	103530	-44070	0.10	0.70	261	183	-78
0026	3T	3	125	1212	88	121200	86370	-34830	0.07	0.71	214	152	-62
0026	3T	3	126	1374	102	137400	131300	-6100	0.07	0.96	243	232	-11
0026	3T	3	132	5	0	500	0	-500	0.00	0.00	0	0	0
0026	3T	3	134	752	77	75200	67610	-7590	0.10	0.90	133	119	-14
0026	3T	3	135	795	58	79500	62180	-17320	0.07	0.78	140	110	-30
0026	3T	3	136	796	41	79600	50030	-29570	0.05	0.63	140	88	-52
0026	3T	3	142	3	0	300	0	-300	0.00	0.00	0	0	0
0026	3T	3	143	24	1	2400	570	-1830	0.04	0.24	4	1	-3
0026	3T	3	145	474	26	47400	29440	-17960	0.05	0.62	83	52	-31
0026	3T	3	146	271	10	27100	19480	-7620	0.04	0.72	47	34	-13
0026	3T	3	152	1	0	100	0	-100	0.00	0.00	0	0	0
0026	3T	3	153	5	1	500	1390	890	0.20	2.78	0	2	2
0026	3T	3	154	5	1	500	2060	1560	0.20	4.12	0	3	3
0026	3T	3	156	89	3	8900	4660	-4240	0.03	0.52	15	8	-7
0026	3T	3	163	1	0	100	0	-100	0.00	0.00	0	0	0
0026	3T	3	164	2	0	200	0	-200	0.00	0.00	0	0	0
0026	3T	3	165	1	0	100	0	-100	0.00	0.00	0	0	0
0026	3T	3	213	2	0	200	0	-200	0.00	0.00	0	0	0
0026	3T	3	214	4	0	400	0	-400	0.00	0.00	0	0	0
0026	3T	3	215	11	1	1100	2250	1150	0.09	2.05	1	3	2
0026	3T	3	216	11	0	1100	0	-1100	0.00	0.00	1	0	-1
0026	3T	3	234	40	4	4000	4910	910	0.10	1.23	7	8	1
0026	3T	3	235	38	0	3800	0	-3800	0.00	0.00	6	0	-6
0026	3T	3	236	55	2	5500	2260	-3240	0.04	0.41	9	4	-5
0026	3T	3	245	33	1	3300	1580	-1720	0.03	0.48	5	2	-3
0026	3T	3	246	16	1	1600	30170	28570	0.06	18.86	2	53	51
0026	3T	3	253	1	0	100	0	-100	0.00	0.00	0	0	0
0026	3T	3	256	15	0	1500	0	-1500	0.00	0.00	2	0	-2
0026	3T	4	123	874	128	87400	81360	-6040	0.15	0.93	154	144	-10
0026	3T	4	124	1726	162	172600	126500	-46100	0.09	0.73	305	223	-82
0026	3T	4	125	909	63	90900	64170	-26730	0.07	0.71	160	113	-47
0026	3T	4	126	782	49	78200	75220	-2980	0.06	0.96	138	133	-5
0026	3T	4	132	4	0	400	0	-400	0.00	0.00	0	0	0
0026	3T	4	134	727	84	72700	63070	-9630	0.12	0.87	128	111	-17
0026	3T	4	135	570	51	57000	45800	-11200	0.09	0.80	100	81	-19
0026	3T	4	136	502	41	50200	47850	-2350	0.08	0.95	88	84	-4
0026	3T	4	142	2	0	200	0	-200	0.00	0.00	0	0	0
0026	3T	4	143	31	1	3100	860	-2240	0.03	0.28	5	1	-4
0026	3T	4	145	239	14	23900	17870	-6030	0.06	0.75	42	31	-11
0026	3T	4	146	160	14	16000	17750	1750	0.09	1.11	28	31	3
0026	3T	4	153	5	0	500	0	-500	0.00	0.00	0	0	0
0026	3T	4	154	3	0	300	0	-300	0.00	0.00	0	0	0
0026	3T	4	156	57	6	5700	9100	3400	0.11	1.60	10	16	6
0026	3T	4	164	4	0	400	0	-400	0.00	0.00	0	0	0
0026	3T	4	165	2	0	200	0	-200	0.00	0.00	0	0	0
0026	3T	4	213	2	0	200	0	-200	0.00	0.00	0	0	0
0026	3T	4	214	12	0	1200	0	-1200	0.00	0.00	2	0	-2
0026	3T	4	215	7	0	700	0	-700	0.00	0.00	1	0	-1
0026	3T	4	216	4	0	400	0	-400	0.00	0.00	0	0	0
0026	3T	4	234	28	1	2800	760	-2040	0.04	0.27	4	1	-3
0026	3T	4	235	59	3	5900	3190	-2710	0.05	0.54	10	5	-5
0026	3T	4	236	45	2	4500	2250	-2250	0.04	0.50	7	3	-4
0026	3T	4	245	36	0	3600	0	-3600	0.00	0.00	6	0	-6
0026	3T	4	246	16	1	1600	390	-1210	0.06	0.24	2	0	-2
0026	3T	4	253	1	0	100	0	-100	0.00	0.00	0	0	0
0026	3T	4	256	10	0	1000	0	-1000	0.00	0.00	1	0	-1
0026	3T	4	263	1	0	100	0	-100	0.00	0.00	0	0	0
0026	3T	5	123	849	118	84900	65090	-19810	0.14	0.77	150	115	-35
0026	3T	5	124	1956	192	195600	136290	-59310	0.10	0.70	346	241	-105
0026	3T	5	125	710	60	71000	59920	-11080	0.08	0.84	125	106	-19
0026	3T	5	126	539	38	53900	55450	1550	0.07	1.03	95	98	3
0026	3T	5	132	2	0	200	0	-200	0.00	0.00	0	0	0
0026	3T	5	134	638	54	63800	47950	-15850	0.08	0.75	112	84	-28
0026	3T	5	135	366	20	36600	22590	-14010	0.05	0.62	64	39	-25
0026	3T	5	136	272	18	27200	23630	-3570	0.07	0.87	48	41	-7
0026	3T	5	142	1	0	100	0	-100	0.00	0.00	0	0	0
0026	3T	5	143	7	0	700	0	-700	0.00	0.00	1	0	-1
0026	3T	5	145	212	14	21200	14220	-6980	0.07	0.67	37	25	-12
0026	3T	5	146	105	5	10500	12070	1570	0.05	1.15	18	21	3
0026	3T	5	153	1	0	100	0	-100	0.00	0.00	0	0	0
0026	3T	5	154	4	0	400	0	-400	0.00	0.00	0	0	0
0026	3T	5	156	21	5	2100	7160	5060	0.24	3.41	3	12	9
0026	3T	5	163	1	0	100	0	-100	0.00	0.00	0	0	0
0026	3T	5	164	1	1	100	1980	1880	1.00	19.80	0	3	3
0026	3T	5	214	1	0	100	0	-100	0.00	0.00	0	0	0
0026	3T	5	215	1	0	100	0	-100	0.00	0.00	0	0	0
0026	3T	5	216	5	0	500	0	-500	0.00	0.00	0	0	0
0026	3T	5	234	11	0	1100	0	-1100	0.00	0.00	1	0	-1
0026	3T	5	235	12	0	1200	0	-1200	0.00	0.00	2	0	-2
0026	3T	5	236	7	0	700	0	-700	0.00	0.00	1	0	-1
0026	3T	5	245	5	0	500	0	-500	0.00	0.00	0	0	0
0026	3T	5	246	6	0	600	0	-600	0.00	0.00	1	0	-1
0026	3T	5	256	1	0	100	0	-100	0.00	0.00	0	0	0
0026	3T	6	123	57	3	5700	1900	-3800	0.05	0.33	10	3	-7
0026	3T	6	124	153	15	15300	9830	-5470	0.10	0.64	27	17	-10
0026	3T	6	125	55	8	5500	10170	4670	0.15	1.85	9	18	9
0026	3T	6	126	49	4	4900	12790	7890	0.08	2.61	8	22	14
0026	3T	6	134	43	5	4300	2980	-1320	0.12	0.69	7	5	-2
0026	3T	6	135	30	2	3000	980	-2020	0.07	0.33	5	1	-4
0026	3T	6	136	32	0	3200	0	-3200	0.00	0.00	5	0	-5
0026	3T	6	143	3	0	300	0	-300	0.00	0.00	0	0	0
0026	3T	6	145	17	1	1700	820	-880	0.06	0.48	3	1	-2
0026	3T	6	146	9	1	900	640	-260	0.11	0.71	1	1	0
0026	3T	6	164	1	0	100	0	-100	0.00	0.00	0	0	0
0026	3T	6	216	2	1	200	8510	8310	0.50	42.55	0	15	15
0026	3T	6	235	2	1	200	4620	4420	0.50	23.10	0	8	8
0026	3T	6	236	1	0	100	0	-100	0.00	0.00	0	0	0
0026	3T	6	245	1	0	100	0	-100	0.00	0.00	0	0	0
0026	3T	6	246	1	0	100	0	-100	0.00	0.00	0	0	0
0026	3T	7	123	1597	220	159700	145380	-14320	0.14	0.91	282	257	-25
0026	3T	7	124	3049	270	304900	220280	-84620	0.09	0.72	539	389	-150
0026	3T	7	125	1211	104	121100	119340	-1760	0.09	0.99	214	211	-3
0026	3T	7	126	975	66	97500	90520	-6980	0.07	0.93	172	160	-12
0026	3T	7	132	15	3	1500	2390	890	0.20	1.59	2	4	2
0026	3T	7	134	818	74	81800	64650	-17150	0.09	0.79	144	114	-30
0026	3T	7	135	638	49	63800	46600	-17200	0.08	0.73	112	82	-30
0026	3T	7	136	412	29	41200	35520	-5680	0.07	0.86	72	62	-10
0026	3T	7	142	9	0	900	0	-900	0.00	0.00	1	0	-1
0026	3T	7	143	26	4	2600	4230	1630	0.15	1.63	4	7	3
0026	3T	7	145	252	16	25200	22890	-2310	0.06	0.91	44	40	-4
0026	3T	7	146	172	10	17200	13220	-3980	0.06	0.77	30	23	-7
0026	3T	7	152	4	0	400	0	-400	0.00	0.00	0	0	0
0026	3T	7	153	4	0	400	0	-400	0.00	0.00	0	0	0
0026	3T	7	156	52	1	5200	990	-4210	0.02	0.19	9	1	-8
0026	3T	7	163	1	0	100	0	-100	0.00	0.00	0	0	0
0026	3T	7	164	2	1	200	4070	3870	0.50	20.35	0	7	7
0026	3T	7	165	2	0	200	0	-200	0.00	0.00	0	0	0
0026	3T	7	214	2	0	200	0	-200	0.00	0.00	0	0	0
0026	3T	7	216	6	0	600	0	-600	0.00	0.00	1	0	-1
0026	3T	7	234	17	1	1700	1140	-560	0.06	0.67	3	2	-1
0026	3T	7	235	13	1	1300	2130	830	0.08	1.64	2	3	1
0026	3T	7	236	6	0	600	0	-600	0.00	0.00	1	0	-1
0026	3T	7	243	1	0	100	0	-100	0.00	0.00	0	0	0
0026	3T	7	245	8	0	800	0	-800	0.00	0.00	1	0	-1
0026	3T	7	246	5	0	500	0	-500	0.00	0.00	0	0	0
0026	3T	7	256	5	0	500	0	-500	0.00	0.00	0	0	0
0027	1T	1	1	20169	10452	2016900	1872670	-144230	0.52	0.93	3569	3314	-255
0027	1T	1	2	6812	2560	681200	612530	-68670	0.38	0.90	1205	1084	-121
0027	1T	2	1	3999	2505	399900	365860	-34040	0.63	0.91	707	647	-60
0027	1T	2	2	111	36	11100	13060	1960	0.32	1.18	19	23	4
0027	1T	3	1	14730	8547	1473000	1375910	-97090	0.58	0.93	2607	2435	-172
0027	1T	3	2	1745	555	174500	150150	-24350	0.32	0.86	308	265	-43
0027	1T	4	1	4659	3050	465900	421100	-44800	0.65	0.90	824	745	-79
0027	1T	4	2	94	23	9400	7010	-2390	0.24	0.75	16	12	-4
0027	1T	5	1	2383	1451	238300	216230	-22070	0.61	0.91	421	382	-39
0027	1T	5	2	68	28	6800	5910	-890	0.41	0.87	12	10	-2
0027	1T	6	1	3079	2202	307900	277490	-30410	0.72	0.90	544	491	-53
0027	1T	6	2	35	9	3500	2010	-1490	0.26	0.57	6	3	-3
0027	1T	7	1	1130	785	113000	99070	-13930	0.69	0.88	200	175	-25
0027	1T	7	2	5	0	500	0	-500	0.00	0.00	0	0	0
0027	1T	else	1	11394	7766	1139400	1039250	-100150	0.68	0.91	2016	1839	-177
0027	1T	else	2	186	58	18600	14600	-4000	0.31	0.78	32	25	-7
0027	2F	1	12	7425	2464	742500	647130	-95370	0.33	0.87	1314	1145	-169
0027	2F	1	13	5208	1648	520800	415570	-105230	0.32	0.80	921	735	-186
0027	2F	1	14	4051	1118	405100	308000	-97100	0.28	0.76	716	545	-171
0027	2F	1	15	1796	411	179600	150760	-28840	0.23	0.84	317	266	-51
0027	2F	1	16	1194	236	119400	113040	-6360	0.20	0.95	211	200	-11
0027	2F	1	23	851	200	85100	76840	-8260	0.24	0.90	150	136	-14
0027	2F	1	24	411	75	41100	26560	-14540	0.18	0.65	72	47	-25
0027	2F	1	25	410	60	41000	28990	-12010	0.15	0.71	72	51	-21
0027	2F	1	26	416	80	41600	41030	-570	0.19	0.99	73	72	-1
0027	2F	2	12	1605	558	160500	138340	-22160	0.35	0.86	284	244	-40
0027	2F	2	13	1331	431	133100	109900	-23200	0.32	0.83	235	194	-41
0027	2F	2	14	691	194	69100	58880	-10220	0.28	0.85	122	104	-18
0027	2F	2	15	161	35	16100	13720	-2380	0.22	0.85	28	24	-4
0027	2F	2	16	65	10	6500	8270	1770	0.15	1.27	11	14	3
0027	2F	2	23	14	2	1400	2060	660	0.14	1.47	2	3	1
0027	2F	2	24	4	3	400	850	450	0.75	2.13	0	1	1
0027	2F	2	25	4	0	400	0	-400	0.00	0.00	0	0	0
0027	2F	2	26	2	0	200	0	-200	0.00	0.00	0	0	0
0027	2F	3	12	5855	1931	585500	502650	-82850	0.33	0.86	1036	889	-147
0027	2F	3	13	4007	1234	400700	323960	-76740	0.31	0.81	709	573	-136
0027	2F	3	14	2919	844	291900	229310	-62590	0.29	0.79	516	405	-111
0027	2F	3	15	1063	216	106300	85480	-20820	0.20	0.80	188	151	-37
0027	2F	3	16	606	120	60600	54160	-6440	0.20	0.89	107	95	-12
0027	2F	3	23	148	40	14800	15920	1120	0.27	1.08	26	28	2
0027	2F	3	24	107	18	10700	6710	-3990	0.17	0.63	18	11	-7
0027	2F	3	25	94	14	9400	5820	-3580	0.15	0.62	16	10	-6
0027	2F	3	26	97	10	9700	6080	-3620	0.10	0.63	17	10	-7
0027	2F	4	12	2779	921	277900	231270	-46630	0.33	0.83	491	409	-82
0027	2F	4	13	1168	339	116800	92920	-23880	0.29	0.80	206	164	-42
0027	2F	4	14	476	106	47600	33780	-13820	0.22	0.71	84	59	-25
0027	2F	4	15	63	14	6300	5290	-1010	0.22	0.84	11	9	-2
0027	2F	4	16	18	1	1800	500	-1300	0.06	0.28	3	0	-3
0027	2F	4	23	4	1	400	1140	740	0.25	2.85	0	2	2
0027	2F	4	24	1	0	100	0	-100	0.00	0.00	0	0	0
0027	2F	4	25	4	0	400	0	-400	0.00	0.00	0	0	0
0027	2F	5	12	1319	419	131900	103510	-28390	0.32	0.78	233	183	-50
0027	2F	5	13	636	213	63600	52650	-10950	0.33	0.83	112	93	-19
0027	2F	5	14	332	99	33200	28410	-4790	0.30	0.86	58	50	-8
0027	2F	5	15	32	9	3200	2360	-840	0.28	0.74	5	4	-1
0027	2F	5	16	20	3	2000	1740	-260	0.15	0.87	3	3	0
0027	2F	5	23	3	1	300	200	-100	0.33	0.67	0	0	0
0027	2F	5	24	1	0	100	0	-100	0.00	0.00	0	0	0
0027	2F	5	25	1	0	100	0	-100	0.00	0.00	0	0	0
0027	2F	5	26	1	1	100	580	480	1.00	5.80	0	1	1
0027	2F	6	12	2473	991	247300	199580	-47720	0.40	0.81	437	353	-84
0027	2F	6	13	474	126	47400	34960	-12440	0.27	0.74	83	61	-22
0027	2F	6	14	101	22	10100	7780	-2320	0.22	0.77	17	13	-4
0027	2F	6	15	6	4	600	2660	2060	0.67	4.43	1	4	3
0027	2F	6	16	2	0	200	0	-200	0.00	0.00	0	0	0
0027	2F	6	23	5	0	500	0	-500	0.00	0.00	0	0	0
0027	2F	6	25	1	0	100	0	-100	0.00	0.00	0	0	0
0027	2F	7	12	981	314	98100	73250	-24850	0.32	0.75	173	129	-44
0027	2F	7	13	85	26	8500	9580	1080	0.31	1.13	15	16	1
0027	2F	7	14	16	5	1600	2960	1360	0.31	1.85	2	5	3
0027	2F	7	15	1	0	100	0	-100	0.00	0.00	0	0	0
0027	2F	7	16	1	0	100	0	-100	0.00	0.00	0	0	0
0027	2F	else	12	7259	2609	725900	593310	-132590	0.36	0.82	1284	1050	-234
0027	2F	else	13	2536	863	253600	199940	-53660	0.34	0.79	448	353	-95
0027	2F	else	14	1147	357	114700	87650	-27050	0.31	0.76	203	155	-48
0027	2F	else	15	140	39	14000	16090	2090	0.28	1.15	24	28	4
0027	2F	else	16	107	23	10700	5690	-5010	0.21	0.53	18	10	-8
0027	2F	else	23	13	1	1300	280	-1020	0.08	0.22	2	0	-2
0027	2F	else	24	5	1	500	420	-80	0.20	0.84	0	0	0
0027	2F	else	25	5	1	500	360	-140	0.20	0.72	0	0	0
0027	2F	else	26	3	0	300	0	-300	0.00	0.00	0	0	0
0027	2T	1	12	6854	1642	685400	584390	-101010	0.24	0.85	1213	1034	-179
0027	2T	1	13	5208	1157	520800	414480	-106320	0.22	0.80	921	733	-188
0027	2T	1	14	4051	782	405100	303460	-101640	0.19	0.75	716	537	-179
0027	2T	1	15	1796	281	179600	150140	-29460	0.16	0.84	317	265	-52
0027	2T	1	16	1194	161	119400	112700	-6700	0.13	0.94	211	199	-12
0027	2T	1	21	571	65	57100	52190	-4910	0.11	0.91	101	92	-9
0027	2T	1	23	851	120	85100	71720	-13380	0.14	0.84	150	126	-24
0027	2T	1	24	411	45	41100	24780	-16320	0.11	0.60	72	43	-29
0027	2T	1	25	410	42	41000	32410	-8590	0.10	0.79	72	57	-15
0027	2T	1	26	416	43	41600	33990	-7610	0.10	0.82	73	60	-13
0027	2T	2	12	1594	423	159400	131670	-27730	0.27	0.83	282	233	-49
0027	2T	2	13	1331	314	133100	101120	-31980	0.24	0.76	235	178	-57
0027	2T	2	14	691	152	69100	60490	-8610	0.22	0.88	122	107	-15
0027	2T	2	15	161	28	16100	14270	-1830	0.17	0.89	28	25	-3
0027	2T	2	16	65	9	6500	9090	2590	0.14	1.40	11	16	5
0027	2T	2	21	11	1	1100	1130	30	0.09	1.03	1	2	1
0027	2T	2	23	14	2	1400	5010	3610	0.14	3.58	2	8	6
0027	2T	2	24	4	2	400	940	540	0.50	2.35	0	1	1
0027	2T	2	25	4	0	400	0	-400	0.00	0.00	0	0	0
0027	2T	2	26	2	0	200	0	-200	0.00	0.00	0	0	0
0027	2T	3	12	5744	1452	574400	478240	-96160	0.25	0.83	1016	846	-170
0027	2T	3	13	4007	916	400700	313530	-87170	0.23	0.78	709	554	-155
0027	2T	3	14	2919	617	291900	234530	-57370	0.21	0.80	516	415	-101
0027	2T	3	15	1063	164	106300	89840	-16460	0.15	0.85	188	159	-29
0027	2T	3	16	606	93	60600	62270	1670	0.15	1.03	107	110	3
0027	2T	3	21	111	7	11100	7950	-3150	0.06	0.72	19	14	-5
0027	2T	3	23	148	20	14800	10830	-3970	0.14	0.73	26	19	-7
0027	2T	3	24	107	8	10700	5880	-4820	0.07	0.55	18	10	-8
0027	2T	3	25	94	9	9400	6280	-3120	0.10	0.67	16	11	-5
0027	2T	3	26	97	7	9700	7450	-2250	0.07	0.77	17	13	-4
0027	2T	4	12	2763	720	276300	218880	-57420	0.26	0.79	489	387	-102
0027	2T	4	13	1168	258	116800	84980	-31820	0.22	0.73	206	150	-56
0027	2T	4	14	476	86	47600	33360	-14240	0.18	0.70	84	59	-25
0027	2T	4	15	63	10	6300	4760	-1540	0.16	0.76	11	8	-3
0027	2T	4	16	18	1	1800	570	-1230	0.06	0.32	3	1	-2
0027	2T	4	21	16	0	1600	0	-1600	0.00	0.00	2	0	-2
0027	2T	4	23	4	0	400	0	-400	0.00	0.00	0	0	0
0027	2T	4	24	1	0	100	0	-100	0.00	0.00	0	0	0
0027	2T	4	25	4	0	400	0	-400	0.00	0.00	0	0	0
0027	2T	5	12	1312	316	131200	97680	-33520	0.24	0.74	232	172	-60
0027	2T	5	13	636	160	63600	48020	-15580	0.25	0.76	112	84	-28
0027	2T	5	14	332	74	33200	27810	-5390	0.22	0.84	58	49	-9
0027	2T	5	15	32	6	3200	3370	170	0.19	1.05	5	5	0
0027	2T	5	16	20	3	2000	2380	380	0.15	1.19	3	4	1
0027	2T	5	21	7	0	700	0	-700	0.00	0.00	1	0	-1
0027	2T	5	23	3	0	300	0	-300	0.00	0.00	0	0	0
0027	2T	5	24	1	0	100	0	-100	0.00	0.00	0	0	0
0027	2T	5	25	1	0	100	0	-100	0.00	0.00	0	0	0
0027	2T	5	26	1	1	100	970	870	1.00	9.70	0	1	1
0027	2T	6	12	2473	805	247300	194090	-53210	0.33	0.78	437	343	-94
0027	2T	6	13	474	114	47400	36530	-10870	0.24	0.77	83	64	-19
0027	2T	6	14	101	21	10100	8930	-1170	0.21	0.88	17	15	-2
0027	2T	6	15	6	4	600	3010	2410	0.67	5.02	1	5	4
0027	2T	6	16	2	0	200	0	-200	0.00	0.00	0	0	0
0027	2T	6	23	5	0	500	0	-500	0.00	0.00	0	0	0
0027	2T	6	25	1	0	100	0	-100	0.00	0.00	0	0	0
0027	2T	7	12	980	257	98000	72840	-25160	0.26	0.74	173	128	-45
0027	2T	7	13	85	24	8500	10560	2060	0.28	1.24	15	18	3
0027	2T	7	14	16	5	1600	3160	1560	0.31	1.98	2	5	3
0027	2T	7	15	1	0	100	0	-100	0.00	0.00	0	0	0
0027	2T	7	16	1	0	100	0	-100	0.00	0.00	0	0	0
0027	2T	7	21	1	0	100	0	-100	0.00	0.00	0	0	0
0027	2T	else	12	7255	2107	725500	580150	-145350	0.29	0.80	1284	1026	-258
0027	2T	else	13	2536	644	253600	187540	-66060	0.25	0.74	448	331	-117
0027	2T	else	14	1147	276	114700	90570	-24130	0.24	0.79	203	160	-43
0027	2T	else	15	140	30	14000	16490	2490	0.21	1.18	24	29	5
0027	2T	else	16	107	16	10700	4820	-5880	0.15	0.45	18	8	-10
0027	2T	else	21	4	0	400	0	-400	0.00	0.00	0	0	0
0027	2T	else	23	13	0	1300	0	-1300	0.00	0.00	2	0	-2
0027	2T	else	24	5	0	500	0	-500	0.00	0.00	0	0	0
0027	2T	else	25	5	1	500	490	-10	0.20	0.98	0	0	0
0027	2T	else	26	3	0	300	0	-300	0.00	0.00	0	0	0
0027	3F	1	123	1110	305	111000	88790	-22210	0.27	0.80	196	157	-39
0027	3F	1	124	2224	571	222400	177450	-44950	0.26	0.80	393	314	-79
0027	3F	1	125	1587	333	158700	142170	-16530	0.21	0.90	280	251	-29
0027	3F	1	126	2216	340	221600	174270	-47330	0.15	0.79	392	308	-84
0027	3F	1	134	1177	294	117700	91030	-26670	0.25	0.77	208	161	-47
0027	3F	1	135	1321	273	132100	94590	-37510	0.21	0.72	233	167	-66
0027	3F	1	136	1740	265	174000	126490	-47510	0.15	0.73	307	223	-84
0027	3F	1	145	807	150	80700	63170	-17530	0.19	0.78	142	111	-31
0027	3F	1	146	761	117	76100	57780	-18320	0.15	0.76	134	102	-32
0027	3F	1	156	402	67	40200	36140	-4060	0.17	0.90	71	63	-8
0027	3F	1	234	132	31	13200	12500	-700	0.23	0.95	23	22	-1
0027	3F	1	235	247	50	24700	22150	-2550	0.20	0.90	43	39	-4
0027	3F	1	236	329	41	32900	21870	-11030	0.12	0.66	58	38	-20
0027	3F	1	245	121	14	12100	6030	-6070	0.12	0.50	21	10	-11
0027	3F	1	246	83	6	8300	2380	-5920	0.07	0.29	14	4	-10
0027	3F	1	256	104	9	10400	3760	-6640	0.09	0.36	18	6	-12
0027	3F	2	123	116	36	11600	10660	-940	0.31	0.92	20	18	-2
0027	3F	2	124	484	112	48400	35850	-12550	0.23	0.74	85	63	-22
0027	3F	2	125	464	79	46400	38410	-7990	0.17	0.83	82	67	-15
0027	3F	2	126	539	76	53900	44680	-9220	0.14	0.83	95	79	-16
0027	3F	2	134	320	80	32000	31700	-300	0.25	0.99	56	56	0
0027	3F	2	135	446	79	44600	34630	-9970	0.18	0.78	78	61	-17
0027	3F	2	136	463	55	46300	33860	-12440	0.12	0.73	81	59	-22
0027	3F	2	145	208	25	20800	12510	-8290	0.12	0.60	36	22	-14
0027	3F	2	146	145	19	14500	9710	-4790	0.13	0.67	25	17	-8
0027	3F	2	156	30	2	3000	1400	-1600	0.07	0.47	5	2	-3
0027	3F	2	234	6	1	600	300	-300	0.17	0.50	1	0	-1
0027	3F	2	235	2	0	200	0	-200	0.00	0.00	0	0	0
0027	3F	2	236	2	0	200	0	-200	0.00	0.00	0	0	0
0027	3F	2	245	1	0	100	0	-100	0.00	0.00	0	0	0
0027	3F	2	256	1	1	100	330	230	1.00	3.30	0	0	0
0027	3F	3	123	1182	311	118200	93750	-24450	0.26	0.79	209	165	-44
0027	3F	3	124	1661	392	166100	120670	-45430	0.24	0.73	293	213	-80
0027	3F	3	125	1251	251	125100	97350	-27750	0.20	0.78	221	172	-49
0027	3F	3	126	1345	213	134500	118270	-16230	0.16	0.88	238	209	-29
0027	3F	3	134	932	231	93200	75780	-17420	0.25	0.81	164	134	-30
0027	3F	3	135	902	140	90200	51930	-38270	0.16	0.58	159	91	-68
0027	3F	3	136	1004	156	100400	79490	-20910	0.16	0.79	177	140	-37
0027	3F	3	145	613	109	61300	43970	-17330	0.18	0.72	108	77	-31
0027	3F	3	146	444	58	44400	25300	-19100	0.13	0.57	78	44	-34
0027	3F	3	156	162	21	16200	11960	-4240	0.13	0.74	28	21	-7
0027	3F	3	234	28	4	2800	2520	-280	0.14	0.90	4	4	0
0027	3F	3	235	30	7	3000	2970	-30	0.23	0.99	5	5	0
0027	3F	3	236	46	11	4600	6740	2140	0.24	1.47	8	11	3
0027	3F	3	245	33	3	3300	950	-2350	0.09	0.29	5	1	-4
0027	3F	3	246	21	0	2100	0	-2100	0.00	0.00	3	0	-3
0027	3F	3	256	17	1	1700	3630	1930	0.06	2.14	3	6	3
0027	3F	4	123	212	49	21200	15080	-6120	0.23	0.71	37	26	-11
0027	3F	4	124	1282	249	128200	99660	-28540	0.19	0.78	226	176	-50
0027	3F	4	125	589	77	58900	45470	-13430	0.13	0.77	104	80	-24
0027	3F	4	126	687	55	68700	50600	-18100	0.08	0.74	121	89	-32
0027	3F	4	134	414	74	41400	29270	-12130	0.18	0.71	73	51	-22
0027	3F	4	135	300	46	30000	23770	-6230	0.15	0.79	53	42	-11
0027	3F	4	136	353	33	35300	27850	-7450	0.09	0.79	62	49	-13
0027	3F	4	145	118	13	11800	5670	-6130	0.11	0.48	20	10	-10
0027	3F	4	146	95	13	9500	11870	2370	0.14	1.25	16	21	5
0027	3F	4	156	17	2	1700	1630	-70	0.12	0.96	3	2	-1
0027	3F	4	234	1	0	100	0	-100	0.00	0.00	0	0	0
0027	3F	4	235	2	0	200	0	-200	0.00	0.00	0	0	0
0027	3F	4	236	1	0	100	0	-100	0.00	0.00	0	0	0
0027	3F	4	245	1	0	100	0	-100	0.00	0.00	0	0	0
0027	3F	4	256	1	0	100	0	-100	0.00	0.00	0	0	0
0027	3F	5	123	98	31	9800	9240	-560	0.32	0.94	17	16	-1
0027	3F	5	124	583	135	58300	43770	-14530	0.23	0.75	103	77	-26
0027	3F	5	125	306	49	30600	21450	-9150	0.16	0.70	54	37	-17
0027	3F	5	126	328	38	32800	20680	-12120	0.12	0.63	58	36	-22
0027	3F	5	134	179	34	17900	11270	-6630	0.19	0.63	31	19	-12
0027	3F	5	135	191	43	19100	18110	-990	0.23	0.95	33	32	-1
0027	3F	5	136	220	22	22000	13830	-8170	0.10	0.63	38	24	-14
0027	3F	5	145	71	11	7100	5200	-1900	0.15	0.73	12	9	-3
0027	3F	5	146	60	4	6000	2380	-3620	0.07	0.40	10	4	-6
0027	3F	5	156	9	3	900	1380	480	0.33	1.53	1	2	1
0027	3F	5	234	1	1	100	260	160	1.00	2.60	0	0	0
0027	3F	5	235	1	0	100	0	-100	0.00	0.00	0	0	0
0027	3F	5	245	1	0	100	0	-100	0.00	0.00	0	0	0
0027	3F	5	256	1	0	100	0	-100	0.00	0.00	0	0	0
0027	3F	6	123	606	170	60600	42040	-18560	0.28	0.69	107	74	-33
0027	3F	6	124	1375	259	137500	92170	-45330	0.19	0.67	243	163	-80
0027	3F	6	125	286	47	28600	27890	-710	0.16	0.98	50	49	-1
0027	3F	6	126	204	24	20400	28360	7960	0.12	1.39	36	50	14
0027	3F	6	134	226	43	22600	21610	-990	0.19	0.96	40	38	-2
0027	3F	6	135	104	11	10400	8260	-2140	0.11	0.79	18	14	-4
0027	3F	6	136	75	5	7500	5570	-1930	0.07	0.74	13	9	-4
0027	3F	6	145	17	1	1700	540	-1160	0.06	0.32	3	0	-3
0027	3F	6	146	6	0	600	0	-600	0.00	0.00	1	0	-1
0027	3F	6	156	1	0	100	0	-100	0.00	0.00	0	0	0
0027	3F	6	234	1	0	100	0	-100	0.00	0.00	0	0	0
0027	3F	6	235	1	0	100	0	-100	0.00	0.00	0	0	0
0027	3F	6	236	1	0	100	0	-100	0.00	0.00	0	0	0
0027	3F	7	123	150	37	15000	12680	-2320	0.25	0.85	26	22	-4
0027	3F	7	124	690	111	69000	45030	-23970	0.16	0.65	122	79	-43
0027	3F	7	125	45	5	4500	3550	-950	0.11	0.79	7	6	-1
0027	3F	7	126	96	7	9600	9170	-430	0.07	0.96	16	16	0
0027	3F	7	134	47	8	4700	4430	-270	0.17	0.94	8	7	-1
0027	3F	7	135	14	3	1400	2570	1170	0.21	1.84	2	4	2
0027	3F	7	136	18	0	1800	0	-1800	0.00	0.00	3	0	-3
0027	3F	7	145	2	0	200	0	-200	0.00	0.00	0	0	0
0027	3F	7	146	1	0	100	0	-100	0.00	0.00	0	0	0
0027	3F	7	156	1	0	100	0	-100	0.00	0.00	0	0	0
0027	3F	else	123	2262	686	226200	185100	-41100	0.30	0.82	400	327	-73
0027	3F	else	124	2937	604	293700	221010	-72690	0.21	0.75	519	391	-128
0027	3F	else	125	815	157	81500	66110	-15390	0.19	0.81	144	117	-27
0027	3F	else	126	740	102	74000	61250	-12750	0.14	0.83	130	108	-22
0027	3F	else	134	781	196	78100	63050	-15050	0.25	0.81	138	111	-27
0027	3F	else	135	456	88	45600	33840	-11760	0.19	0.74	80	59	-21
0027	3F	else	136	324	56	32400	24820	-7580	0.17	0.77	57	43	-14
0027	3F	else	145	157	31	15700	12460	-3240	0.20	0.79	27	22	-5
0027	3F	else	146	103	7	10300	3650	-6650	0.07	0.35	18	6	-12
0027	3F	else	156	16	3	1600	2140	540	0.19	1.34	2	3	1
0027	3F	else	234	2	1	200	180	-20	0.50	0.90	0	0	0
0027	3F	else	235	5	1	500	360	-140	0.20	0.72	0	0	0
0027	3F	else	236	3	0	300	0	-300	0.00	0.00	0	0	0
0027	3F	else	245	1	0	100	0	-100	0.00	0.00	0	0	0
0027	3F	else	246	2	0	200	0	-200	0.00	0.00	0	0	0
0027	3F	else	256	1	0	100	0	-100	0.00	0.00	0	0	0
0027	3T	1	123	1073	119	107300	89990	-17310	0.11	0.84	189	159	-30
0027	3T	1	124	2151	221	215100	185470	-29630	0.10	0.86	380	328	-52
0027	3T	1	125	1382	124	138200	134090	-4110	0.09	0.97	244	237	-7
0027	3T	1	126	1916	122	191600	163970	-27630	0.06	0.86	339	290	-49
0027	3T	1	132	30	2	3000	1710	-1290	0.07	0.57	5	3	-2
0027	3T	1	134	1123	128	112300	93450	-18850	0.11	0.83	198	165	-33
0027	3T	1	135	1299	113	129900	94960	-34940	0.09	0.73	229	168	-61
0027	3T	1	136	1738	114	173800	143010	-30790	0.07	0.82	307	253	-54
0027	3T	1	142	5	0	500	0	-500	0.00	0.00	0	0	0
0027	3T	1	143	54	2	5400	4230	-1170	0.04	0.78	9	7	-2
0027	3T	1	145	790	47	79000	59440	-19560	0.06	0.75	139	105	-34
0027	3T	1	146	735	45	73500	54880	-18620	0.06	0.75	130	97	-33
0027	3T	1	152	7	1	700	2630	1930	0.14	3.76	1	4	3
0027	3T	1	153	22	0	2200	0	-2200	0.00	0.00	3	0	-3
0027	3T	1	154	17	2	1700	4160	2460	0.12	2.45	3	7	4
0027	3T	1	156	398	20	39800	25510	-14290	0.05	0.64	70	45	-25
0027	3T	1	162	2	0	200	0	-200	0.00	0.00	0	0	0
0027	3T	1	163	2	0	200	0	-200	0.00	0.00	0	0	0
0027	3T	1	164	26	1	2600	710	-1890	0.04	0.27	4	1	-3
0027	3T	1	165	4	1	400	4790	4390	0.25	11.98	0	8	8
0027	3T	1	213	7	2	700	4300	3600	0.29	6.14	1	7	6
0027	3T	1	214	68	6	6800	10320	3520	0.09	1.52	12	18	6
0027	3T	1	215	198	6	19800	8310	-11490	0.03	0.42	35	14	-21
0027	3T	1	216	298	8	29800	22600	-7200	0.03	0.76	52	40	-12
0027	3T	1	234	132	8	13200	8390	-4810	0.06	0.64	23	14	-9
0027	3T	1	235	246	22	24600	29010	4410	0.09	1.18	43	51	8
0027	3T	1	236	329	14	32900	27450	-5450	0.04	0.83	58	48	-10
0027	3T	1	245	119	5	11900	7620	-4280	0.04	0.64	21	13	-8
0027	3T	1	246	83	4	8300	4600	-3700	0.05	0.55	14	8	-6
0027	3T	1	253	1	0	100	0	-100	0.00	0.00	0	0	0
0027	3T	1	254	2	0	200	0	-200	0.00	0.00	0	0	0
0027	3T	1	256	104	0	10400	0	-10400	0.00	0.00	18	0	-18
0027	3T	2	123	116	15	11600	10970	-630	0.13	0.95	20	19	-1
0027	3T	2	124	482	38	48200	27400	-20800	0.08	0.57	85	48	-37
0027	3T	2	125	461	38	46100	33960	-12140	0.08	0.74	81	60	-21
0027	3T	2	126	533	35	53300	44460	-8840	0.07	0.83	94	78	-16
0027	3T	2	134	318	33	31800	26430	-5370	0.10	0.83	56	46	-10
0027	3T	2	135	445	35	44500	35430	-9070	0.08	0.80	78	62	-16
0027	3T	2	136	463	26	46300	32600	-13700	0.06	0.70	81	57	-24
0027	3T	2	143	2	0	200	0	-200	0.00	0.00	0	0	0
0027	3T	2	145	207	9	20700	10380	-10320	0.04	0.50	36	18	-18
0027	3T	2	146	145	11	14500	15080	580	0.08	1.04	25	26	1
0027	3T	2	153	1	1	100	770	670	1.00	7.70	0	1	1
0027	3T	2	154	1	0	100	0	-100	0.00	0.00	0	0	0
0027	3T	2	156	27	1	2700	1060	-1640	0.04	0.39	4	1	-3
0027	3T	2	165	3	0	300	0	-300	0.00	0.00	0	0	0
0027	3T	2	214	2	0	200	0	-200	0.00	0.00	0	0	0
0027	3T	2	215	3	1	300	3000	2700	0.33	10.00	0	5	5
0027	3T	2	216	6	0	600	0	-600	0.00	0.00	1	0	-1
0027	3T	2	234	6	0	600	0	-600	0.00	0.00	1	0	-1
0027	3T	2	235	2	0	200	0	-200	0.00	0.00	0	0	0
0027	3T	2	236	2	0	200	0	-200	0.00	0.00	0	0	0
0027	3T	2	245	1	0	100	0	-100	0.00	0.00	0	0	0
0027	3T	2	256	1	0	100	0	-100	0.00	0.00	0	0	0
0027	3T	3	123	1143	124	114300	86790	-27510	0.11	0.76	202	153	-49
0027	3T	3	124	1638	157	163800	123380	-40420	0.10	0.75	289	218	-71
0027	3T	3	125	1202	101	120200	90130	-30070	0.08	0.75	212	159	-53
0027	3T	3	126	1293	91	129300	129250	-50	0.07	1.00	228	228	0
0027	3T	3	132	38	1	3800	720	-3080	0.03	0.19	6	1	-5
0027	3T	3	134	910	86	91000	71360	-19640	0.09	0.78	161	126	-35
0027	3T	3	135	892	57	89200	52470	-36730	0.06	0.59	157	92	-65
0027	3T	3	136	1004	84	100400	94240	-6160	0.08	0.94	177	166	-11
0027	3T	3	142	10	0	1000	0	-1000	0.00	0.00	1	0	-1
0027	3T	3	143	22	2	2200	2480	280	0.09	1.13	3	4	1
0027	3T	3	145	612	36	61200	40320	-20880	0.06	0.66	108	71	-37
0027	3T	3	146	435	25	43500	27440	-16060	0.06	0.63	76	48	-28
0027	3T	3	152	4	1	400	790	390	0.25	1.98	0	1	1
0027	3T	3	153	10	0	1000	0	-1000	0.00	0.00	1	0	-1
0027	3T	3	154	1	0	100	0	-100	0.00	0.00	0	0	0
0027	3T	3	156	161	8	16100	10960	-5140	0.05	0.68	28	19	-9
0027	3T	3	164	9	0	900	0	-900	0.00	0.00	1	0	-1
0027	3T	3	165	1	0	100	0	-100	0.00	0.00	0	0	0
0027	3T	3	213	1	0	100	0	-100	0.00	0.00	0	0	0
0027	3T	3	214	13	0	1300	0	-1300	0.00	0.00	2	0	-2
0027	3T	3	215	45	1	4500	2210	-2290	0.02	0.49	7	3	-4
0027	3T	3	216	52	1	5200	8510	3310	0.02	1.64	9	15	6
0027	3T	3	234	28	1	2800	1680	-1120	0.04	0.60	4	2	-2
0027	3T	3	235	29	1	2900	880	-2020	0.03	0.30	5	1	-4
0027	3T	3	236	46	2	4600	3560	-1040	0.04	0.77	8	6	-2
0027	3T	3	245	33	0	3300	0	-3300	0.00	0.00	5	0	-5
0027	3T	3	246	21	0	2100	0	-2100	0.00	0.00	3	0	-3
0027	3T	3	253	1	0	100	0	-100	0.00	0.00	0	0	0
0027	3T	3	256	17	0	1700	0	-1700	0.00	0.00	3	0	-3
0027	3T	4	123	212	24	21200	14130	-7070	0.11	0.67	37	25	-12
0027	3T	4	124	1278	115	127800	96570	-31230	0.09	0.76	226	170	-56
0027	3T	4	125	583	37	58300	42870	-15430	0.06	0.74	103	75	-28
0027	3T	4	126	681	35	68100	65100	-3000	0.05	0.96	120	115	-5
0027	3T	4	134	413	34	41300	29480	-11820	0.08	0.71	73	52	-21
0027	3T	4	135	300	21	30000	24500	-5500	0.07	0.82	53	43	-10
0027	3T	4	136	353	18	35300	31720	-3580	0.05	0.90	62	56	-6
0027	3T	4	143	1	0	100	0	-100	0.00	0.00	0	0	0
0027	3T	4	145	118	7	11800	6970	-4830	0.06	0.59	20	12	-8
0027	3T	4	146	95	7	9500	8280	-1220	0.07	0.87	16	14	-2
0027	3T	4	156	17	1	1700	2420	720	0.06	1.42	3	4	1
0027	3T	4	214	4	0	400	0	-400	0.00	0.00	0	0	0
0027	3T	4	215	6	0	600	0	-600	0.00	0.00	1	0	-1
0027	3T	4	216	6	0	600	0	-600	0.00	0.00	1	0	-1
0027	3T	4	234	1	0	100	0	-100	0.00	0.00	0	0	0
0027	3T	4	235	2	0	200	0	-200	0.00	0.00	0	0	0
0027	3T	4	236	1	0	100	0	-100	0.00	0.00	0	0	0
0027	3T	4	245	1	0	100	0	-100	0.00	0.00	0	0	0
0027	3T	4	256	1	0	100	0	-100	0.00	0.00	0	0	0
0027	3T	5	123	98	13	9800	9430	-370	0.13	0.96	17	16	-1
0027	3T	5	124	581	64	58100	50360	-7740	0.11	0.87	102	89	-13
0027	3T	5	125	305	15	30500	15650	-14850	0.05	0.51	53	27	-26
0027	3T	5	126	324	22	32400	24460	-7940	0.07	0.75	57	43	-14
0027	3T	5	134	176	14	17600	9880	-7720	0.08	0.56	31	17	-14
0027	3T	5	135	191	22	19100	18970	-130	0.12	0.99	33	33	0
0027	3T	5	136	220	12	22000	18270	-3730	0.05	0.83	38	32	-6
0027	3T	5	143	3	1	300	970	670	0.33	3.23	0	1	1
0027	3T	5	145	71	3	7100	2580	-4520	0.04	0.36	12	4	-8
0027	3T	5	146	60	2	6000	2740	-3260	0.03	0.46	10	4	-6
0027	3T	5	156	9	2	900	3240	2340	0.22	3.60	1	5	4
0027	3T	5	214	2	0	200	0	-200	0.00	0.00	0	0	0
0027	3T	5	215	1	0	100	0	-100	0.00	0.00	0	0	0
0027	3T	5	216	4	0	400	0	-400	0.00	0.00	0	0	0
0027	3T	5	234	1	0	100	0	-100	0.00	0.00	0	0	0
0027	3T	5	235	1	0	100	0	-100	0.00	0.00	0	0	0
0027	3T	5	245	1	0	100	0	-100	0.00	0.00	0	0	0
0027	3T	5	256	1	0	100	0	-100	0.00	0.00	0	0	0
0027	3T	6	123	606	92	60600	44900	-15700	0.15	0.74	107	79	-28
0027	3T	6	124	1375	135	137500	88580	-48920	0.10	0.64	243	156	-87
0027	3T	6	125	286	28	28600	30380	1780	0.10	1.06	50	53	3
0027	3T	6	126	204	12	20400	27980	7580	0.06	1.37	36	49	13
0027	3T	6	134	225	20	22500	22300	-200	0.09	0.99	39	39	0
0027	3T	6	135	103	6	10300	6640	-3660	0.06	0.64	18	11	-7
0027	3T	6	136	75	0	7500	0	-7500	0.00	0.00	13	0	-13
0027	3T	6	143	1	0	100	0	-100	0.00	0.00	0	0	0
0027	3T	6	145	16	0	1600	0	-1600	0.00	0.00	2	0	-2
0027	3T	6	146	6	0	600	0	-600	0.00	0.00	1	0	-1
0027	3T	6	153	1	1	100	3960	3860	1.00	39.60	0	7	7
0027	3T	6	154	1	0	100	0	-100	0.00	0.00	0	0	0
0027	3T	6	156	1	0	100	0	-100	0.00	0.00	0	0	0
0027	3T	6	234	1	0	100	0	-100	0.00	0.00	0	0	0
0027	3T	6	235	1	0	100	0	-100	0.00	0.00	0	0	0
0027	3T	6	236	1	0	100	0	-100	0.00	0.00	0	0	0
0027	3T	7	123	150	24	15000	17720	2720	0.16	1.18	26	31	5
0027	3T	7	124	690	58	69000	47750	-21250	0.08	0.69	122	84	-38
0027	3T	7	125	45	2	4500	6650	2150	0.04	1.48	7	11	4
0027	3T	7	126	95	5	9500	10900	1400	0.05	1.15	16	19	3
0027	3T	7	134	47	6	4700	7370	2670	0.13	1.57	8	13	5
0027	3T	7	135	14	3	1400	5500	4100	0.21	3.93	2	9	7
0027	3T	7	136	18	0	1800	0	-1800	0.00	0.00	3	0	-3
0027	3T	7	145	2	0	200	0	-200	0.00	0.00	0	0	0
0027	3T	7	146	1	0	100	0	-100	0.00	0.00	0	0	0
0027	3T	7	156	1	0	100	0	-100	0.00	0.00	0	0	0
0027	3T	7	216	1	0	100	0	-100	0.00	0.00	0	0	0
0027	3T	else	123	2252	322	225200	189130	-36070	0.14	0.84	398	334	-64
0027	3T	else	124	2932	276	293200	215720	-77480	0.09	0.74	518	381	-137
0027	3T	else	125	810	73	81000	62820	-18180	0.09	0.78	143	111	-32
0027	3T	else	126	740	53	74000	68940	-5060	0.07	0.93	130	122	-8
0027	3T	else	132	10	4	1000	4240	3240	0.40	4.24	1	7	6
0027	3T	else	134	770	87	77000	62230	-14770	0.11	0.81	136	110	-26
0027	3T	else	135	452	37	45200	32380	-12820	0.08	0.72	80	57	-23
0027	3T	else	136	324	26	32400	23890	-8510	0.08	0.74	57	42	-15
0027	3T	else	142	5	1	500	1800	1300	0.20	3.60	0	3	3
0027	3T	else	143	11	0	1100	0	-1100	0.00	0.00	1	0	-1
0027	3T	else	145	154	13	15400	13090	-2310	0.08	0.85	27	23	-4
0027	3T	else	146	103	4	10300	5840	-4460	0.04	0.57	18	10	-8
0027	3T	else	152	1	0	100	0	-100	0.00	0.00	0	0	0
0027	3T	else	153	4	0	400	0	-400	0.00	0.00	0	0	0
0027	3T	else	154	3	0	300	0	-300	0.00	0.00	0	0	0
0027	3T	else	156	15	3	1500	7210	5710	0.20	4.81	2	12	10
0027	3T	else	165	1	0	100	0	-100	0.00	0.00	0	0	0
0027	3T	else	215	4	0	400	0	-400	0.00	0.00	0	0	0
0027	3T	else	234	2	0	200	0	-200	0.00	0.00	0	0	0
0027	3T	else	235	5	0	500	0	-500	0.00	0.00	0	0	0
0027	3T	else	236	3	0	300	0	-300	0.00	0.00	0	0	0
0027	3T	else	245	1	0	100	0	-100	0.00	0.00	0	0	0
0027	3T	else	246	2	0	200	0	-200	0.00	0.00	0	0	0
0027	3T	else	256	1	0	100	0	-100	0.00	0.00	0	0	0
0028	1T	1	1	5998	3829	599800	543880	-55920	0.64	0.91	1061	962	-99
0028	1T	1	2	122	38	12200	10930	-1270	0.31	0.90	21	19	-2
0028	1T	10	1	6110	3641	611000	553850	-57150	0.60	0.91	1081	980	-101
0028	1T	10	2	204	75	20400	16930	-3470	0.37	0.83	36	29	-7
0028	1T	11	1	6409	4195	640900	578440	-62460	0.65	0.90	1134	1023	-111
0028	1T	12	1	6391	4506	639100	575470	-63630	0.71	0.90	1131	1018	-113
0028	1T	12	2	2	0	200	0	-200	0.00	0.00	0	0	0
0028	1T	2	1	4981	2350	498100	453720	-44380	0.47	0.91	881	803	-78
0028	1T	2	2	632	195	63200	63570	370	0.31	1.01	111	112	1
0028	1T	3	1	5731	2605	573100	533440	-39660	0.45	0.93	1014	944	-70
0028	1T	3	2	418	147	41800	34690	-7110	0.35	0.83	73	61	-12
0028	1T	4	1	5748	2790	574800	519170	-55630	0.49	0.90	1017	918	-99
0028	1T	4	2	426	160	42600	38640	-3960	0.38	0.91	75	68	-7
0028	1T	5	1	5692	3178	569200	530520	-38680	0.56	0.93	1007	938	-69
0028	1T	5	2	491	189	49100	42420	-6680	0.38	0.86	86	75	-11
0028	1T	6	1	5166	2557	516600	481870	-34730	0.49	0.93	914	852	-62
0028	1T	6	2	849	339	84900	76930	-7970	0.40	0.91	150	136	-14
0028	1T	7	1	5338	2827	533800	494560	-39240	0.53	0.93	944	875	-69
0028	1T	7	2	710	300	71000	66060	-4940	0.42	0.93	125	116	-9
0028	1T	8	1	5279	2929	527900	480700	-47200	0.55	0.91	934	850	-84
0028	1T	8	2	592	258	59200	57480	-1720	0.44	0.97	104	101	-3
0028	1T	9	1	5697	3365	569700	524790	-44910	0.59	0.92	1008	928	-80
0028	1T	9	2	470	180	47000	42340	-4660	0.38	0.90	83	74	-9
0028	2F	1	12	3967	1217	396700	338470	-58230	0.31	0.85	702	599	-103
0028	2F	1	13	1233	334	123300	94610	-28690	0.27	0.77	218	167	-51
0028	2F	1	14	662	197	66200	52030	-14170	0.30	0.79	117	92	-25
0028	2F	1	15	50	10	5000	4000	-1000	0.20	0.80	8	7	-1
0028	2F	1	16	60	7	6000	5490	-510	0.12	0.92	10	9	-1
0028	2F	1	23	9	1	900	560	-340	0.11	0.62	1	0	-1
0028	2F	1	24	1	0	100	0	-100	0.00	0.00	0	0	0
0028	2F	1	25	2	1	200	320	120	0.50	1.60	0	0	0
0028	2F	1	26	2	1	200	1140	940	0.50	5.70	0	2	2
0028	2F	10	12	4000	1338	400000	330220	-69780	0.33	0.83	707	584	-123
0028	2F	10	13	1460	473	146000	125930	-20070	0.32	0.86	258	222	-36
0028	2F	10	14	502	135	50200	38220	-11980	0.27	0.76	88	67	-21
0028	2F	10	15	62	17	6200	7700	1500	0.27	1.24	10	13	3
0028	2F	10	16	46	8	4600	4920	320	0.17	1.07	8	8	0
0028	2F	10	23	11	2	1100	2060	960	0.18	1.87	1	3	2
0028	2F	10	24	7	1	700	430	-270	0.14	0.61	1	0	-1
0028	2F	10	25	3	0	300	0	-300	0.00	0.00	0	0	0
0028	2F	10	26	5	0	500	0	-500	0.00	0.00	0	0	0
0028	2F	11	12	4218	1432	421800	347670	-74130	0.34	0.82	746	615	-131
0028	2F	11	13	1599	501	159900	131420	-28480	0.31	0.82	283	232	-51
0028	2F	11	14	554	145	55400	44830	-10570	0.26	0.81	98	79	-19
0028	2F	11	15	33	5	3300	2740	-560	0.15	0.83	5	4	-1
0028	2F	11	16	3	1	300	250	-50	0.33	0.83	0	0	0
0028	2F	12	12	5896	1857	589600	486270	-103330	0.31	0.82	1043	860	-183
0028	2F	12	13	426	142	42600	33970	-8630	0.33	0.80	75	60	-15
0028	2F	12	14	67	7	6700	1940	-4760	0.10	0.29	11	3	-8
0028	2F	12	15	1	0	100	0	-100	0.00	0.00	0	0	0
0028	2F	2	12	3147	940	314700	268170	-46530	0.30	0.85	556	474	-82
0028	2F	2	13	864	209	86400	65470	-20930	0.24	0.76	152	115	-37
0028	2F	2	14	436	120	43600	29270	-14330	0.28	0.67	77	51	-26
0028	2F	2	15	33	8	3300	3370	70	0.24	1.02	5	5	0
0028	2F	2	16	50	7	5000	2660	-2340	0.14	0.53	8	4	-4
0028	2F	2	23	54	7	5400	4060	-1340	0.13	0.75	9	7	-2
0028	2F	2	24	7	0	700	0	-700	0.00	0.00	1	0	-1
0028	2F	2	25	17	3	1700	1620	-80	0.18	0.95	3	2	-1
0028	2F	2	26	20	2	2000	640	-1360	0.10	0.32	3	1	-2
0028	2F	3	12	3292	850	329200	318260	-10940	0.26	0.97	582	563	-19
0028	2F	3	13	1652	534	165200	135690	-29510	0.32	0.82	292	240	-52
0028	2F	3	14	537	114	53700	43290	-10410	0.21	0.81	95	76	-19
0028	2F	3	15	94	16	9400	8730	-670	0.17	0.93	16	15	-1
0028	2F	3	16	41	8	4100	3960	-140	0.20	0.97	7	7	0
0028	2F	3	23	49	10	4900	3360	-1540	0.20	0.69	8	5	-3
0028	2F	3	24	15	0	1500	0	-1500	0.00	0.00	2	0	-2
0028	2F	3	25	23	5	2300	2220	-80	0.22	0.97	4	3	-1
0028	2F	3	26	15	2	1500	940	-560	0.13	0.63	2	1	-1
0028	2F	4	12	3463	983	346300	287420	-58880	0.28	0.83	612	508	-104
0028	2F	4	13	1340	364	134000	106990	-27010	0.27	0.80	237	189	-48
0028	2F	4	14	686	155	68600	54140	-14460	0.23	0.79	121	95	-26
0028	2F	4	15	96	20	9600	12110	2510	0.21	1.26	16	21	5
0028	2F	4	16	108	20	10800	11610	810	0.19	1.08	19	20	1
0028	2F	4	23	39	5	3900	1180	-2720	0.13	0.30	6	2	-4
0028	2F	4	24	22	5	2200	1790	-410	0.23	0.81	3	3	0
0028	2F	4	25	8	2	800	1020	220	0.25	1.28	1	1	0
0028	2F	4	26	16	1	1600	770	-830	0.06	0.48	2	1	-1
0028	2F	5	12	3546	1214	354600	306850	-47750	0.34	0.87	627	543	-84
0028	2F	5	13	1273	416	127300	110590	-16710	0.33	0.87	225	195	-30
0028	2F	5	14	663	186	66300	50690	-15610	0.28	0.76	117	89	-28
0028	2F	5	15	87	21	8700	8950	250	0.24	1.03	15	15	0
0028	2F	5	16	98	17	9800	7250	-2550	0.17	0.74	17	12	-5
0028	2F	5	23	30	7	3000	2120	-880	0.23	0.71	5	3	-2
0028	2F	5	24	37	4	3700	2780	-920	0.11	0.75	6	4	-2
0028	2F	5	25	10	3	1000	1810	810	0.30	1.81	1	3	2
0028	2F	5	26	12	2	1200	650	-550	0.17	0.54	2	1	-1
0028	2F	6	12	2731	826	273100	235490	-37610	0.30	0.86	483	416	-67
0028	2F	6	13	1344	425	134400	107740	-26660	0.32	0.80	237	190	-47
0028	2F	6	14	685	167	68500	48680	-19820	0.24	0.71	121	86	-35
0028	2F	6	15	147	30	14700	12230	-2470	0.20	0.83	26	21	-5
0028	2F	6	16	229	40	22900	18860	-4040	0.17	0.82	40	33	-7
0028	2F	6	23	73	20	7300	7290	-10	0.27	1.00	12	12	0
0028	2F	6	24	40	7	4000	2390	-1610	0.18	0.60	7	4	-3
0028	2F	6	25	30	4	3000	1700	-1300	0.13	0.57	5	3	-2
0028	2F	6	26	56	7	5600	2280	-3320	0.13	0.41	9	4	-5
0028	2F	7	12	2612	825	261200	232570	-28630	0.32	0.89	462	411	-51
0028	2F	7	13	1460	495	146000	121970	-24030	0.34	0.84	258	215	-43
0028	2F	7	14	808	275	80800	74760	-6040	0.34	0.93	143	132	-11
0028	2F	7	15	184	43	18400	15960	-2440	0.23	0.87	32	28	-4
0028	2F	7	16	213	60	21300	27310	6010	0.28	1.28	37	48	11
0028	2F	7	23	52	14	5200	4370	-830	0.27	0.84	9	7	-2
0028	2F	7	24	35	8	3500	2330	-1170	0.23	0.67	6	4	-2
0028	2F	7	25	20	3	2000	840	-1160	0.15	0.42	3	1	-2
0028	2F	7	26	44	7	4400	4030	-370	0.16	0.92	7	7	0
0028	2F	8	12	2560	837	256000	223520	-32480	0.33	0.87	453	395	-58
0028	2F	8	13	1324	434	132400	102450	-29950	0.33	0.77	234	181	-53
0028	2F	8	14	850	273	85000	71350	-13650	0.32	0.84	150	126	-24
0028	2F	8	15	334	96	33400	28080	-5320	0.29	0.84	59	49	-10
0028	2F	8	16	143	32	14300	15260	960	0.22	1.07	25	27	2
0028	2F	8	23	48	12	4800	2730	-2070	0.25	0.57	8	4	-4
0028	2F	8	24	20	2	2000	660	-1340	0.10	0.33	3	1	-2
0028	2F	8	25	18	3	1800	1230	-570	0.17	0.68	3	2	-1
0028	2F	8	26	23	3	2300	850	-1450	0.13	0.37	4	1	-3
0028	2F	9	12	3074	1052	307400	258750	-48650	0.34	0.84	544	457	-87
0028	2F	9	13	1480	464	148000	112840	-35160	0.31	0.76	261	199	-62
0028	2F	9	14	816	246	81600	63400	-18200	0.30	0.78	144	112	-32
0028	2F	9	15	147	37	14700	11040	-3660	0.25	0.75	26	19	-7
0028	2F	9	16	114	18	11400	5830	-5570	0.16	0.51	20	10	-10
0028	2F	9	23	25	8	2500	3040	540	0.32	1.22	4	5	1
0028	2F	9	24	18	5	1800	2620	820	0.28	1.46	3	4	1
0028	2F	9	25	20	3	2000	1150	-850	0.15	0.58	3	2	-1
0028	2F	9	26	12	2	1200	630	-570	0.17	0.53	2	1	-1
0028	2T	1	12	3966	989	396600	319940	-76660	0.25	0.81	701	566	-135
0028	2T	1	13	1233	265	123300	92790	-30510	0.21	0.75	218	164	-54
0028	2T	1	14	662	136	66200	48790	-17410	0.21	0.74	117	86	-31
0028	2T	1	15	50	6	5000	4910	-90	0.12	0.98	8	8	0
0028	2T	1	16	60	4	6000	2090	-3910	0.07	0.35	10	3	-7
0028	2T	1	21	1	0	100	0	-100	0.00	0.00	0	0	0
0028	2T	1	23	9	0	900	0	-900	0.00	0.00	1	0	-1
0028	2T	1	24	1	0	100	0	-100	0.00	0.00	0	0	0
0028	2T	1	25	2	1	200	520	320	0.50	2.60	0	0	0
0028	2T	1	26	2	0	200	0	-200	0.00	0.00	0	0	0
0028	2T	10	12	3993	986	399300	306550	-92750	0.25	0.77	706	542	-164
0028	2T	10	13	1460	340	146000	115120	-30880	0.23	0.79	258	203	-55
0028	2T	10	14	502	99	50200	37970	-12230	0.20	0.76	88	67	-21
0028	2T	10	15	62	13	6200	9470	3270	0.21	1.53	10	16	6
0028	2T	10	16	46	7	4600	5530	930	0.15	1.20	8	9	1
0028	2T	10	21	7	0	700	0	-700	0.00	0.00	1	0	-1
0028	2T	10	23	11	2	1100	5010	3910	0.18	4.55	1	8	7
0028	2T	10	24	7	0	700	0	-700	0.00	0.00	1	0	-1
0028	2T	10	25	3	0	300	0	-300	0.00	0.00	0	0	0
0028	2T	10	26	5	0	500	0	-500	0.00	0.00	0	0	0
0028	2T	11	12	4218	1133	421800	334330	-87470	0.27	0.79	746	591	-155
0028	2T	11	13	1599	377	159900	121750	-38150	0.24	0.76	283	215	-68
0028	2T	11	14	554	113	55400	41120	-14280	0.20	0.74	98	72	-26
0028	2T	11	15	33	5	3300	4080	780	0.15	1.24	5	7	2
0028	2T	11	16	3	1	300	540	240	0.33	1.80	0	0	0
0028	2T	12	12	5896	1543	589600	479380	-110220	0.26	0.81	1043	848	-195
0028	2T	12	13	426	118	42600	35990	-6610	0.28	0.84	75	63	-12
0028	2T	12	14	67	6	6700	2060	-4640	0.09	0.31	11	3	-8
0028	2T	12	15	1	0	100	0	-100	0.00	0.00	0	0	0
0028	2T	2	12	3047	620	304700	258420	-46280	0.20	0.85	539	457	-82
0028	2T	2	13	864	140	86400	61730	-24670	0.16	0.71	152	109	-43
0028	2T	2	14	436	78	43600	27650	-15950	0.18	0.63	77	48	-29
0028	2T	2	15	33	6	3300	3360	60	0.18	1.02	5	5	0
0028	2T	2	16	50	5	5000	3140	-1860	0.10	0.63	8	5	-3
0028	2T	2	21	100	4	10000	4400	-5600	0.04	0.44	17	7	-10
0028	2T	2	23	54	5	5400	4440	-960	0.09	0.82	9	7	-2
0028	2T	2	24	7	0	700	0	-700	0.00	0.00	1	0	-1
0028	2T	2	25	17	2	1700	1410	-290	0.12	0.83	3	2	-1
0028	2T	2	26	20	1	2000	710	-1290	0.05	0.36	3	1	-2
0028	2T	3	12	3282	555	328200	297390	-30810	0.17	0.91	580	526	-54
0028	2T	3	13	1652	363	165200	135500	-29700	0.22	0.82	292	239	-53
0028	2T	3	14	537	81	53700	46230	-7470	0.15	0.86	95	81	-14
0028	2T	3	15	94	12	9400	11830	2430	0.13	1.26	16	20	4
0028	2T	3	16	41	2	4100	1340	-2760	0.05	0.33	7	2	-5
0028	2T	3	21	10	0	1000	0	-1000	0.00	0.00	1	0	-1
0028	2T	3	23	49	7	4900	4020	-880	0.14	0.82	8	7	-1
0028	2T	3	24	15	0	1500	0	-1500	0.00	0.00	2	0	-2
0028	2T	3	25	23	2	2300	1260	-1040	0.09	0.55	4	2	-2
0028	2T	3	26	15	1	1500	720	-780	0.07	0.48	2	1	-1
0028	2T	4	12	3462	690	346200	269160	-77040	0.20	0.78	612	476	-136
0028	2T	4	13	1340	275	134000	111870	-22130	0.21	0.83	237	198	-39
0028	2T	4	14	686	115	68600	57180	-11420	0.17	0.83	121	101	-20
0028	2T	4	15	96	14	9600	12890	3290	0.15	1.34	16	22	6
0028	2T	4	16	108	16	10800	18400	7600	0.15	1.70	19	32	13
0028	2T	4	21	1	0	100	0	-100	0.00	0.00	0	0	0
0028	2T	4	23	39	2	3900	520	-3380	0.05	0.13	6	0	-6
0028	2T	4	24	22	1	2200	570	-1630	0.05	0.26	3	1	-2
0028	2T	4	25	8	2	800	1630	830	0.25	2.04	1	2	1
0028	2T	4	26	16	1	1600	1160	-440	0.06	0.73	2	2	0
0028	2T	5	12	3546	873	354600	294290	-60310	0.25	0.83	627	520	-107
0028	2T	5	13	1273	298	127300	112460	-14840	0.23	0.88	225	199	-26
0028	2T	5	14	663	139	66300	53620	-12680	0.21	0.81	117	94	-23
0028	2T	5	15	87	18	8700	14390	5690	0.21	1.65	15	25	10
0028	2T	5	16	98	13	9800	9800	0	0.13	1.00	17	17	0
0028	2T	5	23	30	6	3000	3030	30	0.20	1.01	5	5	0
0028	2T	5	24	37	1	3700	430	-3270	0.03	0.12	6	0	-6
0028	2T	5	25	10	2	1000	3250	2250	0.20	3.25	1	5	4
0028	2T	5	26	12	1	1200	240	-960	0.08	0.20	2	0	-2
0028	2T	6	12	2730	558	273000	219040	-53960	0.20	0.80	483	387	-96
0028	2T	6	13	1344	278	134400	101320	-33080	0.21	0.75	237	179	-58
0028	2T	6	14	685	126	68500	52170	-16330	0.18	0.76	121	92	-29
0028	2T	6	15	147	20	14700	10930	-3770	0.14	0.74	26	19	-7
0028	2T	6	16	229	27	22900	22340	-560	0.12	0.98	40	39	-1
0028	2T	6	21	1	0	100	0	-100	0.00	0.00	0	0	0
0028	2T	6	23	73	13	7300	6660	-640	0.18	0.91	12	11	-1
0028	2T	6	24	40	7	4000	4600	600	0.18	1.15	7	8	1
0028	2T	6	25	30	3	3000	2120	-880	0.10	0.71	5	3	-2
0028	2T	6	26	56	5	5600	4410	-1190	0.09	0.79	9	7	-2
0028	2T	7	12	2608	569	260800	218640	-42160	0.22	0.84	461	386	-75
0028	2T	7	13	1460	328	146000	111060	-34940	0.22	0.76	258	196	-62
0028	2T	7	14	808	200	80800	78800	-2000	0.25	0.98	143	139	-4
0028	2T	7	15	184	34	18400	17120	-1280	0.18	0.93	32	30	-2
0028	2T	7	16	213	44	21300	30010	8710	0.21	1.41	37	53	16
0028	2T	7	21	4	1	400	700	300	0.25	1.75	0	1	1
0028	2T	7	23	52	9	5200	4910	-290	0.17	0.94	9	8	-1
0028	2T	7	24	35	3	3500	2070	-1430	0.09	0.59	6	3	-3
0028	2T	7	25	20	2	2000	960	-1040	0.10	0.48	3	1	-2
0028	2T	7	26	44	6	4400	5840	1440	0.14	1.33	7	10	3
0028	2T	8	12	2557	607	255700	219230	-36470	0.24	0.86	452	388	-64
0028	2T	8	13	1324	308	132400	101830	-30570	0.23	0.77	234	180	-54
0028	2T	8	14	850	192	85000	70800	-14200	0.23	0.83	150	125	-25
0028	2T	8	15	334	63	33400	26630	-6770	0.19	0.80	59	47	-12
0028	2T	8	16	143	24	14300	16830	2530	0.17	1.18	25	29	4
0028	2T	8	21	3	1	300	1130	830	0.33	3.77	0	2	2
0028	2T	8	23	48	9	4800	3020	-1780	0.19	0.63	8	5	-3
0028	2T	8	24	20	1	2000	960	-1040	0.05	0.48	3	1	-2
0028	2T	8	25	18	2	1800	2190	390	0.11	1.22	3	3	0
0028	2T	8	26	23	2	2300	1050	-1250	0.09	0.46	4	1	-3
0028	2T	9	12	3070	775	307000	248190	-58810	0.25	0.81	543	439	-104
0028	2T	9	13	1480	342	148000	112800	-35200	0.23	0.76	261	199	-62
0028	2T	9	14	816	173	81600	60620	-20980	0.21	0.74	144	107	-37
0028	2T	9	15	147	30	14700	13240	-1460	0.20	0.90	26	23	-3
0028	2T	9	16	114	12	11400	5800	-5600	0.11	0.51	20	10	-10
0028	2T	9	21	4	0	400	0	-400	0.00	0.00	0	0	0
0028	2T	9	23	25	6	2500	3720	1220	0.24	1.49	4	6	2
0028	2T	9	24	18	3	1800	2750	950	0.17	1.53	3	4	1
0028	2T	9	25	20	1	2000	2070	70	0.05	1.04	3	3	0
0028	2T	9	26	12	2	1200	1030	-170	0.17	0.86	2	1	-1
0028	3F	1	123	2917	635	291700	251310	-40390	0.22	0.86	516	444	-72
0028	3F	1	124	566	116	56600	39590	-17010	0.20	0.70	100	70	-30
0028	3F	1	125	266	48	26600	21980	-4620	0.18	0.83	47	38	-9
0028	3F	1	126	131	21	13100	12540	-560	0.16	0.96	23	22	-1
0028	3F	1	134	564	96	56400	39970	-16430	0.17	0.71	99	70	-29
0028	3F	1	135	85	18	8500	6260	-2240	0.21	0.74	15	11	-4
0028	3F	1	136	61	6	6100	2110	-3990	0.10	0.35	10	3	-7
0028	3F	1	145	39	8	3900	3160	-740	0.21	0.81	6	5	-1
0028	3F	1	146	13	4	1300	2050	750	0.31	1.58	2	3	1
0028	3F	1	234	2	0	200	0	-200	0.00	0.00	0	0	0
0028	3F	1	235	3	1	300	220	-80	0.33	0.73	0	0	0
0028	3F	1	236	1	1	100	1890	1790	1.00	18.90	0	3	3
0028	3F	10	123	696	194	69600	53780	-15820	0.28	0.77	123	95	-28
0028	3F	10	124	2062	421	206200	151080	-55120	0.20	0.73	364	267	-97
0028	3F	10	125	693	125	69300	61740	-7560	0.18	0.89	122	109	-13
0028	3F	10	126	533	78	53300	46710	-6590	0.15	0.88	94	82	-12
0028	3F	10	134	567	120	56700	47620	-9080	0.21	0.84	100	84	-16
0028	3F	10	135	413	85	41300	37890	-3410	0.21	0.92	73	67	-6
0028	3F	10	136	259	25	25900	12520	-13380	0.10	0.48	45	22	-23
0028	3F	10	145	98	8	9800	4290	-5510	0.08	0.44	17	7	-10
0028	3F	10	146	74	10	7400	5160	-2240	0.14	0.70	13	9	-4
0028	3F	10	156	11	3	1100	1710	610	0.27	1.55	1	3	2
0028	3F	10	234	4	0	400	0	-400	0.00	0.00	0	0	0
0028	3F	10	235	4	1	400	360	-40	0.25	0.90	0	0	0
0028	3F	10	236	1	0	100	0	-100	0.00	0.00	0	0	0
0028	3F	10	245	4	0	400	0	-400	0.00	0.00	0	0	0
0028	3F	10	246	1	0	100	0	-100	0.00	0.00	0	0	0
0028	3F	11	123	1487	353	148700	115600	-33100	0.24	0.78	263	204	-59
0028	3F	11	124	2200	413	220000	156390	-63610	0.19	0.71	389	276	-113
0028	3F	11	125	407	76	40700	43550	2850	0.19	1.07	72	77	5
0028	3F	11	126	108	11	10800	8840	-1960	0.10	0.82	19	15	-4
0028	3F	11	134	881	162	88100	63940	-24160	0.18	0.73	155	113	-42
0028	3F	11	135	162	21	16200	10500	-5700	0.13	0.65	28	18	-10
0028	3F	11	136	2	1	200	470	270	0.50	2.35	0	0	0
0028	3F	11	145	47	6	4700	2030	-2670	0.13	0.43	8	3	-5
0028	3F	11	146	34	3	3400	2680	-720	0.09	0.79	6	4	-2
0028	3F	11	156	2	0	200	0	-200	0.00	0.00	0	0	0
0028	3F	12	123	2024	487	202400	165560	-36840	0.24	0.82	358	293	-65
0028	3F	12	124	3564	607	356400	262370	-94030	0.17	0.74	630	464	-166
0028	3F	12	125	217	36	21700	20830	-870	0.17	0.96	38	36	-2
0028	3F	12	126	45	3	4500	2080	-2420	0.07	0.46	7	3	-4
0028	3F	12	134	195	41	19500	15460	-4040	0.21	0.79	34	27	-7
0028	3F	12	135	2	0	200	0	-200	0.00	0.00	0	0	0
0028	3F	12	145	3	0	300	0	-300	0.00	0.00	0	0	0
0028	3F	12	146	2	0	200	0	-200	0.00	0.00	0	0	0
0028	3F	2	123	1675	391	167500	146730	-20770	0.23	0.88	296	259	-37
0028	3F	2	124	792	159	79200	59160	-20040	0.20	0.75	140	104	-36
0028	3F	2	125	337	61	33700	34290	590	0.18	1.02	59	60	1
0028	3F	2	126	160	19	16000	9630	-6370	0.12	0.60	28	17	-11
0028	3F	2	134	163	42	16300	17730	1430	0.26	1.09	28	31	3
0028	3F	2	135	93	14	9300	6260	-3040	0.15	0.67	16	11	-5
0028	3F	2	136	43	8	4300	4280	-20	0.19	1.00	7	7	0
0028	3F	2	145	36	5	3600	1900	-1700	0.14	0.53	6	3	-3
0028	3F	2	146	11	3	1100	1510	410	0.27	1.37	1	2	1
0028	3F	2	156	2	1	200	370	170	0.50	1.85	0	0	0
0028	3F	2	234	2	0	200	0	-200	0.00	0.00	0	0	0
0028	3F	2	235	6	0	600	0	-600	0.00	0.00	1	0	-1
0028	3F	2	236	8	0	800	0	-800	0.00	0.00	1	0	-1
0028	3F	2	245	2	0	200	0	-200	0.00	0.00	0	0	0
0028	3F	2	246	1	0	100	0	-100	0.00	0.00	0	0	0
0028	3F	2	256	2	1	200	260	60	0.50	1.30	0	0	0
0028	3F	3	123	1099	235	109900	84710	-25190	0.21	0.77	194	149	-45
0028	3F	3	124	1080	186	108000	93500	-14500	0.17	0.87	191	165	-26
0028	3F	3	125	525	96	52500	63130	10630	0.18	1.20	92	111	19
0028	3F	3	126	550	86	55000	47010	-7990	0.16	0.85	97	83	-14
0028	3F	3	134	364	78	36400	30350	-6050	0.21	0.83	64	53	-11
0028	3F	3	135	385	84	38500	29090	-9410	0.22	0.76	68	51	-17
0028	3F	3	136	255	36	25500	16520	-8980	0.14	0.65	45	29	-16
0028	3F	3	145	115	10	11500	4620	-6880	0.09	0.40	20	8	-12
0028	3F	3	146	90	12	9000	6870	-2130	0.13	0.76	15	12	-3
0028	3F	3	156	23	6	2300	2540	240	0.26	1.10	4	4	0
0028	3F	3	234	8	0	800	0	-800	0.00	0.00	1	0	-1
0028	3F	3	235	13	3	1300	1310	10	0.23	1.01	2	2	0
0028	3F	3	236	12	0	1200	0	-1200	0.00	0.00	2	0	-2
0028	3F	3	246	3	0	300	0	-300	0.00	0.00	0	0	0
0028	3F	3	256	4	0	400	0	-400	0.00	0.00	0	0	0
0028	3F	4	123	938	238	93800	72340	-21460	0.25	0.77	166	128	-38
0028	3F	4	124	1295	233	129500	86500	-43000	0.18	0.67	229	153	-76
0028	3F	4	125	479	74	47900	35080	-12820	0.15	0.73	84	62	-22
0028	3F	4	126	660	91	66000	64500	-1500	0.14	0.98	116	114	-2
0028	3F	4	134	383	71	38300	21790	-16510	0.19	0.57	67	38	-29
0028	3F	4	135	320	55	32000	22540	-9460	0.17	0.70	56	39	-17
0028	3F	4	136	345	49	34500	24490	-10010	0.14	0.71	61	43	-18
0028	3F	4	145	140	17	14000	10900	-3100	0.12	0.78	24	19	-5
0028	3F	4	146	158	23	15800	17720	1920	0.15	1.12	27	31	4
0028	3F	4	156	24	4	2400	3390	990	0.17	1.41	4	6	2
0028	3F	4	234	6	0	600	0	-600	0.00	0.00	1	0	-1
0028	3F	4	235	8	0	800	0	-800	0.00	0.00	1	0	-1
0028	3F	4	236	12	1	1200	420	-780	0.08	0.35	2	0	-2
0028	3F	4	245	5	1	500	210	-290	0.20	0.42	0	0	0
0028	3F	4	246	4	0	400	0	-400	0.00	0.00	0	0	0
0028	3F	4	256	3	0	300	0	-300	0.00	0.00	0	0	0
0028	3F	5	123	1009	273	100900	86240	-14660	0.27	0.85	178	152	-26
0028	3F	5	124	1340	366	134000	111080	-22920	0.27	0.83	237	196	-41
0028	3F	5	125	562	122	56200	45240	-10960	0.22	0.80	99	80	-19
0028	3F	5	126	549	75	54900	44700	-10200	0.14	0.81	97	79	-18
0028	3F	5	134	434	123	43400	36210	-7190	0.28	0.83	76	64	-12
0028	3F	5	135	271	52	27100	20740	-6360	0.19	0.77	47	36	-11
0028	3F	5	136	260	48	26000	20940	-5060	0.18	0.81	46	37	-9
0028	3F	5	145	113	22	11300	8170	-3130	0.19	0.72	20	14	-6
0028	3F	5	146	90	11	9000	4290	-4710	0.12	0.48	15	7	-8
0028	3F	5	156	22	4	2200	1970	-230	0.18	0.90	3	3	0
0028	3F	5	234	9	3	900	1050	150	0.33	1.17	1	1	0
0028	3F	5	235	7	1	700	320	-380	0.14	0.46	1	0	-1
0028	3F	5	236	9	2	900	450	-450	0.22	0.50	1	0	-1
0028	3F	5	245	6	0	600	0	-600	0.00	0.00	1	0	-1
0028	3F	5	246	7	2	700	620	-80	0.29	0.89	1	1	0
0028	3F	5	256	1	0	100	0	-100	0.00	0.00	0	0	0
0028	3F	6	123	675	228	67500	59290	-8210	0.34	0.88	119	104	-15
0028	3F	6	124	912	193	91200	66030	-25170	0.21	0.72	161	116	-45
0028	3F	6	125	559	104	55900	40450	-15450	0.19	0.72	98	71	-27
0028	3F	6	126	526	82	52600	38810	-13790	0.16	0.74	93	68	-25
0028	3F	6	134	412	98	41200	28580	-12620	0.24	0.69	72	50	-22
0028	3F	6	135	316	64	31600	28770	-2830	0.20	0.91	55	50	-5
0028	3F	6	136	318	54	31800	26860	-4940	0.17	0.84	56	47	-9
0028	3F	6	145	140	24	14000	9680	-4320	0.17	0.69	24	17	-7
0028	3F	6	146	111	15	11100	6230	-4870	0.14	0.56	19	11	-8
0028	3F	6	156	39	5	3900	2220	-1680	0.13	0.57	6	3	-3
0028	3F	6	234	19	4	1900	1290	-610	0.21	0.68	3	2	-1
0028	3F	6	235	23	6	2300	1620	-680	0.26	0.70	4	2	-2
0028	3F	6	236	23	2	2300	1030	-1270	0.09	0.45	4	1	-3
0028	3F	6	245	12	3	1200	1250	50	0.25	1.04	2	2	0
0028	3F	6	246	6	1	600	190	-410	0.17	0.32	1	0	-1
0028	3F	6	256	4	0	400	0	-400	0.00	0.00	0	0	0
0028	3F	7	123	604	149	60400	47570	-12830	0.25	0.79	106	84	-22
0028	3F	7	124	857	217	85700	71150	-14550	0.25	0.83	151	125	-26
0028	3F	7	125	534	90	53400	33030	-20370	0.17	0.62	94	58	-36
0028	3F	7	126	572	83	57200	46120	-11080	0.15	0.81	101	81	-20
0028	3F	7	134	409	116	40900	32050	-8850	0.28	0.78	72	56	-16
0028	3F	7	135	326	67	32600	26530	-6070	0.21	0.81	57	46	-11
0028	3F	7	136	368	62	36800	25470	-11330	0.17	0.69	65	45	-20
0028	3F	7	145	201	42	20100	16040	-4060	0.21	0.80	35	28	-7
0028	3F	7	146	115	15	11500	5760	-5740	0.13	0.50	20	10	-10
0028	3F	7	156	46	8	4600	4060	-540	0.17	0.88	8	7	-1
0028	3F	7	234	11	2	1100	620	-480	0.18	0.56	1	1	0
0028	3F	7	235	10	4	1000	1220	220	0.40	1.22	1	2	1
0028	3F	7	236	15	1	1500	310	-1190	0.07	0.21	2	0	-2
0028	3F	7	245	5	0	500	0	-500	0.00	0.00	0	0	0
0028	3F	7	246	10	1	1000	430	-570	0.10	0.43	1	0	-1
0028	3F	7	256	5	1	500	620	120	0.20	1.24	0	1	1
0028	3F	8	123	587	180	58700	49050	-9650	0.31	0.84	103	86	-17
0028	3F	8	124	930	239	93000	68520	-24480	0.26	0.74	164	121	-43
0028	3F	8	125	504	117	50400	45890	-4510	0.23	0.91	89	81	-8
0028	3F	8	126	480	70	48000	40470	-7530	0.15	0.84	84	71	-13
0028	3F	8	134	316	70	31600	21870	-9730	0.22	0.69	55	38	-17
0028	3F	8	135	277	57	27700	18780	-8920	0.21	0.68	49	33	-16
0028	3F	8	136	344	57	34400	23800	-10600	0.17	0.69	60	42	-18
0028	3F	8	145	134	31	13400	11640	-1760	0.23	0.87	23	20	-3
0028	3F	8	146	117	13	11700	6510	-5190	0.11	0.56	20	11	-9
0028	3F	8	156	41	2	4100	730	-3370	0.05	0.18	7	1	-6
0028	3F	8	234	12	2	1200	600	-600	0.17	0.50	2	1	-1
0028	3F	8	235	17	1	1700	200	-1500	0.06	0.12	3	0	-3
0028	3F	8	236	8	1	800	290	-510	0.13	0.36	1	0	-1
0028	3F	8	245	8	0	800	0	-800	0.00	0.00	1	0	-1
0028	3F	8	246	5	0	500	0	-500	0.00	0.00	0	0	0
0028	3F	8	256	5	0	500	0	-500	0.00	0.00	0	0	0
0028	3F	9	123	705	225	70500	65910	-4590	0.32	0.93	124	116	-8
0028	3F	9	124	1182	259	118200	87120	-31080	0.22	0.74	209	154	-55
0028	3F	9	125	545	105	54500	47200	-7300	0.19	0.87	96	83	-13
0028	3F	9	126	542	83	54200	49330	-4870	0.15	0.91	95	87	-8
0028	3F	9	134	437	116	43700	37170	-6530	0.27	0.85	77	65	-12
0028	3F	9	135	334	60	33400	21120	-12280	0.18	0.63	59	37	-22
0028	3F	9	136	302	55	30200	27020	-3180	0.18	0.89	53	47	-6
0028	3F	9	145	137	31	13700	11920	-1780	0.23	0.87	24	21	-3
0028	3F	9	146	100	13	10000	4460	-5540	0.13	0.45	17	7	-10
0028	3F	9	156	24	4	2400	1840	-560	0.17	0.77	4	3	-1
0028	3F	9	234	2	1	200	340	140	0.50	1.70	0	0	0
0028	3F	9	235	9	4	900	1710	810	0.44	1.90	1	3	2
0028	3F	9	236	11	0	1100	0	-1100	0.00	0.00	1	0	-1
0028	3F	9	245	1	0	100	0	-100	0.00	0.00	0	0	0
0028	3F	9	246	7	1	700	2100	1400	0.14	3.00	1	3	2
0028	3F	9	256	4	2	400	710	310	0.50	1.78	0	1	1
0028	3T	1	123	2881	285	288100	241560	-46540	0.10	0.84	509	427	-82
0028	3T	1	124	535	44	53500	42260	-11240	0.08	0.79	94	74	-20
0028	3T	1	125	265	21	26500	19140	-7360	0.08	0.72	46	33	-13
0028	3T	1	126	129	9	12900	8580	-4320	0.07	0.67	22	15	-7
0028	3T	1	132	35	4	3500	4650	1150	0.11	1.33	6	8	2
0028	3T	1	134	154	14	15400	13020	-2380	0.09	0.85	27	23	-4
0028	3T	1	135	68	7	6800	7710	910	0.10	1.13	12	13	1
0028	3T	1	136	35	1	3500	380	-3120	0.03	0.11	6	0	-6
0028	3T	1	142	31	1	3100	790	-2310	0.03	0.25	5	1	-4
0028	3T	1	143	410	30	41000	37850	-3150	0.07	0.92	72	66	-6
0028	3T	1	145	39	6	3900	5610	1710	0.15	1.44	6	9	3
0028	3T	1	146	13	1	1300	1440	140	0.08	1.11	2	2	0
0028	3T	1	152	1	0	100	0	-100	0.00	0.00	0	0	0
0028	3T	1	153	17	1	1700	1170	-530	0.06	0.69	3	2	-1
0028	3T	1	162	2	0	200	0	-200	0.00	0.00	0	0	0
0028	3T	1	163	26	0	2600	0	-2600	0.00	0.00	4	0	-4
0028	3T	1	213	1	0	100	0	-100	0.00	0.00	0	0	0
0028	3T	1	234	1	0	100	0	-100	0.00	0.00	0	0	0
0028	3T	1	235	1	0	100	0	-100	0.00	0.00	0	0	0
0028	3T	1	236	1	0	100	0	-100	0.00	0.00	0	0	0
0028	3T	1	243	1	0	100	0	-100	0.00	0.00	0	0	0
0028	3T	1	253	2	1	200	930	730	0.50	4.65	0	1	1
0028	3T	10	123	695	79	69500	50520	-18980	0.11	0.73	123	89	-34
0028	3T	10	124	2061	171	206100	137210	-68890	0.08	0.67	364	242	-122
0028	3T	10	125	692	57	69200	68490	-710	0.08	0.99	122	121	-1
0028	3T	10	126	528	33	52800	45960	-6840	0.06	0.87	93	81	-12
0028	3T	10	132	1	1	100	640	540	1.00	6.40	0	1	1
0028	3T	10	134	565	51	56500	45040	-11460	0.09	0.80	100	79	-21
0028	3T	10	135	413	34	41300	34250	-7050	0.08	0.83	73	60	-13
0028	3T	10	136	259	12	25900	13520	-12380	0.05	0.52	45	23	-22
0028	3T	10	143	2	0	200	0	-200	0.00	0.00	0	0	0
0028	3T	10	145	95	3	9500	2160	-7340	0.03	0.23	16	3	-13
0028	3T	10	146	74	7	7400	8070	670	0.09	1.09	13	14	1
0028	3T	10	154	3	0	300	0	-300	0.00	0.00	0	0	0
0028	3T	10	156	11	1	1100	760	-340	0.09	0.69	1	1	0
0028	3T	10	214	1	0	100	0	-100	0.00	0.00	0	0	0
0028	3T	10	215	1	0	100	0	-100	0.00	0.00	0	0	0
0028	3T	10	216	5	0	500	0	-500	0.00	0.00	0	0	0
0028	3T	10	234	4	0	400	0	-400	0.00	0.00	0	0	0
0028	3T	10	235	4	0	400	0	-400	0.00	0.00	0	0	0
0028	3T	10	236	1	0	100	0	-100	0.00	0.00	0	0	0
0028	3T	10	245	4	0	400	0	-400	0.00	0.00	0	0	0
0028	3T	10	246	1	0	100	0	-100	0.00	0.00	0	0	0
0028	3T	11	123	1487	178	148700	132570	-16130	0.12	0.89	263	234	-29
0028	3T	11	124	2199	195	219900	161560	-58340	0.09	0.73	389	285	-104
0028	3T	11	125	407	37	40700	46490	5790	0.09	1.14	72	82	10
0028	3T	11	126	108	5	10800	5960	-4840	0.05	0.55	19	10	-9
0028	3T	11	134	805	75	80500	65990	-14510	0.09	0.82	142	116	-26
0028	3T	11	135	140	5	14000	4260	-9740	0.04	0.30	24	7	-17
0028	3T	11	142	1	0	100	0	-100	0.00	0.00	0	0	0
0028	3T	11	143	76	3	7600	5700	-1900	0.04	0.75	13	10	-3
0028	3T	11	145	47	4	4700	3070	-1630	0.09	0.65	8	5	-3
0028	3T	11	146	34	1	3400	1790	-1610	0.03	0.53	6	3	-3
0028	3T	11	153	22	1	2200	9140	6940	0.05	4.15	3	16	13
0028	3T	11	156	2	0	200	0	-200	0.00	0.00	0	0	0
0028	3T	11	163	2	1	200	2140	1940	0.50	10.70	0	3	3
0028	3T	12	123	2018	241	201800	174960	-26840	0.12	0.87	357	309	-48
0028	3T	12	124	3562	291	356200	266140	-90060	0.08	0.75	630	471	-159
0028	3T	12	125	217	21	21700	27860	6160	0.10	1.28	38	49	11
0028	3T	12	126	45	2	4500	2220	-2280	0.04	0.49	7	3	-4
0028	3T	12	132	6	1	600	1030	430	0.17	1.72	1	1	0
0028	3T	12	134	177	17	17700	15000	-2700	0.10	0.85	31	26	-5
0028	3T	12	135	2	0	200	0	-200	0.00	0.00	0	0	0
0028	3T	12	142	2	0	200	0	-200	0.00	0.00	0	0	0
0028	3T	12	143	18	0	1800	0	-1800	0.00	0.00	3	0	-3
0028	3T	12	145	3	0	300	0	-300	0.00	0.00	0	0	0
0028	3T	12	146	2	0	200	0	-200	0.00	0.00	0	0	0
0028	3T	2	123	1607	138	160700	143070	-17630	0.09	0.89	284	253	-31
0028	3T	2	124	765	56	76500	59360	-17140	0.07	0.78	135	105	-30
0028	3T	2	125	319	19	31900	27010	-4890	0.06	0.85	56	47	-9
0028	3T	2	126	145	4	14500	6530	-7970	0.03	0.45	25	11	-14
0028	3T	2	132	18	1	1800	2170	370	0.06	1.21	3	3	0
0028	3T	2	134	120	9	12000	12340	340	0.08	1.03	21	21	0
0028	3T	2	135	89	5	8900	4570	-4330	0.06	0.51	15	8	-7
0028	3T	2	136	35	5	3500	8990	5490	0.14	2.57	6	15	9
0028	3T	2	142	27	0	2700	0	-2700	0.00	0.00	4	0	-4
0028	3T	2	143	43	1	4300	3270	-1030	0.02	0.76	7	5	-2
0028	3T	2	145	36	3	3600	2490	-1110	0.08	0.69	6	4	-2
0028	3T	2	146	11	0	1100	0	-1100	0.00	0.00	1	0	-1
0028	3T	2	152	1	0	100	0	-100	0.00	0.00	0	0	0
0028	3T	2	153	4	0	400	0	-400	0.00	0.00	0	0	0
0028	3T	2	156	2	0	200	0	-200	0.00	0.00	0	0	0
0028	3T	2	163	8	0	800	0	-800	0.00	0.00	1	0	-1
0028	3T	2	213	20	2	2000	8330	6330	0.10	4.17	3	14	11
0028	3T	2	215	11	0	1100	0	-1100	0.00	0.00	1	0	-1
0028	3T	2	216	8	0	800	0	-800	0.00	0.00	1	0	-1
0028	3T	2	231	30	2	3000	5660	2660	0.07	1.89	5	10	5
0028	3T	2	235	2	0	200	0	-200	0.00	0.00	0	0	0
0028	3T	2	236	3	0	300	0	-300	0.00	0.00	0	0	0
0028	3T	2	243	2	0	200	0	-200	0.00	0.00	0	0	0
0028	3T	2	245	2	0	200	0	-200	0.00	0.00	0	0	0
0028	3T	2	246	1	0	100	0	-100	0.00	0.00	0	0	0
0028	3T	2	251	6	0	600	0	-600	0.00	0.00	1	0	-1
0028	3T	2	253	4	0	400	0	-400	0.00	0.00	0	0	0
0028	3T	2	256	2	1	200	710	510	0.50	3.55	0	1	1
0028	3T	2	261	7	0	700	0	-700	0.00	0.00	1	0	-1
0028	3T	2	263	5	0	500	0	-500	0.00	0.00	0	0	0
0028	3T	3	123	1084	84	108400	82710	-25690	0.08	0.76	191	146	-45
0028	3T	3	124	1078	63	107800	92670	-15130	0.06	0.86	190	164	-26
0028	3T	3	125	523	36	52300	72440	20140	0.07	1.39	92	128	36
0028	3T	3	126	548	33	54800	65830	11030	0.06	1.20	96	116	20
0028	3T	3	132	14	3	1400	2140	740	0.21	1.53	2	3	1
0028	3T	3	134	349	25	34900	23990	-10910	0.07	0.69	61	42	-19
0028	3T	3	135	381	39	38100	41850	3750	0.10	1.10	67	74	7
0028	3T	3	136	254	8	25400	10750	-14650	0.03	0.42	44	19	-25
0028	3T	3	142	2	0	200	0	-200	0.00	0.00	0	0	0
0028	3T	3	143	15	1	1500	670	-830	0.07	0.45	2	1	-1
0028	3T	3	145	113	3	11300	5770	-5530	0.03	0.51	20	10	-10
0028	3T	3	146	90	5	9000	8040	-960	0.06	0.89	15	14	-1
0028	3T	3	153	4	0	400	0	-400	0.00	0.00	0	0	0
0028	3T	3	154	2	0	200	0	-200	0.00	0.00	0	0	0
0028	3T	3	156	23	1	2300	2030	-270	0.04	0.88	4	3	-1
0028	3T	3	163	1	0	100	0	-100	0.00	0.00	0	0	0
0028	3T	3	213	1	0	100	0	-100	0.00	0.00	0	0	0
0028	3T	3	215	2	0	200	0	-200	0.00	0.00	0	0	0
0028	3T	3	216	2	0	200	0	-200	0.00	0.00	0	0	0
0028	3T	3	234	7	0	700	0	-700	0.00	0.00	1	0	-1
0028	3T	3	235	9	2	900	2550	1650	0.22	2.83	1	4	3
0028	3T	3	236	11	0	1100	0	-1100	0.00	0.00	1	0	-1
0028	3T	3	243	1	0	100	0	-100	0.00	0.00	0	0	0
0028	3T	3	246	3	0	300	0	-300	0.00	0.00	0	0	0
0028	3T	3	253	4	0	400	0	-400	0.00	0.00	0	0	0
0028	3T	3	256	4	0	400	0	-400	0.00	0.00	0	0	0
0028	3T	3	263	1	0	100	0	-100	0.00	0.00	0	0	0
0028	3T	4	123	933	87	93300	60940	-32360	0.09	0.65	165	107	-58
0028	3T	4	124	1294	84	129400	86610	-42790	0.06	0.67	229	153	-76
0028	3T	4	125	478	33	47800	41700	-6100	0.07	0.87	84	73	-11
0028	3T	4	126	660	36	66000	74170	8170	0.05	1.12	116	131	15
0028	3T	4	132	4	0	400	0	-400	0.00	0.00	0	0	0
0028	3T	4	134	374	25	37400	21870	-15530	0.07	0.58	66	38	-28
0028	3T	4	135	319	22	31900	26320	-5580	0.07	0.83	56	46	-10
0028	3T	4	136	345	26	34500	35680	1180	0.08	1.03	61	63	2
0028	3T	4	142	1	0	100	0	-100	0.00	0.00	0	0	0
0028	3T	4	143	9	1	900	750	-150	0.11	0.83	1	1	0
0028	3T	4	145	138	5	13800	15420	1620	0.04	1.12	24	27	3
0028	3T	4	146	158	9	15800	16670	870	0.06	1.06	27	29	2
0028	3T	4	152	1	0	100	0	-100	0.00	0.00	0	0	0
0028	3T	4	153	1	0	100	0	-100	0.00	0.00	0	0	0
0028	3T	4	154	2	0	200	0	-200	0.00	0.00	0	0	0
0028	3T	4	156	24	3	2400	10430	8030	0.13	4.35	4	18	14
0028	3T	4	213	1	0	100	0	-100	0.00	0.00	0	0	0
0028	3T	4	234	6	0	600	0	-600	0.00	0.00	1	0	-1
0028	3T	4	235	8	0	800	0	-800	0.00	0.00	1	0	-1
0028	3T	4	236	12	0	1200	0	-1200	0.00	0.00	2	0	-2
0028	3T	4	245	4	0	400	0	-400	0.00	0.00	0	0	0
0028	3T	4	246	4	0	400	0	-400	0.00	0.00	0	0	0
0028	3T	4	254	1	0	100	0	-100	0.00	0.00	0	0	0
0028	3T	4	256	3	0	300	0	-300	0.00	0.00	0	0	0
0028	3T	5	123	1007	120	100700	83990	-16710	0.12	0.83	178	148	-30
0028	3T	5	124	1340	134	134000	100730	-33270	0.10	0.75	237	178	-59
0028	3T	5	125	562	51	56200	51330	-4870	0.09	0.91	99	90	-9
0028	3T	5	126	549	22	54900	46110	-8790	0.04	0.84	97	81	-16
0028	3T	5	132	2	0	200	0	-200	0.00	0.00	0	0	0
0028	3T	5	134	418	52	41800	43090	1290	0.12	1.03	73	76	3
0028	3T	5	135	269	24	26900	26720	-180	0.09	0.99	47	47	0
0028	3T	5	136	258	22	25800	28070	2270	0.09	1.09	45	49	4
0028	3T	5	143	16	0	1600	0	-1600	0.00	0.00	2	0	-2
0028	3T	5	145	113	11	11300	11710	410	0.10	1.04	20	20	0
0028	3T	5	146	90	3	9000	3100	-5900	0.03	0.34	15	5	-10
0028	3T	5	153	2	0	200	0	-200	0.00	0.00	0	0	0
0028	3T	5	156	20	3	2000	5030	3030	0.15	2.52	3	8	5
0028	3T	5	163	2	0	200	0	-200	0.00	0.00	0	0	0
0028	3T	5	165	2	0	200	0	-200	0.00	0.00	0	0	0
0028	3T	5	234	9	1	900	1790	890	0.11	1.99	1	3	2
0028	3T	5	235	7	0	700	0	-700	0.00	0.00	1	0	-1
0028	3T	5	236	9	0	900	0	-900	0.00	0.00	1	0	-1
0028	3T	5	245	6	0	600	0	-600	0.00	0.00	1	0	-1
0028	3T	5	246	7	0	700	0	-700	0.00	0.00	1	0	-1
0028	3T	5	256	1	0	100	0	-100	0.00	0.00	0	0	0
0028	3T	6	123	672	99	67200	67280	80	0.15	1.00	118	119	1
0028	3T	6	124	905	62	90500	58340	-32160	0.07	0.64	160	103	-57
0028	3T	6	125	558	35	55800	43330	-12470	0.06	0.78	98	76	-22
0028	3T	6	126	526	18	52600	29030	-23570	0.03	0.55	93	51	-42
0028	3T	6	132	3	0	300	0	-300	0.00	0.00	0	0	0
0028	3T	6	134	403	37	40300	28450	-11850	0.09	0.71	71	50	-21
0028	3T	6	135	313	22	31300	26660	-4640	0.07	0.85	55	47	-8
0028	3T	6	136	317	23	31700	28840	-2860	0.07	0.91	56	51	-5
0028	3T	6	142	7	0	700	0	-700	0.00	0.00	1	0	-1
0028	3T	6	143	9	1	900	450	-450	0.11	0.50	1	0	-1
0028	3T	6	145	140	6	14000	8720	-5280	0.04	0.62	24	15	-9
0028	3T	6	146	107	7	10700	6690	-4010	0.07	0.63	18	11	-7
0028	3T	6	153	3	0	300	0	-300	0.00	0.00	0	0	0
0028	3T	6	156	36	0	3600	0	-3600	0.00	0.00	6	0	-6
0028	3T	6	163	1	0	100	0	-100	0.00	0.00	0	0	0
0028	3T	6	164	4	1	400	990	590	0.25	2.48	0	1	1
0028	3T	6	165	3	0	300	0	-300	0.00	0.00	0	0	0
0028	3T	6	215	1	0	100	0	-100	0.00	0.00	0	0	0
0028	3T	6	234	19	0	1900	0	-1900	0.00	0.00	3	0	-3
0028	3T	6	235	23	2	2300	1740	-560	0.09	0.76	4	3	-1
0028	3T	6	236	23	0	2300	0	-2300	0.00	0.00	4	0	-4
0028	3T	6	245	12	0	1200	0	-1200	0.00	0.00	2	0	-2
0028	3T	6	246	6	0	600	0	-600	0.00	0.00	1	0	-1
0028	3T	6	256	4	0	400	0	-400	0.00	0.00	0	0	0
0028	3T	7	123	603	73	60300	61320	1020	0.12	1.02	106	108	2
0028	3T	7	124	857	84	85700	94160	8460	0.10	1.10	151	166	15
0028	3T	7	125	532	34	53200	34200	-19000	0.06	0.64	94	60	-34
0028	3T	7	126	568	30	56800	38220	-18580	0.05	0.67	100	67	-33
0028	3T	7	132	1	0	100	0	-100	0.00	0.00	0	0	0
0028	3T	7	134	402	39	40200	27110	-13090	0.10	0.67	71	47	-24
0028	3T	7	135	325	28	32500	26550	-5950	0.09	0.82	57	46	-11
0028	3T	7	136	367	25	36700	23190	-13510	0.07	0.63	64	41	-23
0028	3T	7	143	7	1	700	1370	670	0.14	1.96	1	2	1
0028	3T	7	145	198	12	19800	20730	930	0.06	1.05	35	36	1
0028	3T	7	146	109	8	10900	7420	-3480	0.07	0.68	19	13	-6
0028	3T	7	152	2	0	200	0	-200	0.00	0.00	0	0	0
0028	3T	7	153	1	0	100	0	-100	0.00	0.00	0	0	0
0028	3T	7	154	3	1	300	2940	2640	0.33	9.80	0	5	5
0028	3T	7	156	44	2	4400	2680	-1720	0.05	0.61	7	4	-3
0028	3T	7	163	1	0	100	0	-100	0.00	0.00	0	0	0
0028	3T	7	164	6	0	600	0	-600	0.00	0.00	1	0	-1
0028	3T	7	165	2	0	200	0	-200	0.00	0.00	0	0	0
0028	3T	7	216	4	1	400	3320	2920	0.25	8.30	0	5	5
0028	3T	7	234	11	2	1100	2420	1320	0.18	2.20	1	4	3
0028	3T	7	235	10	1	1000	780	-220	0.10	0.78	1	1	0
0028	3T	7	236	15	1	1500	780	-720	0.07	0.52	2	1	-1
0028	3T	7	245	5	0	500	0	-500	0.00	0.00	0	0	0
0028	3T	7	246	10	0	1000	0	-1000	0.00	0.00	1	0	-1
0028	3T	7	256	5	0	500	0	-500	0.00	0.00	0	0	0
0028	3T	8	123	584	76	58400	54190	-4210	0.13	0.93	103	95	-8
0028	3T	8	124	926	99	92600	75720	-16880	0.11	0.82	163	134	-29
0028	3T	8	125	502	48	50200	59980	9780	0.10	1.19	88	106	18
0028	3T	8	126	478	29	47800	49000	1200	0.06	1.03	84	86	2
0028	3T	8	132	3	0	300	0	-300	0.00	0.00	0	0	0
0028	3T	8	134	305	27	30500	22400	-8100	0.09	0.73	53	39	-14
0028	3T	8	135	272	25	27200	19270	-7930	0.09	0.71	48	34	-14
0028	3T	8	136	343	26	34300	30640	-3660	0.08	0.89	60	54	-6
0028	3T	8	142	3	0	300	0	-300	0.00	0.00	0	0	0
0028	3T	8	143	11	0	1100	0	-1100	0.00	0.00	1	0	-1
0028	3T	8	145	130	11	13000	10780	-2220	0.08	0.83	23	19	-4
0028	3T	8	146	115	5	11500	5100	-6400	0.04	0.44	20	9	-11
0028	3T	8	152	2	0	200	0	-200	0.00	0.00	0	0	0
0028	3T	8	153	5	0	500	0	-500	0.00	0.00	0	0	0
0028	3T	8	154	4	0	400	0	-400	0.00	0.00	0	0	0
0028	3T	8	156	41	2	4100	1590	-2510	0.05	0.39	7	2	-5
0028	3T	8	163	1	0	100	0	-100	0.00	0.00	0	0	0
0028	3T	8	164	2	0	200	0	-200	0.00	0.00	0	0	0
0028	3T	8	214	1	0	100	0	-100	0.00	0.00	0	0	0
0028	3T	8	216	2	1	200	4180	3980	0.50	20.90	0	7	7
0028	3T	8	234	12	1	1200	870	-330	0.08	0.73	2	1	-1
0028	3T	8	235	16	0	1600	0	-1600	0.00	0.00	2	0	-2
0028	3T	8	236	8	0	800	0	-800	0.00	0.00	1	0	-1
0028	3T	8	245	8	0	800	0	-800	0.00	0.00	1	0	-1
0028	3T	8	246	5	0	500	0	-500	0.00	0.00	0	0	0
0028	3T	8	253	1	0	100	0	-100	0.00	0.00	0	0	0
0028	3T	8	256	5	0	500	0	-500	0.00	0.00	0	0	0
0028	3T	9	123	703	93	70300	59210	-11090	0.13	0.84	124	104	-20
0028	3T	9	124	1178	105	117800	84860	-32940	0.09	0.72	208	150	-58
0028	3T	9	125	540	43	54000	47400	-6600	0.08	0.88	95	83	-12
0028	3T	9	126	541	41	54100	55210	1110	0.08	1.02	95	97	2
0028	3T	9	132	2	0	200	0	-200	0.00	0.00	0	0	0
0028	3T	9	134	431	56	43100	40760	-2340	0.13	0.95	76	72	-4
0028	3T	9	135	334	21	33400	20230	-13170	0.06	0.61	59	35	-24
0028	3T	9	136	302	19	30200	20580	-9620	0.06	0.68	53	36	-17
0028	3T	9	142	3	0	300	0	-300	0.00	0.00	0	0	0
0028	3T	9	143	6	1	600	970	370	0.17	1.62	1	1	0
0028	3T	9	145	134	9	13400	6900	-6500	0.07	0.51	23	12	-11
0028	3T	9	146	98	5	9800	5260	-4540	0.05	0.54	17	9	-8
0028	3T	9	152	3	1	300	750	450	0.33	2.50	0	1	1
0028	3T	9	154	3	0	300	0	-300	0.00	0.00	0	0	0
0028	3T	9	156	24	2	2400	4990	2590	0.08	2.08	4	8	4
0028	3T	9	164	2	0	200	0	-200	0.00	0.00	0	0	0
0028	3T	9	214	1	0	100	0	-100	0.00	0.00	0	0	0
0028	3T	9	215	2	0	200	0	-200	0.00	0.00	0	0	0
0028	3T	9	216	1	0	100	0	-100	0.00	0.00	0	0	0
0028	3T	9	234	2	0	200	0	-200	0.00	0.00	0	0	0
0028	3T	9	235	8	1	800	2790	1990	0.13	3.49	1	4	3
0028	3T	9	236	11	0	1100	0	-1100	0.00	0.00	1	0	-1
0028	3T	9	245	1	0	100	0	-100	0.00	0.00	0	0	0
0028	3T	9	246	7	1	700	6240	5540	0.14	8.91	1	11	10
0028	3T	9	253	1	0	100	0	-100	0.00	0.00	0	0	0
0028	3T	9	256	4	0	400	0	-400	0.00	0.00	0	0	0
0039	1T	nopattern	1	66415	38429	6641500	6113090	-528410	0.58	0.92	11754	10819	-935
0039	1T	nopattern	2	5854	2355	585400	524190	-61210	0.40	0.90	1036	927	-109
0039	2F	nopattern	12	36659	12190	3665900	3104650	-561250	0.33	0.85	6488	5494	-994
0039	2F	nopattern	13	15735	4981	1573500	1251100	-322400	0.32	0.80	2784	2214	-570
0039	2F	nopattern	14	8361	2478	836100	655250	-180850	0.30	0.78	1479	1159	-320
0039	2F	nopattern	15	2563	558	256300	213490	-42810	0.22	0.83	453	377	-76
0039	2F	nopattern	16	2062	395	206200	177810	-28390	0.19	0.86	364	314	-50
0039	2F	nopattern	23	316	72	31600	21510	-10090	0.23	0.68	55	38	-17
0039	2F	nopattern	24	208	46	20800	14800	-6000	0.22	0.71	36	26	-10
0039	2F	nopattern	25	247	46	24700	16610	-8090	0.19	0.67	43	29	-14
0039	2F	nopattern	26	390	68	39000	29540	-9460	0.17	0.76	69	52	-17
0039	2T	nopattern	12	36562	9169	3656200	2977610	-678590	0.25	0.81	6471	5270	-1201
0039	2T	nopattern	13	15735	3560	1573500	1201240	-372260	0.23	0.76	2784	2126	-658
0039	2T	nopattern	14	8361	1772	836100	665660	-170440	0.21	0.80	1479	1178	-301
0039	2T	nopattern	15	2563	387	256300	219690	-36610	0.15	0.86	453	388	-65
0039	2T	nopattern	16	2062	273	206200	179460	-26740	0.13	0.87	364	317	-47
0039	2T	nopattern	21	97	11	9700	9380	-320	0.11	0.97	17	16	-1
0039	2T	nopattern	23	316	41	31600	20450	-11150	0.13	0.65	55	36	-19
0039	2T	nopattern	24	208	26	20800	13470	-7330	0.13	0.65	36	23	-13
0039	2T	nopattern	25	247	26	24700	17430	-7270	0.11	0.71	43	30	-13
0039	2T	nopattern	26	390	37	39000	25610	-13390	0.09	0.66	69	45	-24
0039	3F	nopattern	123	9623	2572	962300	796960	-165340	0.27	0.83	1703	1410	-293
0039	3F	nopattern	124	14160	2949	1416000	1033000	-383000	0.21	0.73	2506	1828	-678
0039	3F	nopattern	125	6051	1129	605100	499460	-105640	0.19	0.83	1070	884	-186
0039	3F	nopattern	126	5165	770	516500	440980	-75520	0.15	0.85	914	780	-134
0039	3F	nopattern	134	5230	1223	523000	410030	-112970	0.23	0.78	925	725	-200
0039	3F	nopattern	135	3201	619	320100	218650	-101450	0.19	0.68	566	386	-180
0039	3F	nopattern	136	3110	494	311000	243150	-67850	0.16	0.78	550	430	-120
0039	3F	nopattern	145	1151	213	115100	95560	-19540	0.19	0.83	203	169	-34
0039	3F	nopattern	146	1052	152	105200	79040	-26160	0.14	0.75	186	139	-47
0039	3F	nopattern	156	401	57	40100	34650	-5450	0.14	0.86	70	61	-9
0039	3F	nopattern	234	80	16	8000	4490	-3510	0.20	0.56	14	7	-7
0039	3F	nopattern	235	71	12	7100	4200	-2900	0.17	0.59	12	7	-5
0039	3F	nopattern	236	89	18	8900	7340	-1560	0.20	0.82	15	12	-3
0039	3F	nopattern	245	28	3	2800	1560	-1240	0.11	0.56	4	2	-2
0039	3F	nopattern	246	34	6	3400	2620	-780	0.18	0.77	6	4	-2
0039	3F	nopattern	256	35	3	3500	1170	-2330	0.09	0.33	6	2	-4
0039	3T	nopattern	123	9477	1159	947700	851010	-96690	0.12	0.90	1677	1506	-171
0039	3T	nopattern	124	14085	1243	1408500	1032360	-376140	0.09	0.73	2492	1827	-665
0039	3T	nopattern	125	6022	461	602200	518760	-83440	0.08	0.86	1065	918	-147
0039	3T	nopattern	126	5101	313	510100	448230	-61870	0.06	0.88	902	793	-109
0039	3T	nopattern	132	135	14	13500	10540	-2960	0.10	0.78	23	18	-5
0039	3T	nopattern	134	5127	512	512700	404120	-108580	0.10	0.79	907	715	-192
0039	3T	nopattern	135	3146	238	314600	203540	-111060	0.08	0.65	556	360	-196
0039	3T	nopattern	136	3084	203	308400	265250	-43150	0.07	0.86	545	469	-76
0039	3T	nopattern	142	60	4	6000	3370	-2630	0.07	0.56	10	5	-5
0039	3T	nopattern	143	103	10	10300	10380	80	0.10	1.01	18	18	0
0039	3T	nopattern	145	1121	71	112100	92690	-19410	0.06	0.83	198	164	-34
0039	3T	nopattern	146	1019	61	101900	83340	-18560	0.06	0.82	180	147	-33
0039	3T	nopattern	152	16	0	1600	0	-1600	0.00	0.00	2	0	-2
0039	3T	nopattern	153	55	3	5500	4690	-810	0.05	0.85	9	8	-1
0039	3T	nopattern	154	30	3	3000	3180	180	0.10	1.06	5	5	0
0039	3T	nopattern	156	394	18	39400	34260	-5140	0.05	0.87	69	60	-9
0039	3T	nopattern	162	7	0	700	0	-700	0.00	0.00	1	0	-1
0039	3T	nopattern	163	26	1	2600	630	-1970	0.04	0.24	4	1	-3
0039	3T	nopattern	164	33	3	3300	15330	12030	0.09	4.65	5	27	22
0039	3T	nopattern	165	7	0	700	0	-700	0.00	0.00	1	0	-1
0039	3T	nopattern	213	10	0	1000	0	-1000	0.00	0.00	1	0	-1
0039	3T	nopattern	214	15	0	1500	0	-1500	0.00	0.00	2	0	-2
0039	3T	nopattern	215	13	2	1300	5360	4060	0.15	4.12	2	9	7
0039	3T	nopattern	216	57	3	5700	9950	4250	0.05	1.75	10	17	7
0039	3T	nopattern	231	1	0	100	0	-100	0.00	0.00	0	0	0
0039	3T	nopattern	234	77	4	7700	3720	-3980	0.05	0.48	13	6	-7
0039	3T	nopattern	235	66	3	6600	3460	-3140	0.05	0.52	11	6	-5
0039	3T	nopattern	236	87	6	8700	7100	-1600	0.07	0.82	15	12	-3
0039	3T	nopattern	243	3	0	300	0	-300	0.00	0.00	0	0	0
0039	3T	nopattern	245	27	0	2700	0	-2700	0.00	0.00	4	0	-4
0039	3T	nopattern	246	34	2	3400	2480	-920	0.06	0.73	6	4	-2
0039	3T	nopattern	253	5	0	500	0	-500	0.00	0.00	0	0	0
0039	3T	nopattern	254	1	0	100	0	-100	0.00	0.00	0	0	0
0039	3T	nopattern	256	33	0	3300	0	-3300	0.00	0.00	5	0	-5
0039	3T	nopattern	263	2	0	200	0	-200	0.00	0.00	0	0	0
0039	3T	nopattern	265	2	0	200	0	-200	0.00	0.00	0	0	0
0040	1T	1	1	11138	6378	1113800	1026380	-87420	0.57	0.92	1971	1816	-155
0040	1T	1	2	1655	633	165500	140940	-24560	0.38	0.85	292	249	-43
0040	1T	2	1	10596	5939	1059600	955640	-103960	0.56	0.90	1875	1691	-184
0040	1T	2	2	1789	720	178900	168000	-10900	0.40	0.94	316	297	-19
0040	1T	3	1	10690	6215	1069000	1009830	-59170	0.58	0.94	1892	1787	-105
0040	1T	3	2	1819	682	181900	163020	-18880	0.37	0.90	321	288	-33
0040	1T	4	1	8762	5354	876200	812650	-63550	0.61	0.93	1550	1438	-112
0040	1T	4	2	1449	564	144900	125980	-18920	0.39	0.87	256	222	-34
0040	1T	5	1	7736	4912	773600	710580	-63020	0.63	0.92	1369	1257	-112
0040	1T	5	2	449	145	44900	37070	-7830	0.32	0.83	79	65	-14
0040	1T	6	1	612	373	61200	54260	-6940	0.61	0.89	108	96	-12
0040	1T	6	2	35	16	3500	3530	30	0.46	1.01	6	6	0
0040	1T	7	1	12653	7891	1265300	1163030	-102270	0.62	0.92	2239	2058	-181
0040	1T	7	2	807	279	80700	73140	-7560	0.35	0.91	142	129	-13
0040	2F	1	12	5816	1795	581600	488310	-93290	0.31	0.84	1029	864	-165
0040	2F	1	13	3295	1006	329500	269540	-59960	0.31	0.82	583	477	-106
0040	2F	1	14	1089	303	108900	84810	-24090	0.28	0.78	192	150	-42
0040	2F	1	15	214	50	21400	16580	-4820	0.23	0.77	37	29	-8
0040	2F	1	16	370	72	37000	33560	-3440	0.19	0.91	65	59	-6
0040	2F	1	23	123	29	12300	11530	-770	0.24	0.94	21	20	-1
0040	2F	1	24	35	5	3500	1940	-1560	0.14	0.55	6	3	-3
0040	2F	1	25	9	1	900	250	-650	0.11	0.28	1	0	-1
0040	2F	1	26	69	8	6900	2690	-4210	0.12	0.39	12	4	-8
0040	2F	2	12	4454	1490	445400	372370	-73030	0.33	0.84	788	659	-129
0040	2F	2	13	3074	958	307400	239060	-68340	0.31	0.78	544	423	-121
0040	2F	2	14	1714	530	171400	140470	-30930	0.31	0.82	303	248	-55
0040	2F	2	15	474	121	47400	37340	-10060	0.26	0.79	83	66	-17
0040	2F	2	16	428	99	42800	38350	-4450	0.23	0.90	75	67	-8
0040	2F	2	23	116	31	11600	11800	200	0.27	1.02	20	20	0
0040	2F	2	24	117	27	11700	9370	-2330	0.23	0.80	20	16	-4
0040	2F	2	25	75	18	7500	8170	670	0.24	1.09	13	14	1
0040	2F	2	26	111	20	11100	8040	-3060	0.18	0.72	19	14	-5
0040	2F	3	12	4690	1643	469000	405810	-63190	0.35	0.87	830	718	-112
0040	2F	3	13	2978	944	297800	237460	-60340	0.32	0.80	527	420	-107
0040	2F	3	14	1771	469	177100	131540	-45560	0.26	0.74	313	232	-81
0040	2F	3	15	599	140	59900	47030	-12870	0.23	0.79	106	83	-23
0040	2F	3	16	369	71	36900	29770	-7130	0.19	0.81	65	52	-13
0040	2F	3	23	135	35	13500	11170	-2330	0.26	0.83	23	19	-4
0040	2F	3	24	98	20	9800	8530	-1270	0.20	0.87	17	15	-2
0040	2F	3	25	90	15	9000	5860	-3140	0.17	0.65	15	10	-5
0040	2F	3	26	106	25	10600	10030	-570	0.24	0.95	18	17	-1
0040	2F	4	12	4231	1489	423100	352880	-70220	0.35	0.83	748	624	-124
0040	2F	4	13	2379	796	237900	191340	-46560	0.33	0.80	421	338	-83
0040	2F	4	14	1345	400	134500	105010	-29490	0.30	0.78	238	185	-53
0040	2F	4	15	415	104	41500	39170	-2330	0.25	0.94	73	69	-4
0040	2F	4	16	191	38	19100	16780	-2320	0.20	0.88	33	29	-4
0040	2F	4	23	155	45	15500	15690	190	0.29	1.01	27	27	0
0040	2F	4	24	119	21	11900	7220	-4680	0.18	0.61	21	12	-9
0040	2F	4	25	104	27	10400	15090	4690	0.26	1.45	18	26	8
0040	2F	4	26	62	11	6200	6770	570	0.18	1.09	10	11	1
0040	2F	5	12	4074	1531	407400	344810	-62590	0.38	0.85	721	610	-111
0040	2F	5	13	1730	541	173000	130840	-42160	0.31	0.76	306	231	-75
0040	2F	5	14	1111	349	111100	89230	-21870	0.31	0.80	196	157	-39
0040	2F	5	15	313	74	31300	25430	-5870	0.24	0.81	55	45	-10
0040	2F	5	16	236	52	23600	21220	-2380	0.22	0.90	41	37	-4
0040	2F	5	23	39	6	3900	2240	-1660	0.15	0.57	6	3	-3
0040	2F	5	24	35	6	3500	2260	-1240	0.17	0.65	6	4	-2
0040	2F	5	25	15	1	1500	250	-1250	0.07	0.17	2	0	-2
0040	2F	5	26	27	4	2700	2680	-20	0.15	0.99	4	4	0
0040	2F	6	12	306	116	30600	25190	-5410	0.38	0.82	54	44	-10
0040	2F	6	13	145	53	14500	12930	-1570	0.37	0.89	25	22	-3
0040	2F	6	14	89	19	8900	4360	-4540	0.21	0.49	15	7	-8
0040	2F	6	15	24	7	2400	2820	420	0.29	1.18	4	4	0
0040	2F	6	16	30	10	3000	4390	1390	0.33	1.46	5	7	2
0040	2F	6	23	3	0	300	0	-300	0.00	0.00	0	0	0
0040	2F	6	24	2	0	200	0	-200	0.00	0.00	0	0	0
0040	2F	6	25	1	0	100	0	-100	0.00	0.00	0	0	0
0040	2F	6	26	4	1	400	640	240	0.25	1.60	0	1	1
0040	2F	7	12	7143	2476	714300	609620	-104680	0.35	0.85	1264	1078	-186
0040	2F	7	13	2766	831	276600	215580	-61020	0.30	0.78	489	381	-108
0040	2F	7	14	1585	439	158500	120600	-37900	0.28	0.76	280	213	-67
0040	2F	7	15	410	86	41000	33840	-7160	0.21	0.83	72	59	-13
0040	2F	7	16	321	55	32100	23520	-8580	0.17	0.73	56	41	-15
0040	2F	7	23	64	20	6400	7210	810	0.31	1.13	11	12	1
0040	2F	7	24	41	9	4100	3580	-520	0.22	0.87	7	6	-1
0040	2F	7	25	41	4	4100	1400	-2700	0.10	0.34	7	2	-5
0040	2F	7	26	37	6	3700	3380	-320	0.16	0.91	6	5	-1
0040	2T	1	12	5775	1325	577500	461010	-116490	0.23	0.80	1022	815	-207
0040	2T	1	13	3295	686	329500	247050	-82450	0.21	0.75	583	437	-146
0040	2T	1	14	1089	224	108900	82860	-26040	0.21	0.76	192	146	-46
0040	2T	1	15	214	36	21400	18170	-3230	0.17	0.85	37	32	-5
0040	2T	1	16	370	42	37000	27960	-9040	0.11	0.76	65	49	-16
0040	2T	1	21	41	0	4100	0	-4100	0.00	0.00	7	0	-7
0040	2T	1	23	123	15	12300	10570	-1730	0.12	0.86	21	18	-3
0040	2T	1	24	35	3	3500	2390	-1110	0.09	0.68	6	4	-2
0040	2T	1	25	9	0	900	0	-900	0.00	0.00	1	0	-1
0040	2T	1	26	69	2	6900	1160	-5740	0.03	0.17	12	2	-10
0040	2T	2	12	4412	1065	441200	347280	-93920	0.24	0.79	780	614	-166
0040	2T	2	13	3074	713	307400	245580	-61820	0.23	0.80	544	434	-110
0040	2T	2	14	1714	382	171400	142490	-28910	0.22	0.83	303	252	-51
0040	2T	2	15	474	84	47400	36120	-11280	0.18	0.76	83	63	-20
0040	2T	2	16	428	63	42800	32380	-10420	0.15	0.76	75	57	-18
0040	2T	2	21	42	9	4200	5800	1600	0.21	1.38	7	10	3
0040	2T	2	23	116	15	11600	8730	-2870	0.13	0.75	20	15	-5
0040	2T	2	24	117	16	11700	8060	-3640	0.14	0.69	20	14	-6
0040	2T	2	25	75	12	7500	10210	2710	0.16	1.36	13	18	5
0040	2T	2	26	111	15	11100	10240	-860	0.14	0.92	19	18	-1
0040	2T	3	12	4635	1228	463500	396780	-66720	0.26	0.86	820	702	-118
0040	2T	3	13	2978	671	297800	228540	-69260	0.23	0.77	527	404	-123
0040	2T	3	14	1771	326	177100	129350	-47750	0.18	0.73	313	228	-85
0040	2T	3	15	599	94	59900	48880	-11020	0.16	0.82	106	86	-20
0040	2T	3	16	369	50	36900	34740	-2160	0.14	0.94	65	61	-4
0040	2T	3	21	55	4	5500	3070	-2430	0.07	0.56	9	5	-4
0040	2T	3	23	135	21	13500	13430	-70	0.16	0.99	23	23	0
0040	2T	3	24	98	10	9800	6390	-3410	0.10	0.65	17	11	-6
0040	2T	3	25	90	9	9000	6490	-2510	0.10	0.72	15	11	-4
0040	2T	3	26	106	9	10600	7900	-2700	0.08	0.75	18	13	-5
0040	2T	4	12	4196	1128	419600	331690	-87910	0.27	0.79	742	587	-155
0040	2T	4	13	2379	596	237900	188450	-49450	0.25	0.79	421	333	-88
0040	2T	4	14	1345	293	134500	105220	-29280	0.22	0.78	238	186	-52
0040	2T	4	15	415	76	41500	44720	3220	0.18	1.08	73	79	6
0040	2T	4	16	191	29	19100	19070	-30	0.15	1.00	33	33	0
0040	2T	4	21	35	3	3500	1950	-1550	0.09	0.56	6	3	-3
0040	2T	4	23	155	27	15500	15320	-180	0.17	0.99	27	27	0
0040	2T	4	24	119	14	11900	8610	-3290	0.12	0.72	21	15	-6
0040	2T	4	25	104	18	10400	13760	3360	0.17	1.32	18	24	6
0040	2T	4	26	62	7	6200	5510	-690	0.11	0.89	10	9	-1
0040	2T	5	12	4060	1203	406000	332340	-73660	0.30	0.82	718	588	-130
0040	2T	5	13	1730	386	173000	123550	-49450	0.22	0.71	306	218	-88
0040	2T	5	14	1111	262	111100	92120	-18980	0.24	0.83	196	163	-33
0040	2T	5	15	313	50	31300	23940	-7360	0.16	0.76	55	42	-13
0040	2T	5	16	236	41	23600	23700	100	0.17	1.00	41	41	0
0040	2T	5	21	14	0	1400	0	-1400	0.00	0.00	2	0	-2
0040	2T	5	23	39	2	3900	830	-3070	0.05	0.21	6	1	-5
0040	2T	5	24	35	1	3500	2420	-1080	0.03	0.69	6	4	-2
0040	2T	5	25	15	1	1500	360	-1140	0.07	0.24	2	0	-2
0040	2T	5	26	27	2	2700	1960	-740	0.07	0.73	4	3	-1
0040	2T	6	12	304	90	30400	23650	-6750	0.30	0.78	53	41	-12
0040	2T	6	13	145	38	14500	11230	-3270	0.26	0.77	25	19	-6
0040	2T	6	14	89	13	8900	4140	-4760	0.15	0.47	15	7	-8
0040	2T	6	15	24	2	2400	1560	-840	0.08	0.65	4	2	-2
0040	2T	6	16	30	7	3000	4610	1610	0.23	1.54	5	8	3
0040	2T	6	21	2	0	200	0	-200	0.00	0.00	0	0	0
0040	2T	6	23	3	0	300	0	-300	0.00	0.00	0	0	0
0040	2T	6	24	2	0	200	0	-200	0.00	0.00	0	0	0
0040	2T	6	25	1	0	100	0	-100	0.00	0.00	0	0	0
0040	2T	6	26	4	1	400	1590	1190	0.25	3.98	0	2	2
0040	2T	7	12	7139	1957	713900	596270	-117630	0.27	0.84	1263	1055	-208
0040	2T	7	13	2766	628	276600	205150	-71450	0.23	0.74	489	363	-126
0040	2T	7	14	1585	333	158500	124200	-34300	0.21	0.78	280	219	-61
0040	2T	7	15	410	67	41000	34580	-6420	0.16	0.84	72	61	-11
0040	2T	7	16	321	44	32100	25390	-6710	0.14	0.79	56	44	-12
0040	2T	7	21	4	0	400	0	-400	0.00	0.00	0	0	0
0040	2T	7	23	64	10	6400	6530	130	0.16	1.02	11	11	0
0040	2T	7	24	41	4	4100	3490	-610	0.10	0.85	7	6	-1
0040	2T	7	25	41	3	4100	2200	-1900	0.07	0.54	7	3	-4
0040	2T	7	26	37	4	3700	3720	20	0.11	1.01	6	6	0
0040	3F	1	123	454	125	45400	36010	-9390	0.28	0.79	80	63	-17
0040	3F	1	124	1702	391	170200	131600	-38600	0.23	0.77	301	232	-69
0040	3F	1	125	1043	171	104300	85880	-18420	0.16	0.82	184	152	-32
0040	3F	1	126	2503	218	250300	210700	-39600	0.09	0.84	443	372	-71
0040	3F	1	134	943	228	94300	71470	-22830	0.24	0.76	166	126	-40
0040	3F	1	135	612	125	61200	50130	-11070	0.20	0.82	108	88	-20
0040	3F	1	136	1422	136	142200	108700	-33500	0.10	0.76	251	192	-59
0040	3F	1	145	221	47	22100	22390	290	0.21	1.01	39	39	0
0040	3F	1	146	346	37	34600	25940	-8660	0.11	0.75	61	45	-16
0040	3F	1	156	43	9	4300	5280	980	0.21	1.23	7	9	2
0040	3F	1	234	31	5	3100	1730	-1370	0.16	0.56	5	3	-2
0040	3F	1	235	35	9	3500	4910	1410	0.26	1.40	6	8	2
0040	3F	1	236	51	3	5100	1460	-3640	0.06	0.29	9	2	-7
0040	3F	1	245	10	0	1000	0	-1000	0.00	0.00	1	0	-1
0040	3F	1	246	12	1	1200	400	-800	0.08	0.33	2	0	-2
0040	3F	1	256	1	1	100	1510	1410	1.00	15.10	0	2	2
0040	3F	2	123	543	139	54300	36430	-17870	0.26	0.67	96	64	-32
0040	3F	2	124	1398	355	139800	116600	-23200	0.25	0.83	247	206	-41
0040	3F	2	125	923	182	92300	75850	-16450	0.20	0.82	163	134	-29
0040	3F	2	126	1432	204	143200	114900	-28300	0.14	0.80	253	203	-50
0040	3F	2	134	885	186	88500	64830	-23670	0.21	0.73	156	114	-42
0040	3F	2	135	817	159	81700	58590	-23110	0.19	0.72	144	103	-41
0040	3F	2	136	1045	138	104500	72040	-32460	0.13	0.69	184	127	-57
0040	3F	2	145	283	46	28300	15950	-12350	0.16	0.56	50	28	-22
0040	3F	2	146	393	54	39300	33590	-5710	0.14	0.85	69	59	-10
0040	3F	2	156	101	16	10100	9890	-210	0.16	0.98	17	17	0
0040	3F	2	234	13	2	1300	780	-520	0.15	0.60	2	1	-1
0040	3F	2	235	42	6	4200	2490	-1710	0.14	0.59	7	4	-3
0040	3F	2	236	48	7	4800	3410	-1390	0.15	0.71	8	6	-2
0040	3F	2	245	19	1	1900	370	-1530	0.05	0.19	3	0	-3
0040	3F	2	246	34	6	3400	2860	-540	0.18	0.84	6	5	-1
0040	3F	2	256	17	3	1700	1680	-20	0.18	0.99	3	2	-1
0040	3F	3	123	866	273	86600	81520	-5080	0.32	0.94	153	144	-9
0040	3F	3	124	1428	335	142800	111760	-31040	0.23	0.78	252	197	-55
0040	3F	3	125	1218	217	121800	93210	-28590	0.18	0.77	215	164	-51
0040	3F	3	126	1037	173	103700	100160	-3540	0.17	0.97	183	177	-6
0040	3F	3	134	756	174	75600	64200	-11400	0.23	0.85	133	113	-20
0040	3F	3	135	933	163	93300	67080	-26220	0.17	0.72	165	118	-47
0040	3F	3	136	737	111	73700	57230	-16470	0.15	0.78	130	101	-29
0040	3F	3	145	514	86	51400	39810	-11590	0.17	0.77	90	70	-20
0040	3F	3	146	249	44	24900	25630	730	0.18	1.03	44	45	1
0040	3F	3	156	89	8	8900	6170	-2730	0.09	0.69	15	10	-5
0040	3F	3	234	30	5	3000	1950	-1050	0.17	0.65	5	3	-2
0040	3F	3	235	36	7	3600	3040	-560	0.19	0.84	6	5	-1
0040	3F	3	236	40	5	4000	2550	-1450	0.13	0.64	7	4	-3
0040	3F	3	245	32	5	3200	2300	-900	0.16	0.72	5	4	-1
0040	3F	3	246	14	3	1400	1840	440	0.21	1.31	2	3	1
0040	3F	3	256	11	0	1100	0	-1100	0.00	0.00	1	0	-1
0040	3F	4	123	956	298	95600	85100	-10500	0.31	0.89	169	150	-19
0040	3F	4	124	1493	339	149300	104140	-45160	0.23	0.70	264	184	-80
0040	3F	4	125	1022	193	102200	82780	-19420	0.19	0.81	180	146	-34
0040	3F	4	126	630	81	63000	51660	-11340	0.13	0.82	111	91	-20
0040	3F	4	134	786	197	78600	64090	-14510	0.25	0.82	139	113	-26
0040	3F	4	135	660	134	66000	48940	-17060	0.20	0.74	116	86	-30
0040	3F	4	136	380	55	38000	24830	-13170	0.14	0.65	67	43	-24
0040	3F	4	145	258	44	25800	16600	-9200	0.17	0.64	45	29	-16
0040	3F	4	146	148	24	14800	16880	2080	0.16	1.14	26	29	3
0040	3F	4	156	44	10	4400	3110	-1290	0.23	0.71	7	5	-2
0040	3F	4	234	37	9	3700	2780	-920	0.24	0.75	6	4	-2
0040	3F	4	235	60	7	6000	4010	-1990	0.12	0.67	10	7	-3
0040	3F	4	236	30	5	3000	1720	-1280	0.17	0.57	5	3	-2
0040	3F	4	245	27	2	2700	860	-1840	0.07	0.32	4	1	-3
0040	3F	4	246	24	4	2400	1460	-940	0.17	0.61	4	2	-2
0040	3F	4	256	6	3	600	1080	480	0.50	1.80	1	1	0
0040	3F	5	123	1062	301	106200	79780	-26420	0.28	0.75	187	141	-46
0040	3F	5	124	1759	390	175900	128950	-46950	0.22	0.73	311	228	-83
0040	3F	5	125	652	121	65200	50640	-14560	0.19	0.78	115	89	-26
0040	3F	5	126	506	92	50600	51100	500	0.18	1.01	89	90	1
0040	3F	5	134	584	131	58400	39600	-18800	0.22	0.68	103	70	-33
0040	3F	5	135	394	69	39400	26830	-12570	0.18	0.68	69	47	-22
0040	3F	5	136	263	42	26300	16940	-9360	0.16	0.64	46	29	-17
0040	3F	5	145	246	46	24600	18660	-5940	0.19	0.76	43	33	-10
0040	3F	5	146	114	29	11400	13550	2150	0.25	1.19	20	23	3
0040	3F	5	156	29	4	2900	1440	-1460	0.14	0.50	5	2	-3
0040	3F	5	234	6	0	600	0	-600	0.00	0.00	1	0	-1
0040	3F	5	235	9	0	900	0	-900	0.00	0.00	1	0	-1
0040	3F	5	236	8	1	800	1040	240	0.13	1.30	1	1	0
0040	3F	5	245	6	1	600	240	-360	0.17	0.40	1	0	-1
0040	3F	5	246	7	3	700	3390	2690	0.43	4.84	1	6	5
0040	3F	5	256	1	0	100	0	-100	0.00	0.00	0	0	0
0040	3F	6	123	78	19	7800	5640	-2160	0.24	0.72	13	9	-4
0040	3F	6	124	126	26	12600	8490	-4110	0.21	0.67	22	15	-7
0040	3F	6	125	45	8	4500	3860	-640	0.18	0.86	7	6	-1
0040	3F	6	126	50	7	5000	3170	-1830	0.14	0.63	8	5	-3
0040	3F	6	134	56	16	5600	5090	-510	0.29	0.91	9	9	0
0040	3F	6	135	29	6	2900	1640	-1260	0.21	0.57	5	2	-3
0040	3F	6	136	23	4	2300	1770	-530	0.17	0.77	4	3	-1
0040	3F	6	145	18	2	1800	600	-1200	0.11	0.33	3	1	-2
0040	3F	6	146	16	4	1600	1160	-440	0.25	0.73	2	2	0
0040	3F	6	156	3	0	300	0	-300	0.00	0.00	0	0	0
0040	3F	6	234	1	0	100	0	-100	0.00	0.00	0	0	0
0040	3F	6	235	1	0	100	0	-100	0.00	0.00	0	0	0
0040	3F	7	123	1778	490	177800	145630	-32170	0.28	0.82	314	257	-57
0040	3F	7	124	2753	579	275300	204620	-70680	0.21	0.74	487	362	-125
0040	3F	7	125	1352	238	135200	110230	-24970	0.18	0.82	239	195	-44
0040	3F	7	126	987	153	98700	87390	-11310	0.16	0.89	174	154	-20
0040	3F	7	134	805	174	80500	63690	-16810	0.22	0.79	142	112	-30
0040	3F	7	135	621	87	62100	37270	-24830	0.14	0.60	109	65	-44
0040	3F	7	136	386	50	38600	27800	-10800	0.13	0.72	68	49	-19
0040	3F	7	145	202	31	20200	13130	-7070	0.15	0.65	35	23	-12
0040	3F	7	146	161	29	16100	14500	-1600	0.18	0.90	28	25	-3
0040	3F	7	156	38	6	3800	2990	-810	0.16	0.79	6	5	-1
0040	3F	7	234	10	1	1000	560	-440	0.10	0.56	1	0	-1
0040	3F	7	235	13	1	1300	250	-1050	0.08	0.19	2	0	-2
0040	3F	7	236	11	1	1100	410	-690	0.09	0.37	1	0	-1
0040	3F	7	245	9	1	900	440	-460	0.11	0.49	1	0	-1
0040	3F	7	246	5	1	500	650	150	0.20	1.30	0	1	1
0040	3F	7	256	3	0	300	0	-300	0.00	0.00	0	0	0
0040	3T	1	123	436	52	43600	30230	-13370	0.12	0.69	77	53	-24
0040	3T	1	124	1690	162	169000	127770	-41230	0.10	0.76	299	226	-73
0040	3T	1	125	1036	75	103600	90940	-12660	0.07	0.88	183	160	-23
0040	3T	1	126	2479	98	247900	217480	-30420	0.04	0.88	438	384	-54
0040	3T	1	132	15	0	1500	0	-1500	0.00	0.00	2	0	-2
0040	3T	1	134	942	94	94200	74730	-19470	0.10	0.79	166	132	-34
0040	3T	1	135	607	52	60700	54180	-6520	0.09	0.89	107	95	-12
0040	3T	1	136	1404	55	140400	94060	-46340	0.04	0.67	248	166	-82
0040	3T	1	142	4	0	400	0	-400	0.00	0.00	0	0	0
0040	3T	1	143	1	0	100	0	-100	0.00	0.00	0	0	0
0040	3T	1	145	207	16	20700	16780	-3920	0.08	0.81	36	29	-7
0040	3T	1	146	296	18	29600	31940	2340	0.06	1.08	52	56	4
0040	3T	1	152	2	0	200	0	-200	0.00	0.00	0	0	0
0040	3T	1	153	5	0	500	0	-500	0.00	0.00	0	0	0
0040	3T	1	154	14	1	1400	3200	1800	0.07	2.29	2	5	3
0040	3T	1	156	38	2	3800	2400	-1400	0.05	0.63	6	4	-2
0040	3T	1	163	18	0	1800	0	-1800	0.00	0.00	3	0	-3
0040	3T	1	164	50	1	5000	2570	-2430	0.02	0.51	8	4	-4
0040	3T	1	165	5	0	500	0	-500	0.00	0.00	0	0	0
0040	3T	1	213	3	0	300	0	-300	0.00	0.00	0	0	0
0040	3T	1	214	8	0	800	0	-800	0.00	0.00	1	0	-1
0040	3T	1	215	5	0	500	0	-500	0.00	0.00	0	0	0
0040	3T	1	216	24	0	2400	0	-2400	0.00	0.00	4	0	-4
0040	3T	1	234	31	1	3100	1520	-1580	0.03	0.49	5	2	-3
0040	3T	1	235	35	3	3500	9320	5820	0.09	2.66	6	16	10
0040	3T	1	236	51	1	5100	910	-4190	0.02	0.18	9	1	-8
0040	3T	1	245	10	0	1000	0	-1000	0.00	0.00	1	0	-1
0040	3T	1	246	8	0	800	0	-800	0.00	0.00	1	0	-1
0040	3T	1	256	1	0	100	0	-100	0.00	0.00	0	0	0
0040	3T	1	264	4	1	400	1460	1060	0.25	3.65	0	2	2
0040	3T	2	123	530	56	53000	34980	-18020	0.11	0.66	93	61	-32
0040	3T	2	124	1384	149	138400	129220	-9180	0.11	0.93	244	228	-16
0040	3T	2	125	914	67	91400	71570	-19830	0.07	0.78	161	126	-35
0040	3T	2	126	1405	82	140500	104500	-36000	0.06	0.74	248	184	-64
0040	3T	2	132	11	0	1100	0	-1100	0.00	0.00	1	0	-1
0040	3T	2	134	871	87	87100	71050	-16050	0.10	0.82	154	125	-29
0040	3T	2	135	802	61	80200	55510	-24690	0.08	0.69	141	98	-43
0040	3T	2	136	1040	62	104000	77720	-26280	0.06	0.75	184	137	-47
0040	3T	2	142	5	0	500	0	-500	0.00	0.00	0	0	0
0040	3T	2	143	14	1	1400	540	-860	0.07	0.39	2	0	-2
0040	3T	2	145	270	11	27000	9210	-17790	0.04	0.34	47	16	-31
0040	3T	2	146	385	31	38500	42860	4360	0.08	1.11	68	75	7
0040	3T	2	152	3	1	300	1160	860	0.33	3.87	0	2	2
0040	3T	2	153	15	0	1500	0	-1500	0.00	0.00	2	0	-2
0040	3T	2	154	13	1	1300	1320	20	0.08	1.02	2	2	0
0040	3T	2	156	101	5	10100	9010	-1090	0.05	0.89	17	15	-2
0040	3T	2	162	2	0	200	0	-200	0.00	0.00	0	0	0
0040	3T	2	163	5	0	500	0	-500	0.00	0.00	0	0	0
0040	3T	2	164	8	1	800	1250	450	0.13	1.56	1	2	1
0040	3T	2	213	2	0	200	0	-200	0.00	0.00	0	0	0
0040	3T	2	214	9	2	900	3200	2300	0.22	3.56	1	5	4
0040	3T	2	215	6	0	600	0	-600	0.00	0.00	1	0	-1
0040	3T	2	216	25	4	2500	15250	12750	0.16	6.10	4	26	22
0040	3T	2	234	13	1	1300	1830	530	0.08	1.41	2	3	1
0040	3T	2	235	41	2	4100	3170	-930	0.05	0.77	7	5	-2
0040	3T	2	236	48	1	4800	700	-4100	0.02	0.15	8	1	-7
0040	3T	2	245	19	1	1900	1350	-550	0.05	0.71	3	2	-1
0040	3T	2	246	33	1	3300	960	-2340	0.03	0.29	5	1	-4
0040	3T	2	253	1	0	100	0	-100	0.00	0.00	0	0	0
0040	3T	2	256	17	0	1700	0	-1700	0.00	0.00	3	0	-3
0040	3T	2	264	1	0	100	0	-100	0.00	0.00	0	0	0
0040	3T	3	123	857	129	85700	90030	4330	0.15	1.05	151	159	8
0040	3T	3	124	1409	148	140900	103920	-36980	0.11	0.74	249	183	-66
0040	3T	3	125	1209	99	120900	109540	-11360	0.08	0.91	213	193	-20
0040	3T	3	126	1015	77	101500	93540	-7960	0.08	0.92	179	165	-14
0040	3T	3	132	3	0	300	0	-300	0.00	0.00	0	0	0
0040	3T	3	134	737	73	73700	63000	-10700	0.10	0.85	130	111	-19
0040	3T	3	135	922	60	92200	53170	-39030	0.07	0.58	163	94	-69
0040	3T	3	136	736	42	73600	54770	-18830	0.06	0.74	130	96	-34
0040	3T	3	142	1	0	100	0	-100	0.00	0.00	0	0	0
0040	3T	3	143	19	1	1900	3590	1690	0.05	1.89	3	6	3
0040	3T	3	145	498	32	49800	40360	-9440	0.06	0.81	88	71	-17
0040	3T	3	146	246	14	24600	25760	1160	0.06	1.05	43	45	2
0040	3T	3	153	11	1	1100	770	-330	0.09	0.70	1	1	0
0040	3T	3	154	16	1	1600	960	-640	0.06	0.60	2	1	-1
0040	3T	3	156	87	3	8700	4530	-4170	0.03	0.52	15	8	-7
0040	3T	3	163	1	0	100	0	-100	0.00	0.00	0	0	0
0040	3T	3	164	3	0	300	0	-300	0.00	0.00	0	0	0
0040	3T	3	165	2	0	200	0	-200	0.00	0.00	0	0	0
0040	3T	3	213	6	1	600	2190	1590	0.17	3.65	1	3	2
0040	3T	3	214	18	0	1800	0	-1800	0.00	0.00	3	0	-3
0040	3T	3	215	9	0	900	0	-900	0.00	0.00	1	0	-1
0040	3T	3	216	22	0	2200	0	-2200	0.00	0.00	3	0	-3
0040	3T	3	234	30	3	3000	4550	1550	0.10	1.52	5	8	3
0040	3T	3	235	34	1	3400	1560	-1840	0.03	0.46	6	2	-4
0040	3T	3	236	40	3	4000	3770	-230	0.08	0.94	7	6	-1
0040	3T	3	245	32	4	3200	7690	4490	0.13	2.40	5	13	8
0040	3T	3	246	14	1	1400	1350	-50	0.07	0.96	2	2	0
0040	3T	3	253	2	0	200	0	-200	0.00	0.00	0	0	0
0040	3T	3	256	11	0	1100	0	-1100	0.00	0.00	1	0	-1
0040	3T	4	123	941	125	94100	75540	-18560	0.13	0.80	166	133	-33
0040	3T	4	124	1484	149	148400	109980	-38420	0.10	0.74	262	194	-68
0040	3T	4	125	1012	72	101200	69440	-31760	0.07	0.69	179	122	-57
0040	3T	4	126	618	31	61800	47250	-14550	0.05	0.76	109	83	-26
0040	3T	4	132	11	1	1100	530	-570	0.09	0.48	1	0	-1
0040	3T	4	134	764	101	76400	76060	-340	0.13	1.00	135	134	-1
0040	3T	4	135	656	68	65600	58500	-7100	0.10	0.89	116	103	-13
0040	3T	4	136	379	33	37900	30600	-7300	0.09	0.81	67	54	-13
0040	3T	4	143	22	1	2200	2290	90	0.05	1.04	3	4	1
0040	3T	4	145	246	13	24600	13060	-11540	0.05	0.53	43	23	-20
0040	3T	4	146	146	15	14600	18040	3440	0.10	1.24	25	31	6
0040	3T	4	153	4	0	400	0	-400	0.00	0.00	0	0	0
0040	3T	4	154	12	0	1200	0	-1200	0.00	0.00	2	0	-2
0040	3T	4	156	44	4	4400	3940	-460	0.09	0.90	7	6	-1
0040	3T	4	163	1	0	100	0	-100	0.00	0.00	0	0	0
0040	3T	4	164	2	0	200	0	-200	0.00	0.00	0	0	0
0040	3T	4	213	4	0	400	0	-400	0.00	0.00	0	0	0
0040	3T	4	214	9	0	900	0	-900	0.00	0.00	1	0	-1
0040	3T	4	215	10	0	1000	0	-1000	0.00	0.00	1	0	-1
0040	3T	4	216	12	0	1200	0	-1200	0.00	0.00	2	0	-2
0040	3T	4	234	37	1	3700	1620	-2080	0.03	0.44	6	2	-4
0040	3T	4	235	57	2	5700	2880	-2820	0.04	0.51	10	5	-5
0040	3T	4	236	30	4	3000	5040	2040	0.13	1.68	5	8	3
0040	3T	4	245	26	0	2600	0	-2600	0.00	0.00	4	0	-4
0040	3T	4	246	24	2	2400	1490	-910	0.08	0.62	4	2	-2
0040	3T	4	253	3	0	300	0	-300	0.00	0.00	0	0	0
0040	3T	4	254	1	0	100	0	-100	0.00	0.00	0	0	0
0040	3T	4	256	6	1	600	770	170	0.17	1.28	1	1	0
0040	3T	5	123	1046	144	104600	80320	-24280	0.14	0.77	185	142	-43
0040	3T	5	124	1757	197	175700	133600	-42100	0.11	0.76	310	236	-74
0040	3T	5	125	651	57	65100	55890	-9210	0.09	0.86	115	98	-17
0040	3T	5	126	497	39	49700	51710	2010	0.08	1.04	87	91	4
0040	3T	5	132	13	1	1300	780	-520	0.08	0.60	2	1	-1
0040	3T	5	134	570	50	57000	36210	-20790	0.09	0.64	100	64	-36
0040	3T	5	135	389	29	38900	27370	-11530	0.07	0.70	68	48	-20
0040	3T	5	136	262	18	26200	18280	-7920	0.07	0.70	46	32	-14
0040	3T	5	143	14	1	1400	1240	-160	0.07	0.89	2	2	0
0040	3T	5	145	231	13	23100	13700	-9400	0.06	0.59	40	24	-16
0040	3T	5	146	114	7	11400	7180	-4220	0.06	0.63	20	12	-8
0040	3T	5	153	5	0	500	0	-500	0.00	0.00	0	0	0
0040	3T	5	154	15	1	1500	770	-730	0.07	0.51	2	1	-1
0040	3T	5	156	29	1	2900	710	-2190	0.03	0.24	5	1	-4
0040	3T	5	162	1	0	100	0	-100	0.00	0.00	0	0	0
0040	3T	5	163	1	0	100	0	-100	0.00	0.00	0	0	0
0040	3T	5	213	3	0	300	0	-300	0.00	0.00	0	0	0
0040	3T	5	214	2	0	200	0	-200	0.00	0.00	0	0	0
0040	3T	5	215	1	0	100	0	-100	0.00	0.00	0	0	0
0040	3T	5	216	8	0	800	0	-800	0.00	0.00	1	0	-1
0040	3T	5	234	4	0	400	0	-400	0.00	0.00	0	0	0
0040	3T	5	235	9	0	900	0	-900	0.00	0.00	1	0	-1
0040	3T	5	236	8	0	800	0	-800	0.00	0.00	1	0	-1
0040	3T	5	243	2	0	200	0	-200	0.00	0.00	0	0	0
0040	3T	5	245	5	0	500	0	-500	0.00	0.00	0	0	0
0040	3T	5	246	7	0	700	0	-700	0.00	0.00	1	0	-1
0040	3T	5	254	1	0	100	0	-100	0.00	0.00	0	0	0
0040	3T	5	256	1	0	100	0	-100	0.00	0.00	0	0	0
0040	3T	6	123	77	11	7700	5920	-1780	0.14	0.77	13	10	-3
0040	3T	6	124	125	11	12500	7140	-5360	0.09	0.57	22	12	-10
0040	3T	6	125	45	4	4500	5540	1040	0.09	1.23	7	9	2
0040	3T	6	126	49	3	4900	3620	-1280	0.06	0.74	8	6	-2
0040	3T	6	132	1	0	100	0	-100	0.00	0.00	0	0	0
0040	3T	6	134	55	7	5500	4560	-940	0.13	0.83	9	8	-1
0040	3T	6	135	29	3	2900	2130	-770	0.10	0.73	5	3	-2
0040	3T	6	136	23	2	2300	1600	-700	0.09	0.70	4	2	-2
0040	3T	6	143	1	0	100	0	-100	0.00	0.00	0	0	0
0040	3T	6	145	18	1	1800	820	-980	0.06	0.46	3	1	-2
0040	3T	6	146	16	1	1600	640	-960	0.06	0.40	2	1	-1
0040	3T	6	156	3	0	300	0	-300	0.00	0.00	0	0	0
0040	3T	6	214	1	0	100	0	-100	0.00	0.00	0	0	0
0040	3T	6	216	1	0	100	0	-100	0.00	0.00	0	0	0
0040	3T	6	234	1	0	100	0	-100	0.00	0.00	0	0	0
0040	3T	6	235	1	0	100	0	-100	0.00	0.00	0	0	0
0040	3T	7	123	1770	239	177000	158030	-18970	0.14	0.89	313	279	-34
0040	3T	7	124	2745	252	274500	200350	-74150	0.09	0.73	485	354	-131
0040	3T	7	125	1347	104	134700	111300	-23400	0.08	0.83	238	196	-42
0040	3T	7	126	985	71	98500	92580	-5920	0.07	0.94	174	163	-11
0040	3T	7	132	8	1	800	760	-40	0.13	0.95	1	1	0
0040	3T	7	134	785	67	78500	54950	-23550	0.09	0.70	138	97	-41
0040	3T	7	135	617	41	61700	38830	-22870	0.07	0.63	109	68	-41
0040	3T	7	136	384	23	38400	30750	-7650	0.06	0.80	67	54	-13
0040	3T	7	142	7	0	700	0	-700	0.00	0.00	1	0	-1
0040	3T	7	143	20	1	2000	450	-1550	0.05	0.23	3	0	-3
0040	3T	7	145	201	13	20100	12810	-7290	0.06	0.64	35	22	-13
0040	3T	7	146	155	13	15500	14380	-1120	0.08	0.93	27	25	-2
0040	3T	7	152	5	0	500	0	-500	0.00	0.00	0	0	0
0040	3T	7	153	4	1	400	1530	1130	0.25	3.83	0	2	2
0040	3T	7	154	1	0	100	0	-100	0.00	0.00	0	0	0
0040	3T	7	156	37	2	3700	4540	840	0.05	1.23	6	8	2
0040	3T	7	163	2	0	200	0	-200	0.00	0.00	0	0	0
0040	3T	7	164	6	0	600	0	-600	0.00	0.00	1	0	-1
0040	3T	7	165	1	0	100	0	-100	0.00	0.00	0	0	0
0040	3T	7	214	1	0	100	0	-100	0.00	0.00	0	0	0
0040	3T	7	216	2	0	200	0	-200	0.00	0.00	0	0	0
0040	3T	7	234	10	1	1000	2700	1700	0.10	2.70	1	4	3
0040	3T	7	235	13	0	1300	0	-1300	0.00	0.00	2	0	-2
0040	3T	7	236	11	0	1100	0	-1100	0.00	0.00	1	0	-1
0040	3T	7	245	9	0	900	0	-900	0.00	0.00	1	0	-1
0040	3T	7	246	5	0	500	0	-500	0.00	0.00	0	0	0
0040	3T	7	256	3	0	300	0	-300	0.00	0.00	0	0	0
0023	2T	14_7	21	1	0	100	0	-100	0.00	0.00	0	0	0
0023	2T	14_7	23	5	0	500	0	-500	0.00	0.00	0	0	0
0023	2T	14_7	24	2	0	200	0	-200	0.00	0.00	0	0	0
0023	2T	14_7	26	4	1	400	690	290	0.25	1.73	0	1	1
0023	2T	14_8	12	49	6	4900	2510	-2390	0.12	0.51	8	4	-4
0023	2T	14_8	13	35	2	3500	700	-2800	0.06	0.20	6	1	-5
0023	2T	14_8	14	31	10	3100	4150	1050	0.32	1.34	5	7	2
0023	2T	14_8	15	14	1	1400	570	-830	0.07	0.41	2	1	-1
0023	2T	14_8	16	15	2	1500	1140	-360	0.13	0.76	2	2	0
0023	2T	14_8	23	7	1	700	350	-350	0.14	0.50	1	0	-1
0023	2T	14_8	24	4	0	400	0	-400	0.00	0.00	0	0	0
0023	2T	14_8	25	2	1	200	860	660	0.50	4.30	0	1	1
0023	2T	14_8	26	4	0	400	0	-400	0.00	0.00	0	0	0
0023	2T	14_9	12	82	13	8200	4700	-3500	0.16	0.57	14	8	-6
0023	2T	14_9	13	36	8	3600	3520	-80	0.22	0.98	6	6	0
0023	2T	14_9	14	15	1	1500	250	-1250	0.07	0.17	2	0	-2
0023	2T	14_9	15	3	1	300	560	260	0.33	1.87	0	0	0
0023	2T	14_9	16	6	0	600	0	-600	0.00	0.00	1	0	-1
0023	2T	14_9	21	1	0	100	0	-100	0.00	0.00	0	0	0
0023	2T	14_9	23	3	0	300	0	-300	0.00	0.00	0	0	0
0023	2T	14_9	24	5	1	500	440	-60	0.20	0.88	0	0	0
0023	2T	14_9	25	4	0	400	0	-400	0.00	0.00	0	0	0
0023	2T	14_9	26	1	0	100	0	-100	0.00	0.00	0	0	0
0023	2T	15_1	12	167	43	16700	12860	-3840	0.26	0.77	29	22	-7
0023	2T	15_1	13	75	14	7500	4210	-3290	0.19	0.56	13	7	-6
0023	2T	15_1	14	19	4	1900	1300	-600	0.21	0.68	3	2	-1
0023	2T	15_1	15	5	1	500	390	-110	0.20	0.78	0	0	0
0023	2T	15_1	16	8	4	800	2380	1580	0.50	2.98	1	4	3
0023	2T	15_10	12	172	45	17200	12140	-5060	0.26	0.71	30	21	-9
0023	2T	15_10	13	78	20	7800	6330	-1470	0.26	0.81	13	11	-2
0023	2T	15_10	14	22	4	2200	1660	-540	0.18	0.75	3	2	-1
0023	2T	15_10	15	3	0	300	0	-300	0.00	0.00	0	0	0
0023	2T	15_10	16	2	0	200	0	-200	0.00	0.00	0	0	0
0023	2T	15_10	23	1	0	100	0	-100	0.00	0.00	0	0	0
0023	2T	15_10	24	1	0	100	0	-100	0.00	0.00	0	0	0
0023	2T	15_11	12	211	51	21100	15020	-6080	0.24	0.71	37	26	-11
0023	2T	15_11	13	53	15	5300	4640	-660	0.28	0.88	9	8	-1
0023	2T	15_11	14	15	6	1500	2220	720	0.40	1.48	2	3	1
0023	2T	15_11	15	1	1	100	1960	1860	1.00	19.60	0	3	3
0023	2T	15_12	12	214	53	21400	15000	-6400	0.25	0.70	37	26	-11
0023	2T	15_12	13	52	9	5200	2730	-2470	0.17	0.53	9	4	-5
0023	2T	15_12	14	12	2	1200	970	-230	0.17	0.81	2	1	-1
0023	2T	15_12	15	1	0	100	0	-100	0.00	0.00	0	0	0
0023	2T	15_2	12	96	19	9600	8620	-980	0.20	0.90	16	15	-1
0023	2T	15_2	13	64	9	6400	3950	-2450	0.14	0.62	11	6	-5
0023	2T	15_2	14	36	6	3600	3450	-150	0.17	0.96	6	6	0
0023	2T	15_2	15	15	1	1500	620	-880	0.07	0.41	2	1	-1
0023	2T	15_2	16	2	0	200	0	-200	0.00	0.00	0	0	0
0023	2T	15_2	23	4	0	400	0	-400	0.00	0.00	0	0	0
0023	2T	15_2	24	2	0	200	0	-200	0.00	0.00	0	0	0
0023	2T	15_2	25	1	0	100	0	-100	0.00	0.00	0	0	0
0023	2T	15_3	12	69	8	6900	4370	-2530	0.12	0.63	12	7	-5
0023	2T	15_3	13	58	12	5800	5810	10	0.21	1.00	10	10	0
0023	2T	15_3	14	25	6	2500	4350	1850	0.24	1.74	4	7	3
0023	2T	15_3	15	21	3	2100	3960	1860	0.14	1.89	3	7	4
0023	2T	15_3	16	23	4	2300	3580	1280	0.17	1.56	4	6	2
0023	2T	15_3	23	2	0	200	0	-200	0.00	0.00	0	0	0
0023	2T	15_3	26	5	0	500	0	-500	0.00	0.00	0	0	0
0023	2T	15_4	12	37	5	3700	1900	-1800	0.14	0.51	6	3	-3
0023	2T	15_4	13	65	12	6500	5080	-1420	0.18	0.78	11	8	-3
0023	2T	15_4	14	34	2	3400	2360	-1040	0.06	0.69	6	4	-2
0023	2T	15_4	15	25	4	2500	3660	1160	0.16	1.46	4	6	2
0023	2T	15_4	16	29	1	2900	490	-2410	0.03	0.17	5	0	-5
0023	2T	15_4	23	3	0	300	0	-300	0.00	0.00	0	0	0
0023	2T	15_4	25	3	0	300	0	-300	0.00	0.00	0	0	0
0023	2T	15_4	26	2	0	200	0	-200	0.00	0.00	0	0	0
0023	2T	15_5	12	84	20	8400	6620	-1780	0.24	0.79	14	11	-3
0023	2T	15_5	13	105	32	10500	11120	620	0.30	1.06	18	19	1
0023	2T	15_5	14	88	18	8800	6870	-1930	0.20	0.78	15	12	-3
0023	2T	15_5	15	1	0	100	0	-100	0.00	0.00	0	0	0
0023	2T	15_5	24	1	1	100	690	590	1.00	6.90	0	1	1
0023	2T	15_6	12	102	17	10200	7350	-2850	0.17	0.72	18	13	-5
0023	2T	15_6	13	34	7	3400	3380	-20	0.21	0.99	6	5	-1
0023	2T	15_6	14	14	1	1400	280	-1120	0.07	0.20	2	0	-2
0023	2T	15_6	15	9	0	900	0	-900	0.00	0.00	1	0	-1
0023	2T	15_6	16	9	4	900	2200	1300	0.44	2.44	1	3	2
0023	2T	15_6	21	3	0	300	0	-300	0.00	0.00	0	0	0
0023	2T	15_6	23	4	1	400	580	180	0.25	1.45	0	1	1
0023	2T	15_6	24	2	0	200	0	-200	0.00	0.00	0	0	0
0023	2T	15_6	25	3	0	300	0	-300	0.00	0.00	0	0	0
0023	2T	15_6	26	9	1	900	620	-280	0.11	0.69	1	1	0
0023	2T	15_7	12	102	15	10200	6680	-3520	0.15	0.65	18	11	-7
0023	2T	15_7	13	43	10	4300	3360	-940	0.23	0.78	7	5	-2
0023	2T	15_7	14	24	5	2400	2120	-280	0.21	0.88	4	3	-1
0023	2T	15_7	15	13	3	1300	850	-450	0.23	0.65	2	1	-1
0023	2T	15_7	16	12	6	1200	2730	1530	0.50	2.28	2	4	2
0023	2T	15_7	21	1	0	100	0	-100	0.00	0.00	0	0	0
0023	2T	15_7	23	5	1	500	330	-170	0.20	0.66	0	0	0
0023	2T	15_7	24	1	1	100	970	870	1.00	9.70	0	1	1
0023	2T	15_7	25	1	0	100	0	-100	0.00	0.00	0	0	0
0023	2T	15_7	26	4	1	400	1350	950	0.25	3.38	0	2	2
0023	2T	15_8	12	233	67	23300	15550	-7750	0.29	0.67	41	27	-14
0023	2T	15_8	13	3	2	300	850	550	0.67	2.83	0	1	1
0023	2T	15_8	14	47	10	4700	3060	-1640	0.21	0.65	8	5	-3
0023	2T	15_9	12	142	33	14200	9990	-4210	0.23	0.70	25	17	-8
0023	2T	15_9	13	59	13	5900	4590	-1310	0.22	0.78	10	8	-2
0023	2T	15_9	14	28	4	2800	1480	-1320	0.14	0.53	4	2	-2
0023	2T	15_9	15	6	0	600	0	-600	0.00	0.00	1	0	-1
0023	2T	15_9	16	6	1	600	700	100	0.17	1.17	1	1	0
0023	2T	15_9	23	1	0	100	0	-100	0.00	0.00	0	0	0
0023	2T	16_1	12	197	59	19700	15670	-4030	0.30	0.80	34	27	-7
0023	2T	16_1	13	63	15	6300	4280	-2020	0.24	0.68	11	7	-4
0023	2T	16_1	14	19	6	1900	2360	460	0.32	1.24	3	4	1
0023	2T	16_1	15	5	1	500	410	-90	0.20	0.82	0	0	0
0023	2T	16_10	12	192	49	19200	13540	-5660	0.26	0.71	33	23	-10
0023	2T	16_10	13	49	17	4900	4980	80	0.35	1.02	8	8	0
0023	2T	16_10	14	20	2	2000	590	-1410	0.10	0.30	3	1	-2
0023	2T	16_10	15	4	1	400	420	20	0.25	1.05	0	0	0
0023	2T	16_10	16	11	2	1100	1660	560	0.18	1.51	1	2	1
0023	2T	16_10	21	1	0	100	0	-100	0.00	0.00	0	0	0
0023	2T	16_10	23	1	0	100	0	-100	0.00	0.00	0	0	0
0023	2T	16_11	12	197	59	19700	15900	-3800	0.30	0.81	34	28	-6
0023	2T	16_11	13	59	13	5900	3910	-1990	0.22	0.66	10	6	-4
0023	2T	16_11	14	29	5	2900	1990	-910	0.17	0.69	5	3	-2
0023	2T	16_11	15	1	0	100	0	-100	0.00	0.00	0	0	0
0023	2T	16_12	12	224	60	22400	17350	-5050	0.27	0.77	39	30	-9
0023	2T	16_12	13	45	17	4500	4970	470	0.38	1.10	7	8	1
0023	2T	16_12	14	10	5	1000	1560	560	0.50	1.56	1	2	1
0023	2T	16_2	12	116	34	11600	12740	1140	0.29	1.10	20	22	2
0023	2T	16_2	13	56	8	5600	2540	-3060	0.14	0.45	9	4	-5
0023	2T	16_2	14	35	6	3500	2720	-780	0.17	0.78	6	4	-2
0023	2T	16_2	15	13	2	1300	2030	730	0.15	1.56	2	3	1
0023	2T	16_2	16	17	1	1700	360	-1340	0.06	0.21	3	0	-3
0023	2T	16_2	23	3	0	300	0	-300	0.00	0.00	0	0	0
0023	2T	16_2	24	1	0	100	0	-100	0.00	0.00	0	0	0
0023	2T	16_2	25	2	1	200	1530	1330	0.50	7.65	0	2	2
0023	2T	16_2	26	1	0	100	0	-100	0.00	0.00	0	0	0
0023	2T	16_3	12	74	13	7400	6290	-1110	0.18	0.85	13	11	-2
0023	2T	16_3	13	49	3	4900	910	-3990	0.06	0.19	8	1	-7
0023	2T	16_3	14	34	5	3400	1800	-1600	0.15	0.53	6	3	-3
0023	2T	16_3	15	19	4	1900	2580	680	0.21	1.36	3	4	1
0023	2T	16_3	16	21	1	2100	1180	-920	0.05	0.56	3	2	-1
0023	2T	16_3	21	1	0	100	0	-100	0.00	0.00	0	0	0
0023	2T	16_3	23	2	1	200	640	440	0.50	3.20	0	1	1
0023	2T	16_3	24	3	1	300	490	190	0.33	1.63	0	0	0
0023	2T	16_3	25	1	0	100	0	-100	0.00	0.00	0	0	0
0023	2T	16_3	26	2	0	200	0	-200	0.00	0.00	0	0	0
0023	2T	16_4	12	78	12	7800	5380	-2420	0.15	0.69	13	9	-4
0023	2T	16_4	13	59	6	5900	2310	-3590	0.10	0.39	10	4	-6
0023	2T	16_4	14	32	9	3200	5530	2330	0.28	1.73	5	9	4
0023	2T	16_4	15	15	1	1500	860	-640	0.07	0.57	2	1	-1
0023	2T	16_4	16	12	1	1200	1420	220	0.08	1.18	2	2	0
0023	2T	16_4	21	1	0	100	0	-100	0.00	0.00	0	0	0
0023	2T	16_4	23	3	1	300	650	350	0.33	2.17	0	1	1
0023	2T	16_4	24	4	0	400	0	-400	0.00	0.00	0	0	0
0023	2T	16_4	25	5	1	500	2780	2280	0.20	5.56	0	4	4
0023	2T	16_4	26	5	0	500	0	-500	0.00	0.00	0	0	0
0023	2T	16_5	12	87	24	8700	7300	-1400	0.28	0.84	15	12	-3
0023	2T	16_5	13	65	13	6500	5670	-830	0.20	0.87	11	10	-1
0023	2T	16_5	14	29	5	2900	2010	-890	0.17	0.69	5	3	-2
0023	2T	16_5	15	10	3	1000	2550	1550	0.30	2.55	1	4	3
0023	2T	16_5	16	16	3	1600	1770	170	0.19	1.11	2	3	1
0023	2T	16_5	23	2	0	200	0	-200	0.00	0.00	0	0	0
0023	2T	16_5	24	2	1	200	740	540	0.50	3.70	0	1	1
0023	2T	16_5	25	3	2	300	1040	740	0.67	3.47	0	1	1
0023	2T	16_5	26	2	0	200	0	-200	0.00	0.00	0	0	0
0023	2T	16_6	12	205	71	20500	18050	-2450	0.35	0.88	36	31	-5
0023	2T	16_6	13	76	18	7600	4960	-2640	0.24	0.65	13	8	-5
0023	2T	16_6	14	2	0	200	0	-200	0.00	0.00	0	0	0
0023	2T	16_6	15	1	1	100	410	310	1.00	4.10	0	0	0
0023	2T	16_6	16	2	0	200	0	-200	0.00	0.00	0	0	0
0023	2T	16_6	23	1	0	100	0	-100	0.00	0.00	0	0	0
0023	2T	16_7	12	78	15	7800	6100	-1700	0.19	0.78	13	10	-3
0023	2T	16_7	13	30	5	3000	2070	-930	0.17	0.69	5	3	-2
0023	2T	16_7	14	31	7	3100	2130	-970	0.23	0.69	5	3	-2
0023	2T	16_7	15	12	1	1200	490	-710	0.08	0.41	2	0	-2
0023	2T	16_7	16	15	4	1500	3860	2360	0.27	2.57	2	6	4
0023	2T	16_7	21	2	0	200	0	-200	0.00	0.00	0	0	0
0023	2T	16_7	23	2	1	200	340	140	0.50	1.70	0	0	0
0023	2T	16_7	24	2	0	200	0	-200	0.00	0.00	0	0	0
0023	2T	16_7	25	6	1	600	370	-230	0.17	0.62	1	0	-1
0023	2T	16_7	26	5	0	500	0	-500	0.00	0.00	0	0	0
0023	2T	16_8	12	99	25	9900	9460	-440	0.25	0.96	17	16	-1
0023	2T	16_8	13	37	3	3700	1830	-1870	0.08	0.49	6	3	-3
0023	2T	16_8	14	48	12	4800	3600	-1200	0.25	0.75	8	6	-2
0023	2T	16_8	15	13	3	1300	1600	300	0.23	1.23	2	2	0
0023	2T	16_8	16	2	0	200	0	-200	0.00	0.00	0	0	0
0023	2T	16_8	21	6	0	600	0	-600	0.00	0.00	1	0	-1
0023	2T	16_8	23	4	0	400	0	-400	0.00	0.00	0	0	0
0023	2T	16_8	25	7	2	700	1420	720	0.29	2.03	1	2	1
0023	2T	16_8	26	6	0	600	0	-600	0.00	0.00	1	0	-1
0023	2T	16_9	12	77	17	7700	5580	-2120	0.22	0.72	13	9	-4
0023	2T	16_9	13	27	5	2700	1650	-1050	0.19	0.61	4	2	-2
0023	2T	16_9	14	177	55	17700	15830	-1870	0.31	0.89	31	28	-3
0023	2T	16_9	15	1	0	100	0	-100	0.00	0.00	0	0	0
0023	2T	17_1	12	185	43	18500	12230	-6270	0.23	0.66	32	21	-11
0023	2T	17_1	13	66	15	6600	5120	-1480	0.23	0.78	11	9	-2
0023	2T	17_1	14	21	3	2100	910	-1190	0.14	0.43	3	1	-2
0023	2T	17_1	15	1	1	100	380	280	1.00	3.80	0	0	0
0023	2T	17_10	12	149	40	14900	10400	-4500	0.27	0.70	26	18	-8
0023	2T	17_10	13	77	24	7700	7540	-160	0.31	0.98	13	13	0
0023	2T	17_10	14	22	4	2200	1830	-370	0.18	0.83	3	3	0
0023	2T	17_10	15	1	0	100	0	-100	0.00	0.00	0	0	0
0023	2T	17_10	16	2	0	200	0	-200	0.00	0.00	0	0	0
0023	2T	17_10	21	3	0	300	0	-300	0.00	0.00	0	0	0
0023	2T	17_10	26	1	0	100	0	-100	0.00	0.00	0	0	0
0023	2T	17_11	12	154	45	15400	11610	-3790	0.29	0.75	27	20	-7
0023	2T	17_11	13	68	18	6800	5810	-990	0.26	0.85	12	10	-2
0023	2T	17_11	14	21	2	2100	610	-1490	0.10	0.29	3	1	-2
0023	2T	17_11	21	5	0	500	0	-500	0.00	0.00	0	0	0
0023	2T	17_11	26	1	0	100	0	-100	0.00	0.00	0	0	0
0023	2T	17_12	12	222	59	22200	16140	-6060	0.27	0.73	39	28	-11
0023	2T	17_12	13	30	5	3000	1570	-1430	0.17	0.52	5	2	-3
0023	2T	17_12	15	1	0	100	0	-100	0.00	0.00	0	0	0
0023	2T	17_12	21	1	0	100	0	-100	0.00	0.00	0	0	0
0023	2T	17_12	25	1	0	100	0	-100	0.00	0.00	0	0	0
0023	2T	17_2	12	124	19	12400	6770	-5630	0.15	0.55	21	11	-10
0023	2T	17_2	13	55	11	5500	4950	-550	0.20	0.90	9	8	-1
0023	2T	17_2	14	25	2	2500	1490	-1010	0.08	0.60	4	2	-2
0023	2T	17_2	15	9	0	900	0	-900	0.00	0.00	1	0	-1
0023	2T	17_2	16	2	0	200	0	-200	0.00	0.00	0	0	0
0023	2T	17_2	23	1	0	100	0	-100	0.00	0.00	0	0	0
0023	2T	17_2	24	2	0	200	0	-200	0.00	0.00	0	0	0
0023	2T	17_2	25	2	0	200	0	-200	0.00	0.00	0	0	0
0023	2T	17_3	12	71	13	7100	5430	-1670	0.18	0.76	12	9	-3
0023	2T	17_3	13	43	4	4300	2240	-2060	0.09	0.52	7	3	-4
0023	2T	17_3	14	26	0	2600	0	-2600	0.00	0.00	4	0	-4
0023	2T	17_3	15	14	1	1400	990	-410	0.07	0.71	2	1	-1
0023	2T	17_3	16	4	1	400	770	370	0.25	1.93	0	1	1
0023	2T	17_3	21	4	1	400	680	280	0.25	1.70	0	1	1
0023	2T	17_3	23	9	0	900	0	-900	0.00	0.00	1	0	-1
0023	2T	17_3	24	4	0	400	0	-400	0.00	0.00	0	0	0
0023	2T	17_3	25	1	0	100	0	-100	0.00	0.00	0	0	0
0023	2T	17_3	26	1	0	100	0	-100	0.00	0.00	0	0	0
0023	2T	17_4	12	107	19	10700	6000	-4700	0.18	0.56	18	10	-8
0023	2T	17_4	13	59	19	5900	5240	-660	0.32	0.89	10	9	-1
0023	2T	17_4	14	29	7	2900	3760	860	0.24	1.30	5	6	1
0023	2T	17_4	15	9	1	900	1010	110	0.11	1.12	1	1	0
0023	2T	17_4	16	1	0	100	0	-100	0.00	0.00	0	0	0
0023	2T	17_4	21	1	0	100	0	-100	0.00	0.00	0	0	0
0023	2T	17_4	23	6	1	600	470	-130	0.17	0.78	1	0	-1
0023	2T	17_4	24	6	0	600	0	-600	0.00	0.00	1	0	-1
0023	2T	17_4	25	3	2	300	1330	1030	0.67	4.43	0	2	2
0023	2T	17_5	12	100	30	10000	10440	440	0.30	1.04	17	18	1
0023	2T	17_5	13	75	23	7500	5750	-1750	0.31	0.77	13	10	-3
0023	2T	17_5	14	31	6	3100	1740	-1360	0.19	0.56	5	3	-2
0023	2T	17_5	15	4	0	400	0	-400	0.00	0.00	0	0	0
0023	2T	17_5	16	1	0	100	0	-100	0.00	0.00	0	0	0
0023	2T	17_5	21	1	0	100	0	-100	0.00	0.00	0	0	0
0023	2T	17_5	23	1	0	100	0	-100	0.00	0.00	0	0	0
0023	2T	17_5	24	2	0	200	0	-200	0.00	0.00	0	0	0
0023	2T	17_5	25	3	0	300	0	-300	0.00	0.00	0	0	0
0023	2T	17_5	26	4	0	400	0	-400	0.00	0.00	0	0	0
0023	2T	17_6	12	106	24	10600	7320	-3280	0.23	0.69	18	12	-6
0023	2T	17_6	13	38	9	3800	2540	-1260	0.24	0.67	6	4	-2
0023	2T	17_6	14	26	5	2600	2310	-290	0.19	0.89	4	4	0
0023	2T	17_6	15	11	2	1100	620	-480	0.18	0.56	1	1	0
0023	2T	17_6	16	2	1	200	600	400	0.50	3.00	0	1	1
0023	2T	17_6	23	5	0	500	0	-500	0.00	0.00	0	0	0
0023	2T	17_6	24	7	2	700	760	60	0.29	1.09	1	1	0
0023	2T	17_6	25	1	0	100	0	-100	0.00	0.00	0	0	0
0023	2T	17_6	26	1	0	100	0	-100	0.00	0.00	0	0	0
0023	2T	17_7	12	98	23	9800	7880	-1920	0.23	0.80	17	13	-4
0023	2T	17_7	13	61	16	6100	6490	390	0.26	1.06	10	11	1
0023	2T	17_7	14	28	6	2800	2300	-500	0.21	0.82	4	4	0
0023	2T	17_7	15	5	2	500	680	180	0.40	1.36	0	1	1
0023	2T	17_7	16	3	0	300	0	-300	0.00	0.00	0	0	0
0023	2T	17_7	21	2	1	200	1410	1210	0.50	7.05	0	2	2
0023	2T	17_7	23	6	1	600	620	20	0.17	1.03	1	1	0
0023	2T	17_7	24	7	1	700	390	-310	0.14	0.56	1	0	-1
0023	2T	17_7	25	1	0	100	0	-100	0.00	0.00	0	0	0
0023	2T	17_8	12	101	20	10100	5850	-4250	0.20	0.58	17	10	-7
0023	2T	17_8	13	63	17	6300	4240	-2060	0.27	0.67	11	7	-4
0023	2T	17_8	14	34	7	3400	2270	-1130	0.21	0.67	6	4	-2
0023	2T	17_8	15	7	1	700	350	-350	0.14	0.50	1	0	-1
0023	2T	17_8	16	4	2	400	680	280	0.50	1.70	0	1	1
0023	2T	17_8	21	2	0	200	0	-200	0.00	0.00	0	0	0
0023	2T	17_8	23	1	0	100	0	-100	0.00	0.00	0	0	0
0023	2T	17_8	24	1	0	100	0	-100	0.00	0.00	0	0	0
0023	2T	17_8	25	1	0	100	0	-100	0.00	0.00	0	0	0
0023	2T	17_9	12	135	48	13500	13100	-400	0.36	0.97	23	23	0
0023	2T	17_9	13	110	32	11000	8010	-2990	0.29	0.73	19	14	-5
0023	2T	17_9	14	23	6	2300	1780	-520	0.26	0.77	4	3	-1
0023	2T	18_1	12	244	86	24400	24000	-400	0.35	0.98	43	42	-1
0023	2T	18_1	13	38	6	3800	1750	-2050	0.16	0.46	6	3	-3
0023	2T	18_1	14	7	1	700	270	-430	0.14	0.39	1	0	-1
0023	2T	18_1	15	6	2	600	1030	430	0.33	1.72	1	1	0
0023	2T	18_10	12	127	37	12700	12130	-570	0.29	0.96	22	21	-1
0023	2T	18_10	13	46	15	4600	6040	1440	0.33	1.31	8	10	2
0023	2T	18_10	14	24	5	2400	2100	-300	0.21	0.88	4	3	-1
0023	2T	18_10	15	9	0	900	0	-900	0.00	0.00	1	0	-1
0023	2T	18_10	16	12	1	1200	390	-810	0.08	0.33	2	0	-2
0023	2T	18_10	23	1	0	100	0	-100	0.00	0.00	0	0	0
0023	2T	18_10	25	1	0	100	0	-100	0.00	0.00	0	0	0
0023	2T	18_10	26	4	0	400	0	-400	0.00	0.00	0	0	0
0023	2T	18_11	12	144	49	14400	12620	-1780	0.34	0.88	25	22	-3
0023	2T	18_11	13	89	21	8900	6520	-2380	0.24	0.73	15	11	-4
0023	2T	18_11	14	38	11	3800	3060	-740	0.29	0.81	6	5	-1
0023	2T	18_11	15	13	2	1300	760	-540	0.15	0.58	2	1	-1
0023	2T	18_11	16	2	0	200	0	-200	0.00	0.00	0	0	0
0023	2T	18_12	12	257	93	25700	24110	-1590	0.36	0.94	45	42	-3
0023	2T	18_12	13	25	10	2500	3170	670	0.40	1.27	4	5	1
0023	2T	18_12	14	7	2	700	570	-130	0.29	0.81	1	1	0
0023	2T	18_2	12	178	48	17800	15740	-2060	0.27	0.88	31	27	-4
0023	2T	18_2	13	59	8	5900	2540	-3360	0.14	0.43	10	4	-6
0023	2T	18_2	14	38	11	3800	3330	-470	0.29	0.88	6	5	-1
0023	2T	18_2	15	5	1	500	220	-280	0.20	0.44	0	0	0
0023	2T	18_2	16	3	0	300	0	-300	0.00	0.00	0	0	0
0023	2T	18_3	12	134	39	13400	14420	1020	0.29	1.08	23	25	2
0023	2T	18_3	13	107	27	10700	8850	-1850	0.25	0.83	18	15	-3
0023	2T	18_3	14	28	9	2800	2970	170	0.32	1.06	4	5	1
0023	2T	18_3	15	6	2	600	660	60	0.33	1.10	1	1	0
0023	2T	18_3	16	11	2	1100	880	-220	0.18	0.80	1	1	0
0023	2T	18_4	12	289	130	28900	21650	-7250	0.45	0.75	51	38	-13
0023	2T	18_4	13	4	0	400	0	-400	0.00	0.00	0	0	0
0023	2T	18_4	14	2	0	200	0	-200	0.00	0.00	0	0	0
0023	2T	18_5	12	70	11	7000	3960	-3040	0.16	0.57	12	7	-5
0023	2T	18_5	13	62	17	6200	7230	1030	0.27	1.17	10	12	2
0023	2T	18_5	14	12	2	1200	530	-670	0.17	0.44	2	0	-2
0023	2T	18_5	15	10	1	1000	490	-510	0.10	0.49	1	0	-1
0023	2T	18_5	16	8	3	800	1340	540	0.38	1.68	1	2	1
0023	2T	18_5	21	25	6	2500	2170	-330	0.24	0.87	4	3	-1
0023	2T	18_5	23	9	1	900	630	-270	0.11	0.70	1	1	0
0023	2T	18_5	24	18	4	1800	2900	1100	0.22	1.61	3	5	2
0023	2T	18_5	25	1	0	100	0	-100	0.00	0.00	0	0	0
0023	2T	18_5	26	6	1	600	320	-280	0.17	0.53	1	0	-1
0023	2T	18_6	12	68	11	6800	4480	-2320	0.16	0.66	12	7	-5
0023	2T	18_6	13	58	7	5800	3820	-1980	0.12	0.66	10	6	-4
0023	2T	18_6	14	25	5	2500	5630	3130	0.20	2.25	4	9	5
0023	2T	18_6	15	2	0	200	0	-200	0.00	0.00	0	0	0
0023	2T	18_6	16	15	1	1500	340	-1160	0.07	0.23	2	0	-2
0023	2T	18_6	21	9	0	900	0	-900	0.00	0.00	1	0	-1
0023	2T	18_6	23	9	0	900	0	-900	0.00	0.00	1	0	-1
0023	2T	18_6	24	2	0	200	0	-200	0.00	0.00	0	0	0
0023	2T	18_6	25	1	0	100	0	-100	0.00	0.00	0	0	0
0023	2T	18_6	26	6	1	600	630	30	0.17	1.05	1	1	0
0023	2T	18_7	12	125	29	12500	11650	-850	0.23	0.93	22	20	-2
0023	2T	18_7	13	67	12	6700	4860	-1840	0.18	0.73	11	8	-3
0023	2T	18_7	14	18	2	1800	1090	-710	0.11	0.61	3	1	-2
0023	2T	18_7	15	2	0	200	0	-200	0.00	0.00	0	0	0
0023	2T	18_7	16	3	1	300	790	490	0.33	2.63	0	1	1
0023	2T	18_7	21	12	0	1200	0	-1200	0.00	0.00	2	0	-2
0023	2T	18_7	23	6	0	600	0	-600	0.00	0.00	1	0	-1
0023	2T	18_7	24	1	0	100	0	-100	0.00	0.00	0	0	0
0023	2T	18_7	26	1	0	100	0	-100	0.00	0.00	0	0	0
0023	2T	18_8	12	78	19	7800	7150	-650	0.24	0.92	13	12	-1
0023	2T	18_8	13	65	15	6500	5540	-960	0.23	0.85	11	9	-2
0023	2T	18_8	14	26	4	2600	1270	-1330	0.15	0.49	4	2	-2
0023	2T	18_8	15	15	2	1500	640	-860	0.13	0.43	2	1	-1
0023	2T	18_8	16	7	3	700	2210	1510	0.43	3.16	1	3	2
0023	2T	18_8	21	2	0	200	0	-200	0.00	0.00	0	0	0
0023	2T	18_8	23	3	1	300	520	220	0.33	1.73	0	0	0
0023	2T	18_8	24	2	0	200	0	-200	0.00	0.00	0	0	0
0023	2T	18_8	25	3	0	300	0	-300	0.00	0.00	0	0	0
0023	2T	18_8	26	7	0	700	0	-700	0.00	0.00	1	0	-1
0023	2T	18_9	12	85	23	8500	8590	90	0.27	1.01	15	15	0
0023	2T	18_9	13	80	20	8000	6540	-1460	0.25	0.82	14	11	-3
0023	2T	18_9	14	26	7	2600	2350	-250	0.27	0.90	4	4	0
0023	2T	18_9	15	2	0	200	0	-200	0.00	0.00	0	0	0
0023	2T	18_9	16	4	0	400	0	-400	0.00	0.00	0	0	0
0023	2T	18_9	21	3	0	300	0	-300	0.00	0.00	0	0	0
0023	2T	18_9	23	2	0	200	0	-200	0.00	0.00	0	0	0
0023	2T	18_9	24	4	1	400	770	370	0.25	1.93	0	1	1
0023	2T	18_9	25	2	0	200	0	-200	0.00	0.00	0	0	0
0023	2T	18_9	26	3	1	300	970	670	0.33	3.23	0	1	1
0023	2T	19_1	12	149	36	14900	10410	-4490	0.24	0.70	26	18	-8
0023	2T	19_1	13	50	11	5000	3180	-1820	0.22	0.64	8	5	-3
0023	2T	19_1	14	19	5	1900	1620	-280	0.26	0.85	3	2	-1
0023	2T	19_1	15	3	0	300	0	-300	0.00	0.00	0	0	0
0023	2T	19_1	16	3	0	300	0	-300	0.00	0.00	0	0	0
0023	2T	19_10	12	163	45	16300	12740	-3560	0.28	0.78	28	22	-6
0023	2T	19_10	13	62	13	6200	4370	-1830	0.21	0.70	10	7	-3
0023	2T	19_10	14	23	5	2300	1450	-850	0.22	0.63	4	2	-2
0023	2T	19_10	15	1	0	100	0	-100	0.00	0.00	0	0	0
0023	2T	19_10	16	1	0	100	0	-100	0.00	0.00	0	0	0
0023	2T	19_11	12	181	51	18100	13460	-4640	0.28	0.74	32	23	-9
0023	2T	19_11	13	53	13	5300	3490	-1810	0.25	0.66	9	6	-3
0023	2T	19_11	14	18	3	1800	910	-890	0.17	0.51	3	1	-2
0023	2T	19_11	15	1	0	100	0	-100	0.00	0.00	0	0	0
0023	2T	19_12	12	208	55	20800	17240	-3560	0.26	0.83	36	30	-6
0023	2T	19_12	13	26	7	2600	2250	-350	0.27	0.87	4	3	-1
0023	2T	19_12	14	10	2	1000	830	-170	0.20	0.83	1	1	0
0023	2T	19_2	12	71	13	7100	4990	-2110	0.18	0.70	12	8	-4
0023	2T	19_2	13	51	5	5100	1820	-3280	0.10	0.36	9	3	-6
0023	2T	19_2	14	23	4	2300	2520	220	0.17	1.10	4	4	0
0023	2T	19_2	15	13	0	1300	0	-1300	0.00	0.00	2	0	-2
0023	2T	19_2	16	11	0	1100	0	-1100	0.00	0.00	1	0	-1
0023	2T	19_2	23	5	1	500	1800	1300	0.20	3.60	0	3	3
0023	2T	19_2	26	3	1	300	310	10	0.33	1.03	0	0	0
0023	2T	19_3	12	58	14	5800	6530	730	0.24	1.13	10	11	1
0023	2T	19_3	13	38	3	3800	1200	-2600	0.08	0.32	6	2	-4
0023	2T	19_3	14	11	3	1100	1250	150	0.27	1.14	1	2	1
0023	2T	19_3	15	12	0	1200	0	-1200	0.00	0.00	2	0	-2
0023	2T	19_3	16	17	1	1700	350	-1350	0.06	0.21	3	0	-3
0023	2T	19_3	23	4	0	400	0	-400	0.00	0.00	0	0	0
0023	2T	19_3	24	5	1	500	840	340	0.20	1.68	0	1	1
0023	2T	19_3	25	1	0	100	0	-100	0.00	0.00	0	0	0
0023	2T	19_3	26	4	0	400	0	-400	0.00	0.00	0	0	0
0023	2T	19_4	12	56	6	5600	2230	-3370	0.11	0.40	9	3	-6
0023	2T	19_4	13	50	9	5000	3870	-1130	0.18	0.77	8	6	-2
0023	2T	19_4	14	8	2	800	650	-150	0.25	0.81	1	1	0
0023	2T	19_4	15	8	1	800	720	-80	0.13	0.90	1	1	0
0023	2T	19_4	16	10	1	1000	670	-330	0.10	0.67	1	1	0
0023	2T	19_4	21	5	0	500	0	-500	0.00	0.00	0	0	0
0023	2T	19_4	23	5	0	500	0	-500	0.00	0.00	0	0	0
0023	2T	19_4	24	2	1	200	550	350	0.50	2.75	0	0	0
0023	2T	19_4	26	9	0	900	0	-900	0.00	0.00	1	0	-1
0023	2T	19_5	12	67	20	6700	5850	-850	0.30	0.87	11	10	-1
0023	2T	19_5	13	25	7	2500	2520	20	0.28	1.01	4	4	0
0023	2T	19_5	14	159	55	15900	14390	-1510	0.35	0.91	28	25	-3
0023	2T	19_6	12	51	7	5100	1910	-3190	0.14	0.37	9	3	-6
0023	2T	19_6	13	48	11	4800	2820	-1980	0.23	0.59	8	4	-4
0023	2T	19_6	14	15	2	1500	1060	-440	0.13	0.71	2	1	-1
0023	2T	19_6	15	2	0	200	0	-200	0.00	0.00	0	0	0
0023	2T	19_6	16	9	0	900	0	-900	0.00	0.00	1	0	-1
0023	2T	19_6	21	5	1	500	580	80	0.20	1.16	0	1	1
0023	2T	19_6	23	7	0	700	0	-700	0.00	0.00	1	0	-1
0023	2T	19_6	24	4	0	400	0	-400	0.00	0.00	0	0	0
0023	2T	19_6	25	1	0	100	0	-100	0.00	0.00	0	0	0
0023	2T	19_6	26	7	0	700	0	-700	0.00	0.00	1	0	-1
0023	2T	19_7	12	63	14	6300	3570	-2730	0.22	0.57	11	6	-5
0023	2T	19_7	13	120	38	12000	10540	-1460	0.32	0.88	21	18	-3
0023	2T	19_7	14	53	18	5300	6170	870	0.34	1.16	9	10	1
0023	2T	19_7	15	3	0	300	0	-300	0.00	0.00	0	0	0
0023	2T	19_7	16	5	1	500	300	-200	0.20	0.60	0	0	0
0023	2T	19_8	12	83	16	8300	4480	-3820	0.19	0.54	14	7	-7
0023	2T	19_8	13	94	24	9400	6600	-2800	0.26	0.70	16	11	-5
0023	2T	19_8	14	41	12	4100	4190	90	0.29	1.02	7	7	0
0023	2T	19_8	15	5	0	500	0	-500	0.00	0.00	0	0	0
0023	2T	19_8	16	3	0	300	0	-300	0.00	0.00	0	0	0
0023	2T	19_8	24	1	0	100	0	-100	0.00	0.00	0	0	0
0023	2T	19_9	12	128	43	12800	11970	-830	0.34	0.94	22	21	-1
0023	2T	19_9	13	78	28	7800	7570	-230	0.36	0.97	13	13	0
0023	2T	19_9	14	31	1	3100	330	-2770	0.03	0.11	5	0	-5
0023	2T	19_9	15	3	1	300	220	-80	0.33	0.73	0	0	0
0023	2T	19_9	16	2	0	200	0	-200	0.00	0.00	0	0	0
0023	2T	19_9	21	1	0	100	0	-100	0.00	0.00	0	0	0
0023	2T	19_9	23	1	0	100	0	-100	0.00	0.00	0	0	0
0023	2T	20_1	12	142	23	14200	8360	-5840	0.16	0.59	25	14	-11
0023	2T	20_1	13	46	6	4600	2810	-1790	0.13	0.61	8	4	-4
0023	2T	20_1	14	28	3	2800	1400	-1400	0.11	0.50	4	2	-2
0023	2T	20_1	15	11	1	1100	570	-530	0.09	0.52	1	1	0
0023	2T	20_1	16	2	1	200	630	430	0.50	3.15	0	1	1
0023	2T	20_1	23	1	0	100	0	-100	0.00	0.00	0	0	0
0023	2T	20_1	24	1	0	100	0	-100	0.00	0.00	0	0	0
0023	2T	20_1	25	1	0	100	0	-100	0.00	0.00	0	0	0
0023	2T	20_10	12	156	43	15600	13560	-2040	0.28	0.87	27	24	-3
0023	2T	20_10	13	74	15	7400	4250	-3150	0.20	0.57	13	7	-6
0023	2T	20_10	14	28	6	2800	2030	-770	0.21	0.73	4	3	-1
0023	2T	20_10	15	3	0	300	0	-300	0.00	0.00	0	0	0
0023	2T	20_11	12	181	55	18100	14940	-3160	0.30	0.83	32	26	-6
0023	2T	20_11	13	61	21	6100	5640	-460	0.34	0.92	10	9	-1
0023	2T	20_11	14	25	9	2500	2650	150	0.36	1.06	4	4	0
0023	2T	20_11	15	2	1	200	380	180	0.50	1.90	0	0	0
0023	2T	20_12	12	204	47	20400	15180	-5220	0.23	0.74	36	26	-10
0023	2T	20_12	13	37	12	3700	3690	-10	0.32	1.00	6	6	0
0023	2T	20_12	14	15	0	1500	0	-1500	0.00	0.00	2	0	-2
0023	2T	20_12	15	1	1	100	380	280	1.00	3.80	0	0	0
0011	1T	5_8	2	40	15	4000	6520	2520	0.38	1.63	7	11	4
0011	1T	5_9	1	654	442	65400	62030	-3370	0.68	0.95	115	109	-6
0011	1T	5_9	2	36	8	3600	2400	-1200	0.22	0.67	6	4	-2
0011	1T	6_1	1	50	33	5000	5310	310	0.66	1.06	8	9	1
0011	1T	6_1	2	4	2	400	900	500	0.50	2.25	0	1	1
0011	1T	6_10	1	54	44	5400	5730	330	0.81	1.06	9	10	1
0011	1T	6_10	2	1	0	100	0	-100	0.00	0.00	0	0	0
0011	1T	6_11	1	57	43	5700	4840	-860	0.75	0.85	10	8	-2
0011	1T	6_11	2	1	0	100	0	-100	0.00	0.00	0	0	0
0011	1T	6_12	1	56	37	5600	4560	-1040	0.66	0.81	9	8	-1
0011	1T	6_12	2	1	1	100	570	470	1.00	5.70	0	1	1
0011	1T	6_2	1	41	20	4100	3550	-550	0.49	0.87	7	6	-1
0011	1T	6_2	2	9	2	900	460	-440	0.22	0.51	1	0	-1
0011	1T	6_3	1	42	26	4200	4210	10	0.62	1.00	7	7	0
0011	1T	6_3	2	4	2	400	540	140	0.50	1.35	0	0	0
0011	1T	6_4	1	52	28	5200	4580	-620	0.54	0.88	9	8	-1
0011	1T	6_4	2	1	0	100	0	-100	0.00	0.00	0	0	0
0011	1T	6_5	1	54	26	5400	4410	-990	0.48	0.82	9	7	-2
0011	1T	6_6	1	49	26	4900	4050	-850	0.53	0.83	8	7	-1
0011	1T	6_6	2	2	1	200	1110	910	0.50	5.55	0	1	1
0011	1T	6_7	1	47	24	4700	4260	-440	0.51	0.91	8	7	-1
0011	1T	6_7	2	3	2	300	560	260	0.67	1.87	0	0	0
0011	1T	6_8	1	50	32	5000	5010	10	0.64	1.00	8	8	0
0011	1T	6_9	1	50	30	5000	3900	-1100	0.60	0.78	8	6	-2
0011	1T	6_9	2	5	2	500	1080	580	0.40	2.16	0	1	1
0011	1T	7_1	1	940	623	94000	83470	-10530	0.66	0.89	166	147	-19
0011	1T	7_1	2	84	20	8400	13940	5540	0.24	1.66	14	24	10
0011	1T	7_10	1	1047	666	104700	98260	-6440	0.64	0.94	185	173	-12
0011	1T	7_10	2	73	15	7300	4990	-2310	0.21	0.68	12	8	-4
0011	1T	7_11	1	1091	745	109100	100100	-9000	0.68	0.92	193	177	-16
0011	1T	7_11	2	47	13	4700	4700	0	0.28	1.00	8	8	0
0011	1T	7_12	1	1118	773	111800	97790	-14010	0.69	0.87	197	173	-24
0011	1T	7_12	2	41	7	4100	2140	-1960	0.17	0.52	7	3	-4
0011	1T	7_2	1	828	435	82800	75150	-7650	0.53	0.91	146	133	-13
0011	1T	7_2	2	137	24	13700	9520	-4180	0.18	0.69	24	16	-8
0011	1T	7_3	1	903	503	90300	86600	-3700	0.56	0.96	159	153	-6
0011	1T	7_3	2	131	38	13100	16980	3880	0.29	1.30	23	30	7
0011	1T	7_4	1	939	551	93900	89700	-4200	0.59	0.96	166	158	-8
0011	1T	7_4	2	121	38	12100	11470	-630	0.31	0.95	21	20	-1
0011	1T	7_5	1	963	586	96300	88600	-7700	0.61	0.92	170	156	-14
0011	1T	7_5	2	105	29	10500	9910	-590	0.28	0.94	18	17	-1
0011	1T	7_6	1	945	551	94500	82930	-11570	0.58	0.88	167	146	-21
0011	1T	7_6	2	113	36	11300	9730	-1570	0.32	0.86	20	17	-3
0011	1T	7_7	1	992	633	99200	93260	-5940	0.64	0.94	175	165	-10
0011	1T	7_7	2	72	20	7200	4860	-2340	0.28	0.68	12	8	-4
0011	1T	7_8	1	1013	656	101300	92520	-8780	0.65	0.91	179	163	-16
0011	1T	7_8	2	70	16	7000	5950	-1050	0.23	0.85	12	10	-2
0011	1T	7_9	1	1053	684	105300	99580	-5720	0.65	0.95	186	176	-10
0011	1T	7_9	2	48	15	4800	3960	-840	0.31	0.83	8	7	-1
0011	2F	1_1	12	345	80	34500	25500	-9000	0.23	0.74	61	45	-16
0011	2F	1_1	13	247	54	24700	20010	-4690	0.22	0.81	43	35	-8
0011	2F	1_1	14	183	34	18300	11350	-6950	0.19	0.62	32	20	-12
0011	2F	1_1	15	66	3	6600	2300	-4300	0.05	0.35	11	4	-7
0011	2F	1_1	16	15	0	1500	0	-1500	0.00	0.00	2	0	-2
0011	2F	1_1	23	15	0	1500	0	-1500	0.00	0.00	2	0	-2
0011	2F	1_1	24	11	3	1100	8640	7540	0.27	7.85	1	15	14
0011	2F	1_1	25	9	0	900	0	-900	0.00	0.00	1	0	-1
0011	2F	1_1	26	2	0	200	0	-200	0.00	0.00	0	0	0
0011	2F	1_10	12	485	148	48500	41570	-6930	0.31	0.86	85	73	-12
0011	2F	1_10	13	287	63	28700	19210	-9490	0.22	0.67	50	34	-16
0011	2F	1_10	14	137	27	13700	12320	-1380	0.20	0.90	24	21	-3
0011	2F	1_10	15	30	4	3000	2070	-930	0.13	0.69	5	3	-2
0011	2F	1_10	16	20	1	2000	1230	-770	0.05	0.62	3	2	-1
0011	2F	1_10	23	2	0	200	0	-200	0.00	0.00	0	0	0
0011	2F	1_10	24	1	0	100	0	-100	0.00	0.00	0	0	0
0011	2F	1_10	25	1	0	100	0	-100	0.00	0.00	0	0	0
0011	2F	1_10	26	3	0	300	0	-300	0.00	0.00	0	0	0
0011	2F	1_11	12	521	154	52100	45020	-7080	0.30	0.86	92	79	-13
0011	2F	1_11	13	271	65	27100	21730	-5370	0.24	0.80	47	38	-9
0011	2F	1_11	14	167	39	16700	14690	-2010	0.23	0.88	29	26	-3
0011	2F	1_11	15	39	8	3900	4990	1090	0.21	1.28	6	8	2
0011	2F	1_11	16	7	1	700	890	190	0.14	1.27	1	1	0
0011	2F	1_11	23	1	0	100	0	-100	0.00	0.00	0	0	0
0011	2F	1_11	24	1	1	100	1120	1020	1.00	11.20	0	1	1
0011	2F	1_11	25	2	0	200	0	-200	0.00	0.00	0	0	0
0011	2F	1_12	12	613	179	61300	49190	-12110	0.29	0.80	108	87	-21
0011	2F	1_12	13	239	61	23900	22380	-1520	0.26	0.94	42	39	-3
0011	2F	1_12	14	149	33	14900	11430	-3470	0.22	0.77	26	20	-6
0011	2F	1_12	15	39	1	3900	600	-3300	0.03	0.15	6	1	-5
0011	2F	1_12	16	3	0	300	0	-300	0.00	0.00	0	0	0
0011	2F	1_12	23	2	0	200	0	-200	0.00	0.00	0	0	0
0011	2F	1_12	25	1	0	100	0	-100	0.00	0.00	0	0	0
0011	2F	1_2	12	359	85	35900	25540	-10360	0.24	0.71	63	45	-18
0011	2F	1_2	13	239	37	23900	17250	-6650	0.15	0.72	42	30	-12
0011	2F	1_2	14	172	21	17200	8920	-8280	0.12	0.52	30	15	-15
0011	2F	1_2	15	65	5	6500	5150	-1350	0.08	0.79	11	9	-2
0011	2F	1_2	16	24	1	2400	360	-2040	0.04	0.15	4	0	-4
0011	2F	1_2	23	17	1	1700	330	-1370	0.06	0.19	3	0	-3
0011	2F	1_2	24	14	0	1400	0	-1400	0.00	0.00	2	0	-2
0011	2F	1_2	25	7	0	700	0	-700	0.00	0.00	1	0	-1
0011	2F	1_2	26	1	0	100	0	-100	0.00	0.00	0	0	0
0011	2F	1_3	12	323	62	32300	27260	-5040	0.19	0.84	57	48	-9
0011	2F	1_3	13	247	50	24700	17780	-6920	0.20	0.72	43	31	-12
0011	2F	1_3	14	151	25	15100	17370	2270	0.17	1.15	26	30	4
0011	2F	1_3	15	78	7	7800	10160	2360	0.09	1.30	13	17	4
0011	2F	1_3	16	19	0	1900	0	-1900	0.00	0.00	3	0	-3
0011	2F	1_3	23	23	2	2300	1900	-400	0.09	0.83	4	3	-1
0011	2F	1_3	24	13	0	1300	0	-1300	0.00	0.00	2	0	-2
0011	2F	1_3	25	6	1	600	880	280	0.17	1.47	1	1	0
0011	2F	1_3	26	4	0	400	0	-400	0.00	0.00	0	0	0
0011	2F	1_4	12	403	102	40300	33570	-6730	0.25	0.83	71	59	-12
0011	2F	1_4	13	258	44	25800	17110	-8690	0.17	0.66	45	30	-15
0011	2F	1_4	14	140	27	14000	12000	-2000	0.19	0.86	24	21	-3
0011	2F	1_4	15	57	5	5700	1310	-4390	0.09	0.23	10	2	-8
0011	2F	1_4	16	27	2	2700	5300	2600	0.07	1.96	4	9	5
0011	2F	1_4	23	26	3	2600	1090	-1510	0.12	0.42	4	1	-3
0011	2F	1_4	24	12	1	1200	270	-930	0.08	0.23	2	0	-2
0011	2F	1_4	25	4	0	400	0	-400	0.00	0.00	0	0	0
0011	2F	1_4	26	2	0	200	0	-200	0.00	0.00	0	0	0
0011	2F	1_5	12	369	126	36900	32830	-4070	0.34	0.89	65	58	-7
0011	2F	1_5	13	247	61	24700	26290	1590	0.25	1.06	43	46	3
0011	2F	1_5	14	158	28	15800	12940	-2860	0.18	0.82	27	22	-5
0011	2F	1_5	15	36	2	3600	1200	-2400	0.06	0.33	6	2	-4
0011	2F	1_5	16	14	2	1400	910	-490	0.14	0.65	2	1	-1
0011	2F	1_5	23	30	5	3000	1520	-1480	0.17	0.51	5	2	-3
0011	2F	1_5	24	19	1	1900	420	-1480	0.05	0.22	3	0	-3
0011	2F	1_5	25	5	0	500	0	-500	0.00	0.00	0	0	0
0011	2F	1_5	26	5	0	500	0	-500	0.00	0.00	0	0	0
0011	2F	1_6	12	346	95	34600	36370	1770	0.27	1.05	61	64	3
0011	2F	1_6	13	198	41	19800	16770	-3030	0.21	0.85	35	29	-6
0011	2F	1_6	14	130	12	13000	5440	-7560	0.09	0.42	23	9	-14
0011	2F	1_6	15	45	5	4500	1530	-2970	0.11	0.34	7	2	-5
0011	2F	1_6	16	39	5	3900	2240	-1660	0.13	0.57	6	3	-3
0011	2F	1_6	23	27	4	2700	1440	-1260	0.15	0.53	4	2	-2
0011	2F	1_6	24	12	4	1200	1940	740	0.33	1.62	2	3	1
0011	2F	1_6	25	12	1	1200	690	-510	0.08	0.58	2	1	-1
0011	2F	1_6	26	10	1	1000	180	-820	0.10	0.18	1	0	-1
0011	2F	1_7	12	343	84	34300	27750	-6550	0.24	0.81	60	49	-11
0011	2F	1_7	13	220	48	22000	15080	-6920	0.22	0.69	38	26	-12
0011	2F	1_7	14	134	32	13400	10920	-2480	0.24	0.81	23	19	-4
0011	2F	1_7	15	47	10	4700	6040	1340	0.21	1.29	8	10	2
0011	2F	1_7	16	28	3	2800	3140	340	0.11	1.12	4	5	1
0011	2F	1_7	23	30	3	3000	1380	-1620	0.10	0.46	5	2	-3
0011	2F	1_7	24	25	7	2500	4050	1550	0.28	1.62	4	7	3
0011	2F	1_7	25	15	0	1500	0	-1500	0.00	0.00	2	0	-2
0011	2F	1_7	26	5	2	500	1240	740	0.40	2.48	0	2	2
0011	2F	1_8	12	361	95	36100	30210	-5890	0.26	0.84	63	53	-10
0011	2F	1_8	13	206	57	20600	17940	-2660	0.28	0.87	36	31	-5
0011	2F	1_8	14	144	24	14400	6340	-8060	0.17	0.44	25	11	-14
0011	2F	1_8	15	47	8	4700	6740	2040	0.17	1.43	8	11	3
0041	1T	nopattern	1	21327	15295	2132700	1941700	-191000	0.72	0.91	3774	3436	-338
0041	1T	nopattern	2	10557	3540	1055700	912230	-143470	0.34	0.86	1868	1614	-254
0041	2F	nopattern	12	9017	3449	901700	737350	-164350	0.38	0.82	1595	1305	-290
0041	2F	nopattern	13	5358	1720	535800	434670	-101130	0.32	0.81	948	769	-179
0041	2F	nopattern	14	4499	1036	449900	337580	-112320	0.23	0.75	796	597	-199
0041	2F	nopattern	15	2906	421	290600	225220	-65380	0.14	0.78	514	398	-116
0041	2F	nopattern	16	1618	184	161800	140010	-21790	0.11	0.87	286	247	-39
0041	2F	nopattern	23	523	70	52300	41210	-11090	0.13	0.79	92	72	-20
0041	2F	nopattern	24	1528	204	152800	110450	-42350	0.13	0.72	270	195	-75
0041	2F	nopattern	25	2022	204	202200	125710	-76490	0.10	0.62	357	222	-135
0041	2F	nopattern	26	2005	139	200500	131220	-69280	0.07	0.65	354	232	-122
0041	2T	nopattern	12	7753	2484	775300	615360	-159940	0.32	0.79	1372	1089	-283
0041	2T	nopattern	13	4675	1272	467500	367190	-100310	0.27	0.79	827	649	-178
0041	2T	nopattern	14	4271	808	427100	301400	-125700	0.19	0.71	755	533	-222
0041	2T	nopattern	15	2772	341	277200	216510	-60690	0.12	0.78	490	383	-107
0041	2T	nopattern	16	1496	143	149600	129770	-19830	0.10	0.87	264	229	-35
0041	2T	nopattern	21	1264	177	126400	108550	-17850	0.14	0.86	223	192	-31
0041	2T	nopattern	23	416	33	41600	26870	-14730	0.08	0.65	73	47	-26
0041	2T	nopattern	24	1298	112	129800	81410	-48390	0.09	0.63	229	144	-85
0041	2T	nopattern	25	1843	147	184300	123390	-60910	0.08	0.67	326	218	-108
0041	2T	nopattern	26	1856	108	185600	138720	-46880	0.06	0.75	328	245	-83
0041	3F	nopattern	123	1989	579	198900	160210	-38690	0.29	0.81	352	283	-69
0041	3F	nopattern	124	3530	750	353000	248260	-104740	0.21	0.70	624	439	-185
0041	3F	nopattern	125	2374	363	237400	181520	-55880	0.15	0.76	420	321	-99
0041	3F	nopattern	126	2977	297	297700	239900	-57800	0.10	0.81	526	424	-102
0041	3F	nopattern	134	2059	445	205900	167630	-38270	0.22	0.81	364	296	-68
0041	3F	nopattern	135	1868	236	186800	126290	-60510	0.13	0.68	330	223	-107
0041	3F	nopattern	136	1780	159	178000	133210	-44790	0.09	0.75	315	235	-80
0041	3F	nopattern	145	1626	172	162600	114350	-48250	0.11	0.70	287	202	-85
0041	3F	nopattern	146	1592	133	159200	124690	-34510	0.08	0.78	281	220	-61
0041	3F	nopattern	156	902	45	90200	66680	-23520	0.05	0.74	159	118	-41
0041	3F	nopattern	234	72	5	7200	5770	-1430	0.07	0.80	12	10	-2
0041	3F	nopattern	235	85	8	8500	10920	2420	0.09	1.28	15	19	4
0041	3F	nopattern	236	105	3	10500	1660	-8840	0.03	0.16	18	2	-16
0041	3F	nopattern	245	132	3	13200	4650	-8550	0.02	0.35	23	8	-15
0041	3F	nopattern	246	160	5	16000	6780	-9220	0.03	0.42	28	12	-16
0041	3F	nopattern	256	207	8	20700	8860	-11840	0.04	0.43	36	15	-21
0041	3T	nopattern	123	1500	216	150000	127270	-22730	0.14	0.85	265	225	-40
0041	3T	nopattern	124	2445	254	244500	161160	-83340	0.10	0.66	432	285	-147
0041	3T	nopattern	125	1228	119	122800	95630	-27170	0.10	0.78	217	169	-48
0041	3T	nopattern	126	1949	100	194900	155650	-39250	0.05	0.80	344	275	-69
0041	3T	nopattern	132	166	19	16600	14380	-2220	0.11	0.87	29	25	-4
0041	3T	nopattern	134	1223	128	122300	99830	-22470	0.10	0.82	216	176	-40
0041	3T	nopattern	135	1052	70	105200	63450	-41750	0.07	0.60	186	112	-74
0041	3T	nopattern	136	1111	66	111100	97400	-13700	0.06	0.88	196	172	-24
0041	3T	nopattern	142	140	8	14000	8960	-5040	0.06	0.64	24	15	-9
0041	3T	nopattern	143	124	6	12400	7760	-4640	0.05	0.63	21	13	-8
0041	3T	nopattern	145	772	38	77200	53000	-24200	0.05	0.69	136	93	-43
0041	3T	nopattern	146	1084	50	108400	87790	-20610	0.05	0.81	191	155	-36
0041	3T	nopattern	152	62	0	6200	0	-6200	0.00	0.00	10	0	-10
0041	3T	nopattern	153	200	6	20000	10710	-9290	0.03	0.54	35	18	-17
0041	3T	nopattern	154	261	7	26100	23490	-2610	0.03	0.90	46	41	-5
0041	3T	nopattern	156	689	18	68900	65660	-3240	0.03	0.95	121	116	-5
0041	3T	nopattern	162	73	0	7300	0	-7300	0.00	0.00	12	0	-12
0041	3T	nopattern	163	72	3	7200	5850	-1350	0.04	0.81	12	10	-2
0041	3T	nopattern	164	55	4	5500	12160	6660	0.07	2.21	9	21	12
0041	3T	nopattern	165	19	0	1900	0	-1900	0.00	0.00	3	0	-3
0041	3T	nopattern	213	116	10	11600	8460	-3140	0.09	0.73	20	14	-6
0041	3T	nopattern	214	88	9	8800	14320	5520	0.10	1.63	15	25	10
0041	3T	nopattern	215	111	2	11100	3050	-8050	0.02	0.27	19	5	-14
0041	3T	nopattern	216	237	9	23700	24610	910	0.04	1.04	41	43	2
0041	3T	nopattern	231	192	7	19200	23450	4250	0.04	1.22	33	41	8
0041	3T	nopattern	234	33	2	3300	6680	3380	0.06	2.02	5	11	6
0041	3T	nopattern	235	47	0	4700	0	-4700	0.00	0.00	8	0	-8
0041	3T	nopattern	236	42	1	4200	880	-3320	0.02	0.21	7	1	-6
0041	3T	nopattern	241	783	23	78300	46300	-32000	0.03	0.59	138	81	-57
0041	3T	nopattern	243	11	0	1100	0	-1100	0.00	0.00	1	0	-1
0041	3T	nopattern	245	87	0	8700	0	-8700	0.00	0.00	15	0	-15
0041	3T	nopattern	246	84	1	8400	3830	-4570	0.01	0.46	14	6	-8
0041	3T	nopattern	251	950	25	95000	80090	-14910	0.03	0.84	168	141	-27
0041	3T	nopattern	253	21	1	2100	1480	-620	0.05	0.70	3	2	-1
0041	3T	nopattern	254	17	0	1700	0	-1700	0.00	0.00	3	0	-3
0041	3T	nopattern	256	152	4	15200	5340	-9860	0.03	0.35	26	9	-17
0041	3T	nopattern	261	692	9	69200	34450	-34750	0.01	0.50	122	60	-62
0041	3T	nopattern	263	22	0	2200	0	-2200	0.00	0.00	3	0	-3
0041	3T	nopattern	264	15	0	1500	0	-1500	0.00	0.00	2	0	-2
0041	3T	nopattern	265	7	0	700	0	-700	0.00	0.00	1	0	-1
0042	1T	1	1	3804	2638	380400	337600	-42800	0.69	0.89	673	597	-76
0042	1T	1	2	2195	793	219500	195880	-23620	0.36	0.89	388	346	-42
0042	1T	2	1	3247	2285	324700	293650	-31050	0.70	0.90	574	519	-55
0042	1T	2	2	2120	802	212000	197430	-14570	0.38	0.93	375	349	-26
0042	1T	3	1	3248	2370	324800	303760	-21040	0.73	0.94	574	537	-37
0042	1T	3	2	2265	785	226500	198300	-28200	0.35	0.88	400	350	-50
0042	1T	4	1	3485	2578	348500	321790	-26710	0.74	0.92	616	569	-47
0042	1T	4	2	1720	603	172000	150260	-21740	0.35	0.87	304	265	-39
0042	1T	5	1	2983	2205	298300	270190	-28110	0.74	0.91	527	478	-49
0042	1T	5	2	938	248	93800	75590	-18210	0.26	0.81	166	133	-33
0042	1T	6	1	227	164	22700	20010	-2690	0.72	0.88	40	35	-5
0042	1T	6	2	63	19	6300	4650	-1650	0.30	0.74	11	8	-3
0042	1T	7	1	4297	3094	429700	388130	-41570	0.72	0.90	760	686	-74
0042	1T	7	2	1677	423	167700	133110	-34590	0.25	0.79	296	235	-61
0042	2F	1	12	819	312	81900	65380	-16520	0.38	0.80	144	115	-29
0042	2F	1	13	1138	302	113800	85320	-28480	0.27	0.75	201	151	-50
0042	2F	1	14	993	220	99300	73400	-25900	0.22	0.74	175	129	-46
0042	2F	1	15	664	86	66400	56490	-9910	0.13	0.85	117	99	-18
0042	2F	1	16	461	44	46100	40020	-6080	0.10	0.87	81	70	-11
0042	2F	1	23	155	25	15500	14730	-770	0.16	0.95	27	26	-1
0042	2F	1	24	448	56	44800	25970	-18830	0.13	0.58	79	45	-34
0042	2F	1	25	638	68	63800	41260	-22540	0.11	0.65	112	73	-39
0042	2F	1	26	543	39	54300	28840	-25460	0.07	0.53	96	51	-45
0042	2F	2	12	895	339	89500	70780	-18720	0.38	0.79	158	125	-33
0042	2F	2	13	808	287	80800	68890	-11910	0.36	0.85	143	121	-22
0042	2F	2	14	890	213	89000	67380	-21620	0.24	0.76	157	119	-38
0042	2F	2	15	548	92	54800	50050	-4750	0.17	0.91	96	88	-8
0042	2F	2	16	278	46	27800	28450	650	0.17	1.02	49	50	1
0042	2F	2	23	97	15	9700	9510	-190	0.15	0.98	17	16	-1
0042	2F	2	24	425	55	42500	26930	-15570	0.13	0.63	75	47	-28
0042	2F	2	25	426	40	42600	23330	-19270	0.09	0.55	75	41	-34
0042	2F	2	26	543	46	54300	32350	-21950	0.08	0.60	96	57	-39
0042	2F	3	12	1054	422	105400	88000	-17400	0.40	0.83	186	155	-31
0042	2F	3	13	814	257	81400	62950	-18450	0.32	0.77	144	111	-33
0042	2F	3	14	891	212	89100	71840	-17260	0.24	0.81	157	127	-30
0042	2F	3	15	492	79	49200	40040	-9160	0.16	0.81	87	70	-17
0042	2F	3	16	244	35	24400	25020	620	0.14	1.03	43	44	1
0042	2F	3	23	140	28	14000	13220	-780	0.20	0.94	24	23	-1
0042	2F	3	24	332	61	33200	30450	-2750	0.18	0.92	58	53	-5
0042	2F	3	25	430	46	43000	26380	-16620	0.11	0.61	76	46	-30
0042	2F	3	26	399	35	39900	24830	-15070	0.09	0.62	70	43	-27
0042	2F	4	12	1279	507	127900	103540	-24360	0.40	0.81	226	183	-43
0042	2F	4	13	834	297	83400	70120	-13280	0.36	0.84	147	124	-23
0042	2F	4	14	907	221	90700	71690	-19010	0.24	0.79	160	126	-34
0042	2F	4	15	497	89	49700	42290	-7410	0.18	0.85	87	74	-13
0042	2F	4	16	234	27	23400	17690	-5710	0.12	0.76	41	31	-10
0042	2F	4	23	118	19	11800	6020	-5780	0.16	0.51	20	10	-10
0042	2F	4	24	238	28	23800	15090	-8710	0.12	0.63	42	26	-16
0042	2F	4	25	336	44	33600	32240	-1360	0.13	0.96	59	57	-2
0042	2F	4	26	284	22	28400	17420	-10980	0.08	0.61	50	30	-20
0042	2F	5	12	1179	515	117900	97850	-20050	0.44	0.83	208	173	-35
0042	2F	5	13	703	208	70300	53960	-16340	0.30	0.77	124	95	-29
0042	2F	5	14	709	153	70900	54800	-16100	0.22	0.77	125	96	-29
0042	2F	5	15	407	59	40700	33560	-7140	0.14	0.82	72	59	-13
0042	2F	5	16	172	18	17200	11890	-5310	0.10	0.69	30	21	-9
0042	2F	5	23	61	8	6100	3900	-2200	0.13	0.64	10	6	-4
0042	2F	5	24	132	13	13200	8460	-4740	0.10	0.64	23	14	-9
0042	2F	5	25	141	16	14100	11280	-2820	0.11	0.80	24	19	-5
0042	2F	5	26	118	7	11800	9030	-2770	0.06	0.77	20	15	-5
0042	2F	6	12	89	35	8900	6890	-2010	0.39	0.77	15	12	-3
0042	2F	6	13	64	24	6400	6230	-170	0.38	0.97	11	11	0
0042	2F	6	14	41	6	4100	1770	-2330	0.15	0.43	7	3	-4
0042	2F	6	15	37	8	3700	5030	1330	0.22	1.36	6	8	2
0042	2F	6	16	13	3	1300	1240	-60	0.23	0.95	2	2	0
0042	2F	6	23	3	0	300	0	-300	0.00	0.00	0	0	0
0042	2F	6	24	8	0	800	0	-800	0.00	0.00	1	0	-1
0042	2F	6	25	13	0	1300	0	-1300	0.00	0.00	2	0	-2
0042	2F	6	26	8	0	800	0	-800	0.00	0.00	1	0	-1
0042	2F	7	12	1624	652	162400	137040	-25360	0.40	0.84	287	242	-45
0042	2F	7	13	942	306	94200	79470	-14730	0.32	0.84	166	140	-26
0042	2F	7	14	937	205	93700	69040	-24660	0.22	0.74	165	122	-43
0042	2F	7	15	762	90	76200	52040	-24160	0.12	0.68	134	92	-42
0042	2F	7	16	353	35	35300	29050	-6250	0.10	0.82	62	51	-11
0042	2F	7	23	125	18	12500	12680	180	0.14	1.01	22	22	0
0042	2F	7	24	234	25	23400	17970	-5430	0.11	0.77	41	31	-10
0042	2F	7	25	305	20	30500	19990	-10510	0.07	0.66	53	35	-18
0042	2F	7	26	238	13	23800	14970	-8830	0.05	0.63	42	26	-16
0042	2T	1	12	656	222	65600	52970	-12630	0.34	0.81	116	93	-23
0042	2T	1	13	1075	226	107500	73720	-33780	0.21	0.69	190	130	-60
0042	2T	1	14	924	175	92400	70440	-21960	0.19	0.76	163	124	-39
0042	2T	1	15	622	61	62200	46900	-15300	0.10	0.75	110	83	-27
0042	2T	1	16	436	32	43600	35920	-7680	0.07	0.82	77	63	-14
0042	2T	1	21	163	26	16300	13450	-2850	0.16	0.83	28	23	-5
0042	2T	1	23	127	13	12700	9320	-3380	0.10	0.73	22	16	-6
0042	2T	1	24	402	28	40200	18900	-21300	0.07	0.47	71	33	-38
0042	2T	1	25	601	51	60100	38980	-21120	0.08	0.65	106	68	-38
0042	2T	1	26	484	23	48400	21970	-26430	0.05	0.45	85	38	-47
0042	2T	2	12	822	254	82200	61470	-20730	0.31	0.75	145	108	-37
0042	2T	2	13	736	211	73600	60970	-12630	0.29	0.83	130	107	-23
0042	2T	2	14	854	158	85400	57390	-28010	0.19	0.67	151	101	-50
0042	2T	2	15	520	71	52000	44450	-7550	0.14	0.85	92	78	-14
0042	2T	2	16	252	32	25200	22360	-2840	0.13	0.89	44	39	-5
0042	2T	2	21	73	5	7300	3450	-3850	0.07	0.47	12	6	-6
0042	2T	2	23	74	7	7400	6110	-1290	0.09	0.83	13	10	-3
0042	2T	2	24	369	36	36900	18510	-18390	0.10	0.50	65	32	-33
0042	2T	2	25	391	33	39100	24250	-14850	0.08	0.62	69	42	-27
0042	2T	2	26	500	33	50000	25320	-24680	0.07	0.51	88	44	-44
0042	2T	3	12	860	308	86000	73510	-12490	0.36	0.85	152	130	-22
0042	2T	3	13	771	209	77100	59670	-17430	0.27	0.77	136	105	-31
0042	2T	3	14	856	174	85600	69610	-15990	0.20	0.81	151	123	-28
0042	2T	3	15	482	68	48200	42100	-6100	0.14	0.87	85	74	-11
0042	2T	3	16	227	27	22700	23220	520	0.12	1.02	40	41	1
0042	2T	3	21	194	23	19400	11730	-7670	0.12	0.60	34	20	-14
0042	2T	3	23	130	19	13000	17330	4330	0.15	1.33	23	30	7
0042	2T	3	24	298	32	29800	21650	-8150	0.11	0.73	52	38	-14
0042	2T	3	25	416	33	41600	21450	-20150	0.08	0.52	73	37	-36
0042	2T	3	26	358	25	35800	25630	-10170	0.07	0.72	63	45	-18
0042	2T	4	12	1060	352	106000	82890	-23110	0.33	0.78	187	146	-41
0042	2T	4	13	797	245	79700	68830	-10870	0.31	0.86	141	121	-20
0042	2T	4	14	876	184	87600	65810	-21790	0.21	0.75	155	116	-39
0042	2T	4	15	483	79	48300	46710	-1590	0.16	0.97	85	82	-3
0042	2T	4	16	221	21	22100	15900	-6200	0.10	0.72	39	28	-11
0042	2T	4	21	219	27	21900	12990	-8910	0.12	0.59	38	22	-16
0042	2T	4	23	110	11	11000	5700	-5300	0.10	0.52	19	10	-9
0042	2T	4	24	212	15	21200	12160	-9040	0.07	0.57	37	21	-16
0042	2T	4	25	320	30	32000	30280	-1720	0.09	0.95	56	53	-3
0042	2T	4	26	267	18	26700	18620	-8080	0.07	0.70	47	32	-15
0042	2T	5	12	1041	365	104100	80710	-23390	0.35	0.78	184	142	-42
0042	2T	5	13	674	168	67400	49460	-17940	0.25	0.73	119	87	-32
0042	2T	5	14	670	119	67000	50310	-16690	0.18	0.75	118	89	-29
0042	2T	5	15	388	47	38800	31170	-7630	0.12	0.80	68	55	-13
0042	2T	5	16	150	14	15000	11060	-3940	0.09	0.74	26	19	-7
0042	2T	5	21	138	15	13800	9030	-4770	0.11	0.65	24	15	-9
0042	2T	5	23	56	2	5600	1510	-4090	0.04	0.27	9	2	-7
0042	2T	5	24	100	7	10000	6860	-3140	0.07	0.69	17	12	-5
0042	2T	5	25	127	7	12700	6050	-6650	0.06	0.48	22	10	-12
0042	2T	5	26	104	5	10400	9370	-1030	0.05	0.90	18	16	-2
0042	2T	6	12	78	26	7800	5590	-2210	0.33	0.72	13	9	-4
0042	2T	6	13	61	17	6100	5000	-1100	0.28	0.82	10	8	-2
0042	2T	6	14	36	5	3600	1590	-2010	0.14	0.44	6	2	-4
0042	2T	6	15	36	7	3600	5000	1400	0.19	1.39	6	8	2
0042	2T	6	16	12	3	1200	1690	490	0.25	1.41	2	2	0
0042	2T	6	21	11	1	1100	740	-360	0.09	0.67	1	1	0
0042	2T	6	23	2	0	200	0	-200	0.00	0.00	0	0	0
0042	2T	6	24	5	0	500	0	-500	0.00	0.00	0	0	0
0042	2T	6	25	12	0	1200	0	-1200	0.00	0.00	2	0	-2
0042	2T	6	26	7	0	700	0	-700	0.00	0.00	1	0	-1
0042	2T	7	12	1425	482	142500	118030	-24470	0.34	0.83	252	208	-44
0042	2T	7	13	869	237	86900	69210	-17690	0.27	0.80	153	122	-31
0042	2T	7	14	869	152	86900	60500	-26400	0.17	0.70	153	107	-46
0042	2T	7	15	735	76	73500	50500	-23000	0.10	0.69	130	89	-41
0042	2T	7	16	319	31	31900	27910	-3990	0.10	0.87	56	49	-7
0042	2T	7	21	199	25	19900	18000	-1900	0.13	0.90	35	31	-4
0042	2T	7	23	105	5	10500	2910	-7590	0.05	0.28	18	5	-13
0042	2T	7	24	175	17	17500	17800	300	0.10	1.02	30	31	1
0042	2T	7	25	276	12	27600	21400	-6200	0.04	0.78	48	37	-11
0042	2T	7	26	220	11	22000	16950	-5050	0.05	0.77	38	30	-8
0042	3F	1	123	173	53	17300	13840	-3460	0.31	0.80	30	24	-6
0042	3F	1	124	493	106	49300	36760	-12540	0.22	0.75	87	65	-22
0042	3F	1	125	309	49	30900	28000	-2900	0.16	0.91	54	49	-5
0042	3F	1	126	463	42	46300	32950	-13350	0.09	0.71	81	58	-23
0042	3F	1	134	341	81	34100	29060	-5040	0.24	0.85	60	51	-9
0042	3F	1	135	206	25	20600	12580	-8020	0.12	0.61	36	22	-14
0042	3F	1	136	798	59	79800	68230	-11570	0.07	0.86	141	120	-21
0042	3F	1	145	190	17	19000	11310	-7690	0.09	0.60	33	20	-13
0042	3F	1	146	572	50	57200	63700	6500	0.09	1.11	101	112	11
0042	3F	1	156	324	12	32400	17140	-15260	0.04	0.53	57	30	-27
0042	3F	1	234	24	0	2400	0	-2400	0.00	0.00	4	0	-4
0042	3F	1	235	24	2	2400	2450	50	0.08	1.02	4	4	0
0042	3F	1	236	30	0	3000	0	-3000	0.00	0.00	5	0	-5
0042	3F	1	245	56	4	5600	4470	-1130	0.07	0.80	9	7	-2
0042	3F	1	246	90	1	9000	580	-8420	0.01	0.06	15	1	-14
0042	3F	1	256	138	7	13800	7970	-5830	0.05	0.58	24	14	-10
0042	3F	2	123	126	35	12600	8390	-4210	0.28	0.67	22	14	-8
0042	3F	2	124	456	105	45600	40200	-5400	0.23	0.88	80	71	-9
0042	3F	2	125	259	49	25900	23450	-2450	0.19	0.91	45	41	-4
0042	3F	2	126	399	59	39900	41450	1550	0.15	1.04	70	73	3
0042	3F	2	134	278	55	27800	19210	-8590	0.20	0.69	49	34	-15
0042	3F	2	135	212	39	21200	18530	-2670	0.18	0.87	37	32	-5
0042	3F	2	136	383	36	38300	27190	-11110	0.09	0.71	67	48	-19
0042	3F	2	145	224	28	22400	19070	-3330	0.13	0.85	39	33	-6
0042	3F	2	146	437	46	43700	35010	-8690	0.11	0.80	77	61	-16
0042	3F	2	156	216	10	21600	13930	-7670	0.05	0.64	38	24	-14
0042	3F	2	234	18	2	1800	2110	310	0.11	1.17	3	3	0
0042	3F	2	235	13	0	1300	0	-1300	0.00	0.00	2	0	-2
0042	3F	2	236	24	1	2400	330	-2070	0.04	0.14	4	0	-4
0042	3F	2	245	49	3	4900	1330	-3570	0.06	0.27	8	2	-6
0042	3F	2	246	95	4	9500	2640	-6860	0.04	0.28	16	4	-12
0042	3F	2	256	71	4	7100	8210	1110	0.06	1.16	12	14	2
0042	3F	3	123	206	64	20600	18920	-1680	0.31	0.92	36	33	-3
0042	3F	3	124	443	99	44300	33730	-10570	0.22	0.76	78	59	-19
0042	3F	3	125	353	56	35300	29140	-6160	0.16	0.83	62	51	-11
0042	3F	3	126	391	38	39100	26660	-12440	0.10	0.68	69	47	-22
0042	3F	3	134	285	53	28500	19720	-8780	0.19	0.69	50	34	-16
0042	3F	3	135	279	51	27900	23660	-4240	0.18	0.85	49	41	-8
0042	3F	3	136	318	28	31800	19920	-11880	0.09	0.63	56	35	-21
0042	3F	3	145	252	20	25200	10100	-15100	0.08	0.40	44	17	-27
0042	3F	3	146	332	37	33200	37060	3860	0.11	1.12	58	65	7
0042	3F	3	156	151	5	15100	6290	-8810	0.03	0.42	26	11	-15
0042	3F	3	234	14	1	1400	620	-780	0.07	0.44	2	1	-1
0042	3F	3	235	25	3	2500	4640	2140	0.12	1.86	4	8	4
0042	3F	3	236	25	1	2500	930	-1570	0.04	0.37	4	1	-3
0042	3F	3	245	36	4	3600	1320	-2280	0.11	0.37	6	2	-4
0042	3F	3	246	41	4	4100	2520	-1580	0.10	0.61	7	4	-3
0042	3F	3	256	68	2	6800	2770	-4030	0.03	0.41	12	4	-8
0042	3F	4	123	287	83	28700	21170	-7530	0.29	0.74	50	37	-13
0042	3F	4	124	442	87	44200	26550	-17650	0.20	0.60	78	46	-32
0042	3F	4	125	363	57	36300	33200	-3100	0.16	0.91	64	58	-6
0042	3F	4	126	448	54	44800	39760	-5040	0.12	0.89	79	70	-9
0042	3F	4	134	311	70	31100	25180	-5920	0.23	0.81	55	44	-11
0042	3F	4	135	245	30	24500	14850	-9650	0.12	0.61	43	26	-17
0042	3F	4	136	284	30	28400	32470	4070	0.11	1.14	50	57	7
0042	3F	4	145	287	22	28700	20630	-8070	0.08	0.72	50	36	-14
0042	3F	4	146	316	16	31600	18430	-13170	0.05	0.58	55	32	-23
0042	3F	4	156	170	10	17000	15980	-1020	0.06	0.94	30	28	-2
0042	3F	4	234	15	0	1500	0	-1500	0.00	0.00	2	0	-2
0042	3F	4	235	17	2	1700	1350	-350	0.12	0.79	3	2	-1
0042	3F	4	236	13	0	1300	0	-1300	0.00	0.00	2	0	-2
0042	3F	4	245	22	1	2200	1200	-1000	0.05	0.55	3	2	-1
0042	3F	4	246	20	1	2000	1480	-520	0.05	0.74	3	2	-1
0042	3F	4	256	42	2	4200	1200	-3000	0.05	0.29	7	2	-5
0042	3F	5	123	252	85	25200	19590	-5610	0.34	0.78	44	34	-10
0042	3F	5	124	395	93	39500	29120	-10380	0.24	0.74	69	51	-18
0042	3F	5	125	263	28	26300	13070	-13230	0.11	0.50	46	23	-23
0042	3F	5	126	348	36	34800	31440	-3360	0.10	0.90	61	55	-6
0042	3F	5	134	220	37	22000	15440	-6560	0.17	0.70	38	27	-11
0042	3F	5	135	230	25	23000	13020	-9980	0.11	0.57	40	23	-17
0042	3F	5	136	176	10	17600	7400	-10200	0.06	0.42	31	13	-18
0042	3F	5	145	219	23	21900	21860	-40	0.11	1.00	38	38	0
0042	3F	5	146	206	13	20600	18520	-2080	0.06	0.90	36	32	-4
0042	3F	5	156	133	2	13300	1900	-11400	0.02	0.14	23	3	-20
0042	3F	5	234	6	0	600	0	-600	0.00	0.00	1	0	-1
0042	3F	5	235	8	0	800	0	-800	0.00	0.00	1	0	-1
0042	3F	5	236	7	0	700	0	-700	0.00	0.00	1	0	-1
0042	3F	5	245	12	0	1200	0	-1200	0.00	0.00	2	0	-2
0042	3F	5	246	14	1	1400	2560	1160	0.07	1.83	2	4	2
0042	3F	5	256	19	0	1900	0	-1900	0.00	0.00	3	0	-3
0042	3F	6	123	16	1	1600	310	-1290	0.06	0.19	2	0	-2
0042	3F	6	124	28	7	2800	2360	-440	0.25	0.84	4	4	0
0042	3F	6	125	23	4	2300	1830	-470	0.17	0.80	4	3	-1
0042	3F	6	126	28	3	2800	2410	-390	0.11	0.86	4	4	0
0042	3F	6	134	20	8	2000	3370	1370	0.40	1.69	3	5	2
0042	3F	6	135	20	3	2000	870	-1130	0.15	0.44	3	1	-2
0042	3F	6	136	20	4	2000	2890	890	0.20	1.45	3	5	2
0042	3F	6	145	13	2	1300	1140	-160	0.15	0.88	2	2	0
0042	3F	6	146	9	0	900	0	-900	0.00	0.00	1	0	-1
0042	3F	6	156	14	0	1400	0	-1400	0.00	0.00	2	0	-2
0042	3F	6	234	1	0	100	0	-100	0.00	0.00	0	0	0
0042	3F	6	245	1	0	100	0	-100	0.00	0.00	0	0	0
0042	3F	6	246	1	0	100	0	-100	0.00	0.00	0	0	0
0042	3F	6	256	1	0	100	0	-100	0.00	0.00	0	0	0
0042	3F	7	123	408	117	40800	31740	-9060	0.29	0.78	72	56	-16
0042	3F	7	124	507	116	50700	41160	-9540	0.23	0.81	89	72	-17
0042	3F	7	125	409	65	40900	39180	-1720	0.16	0.96	72	69	-3
0042	3F	7	126	553	49	55300	38360	-16940	0.09	0.69	97	67	-30
0042	3F	7	134	364	73	36400	27080	-9320	0.20	0.74	64	47	-17
0042	3F	7	135	279	35	27900	20790	-7110	0.13	0.75	49	36	-13
0042	3F	7	136	239	22	23900	23960	60	0.09	1.00	42	42	0
0042	3F	7	145	329	28	32900	18980	-13920	0.09	0.58	58	33	-25
0042	3F	7	146	284	22	28400	19450	-8950	0.08	0.68	50	34	-16
0042	3F	7	156	283	12	28300	22170	-6130	0.04	0.78	50	39	-11
0042	3F	7	234	20	0	2000	0	-2000	0.00	0.00	3	0	-3
0042	3F	7	235	18	1	1800	1550	-250	0.06	0.86	3	2	-1
0042	3F	7	236	13	0	1300	0	-1300	0.00	0.00	2	0	-2
0042	3F	7	245	17	0	1700	0	-1700	0.00	0.00	3	0	-3
0042	3F	7	246	19	0	1900	0	-1900	0.00	0.00	3	0	-3
0042	3F	7	256	37	2	3700	9320	5620	0.05	2.52	6	16	10
0042	3T	1	123	17	3	1700	1180	-520	0.18	0.69	3	2	-1
0042	3T	1	124	203	25	20300	12650	-7650	0.12	0.62	35	22	-13
0042	3T	1	125	71	5	7100	2870	-4230	0.07	0.40	12	5	-7
0042	3T	1	126	232	11	23200	18450	-4750	0.05	0.80	41	32	-9
0042	3T	1	132	78	7	7800	4460	-3340	0.09	0.57	13	7	-6
0042	3T	1	134	219	18	21900	14050	-7850	0.08	0.64	38	24	-14
0042	3T	1	135	89	5	8900	3410	-5490	0.06	0.38	15	6	-9
0042	3T	1	136	642	17	64200	38720	-25480	0.03	0.60	113	68	-45
0042	3T	1	142	40	4	4000	4180	180	0.10	1.05	7	7	0
0042	3T	1	143	2	0	200	0	-200	0.00	0.00	0	0	0
0042	3T	1	145	84	3	8400	3150	-5250	0.04	0.38	14	5	-9
0042	3T	1	146	474	24	47400	57240	9840	0.05	1.21	83	101	18
0042	3T	1	152	47	2	4700	3150	-1550	0.04	0.67	8	5	-3
0042	3T	1	153	6	0	600	0	-600	0.00	0.00	1	0	-1
0042	3T	1	154	32	1	3200	12050	8850	0.03	3.77	5	21	16
0042	3T	1	156	277	4	27700	7190	-20510	0.01	0.26	49	12	-37
0042	3T	1	162	21	2	2100	4930	2830	0.10	2.35	3	8	5
0042	3T	1	163	13	1	1300	780	-520	0.08	0.60	2	1	-1
0042	3T	1	164	30	2	3000	9150	6150	0.07	3.05	5	16	11
0042	3T	1	165	4	0	400	0	-400	0.00	0.00	0	0	0
0042	3T	1	214	18	0	1800	0	-1800	0.00	0.00	3	0	-3
0042	3T	1	215	28	1	2800	920	-1880	0.04	0.33	4	1	-3
0042	3T	1	216	48	1	4800	1850	-2950	0.02	0.39	8	3	-5
0042	3T	1	231	63	0	6300	0	-6300	0.00	0.00	11	0	-11
0042	3T	1	234	19	0	1900	0	-1900	0.00	0.00	3	0	-3
0042	3T	1	235	13	0	1300	0	-1300	0.00	0.00	2	0	-2
0042	3T	1	236	20	0	2000	0	-2000	0.00	0.00	3	0	-3
0042	3T	1	241	212	4	21200	8520	-12680	0.02	0.40	37	15	-22
0042	3T	1	245	39	0	3900	0	-3900	0.00	0.00	6	0	-6
0042	3T	1	246	67	0	6700	0	-6700	0.00	0.00	11	0	-11
0042	3T	1	251	155	4	15500	9410	-6090	0.03	0.61	27	16	-11
0042	3T	1	253	2	0	200	0	-200	0.00	0.00	0	0	0
0042	3T	1	254	12	1	1200	5330	4130	0.08	4.44	2	9	7
0042	3T	1	256	122	1	12200	1210	-10990	0.01	0.10	21	2	-19
0042	3T	1	261	145	5	14500	15910	1410	0.03	1.10	25	28	3
0042	3T	1	263	6	0	600	0	-600	0.00	0.00	1	0	-1
0042	3T	1	264	15	0	1500	0	-1500	0.00	0.00	2	0	-2
0042	3T	1	265	6	0	600	0	-600	0.00	0.00	1	0	-1
0042	3T	2	123	71	10	7100	4540	-2560	0.14	0.64	12	8	-4
0042	3T	2	124	261	30	26100	20750	-5350	0.11	0.80	46	36	-10
0042	3T	2	125	121	9	12100	5710	-6390	0.07	0.47	21	10	-11
0042	3T	2	126	245	11	24500	14950	-9550	0.04	0.61	43	26	-17
0042	3T	2	132	16	2	1600	1180	-420	0.13	0.74	2	2	0
0042	3T	2	134	190	21	19000	13680	-5320	0.11	0.72	33	24	-9
0042	3T	2	135	111	9	11100	10570	-530	0.08	0.95	19	18	-1
0042	3T	2	136	304	20	30400	30460	60	0.07	1.00	53	53	0
0042	3T	2	142	19	1	1900	940	-960	0.05	0.49	3	1	-2
0042	3T	2	143	3	1	300	1540	1240	0.33	5.13	0	2	2
0042	3T	2	145	137	10	13700	15530	1830	0.07	1.13	24	27	3
0042	3T	2	146	363	16	36300	22910	-13390	0.04	0.63	64	40	-24
0042	3T	2	152	19	2	1900	2020	120	0.11	1.06	3	3	0
0042	3T	2	153	20	1	2000	1340	-660	0.05	0.67	3	2	-1
0042	3T	2	154	46	3	4600	5210	610	0.07	1.13	8	9	1
0042	3T	2	156	183	1	18300	4530	-13770	0.01	0.25	32	8	-24
0042	3T	2	162	14	2	1400	5810	4410	0.14	4.15	2	10	8
0042	3T	2	163	12	1	1200	1480	280	0.08	1.23	2	2	0
0042	3T	2	164	20	1	2000	2640	640	0.05	1.32	3	4	1
0042	3T	2	165	5	0	500	0	-500	0.00	0.00	0	0	0
0042	3T	2	213	2	0	200	0	-200	0.00	0.00	0	0	0
0042	3T	2	214	20	1	2000	2480	480	0.05	1.24	3	4	1
0042	3T	2	215	10	1	1000	5890	4890	0.10	5.89	1	10	9
0042	3T	2	216	11	0	1100	0	-1100	0.00	0.00	1	0	-1
0042	3T	2	231	30	0	3000	0	-3000	0.00	0.00	5	0	-5
0042	3T	2	234	13	0	1300	0	-1300	0.00	0.00	2	0	-2
0042	3T	2	235	7	0	700	0	-700	0.00	0.00	1	0	-1
0042	3T	2	236	18	1	1800	880	-920	0.06	0.49	3	1	-2
0042	3T	2	241	144	4	14400	5750	-8650	0.03	0.40	25	10	-15
0042	3T	2	245	44	1	4400	1350	-3050	0.02	0.31	7	2	-5
0042	3T	2	246	73	1	7300	3830	-3470	0.01	0.52	12	6	-6
0042	3T	2	251	101	2	10100	5260	-4840	0.02	0.52	17	9	-8
0042	3T	2	253	1	0	100	0	-100	0.00	0.00	0	0	0
0042	3T	2	256	52	1	5200	1410	-3790	0.02	0.27	9	2	-7
0042	3T	2	261	121	2	12100	3460	-8640	0.02	0.29	21	6	-15
0042	3T	2	263	2	0	200	0	-200	0.00	0.00	0	0	0
0042	3T	2	264	10	0	1000	0	-1000	0.00	0.00	1	0	-1
0042	3T	2	265	6	0	600	0	-600	0.00	0.00	1	0	-1
0042	3T	3	123	126	23	12600	12240	-360	0.18	0.97	22	21	-1
0042	3T	3	124	236	33	23600	20960	-2640	0.14	0.89	41	37	-4
0042	3T	3	125	179	17	17900	13460	-4440	0.09	0.75	31	23	-8
0042	3T	3	126	234	21	23400	21200	-2200	0.09	0.91	41	37	-4
0042	3T	3	132	13	2	1300	3890	2590	0.15	2.99	2	6	4
0042	3T	3	134	169	16	16900	10590	-6310	0.09	0.63	29	18	-11
0042	3T	3	135	204	18	20400	14740	-5660	0.09	0.72	36	26	-10
0042	3T	3	136	250	18	25000	22170	-2830	0.07	0.89	44	39	-5
0042	3T	3	142	13	1	1300	610	-690	0.08	0.47	2	1	-1
0042	3T	3	143	8	1	800	740	-60	0.13	0.93	1	1	0
0042	3T	3	145	187	5	18700	5760	-12940	0.03	0.31	33	10	-23
0042	3T	3	146	290	17	29000	25400	-3600	0.06	0.88	51	44	-7
0042	3T	3	152	5	0	500	0	-500	0.00	0.00	0	0	0
0042	3T	3	153	13	2	1300	3240	1940	0.15	2.49	2	5	3
0042	3T	3	154	19	0	1900	0	-1900	0.00	0.00	3	0	-3
0042	3T	3	156	117	3	11700	7430	-4270	0.03	0.64	20	13	-7
0042	3T	3	162	7	0	700	0	-700	0.00	0.00	1	0	-1
0042	3T	3	163	14	0	1400	0	-1400	0.00	0.00	2	0	-2
0042	3T	3	164	5	0	500	0	-500	0.00	0.00	0	0	0
0042	3T	3	165	11	0	1100	0	-1100	0.00	0.00	1	0	-1
0042	3T	3	213	7	1	700	890	190	0.14	1.27	1	1	0
0042	3T	3	214	17	0	1700	0	-1700	0.00	0.00	3	0	-3
0042	3T	3	215	31	0	3100	0	-3100	0.00	0.00	5	0	-5
0042	3T	3	216	54	1	5400	1950	-3450	0.02	0.36	9	3	-6
0042	3T	3	231	56	3	5600	4070	-1530	0.05	0.73	9	7	-2
0042	3T	3	234	13	1	1300	3760	2460	0.08	2.89	2	6	4
0042	3T	3	235	22	1	2200	5370	3170	0.05	2.44	3	9	6
0042	3T	3	236	22	0	2200	0	-2200	0.00	0.00	3	0	-3
0042	3T	3	241	165	12	16500	24960	8460	0.07	1.51	29	44	15
0042	3T	3	245	33	1	3300	860	-2440	0.03	0.26	5	1	-4
0042	3T	3	246	35	0	3500	0	-3500	0.00	0.00	6	0	-6
0042	3T	3	251	132	5	13200	13950	750	0.04	1.06	23	24	1
0042	3T	3	253	1	0	100	0	-100	0.00	0.00	0	0	0
0042	3T	3	256	63	0	6300	0	-6300	0.00	0.00	11	0	-11
0042	3T	3	261	82	1	8200	3800	-4400	0.01	0.46	14	6	-8
0042	3T	3	263	2	0	200	0	-200	0.00	0.00	0	0	0
0042	3T	3	264	1	0	100	0	-100	0.00	0.00	0	0	0
0042	3T	3	265	2	0	200	0	-200	0.00	0.00	0	0	0
0042	3T	4	123	204	33	20400	14090	-6310	0.16	0.69	36	24	-12
0042	3T	4	124	247	23	24700	13880	-10820	0.09	0.56	43	24	-19
0042	3T	4	125	199	22	19900	17710	-2190	0.11	0.89	35	31	-4
0042	3T	4	126	299	15	29900	20620	-9280	0.05	0.69	52	36	-16
0042	3T	4	132	9	0	900	0	-900	0.00	0.00	1	0	-1
0042	3T	4	134	205	29	20500	20940	440	0.14	1.02	36	37	1
0042	3T	4	135	173	11	17300	14530	-2770	0.06	0.84	30	25	-5
0042	3T	4	136	222	15	22200	30290	8090	0.07	1.36	39	53	14
0042	3T	4	142	12	0	1200	0	-1200	0.00	0.00	2	0	-2
0042	3T	4	143	15	2	1500	2430	930	0.13	1.62	2	4	2
0042	3T	4	145	200	5	20000	6710	-13290	0.03	0.34	35	11	-24
0042	3T	4	146	273	10	27300	22520	-4780	0.04	0.82	48	39	-9
0042	3T	4	152	5	0	500	0	-500	0.00	0.00	0	0	0
0042	3T	4	153	13	0	1300	0	-1300	0.00	0.00	2	0	-2
0042	3T	4	154	22	2	2200	6780	4580	0.09	3.08	3	12	9
0042	3T	4	156	148	5	14800	18790	3990	0.03	1.27	26	33	7
0042	3T	4	162	10	2	1000	3640	2640	0.20	3.64	1	6	5
0042	3T	4	163	11	0	1100	0	-1100	0.00	0.00	1	0	-1
0042	3T	4	164	3	0	300	0	-300	0.00	0.00	0	0	0
0042	3T	4	165	4	0	400	0	-400	0.00	0.00	0	0	0
0042	3T	4	213	5	0	500	0	-500	0.00	0.00	0	0	0
0042	3T	4	214	40	1	4000	1150	-2850	0.03	0.29	7	2	-5
0042	3T	4	215	35	1	3500	1530	-1970	0.03	0.44	6	2	-4
0042	3T	4	216	58	3	5800	12140	6340	0.05	2.09	10	21	11
0042	3T	4	231	65	3	6500	3880	-2620	0.05	0.60	11	6	-5
0042	3T	4	234	13	0	1300	0	-1300	0.00	0.00	2	0	-2
0042	3T	4	235	13	0	1300	0	-1300	0.00	0.00	2	0	-2
0042	3T	4	236	9	0	900	0	-900	0.00	0.00	1	0	-1
0042	3T	4	241	131	3	13100	8910	-4190	0.02	0.68	23	15	-8
0042	3T	4	245	18	0	1800	0	-1800	0.00	0.00	3	0	-3
0042	3T	4	246	15	0	1500	0	-1500	0.00	0.00	2	0	-2
0042	3T	4	251	119	3	11900	21720	9820	0.03	1.83	21	38	17
0042	3T	4	253	2	1	200	6300	6100	0.50	31.50	0	11	11
0042	3T	4	254	2	0	200	0	-200	0.00	0.00	0	0	0
0042	3T	4	256	34	2	3400	2650	-750	0.06	0.78	6	4	-2
0042	3T	4	261	75	3	7500	7070	-430	0.04	0.94	13	12	-1
0042	3T	4	263	3	0	300	0	-300	0.00	0.00	0	0	0
0042	3T	4	264	1	0	100	0	-100	0.00	0.00	0	0	0
0042	3T	4	265	1	0	100	0	-100	0.00	0.00	0	0	0
0042	3T	5	123	202	39	20200	18820	-1380	0.19	0.93	35	33	-2
0042	3T	5	124	301	43	30100	23460	-6640	0.14	0.78	53	41	-12
0042	3T	5	125	197	14	19700	10860	-8840	0.07	0.55	34	19	-15
0042	3T	5	126	272	16	27200	23540	-3660	0.06	0.87	48	41	-7
0042	3T	5	132	12	0	1200	0	-1200	0.00	0.00	2	0	-2
0042	3T	5	134	157	12	15700	10330	-5370	0.08	0.66	27	18	-9
0042	3T	5	135	177	14	17700	13570	-4130	0.08	0.77	31	24	-7
0042	3T	5	136	142	4	14200	7970	-6230	0.03	0.56	25	14	-11
0042	3T	5	142	5	0	500	0	-500	0.00	0.00	0	0	0
0042	3T	5	143	14	1	1400	2280	880	0.07	1.63	2	4	2
0042	3T	5	145	145	5	14500	13090	-1410	0.03	0.90	25	23	-2
0042	3T	5	146	171	5	17100	18180	1080	0.03	1.06	30	32	2
0042	3T	5	152	2	0	200	0	-200	0.00	0.00	0	0	0
0042	3T	5	153	13	1	1300	970	-330	0.08	0.75	2	1	-1
0042	3T	5	154	26	2	2600	7160	4560	0.08	2.75	4	12	8
0042	3T	5	156	112	1	11200	2100	-9100	0.01	0.19	19	3	-16
0042	3T	5	162	2	0	200	0	-200	0.00	0.00	0	0	0
0042	3T	5	163	3	0	300	0	-300	0.00	0.00	0	0	0
0042	3T	5	164	3	0	300	0	-300	0.00	0.00	0	0	0
0042	3T	5	165	5	0	500	0	-500	0.00	0.00	0	0	0
0042	3T	5	213	10	1	1000	1060	60	0.10	1.06	1	1	0
0042	3T	5	214	23	0	2300	0	-2300	0.00	0.00	4	0	-4
0042	3T	5	215	26	0	2600	0	-2600	0.00	0.00	4	0	-4
0042	3T	5	216	35	2	3500	8020	4520	0.06	2.29	6	14	8
0042	3T	5	231	26	1	2600	2420	-180	0.04	0.93	4	4	0
0042	3T	5	234	5	0	500	0	-500	0.00	0.00	0	0	0
0042	3T	5	235	6	0	600	0	-600	0.00	0.00	1	0	-1
0042	3T	5	236	4	0	400	0	-400	0.00	0.00	0	0	0
0042	3T	5	241	54	2	5400	3410	-1990	0.04	0.63	9	6	-3
0042	3T	5	245	9	0	900	0	-900	0.00	0.00	1	0	-1
0042	3T	5	246	11	0	1100	0	-1100	0.00	0.00	1	0	-1
0042	3T	5	251	37	0	3700	0	-3700	0.00	0.00	6	0	-6
0042	3T	5	253	1	0	100	0	-100	0.00	0.00	0	0	0
0042	3T	5	254	2	0	200	0	-200	0.00	0.00	0	0	0
0042	3T	5	256	17	0	1700	0	-1700	0.00	0.00	3	0	-3
0042	3T	5	261	34	1	3400	12870	9470	0.03	3.79	6	22	16
0042	3T	5	263	2	0	200	0	-200	0.00	0.00	0	0	0
0042	3T	5	264	2	0	200	0	-200	0.00	0.00	0	0	0
0042	3T	6	123	15	0	1500	0	-1500	0.00	0.00	2	0	-2
0042	3T	6	124	21	4	2100	2870	770	0.19	1.37	3	5	2
0042	3T	6	125	14	2	1400	1490	90	0.14	1.06	2	2	0
0042	3T	6	126	24	0	2400	0	-2400	0.00	0.00	4	0	-4
0042	3T	6	134	16	4	1600	3730	2130	0.25	2.33	2	6	4
0042	3T	6	135	16	0	1600	0	-1600	0.00	0.00	2	0	-2
0042	3T	6	136	16	0	1600	0	-1600	0.00	0.00	2	0	-2
0042	3T	6	142	2	0	200	0	-200	0.00	0.00	0	0	0
0042	3T	6	145	4	0	400	0	-400	0.00	0.00	0	0	0
0042	3T	6	146	8	0	800	0	-800	0.00	0.00	1	0	-1
0042	3T	6	152	2	0	200	0	-200	0.00	0.00	0	0	0
0042	3T	6	154	4	1	400	1910	1510	0.25	4.78	0	3	3
0042	3T	6	156	10	0	1000	0	-1000	0.00	0.00	1	0	-1
0042	3T	6	163	1	0	100	0	-100	0.00	0.00	0	0	0
0042	3T	6	214	2	0	200	0	-200	0.00	0.00	0	0	0
0042	3T	6	215	3	0	300	0	-300	0.00	0.00	0	0	0
0042	3T	6	216	4	0	400	0	-400	0.00	0.00	0	0	0
0042	3T	6	231	1	0	100	0	-100	0.00	0.00	0	0	0
0042	3T	6	241	2	0	200	0	-200	0.00	0.00	0	0	0
0042	3T	6	245	1	0	100	0	-100	0.00	0.00	0	0	0
0042	3T	6	246	1	0	100	0	-100	0.00	0.00	0	0	0
0042	3T	6	251	4	0	400	0	-400	0.00	0.00	0	0	0
0042	3T	6	256	1	0	100	0	-100	0.00	0.00	0	0	0
0042	3T	7	123	285	39	28500	21040	-7460	0.14	0.74	50	37	-13
0042	3T	7	124	330	33	33000	23570	-9430	0.10	0.71	58	41	-17
0042	3T	7	125	227	23	22700	22280	-420	0.10	0.98	40	39	-1
0042	3T	7	126	393	20	39300	33350	-5950	0.05	0.85	69	59	-10
0042	3T	7	132	33	6	3300	3660	360	0.18	1.11	5	6	1
0042	3T	7	134	237	23	23700	16610	-7090	0.10	0.70	41	29	-12
0042	3T	7	135	157	12	15700	14440	-1260	0.08	0.92	27	25	-2
0042	3T	7	136	164	8	16400	10460	-5940	0.05	0.64	29	18	-11
0042	3T	7	142	30	2	3000	2980	-20	0.07	0.99	5	5	0
0042	3T	7	143	26	4	2600	3860	1260	0.15	1.48	4	6	2
0042	3T	7	145	158	8	15800	9870	-5930	0.05	0.62	27	17	-10
0042	3T	7	146	199	9	19900	16040	-3860	0.05	0.81	35	28	-7
0042	3T	7	152	19	1	1900	2420	520	0.05	1.27	3	4	1
0042	3T	7	153	29	0	2900	0	-2900	0.00	0.00	5	0	-5
0042	3T	7	154	63	2	6300	5850	-450	0.03	0.93	11	10	-1
0042	3T	7	156	241	7	24100	27880	3780	0.03	1.16	42	49	7
0042	3T	7	162	12	0	1200	0	-1200	0.00	0.00	2	0	-2
0042	3T	7	163	11	0	1100	0	-1100	0.00	0.00	1	0	-1
0042	3T	7	164	2	0	200	0	-200	0.00	0.00	0	0	0
0042	3T	7	165	3	0	300	0	-300	0.00	0.00	0	0	0
0042	3T	7	213	21	1	2100	1080	-1020	0.05	0.51	3	1	-2
0042	3T	7	214	21	2	2100	1760	-340	0.10	0.84	3	3	0
0042	3T	7	215	26	0	2600	0	-2600	0.00	0.00	4	0	-4
0042	3T	7	216	66	0	6600	0	-6600	0.00	0.00	11	0	-11
0042	3T	7	231	64	1	6400	1650	-4750	0.02	0.26	11	2	-9
0042	3T	7	234	11	0	1100	0	-1100	0.00	0.00	1	0	-1
0042	3T	7	235	8	0	800	0	-800	0.00	0.00	1	0	-1
0042	3T	7	236	7	0	700	0	-700	0.00	0.00	1	0	-1
0042	3T	7	241	107	3	10700	8790	-1910	0.03	0.82	18	15	-3
0042	3T	7	245	10	0	1000	0	-1000	0.00	0.00	1	0	-1
0042	3T	7	246	12	0	1200	0	-1200	0.00	0.00	2	0	-2
0042	3T	7	251	129	2	12900	5670	-7230	0.02	0.44	22	10	-12
0042	3T	7	253	3	0	300	0	-300	0.00	0.00	0	0	0
0042	3T	7	256	29	0	2900	0	-2900	0.00	0.00	5	0	-5
0042	3T	7	261	70	2	7000	14380	7380	0.03	2.05	12	25	13
0042	3T	7	264	1	0	100	0	-100	0.00	0.00	0	0	0
0042	3T	7	265	1	0	100	0	-100	0.00	0.00	0	0	0
0043	1T	nopattern	1	21230	14746	2123000	2018950	-104050	0.69	0.95	3757	3573	-184
0043	1T	nopattern	2	12471	3350	1247100	1161760	-85340	0.27	0.93	2207	2056	-151
0043	2F	nopattern	12	8344	2870	834400	724750	-109650	0.34	0.87	1476	1282	-194
0043	2F	nopattern	13	7061	1949	706100	590150	-115950	0.28	0.84	1249	1044	-205
0043	2F	nopattern	14	6691	1465	669100	525510	-143590	0.22	0.79	1184	930	-254
0043	2F	nopattern	15	5000	696	500000	439110	-60890	0.14	0.88	884	777	-107
0043	2F	nopattern	16	3886	403	388600	315740	-72860	0.10	0.81	687	558	-129
0043	2F	nopattern	23	3387	313	338700	259280	-79420	0.09	0.77	599	458	-141
0043	2F	nopattern	24	3416	288	341600	240400	-101200	0.08	0.70	604	425	-179
0043	2F	nopattern	25	3371	215	337100	240200	-96900	0.06	0.71	596	425	-171
0043	2F	nopattern	26	3179	188	317900	192470	-125430	0.06	0.61	562	340	-222
0043	2T	nopattern	12	5326	1530	532600	454730	-77870	0.29	0.85	942	804	-138
0043	2T	nopattern	13	4487	1047	448700	376250	-72450	0.23	0.84	794	665	-129
0043	2T	nopattern	14	4437	840	443700	360420	-83280	0.19	0.81	785	637	-148
0043	2T	nopattern	15	3248	373	324800	284740	-40060	0.11	0.88	574	503	-71
0043	2T	nopattern	16	2463	222	246300	227650	-18650	0.09	0.92	435	402	-33
0043	2T	nopattern	21	3018	409	301800	293210	-8590	0.14	0.97	534	518	-16
0043	2T	nopattern	23	1824	102	182400	152080	-30320	0.06	0.83	322	269	-53
0043	2T	nopattern	24	1736	104	173600	135980	-37620	0.06	0.78	307	240	-67
0043	2T	nopattern	25	1932	103	193200	149500	-43700	0.05	0.77	341	264	-77
0043	2T	nopattern	26	2036	104	203600	164100	-39500	0.05	0.81	360	290	-70
0043	3F	nopattern	123	4070	960	407000	328940	-78060	0.24	0.81	720	582	-138
0043	3F	nopattern	124	3971	777	397100	302650	-94450	0.20	0.76	702	535	-167
0043	3F	nopattern	125	3214	439	321400	281720	-39680	0.14	0.88	568	498	-70
0043	3F	nopattern	126	2803	296	280300	253520	-26780	0.11	0.90	496	448	-48
0043	3F	nopattern	134	3583	624	358300	283540	-74760	0.17	0.79	634	501	-133
0043	3F	nopattern	135	2957	338	295700	202190	-93510	0.11	0.68	523	357	-166
0043	3F	nopattern	136	2571	259	257100	207260	-49840	0.10	0.81	455	366	-89
0043	3F	nopattern	145	2871	280	287100	235550	-51550	0.10	0.82	508	416	-92
0043	3F	nopattern	146	2263	175	226300	141810	-84490	0.08	0.63	400	250	-150
0043	3F	nopattern	156	2013	120	201300	194880	-6420	0.06	0.97	356	344	-12
0043	3F	nopattern	234	1999	129	199900	141840	-58060	0.06	0.71	353	251	-102
0043	3F	nopattern	235	1808	105	180800	109600	-71200	0.06	0.61	320	193	-127
0043	3F	nopattern	236	1684	64	168400	91600	-76800	0.04	0.54	298	162	-136
0043	3F	nopattern	245	1719	59	171900	90790	-81110	0.03	0.53	304	160	-144
0043	3F	nopattern	246	1496	69	149600	113510	-36090	0.05	0.76	264	200	-64
0043	3F	nopattern	256	1416	51	141600	92830	-48770	0.04	0.66	250	164	-86
0043	3T	nopattern	123	1373	180	137300	129050	-8250	0.13	0.94	243	228	-15
0043	3T	nopattern	124	1259	104	125900	82750	-43150	0.08	0.66	222	146	-76
0043	3T	nopattern	125	999	61	99900	78970	-20930	0.06	0.79	176	139	-37
0043	3T	nopattern	126	820	41	82000	65380	-16620	0.05	0.80	145	115	-30
0043	3T	nopattern	132	1014	91	101400	85680	-15720	0.09	0.84	179	151	-28
0043	3T	nopattern	134	1062	96	106200	98330	-7870	0.09	0.93	187	174	-13
0043	3T	nopattern	135	819	38	81900	46590	-35310	0.05	0.57	144	82	-62
0043	3T	nopattern	136	699	38	69900	60020	-9880	0.05	0.86	123	106	-17
0043	3T	nopattern	142	987	84	98700	85710	-12990	0.09	0.87	174	151	-23
0043	3T	nopattern	143	959	48	95900	64970	-30930	0.05	0.68	169	114	-55
0043	3T	nopattern	145	818	35	81800	45970	-35830	0.04	0.56	144	81	-63
0043	3T	nopattern	146	608	22	60800	36790	-24010	0.04	0.61	107	65	-42
0043	3T	nopattern	152	659	32	65900	63340	-2560	0.05	0.96	116	112	-4
0043	3T	nopattern	153	636	20	63600	47140	-16460	0.03	0.74	112	83	-29
0043	3T	nopattern	154	615	12	61500	29860	-31640	0.02	0.49	108	52	-56
0043	3T	nopattern	156	520	16	52000	55900	3900	0.03	1.08	92	98	6
0043	3T	nopattern	162	520	14	52000	40510	-11490	0.03	0.78	92	71	-21
0043	3T	nopattern	163	502	12	50200	42840	-7360	0.02	0.85	88	75	-13
0043	3T	nopattern	164	449	9	44900	29060	-15840	0.02	0.65	79	51	-28
0043	3T	nopattern	165	314	4	31400	7460	-23940	0.01	0.24	55	13	-42
0043	3T	nopattern	213	566	31	56600	58600	2000	0.05	1.04	100	103	3
0043	3T	nopattern	214	556	29	55600	46610	-8990	0.05	0.84	98	82	-16
0043	3T	nopattern	215	542	19	54200	52340	-1860	0.04	0.97	95	92	-3
0043	3T	nopattern	216	554	16	55400	50250	-5150	0.03	0.91	98	88	-10
0043	3T	nopattern	231	431	9	43100	46240	3140	0.02	1.07	76	81	5
0043	3T	nopattern	234	353	4	35300	10450	-24850	0.01	0.30	62	18	-44
0043	3T	nopattern	235	289	5	28900	30730	1830	0.02	1.06	51	54	3
0043	3T	nopattern	236	290	5	29000	17830	-11170	0.02	0.61	51	31	-20
0043	3T	nopattern	241	417	10	41700	41930	230	0.02	1.01	73	74	1
0043	3T	nopattern	243	302	7	30200	52910	22710	0.02	1.75	53	93	40
0043	3T	nopattern	245	275	1	27500	2200	-25300	0.00	0.08	48	3	-45
0043	3T	nopattern	246	270	6	27000	38240	11240	0.02	1.42	47	67	20
0043	3T	nopattern	251	504	8	50400	23320	-27080	0.02	0.46	89	41	-48
0043	3T	nopattern	253	300	9	30000	18670	-11330	0.03	0.62	53	33	-20
0043	3T	nopattern	254	256	1	25600	19000	-6600	0.00	0.74	45	33	-12
0043	3T	nopattern	256	317	4	31700	10100	-21600	0.01	0.32	56	17	-39
0043	3T	nopattern	261	547	9	54700	63710	9010	0.02	1.16	96	112	16
0043	3T	nopattern	263	321	5	32100	27310	-4790	0.02	0.85	56	48	-8
0043	3T	nopattern	264	281	3	28100	12760	-15340	0.01	0.45	49	22	-27
0043	3T	nopattern	265	246	5	24600	17860	-6740	0.02	0.73	43	31	-12
0044	1T	1	1	4293	2666	429300	413220	-16080	0.62	0.96	759	731	-28
0044	1T	1	2	2480	618	248000	227330	-20670	0.25	0.92	438	402	-36
0044	1T	2	1	3595	2294	359500	345200	-14300	0.64	0.96	636	610	-26
0044	1T	2	2	2425	675	242500	194610	-47890	0.28	0.80	429	344	-85
0044	1T	3	1	3597	2475	359700	352930	-6770	0.69	0.98	636	624	-12
0044	1T	3	2	2294	664	229400	199940	-29460	0.29	0.87	406	353	-53
0044	1T	4	1	3390	2459	339000	326710	-12290	0.73	0.96	600	578	-22
0044	1T	4	2	1778	559	177800	160850	-16950	0.31	0.90	314	284	-30
0044	1T	5	1	2935	2161	293500	280300	-13200	0.74	0.96	519	496	-23
0044	1T	5	2	1159	281	115900	105330	-10570	0.24	0.91	205	186	-19
0044	1T	6	1	238	173	23800	21630	-2170	0.73	0.91	42	38	-4
0044	1T	6	2	78	21	7800	8800	1000	0.27	1.13	13	15	2
0044	1T	7	1	4289	3104	428900	405960	-22940	0.72	0.95	759	718	-41
0044	1T	7	2	1834	409	183400	160830	-22570	0.22	0.88	324	284	-40
0044	2F	1	12	1640	478	164000	142070	-21930	0.29	0.87	290	251	-39
0044	2F	1	13	1460	372	146000	119500	-26500	0.25	0.82	258	211	-47
0044	2F	1	14	1234	241	123400	95250	-28150	0.20	0.77	218	168	-50
0044	2F	1	15	896	95	89600	75480	-14120	0.11	0.84	158	133	-25
0044	2F	1	16	705	58	70500	53550	-16950	0.08	0.76	124	94	-30
0044	2F	1	23	811	70	81100	61940	-19160	0.09	0.76	143	109	-34
0044	2F	1	24	771	62	77100	76330	-770	0.08	0.99	136	135	-1
0044	2F	1	25	638	38	63800	52860	-10940	0.06	0.83	112	93	-19
0044	2F	1	26	576	30	57600	26480	-31120	0.05	0.46	101	46	-55
0044	2F	2	12	1384	445	138400	124870	-13530	0.32	0.90	244	221	-23
0044	2F	2	13	1218	303	121800	92690	-29110	0.25	0.76	215	164	-51
0044	2F	2	14	1171	259	117100	95620	-21480	0.22	0.82	207	169	-38
0044	2F	2	15	827	94	82700	53140	-29560	0.11	0.64	146	94	-52
0044	2F	2	16	727	88	72700	60300	-12400	0.12	0.83	128	106	-22
0044	2F	2	23	687	78	68700	63900	-4800	0.11	0.93	121	113	-8
0044	2F	2	24	651	61	65100	62070	-3030	0.09	0.95	115	109	-6
0044	2F	2	25	670	42	67000	42920	-24080	0.06	0.64	118	75	-43
0044	2F	2	26	646	39	64600	28660	-35940	0.06	0.44	114	50	-64
0044	2F	3	12	1401	506	140100	131220	-8880	0.36	0.94	247	232	-15
0044	2F	3	13	1241	340	124100	102510	-21590	0.27	0.83	219	181	-38
0044	2F	3	14	1117	253	111700	89210	-22490	0.23	0.80	197	157	-40
0044	2F	3	15	865	144	86500	84450	-2050	0.17	0.98	153	149	-4
0044	2F	3	16	663	68	66300	50960	-15340	0.10	0.77	117	90	-27
0044	2F	3	23	601	40	60100	29060	-31040	0.07	0.48	106	51	-55
0044	2F	3	24	593	54	59300	50970	-8330	0.09	0.86	104	90	-14
0044	2F	3	25	693	56	69300	57700	-11600	0.08	0.83	122	102	-20
0044	2F	3	26	637	48	63700	52370	-11330	0.08	0.82	112	92	-20
0044	2F	4	12	1266	445	126600	111820	-14780	0.35	0.88	224	197	-27
0044	2F	4	13	1112	349	111200	103720	-7480	0.31	0.93	196	183	-13
0044	2F	4	14	1038	256	103800	86740	-17060	0.25	0.84	183	153	-30
0044	2F	4	15	780	103	78000	63390	-14610	0.13	0.81	138	112	-26
0044	2F	4	16	509	45	50900	32440	-18460	0.09	0.64	90	57	-33
0044	2F	4	23	493	65	49300	47640	-1660	0.13	0.97	87	84	-3
0044	2F	4	24	468	46	46800	27350	-19450	0.10	0.58	82	48	-34
0044	2F	4	25	534	45	53400	32380	-21020	0.08	0.61	94	57	-37
0044	2F	4	26	438	27	43800	50260	6460	0.06	1.15	77	88	11
0044	2F	5	12	1048	416	104800	94670	-10130	0.40	0.90	185	167	-18
0044	2F	5	13	895	267	89500	79280	-10220	0.30	0.89	158	140	-18
0044	2F	5	14	848	207	84800	70910	-13890	0.24	0.84	150	125	-25
0044	2F	5	15	631	87	63100	57790	-5310	0.14	0.92	111	102	-9
0044	2F	5	16	414	50	41400	41430	30	0.12	1.00	73	73	0
0044	2F	5	23	347	22	34700	18080	-16620	0.06	0.52	61	32	-29
0044	2F	5	24	315	23	31500	21140	-10360	0.07	0.67	55	37	-18
0044	2F	5	25	329	16	32900	13190	-19710	0.05	0.40	58	23	-35
0044	2F	5	26	262	10	26200	14380	-11820	0.04	0.55	46	25	-21
0044	2F	6	12	79	30	7900	6910	-990	0.38	0.87	13	12	-1
0044	2F	6	13	75	17	7500	4820	-2680	0.23	0.64	13	8	-5
0044	2F	6	14	69	15	6900	4970	-1930	0.22	0.72	12	8	-4
0044	2F	6	15	58	9	5800	4090	-1710	0.16	0.71	10	7	-3
0044	2F	6	16	34	8	3400	6820	3420	0.24	2.01	6	12	6
0044	2F	6	23	23	1	2300	1970	-330	0.04	0.86	4	3	-1
0044	2F	6	24	30	5	3000	4090	1090	0.17	1.36	5	7	2
0044	2F	6	25	18	0	1800	0	-1800	0.00	0.00	3	0	-3
0044	2F	6	26	26	0	2600	0	-2600	0.00	0.00	4	0	-4
0044	2F	7	12	1566	576	156600	135190	-21410	0.37	0.86	277	239	-38
0044	2F	7	13	1279	349	127900	108170	-19730	0.27	0.85	226	191	-35
0044	2F	7	14	1337	288	133700	105880	-27820	0.22	0.79	236	187	-49
0044	2F	7	15	922	128	92200	75200	-17000	0.14	0.82	163	133	-30
0044	2F	7	16	762	70	76200	54700	-21500	0.09	0.72	134	96	-38
0044	2F	7	23	507	30	50700	25700	-25000	0.06	0.51	89	45	-44
0044	2F	7	24	487	37	48700	37090	-11610	0.08	0.76	86	65	-21
0044	2F	7	25	535	27	53500	27650	-25850	0.05	0.52	94	48	-46
0044	2F	7	26	487	18	48700	25340	-23360	0.04	0.52	86	44	-42
0044	2T	1	12	1055	253	105500	92050	-13450	0.24	0.87	186	162	-24
0044	2T	1	13	978	188	97800	70110	-27690	0.19	0.72	173	124	-49
0044	2T	1	14	802	132	80200	69800	-10400	0.16	0.87	141	123	-18
0044	2T	1	15	603	62	60300	63840	3540	0.10	1.06	106	112	6
0044	2T	1	16	495	36	49500	41730	-7770	0.07	0.84	87	73	-14
0044	2T	1	21	585	63	58500	59670	1170	0.11	1.02	103	105	2
0044	2T	1	23	432	25	43200	30990	-12210	0.06	0.72	76	54	-22
0044	2T	1	24	401	20	40100	36320	-3780	0.05	0.91	70	64	-6
0044	2T	1	25	343	13	34300	15610	-18690	0.04	0.46	60	27	-33
0044	2T	1	26	336	14	33600	22130	-11470	0.04	0.66	59	39	-20
0044	2T	2	12	830	207	83000	71700	-11300	0.25	0.86	146	126	-20
0044	2T	2	13	763	144	76300	59460	-16840	0.19	0.78	135	105	-30
0044	2T	2	14	780	139	78000	68980	-9020	0.18	0.88	138	122	-16
0044	2T	2	15	546	50	54600	37240	-17360	0.09	0.68	96	65	-31
0044	2T	2	16	427	38	42700	35340	-7360	0.09	0.83	75	62	-13
0044	2T	2	21	554	80	55400	61040	5640	0.14	1.10	98	108	10
0044	2T	2	23	378	30	37800	45370	7570	0.08	1.20	66	80	14
0044	2T	2	24	335	23	33500	21190	-12310	0.07	0.63	59	37	-22
0044	2T	2	25	384	11	38400	9380	-29020	0.03	0.24	67	16	-51
0044	2T	2	26	404	20	40400	19130	-21270	0.05	0.47	71	33	-38
0044	2T	3	12	882	255	88200	79220	-8980	0.29	0.90	156	140	-16
0044	2T	3	13	796	192	79600	76400	-3200	0.24	0.96	140	135	-5
0044	2T	3	14	765	145	76500	62550	-13950	0.19	0.82	135	110	-25
0044	2T	3	15	561	86	56100	58050	1950	0.15	1.03	99	102	3
0044	2T	3	16	395	36	39500	34770	-4730	0.09	0.88	69	61	-8
0044	2T	3	21	519	82	51900	54320	2420	0.16	1.05	91	96	5
0044	2T	3	23	325	14	32500	18940	-13560	0.04	0.58	57	33	-24
0044	2T	3	24	297	18	29700	24280	-5420	0.06	0.82	52	42	-10
0044	2T	3	25	379	26	37900	33890	-4010	0.07	0.89	67	59	-8
0044	2T	3	26	380	22	38000	42950	4950	0.06	1.13	67	76	9
0044	2T	4	12	855	254	85500	71970	-13530	0.30	0.84	151	127	-24
0044	2T	4	13	784	216	78400	73550	-4850	0.28	0.94	138	130	-8
0044	2T	4	14	746	162	74600	65100	-9500	0.22	0.87	132	115	-17
0044	2T	4	15	503	63	50300	47820	-2480	0.13	0.95	89	84	-5
0044	2T	4	16	342	27	34200	22910	-11290	0.08	0.67	60	40	-20
0044	2T	4	21	411	60	41100	35700	-5400	0.15	0.87	72	63	-9
0044	2T	4	23	279	22	27900	27380	-520	0.08	0.98	49	48	-1
0044	2T	4	24	231	17	23100	14320	-8780	0.07	0.62	40	25	-15
0044	2T	4	25	316	21	31600	26620	-4980	0.07	0.84	55	47	-8
0044	2T	4	26	256	16	25600	35930	10330	0.06	1.40	45	63	18
0044	2T	5	12	761	253	76100	66170	-9930	0.33	0.87	134	117	-17
0044	2T	5	13	666	161	66600	54510	-12090	0.24	0.82	117	96	-21
0044	2T	5	14	640	131	64000	55760	-8240	0.20	0.87	113	98	-15
0044	2T	5	15	435	50	43500	39400	-4100	0.11	0.91	76	69	-7
0044	2T	5	16	270	28	27000	27710	710	0.10	1.03	47	49	2
0044	2T	5	21	287	41	28700	33550	4850	0.14	1.17	50	59	9
0044	2T	5	23	202	8	20200	12530	-7670	0.04	0.62	35	22	-13
0044	2T	5	24	155	4	15500	8410	-7090	0.03	0.54	27	14	-13
0044	2T	5	25	185	8	18500	17310	-1190	0.04	0.94	32	30	-2
0044	2T	5	26	130	6	13000	13710	710	0.05	1.05	23	24	1
0044	2T	6	12	58	20	5800	5230	-570	0.34	0.90	10	9	-1
0044	2T	6	13	52	5	5200	1530	-3670	0.10	0.29	9	2	-7
0044	2T	6	14	50	8	5000	3640	-1360	0.16	0.73	8	6	-2
0044	2T	6	15	41	4	4100	2590	-1510	0.10	0.63	7	4	-3
0044	2T	6	16	22	6	2200	6460	4260	0.27	2.94	3	11	8
0044	2T	6	21	21	3	2100	2770	670	0.14	1.32	3	4	1
0044	2T	6	23	17	0	1700	0	-1700	0.00	0.00	3	0	-3
0044	2T	6	24	13	1	1300	890	-410	0.08	0.68	2	1	-1
0044	2T	6	25	8	0	800	0	-800	0.00	0.00	1	0	-1
0044	2T	6	26	13	0	1300	0	-1300	0.00	0.00	2	0	-2
0044	2T	7	12	1097	355	109700	96970	-12730	0.32	0.88	194	171	-23
0044	2T	7	13	858	206	85800	74900	-10900	0.24	0.87	151	132	-19
0044	2T	7	14	943	166	94300	75200	-19100	0.18	0.80	166	133	-33
0044	2T	7	15	620	73	62000	49450	-12550	0.12	0.80	109	87	-22
0044	2T	7	16	505	35	50500	34510	-15990	0.07	0.68	89	61	-28
0044	2T	7	21	469	46	46900	37790	-9110	0.10	0.81	83	66	-17
0044	2T	7	23	286	8	28600	16540	-12060	0.03	0.58	50	29	-21
0044	2T	7	24	221	17	22100	34820	12720	0.08	1.58	39	61	22
0044	2T	7	25	273	7	27300	10730	-16570	0.03	0.39	48	18	-30
0044	2T	7	26	268	7	26800	10610	-16190	0.03	0.40	47	18	-29
0044	3F	1	123	855	182	85500	80030	-5470	0.21	0.94	151	141	-10
0044	3F	1	124	755	124	75500	60000	-15500	0.16	0.79	133	106	-27
0044	3F	1	125	604	75	60400	53090	-7310	0.12	0.88	106	93	-13
0044	3F	1	126	568	66	56800	59700	2900	0.12	1.05	100	105	5
0044	3F	1	134	721	101	72100	60450	-11650	0.14	0.84	127	106	-21
0044	3F	1	135	542	49	54200	30080	-24120	0.09	0.55	95	53	-42
0044	3F	1	136	494	38	49400	44720	-4680	0.08	0.91	87	79	-8
0044	3F	1	145	506	35	50600	29760	-20840	0.07	0.59	89	52	-37
0044	3F	1	146	430	32	43000	32980	-10020	0.07	0.77	76	58	-18
0044	3F	1	156	341	13	34100	21720	-12380	0.04	0.64	60	38	-22
0044	3F	1	234	446	16	44600	15790	-28810	0.04	0.35	78	27	-51
0044	3F	1	235	402	24	40200	23700	-16500	0.06	0.59	71	41	-30
0044	3F	1	236	353	11	35300	25100	-10200	0.03	0.71	62	44	-18
0044	3F	1	245	344	16	34400	39700	5300	0.05	1.15	60	70	10
0044	3F	1	246	303	6	30300	11650	-18650	0.02	0.38	53	20	-33
0044	3F	1	256	268	5	26800	12050	-14750	0.02	0.45	47	21	-26
0044	3F	2	123	706	154	70600	54670	-15930	0.22	0.77	124	96	-28
0044	3F	2	124	679	124	67900	48980	-18920	0.18	0.72	120	86	-34
0044	3F	2	125	575	86	57500	47910	-9590	0.15	0.83	101	84	-17
0044	3F	2	126	534	65	53400	43670	-9730	0.12	0.82	94	77	-17
0044	3F	2	134	639	101	63900	48620	-15280	0.16	0.76	113	86	-27
0044	3F	2	135	497	68	49700	43570	-6130	0.14	0.88	87	77	-10
0044	3F	2	136	492	47	49200	46970	-2230	0.10	0.95	87	83	-4
0044	3F	2	145	470	39	47000	28000	-19000	0.08	0.60	83	49	-34
0044	3F	2	146	435	46	43500	41320	-2180	0.11	0.95	76	73	-3
0044	3F	2	156	347	21	34700	30390	-4310	0.06	0.88	61	53	-8
0044	3F	2	234	388	32	38800	31880	-6920	0.08	0.82	68	56	-12
0044	3F	2	235	363	12	36300	23940	-12360	0.03	0.66	64	42	-22
0044	3F	2	236	369	18	36900	20410	-16490	0.05	0.55	65	36	-29
0044	3F	2	245	314	17	31400	33460	2060	0.05	1.07	55	59	4
0044	3F	2	246	309	15	30900	19880	-11020	0.05	0.64	54	35	-19
0044	3F	2	256	331	14	33100	14550	-18550	0.04	0.44	58	25	-33
0044	3F	3	123	704	188	70400	68950	-1450	0.27	0.98	124	122	-2
0044	3F	3	124	673	154	67300	68670	1370	0.23	1.02	119	121	2
0044	3F	3	125	573	64	57300	39360	-17940	0.11	0.69	101	69	-32
0044	3F	3	126	518	62	51800	56890	5090	0.12	1.10	91	100	9
0044	3F	3	134	583	89	58300	50680	-7620	0.15	0.87	103	89	-14
0044	3F	3	135	572	73	57200	44370	-12830	0.13	0.78	101	78	-23
0044	3F	3	136	436	39	43600	31640	-11960	0.09	0.73	77	56	-21
0044	3F	3	145	452	41	45200	30450	-14750	0.09	0.67	80	53	-27
0044	3F	3	146	412	21	41200	18380	-22820	0.05	0.45	72	32	-40
0044	3F	3	156	371	30	37100	52860	15760	0.08	1.42	65	93	28
0044	3F	3	234	338	21	33800	15900	-17900	0.06	0.47	59	28	-31
0044	3F	3	235	328	11	32800	7010	-25790	0.03	0.21	58	12	-46
0044	3F	3	236	356	13	35600	17690	-17910	0.04	0.50	63	31	-32
0044	3F	3	245	327	18	32700	30850	-1850	0.06	0.94	57	54	-3
0044	3F	3	246	259	13	25900	14780	-11120	0.05	0.57	45	26	-19
0044	3F	3	256	266	9	26600	15600	-11000	0.03	0.59	47	27	-20
0044	3F	4	123	640	170	64000	58810	-5190	0.27	0.92	113	104	-9
0044	3F	4	124	629	116	62900	43820	-19080	0.18	0.70	111	77	-34
0044	3F	4	125	504	65	50400	37830	-12570	0.13	0.75	89	66	-23
0044	3F	4	126	389	42	38900	45530	6630	0.11	1.17	68	80	12
0044	3F	4	134	536	101	53600	48650	-4950	0.19	0.91	94	86	-8
0044	3F	4	135	500	54	50000	35400	-14600	0.11	0.71	88	62	-26
0044	3F	4	136	362	39	36200	43400	7200	0.11	1.20	64	76	12
0044	3F	4	145	419	37	41900	27620	-14280	0.09	0.66	74	48	-26
0044	3F	4	146	306	21	30600	28830	-1770	0.07	0.94	54	51	-3
0044	3F	4	156	283	14	28300	15500	-12800	0.05	0.55	50	27	-23
0044	3F	4	234	293	22	29300	16020	-13280	0.08	0.55	51	28	-23
0044	3F	4	235	289	26	28900	19340	-9560	0.09	0.67	51	34	-17
0044	3F	4	236	225	14	22500	15360	-7140	0.06	0.68	39	27	-12
0044	3F	4	245	244	10	24400	9180	-15220	0.04	0.38	43	16	-27
0044	3F	4	246	203	8	20300	10660	-9640	0.04	0.53	35	18	-17
0044	3F	4	256	214	6	21400	5290	-16110	0.03	0.25	37	9	-28
0044	3F	5	123	520	153	52000	44270	-7730	0.29	0.85	92	78	-14
0044	3F	5	124	510	108	51000	39530	-11470	0.21	0.78	90	69	-21
0044	3F	5	125	382	45	38200	26210	-11990	0.12	0.69	67	46	-21
0044	3F	5	126	260	35	26000	21140	-4860	0.13	0.81	46	37	-9
0044	3F	5	134	462	100	46200	48220	2020	0.22	1.04	81	85	4
0044	3F	5	135	376	31	37600	23550	-14050	0.08	0.63	66	41	-25
0044	3F	5	136	251	23	25100	24700	-400	0.09	0.98	44	43	-1
0044	3F	5	145	368	46	36800	48920	12120	0.13	1.33	65	86	21
0044	3F	5	146	199	20	19900	16520	-3380	0.10	0.83	35	29	-6
0044	3F	5	156	212	15	21200	20810	-390	0.07	0.98	37	36	-1
0044	3F	5	234	220	10	22000	8080	-13920	0.05	0.37	38	14	-24
0044	3F	5	235	200	4	20000	2220	-17780	0.02	0.11	35	3	-32
0044	3F	5	236	139	5	13900	6160	-7740	0.04	0.44	24	10	-14
0044	3F	5	245	154	8	15400	4180	-11220	0.05	0.27	27	7	-20
0044	3F	5	246	117	4	11700	11810	110	0.03	1.01	20	20	0
0044	3F	5	256	143	2	14300	2800	-11500	0.01	0.20	25	4	-21
0044	3F	6	123	47	5	4700	2180	-2520	0.11	0.46	8	3	-5
0044	3F	6	124	36	11	3600	4250	650	0.31	1.18	6	7	1
0044	3F	6	125	21	2	2100	1420	-680	0.10	0.68	3	2	-1
0044	3F	6	126	23	5	2300	6410	4110	0.22	2.79	4	11	7
0044	3F	6	134	33	6	3300	4150	850	0.18	1.26	5	7	2
0044	3F	6	135	30	3	3000	2760	-240	0.10	0.92	5	4	-1
0044	3F	6	136	21	0	2100	0	-2100	0.00	0.00	3	0	-3
0044	3F	6	145	31	4	3100	2330	-770	0.13	0.75	5	4	-1
0044	3F	6	146	24	3	2400	1180	-1220	0.13	0.49	4	2	-2
0044	3F	6	156	19	1	1900	3710	1810	0.05	1.95	3	6	3
0044	3F	6	234	15	2	1500	770	-730	0.13	0.51	2	1	-1
0044	3F	6	235	10	1	1000	720	-280	0.10	0.72	1	1	0
0044	3F	6	236	13	0	1300	0	-1300	0.00	0.00	2	0	-2
0044	3F	6	245	13	0	1300	0	-1300	0.00	0.00	2	0	-2
0044	3F	6	246	11	0	1100	0	-1100	0.00	0.00	1	0	-1
0044	3F	6	256	6	0	600	0	-600	0.00	0.00	1	0	-1
0044	3F	7	123	774	193	77400	70050	-7350	0.25	0.91	136	123	-13
0044	3F	7	124	784	171	78400	69620	-8780	0.22	0.89	138	123	-15
0044	3F	7	125	569	81	56900	49790	-7110	0.14	0.88	100	88	-12
0044	3F	7	126	499	59	49900	50440	540	0.12	1.01	88	89	1
0044	3F	7	134	643	114	64300	59540	-4760	0.18	0.93	113	105	-8
0044	3F	7	135	533	56	53300	34420	-18880	0.11	0.65	94	60	-34
0044	3F	7	136	436	33	43600	31070	-12530	0.08	0.71	77	54	-23
0044	3F	7	145	549	61	54900	56670	1770	0.11	1.03	97	100	3
0044	3F	7	146	417	37	41700	39970	-1730	0.09	0.96	73	70	-3
0044	3F	7	156	386	14	38600	18370	-20230	0.04	0.48	68	32	-36
0044	3F	7	234	298	15	29800	18110	-11690	0.05	0.61	52	32	-20
0044	3F	7	235	293	12	29300	20030	-9270	0.04	0.68	51	35	-16
0044	3F	7	236	250	6	25000	7550	-17450	0.02	0.30	44	13	-31
0044	3F	7	245	262	5	26200	5900	-20300	0.02	0.23	46	10	-36
0044	3F	7	246	209	7	20900	29160	8260	0.03	1.40	36	51	15
0044	3F	7	256	227	4	22700	5890	-16810	0.02	0.26	40	10	-30
0044	3T	1	123	256	30	25600	27840	2240	0.12	1.09	45	49	4
0044	3T	1	124	211	13	21100	17340	-3760	0.06	0.82	37	30	-7
0044	3T	1	125	184	14	18400	18870	470	0.08	1.03	32	33	1
0044	3T	1	126	188	10	18800	16910	-1890	0.05	0.90	33	29	-4
0044	3T	1	132	233	11	23300	10890	-12410	0.05	0.47	41	19	-22
0044	3T	1	134	217	13	21700	14530	-7170	0.06	0.67	38	25	-13
0044	3T	1	135	160	9	16000	14610	-1390	0.06	0.91	28	25	-3
0044	3T	1	136	165	6	16500	14760	-1740	0.04	0.89	29	26	-3
0044	3T	1	142	194	12	19400	12690	-6710	0.06	0.65	34	22	-12
0044	3T	1	143	159	7	15900	15940	40	0.04	1.00	28	28	0
0044	3T	1	145	151	6	15100	6710	-8390	0.04	0.44	26	11	-15
0044	3T	1	146	135	5	13500	10510	-2990	0.04	0.78	23	18	-5
0044	3T	1	152	146	8	14600	32300	17700	0.05	2.21	25	57	32
0044	3T	1	153	120	3	12000	9580	-2420	0.03	0.80	21	16	-5
0044	3T	1	154	108	6	10800	17580	6780	0.06	1.63	19	31	12
0044	3T	1	156	113	5	11300	15540	4240	0.04	1.38	20	27	7
0044	3T	1	162	125	3	12500	20230	7730	0.02	1.62	22	35	13
0044	3T	1	163	85	0	8500	0	-8500	0.00	0.00	15	0	-15
0044	3T	1	164	99	3	9900	13890	3990	0.03	1.40	17	24	7
0044	3T	1	165	75	1	7500	1570	-5930	0.01	0.21	13	2	-11
0044	3T	1	213	119	4	11900	8080	-3820	0.03	0.68	21	14	-7
0044	3T	1	214	115	3	11500	5130	-6370	0.03	0.45	20	9	-11
0044	3T	1	215	92	4	9200	7760	-1440	0.04	0.84	16	13	-3
0044	3T	1	216	106	1	10600	1420	-9180	0.01	0.13	18	2	-16
0044	3T	1	231	94	1	9400	2020	-7380	0.01	0.21	16	3	-13
0044	3T	1	234	88	0	8800	0	-8800	0.00	0.00	15	0	-15
0044	3T	1	235	71	1	7100	1140	-5960	0.01	0.16	12	2	-10
0044	3T	1	236	71	0	7100	0	-7100	0.00	0.00	12	0	-12
0044	3T	1	241	85	0	8500	0	-8500	0.00	0.00	15	0	-15
0044	3T	1	243	74	1	7400	8000	600	0.01	1.08	13	14	1
0044	3T	1	245	66	1	6600	3190	-3410	0.02	0.48	11	5	-6
0044	3T	1	246	59	1	5900	2210	-3690	0.02	0.37	10	3	-7
0044	3T	1	251	81	2	8100	6360	-1740	0.02	0.79	14	11	-3
0044	3T	1	253	56	2	5600	3820	-1780	0.04	0.68	9	6	-3
0044	3T	1	254	52	1	5200	1340	-3860	0.02	0.26	9	2	-7
0044	3T	1	256	63	0	6300	0	-6300	0.00	0.00	11	0	-11
0044	3T	1	261	72	0	7200	0	-7200	0.00	0.00	12	0	-12
0044	3T	1	263	64	0	6400	0	-6400	0.00	0.00	11	0	-11
0044	3T	1	264	54	0	5400	0	-5400	0.00	0.00	9	0	-9
0044	3T	1	265	53	0	5300	0	-5300	0.00	0.00	9	0	-9
0044	3T	2	123	204	19	20400	16180	-4220	0.09	0.79	36	28	-8
0044	3T	2	124	170	19	17000	16060	-940	0.11	0.94	30	28	-2
0044	3T	2	125	155	15	15500	16420	920	0.10	1.06	27	29	2
0044	3T	2	126	146	7	14600	5800	-8800	0.05	0.40	25	10	-15
0044	3T	2	132	189	12	18900	13770	-5130	0.06	0.73	33	24	-9
0044	3T	2	134	165	13	16500	15610	-890	0.08	0.95	29	27	-2
0044	3T	2	135	139	11	13900	10580	-3320	0.08	0.76	24	18	-6
0044	3T	2	136	122	3	12200	7180	-5020	0.02	0.59	21	12	-9
0044	3T	2	142	184	14	18400	24380	5980	0.08	1.33	32	43	11
0044	3T	2	143	172	14	17200	17570	370	0.08	1.02	30	31	1
0044	3T	2	145	139	6	13900	6740	-7160	0.04	0.48	24	11	-13
0044	3T	2	146	127	4	12700	6060	-6640	0.03	0.48	22	10	-12
0044	3T	2	152	109	9	10900	18110	7210	0.08	1.66	19	32	13
0044	3T	2	153	104	1	10400	470	-9930	0.01	0.05	18	0	-18
0044	3T	2	154	98	0	9800	0	-9800	0.00	0.00	17	0	-17
0044	3T	2	156	93	0	9300	0	-9300	0.00	0.00	16	0	-16
0044	3T	2	162	100	4	10000	8570	-1430	0.04	0.86	17	15	-2
0044	3T	2	163	99	0	9900	0	-9900	0.00	0.00	17	0	-17
0044	3T	2	164	61	3	6100	4330	-1770	0.05	0.71	10	7	-3
0044	3T	2	165	61	0	6100	0	-6100	0.00	0.00	10	0	-10
0044	3T	2	213	102	1	10200	810	-9390	0.01	0.08	18	1	-17
0044	3T	2	214	100	3	10000	3680	-6320	0.03	0.37	17	6	-11
0044	3T	2	215	104	4	10400	11530	1130	0.04	1.11	18	20	2
0044	3T	2	216	112	3	11200	11280	80	0.03	1.01	19	19	0
0044	3T	2	231	68	1	6800	650	-6150	0.01	0.10	12	1	-11
0044	3T	2	234	61	1	6100	4310	-1790	0.02	0.71	10	7	-3
0044	3T	2	235	67	1	6700	16720	10020	0.01	2.50	11	29	18
0044	3T	2	236	88	3	8800	4430	-4370	0.03	0.50	15	7	-8
0044	3T	2	241	80	1	8000	2210	-5790	0.01	0.28	14	3	-11
0044	3T	2	243	66	3	6600	9030	2430	0.05	1.37	11	15	4
0044	3T	2	245	53	0	5300	0	-5300	0.00	0.00	9	0	-9
0044	3T	2	246	52	3	5200	12710	7510	0.06	2.44	9	22	13
0044	3T	2	251	103	1	10300	5210	-5090	0.01	0.51	18	9	-9
0044	3T	2	253	63	0	6300	0	-6300	0.00	0.00	11	0	-11
0044	3T	2	254	42	0	4200	0	-4200	0.00	0.00	7	0	-7
0044	3T	2	256	74	0	7400	0	-7400	0.00	0.00	13	0	-13
0044	3T	2	261	75	0	7500	0	-7500	0.00	0.00	13	0	-13
0044	3T	2	263	69	1	6900	2060	-4840	0.01	0.30	12	3	-9
0044	3T	2	264	56	2	5600	4810	-790	0.04	0.86	9	8	-1
0044	3T	2	265	70	0	7000	0	-7000	0.00	0.00	12	0	-12
0044	3T	3	123	227	35	22700	30630	7930	0.15	1.35	40	54	14
0044	3T	3	124	181	22	18100	24260	6160	0.12	1.34	32	42	10
0044	3T	3	125	175	9	17500	8580	-8920	0.05	0.49	30	15	-15
0044	3T	3	126	147	12	14700	42740	28040	0.08	2.91	26	75	49
0044	3T	3	132	184	19	18400	17560	-840	0.10	0.95	32	31	-1
0044	3T	3	134	169	11	16900	16300	-600	0.07	0.96	29	28	-1
0044	3T	3	135	171	12	17100	13440	-3660	0.07	0.79	30	23	-7
0044	3T	3	136	120	4	12000	5170	-6830	0.03	0.43	21	9	-12
0044	3T	3	142	158	11	15800	10680	-5120	0.07	0.68	27	18	-9
0044	3T	3	143	174	15	17400	24400	7000	0.09	1.40	30	43	13
0044	3T	3	145	134	4	13400	3740	-9660	0.03	0.28	23	6	-17
0044	3T	3	146	117	2	11700	2840	-8860	0.02	0.24	20	5	-15
0044	3T	3	152	113	4	11300	6780	-4520	0.04	0.60	20	12	-8
0044	3T	3	153	114	8	11400	30890	19490	0.07	2.71	20	54	34
0044	3T	3	154	112	3	11200	4470	-6730	0.03	0.40	19	7	-12
0044	3T	3	156	81	9	8100	21040	12940	0.11	2.60	14	37	23
0044	3T	3	162	83	3	8300	12350	4050	0.04	1.49	14	21	7
0044	3T	3	163	78	3	7800	7360	-440	0.04	0.94	13	13	0
0044	3T	3	164	72	1	7200	3240	-3960	0.01	0.45	12	5	-7
0044	3T	3	165	60	1	6000	29400	23400	0.02	4.90	10	52	42
0044	3T	3	213	97	5	9700	6070	-3630	0.05	0.63	17	10	-7
0044	3T	3	214	111	12	11100	25490	14390	0.11	2.30	19	45	26
0044	3T	3	215	89	2	8900	3470	-5430	0.02	0.39	15	6	-9
0044	3T	3	216	86	7	8600	22940	14340	0.08	2.67	15	40	25
0044	3T	3	231	76	1	7600	3460	-4140	0.01	0.46	13	6	-7
0044	3T	3	234	61	1	6100	990	-5110	0.02	0.16	10	1	-9
0044	3T	3	235	46	0	4600	0	-4600	0.00	0.00	8	0	-8
0044	3T	3	236	69	0	6900	0	-6900	0.00	0.00	12	0	-12
0044	3T	3	241	78	3	7800	5160	-2640	0.04	0.66	13	9	-4
0044	3T	3	243	47	1	4700	4280	-420	0.02	0.91	8	7	-1
0044	3T	3	245	56	2	5600	70140	64540	0.04	12.53	9	124	115
0044	3T	3	246	41	0	4100	0	-4100	0.00	0.00	7	0	-7
0044	3T	3	251	101	3	10100	9120	-980	0.03	0.90	17	16	-1
0044	3T	3	253	56	0	5600	0	-5600	0.00	0.00	9	0	-9
0044	3T	3	254	50	2	5000	12050	7050	0.04	2.41	8	21	13
0044	3T	3	256	49	2	4900	33650	28750	0.04	6.87	8	59	51
0044	3T	3	261	104	1	10400	6900	-3500	0.01	0.66	18	12	-6
0044	3T	3	263	60	1	6000	22040	16040	0.02	3.67	10	39	29
0044	3T	3	264	57	0	5700	0	-5700	0.00	0.00	10	0	-10
0044	3T	3	265	39	1	3900	8860	4960	0.03	2.27	6	15	9
0044	3T	4	123	221	34	22100	20870	-1230	0.15	0.94	39	36	-3
0044	3T	4	124	204	14	20400	11730	-8670	0.07	0.58	36	20	-16
0044	3T	4	125	147	11	14700	9150	-5550	0.07	0.62	26	16	-10
0044	3T	4	126	141	7	14100	9750	-4350	0.05	0.69	24	17	-7
0044	3T	4	132	186	18	18600	20110	1510	0.10	1.08	32	35	3
0044	3T	4	134	171	23	17100	22470	5370	0.13	1.31	30	39	9
0044	3T	4	135	172	5	17200	3330	-13870	0.03	0.19	30	5	-25
0044	3T	4	136	120	10	12000	16820	4820	0.08	1.40	21	29	8
0044	3T	4	142	192	17	19200	18960	-240	0.09	0.99	33	33	0
0044	3T	4	143	151	7	15100	12930	-2170	0.05	0.86	26	22	-4
0044	3T	4	145	132	5	13200	4600	-8600	0.04	0.35	23	8	-15
0044	3T	4	146	102	3	10200	5040	-5160	0.03	0.49	18	8	-10
0044	3T	4	152	118	2	11800	3610	-8190	0.02	0.31	20	6	-14
0044	3T	4	153	95	2	9500	2800	-6700	0.02	0.29	16	4	-12
0044	3T	4	154	102	1	10200	1040	-9160	0.01	0.10	18	1	-17
0044	3T	4	156	69	2	6900	4440	-2460	0.03	0.64	12	7	-5
0044	3T	4	162	73	3	7300	5180	-2120	0.04	0.71	12	9	-3
0044	3T	4	163	60	0	6000	0	-6000	0.00	0.00	10	0	-10
0044	3T	4	164	65	3	6500	6800	300	0.05	1.05	11	12	1
0044	3T	4	165	48	1	4800	4570	-230	0.02	0.95	8	8	0
0044	3T	4	213	79	5	7900	9820	1920	0.06	1.24	13	17	4
0044	3T	4	214	87	3	8700	2340	-6360	0.03	0.27	15	4	-11
0044	3T	4	215	74	1	7400	1110	-6290	0.01	0.15	13	1	-12
0044	3T	4	216	48	0	4800	0	-4800	0.00	0.00	8	0	-8
0044	3T	4	231	63	1	6300	660	-5640	0.02	0.10	11	1	-10
0044	3T	4	234	55	1	5500	3990	-1510	0.02	0.73	9	7	-2
0044	3T	4	235	46	1	4600	2640	-1960	0.02	0.57	8	4	-4
0044	3T	4	236	48	2	4800	15050	10250	0.04	3.14	8	26	18
0044	3T	4	241	56	0	5600	0	-5600	0.00	0.00	9	0	-9
0044	3T	4	243	38	0	3800	0	-3800	0.00	0.00	6	0	-6
0044	3T	4	245	39	0	3900	0	-3900	0.00	0.00	6	0	-6
0044	3T	4	246	31	1	3100	6900	3800	0.03	2.23	5	12	7
0044	3T	4	251	80	1	8000	2250	-5750	0.01	0.28	14	3	-11
0044	3T	4	253	47	0	4700	0	-4700	0.00	0.00	8	0	-8
0044	3T	4	254	42	1	4200	2690	-1510	0.02	0.64	7	4	-3
0044	3T	4	256	43	1	4300	2590	-1710	0.02	0.60	7	4	-3
0044	3T	4	261	70	1	7000	16410	9410	0.01	2.34	12	29	17
0044	3T	4	263	43	1	4300	680	-3620	0.02	0.16	7	1	-6
0044	3T	4	264	43	1	4300	13170	8870	0.02	3.06	7	23	16
0044	3T	4	265	23	0	2300	0	-2300	0.00	0.00	4	0	-4
0044	3T	5	123	213	25	21300	12550	-8750	0.12	0.59	37	22	-15
0044	3T	5	124	171	14	17100	10870	-6230	0.08	0.64	30	19	-11
0044	3T	5	125	142	8	14200	9530	-4670	0.06	0.67	25	16	-9
0044	3T	5	126	108	3	10800	5900	-4900	0.03	0.55	19	10	-9
0044	3T	5	132	149	18	14900	16680	1780	0.12	1.12	26	29	3
0044	3T	5	134	164	13	16400	12130	-4270	0.08	0.74	29	21	-8
0044	3T	5	135	126	10	12600	9910	-2690	0.08	0.79	22	17	-5
0044	3T	5	136	83	6	8300	19950	11650	0.07	2.40	14	35	21
0044	3T	5	142	157	15	15700	16450	750	0.10	1.05	27	29	2
0044	3T	5	143	145	11	14500	13240	-1260	0.08	0.91	25	23	-2
0044	3T	5	145	131	8	13100	15520	2420	0.06	1.18	23	27	4
0044	3T	5	146	62	2	6200	7990	1790	0.03	1.29	10	14	4
0044	3T	5	152	75	4	7500	4270	-3230	0.05	0.57	13	7	-6
0044	3T	5	153	101	0	10100	0	-10100	0.00	0.00	17	0	-17
0044	3T	5	154	80	1	8000	5550	-2450	0.01	0.69	14	9	-5
0044	3T	5	156	67	4	6700	16910	10210	0.06	2.52	11	29	18
0044	3T	5	162	45	4	4500	5790	1290	0.09	1.29	7	10	3
0044	3T	5	163	51	0	5100	0	-5100	0.00	0.00	9	0	-9
0044	3T	5	164	50	0	5000	0	-5000	0.00	0.00	8	0	-8
0044	3T	5	165	31	1	3100	19940	16840	0.03	6.43	5	35	30
0044	3T	5	213	46	5	4600	11870	7270	0.11	2.58	8	21	13
0044	3T	5	214	63	0	6300	0	-6300	0.00	0.00	11	0	-11
0044	3T	5	215	56	1	5600	3800	-1800	0.02	0.68	9	6	-3
0044	3T	5	216	33	2	3300	3390	90	0.06	1.03	5	6	1
0044	3T	5	231	46	0	4600	0	-4600	0.00	0.00	8	0	-8
0044	3T	5	234	35	1	3500	5420	1920	0.03	1.55	6	9	3
0044	3T	5	235	36	1	3600	2270	-1330	0.03	0.63	6	4	-2
0044	3T	5	236	30	0	3000	0	-3000	0.00	0.00	5	0	-5
0044	3T	5	241	47	0	4700	0	-4700	0.00	0.00	8	0	-8
0044	3T	5	243	36	0	3600	0	-3600	0.00	0.00	6	0	-6
0044	3T	5	245	24	0	2400	0	-2400	0.00	0.00	4	0	-4
0044	3T	5	246	13	0	1300	0	-1300	0.00	0.00	2	0	-2
0044	3T	5	251	52	1	5200	3930	-1270	0.02	0.76	9	6	-3
0044	3T	5	253	23	0	2300	0	-2300	0.00	0.00	4	0	-4
0044	3T	5	254	24	1	2400	9500	7100	0.04	3.96	4	16	12
0044	3T	5	256	33	0	3300	0	-3300	0.00	0.00	5	0	-5
0044	3T	5	261	33	2	3300	29720	26420	0.06	9.01	5	52	47
0044	3T	5	263	25	0	2500	0	-2500	0.00	0.00	4	0	-4
0044	3T	5	264	11	0	1100	0	-1100	0.00	0.00	1	0	-1
0044	3T	5	265	16	0	1600	0	-1600	0.00	0.00	2	0	-2
0044	3T	6	123	19	0	1900	0	-1900	0.00	0.00	3	0	-3
0044	3T	6	124	15	2	1500	1430	-70	0.13	0.95	2	2	0
0044	3T	6	125	10	1	1000	2970	1970	0.10	2.97	1	5	4
0044	3T	6	126	8	0	800	0	-800	0.00	0.00	1	0	-1
0044	3T	6	132	10	1	1000	990	-10	0.10	0.99	1	1	0
0044	3T	6	134	17	0	1700	0	-1700	0.00	0.00	3	0	-3
0044	3T	6	135	10	0	1000	0	-1000	0.00	0.00	1	0	-1
0044	3T	6	136	6	0	600	0	-600	0.00	0.00	1	0	-1
0044	3T	6	142	9	1	900	3480	2580	0.11	3.87	1	6	5
0044	3T	6	143	8	0	800	0	-800	0.00	0.00	1	0	-1
0044	3T	6	145	10	0	1000	0	-1000	0.00	0.00	1	0	-1
0044	3T	6	146	8	0	800	0	-800	0.00	0.00	1	0	-1
0044	3T	6	152	6	0	600	0	-600	0.00	0.00	1	0	-1
0044	3T	6	153	6	0	600	0	-600	0.00	0.00	1	0	-1
0044	3T	6	154	10	0	1000	0	-1000	0.00	0.00	1	0	-1
0044	3T	6	156	9	0	900	0	-900	0.00	0.00	1	0	-1
0044	3T	6	162	5	2	500	10880	10380	0.40	21.76	0	19	19
0044	3T	6	163	5	0	500	0	-500	0.00	0.00	0	0	0
0044	3T	6	164	1	0	100	0	-100	0.00	0.00	0	0	0
0044	3T	6	165	1	0	100	0	-100	0.00	0.00	0	0	0
0044	3T	6	213	3	0	300	0	-300	0.00	0.00	0	0	0
0044	3T	6	214	3	0	300	0	-300	0.00	0.00	0	0	0
0044	3T	6	215	2	0	200	0	-200	0.00	0.00	0	0	0
0044	3T	6	216	6	0	600	0	-600	0.00	0.00	1	0	-1
0044	3T	6	231	5	0	500	0	-500	0.00	0.00	0	0	0
0044	3T	6	234	6	0	600	0	-600	0.00	0.00	1	0	-1
0044	3T	6	235	2	0	200	0	-200	0.00	0.00	0	0	0
0044	3T	6	236	2	0	200	0	-200	0.00	0.00	0	0	0
0044	3T	6	241	5	0	500	0	-500	0.00	0.00	0	0	0
0044	3T	6	243	1	1	100	2230	2130	1.00	22.30	0	3	3
0044	3T	6	245	1	0	100	0	-100	0.00	0.00	0	0	0
0044	3T	6	246	1	0	100	0	-100	0.00	0.00	0	0	0
0044	3T	6	251	2	0	200	0	-200	0.00	0.00	0	0	0
0044	3T	6	253	1	0	100	0	-100	0.00	0.00	0	0	0
0044	3T	6	254	1	0	100	0	-100	0.00	0.00	0	0	0
0044	3T	6	256	3	0	300	0	-300	0.00	0.00	0	0	0
0044	3T	6	261	3	0	300	0	-300	0.00	0.00	0	0	0
0044	3T	6	263	3	0	300	0	-300	0.00	0.00	0	0	0
0044	3T	6	264	2	0	200	0	-200	0.00	0.00	0	0	0
0044	3T	7	123	276	42	27600	29420	1820	0.15	1.07	48	52	4
0044	3T	7	124	282	30	28200	23920	-4280	0.11	0.85	49	42	-7
0044	3T	7	125	192	21	19200	27700	8500	0.11	1.44	33	49	16
0044	3T	7	126	172	7	17200	14030	-3170	0.04	0.82	30	24	-6
0044	3T	7	132	201	15	20100	16160	-3940	0.07	0.80	35	28	-7
0044	3T	7	134	186	20	18600	19830	1230	0.11	1.07	32	35	3
0044	3T	7	135	164	13	16400	16810	410	0.08	1.03	29	29	0
0044	3T	7	136	116	3	11600	4200	-7400	0.03	0.36	20	7	-13
0044	3T	7	142	205	10	20500	14390	-6110	0.05	0.70	36	25	-11
0044	3T	7	143	187	9	18700	13770	-4930	0.05	0.74	33	24	-9
0044	3T	7	145	196	11	19600	21380	1780	0.06	1.09	34	37	3
0044	3T	7	146	124	6	12400	14540	2140	0.05	1.17	21	25	4
0044	3T	7	152	136	9	13600	18050	4450	0.07	1.33	24	31	7
0044	3T	7	153	113	2	11300	2930	-8370	0.02	0.26	20	5	-15
0044	3T	7	154	120	4	12000	11110	-890	0.03	0.93	21	19	-2
0044	3T	7	156	94	1	9400	7210	-2190	0.01	0.77	16	12	-4
0044	3T	7	162	94	1	9400	2830	-6570	0.01	0.30	16	5	-11
0044	3T	7	163	101	1	10100	2230	-7870	0.01	0.22	17	3	-14
0044	3T	7	164	72	4	7200	15520	8320	0.06	2.16	12	27	15
0044	3T	7	165	78	0	7800	0	-7800	0.00	0.00	13	0	-13
0044	3T	7	213	86	4	8600	7490	-1110	0.05	0.87	15	13	-2
0044	3T	7	214	92	4	9200	12080	2880	0.04	1.31	16	21	5
0044	3T	7	215	82	1	8200	2210	-5990	0.01	0.27	14	3	-11
0044	3T	7	216	81	4	8100	21260	13160	0.05	2.62	14	37	23
0044	3T	7	231	82	2	8200	3830	-4370	0.02	0.47	14	6	-8
0044	3T	7	234	45	0	4500	0	-4500	0.00	0.00	7	0	-7
0044	3T	7	235	45	1	4500	12040	7540	0.02	2.68	7	21	14
0044	3T	7	236	38	0	3800	0	-3800	0.00	0.00	6	0	-6
0044	3T	7	241	61	6	6100	49280	43180	0.10	8.08	10	87	77
0044	3T	7	243	40	0	4000	0	-4000	0.00	0.00	7	0	-7
0044	3T	7	245	32	1	3200	1220	-1980	0.03	0.38	5	2	-3
0044	3T	7	246	33	1	3300	840	-2460	0.03	0.25	5	1	-4
0044	3T	7	251	67	1	6700	7720	1020	0.01	1.15	11	13	2
0044	3T	7	253	44	1	4400	1260	-3140	0.02	0.29	7	2	-5
0044	3T	7	254	27	0	2700	0	-2700	0.00	0.00	4	0	-4
0044	3T	7	256	44	0	4400	0	-4400	0.00	0.00	7	0	-7
0044	3T	7	261	73	0	7300	0	-7300	0.00	0.00	12	0	-12
0044	3T	7	263	36	1	3600	9350	5750	0.03	2.60	6	16	10
0044	3T	7	264	26	0	2600	0	-2600	0.00	0.00	4	0	-4
0044	3T	7	265	26	0	2600	0	-2600	0.00	0.00	4	0	-4
0045	1T	nopattern	1	21741	15254	2174100	1970290	-203810	0.70	0.91	3847	3487	-360
0045	1T	nopattern	2	10128	3298	1012800	865850	-146950	0.33	0.85	1792	1532	-260
0045	2F	nopattern	12	8362	3146	836200	687280	-148920	0.38	0.82	1480	1216	-264
0045	2F	nopattern	13	5571	1775	557100	473130	-83970	0.32	0.85	986	837	-149
0045	2F	nopattern	14	4458	1042	445800	352690	-93110	0.23	0.79	789	624	-165
0045	2F	nopattern	15	3359	453	335900	263350	-72550	0.13	0.78	594	466	-128
0045	2F	nopattern	16	1803	208	180300	159610	-20690	0.12	0.89	319	282	-37
0045	2F	nopattern	23	603	81	60300	34460	-25840	0.13	0.57	106	60	-46
0045	2F	nopattern	24	1638	208	163800	115220	-48580	0.13	0.70	289	203	-86
0045	2F	nopattern	25	2269	218	226900	151630	-75270	0.10	0.67	401	268	-133
0045	2F	nopattern	26	2175	163	217500	151800	-65700	0.07	0.70	384	268	-116
0045	2T	nopattern	12	7283	2267	728300	576390	-151910	0.31	0.79	1289	1020	-269
0045	2T	nopattern	13	4947	1279	494700	388360	-106340	0.26	0.79	875	687	-188
0045	2T	nopattern	14	4232	821	423200	324510	-98690	0.19	0.77	749	574	-175
0045	2T	nopattern	15	3226	361	322600	255330	-67270	0.11	0.79	570	451	-119
0045	2T	nopattern	16	1680	171	168000	151050	-16950	0.10	0.90	297	267	-30
0045	2T	nopattern	21	1079	144	107900	96140	-11760	0.13	0.89	190	170	-20
0045	2T	nopattern	23	521	43	52100	27340	-24760	0.08	0.52	92	48	-44
0045	2T	nopattern	24	1405	120	140500	93250	-47250	0.09	0.66	248	165	-83
0045	2T	nopattern	25	2071	154	207100	146740	-60360	0.07	0.71	366	259	-107
0045	2T	nopattern	26	1944	116	194400	138840	-55560	0.06	0.71	344	245	-99
0045	3F	nopattern	123	2006	591	200600	168030	-32570	0.29	0.84	355	297	-58
0045	3F	nopattern	124	3502	772	350200	261620	-88580	0.22	0.75	619	463	-156
0045	3F	nopattern	125	2164	330	216400	166570	-49830	0.15	0.77	383	294	-89
0045	3F	nopattern	126	2824	281	282400	222730	-59670	0.10	0.79	499	394	-105
0045	3F	nopattern	134	2178	451	217800	175640	-42160	0.21	0.81	385	310	-75
0045	3F	nopattern	135	1673	211	167300	128990	-38310	0.13	0.77	296	228	-68
0045	3F	nopattern	136	1761	170	176100	136380	-39720	0.10	0.77	311	241	-70
0045	3F	nopattern	145	1451	158	145100	109390	-35710	0.11	0.75	256	193	-63
0045	3F	nopattern	146	1445	117	144500	107890	-36610	0.08	0.75	255	190	-65
0045	3F	nopattern	156	1118	51	111800	78720	-33080	0.05	0.70	197	139	-58
0045	3F	nopattern	234	108	7	10800	11320	520	0.06	1.05	19	20	1
0045	3F	nopattern	235	107	5	10700	6600	-4100	0.05	0.62	18	11	-7
0045	3F	nopattern	236	143	5	14300	8520	-5780	0.03	0.60	25	15	-10
0045	3F	nopattern	245	159	6	15900	7710	-8190	0.04	0.48	28	13	-15
0045	3F	nopattern	246	206	9	20600	6580	-14020	0.04	0.32	36	11	-25
0045	3F	nopattern	256	294	12	29400	10430	-18970	0.04	0.35	52	18	-34
0045	3T	nopattern	123	1398	215	139800	124450	-15350	0.15	0.89	247	220	-27
0045	3T	nopattern	124	2384	257	238400	174430	-63970	0.11	0.73	421	308	-113
0045	3T	nopattern	125	1002	97	100200	76000	-24200	0.10	0.76	177	134	-43
0045	3T	nopattern	126	1861	107	186100	161990	-24110	0.06	0.87	329	286	-43
0045	3T	nopattern	132	293	34	29300	23100	-6200	0.12	0.79	51	40	-11
0045	3T	nopattern	134	1363	156	136300	126480	-9820	0.11	0.93	241	223	-18
0045	3T	nopattern	135	913	63	91300	66000	-25300	0.07	0.72	161	116	-45
0045	3T	nopattern	136	1219	61	121900	106160	-15740	0.05	0.87	215	187	-28
0045	3T	nopattern	142	199	16	19900	13040	-6860	0.08	0.66	35	23	-12
0045	3T	nopattern	143	117	5	11700	4100	-7600	0.04	0.35	20	7	-13
0045	3T	nopattern	145	654	35	65400	46520	-18880	0.05	0.71	115	82	-33
0045	3T	nopattern	146	979	39	97900	72820	-25080	0.04	0.74	173	128	-45
0045	3T	nopattern	152	52	3	5200	2870	-2330	0.06	0.55	9	5	-4
0045	3T	nopattern	153	151	4	15100	15890	790	0.03	1.05	26	28	2
0045	3T	nopattern	154	313	9	31300	31450	150	0.03	1.00	55	55	0
0045	3T	nopattern	156	911	21	91100	78240	-12860	0.02	0.86	161	138	-23
0045	3T	nopattern	162	61	1	6100	850	-5250	0.02	0.14	10	1	-9
0045	3T	nopattern	163	78	7	7800	17270	9470	0.09	2.21	13	30	17
0045	3T	nopattern	164	79	1	7900	2260	-5640	0.01	0.29	13	4	-9
0045	3T	nopattern	165	22	0	2200	0	-2200	0.00	0.00	3	0	-3
0045	3T	nopattern	213	61	6	6100	6290	190	0.10	1.03	10	11	1
0045	3T	nopattern	214	121	8	12100	16940	4840	0.07	1.40	21	29	8
0045	3T	nopattern	215	72	1	7200	1600	-5600	0.01	0.22	12	2	-10
0045	3T	nopattern	216	216	1	21600	3060	-18540	0.00	0.14	38	5	-33
0045	3T	nopattern	231	239	7	23900	13130	-10770	0.03	0.55	42	23	-19
0045	3T	nopattern	234	64	0	6400	0	-6400	0.00	0.00	11	0	-11
0045	3T	nopattern	235	47	0	4700	0	-4700	0.00	0.00	8	0	-8
0045	3T	nopattern	236	65	2	6500	13420	6920	0.03	2.06	11	23	12
0045	3T	nopattern	241	731	28	73100	48940	-24160	0.04	0.67	129	86	-43
0045	3T	nopattern	243	6	0	600	0	-600	0.00	0.00	1	0	-1
0045	3T	nopattern	245	84	0	8400	0	-8400	0.00	0.00	14	0	-14
0045	3T	nopattern	246	140	3	14000	4990	-9010	0.02	0.36	24	8	-16
0045	3T	nopattern	251	1018	25	101800	87840	-13960	0.02	0.86	180	155	-25
0045	3T	nopattern	253	33	1	3300	5800	2500	0.03	1.76	5	10	5
0045	3T	nopattern	254	33	0	3300	0	-3300	0.00	0.00	5	0	-5
0045	3T	nopattern	256	217	6	21700	10020	-11680	0.03	0.46	38	17	-21
0045	3T	nopattern	261	655	12	65500	71470	5970	0.02	1.09	115	126	11
0045	3T	nopattern	263	26	0	2600	0	-2600	0.00	0.00	4	0	-4
0045	3T	nopattern	264	24	0	2400	0	-2400	0.00	0.00	4	0	-4
0045	3T	nopattern	265	17	1	1700	6750	5050	0.06	3.97	3	11	8
0046	1T	1	1	3747	2550	374700	329810	-44890	0.68	0.88	663	583	-80
0046	1T	1	2	2183	734	218300	184690	-33610	0.34	0.85	386	326	-60
0046	1T	2	1	3217	2179	321700	288230	-33470	0.68	0.90	569	510	-59
0046	1T	2	2	2068	735	206800	179710	-27090	0.36	0.87	366	318	-48
0046	1T	3	1	3258	2339	325800	310240	-15560	0.72	0.95	576	549	-27
0046	1T	3	2	2101	718	210100	187360	-22740	0.34	0.89	371	331	-40
0046	1T	4	1	3381	2474	338100	315760	-22340	0.73	0.93	598	558	-40
0046	1T	4	2	1647	563	164700	148680	-16020	0.34	0.90	291	263	-28
0046	1T	5	1	3059	2208	305900	276760	-29140	0.72	0.90	541	489	-52
0046	1T	5	2	927	237	92700	72770	-19930	0.26	0.79	164	128	-36
0046	1T	6	1	221	152	22100	18700	-3400	0.69	0.85	39	33	-6
0046	1T	6	2	56	17	5600	4290	-1310	0.30	0.77	9	7	-2
0046	1T	7	1	4359	3101	435900	393160	-42740	0.71	0.90	771	695	-76
0046	1T	7	2	1631	419	163100	132350	-30750	0.26	0.81	288	234	-54
0046	2F	1	12	808	283	80800	57720	-23080	0.35	0.71	143	102	-41
0046	2F	1	13	977	304	97700	87830	-9870	0.31	0.90	172	155	-17
0046	2F	1	14	903	197	90300	67260	-23040	0.22	0.74	159	119	-40
0046	2F	1	15	742	100	74200	69250	-4950	0.13	0.93	131	122	-9
0046	2F	1	16	571	46	57100	49340	-7760	0.08	0.86	101	87	-14
0046	2F	1	23	139	26	13900	11170	-2730	0.19	0.80	24	19	-5
0046	2F	1	24	467	57	46700	32800	-13900	0.12	0.70	82	58	-24
0046	2F	1	25	602	57	60200	40150	-20050	0.09	0.67	106	71	-35
0046	2F	1	26	511	40	51100	32250	-18850	0.08	0.63	90	57	-33
0046	2F	2	12	834	293	83400	60660	-22740	0.35	0.73	147	107	-40
0046	2F	2	13	875	291	87500	74510	-12990	0.33	0.85	154	131	-23
0046	2F	2	14	775	183	77500	56870	-20630	0.24	0.73	137	100	-37
0046	2F	2	15	554	90	55400	52720	-2680	0.16	0.95	98	93	-5
0046	2F	2	16	351	49	35100	31150	-3950	0.14	0.89	62	55	-7
0046	2F	2	23	196	40	19600	19710	110	0.20	1.01	34	34	0
0046	2F	2	24	321	41	32100	17360	-14740	0.13	0.54	56	30	-26
0046	2F	2	25	461	44	46100	25150	-20950	0.10	0.55	81	44	-37
0046	2F	2	26	493	45	49300	32340	-16960	0.09	0.66	87	57	-30
0046	2F	3	12	916	367	91600	75420	-16180	0.40	0.82	162	133	-29
0046	2F	3	13	783	238	78300	58890	-19410	0.30	0.75	138	104	-34
0046	2F	3	14	827	178	82700	61100	-21600	0.22	0.74	146	108	-38
0046	2F	3	15	580	85	58000	50170	-7830	0.15	0.87	102	88	-14
0046	2F	3	16	317	37	31700	25760	-5940	0.12	0.81	56	45	-11
0046	2F	3	23	182	21	18200	8120	-10080	0.12	0.45	32	14	-18
0046	2F	3	24	354	51	35400	27960	-7440	0.14	0.79	62	49	-13
0046	2F	3	25	478	53	47800	33580	-14220	0.11	0.70	84	59	-25
0046	2F	3	26	395	32	39500	23630	-15870	0.08	0.60	69	41	-28
0046	2F	4	12	1019	413	101900	86230	-15670	0.41	0.85	180	152	-28
0046	2F	4	13	910	322	91000	80910	-10090	0.35	0.89	161	143	-18
0046	2F	4	14	814	184	81400	59470	-21930	0.23	0.73	144	105	-39
0046	2F	4	15	586	82	58600	46410	-12190	0.14	0.79	103	82	-21
0046	2F	4	16	254	34	25400	31350	5950	0.13	1.23	44	55	11
0046	2F	4	23	121	30	12100	9840	-2260	0.25	0.81	21	17	-4
0046	2F	4	24	283	45	28300	20710	-7590	0.16	0.73	50	36	-14
0046	2F	4	25	403	44	40300	28630	-11670	0.11	0.71	71	50	-21
0046	2F	4	26	285	18	28500	19380	-9120	0.06	0.68	50	34	-16
0046	2F	5	12	1090	468	109000	91110	-17890	0.43	0.84	192	161	-31
0046	2F	5	13	762	254	76200	69100	-7100	0.33	0.91	134	122	-12
0046	2F	5	14	711	155	71100	56320	-14780	0.22	0.79	125	99	-26
0046	2F	5	15	472	66	47200	34670	-12530	0.14	0.73	83	61	-22
0046	2F	5	16	191	23	19100	12120	-6980	0.12	0.63	33	21	-12
0046	2F	5	23	78	9	7800	4580	-3220	0.12	0.59	13	8	-5
0046	2F	5	24	149	11	14900	7680	-7220	0.07	0.52	26	13	-13
0046	2F	5	25	181	14	18100	8800	-9300	0.08	0.49	32	15	-17
0046	2F	5	26	134	4	13400	5860	-7540	0.03	0.44	23	10	-13
0046	2F	6	12	80	35	8000	6580	-1420	0.44	0.82	14	11	-3
0046	2F	6	13	64	24	6400	6230	-170	0.38	0.97	11	11	0
0046	2F	6	14	44	7	4400	2520	-1880	0.16	0.57	7	4	-3
0046	2F	6	15	33	6	3300	2770	-530	0.18	0.84	5	4	-1
0046	2F	6	16	17	3	1700	1980	280	0.18	1.16	3	3	0
0046	2F	6	23	3	0	300	0	-300	0.00	0.00	0	0	0
0046	2F	6	24	7	1	700	750	50	0.14	1.07	1	1	0
0046	2F	6	25	11	0	1100	0	-1100	0.00	0.00	1	0	-1
0046	2F	6	26	9	0	900	0	-900	0.00	0.00	1	0	-1
0046	2F	7	12	1470	555	147000	117630	-29370	0.38	0.80	260	208	-52
0046	2F	7	13	981	293	98100	78870	-19230	0.30	0.80	173	139	-34
0046	2F	7	14	962	218	96200	75500	-20700	0.23	0.78	170	133	-37
0046	2F	7	15	751	96	75100	53890	-21210	0.13	0.72	132	95	-37
0046	2F	7	16	452	47	45200	49160	3960	0.10	1.09	80	87	7
0046	2F	7	23	103	13	10300	4590	-5710	0.13	0.45	18	8	-10
0046	2F	7	24	233	26	23300	16780	-6520	0.11	0.72	41	29	-12
0046	2F	7	25	331	28	33100	25460	-7640	0.08	0.77	58	45	-13
0046	2F	7	26	297	18	29700	32000	2300	0.06	1.08	52	56	4
0046	2T	1	12	648	196	64800	45280	-19520	0.30	0.70	114	80	-34
0046	2T	1	13	903	213	90300	67840	-22460	0.24	0.75	159	120	-39
0046	2T	1	14	833	145	83300	59020	-24280	0.17	0.71	147	104	-43
0046	2T	1	15	697	74	69700	59880	-9820	0.11	0.86	123	105	-18
0046	2T	1	16	548	37	54800	44240	-10560	0.07	0.81	96	78	-18
0046	2T	1	21	160	16	16000	10290	-5710	0.10	0.64	28	18	-10
0046	2T	1	23	127	15	12700	9720	-2980	0.12	0.77	22	17	-5
0046	2T	1	24	409	31	40900	23920	-16980	0.08	0.58	72	42	-30
0046	2T	1	25	552	43	55200	44220	-10980	0.08	0.80	97	78	-19
0046	2T	1	26	452	29	45200	32100	-13100	0.06	0.71	80	56	-24
0046	2T	2	12	770	219	77000	54080	-22920	0.28	0.70	136	95	-41
0046	2T	2	13	805	199	80500	61380	-19120	0.25	0.76	142	108	-34
0046	2T	2	14	743	128	74300	50290	-24010	0.17	0.68	131	89	-42
0046	2T	2	15	527	72	52700	49180	-3520	0.14	0.93	93	87	-6
0046	2T	2	16	315	41	31500	32320	820	0.13	1.03	55	57	2
0046	2T	2	21	64	6	6400	4550	-1850	0.09	0.71	11	8	-3
0046	2T	2	23	179	21	17900	17490	-410	0.12	0.98	31	30	-1
0046	2T	2	24	264	26	26400	13370	-13030	0.10	0.51	46	23	-23
0046	2T	2	25	414	36	41400	26970	-14430	0.09	0.65	73	47	-26
0046	2T	2	26	440	30	44000	25710	-18290	0.07	0.58	77	45	-32
0046	2T	3	12	821	293	82100	71630	-10470	0.36	0.87	145	126	-19
0046	2T	3	13	733	181	73300	52690	-20610	0.25	0.72	129	93	-36
0046	2T	3	14	788	141	78800	57950	-20850	0.18	0.74	139	102	-37
0046	2T	3	15	556	68	55600	46120	-9480	0.12	0.83	98	81	-17
0046	2T	3	16	298	34	29800	31560	1760	0.11	1.06	52	55	3
0046	2T	3	21	95	7	9500	4510	-4990	0.07	0.47	16	7	-9
0046	2T	3	23	170	12	17000	9760	-7240	0.07	0.57	30	17	-13
0046	2T	3	24	296	31	29600	24440	-5160	0.10	0.83	52	43	-9
0046	2T	3	25	449	38	44900	33340	-11560	0.08	0.74	79	59	-20
0046	2T	3	26	351	20	35100	19390	-15710	0.06	0.55	62	34	-28
0046	2T	4	12	901	300	90100	71940	-18160	0.33	0.80	159	127	-32
0046	2T	4	13	850	263	85000	76120	-8880	0.31	0.90	150	134	-16
0046	2T	4	14	781	148	78100	54330	-23770	0.19	0.70	138	96	-42
0046	2T	4	15	566	73	56600	47950	-8650	0.13	0.85	100	84	-16
0046	2T	4	16	243	28	24300	28840	4540	0.12	1.19	43	51	8
0046	2T	4	21	118	14	11800	9650	-2150	0.12	0.82	20	17	-3
0046	2T	4	23	112	19	11200	10520	-680	0.17	0.94	19	18	-1
0046	2T	4	24	242	31	24200	19310	-4890	0.13	0.80	42	34	-8
0046	2T	4	25	373	26	37300	23690	-13610	0.07	0.64	66	41	-25
0046	2T	4	26	249	12	24900	11070	-13830	0.05	0.44	44	19	-25
0046	2T	5	12	1000	358	100000	82440	-17560	0.36	0.82	176	145	-31
0046	2T	5	13	705	206	70500	64770	-5730	0.29	0.92	124	114	-10
0046	2T	5	14	669	119	66900	49960	-16940	0.18	0.75	118	88	-30
0046	2T	5	15	445	52	44500	32930	-11570	0.12	0.74	78	58	-20
0046	2T	5	16	179	20	17900	12740	-5160	0.11	0.71	31	22	-9
0046	2T	5	21	90	10	9000	7120	-1880	0.11	0.79	15	12	-3
0046	2T	5	23	73	6	7300	5260	-2040	0.08	0.72	12	9	-3
0046	2T	5	24	124	7	12400	9180	-3220	0.06	0.74	21	16	-5
0046	2T	5	25	163	8	16300	7990	-8310	0.05	0.49	28	14	-14
0046	2T	5	26	119	4	11900	6760	-5140	0.03	0.57	21	11	-10
0046	2T	6	12	72	25	7200	4890	-2310	0.35	0.68	12	8	-4
0046	2T	6	13	58	16	5800	4890	-910	0.28	0.84	10	8	-2
0046	2T	6	14	38	5	3800	2160	-1640	0.13	0.57	6	3	-3
0046	2T	6	15	31	4	3100	2070	-1030	0.13	0.67	5	3	-2
0046	2T	6	16	15	3	1500	2610	1110	0.20	1.74	2	4	2
0046	2T	6	21	8	0	800	0	-800	0.00	0.00	1	0	-1
0046	2T	6	23	3	0	300	0	-300	0.00	0.00	0	0	0
0046	2T	6	24	5	1	500	1420	920	0.20	2.84	0	2	2
0046	2T	6	25	10	0	1000	0	-1000	0.00	0.00	1	0	-1
0046	2T	6	26	9	0	900	0	-900	0.00	0.00	1	0	-1
0046	2T	7	12	1312	406	131200	100540	-30660	0.31	0.77	232	177	-55
0046	2T	7	13	889	226	88900	66910	-21990	0.25	0.75	157	118	-39
0046	2T	7	14	898	165	89800	65980	-23820	0.18	0.73	158	116	-42
0046	2T	7	15	712	75	71200	51960	-19240	0.11	0.73	126	91	-35
0046	2T	7	16	418	40	41800	46370	4570	0.10	1.11	73	82	9
0046	2T	7	21	158	16	15800	13810	-1990	0.10	0.87	27	24	-3
0046	2T	7	23	92	7	9200	4780	-4420	0.08	0.52	16	8	-8
0046	2T	7	24	175	13	17500	11910	-5590	0.07	0.68	30	21	-9
0046	2T	7	25	291	17	29100	25770	-3330	0.06	0.89	51	45	-6
0046	2T	7	26	249	11	24900	27100	2200	0.04	1.09	44	47	3
0046	3F	1	123	134	47	13400	12870	-530	0.35	0.96	23	22	-1
0046	3F	1	124	401	91	40100	29040	-11060	0.23	0.72	70	51	-19
0046	3F	1	125	287	35	28700	21540	-7160	0.12	0.75	50	38	-12
0046	3F	1	126	371	36	37100	24530	-12570	0.10	0.66	65	43	-22
0046	3F	1	134	274	61	27400	19130	-8270	0.22	0.70	48	33	-15
0046	3F	1	135	207	36	20700	21880	1180	0.17	1.06	36	38	2
0046	3F	1	136	594	51	59400	51290	-8110	0.09	0.86	105	90	-15
0046	3F	1	145	227	31	22700	22360	-340	0.14	0.99	40	39	-1
0046	3F	1	146	485	41	48500	47310	-1190	0.08	0.98	85	83	-2
0046	3F	1	156	447	14	44700	21020	-23680	0.03	0.47	79	37	-42
0046	3F	1	234	25	2	2500	2570	70	0.08	1.03	4	4	0
0046	3F	1	235	25	2	2500	640	-1860	0.08	0.26	4	1	-3
0046	3F	1	236	44	2	4400	1580	-2820	0.05	0.36	7	2	-5
0046	3F	1	245	105	11	10500	12150	1650	0.10	1.16	18	21	3
0046	3F	1	246	144	11	14400	8350	-6050	0.08	0.58	25	14	-11
0046	3F	1	256	201	9	20100	9710	-10390	0.04	0.48	35	17	-18
0046	3F	2	123	218	60	21800	17340	-4460	0.28	0.80	38	30	-8
0046	3F	2	124	321	68	32100	22360	-9740	0.21	0.70	56	39	-17
0046	3F	2	125	290	49	29000	26640	-2360	0.17	0.92	51	47	-4
0046	3F	2	126	320	36	32000	23330	-8670	0.11	0.73	56	41	-15
0046	3F	2	134	310	68	31000	26770	-4230	0.22	0.86	54	47	-7
0046	3F	2	135	312	42	31200	19580	-11620	0.13	0.63	55	34	-21
0046	3F	2	136	371	33	37100	26160	-10940	0.09	0.71	65	46	-19
0046	3F	2	145	264	27	26400	15950	-10450	0.10	0.60	46	28	-18
0046	3F	2	146	310	30	31000	20530	-10470	0.10	0.66	54	36	-18
0046	3F	2	156	188	5	18800	8890	-9910	0.03	0.47	33	15	-18
0046	3F	2	234	25	3	2500	3000	500	0.12	1.20	4	5	1
0046	3F	2	235	36	3	3600	1480	-2120	0.08	0.41	6	2	-4
0046	3F	2	236	39	1	3900	1620	-2280	0.03	0.42	6	2	-4
0046	3F	2	245	53	4	5300	6590	1290	0.08	1.24	9	11	2
0046	3F	2	246	62	7	6200	4840	-1360	0.11	0.78	10	8	-2
0046	3F	2	256	78	7	7800	3840	-3960	0.09	0.49	13	6	-7
0046	3F	3	123	314	94	31400	26100	-5300	0.30	0.83	55	46	-9
0046	3F	3	124	359	82	35900	28200	-7700	0.23	0.79	63	49	-14
0046	3F	3	125	357	53	35700	26590	-9110	0.15	0.74	63	47	-16
0046	3F	3	126	316	37	31600	22010	-9590	0.12	0.70	55	38	-17
0046	3F	3	134	281	46	28100	18310	-9790	0.16	0.65	49	32	-17
0046	3F	3	135	279	34	27900	16260	-11640	0.12	0.58	49	28	-21
0046	3F	3	136	280	34	28000	22830	-5170	0.12	0.82	49	40	-9
0046	3F	3	145	268	28	26800	17850	-8950	0.10	0.67	47	31	-16
0046	3F	3	146	227	16	22700	16700	-6000	0.07	0.74	40	29	-11
0046	3F	3	156	146	4	14600	3250	-11350	0.03	0.22	25	5	-20
0046	3F	3	234	23	1	2300	1900	-400	0.04	0.83	4	3	-1
0046	3F	3	235	23	2	2300	1910	-390	0.09	0.83	4	3	-1
0046	3F	3	236	35	0	3500	0	-3500	0.00	0.00	6	0	-6
0046	3F	3	245	49	3	4900	4370	-530	0.06	0.89	8	7	-1
0046	3F	3	246	49	6	4900	9280	4380	0.12	1.89	8	16	8
0046	3F	3	256	66	2	6600	1070	-5530	0.03	0.16	11	1	-10
0046	3F	4	123	354	105	35400	28810	-6590	0.30	0.81	62	50	-12
0046	3F	4	124	314	65	31400	20860	-10540	0.21	0.66	55	36	-19
0046	3F	4	125	329	51	32900	30260	-2640	0.16	0.92	58	53	-5
0046	3F	4	126	349	39	34900	34000	-900	0.11	0.97	61	60	-1
0046	3F	4	134	285	50	28500	18470	-10030	0.18	0.65	50	32	-18
0046	3F	4	135	310	33	31000	18100	-12900	0.11	0.58	54	32	-22
0046	3F	4	136	299	31	29900	30470	570	0.10	1.02	52	53	1
0046	3F	4	145	222	28	22200	21100	-1100	0.13	0.95	39	37	-2
0046	3F	4	146	221	14	22100	14320	-7780	0.06	0.65	39	25	-14
0046	3F	4	156	213	3	21300	5890	-15410	0.01	0.28	37	10	-27
0046	3F	4	234	15	3	1500	2060	560	0.20	1.37	2	3	1
0046	3F	4	235	21	2	2100	1170	-930	0.10	0.56	3	2	-1
0046	3F	4	236	16	0	1600	0	-1600	0.00	0.00	2	0	-2
0046	3F	4	245	25	3	2500	2760	260	0.12	1.10	4	4	0
0046	3F	4	246	30	2	3000	2230	-770	0.07	0.74	5	3	-2
0046	3F	4	256	48	6	4800	10030	5230	0.13	2.09	8	17	9
0046	3F	5	123	226	81	22600	18900	-3700	0.36	0.84	40	33	-7
0046	3F	5	124	359	81	35900	25320	-10580	0.23	0.71	63	44	-19
0046	3F	5	125	296	40	29600	22720	-6880	0.14	0.77	52	40	-12
0046	3F	5	126	297	39	29700	31460	1760	0.13	1.06	52	55	3
0046	3F	5	134	211	38	21100	14100	-7000	0.18	0.67	37	24	-13
0046	3F	5	135	223	23	22300	17190	-5110	0.10	0.77	39	30	-9
0046	3F	5	136	194	15	19400	12650	-6750	0.08	0.65	34	22	-12
0046	3F	5	145	199	19	19900	14990	-4910	0.10	0.75	35	26	-9
0046	3F	5	146	153	12	15300	12630	-2670	0.08	0.83	27	22	-5
0046	3F	5	156	117	2	11700	1730	-9970	0.02	0.15	20	3	-17
0046	3F	5	234	14	1	1400	1650	250	0.07	1.18	2	2	0
0046	3F	5	235	10	0	1000	0	-1000	0.00	0.00	1	0	-1
0046	3F	5	236	15	0	1500	0	-1500	0.00	0.00	2	0	-2
0046	3F	5	245	16	0	1600	0	-1600	0.00	0.00	2	0	-2
0046	3F	5	246	12	0	1200	0	-1200	0.00	0.00	2	0	-2
0046	3F	5	256	18	1	1800	2090	290	0.06	1.16	3	3	0
0046	3F	6	123	14	2	1400	480	-920	0.14	0.34	2	0	-2
0046	3F	6	124	30	3	3000	770	-2230	0.10	0.26	5	1	-4
0046	3F	6	125	20	3	2000	1580	-420	0.15	0.79	3	2	-1
0046	3F	6	126	22	2	2200	1520	-680	0.09	0.69	3	2	-1
0046	3F	6	134	15	6	1500	1650	150	0.40	1.10	2	2	0
0046	3F	6	135	17	1	1700	710	-990	0.06	0.42	3	1	-2
0046	3F	6	136	16	2	1600	910	-690	0.13	0.57	2	1	-1
0046	3F	6	145	10	1	1000	1080	80	0.10	1.08	1	1	0
0046	3F	6	146	15	1	1500	600	-900	0.07	0.40	2	1	-1
0046	3F	6	156	7	0	700	0	-700	0.00	0.00	1	0	-1
0046	3F	6	235	1	0	100	0	-100	0.00	0.00	0	0	0
0046	3F	6	245	1	0	100	0	-100	0.00	0.00	0	0	0
0046	3F	6	246	1	0	100	0	-100	0.00	0.00	0	0	0
0046	3F	6	256	1	0	100	0	-100	0.00	0.00	0	0	0
0046	3F	7	123	283	81	28300	21470	-6830	0.29	0.76	50	38	-12
0046	3F	7	124	465	95	46500	36090	-10410	0.20	0.78	82	63	-19
0046	3F	7	125	465	76	46500	44740	-1760	0.16	0.96	82	79	-3
0046	3F	7	126	438	37	43800	27950	-15850	0.08	0.64	77	49	-28
0046	3F	7	134	302	45	30200	19110	-11090	0.15	0.63	53	33	-20
0046	3F	7	135	301	34	30100	26140	-3960	0.11	0.87	53	46	-7
0046	3F	7	136	266	24	26600	29380	2780	0.09	1.10	47	52	5
0046	3F	7	145	289	23	28900	15690	-13210	0.08	0.54	51	27	-24
0046	3F	7	146	302	31	30200	33450	3250	0.10	1.11	53	59	6
0046	3F	7	156	216	13	21600	27290	5690	0.06	1.26	38	48	10
0046	3F	7	234	17	1	1700	3510	1810	0.06	2.06	3	6	3
0046	3F	7	235	13	0	1300	0	-1300	0.00	0.00	2	0	-2
0046	3F	7	236	10	0	1000	0	-1000	0.00	0.00	1	0	-1
0046	3F	7	245	29	0	2900	0	-2900	0.00	0.00	5	0	-5
0046	3F	7	246	28	0	2800	0	-2800	0.00	0.00	4	0	-4
0046	3F	7	256	43	0	4300	0	-4300	0.00	0.00	7	0	-7
0046	3T	1	123	29	6	2900	2660	-240	0.21	0.92	5	4	-1
0046	3T	1	124	203	28	20300	14490	-5810	0.14	0.71	35	25	-10
0046	3T	1	125	85	6	8500	6040	-2460	0.07	0.71	15	10	-5
0046	3T	1	126	222	15	22200	21210	-990	0.07	0.96	39	37	-2
0046	3T	1	132	52	4	5200	2350	-2850	0.08	0.45	9	4	-5
0046	3T	1	134	169	17	16900	10990	-5910	0.10	0.65	29	19	-10
0046	3T	1	135	93	7	9300	6480	-2820	0.08	0.70	16	11	-5
0046	3T	1	136	519	24	51900	53040	1140	0.05	1.02	91	93	2
0046	3T	1	142	29	4	2900	5290	2390	0.14	1.82	5	9	4
0046	3T	1	143	3	0	300	0	-300	0.00	0.00	0	0	0
0046	3T	1	145	116	3	11600	8810	-2790	0.03	0.76	20	15	-5
0046	3T	1	146	443	16	44300	31130	-13170	0.04	0.70	78	55	-23
0046	3T	1	152	60	1	6000	910	-5090	0.02	0.15	10	1	-9
0046	3T	1	153	26	2	2600	7040	4440	0.08	2.71	4	12	8
0046	3T	1	154	51	1	5100	1800	-3300	0.02	0.35	9	3	-6
0046	3T	1	156	420	3	42000	9650	-32350	0.01	0.23	74	17	-57
0046	3T	1	162	15	1	1500	2790	1290	0.07	1.86	2	4	2
0046	3T	1	163	5	0	500	0	-500	0.00	0.00	0	0	0
0046	3T	1	164	11	1	1100	1540	440	0.09	1.40	1	2	1
0046	3T	1	165	1	0	100	0	-100	0.00	0.00	0	0	0
0046	3T	1	214	9	0	900	0	-900	0.00	0.00	1	0	-1
0046	3T	1	215	22	1	2200	1330	-870	0.05	0.60	3	2	-1
0046	3T	1	216	102	2	10200	3570	-6630	0.02	0.35	18	6	-12
0046	3T	1	231	49	1	4900	1540	-3360	0.02	0.31	8	2	-6
0046	3T	1	234	20	1	2000	8690	6690	0.05	4.35	3	15	12
0046	3T	1	235	15	1	1500	1230	-270	0.07	0.82	2	2	0
0046	3T	1	236	37	2	3700	2980	-720	0.05	0.81	6	5	-1
0046	3T	1	241	143	6	14300	13070	-1230	0.04	0.91	25	23	-2
0046	3T	1	245	89	3	8900	4440	-4460	0.03	0.50	15	7	-8
0046	3T	1	246	129	4	12900	7990	-4910	0.03	0.62	22	14	-8
0046	3T	1	251	107	4	10700	15370	4670	0.04	1.44	18	27	9
0046	3T	1	253	5	0	500	0	-500	0.00	0.00	0	0	0
0046	3T	1	254	11	0	1100	0	-1100	0.00	0.00	1	0	-1
0046	3T	1	256	185	2	18500	3800	-14700	0.01	0.21	32	6	-26
0046	3T	1	261	20	0	2000	0	-2000	0.00	0.00	3	0	-3
0046	3T	1	263	1	0	100	0	-100	0.00	0.00	0	0	0
0046	3T	1	264	2	0	200	0	-200	0.00	0.00	0	0	0
0046	3T	1	265	5	0	500	0	-500	0.00	0.00	0	0	0
0046	3T	2	123	102	10	10200	5150	-5050	0.10	0.50	18	9	-9
0046	3T	2	124	176	18	17600	9690	-7910	0.10	0.55	31	17	-14
0046	3T	2	125	155	11	15500	12160	-3340	0.07	0.78	27	21	-6
0046	3T	2	126	194	9	19400	13280	-6120	0.05	0.68	34	23	-11
0046	3T	2	132	32	5	3200	4230	1030	0.16	1.32	5	7	2
0046	3T	2	134	196	30	19600	26820	7220	0.15	1.37	34	47	13
0046	3T	2	135	192	8	19200	9030	-10170	0.04	0.47	33	15	-18
0046	3T	2	136	269	15	26900	24110	-2790	0.06	0.90	47	42	-5
0046	3T	2	142	28	0	2800	0	-2800	0.00	0.00	4	0	-4
0046	3T	2	143	12	0	1200	0	-1200	0.00	0.00	2	0	-2
0046	3T	2	145	179	11	17900	16180	-1720	0.06	0.90	31	28	-3
0046	3T	2	146	235	11	23500	13030	-10470	0.05	0.55	41	23	-18
0046	3T	2	152	21	1	2100	1380	-720	0.05	0.66	3	2	-1
0046	3T	2	153	33	0	3300	0	-3300	0.00	0.00	5	0	-5
0046	3T	2	154	23	1	2300	830	-1470	0.04	0.36	4	1	-3
0046	3T	2	156	162	2	16200	6650	-9550	0.01	0.41	28	11	-17
0046	3T	2	162	14	1	1400	870	-530	0.07	0.62	2	1	-1
0046	3T	2	163	20	0	2000	0	-2000	0.00	0.00	3	0	-3
0046	3T	2	164	16	1	1600	1110	-490	0.06	0.69	2	1	-1
0046	3T	2	165	10	0	1000	0	-1000	0.00	0.00	1	0	-1
0046	3T	2	213	2	0	200	0	-200	0.00	0.00	0	0	0
0046	3T	2	214	8	0	800	0	-800	0.00	0.00	1	0	-1
0046	3T	2	215	17	0	1700	0	-1700	0.00	0.00	3	0	-3
0046	3T	2	216	15	0	1500	0	-1500	0.00	0.00	2	0	-2
0046	3T	2	231	73	4	7300	9390	2090	0.05	1.29	12	16	4
0046	3T	2	234	21	0	2100	0	-2100	0.00	0.00	3	0	-3
0046	3T	2	235	34	1	3400	2790	-610	0.03	0.82	6	4	-2
0046	3T	2	236	34	0	3400	0	-3400	0.00	0.00	6	0	-6
0046	3T	2	241	91	1	9100	830	-8270	0.01	0.09	16	1	-15
0046	3T	2	245	43	0	4300	0	-4300	0.00	0.00	7	0	-7
0046	3T	2	246	50	1	5000	2470	-2530	0.02	0.49	8	4	-4
0046	3T	2	251	89	3	8900	6870	-2030	0.03	0.77	15	12	-3
0046	3T	2	254	4	0	400	0	-400	0.00	0.00	0	0	0
0046	3T	2	256	60	2	6000	2720	-3280	0.03	0.45	10	4	-6
0046	3T	2	261	83	0	8300	0	-8300	0.00	0.00	14	0	-14
0046	3T	2	264	5	0	500	0	-500	0.00	0.00	0	0	0
0046	3T	2	265	13	0	1300	0	-1300	0.00	0.00	2	0	-2
0046	3T	3	123	179	23	17900	13060	-4840	0.13	0.73	31	23	-8
0046	3T	3	124	158	24	15800	13500	-2300	0.15	0.85	27	23	-4
0046	3T	3	125	162	13	16200	11330	-4870	0.08	0.70	28	20	-8
0046	3T	3	126	192	17	19200	16330	-2870	0.09	0.85	33	28	-5
0046	3T	3	132	48	4	4800	2240	-2560	0.08	0.47	8	3	-5
0046	3T	3	134	149	11	14900	9500	-5400	0.07	0.64	26	16	-10
0046	3T	3	135	174	11	17400	11180	-6220	0.06	0.64	30	19	-11
0046	3T	3	136	206	13	20600	14710	-5890	0.06	0.71	36	26	-10
0046	3T	3	142	22	3	2200	2030	-170	0.14	0.92	3	3	0
0046	3T	3	143	19	1	1900	620	-1280	0.05	0.33	3	1	-2
0046	3T	3	145	194	10	19400	12710	-6690	0.05	0.66	34	22	-12
0046	3T	3	146	180	9	18000	15360	-2640	0.05	0.85	31	27	-4
0046	3T	3	152	22	0	2200	0	-2200	0.00	0.00	3	0	-3
0046	3T	3	153	31	3	3100	7300	4200	0.10	2.35	5	12	7
0046	3T	3	154	20	1	2000	4580	2580	0.05	2.29	3	8	5
0046	3T	3	156	123	2	12300	3370	-8930	0.02	0.27	21	5	-16
0046	3T	3	162	7	0	700	0	-700	0.00	0.00	1	0	-1
0046	3T	3	163	19	0	1900	0	-1900	0.00	0.00	3	0	-3
0046	3T	3	164	1	0	100	0	-100	0.00	0.00	0	0	0
0046	3T	3	165	4	0	400	0	-400	0.00	0.00	0	0	0
0046	3T	3	213	1	0	100	0	-100	0.00	0.00	0	0	0
0046	3T	3	214	4	0	400	0	-400	0.00	0.00	0	0	0
0046	3T	3	215	20	0	2000	0	-2000	0.00	0.00	3	0	-3
0046	3T	3	216	32	1	3200	1890	-1310	0.03	0.59	5	3	-2
0046	3T	3	231	81	2	8100	2000	-6100	0.02	0.25	14	3	-11
0046	3T	3	234	21	0	2100	0	-2100	0.00	0.00	3	0	-3
0046	3T	3	235	18	0	1800	0	-1800	0.00	0.00	3	0	-3
0046	3T	3	236	30	0	3000	0	-3000	0.00	0.00	5	0	-5
0046	3T	3	241	157	8	15700	13020	-2680	0.05	0.83	27	23	-4
0046	3T	3	245	32	0	3200	0	-3200	0.00	0.00	5	0	-5
0046	3T	3	246	38	3	3800	33300	29500	0.08	8.76	6	58	52
0046	3T	3	251	149	5	14900	14510	-390	0.03	0.97	26	25	-1
0046	3T	3	253	2	0	200	0	-200	0.00	0.00	0	0	0
0046	3T	3	254	8	0	800	0	-800	0.00	0.00	1	0	-1
0046	3T	3	256	59	0	5900	0	-5900	0.00	0.00	10	0	-10
0046	3T	3	261	79	1	7900	2180	-5720	0.01	0.28	13	3	-10
0046	3T	3	264	6	0	600	0	-600	0.00	0.00	1	0	-1
0046	3T	3	265	3	0	300	0	-300	0.00	0.00	0	0	0
0046	3T	4	123	262	37	26200	20470	-5730	0.14	0.78	46	36	-10
0046	3T	4	124	147	18	14700	10190	-4510	0.12	0.69	26	18	-8
0046	3T	4	125	154	14	15400	9990	-5410	0.09	0.65	27	17	-10
0046	3T	4	126	222	13	22200	18650	-3550	0.06	0.84	39	33	-6
0046	3T	4	132	23	4	2300	3250	950	0.17	1.41	4	5	1
0046	3T	4	134	141	23	14100	18800	4700	0.16	1.33	24	33	9
0046	3T	4	135	198	16	19800	16930	-2870	0.08	0.86	35	29	-6
0046	3T	4	136	234	14	23400	31380	7980	0.06	1.34	41	55	14
0046	3T	4	142	12	0	1200	0	-1200	0.00	0.00	2	0	-2
0046	3T	4	143	34	1	3400	570	-2830	0.03	0.17	6	1	-5
0046	3T	4	145	142	6	14200	8740	-5460	0.04	0.62	25	15	-10
0046	3T	4	146	190	7	19000	16330	-2670	0.04	0.86	33	28	-5
0046	3T	4	152	15	0	1500	0	-1500	0.00	0.00	2	0	-2
0046	3T	4	153	30	1	3000	1420	-1580	0.03	0.47	5	2	-3
0046	3T	4	154	14	0	1400	0	-1400	0.00	0.00	2	0	-2
0046	3T	4	156	188	2	18800	9150	-9650	0.01	0.49	33	16	-17
0046	3T	4	162	3	0	300	0	-300	0.00	0.00	0	0	0
0046	3T	4	163	16	3	1600	6190	4590	0.19	3.87	2	10	8
0046	3T	4	165	4	0	400	0	-400	0.00	0.00	0	0	0
0046	3T	4	213	5	1	500	830	330	0.20	1.66	0	1	1
0046	3T	4	214	11	0	1100	0	-1100	0.00	0.00	1	0	-1
0046	3T	4	215	22	0	2200	0	-2200	0.00	0.00	3	0	-3
0046	3T	4	216	32	0	3200	0	-3200	0.00	0.00	5	0	-5
0046	3T	4	231	61	3	6100	3660	-2440	0.05	0.60	10	6	-4
0046	3T	4	234	8	0	800	0	-800	0.00	0.00	1	0	-1
0046	3T	4	235	17	0	1700	0	-1700	0.00	0.00	3	0	-3
0046	3T	4	236	11	0	1100	0	-1100	0.00	0.00	1	0	-1
0046	3T	4	241	129	5	12900	9650	-3250	0.04	0.75	22	17	-5
0046	3T	4	243	1	0	100	0	-100	0.00	0.00	0	0	0
0046	3T	4	245	20	0	2000	0	-2000	0.00	0.00	3	0	-3
0046	3T	4	246	23	0	2300	0	-2300	0.00	0.00	4	0	-4
0046	3T	4	251	138	3	13800	6000	-7800	0.02	0.43	24	10	-14
0046	3T	4	253	1	0	100	0	-100	0.00	0.00	0	0	0
0046	3T	4	254	1	0	100	0	-100	0.00	0.00	0	0	0
0046	3T	4	256	39	2	3900	3210	-690	0.05	0.82	6	5	-1
0046	3T	4	261	87	3	8700	21250	12550	0.03	2.44	15	37	22
0046	3T	4	263	1	0	100	0	-100	0.00	0.00	0	0	0
0046	3T	4	264	2	0	200	0	-200	0.00	0.00	0	0	0
0046	3T	5	123	170	40	17000	18250	1250	0.24	1.07	30	32	2
0046	3T	5	124	270	29	27000	16940	-10060	0.11	0.63	47	29	-18
0046	3T	5	125	217	21	21700	22260	560	0.10	1.03	38	39	1
0046	3T	5	126	230	15	23000	21320	-1680	0.07	0.93	40	37	-3
0046	3T	5	132	19	3	1900	3870	1970	0.16	2.04	3	6	3
0046	3T	5	134	145	14	14500	10950	-3550	0.10	0.76	25	19	-6
0046	3T	5	135	160	13	16000	16270	270	0.08	1.02	28	28	0
0046	3T	5	136	156	7	15600	11340	-4260	0.04	0.73	27	20	-7
0046	3T	5	142	14	1	1400	1250	-150	0.07	0.89	2	2	0
0046	3T	5	143	11	0	1100	0	-1100	0.00	0.00	1	0	-1
0046	3T	5	145	140	7	14000	11800	-2200	0.05	0.84	24	20	-4
0046	3T	5	146	129	3	12900	3580	-9320	0.02	0.28	22	6	-16
0046	3T	5	152	6	0	600	0	-600	0.00	0.00	1	0	-1
0046	3T	5	153	12	1	1200	2130	930	0.08	1.78	2	3	1
0046	3T	5	154	29	1	2900	2790	-110	0.03	0.96	5	4	-1
0046	3T	5	156	102	1	10200	1120	-9080	0.01	0.11	18	1	-17
0046	3T	5	162	5	2	500	3360	2860	0.40	6.72	0	5	5
0046	3T	5	163	3	0	300	0	-300	0.00	0.00	0	0	0
0046	3T	5	164	5	0	500	0	-500	0.00	0.00	0	0	0
0046	3T	5	165	2	1	200	3880	3680	0.50	19.40	0	6	6
0046	3T	5	213	7	0	700	0	-700	0.00	0.00	1	0	-1
0046	3T	5	214	16	0	1600	0	-1600	0.00	0.00	2	0	-2
0046	3T	5	215	15	0	1500	0	-1500	0.00	0.00	2	0	-2
0046	3T	5	216	26	1	2600	3060	460	0.04	1.18	4	5	1
0046	3T	5	231	28	1	2800	2420	-380	0.04	0.86	4	4	0
0046	3T	5	234	12	0	1200	0	-1200	0.00	0.00	2	0	-2
0046	3T	5	235	8	0	800	0	-800	0.00	0.00	1	0	-1
0046	3T	5	236	11	0	1100	0	-1100	0.00	0.00	1	0	-1
0046	3T	5	241	50	2	5000	5690	690	0.04	1.14	8	10	2
0046	3T	5	245	13	0	1300	0	-1300	0.00	0.00	2	0	-2
0046	3T	5	246	7	0	700	0	-700	0.00	0.00	1	0	-1
0046	3T	5	251	53	0	5300	0	-5300	0.00	0.00	9	0	-9
0046	3T	5	253	2	0	200	0	-200	0.00	0.00	0	0	0
0046	3T	5	254	2	0	200	0	-200	0.00	0.00	0	0	0
0046	3T	5	256	16	0	1600	0	-1600	0.00	0.00	2	0	-2
0046	3T	5	261	32	0	3200	0	-3200	0.00	0.00	5	0	-5
0046	3T	5	263	1	0	100	0	-100	0.00	0.00	0	0	0
0046	3T	5	264	1	0	100	0	-100	0.00	0.00	0	0	0
0046	3T	6	123	13	0	1300	0	-1300	0.00	0.00	2	0	-2
0046	3T	6	124	23	2	2300	850	-1450	0.09	0.37	4	1	-3
0046	3T	6	125	12	3	1200	2380	1180	0.25	1.98	2	4	2
0046	3T	6	126	17	0	1700	0	-1700	0.00	0.00	3	0	-3
0046	3T	6	132	1	0	100	0	-100	0.00	0.00	0	0	0
0046	3T	6	134	10	2	1000	1580	580	0.20	1.58	1	2	1
0046	3T	6	135	14	0	1400	0	-1400	0.00	0.00	2	0	-2
0046	3T	6	136	14	0	1400	0	-1400	0.00	0.00	2	0	-2
0046	3T	6	142	2	0	200	0	-200	0.00	0.00	0	0	0
0046	3T	6	145	4	0	400	0	-400	0.00	0.00	0	0	0
0046	3T	6	146	12	0	1200	0	-1200	0.00	0.00	2	0	-2
0046	3T	6	152	3	0	300	0	-300	0.00	0.00	0	0	0
0046	3T	6	154	1	0	100	0	-100	0.00	0.00	0	0	0
0046	3T	6	156	6	0	600	0	-600	0.00	0.00	1	0	-1
0046	3T	6	214	3	0	300	0	-300	0.00	0.00	0	0	0
0046	3T	6	215	1	0	100	0	-100	0.00	0.00	0	0	0
0046	3T	6	216	3	0	300	0	-300	0.00	0.00	0	0	0
0046	3T	6	235	1	0	100	0	-100	0.00	0.00	0	0	0
0046	3T	6	241	1	0	100	0	-100	0.00	0.00	0	0	0
0046	3T	6	245	1	0	100	0	-100	0.00	0.00	0	0	0
0046	3T	6	246	1	0	100	0	-100	0.00	0.00	0	0	0
0046	3T	6	251	4	0	400	0	-400	0.00	0.00	0	0	0
0046	3T	6	261	2	0	200	0	-200	0.00	0.00	0	0	0
0046	3T	7	123	167	19	16700	9590	-7110	0.11	0.57	29	16	-13
0046	3T	7	124	286	22	28600	16400	-12200	0.08	0.57	50	29	-21
0046	3T	7	125	303	32	30300	34100	3800	0.11	1.13	53	60	7
0046	3T	7	126	287	12	28700	14230	-14470	0.04	0.50	50	25	-25
0046	3T	7	132	61	8	6100	6670	570	0.13	1.09	10	11	1
0046	3T	7	134	198	19	19800	12310	-7490	0.10	0.62	35	21	-14
0046	3T	7	135	182	12	18200	17890	-310	0.07	0.98	32	31	-1
0046	3T	7	136	173	6	17300	15190	-2110	0.03	0.88	30	26	-4
0046	3T	7	142	43	4	4300	4110	-190	0.09	0.96	7	7	0
0046	3T	7	143	11	1	1100	670	-430	0.09	0.61	1	1	0
0046	3T	7	145	185	7	18500	8810	-9690	0.04	0.48	32	15	-17
0046	3T	7	146	203	10	20300	25600	5300	0.05	1.26	35	45	10
0046	3T	7	152	25	0	2500	0	-2500	0.00	0.00	4	0	-4
0046	3T	7	153	22	1	2200	2580	380	0.05	1.17	3	4	1
0046	3T	7	154	22	0	2200	0	-2200	0.00	0.00	3	0	-3
0046	3T	7	156	197	4	19700	13820	-5880	0.02	0.70	34	24	-10
0046	3T	7	162	15	1	1500	5670	4170	0.07	3.78	2	10	8
0046	3T	7	163	7	0	700	0	-700	0.00	0.00	1	0	-1
0046	3T	7	164	20	1	2000	2490	490	0.05	1.25	3	4	1
0046	3T	7	165	3	0	300	0	-300	0.00	0.00	0	0	0
0046	3T	7	213	3	0	300	0	-300	0.00	0.00	0	0	0
0046	3T	7	214	11	0	1100	0	-1100	0.00	0.00	1	0	-1
0046	3T	7	215	23	0	2300	0	-2300	0.00	0.00	4	0	-4
0046	3T	7	216	46	0	4600	0	-4600	0.00	0.00	8	0	-8
0046	3T	7	231	48	1	4800	1650	-3150	0.02	0.34	8	2	-6
0046	3T	7	234	14	0	1400	0	-1400	0.00	0.00	2	0	-2
0046	3T	7	235	9	0	900	0	-900	0.00	0.00	1	0	-1
0046	3T	7	236	7	0	700	0	-700	0.00	0.00	1	0	-1
0046	3T	7	241	103	2	10300	3480	-6820	0.02	0.34	18	6	-12
0046	3T	7	245	21	0	2100	0	-2100	0.00	0.00	3	0	-3
0046	3T	7	246	14	0	1400	0	-1400	0.00	0.00	2	0	-2
0046	3T	7	251	108	2	10800	14580	3780	0.02	1.35	19	25	6
0046	3T	7	253	1	0	100	0	-100	0.00	0.00	0	0	0
0046	3T	7	254	1	0	100	0	-100	0.00	0.00	0	0	0
0046	3T	7	256	29	0	2900	0	-2900	0.00	0.00	5	0	-5
0046	3T	7	261	76	1	7600	11820	4220	0.01	1.56	13	20	7
0046	3T	7	264	4	0	400	0	-400	0.00	0.00	0	0	0
0046	3T	7	265	5	0	500	0	-500	0.00	0.00	0	0	0
0047	1T	01	1	1040	630	104000	101000	-3000	0.61	0.97	184	178	-6
0047	1T	01	2	581	140	58100	59430	1330	0.24	1.02	102	105	3
0047	1T	02	1	837	433	83700	68900	-14800	0.52	0.82	148	121	-27
0047	1T	02	2	542	133	54200	44030	-10170	0.25	0.81	95	77	-18
0047	1T	03	1	477	274	47700	49030	1330	0.57	1.03	84	86	2
0047	1T	03	2	448	116	44800	42980	-1820	0.26	0.96	79	76	-3
0047	1T	04	1	575	351	57500	54080	-3420	0.61	0.94	101	95	-6
0047	1T	04	2	469	122	46900	41560	-5340	0.26	0.89	83	73	-10
0047	1T	05	1	687	464	68700	67180	-1520	0.68	0.98	121	118	-3
0047	1T	05	2	534	138	53400	54650	1250	0.26	1.02	94	96	2
0047	1T	06	1	789	507	78900	71380	-7520	0.64	0.90	139	126	-13
0047	1T	06	2	511	133	51100	40680	-10420	0.26	0.80	90	72	-18
0047	1T	07	1	806	570	80600	80110	-490	0.71	0.99	142	141	-1
0047	1T	07	2	493	124	49300	43400	-5900	0.25	0.88	87	76	-11
0047	1T	08	1	858	616	85800	83590	-2210	0.72	0.97	151	147	-4
0047	1T	08	2	437	114	43700	42730	-970	0.26	0.98	77	75	-2
0047	1T	09	1	957	700	95700	92850	-2850	0.73	0.97	169	164	-5
0047	1T	09	2	520	177	52000	51250	-750	0.34	0.99	92	90	-2
0047	1T	10	1	917	667	91700	91600	-100	0.73	1.00	162	162	0
0047	1T	10	2	549	189	54900	46960	-7940	0.34	0.86	97	83	-14
0047	1T	11	1	930	501	93000	85890	-7110	0.54	0.92	164	152	-12
0047	1T	11	2	591	132	59100	50320	-8780	0.22	0.85	104	89	-15
0047	1T	12	1	1014	646	101400	92150	-9250	0.64	0.91	179	163	-16
0047	1T	12	2	585	128	58500	48610	-9890	0.22	0.83	103	86	-17
0047	1T	13	1	1003	713	100300	101070	770	0.71	1.01	177	178	1
0047	1T	13	2	518	131	51800	45330	-6470	0.25	0.88	91	80	-11
0047	1T	14	1	769	500	76900	74430	-2470	0.65	0.97	136	131	-5
0047	1T	14	2	544	150	54400	55810	1410	0.28	1.03	96	98	2
0047	1T	15	1	1016	664	101600	90970	-10630	0.65	0.90	179	161	-18
0047	1T	15	2	510	130	51000	45800	-5200	0.25	0.90	90	81	-9
0047	1T	16	1	1149	787	114900	107070	-7830	0.68	0.93	203	189	-14
0047	1T	16	2	514	121	51400	59180	7780	0.24	1.15	90	104	14
0047	1T	17	1	1080	763	108000	102060	-5940	0.71	0.95	191	180	-11
0047	1T	17	2	549	149	54900	49690	-5210	0.27	0.91	97	87	-10
0047	1T	18	1	1357	1048	135700	130360	-5340	0.77	0.96	240	230	-10
0047	1T	18	2	513	164	51300	63410	12110	0.32	1.24	90	112	22
0047	1T	19	1	1041	730	104100	98600	-5500	0.70	0.95	184	174	-10
0047	1T	19	2	439	125	43900	42360	-1540	0.28	0.96	77	74	-3
0047	1T	20	1	981	678	98100	92600	-5500	0.69	0.94	173	163	-10
0047	1T	20	2	462	132	46200	44170	-2030	0.29	0.96	81	78	-3
0047	1T	21	1	1288	930	128800	123080	-5720	0.72	0.96	227	217	-10
0047	1T	21	2	404	121	40400	37570	-2830	0.30	0.93	71	66	-5
0047	1T	22	1	993	593	99300	95530	-3770	0.60	0.96	175	169	-6
0047	1T	22	2	563	119	56300	48200	-8100	0.21	0.86	99	85	-14
0047	1T	23	1	961	621	96100	100260	4160	0.65	1.04	170	177	7
0047	1T	23	2	612	141	61200	48950	-12250	0.23	0.80	108	86	-22
0047	1T	24	1	1434	1095	143400	141580	-1820	0.76	0.99	253	250	-3
0047	1T	24	2	422	103	42200	36420	-5780	0.24	0.86	74	64	-10
0047	2F	01	12	432	124	43200	37230	-5970	0.29	0.86	76	65	-11
0047	2F	01	13	195	44	19500	18110	-1390	0.23	0.93	34	32	-2
0047	2F	01	14	171	22	17100	11010	-6090	0.13	0.64	30	19	-11
0047	2F	01	15	208	30	20800	15790	-5010	0.14	0.76	36	27	-9
0047	2F	01	16	109	9	10900	5310	-5590	0.08	0.49	19	9	-10
0047	2F	01	23	111	16	11100	12900	1800	0.14	1.16	19	22	3
0047	2F	01	24	76	2	7600	2780	-4820	0.03	0.37	13	4	-9
0047	2F	01	25	89	5	8900	9080	180	0.06	1.02	15	16	1
0047	2F	01	26	61	1	6100	790	-5310	0.02	0.13	10	1	-9
0047	2F	02	12	331	81	33100	27140	-5960	0.24	0.82	58	48	-10
0047	2F	02	13	161	32	16100	12080	-4020	0.20	0.75	28	21	-7
0047	2F	02	14	131	23	13100	12060	-1040	0.18	0.92	23	21	-2
0047	2F	02	15	147	18	14700	13860	-840	0.12	0.94	26	24	-2
0047	2F	02	16	142	12	14200	9460	-4740	0.08	0.67	25	16	-9
0047	2F	02	23	75	10	7500	5870	-1630	0.13	0.78	13	10	-3
0047	2F	02	24	67	6	6700	3620	-3080	0.09	0.54	11	6	-5
0047	2F	02	25	103	8	10300	5390	-4910	0.08	0.52	18	9	-9
0047	2F	02	26	103	4	10300	4880	-5420	0.04	0.47	18	8	-10
0047	2F	03	12	203	68	20300	19840	-460	0.33	0.98	35	35	0
0047	2F	03	13	93	28	9300	9530	230	0.30	1.02	16	16	0
0047	2F	03	14	91	16	9100	7890	-1210	0.18	0.87	16	13	-3
0047	2F	03	15	93	11	9300	5550	-3750	0.12	0.60	16	9	-7
0047	2F	03	16	75	7	7500	8590	1090	0.09	1.15	13	15	2
0047	2F	03	23	62	10	6200	4820	-1380	0.16	0.78	10	8	-2
0047	2F	03	24	57	5	5700	6360	660	0.09	1.12	10	11	1
0047	2F	03	25	81	6	8100	4050	-4050	0.07	0.50	14	7	-7
0047	2F	03	26	88	4	8800	11380	2580	0.05	1.29	15	20	5
0047	2F	04	12	242	70	24200	21090	-3110	0.29	0.87	42	37	-5
0047	2F	04	13	91	34	9100	11450	2350	0.37	1.26	16	20	4
0047	2F	04	14	105	18	10500	8770	-1730	0.17	0.84	18	15	-3
0047	2F	04	15	100	10	10000	6400	-3600	0.10	0.64	17	11	-6
0047	2F	04	16	112	11	11200	5170	-6030	0.10	0.46	19	9	-10
0047	2F	04	23	69	12	6900	8450	1550	0.17	1.22	12	14	2
0047	2F	04	24	69	6	6900	4700	-2200	0.09	0.68	12	8	-4
0047	2F	04	25	66	3	6600	1390	-5210	0.05	0.21	11	2	-9
0047	2F	04	26	85	6	8500	5870	-2630	0.07	0.69	15	10	-5
0047	2F	05	12	297	97	29700	28910	-790	0.33	0.97	52	51	-1
0047	2F	05	13	129	37	12900	12560	-340	0.29	0.97	22	22	0
0047	2F	05	14	130	33	13000	11510	-1490	0.25	0.89	23	20	-3
0047	2F	05	15	114	18	11400	9280	-2120	0.16	0.81	20	16	-4
0047	2F	05	16	106	11	10600	13240	2640	0.10	1.25	18	23	5
0047	2F	05	23	93	12	9300	7700	-1600	0.13	0.83	16	13	-3
0047	2F	05	24	67	6	6700	3450	-3250	0.09	0.51	11	6	-5
0047	2F	05	25	80	3	8000	2100	-5900	0.04	0.26	14	3	-11
0047	2F	05	26	82	6	8200	2780	-5420	0.07	0.34	14	4	-10
0047	2F	06	12	271	87	27100	22060	-5040	0.32	0.81	47	39	-8
0047	2F	06	13	170	49	17000	15630	-1370	0.29	0.92	30	27	-3
0047	2F	06	14	135	30	13500	9800	-3700	0.22	0.73	23	17	-6
0047	2F	06	15	148	28	14800	14420	-380	0.19	0.97	26	25	-1
0047	2F	06	16	136	8	13600	8420	-5180	0.06	0.62	24	14	-10
0047	2F	06	23	75	11	7500	9080	1580	0.15	1.21	13	16	3
0047	2F	06	24	75	11	7500	9150	1650	0.15	1.22	13	16	3
0047	2F	06	25	71	6	7100	8270	1170	0.08	1.16	12	14	2
0047	2F	06	26	103	6	10300	3420	-6880	0.06	0.33	18	6	-12
0047	2F	07	12	288	83	28800	23810	-4990	0.29	0.83	50	42	-8
0047	2F	07	13	173	58	17300	17380	80	0.34	1.00	30	30	0
0047	2F	07	14	160	33	16000	8980	-7020	0.21	0.56	28	15	-13
0047	2F	07	15	162	29	16200	18270	2070	0.18	1.13	28	32	4
0047	2F	07	16	93	10	9300	9020	-280	0.11	0.97	16	15	-1
0047	2F	07	23	81	8	8100	4030	-4070	0.10	0.50	14	7	-7
0047	2F	07	24	59	7	5900	3560	-2340	0.12	0.60	10	6	-4
0047	2F	07	25	72	7	7200	9260	2060	0.10	1.29	12	16	4
0047	2F	07	26	101	9	10100	17250	7150	0.09	1.71	17	30	13
0047	2F	08	12	301	113	30100	29400	-700	0.38	0.98	53	52	-1
0047	2F	08	13	179	49	17900	14740	-3160	0.27	0.82	31	26	-5
0047	2F	08	14	173	36	17300	11740	-5560	0.21	0.68	30	20	-10
0047	2F	08	15	146	18	14600	11830	-2770	0.12	0.81	25	20	-5
0047	2F	08	16	117	16	11700	11420	-280	0.14	0.98	20	20	0
0047	2F	08	23	49	5	4900	2520	-2380	0.10	0.51	8	4	-4
0047	2F	08	24	52	8	5200	7130	1930	0.15	1.37	9	12	3
0047	2F	08	25	76	10	7600	10390	2790	0.13	1.37	13	18	5
0047	2F	08	26	90	5	9000	4000	-5000	0.06	0.44	15	7	-8
0047	2F	09	12	366	143	36600	32570	-4030	0.39	0.89	64	57	-7
0047	2F	09	13	206	69	20600	20640	40	0.33	1.00	36	36	0
0047	2F	09	14	187	40	18700	15650	-3050	0.21	0.84	33	27	-6
0047	2F	09	15	149	20	14900	14850	-50	0.13	1.00	26	26	0
0047	2F	09	16	116	12	11600	14160	2560	0.10	1.22	20	25	5
0047	2F	09	23	75	4	7500	3190	-4310	0.05	0.43	13	5	-8
0047	2F	09	24	55	9	5500	7410	1910	0.16	1.35	9	13	4
0047	2F	09	25	94	7	9400	5710	-3690	0.07	0.61	16	10	-6
0047	2F	09	26	82	9	8200	9070	870	0.11	1.11	14	16	2
0047	2F	10	12	406	164	40600	36020	-4580	0.40	0.89	71	63	-8
0047	2F	10	13	218	58	21800	14970	-6830	0.27	0.69	38	26	-12
0047	2F	10	14	176	43	17600	17570	-30	0.24	1.00	31	31	0
0047	2F	10	15	124	13	12400	10200	-2200	0.10	0.82	21	18	-3
0047	2F	10	16	86	8	8600	9920	1320	0.09	1.15	15	17	2
0047	2F	10	23	69	10	6900	5010	-1890	0.14	0.73	12	8	-4
0047	2F	10	24	72	13	7200	7650	450	0.18	1.06	12	13	1
0047	2F	10	25	68	11	6800	11570	4770	0.16	1.70	12	20	8
0047	2F	10	26	86	13	8600	9130	530	0.15	1.06	15	16	1
0047	2F	11	12	431	138	43100	41130	-1970	0.32	0.95	76	72	-4
0047	2F	11	13	176	30	17600	13640	-3960	0.17	0.78	31	24	-7
0047	2F	11	14	190	31	19000	13110	-5890	0.16	0.69	33	23	-10
0047	2F	11	15	131	11	13100	10890	-2210	0.08	0.83	23	19	-4
0047	2F	11	16	86	3	8600	2720	-5880	0.03	0.32	15	4	-11
0047	2F	11	23	94	4	9400	4990	-4410	0.04	0.53	16	8	-8
0047	2F	11	24	95	2	9500	1590	-7910	0.02	0.17	16	2	-14
0047	2F	11	25	92	5	9200	7220	-1980	0.05	0.78	16	12	-4
0047	2F	11	26	56	2	5600	1120	-4480	0.04	0.20	9	1	-8
0047	2F	12	12	389	122	38900	31720	-7180	0.31	0.82	68	56	-12
0047	2F	12	13	216	54	21600	14660	-6940	0.25	0.68	38	25	-13
0047	2F	12	14	145	24	14500	10380	-4120	0.17	0.72	25	18	-7
0047	2F	12	15	154	13	15400	8520	-6880	0.08	0.55	27	15	-12
0047	2F	12	16	155	14	15500	9030	-6470	0.09	0.58	27	15	-12
0047	2F	12	23	114	8	11400	5240	-6160	0.07	0.46	20	9	-11
0047	2F	12	24	103	7	10300	11570	1270	0.07	1.12	18	20	2
0047	2F	12	25	80	3	8000	6590	-1410	0.04	0.82	14	11	-3
0047	2F	12	26	87	1	8700	5510	-3190	0.01	0.63	15	9	-6
0047	2F	13	12	374	139	37400	37860	460	0.37	1.01	66	67	1
0047	2F	13	13	206	56	20600	18170	-2430	0.27	0.88	36	32	-4
0047	2F	13	14	213	51	21300	17740	-3560	0.24	0.83	37	31	-6
0047	2F	13	15	121	19	12100	8620	-3480	0.16	0.71	21	15	-6
0047	2F	13	16	144	22	14400	17200	2800	0.15	1.19	25	30	5
0047	2F	13	23	97	8	9700	6960	-2740	0.08	0.72	17	12	-5
0047	2F	13	24	86	4	8600	2320	-6280	0.05	0.27	15	4	-11
0047	2F	13	25	67	7	6700	9110	2410	0.10	1.36	11	16	5
0047	2F	13	26	81	5	8100	7650	-450	0.06	0.94	14	13	-1
0047	2F	14	12	291	96	29100	27130	-1970	0.33	0.93	51	48	-3
0047	2F	14	13	154	40	15400	13180	-2220	0.26	0.86	27	23	-4
0047	2F	14	14	172	44	17200	15410	-1790	0.26	0.90	30	27	-3
0047	2F	14	15	123	12	12300	7040	-5260	0.10	0.57	21	12	-9
0047	2F	14	16	103	5	10300	2060	-8240	0.05	0.20	18	3	-15
0047	2F	14	23	93	12	9300	8300	-1000	0.13	0.89	16	14	-2
0047	2F	14	24	81	7	8100	3510	-4590	0.09	0.43	14	6	-8
0047	2F	14	25	95	4	9500	3760	-5740	0.04	0.40	16	6	-10
0047	2F	14	26	62	5	6200	10760	4560	0.08	1.74	10	19	9
0047	2F	15	12	372	121	37200	28450	-8750	0.33	0.76	65	50	-15
0047	2F	15	13	178	59	17800	19330	1530	0.33	1.09	31	34	3
0047	2F	15	14	237	66	23700	25440	1740	0.28	1.07	41	45	4
0047	2F	15	15	156	15	15600	9500	-6100	0.10	0.61	27	16	-11
0047	2F	15	16	119	12	11900	13070	1170	0.10	1.10	21	23	2
0047	2F	15	23	65	6	6500	3440	-3060	0.09	0.53	11	6	-5
0047	2F	15	24	77	9	7700	7380	-320	0.12	0.96	13	13	0
0047	2F	15	25	81	3	8100	6340	-1760	0.04	0.78	14	11	-3
0047	2F	15	26	90	3	9000	5200	-3800	0.03	0.58	15	9	-6
0047	2F	16	12	440	164	44000	42860	-1140	0.37	0.97	77	75	-2
0047	2F	16	13	245	48	24500	15250	-9250	0.20	0.62	43	26	-17
0047	2F	16	14	252	75	25200	21020	-4180	0.30	0.83	44	37	-7
0047	2F	16	15	146	15	14600	8710	-5890	0.10	0.60	25	15	-10
0047	2F	16	16	119	5	11900	4380	-7520	0.04	0.37	21	7	-14
0047	2F	16	23	80	5	8000	4450	-3550	0.06	0.56	14	7	-7
0047	2F	16	24	74	5	7400	5370	-2030	0.07	0.73	13	9	-4
0047	2F	16	25	74	8	7400	5930	-1470	0.11	0.80	13	10	-3
0047	2F	16	26	81	4	8100	2080	-6020	0.05	0.26	14	3	-11
0047	2F	17	12	395	133	39500	28890	-10610	0.34	0.73	69	51	-18
0047	2F	17	13	236	81	23600	23540	-60	0.34	1.00	41	41	0
0047	2F	17	14	248	55	24800	20670	-4130	0.22	0.83	43	36	-7
0047	2F	17	15	140	24	14000	13770	-230	0.17	0.98	24	24	0
0047	2F	17	16	125	7	12500	5910	-6590	0.06	0.47	22	10	-12
0047	2F	17	23	105	10	10500	9730	-770	0.10	0.93	18	17	-1
0047	2F	17	24	80	10	8000	6820	-1180	0.13	0.85	14	12	-2
0047	2F	17	25	80	10	8000	16110	8110	0.13	2.01	14	28	14
0047	2F	17	26	79	4	7900	5160	-2740	0.05	0.65	13	9	-4
0047	2F	18	12	504	211	50400	46290	-4110	0.42	0.92	89	81	-8
0047	2F	18	13	293	83	29300	25410	-3890	0.28	0.87	51	44	-7
0047	2F	18	14	279	67	27900	22590	-5310	0.24	0.81	49	39	-10
0047	2F	18	15	223	47	22300	26130	3830	0.21	1.17	39	46	7
0047	2F	18	16	111	15	11100	14600	3500	0.14	1.32	19	25	6
0047	2F	18	23	63	5	6300	4630	-1670	0.08	0.73	11	8	-3
0047	2F	18	24	89	11	8900	9270	370	0.12	1.04	15	16	1
0047	2F	18	25	72	8	7200	6580	-620	0.11	0.91	12	11	-1
0047	2F	18	26	92	7	9200	3880	-5320	0.08	0.42	16	6	-10
0047	2F	19	12	362	126	36200	33250	-2950	0.35	0.92	64	58	-6
0047	2F	19	13	219	70	21900	20360	-1540	0.32	0.93	38	36	-2
0047	2F	19	14	272	82	27200	23770	-3430	0.30	0.87	48	42	-6
0047	2F	19	15	124	14	12400	10810	-1590	0.11	0.87	21	19	-2
0047	2F	19	16	98	12	9800	7550	-2250	0.12	0.77	17	13	-4
0047	2F	19	23	101	8	10100	4920	-5180	0.08	0.49	17	8	-9
0047	2F	19	24	66	3	6600	5770	-830	0.05	0.87	11	10	-1
0047	2F	19	25	45	0	4500	0	-4500	0.00	0.00	7	0	-7
0047	2F	19	26	63	6	6300	6310	10	0.10	1.00	11	11	0
0047	2F	20	12	392	159	39200	37250	-1950	0.41	0.95	69	65	-4
0047	2F	20	13	204	60	20400	16350	-4050	0.29	0.80	36	28	-8
0047	2F	20	14	217	50	21700	15910	-5790	0.23	0.73	38	28	-10
0047	2F	20	15	134	15	13400	8530	-4870	0.11	0.64	23	15	-8
0047	2F	20	16	108	13	10800	8960	-1840	0.12	0.83	19	15	-4
0047	2F	20	23	53	2	5300	1670	-3630	0.04	0.32	9	2	-7
0047	2F	20	24	84	8	8400	4220	-4180	0.10	0.50	14	7	-7
0047	2F	20	25	65	3	6500	2920	-3580	0.05	0.45	11	5	-6
0047	2F	20	26	58	4	5800	4640	-1160	0.07	0.80	10	8	-2
0047	2F	21	12	437	160	43700	37500	-6200	0.37	0.86	77	66	-11
0047	2F	21	13	310	103	31000	29390	-1610	0.33	0.95	54	52	-2
0047	2F	21	14	272	74	27200	21290	-5910	0.27	0.78	48	37	-11
0047	2F	21	15	216	41	21600	24540	2940	0.19	1.14	38	43	5
0047	2F	21	16	102	8	10200	10600	400	0.08	1.04	18	18	0
0047	2F	21	23	63	6	6300	2870	-3430	0.10	0.46	11	5	-6
0047	2F	21	24	51	5	5100	5950	850	0.10	1.17	9	10	1
0047	2F	21	25	58	2	5800	710	-5090	0.03	0.12	10	1	-9
0047	2F	21	26	54	3	5400	4360	-1040	0.06	0.81	9	7	-2
0047	2F	22	12	418	120	41800	35620	-6180	0.29	0.85	73	63	-10
0047	2F	22	13	238	63	23800	19250	-4550	0.26	0.81	42	34	-8
0047	2F	22	14	184	24	18400	12590	-5810	0.13	0.68	32	22	-10
0047	2F	22	15	130	7	13000	16950	3950	0.05	1.30	23	30	7
0047	2F	22	16	93	4	9300	3590	-5710	0.04	0.39	16	6	-10
0047	2F	22	23	106	10	10600	5980	-4620	0.09	0.56	18	10	-8
0047	2F	22	24	101	7	10100	4710	-5390	0.07	0.47	17	8	-9
0047	2F	22	25	74	4	7400	2910	-4490	0.05	0.39	13	5	-8
0047	2F	22	26	62	0	6200	0	-6200	0.00	0.00	10	0	-10
0047	2F	23	12	411	134	41100	35260	-5840	0.33	0.86	72	62	-10
0047	2F	23	13	222	55	22200	19830	-2370	0.25	0.89	39	35	-4
0047	2F	23	14	178	40	17800	22870	5070	0.22	1.28	31	40	9
0047	2F	23	15	122	12	12200	5680	-6520	0.10	0.47	21	10	-11
0047	2F	23	16	101	5	10100	9860	-240	0.05	0.98	17	17	0
0047	2F	23	23	117	13	11700	9110	-2590	0.11	0.78	20	16	-4
0047	2F	23	24	107	10	10700	6500	-4200	0.09	0.61	18	11	-7
0047	2F	23	25	90	2	9000	2210	-6790	0.02	0.25	15	3	-12
0047	2F	23	26	68	1	6800	3830	-2970	0.01	0.56	12	6	-6
0047	2F	24	12	501	172	50100	41000	-9100	0.34	0.82	88	72	-16
0047	2F	24	13	313	104	31300	34610	3310	0.33	1.11	55	61	6
0047	2F	24	14	272	56	27200	21420	-5780	0.21	0.79	48	37	-11
0047	2F	24	15	201	22	20100	13220	-6880	0.11	0.66	35	23	-12
0047	2F	24	16	174	22	17400	21120	3720	0.13	1.21	30	37	7
0047	2F	24	23	68	6	6800	2500	-4300	0.09	0.37	12	4	-8
0047	2F	24	24	70	8	7000	12670	5670	0.11	1.81	12	22	10
0047	2F	24	25	56	5	5600	3900	-1700	0.09	0.70	9	6	-3
0047	2F	24	26	57	5	5700	3210	-2490	0.09	0.56	10	5	-5
0047	2T	01	12	264	63	26400	21250	-5150	0.24	0.80	46	37	-9
0047	2T	01	13	195	37	19500	21710	2210	0.19	1.11	34	38	4
0047	2T	01	14	171	15	17100	7620	-9480	0.09	0.45	30	13	-17
0047	2T	01	15	208	25	20800	15380	-5420	0.12	0.74	36	27	-9
0047	2T	01	16	109	7	10900	5830	-5070	0.06	0.53	19	10	-9
0047	2T	01	21	168	14	16800	19070	2270	0.08	1.14	29	33	4
0047	2T	01	23	111	7	11100	13200	2100	0.06	1.19	19	23	4
0047	2T	01	24	76	1	7600	4120	-3480	0.01	0.54	13	7	-6
0047	2T	01	25	89	4	8900	12610	3710	0.04	1.42	15	22	7
0047	2T	01	26	61	0	6100	0	-6100	0.00	0.00	10	0	-10
0047	2T	02	12	202	49	20200	21610	1410	0.24	1.07	35	38	3
0047	2T	02	13	161	24	16100	9810	-6290	0.15	0.61	28	17	-11
0047	2T	02	14	131	16	13100	10500	-2600	0.12	0.80	23	18	-5
0047	2T	02	15	147	13	14700	13270	-1430	0.09	0.90	26	23	-3
0047	2T	02	16	142	10	14200	10440	-3760	0.07	0.74	25	18	-7
0047	2T	02	21	129	8	12900	4850	-8050	0.06	0.38	22	8	-14
0047	2T	02	23	75	6	7500	7100	-400	0.08	0.95	13	12	-1
0047	2T	02	24	67	4	6700	4510	-2190	0.06	0.67	11	7	-4
0047	2T	02	25	103	6	10300	4460	-5840	0.06	0.43	18	7	-11
0047	2T	02	26	103	2	10300	2450	-7850	0.02	0.24	18	4	-14
0047	2T	03	12	98	20	9800	8060	-1740	0.20	0.82	17	14	-3
0047	2T	03	13	93	20	9300	8530	-770	0.22	0.92	16	15	-1
0047	2T	03	14	91	13	9100	11900	2800	0.14	1.31	16	21	5
0047	2T	03	15	93	8	9300	5600	-3700	0.09	0.60	16	9	-7
0047	2T	03	16	75	4	7500	5490	-2010	0.05	0.73	13	9	-4
0047	2T	03	21	105	13	10500	10750	250	0.12	1.02	18	19	1
0047	2T	03	23	62	4	6200	2560	-3640	0.06	0.41	10	4	-6
0047	2T	03	24	57	4	5700	9190	3490	0.07	1.61	10	16	6
0047	2T	03	25	81	4	8100	4570	-3530	0.05	0.56	14	8	-6
0047	2T	03	26	88	2	8800	12050	3250	0.02	1.37	15	21	6
0047	2T	04	12	130	24	13000	8890	-4110	0.18	0.68	23	15	-8
0047	2T	04	13	91	28	9100	10570	1470	0.31	1.16	16	18	2
0047	2T	04	14	105	15	10500	8200	-2300	0.14	0.78	18	14	-4
0047	2T	04	15	100	6	10000	7600	-2400	0.06	0.76	17	13	-4
0047	2T	04	16	112	7	11200	6590	-4610	0.06	0.59	19	11	-8
0047	2T	04	21	112	17	11200	12600	1400	0.15	1.13	19	22	3
0047	2T	04	23	69	5	6900	13830	6930	0.07	2.00	12	24	12
0047	2T	04	24	69	4	6900	3260	-3640	0.06	0.47	12	5	-7
0047	2T	04	25	66	1	6600	820	-5780	0.02	0.12	11	1	-10
0047	2T	04	26	85	5	8500	7940	-560	0.06	0.93	15	14	-1
0047	2T	05	12	164	45	16400	16260	-140	0.27	0.99	29	28	-1
0047	2T	05	13	129	31	12900	12150	-750	0.24	0.94	22	21	-1
0047	2T	05	14	130	28	13000	11170	-1830	0.22	0.86	23	19	-4
0047	2T	05	15	114	12	11400	7500	-3900	0.11	0.66	20	13	-7
0047	2T	05	16	106	10	10600	16610	6010	0.09	1.57	18	29	11
0047	2T	05	21	133	19	13300	17550	4250	0.14	1.32	23	31	8
0047	2T	05	23	93	6	9300	8590	-710	0.06	0.92	16	15	-1
0047	2T	05	24	67	6	6700	4060	-2640	0.09	0.61	11	7	-4
0047	2T	05	25	80	3	8000	2590	-5410	0.04	0.32	14	4	-10
0047	2T	05	26	82	3	8200	3070	-5130	0.04	0.37	14	5	-9
0047	2T	06	12	163	48	16300	15960	-340	0.29	0.98	28	28	0
0047	2T	06	13	170	39	17000	16110	-890	0.23	0.95	30	28	-2
0047	2T	06	14	135	24	13500	9070	-4430	0.18	0.67	23	16	-7
0047	2T	06	15	148	22	14800	16960	2160	0.15	1.15	26	30	4
0047	2T	06	16	136	7	13600	10690	-2910	0.05	0.79	24	18	-6
0047	2T	06	21	108	13	10800	9340	-1460	0.12	0.86	19	16	-3
0047	2T	06	23	75	6	7500	8200	700	0.08	1.09	13	14	1
0047	2T	06	24	75	7	7500	14530	7030	0.09	1.94	13	25	12
0047	2T	06	25	71	4	7100	6030	-1070	0.06	0.85	12	10	-2
0047	2T	06	26	103	3	10300	1810	-8490	0.03	0.18	18	3	-15
0047	2T	07	12	180	37	18000	12430	-5570	0.21	0.69	31	22	-9
0047	2T	07	13	173	47	17300	16030	-1270	0.27	0.93	30	28	-2
0047	2T	07	14	160	26	16000	8480	-7520	0.16	0.53	28	15	-13
0047	2T	07	15	162	25	16200	17000	800	0.15	1.05	28	30	2
0047	2T	07	16	93	9	9300	8970	-330	0.10	0.96	16	15	-1
0047	2T	07	21	108	10	10800	8980	-1820	0.09	0.83	19	15	-4
0047	2T	07	23	81	5	8100	5360	-2740	0.06	0.66	14	9	-5
0047	2T	07	24	59	5	5900	3270	-2630	0.08	0.55	10	5	-5
0047	2T	07	25	72	6	7200	8810	1610	0.08	1.22	12	15	3
0047	2T	07	26	101	6	10100	10870	770	0.06	1.08	17	19	2
0047	2T	08	12	193	58	19300	18730	-570	0.30	0.97	34	33	-1
0047	2T	08	13	179	38	17900	14110	-3790	0.21	0.79	31	24	-7
0047	2T	08	14	173	30	17300	10750	-6550	0.17	0.62	30	19	-11
0047	2T	08	15	146	12	14600	10370	-4230	0.08	0.71	25	18	-7
0047	2T	08	16	117	15	11700	13540	1840	0.13	1.16	20	23	3
0047	2T	08	21	108	21	10800	19850	9050	0.19	1.84	19	35	16
0047	2T	08	23	49	4	4900	2760	-2140	0.08	0.56	8	4	-4
0047	2T	08	24	52	4	5200	8950	3750	0.08	1.72	9	15	6
0047	2T	08	25	76	7	7600	11490	3890	0.09	1.51	13	20	7
0047	2T	08	26	90	2	9000	1500	-7500	0.02	0.17	15	2	-13
0047	2T	09	12	242	81	24200	20430	-3770	0.33	0.84	42	36	-6
0047	2T	09	13	206	59	20600	20900	300	0.29	1.01	36	36	0
0047	2T	09	14	187	36	18700	16220	-2480	0.19	0.87	33	28	-5
0047	2T	09	15	149	19	14900	15790	890	0.13	1.06	26	27	1
0047	2T	09	16	116	9	11600	11560	-40	0.08	1.00	20	20	0
0047	2T	09	21	124	22	12400	19060	6660	0.18	1.54	21	33	12
0047	2T	09	23	75	4	7500	4690	-2810	0.05	0.63	13	8	-5
0047	2T	09	24	55	5	5500	11040	5540	0.09	2.01	9	19	10
0047	2T	09	25	94	4	9400	2480	-6920	0.04	0.26	16	4	-12
0047	2T	09	26	82	8	8200	10850	2650	0.10	1.32	14	19	5
0047	2T	10	12	263	80	26300	21700	-4600	0.30	0.83	46	38	-8
0047	2T	10	13	218	47	21800	15160	-6640	0.22	0.70	38	26	-12
0047	2T	10	14	176	37	17600	19610	2010	0.21	1.11	31	34	3
0047	2T	10	15	124	12	12400	14780	2380	0.10	1.19	21	26	5
0047	2T	10	16	86	7	8600	11750	3150	0.08	1.37	15	20	5
0047	2T	10	21	143	24	14300	13120	-1180	0.17	0.92	25	23	-2
0047	2T	10	23	69	7	6900	6490	-410	0.10	0.94	12	11	-1
0047	2T	10	24	72	7	7200	9630	2430	0.10	1.34	12	17	5
0047	2T	10	25	68	6	6800	11590	4790	0.09	1.70	12	20	8
0047	2T	10	26	86	7	8600	9310	710	0.08	1.08	15	16	1
0047	2T	11	12	262	59	26200	21190	-5010	0.23	0.81	46	37	-9
0047	2T	11	13	176	22	17600	13830	-3770	0.13	0.79	31	24	-7
0047	2T	11	14	190	26	19000	13820	-5180	0.14	0.73	33	24	-9
0047	2T	11	15	131	7	13100	10810	-2290	0.05	0.83	23	19	-4
0047	2T	11	16	86	2	8600	1380	-7220	0.02	0.16	15	2	-13
0047	2T	11	21	169	25	16900	22170	5270	0.15	1.31	29	39	10
0047	2T	11	23	94	2	9400	1070	-8330	0.02	0.11	16	1	-15
0047	2T	11	24	95	0	9500	0	-9500	0.00	0.00	16	0	-16
0047	2T	11	25	92	1	9200	1670	-7530	0.01	0.18	16	2	-14
0047	2T	11	26	56	2	5600	2480	-3120	0.04	0.44	9	4	-5
0047	2T	12	12	260	69	26000	24740	-1260	0.27	0.95	46	43	-3
0047	2T	12	13	216	44	21600	13900	-7700	0.20	0.64	38	24	-14
0047	2T	12	14	145	19	14500	9570	-4930	0.13	0.66	25	16	-9
0047	2T	12	15	154	8	15400	6510	-8890	0.05	0.42	27	11	-16
0047	2T	12	16	155	11	15500	7380	-8120	0.07	0.48	27	13	-14
0047	2T	12	21	129	13	12900	11780	-1120	0.10	0.91	22	20	-2
0047	2T	12	23	114	5	11400	2490	-8910	0.04	0.22	20	4	-16
0047	2T	12	24	103	3	10300	1010	-9290	0.03	0.10	18	1	-17
0047	2T	12	25	80	3	8000	6670	-1330	0.04	0.83	14	11	-3
0047	2T	12	26	87	1	8700	8280	-420	0.01	0.95	15	14	-1
0047	2T	13	12	249	75	24900	22710	-2190	0.30	0.91	44	40	-4
0047	2T	13	13	206	43	20600	16190	-4410	0.21	0.79	36	28	-8
0047	2T	13	14	213	43	21300	19610	-1690	0.20	0.92	37	34	-3
0047	2T	13	15	121	15	12100	9270	-2830	0.12	0.77	21	16	-5
0047	2T	13	16	144	13	14400	17270	2870	0.09	1.20	25	30	5
0047	2T	13	21	125	19	12500	18860	6360	0.15	1.51	22	33	11
0047	2T	13	23	97	5	9700	10690	990	0.05	1.10	17	18	1
0047	2T	13	24	86	3	8600	2560	-6040	0.03	0.30	15	4	-11
0047	2T	13	25	67	4	6700	15210	8510	0.06	2.27	11	26	15
0047	2T	13	26	81	4	8100	8350	250	0.05	1.03	14	14	0
0047	2T	14	12	162	45	16200	12800	-3400	0.28	0.79	28	22	-6
0047	2T	14	13	154	34	15400	14580	-820	0.22	0.95	27	25	-2
0047	2T	14	14	172	38	17200	15060	-2140	0.22	0.88	30	26	-4
0047	2T	14	15	123	6	12300	4770	-7530	0.05	0.39	21	8	-13
0047	2T	14	16	103	5	10300	2930	-7370	0.05	0.28	18	5	-13
0047	2T	14	21	129	22	12900	18750	5850	0.17	1.45	22	33	11
0047	2T	14	23	93	6	9300	7840	-1460	0.06	0.84	16	13	-3
0047	2T	14	24	81	2	8100	1320	-6780	0.02	0.16	14	2	-12
0047	2T	14	25	95	3	9500	5200	-4300	0.03	0.55	16	9	-7
0047	2T	14	26	62	4	6200	27320	21120	0.06	4.41	10	48	38
0047	2T	15	12	251	65	25100	18040	-7060	0.26	0.72	44	31	-13
0047	2T	15	13	178	41	17800	18080	280	0.23	1.02	31	32	1
0047	2T	15	14	237	51	23700	21910	-1790	0.22	0.92	41	38	-3
0047	2T	15	15	156	11	15600	7890	-7710	0.07	0.51	27	13	-14
0047	2T	15	16	119	7	11900	3850	-8050	0.06	0.32	21	6	-15
0047	2T	15	21	121	20	12100	17120	5020	0.17	1.41	21	30	9
0047	2T	15	23	65	5	6500	3150	-3350	0.08	0.48	11	5	-6
0047	2T	15	24	77	3	7700	2880	-4820	0.04	0.37	13	5	-8
0047	2T	15	25	81	1	8100	450	-7650	0.01	0.06	14	0	-14
0047	2T	15	26	90	2	9000	3180	-5820	0.02	0.35	15	5	-10
0047	2T	16	12	315	99	31500	32380	880	0.31	1.03	55	57	2
0047	2T	16	13	245	43	24500	17450	-7050	0.18	0.71	43	30	-13
0047	2T	16	14	252	58	25200	20410	-4790	0.23	0.81	44	36	-8
0047	2T	16	15	146	12	14600	7110	-7490	0.08	0.49	25	12	-13
0047	2T	16	16	119	5	11900	4650	-7250	0.04	0.39	21	8	-13
0047	2T	16	21	125	16	12500	11480	-1020	0.13	0.92	22	20	-2
0047	2T	16	23	80	3	8000	2430	-5570	0.04	0.30	14	4	-10
0047	2T	16	24	74	3	7400	2580	-4820	0.04	0.35	13	4	-9
0047	2T	16	25	74	6	7400	7810	410	0.08	1.06	13	13	0
0047	2T	16	26	81	2	8100	1010	-7090	0.02	0.12	14	1	-13
0047	2T	17	12	270	73	27000	18610	-8390	0.27	0.69	47	32	-15
0047	2T	17	13	236	70	23600	23720	120	0.30	1.01	41	41	0
0047	2T	17	14	248	43	24800	19650	-5150	0.17	0.79	43	34	-9
0047	2T	17	15	140	20	14000	14110	110	0.14	1.01	24	24	0
0047	2T	17	16	125	6	12500	6990	-5510	0.05	0.56	22	12	-10
0047	2T	17	21	125	14	12500	10990	-1510	0.11	0.88	22	19	-3
0047	2T	17	23	105	9	10500	15390	4890	0.09	1.47	18	27	9
0047	2T	17	24	80	6	8000	8730	730	0.08	1.09	14	15	1
0047	2T	17	25	80	5	8000	3160	-4840	0.06	0.40	14	5	-9
0047	2T	17	26	79	3	7900	8400	500	0.04	1.06	13	14	1
0047	2T	18	12	395	150	39500	36770	-2730	0.38	0.93	69	65	-4
0047	2T	18	13	293	66	29300	23000	-6300	0.23	0.78	51	40	-11
0047	2T	18	14	279	60	27900	25010	-2890	0.22	0.90	49	44	-5
0047	2T	18	15	223	39	22300	24470	2170	0.17	1.10	39	43	4
0047	2T	18	16	111	13	11100	14100	3000	0.12	1.27	19	24	5
0047	2T	18	21	109	15	10900	9920	-980	0.14	0.91	19	17	-2
0047	2T	18	23	63	5	6300	6680	380	0.08	1.06	11	11	0
0047	2T	18	24	89	8	8900	16200	7300	0.09	1.82	15	28	13
0047	2T	18	25	72	4	7200	2290	-4910	0.06	0.32	12	4	-8
0047	2T	18	26	92	7	9200	5070	-4130	0.08	0.55	16	8	-8
0047	2T	19	12	274	79	27400	23870	-3530	0.29	0.87	48	42	-6
0047	2T	19	13	219	59	21900	21160	-740	0.27	0.97	38	37	-1
0047	2T	19	14	272	70	27200	25540	-1660	0.26	0.94	48	45	-3
0047	2T	19	15	124	13	12400	10700	-1700	0.10	0.86	21	18	-3
0047	2T	19	16	98	11	9800	9580	-220	0.11	0.98	17	16	-1
0047	2T	19	21	88	11	8800	10840	2040	0.13	1.23	15	19	4
0047	2T	19	23	101	7	10100	6280	-3820	0.07	0.62	17	11	-6
0047	2T	19	24	66	3	6600	14340	7740	0.05	2.17	11	25	14
0047	2T	19	25	45	0	4500	0	-4500	0.00	0.00	7	0	-7
0047	2T	19	26	63	3	6300	5960	-340	0.05	0.95	11	10	-1
0047	2T	20	12	274	79	27400	22880	-4520	0.29	0.84	48	40	-8
0047	2T	20	13	204	48	20400	15270	-5130	0.24	0.75	36	27	-9
0047	2T	20	14	217	40	21700	16570	-5130	0.18	0.76	38	29	-9
0047	2T	20	15	134	14	13400	10050	-3350	0.10	0.75	23	17	-6
0047	2T	20	16	108	9	10800	9210	-1590	0.08	0.85	19	16	-3
0047	2T	20	21	118	22	11800	14320	2520	0.19	1.21	20	25	5
0047	2T	20	23	53	1	5300	1640	-3660	0.02	0.31	9	2	-7
0047	2T	20	24	84	5	8400	3790	-4610	0.06	0.45	14	6	-8
0047	2T	20	25	65	3	6500	4340	-2160	0.05	0.67	11	7	-4
0047	2T	20	26	58	2	5800	1970	-3830	0.03	0.34	10	3	-7
0047	2T	21	12	334	102	33400	28390	-5010	0.31	0.85	59	50	-9
0047	2T	21	13	310	86	31000	32350	1350	0.28	1.04	54	57	3
0047	2T	21	14	272	66	27200	21920	-5280	0.24	0.81	48	38	-10
0047	2T	21	15	216	35	21600	25360	3760	0.16	1.17	38	44	6
0047	2T	21	16	102	6	10200	9330	-870	0.06	0.91	18	16	-2
0047	2T	21	21	103	18	10300	9610	-690	0.17	0.93	18	17	-1
0047	2T	21	23	63	3	6300	1860	-4440	0.05	0.30	11	3	-8
0047	2T	21	24	51	3	5100	4920	-180	0.06	0.96	9	8	-1
0047	2T	21	25	58	1	5800	360	-5440	0.02	0.06	10	0	-10
0047	2T	21	26	54	3	5400	9020	3620	0.06	1.67	9	15	6
0047	2T	22	12	265	58	26500	24850	-1650	0.22	0.94	46	43	-3
0047	2T	22	13	238	43	23800	17880	-5920	0.18	0.75	42	31	-11
0047	2T	22	14	184	20	18400	13570	-4830	0.11	0.74	32	24	-8
0047	2T	22	15	130	6	13000	10180	-2820	0.05	0.78	23	18	-5
0047	2T	22	16	93	4	9300	3220	-6080	0.04	0.35	16	5	-11
0047	2T	22	21	153	14	15300	9450	-5850	0.09	0.62	27	16	-11
0047	2T	22	23	106	3	10600	3060	-7540	0.03	0.29	18	5	-13
0047	2T	22	24	101	5	10100	5710	-4390	0.05	0.57	17	10	-7
0047	2T	22	25	74	2	7400	2020	-5380	0.03	0.27	13	3	-10
0047	2T	22	26	62	0	6200	0	-6200	0.00	0.00	10	0	-10
0047	2T	23	12	255	71	25500	24170	-1330	0.28	0.95	45	42	-3
0047	2T	23	13	222	47	22200	25800	3600	0.21	1.16	39	45	6
0047	2T	23	14	178	31	17800	24450	6650	0.17	1.37	31	43	12
0047	2T	23	15	122	11	12200	6360	-5840	0.09	0.52	21	11	-10
0047	2T	23	16	101	5	10100	12820	2720	0.05	1.27	17	22	5
0047	2T	23	21	156	14	15600	11030	-4570	0.09	0.71	27	19	-8
0047	2T	23	23	117	10	11700	9580	-2120	0.09	0.82	20	16	-4
0047	2T	23	24	107	8	10700	12200	1500	0.07	1.14	18	21	3
0047	2T	23	25	90	0	9000	0	-9000	0.00	0.00	15	0	-15
0047	2T	23	26	68	0	6800	0	-6800	0.00	0.00	12	0	-12
0047	2T	24	12	388	113	38800	30280	-8520	0.29	0.78	68	53	-15
0047	2T	24	13	313	91	31300	36020	4720	0.29	1.15	55	63	8
0047	2T	24	14	272	51	27200	23800	-3400	0.19	0.88	48	42	-6
0047	2T	24	15	201	17	20100	12030	-8070	0.08	0.60	35	21	-14
0047	2T	24	16	174	18	17400	25280	7880	0.10	1.45	30	44	14
0047	2T	24	21	113	20	11300	13990	2690	0.18	1.24	20	24	4
0047	2T	24	23	68	5	6800	4220	-2580	0.07	0.62	12	7	-5
0047	2T	24	24	70	6	7000	29060	22060	0.09	4.15	12	51	39
0047	2T	24	25	56	5	5600	5790	190	0.09	1.03	9	10	1
0047	2T	24	26	57	3	5700	3420	-2280	0.05	0.60	10	6	-4
0047	3F	01	123	157	34	15700	13190	-2510	0.22	0.84	27	23	-4
0047	3F	01	124	145	19	14500	10680	-3820	0.13	0.74	25	18	-7
0047	3F	01	125	138	15	13800	8320	-5480	0.11	0.60	24	14	-10
0047	3F	01	126	95	16	9500	21990	12490	0.17	2.31	16	38	22
0047	3F	01	134	77	9	7700	4670	-3030	0.12	0.61	13	8	-5
0047	3F	01	135	84	11	8400	5400	-3000	0.13	0.64	14	9	-5
0047	3F	01	136	60	6	6000	7370	1370	0.10	1.23	10	13	3
0047	3F	01	145	66	5	6600	5740	-860	0.08	0.87	11	10	-1
0047	3F	01	146	48	4	4800	5690	890	0.08	1.19	8	10	2
0047	3F	01	156	50	4	5000	4810	-190	0.08	0.96	8	8	0
0047	3F	01	234	44	4	4400	3830	-570	0.09	0.87	7	6	-1
0047	3F	01	235	41	3	4100	7470	3370	0.07	1.82	7	13	6
0047	3F	01	236	39	2	3900	3980	80	0.05	1.02	6	7	1
0047	3F	01	245	19	0	1900	0	-1900	0.00	0.00	3	0	-3
0047	3F	01	246	29	2	2900	1460	-1440	0.07	0.50	5	2	-3
0047	3F	01	256	27	0	2700	0	-2700	0.00	0.00	4	0	-4
0047	3F	02	123	111	16	11100	4890	-6210	0.14	0.44	19	8	-11
0047	3F	02	124	105	11	10500	7330	-3170	0.10	0.70	18	12	-6
0047	3F	02	125	113	17	11300	11200	-100	0.15	0.99	20	19	-1
0047	3F	02	126	103	9	10300	8290	-2010	0.09	0.80	18	14	-4
0047	3F	02	134	65	12	6500	7910	1410	0.18	1.22	11	14	3
0047	3F	02	135	63	8	6300	7110	810	0.13	1.13	11	12	1
0047	3F	02	136	48	9	4800	6950	2150	0.19	1.45	8	12	4
0047	3F	02	145	55	5	5500	3000	-2500	0.09	0.55	9	5	-4
0047	3F	02	146	55	3	5500	5600	100	0.05	1.02	9	9	0
0047	3F	02	156	52	5	5200	9490	4290	0.10	1.83	9	16	7
0047	3F	02	234	28	2	2800	1130	-1670	0.07	0.40	4	2	-2
0047	3F	02	235	47	1	4700	530	-4170	0.02	0.11	8	0	-8
0047	3F	02	236	33	1	3300	880	-2420	0.03	0.27	5	1	-4
0047	3F	02	245	29	3	2900	2470	-430	0.10	0.85	5	4	-1
0047	3F	02	246	39	1	3900	300	-3600	0.03	0.08	6	0	-6
0047	3F	02	256	24	1	2400	650	-1750	0.04	0.27	4	1	-3
0047	3F	03	123	89	21	8900	7040	-1860	0.24	0.79	15	12	-3
0047	3F	03	124	69	12	6900	6090	-810	0.17	0.88	12	10	-2
0047	3F	03	125	84	6	8400	2890	-5510	0.07	0.34	14	5	-9
0047	3F	03	126	71	9	7100	5470	-1630	0.13	0.77	12	9	-3
0047	3F	03	134	35	10	3500	4980	1480	0.29	1.42	6	8	2
0047	3F	03	135	33	6	3300	3580	280	0.18	1.08	5	6	1
0047	3F	03	136	27	1	2700	1410	-1290	0.04	0.52	4	2	-2
0047	3F	03	145	35	1	3500	500	-3000	0.03	0.14	6	0	-6
0047	3F	03	146	26	3	2600	4380	1780	0.12	1.68	4	7	3
0047	3F	03	156	32	3	3200	2650	-550	0.09	0.83	5	4	-1
0047	3F	03	234	18	1	1800	560	-1240	0.06	0.31	3	0	-3
0047	3F	03	235	19	1	1900	650	-1250	0.05	0.34	3	1	-2
0047	3F	03	236	31	0	3100	0	-3100	0.00	0.00	5	0	-5
0047	3F	03	245	22	5	2200	8820	6620	0.23	4.01	3	15	12
0047	3F	03	246	15	1	1500	1160	-340	0.07	0.77	2	2	0
0047	3F	03	256	29	1	2900	430	-2470	0.03	0.15	5	0	-5
0047	3F	04	123	82	22	8200	9790	1590	0.27	1.19	14	17	3
0047	3F	04	124	100	11	10000	4280	-5720	0.11	0.43	17	7	-10
0047	3F	04	125	74	14	7400	9830	2430	0.19	1.33	13	17	4
0047	3F	04	126	91	6	9100	6240	-2860	0.07	0.69	16	11	-5
0047	3F	04	134	37	9	3700	7750	4050	0.24	2.09	6	13	7
0047	3F	04	135	41	7	4100	3570	-530	0.17	0.87	7	6	-1
0047	3F	04	136	44	4	4400	2500	-1900	0.09	0.57	7	4	-3
0047	3F	04	145	36	0	3600	0	-3600	0.00	0.00	6	0	-6
0047	3F	04	146	26	2	2600	2580	-20	0.08	0.99	4	4	0
0047	3F	04	156	37	1	3700	430	-3270	0.03	0.12	6	0	-6
0047	3F	04	234	22	2	2200	1160	-1040	0.09	0.53	3	2	-1
0047	3F	04	235	22	1	2200	410	-1790	0.05	0.19	3	0	-3
0047	3F	04	236	29	1	2900	530	-2370	0.03	0.18	5	0	-5
0047	3F	04	245	20	1	2000	490	-1510	0.05	0.25	3	0	-3
0047	3F	04	246	31	2	3100	3320	220	0.06	1.07	5	5	0
0047	3F	04	256	25	3	2500	2390	-110	0.12	0.96	4	4	0
0047	3F	05	123	126	32	12600	13270	670	0.25	1.05	22	23	1
0047	3F	05	124	92	16	9200	8610	-590	0.17	0.94	16	15	-1
0047	3F	05	125	93	11	9300	7770	-1530	0.12	0.84	16	13	-3
0047	3F	05	126	101	13	10100	11870	1770	0.13	1.18	17	21	4
0047	3F	05	134	41	8	4100	4440	340	0.20	1.08	7	7	0
0047	3F	05	135	42	5	4200	3810	-390	0.12	0.91	7	6	-1
0047	3F	05	136	43	2	4300	1240	-3060	0.05	0.29	7	2	-5
0047	3F	05	145	32	4	3200	3980	780	0.13	1.24	5	7	2
0047	3F	05	146	45	3	4500	4710	210	0.07	1.05	7	8	1
0047	3F	05	156	38	3	3800	3340	-460	0.08	0.88	6	5	-1
0047	3F	05	234	24	4	2400	2460	60	0.17	1.03	4	4	0
0047	3F	05	235	27	4	2700	1840	-860	0.15	0.68	4	3	-1
0047	3F	05	236	34	1	3400	1580	-1820	0.03	0.46	6	2	-4
0047	3F	05	245	20	0	2000	0	-2000	0.00	0.00	3	0	-3
0047	3F	05	246	16	1	1600	2750	1150	0.06	1.72	2	4	2
0047	3F	05	256	29	0	2900	0	-2900	0.00	0.00	5	0	-5
0047	3F	06	123	112	28	11200	8850	-2350	0.25	0.79	19	15	-4
0047	3F	06	124	102	22	10200	7780	-2420	0.22	0.76	18	13	-5
0047	3F	06	125	104	13	10400	7620	-2780	0.13	0.73	18	13	-5
0047	3F	06	126	98	8	9800	5480	-4320	0.08	0.56	17	9	-8
0047	3F	06	134	62	7	6200	2850	-3350	0.11	0.46	10	5	-5
0047	3F	06	135	59	7	5900	3850	-2050	0.12	0.65	10	6	-4
0047	3F	06	136	60	6	6000	6590	590	0.10	1.10	10	11	1
0047	3F	06	145	55	4	5500	5710	210	0.07	1.04	9	10	1
0047	3F	06	146	50	7	5000	4330	-670	0.14	0.87	8	7	-1
0047	3F	06	156	47	2	4700	890	-3810	0.04	0.19	8	1	-7
0047	3F	06	234	21	4	2100	3130	1030	0.19	1.49	3	5	2
0047	3F	06	235	22	2	2200	680	-1520	0.09	0.31	3	1	-2
0047	3F	06	236	28	0	2800	0	-2800	0.00	0.00	4	0	-4
0047	3F	06	245	20	0	2000	0	-2000	0.00	0.00	3	0	-3
0047	3F	06	246	33	2	3300	780	-2520	0.06	0.24	5	1	-4
0047	3F	06	256	31	1	3100	1590	-1510	0.03	0.51	5	2	-3
0047	3F	07	123	120	22	12000	7440	-4560	0.18	0.62	21	13	-8
0047	3F	07	124	107	15	10700	6500	-4200	0.14	0.61	18	11	-7
0047	3F	07	125	89	12	8900	6400	-2500	0.13	0.72	15	11	-4
0047	3F	07	126	102	13	10200	10220	20	0.13	1.00	18	18	0
0047	3F	07	134	70	13	7000	5270	-1730	0.19	0.75	12	9	-3
0047	3F	07	135	66	12	6600	7040	440	0.18	1.07	11	12	1
0047	3F	07	136	45	3	4500	2450	-2050	0.07	0.54	7	4	-3
0047	3F	07	145	63	7	6300	6220	-80	0.11	0.99	11	11	0
0047	3F	07	146	49	1	4900	340	-4560	0.02	0.07	8	0	-8
0047	3F	07	156	40	5	4000	5910	1910	0.13	1.48	7	10	3
0047	3F	07	234	21	1	2100	410	-1690	0.05	0.20	3	0	-3
0047	3F	07	235	25	0	2500	0	-2500	0.00	0.00	4	0	-4
0047	3F	07	236	36	3	3600	1060	-2540	0.08	0.29	6	1	-5
0047	3F	07	245	21	3	2100	3970	1870	0.14	1.89	3	7	4
0047	3F	07	246	26	0	2600	0	-2600	0.00	0.00	4	0	-4
0047	3F	07	256	18	0	1800	0	-1800	0.00	0.00	3	0	-3
0047	3F	08	123	117	33	11700	12580	880	0.28	1.08	20	22	2
0047	3F	08	124	111	23	11100	8420	-2680	0.21	0.76	19	14	-5
0047	3F	08	125	123	14	12300	10400	-1900	0.11	0.85	21	18	-3
0047	3F	08	126	80	10	8000	5260	-2740	0.13	0.66	14	9	-5
0047	3F	08	134	79	16	7900	8120	220	0.20	1.03	13	14	1
0047	3F	08	135	64	7	6400	6760	360	0.11	1.06	11	11	0
0047	3F	08	136	48	4	4800	2160	-2640	0.08	0.45	8	3	-5
0047	3F	08	145	62	8	6200	4360	-1840	0.13	0.70	10	7	-3
0047	3F	08	146	52	7	5200	5780	580	0.13	1.11	9	10	1
0047	3F	08	156	41	1	4100	290	-3810	0.02	0.07	7	0	-7
0047	3F	08	234	25	2	2500	1140	-1360	0.08	0.46	4	2	-2
0047	3F	08	235	21	1	2100	1700	-400	0.05	0.81	3	3	0
0047	3F	08	236	27	1	2700	420	-2280	0.04	0.16	4	0	-4
0047	3F	08	245	19	1	1900	1200	-700	0.05	0.63	3	2	-1
0047	3F	08	246	18	2	1800	2750	950	0.11	1.53	3	4	1
0047	3F	08	256	22	1	2200	18430	16230	0.05	8.38	3	32	29
0047	3F	09	123	147	35	14700	11010	-3690	0.24	0.75	26	19	-7
0047	3F	09	124	121	23	12100	11430	-670	0.19	0.94	21	20	-1
0047	3F	09	125	118	15	11800	9020	-2780	0.13	0.76	20	15	-5
0047	3F	09	126	112	11	11200	6880	-4320	0.10	0.61	19	12	-7
0047	3F	09	134	74	13	7400	6330	-1070	0.18	0.86	13	11	-2
0047	3F	09	135	76	8	7600	4220	-3380	0.11	0.56	13	7	-6
0047	3F	09	136	69	7	6900	5170	-1730	0.10	0.75	12	9	-3
0047	3F	09	145	66	4	6600	5230	-1370	0.06	0.79	11	9	-2
0047	3F	09	146	60	6	6000	6110	110	0.10	1.02	10	10	0
0047	3F	09	156	36	0	3600	0	-3600	0.00	0.00	6	0	-6
0047	3F	09	234	26	2	2600	740	-1860	0.08	0.28	4	1	-3
0047	3F	09	235	30	1	3000	1190	-1810	0.03	0.40	5	2	-3
0047	3F	09	236	14	1	1400	640	-760	0.07	0.46	2	1	-1
0047	3F	09	245	25	1	2500	110	-2390	0.04	0.04	4	0	-4
0047	3F	09	246	24	1	2400	480	-1920	0.04	0.20	4	0	-4
0047	3F	09	256	26	1	2600	400	-2200	0.04	0.15	4	0	-4
0047	3F	10	123	179	54	17900	14810	-3090	0.30	0.83	31	26	-5
0047	3F	10	124	155	31	15500	10080	-5420	0.20	0.65	27	17	-10
0047	3F	10	125	126	17	12600	7690	-4910	0.13	0.61	22	13	-9
0047	3F	10	126	103	17	10300	12990	2690	0.17	1.26	18	22	4
0047	3F	10	134	79	17	7900	8960	1060	0.22	1.13	13	15	2
0047	3F	10	135	73	11	7300	6910	-390	0.15	0.95	12	12	0
0047	3F	10	136	48	2	4800	1540	-3260	0.04	0.32	8	2	-6
0047	3F	10	145	69	6	6900	8270	1370	0.09	1.20	12	14	2
0047	3F	10	146	37	2	3700	2430	-1270	0.05	0.66	6	4	-2
0047	3F	10	156	25	3	2500	6000	3500	0.12	2.40	4	10	6
0047	3F	10	234	18	2	1800	4350	2550	0.11	2.42	3	7	4
0047	3F	10	235	25	4	2500	3150	650	0.16	1.26	4	5	1
0047	3F	10	236	17	2	1700	2050	350	0.12	1.21	3	3	0
0047	3F	10	245	25	2	2500	840	-1660	0.08	0.34	4	1	-3
0047	3F	10	246	10	0	1000	0	-1000	0.00	0.00	1	0	-1
0047	3F	10	256	17	1	1700	810	-890	0.06	0.48	3	1	-2
0047	3F	11	123	174	34	17400	12520	-4880	0.20	0.72	30	22	-8
0047	3F	11	124	174	27	17400	12630	-4770	0.16	0.73	30	22	-8
0047	3F	11	125	106	2	10600	820	-9780	0.02	0.08	18	1	-17
0047	3F	11	126	91	6	9100	5700	-3400	0.07	0.63	16	10	-6
0047	3F	11	134	74	8	7400	3530	-3870	0.11	0.48	13	6	-7
0047	3F	11	135	46	6	4600	5290	690	0.13	1.15	8	9	1
0047	3F	11	136	41	1	4100	2090	-2010	0.02	0.51	7	3	-4
0047	3F	11	145	48	5	4800	3920	-880	0.10	0.82	8	6	-2
0047	3F	11	146	60	4	6000	4900	-1100	0.07	0.82	10	8	-2
0047	3F	11	156	48	1	4800	1700	-3100	0.02	0.35	8	3	-5
0047	3F	11	234	54	1	5400	1960	-3440	0.02	0.36	9	3	-6
0047	3F	11	235	31	1	3100	870	-2230	0.03	0.28	5	1	-4
0047	3F	11	236	31	1	3100	820	-2280	0.03	0.26	5	1	-4
0047	3F	11	245	34	2	3400	2930	-470	0.06	0.86	6	5	-1
0047	3F	11	246	24	0	2400	0	-2400	0.00	0.00	4	0	-4
0047	3F	11	256	33	0	3300	0	-3300	0.00	0.00	5	0	-5
0047	3F	12	123	169	34	16900	15670	-1230	0.20	0.93	29	27	-2
0047	3F	12	124	130	20	13000	8840	-4160	0.15	0.68	23	15	-8
0047	3F	12	125	97	9	9700	7060	-2640	0.09	0.73	17	12	-5
0047	3F	12	126	144	17	14400	11660	-2740	0.12	0.81	25	20	-5
0047	3F	12	134	92	20	9200	9500	300	0.22	1.03	16	16	0
0047	3F	12	135	63	7	6300	4930	-1370	0.11	0.78	11	8	-3
0047	3F	12	136	71	14	7100	15390	8290	0.20	2.17	12	27	15
0047	3F	12	145	62	3	6200	1280	-4920	0.05	0.21	10	2	-8
0047	3F	12	146	56	7	5600	7080	1480	0.13	1.26	9	12	3
0047	3F	12	156	62	2	6200	5860	-340	0.03	0.95	10	10	0
0047	3F	12	234	42	5	4200	2950	-1250	0.12	0.70	7	5	-2
0047	3F	12	235	42	5	4200	5500	1300	0.12	1.31	7	9	2
0047	3F	12	236	38	0	3800	0	-3800	0.00	0.00	6	0	-6
0047	3F	12	245	26	0	2600	0	-2600	0.00	0.00	4	0	-4
0047	3F	12	246	31	0	3100	0	-3100	0.00	0.00	5	0	-5
0047	3F	12	256	25	0	2500	0	-2500	0.00	0.00	4	0	-4
0047	3F	13	123	139	33	13900	13800	-100	0.24	0.99	24	24	0
0047	3F	13	124	151	30	15100	12050	-3050	0.20	0.80	26	21	-5
0047	3F	13	125	109	19	10900	14230	3330	0.17	1.31	19	25	6
0047	3F	13	126	113	13	11300	7450	-3850	0.12	0.66	20	13	-7
0047	3F	13	134	100	14	10000	7110	-2890	0.14	0.71	17	12	-5
0047	3F	13	135	61	5	6100	3130	-2970	0.08	0.51	10	5	-5
0047	3F	13	136	60	9	6000	3660	-2340	0.15	0.61	10	6	-4
0047	3F	13	145	71	5	7100	3040	-4060	0.07	0.43	12	5	-7
0047	3F	13	146	53	1	5300	860	-4440	0.02	0.16	9	1	-8
0047	3F	13	156	42	0	4200	0	-4200	0.00	0.00	7	0	-7
0047	3F	13	234	46	5	4600	4800	200	0.11	1.04	8	8	0
0047	3F	13	235	24	2	2400	5900	3500	0.08	2.46	4	10	6
0047	3F	13	236	29	1	2900	460	-2440	0.03	0.16	5	0	-5
0047	3F	13	245	27	1	2700	240	-2460	0.04	0.09	4	0	-4
0047	3F	13	246	29	0	2900	0	-2900	0.00	0.00	5	0	-5
0047	3F	13	256	31	0	3100	0	-3100	0.00	0.00	5	0	-5
0047	3F	14	123	107	15	10700	4870	-5830	0.14	0.46	18	8	-10
0047	3F	14	124	121	27	12100	10540	-1560	0.22	0.87	21	18	-3
0047	3F	14	125	104	11	10400	5240	-5160	0.11	0.50	18	9	-9
0047	3F	14	126	77	9	7700	8290	590	0.12	1.08	13	14	1
0047	3F	14	134	77	10	7700	5300	-2400	0.13	0.69	13	9	-4
0047	3F	14	135	56	4	5600	7180	1580	0.07	1.28	9	12	3
0047	3F	14	136	47	4	4700	3050	-1650	0.09	0.65	8	5	-3
0047	3F	14	145	53	7	5300	6980	1680	0.13	1.32	9	12	3
0047	3F	14	146	45	4	4500	2560	-1940	0.09	0.57	7	4	-3
0047	3F	14	156	39	2	3900	2310	-1590	0.05	0.59	6	4	-2
0047	3F	14	234	34	1	3400	340	-3060	0.03	0.10	6	0	-6
0047	3F	14	235	28	0	2800	0	-2800	0.00	0.00	4	0	-4
0047	3F	14	236	30	2	3000	1540	-1460	0.07	0.51	5	2	-3
0047	3F	14	245	30	0	3000	0	-3000	0.00	0.00	5	0	-5
0047	3F	14	246	26	1	2600	760	-1840	0.04	0.29	4	1	-3
0047	3F	14	256	26	0	2600	0	-2600	0.00	0.00	4	0	-4
0047	3F	15	123	147	29	14700	12120	-2580	0.20	0.82	26	21	-5
0047	3F	15	124	167	36	16700	10330	-6370	0.22	0.62	29	18	-11
0047	3F	15	125	105	15	10500	8140	-2360	0.14	0.78	18	14	-4
0047	3F	15	126	102	12	10200	11010	810	0.12	1.08	18	19	1
0047	3F	15	134	92	14	9200	5690	-3510	0.15	0.62	16	10	-6
0047	3F	15	135	49	4	4900	2970	-1930	0.08	0.61	8	5	-3
0047	3F	15	136	58	4	5800	2540	-3260	0.07	0.44	10	4	-6
0047	3F	15	145	83	8	8300	7130	-1170	0.10	0.86	14	12	-2
0047	3F	15	146	50	4	5000	3740	-1260	0.08	0.75	8	6	-2
0047	3F	15	156	43	1	4300	1840	-2460	0.02	0.43	7	3	-4
0047	3F	15	234	24	1	2400	730	-1670	0.04	0.30	4	1	-3
0047	3F	15	235	25	0	2500	0	-2500	0.00	0.00	4	0	-4
0047	3F	15	236	28	4	2800	6370	3570	0.14	2.28	4	11	7
0047	3F	15	245	29	1	2900	370	-2530	0.03	0.13	5	0	-5
0047	3F	15	246	20	1	2000	440	-1560	0.05	0.22	3	0	-3
0047	3F	15	256	32	3	3200	2410	-790	0.09	0.75	5	4	-1
0047	3F	16	123	176	46	17600	13440	-4160	0.26	0.76	31	23	-8
0047	3F	16	124	182	42	18200	18470	270	0.23	1.01	32	32	0
0047	3F	16	125	121	15	12100	14830	2730	0.12	1.23	21	26	5
0047	3F	16	126	114	19	11400	15620	4220	0.17	1.37	20	27	7
0047	3F	16	134	114	18	11400	6950	-4450	0.16	0.61	20	12	-8
0047	3F	16	135	73	4	7300	1690	-5610	0.05	0.23	12	2	-10
0047	3F	16	136	55	3	5500	1450	-4050	0.05	0.26	9	2	-7
0047	3F	16	145	85	16	8500	12310	3810	0.19	1.45	15	21	6
0047	3F	16	146	56	3	5600	1850	-3750	0.05	0.33	9	3	-6
0047	3F	16	156	41	3	4100	4200	100	0.07	1.02	7	7	0
0047	3F	16	234	22	2	2200	1450	-750	0.09	0.66	3	2	-1
0047	3F	16	235	25	1	2500	610	-1890	0.04	0.24	4	1	-3
0047	3F	16	236	33	1	3300	1010	-2290	0.03	0.31	5	1	-4
0047	3F	16	245	15	0	1500	0	-1500	0.00	0.00	2	0	-2
0047	3F	16	246	27	3	2700	3010	310	0.11	1.11	4	5	1
0047	3F	16	256	18	1	1800	4770	2970	0.06	2.65	3	8	5
0047	3F	17	123	187	43	18700	12100	-6600	0.23	0.65	33	21	-12
0047	3F	17	124	146	22	14600	10760	-3840	0.15	0.74	25	19	-6
0047	3F	17	125	124	13	12400	7240	-5160	0.10	0.58	21	12	-9
0047	3F	17	126	114	8	11400	4670	-6730	0.07	0.41	20	8	-12
0047	3F	17	134	105	17	10500	6780	-3720	0.16	0.65	18	12	-6
0047	3F	17	135	68	5	6800	2500	-4300	0.07	0.37	12	4	-8
0047	3F	17	136	62	6	6200	7900	1700	0.10	1.27	10	13	3
0047	3F	17	145	77	9	7700	9810	2110	0.12	1.27	13	17	4
0047	3F	17	146	56	5	5600	5290	-310	0.09	0.94	9	9	0
0047	3F	17	156	40	3	4000	2650	-1350	0.08	0.66	7	4	-3
0047	3F	17	234	40	4	4000	1910	-2090	0.10	0.48	7	3	-4
0047	3F	17	235	20	1	2000	340	-1660	0.05	0.17	3	0	-3
0047	3F	17	236	34	1	3400	190	-3210	0.03	0.06	6	0	-6
0047	3F	17	245	28	1	2800	810	-1990	0.04	0.29	4	1	-3
0047	3F	17	246	32	1	3200	440	-2760	0.03	0.14	5	0	-5
0047	3F	17	256	20	0	2000	0	-2000	0.00	0.00	3	0	-3
0047	3F	18	123	193	34	19300	10670	-8630	0.18	0.55	34	18	-16
0047	3F	18	124	179	34	17900	11290	-6610	0.19	0.63	31	19	-12
0047	3F	18	125	171	31	17100	14430	-2670	0.18	0.84	30	25	-5
0047	3F	18	126	116	11	11600	7070	-4530	0.09	0.61	20	12	-8
0047	3F	18	134	120	21	12000	10440	-1560	0.18	0.87	21	18	-3
0047	3F	18	135	122	13	12200	5420	-6780	0.11	0.44	21	9	-12
0047	3F	18	136	58	1	5800	370	-5430	0.02	0.06	10	0	-10
0047	3F	18	145	107	13	10700	7360	-3340	0.12	0.69	18	13	-5
0047	3F	18	146	62	5	6200	10200	4000	0.08	1.65	10	18	8
0047	3F	18	156	38	2	3800	4200	400	0.05	1.11	6	7	1
0047	3F	18	234	22	0	2200	0	-2200	0.00	0.00	3	0	-3
0047	3F	18	235	25	2	2500	1290	-1210	0.08	0.52	4	2	-2
0047	3F	18	236	22	0	2200	0	-2200	0.00	0.00	3	0	-3
0047	3F	18	245	27	0	2700	0	-2700	0.00	0.00	4	0	-4
0047	3F	18	246	31	2	3100	1370	-1730	0.06	0.44	5	2	-3
0047	3F	18	256	14	0	1400	0	-1400	0.00	0.00	2	0	-2
0047	3F	19	123	173	41	17300	16390	-910	0.24	0.95	30	29	-1
0047	3F	19	124	179	47	17900	17150	-750	0.26	0.96	31	30	-1
0047	3F	19	125	100	17	10000	10130	130	0.17	1.01	17	17	0
0047	3F	19	126	97	10	9700	10270	570	0.10	1.06	17	18	1
0047	3F	19	134	111	27	11100	11000	-100	0.24	0.99	19	19	0
0047	3F	19	135	51	3	5100	1120	-3980	0.06	0.22	9	1	-8
0047	3F	19	136	53	3	5300	2750	-2550	0.06	0.52	9	4	-5
0047	3F	19	145	58	7	5800	5230	-570	0.12	0.90	10	9	-1
0047	3F	19	146	52	3	5200	1880	-3320	0.06	0.36	9	3	-6
0047	3F	19	156	29	1	2900	2980	80	0.03	1.03	5	5	0
0047	3F	19	234	25	3	2500	2050	-450	0.12	0.82	4	3	-1
0047	3F	19	235	17	1	1700	800	-900	0.06	0.47	3	1	-2
0047	3F	19	236	29	3	2900	2650	-250	0.10	0.91	5	4	-1
0047	3F	19	245	13	1	1300	2220	920	0.08	1.71	2	3	1
0047	3F	19	246	16	1	1600	560	-1040	0.06	0.35	2	0	-2
0047	3F	19	256	18	1	1800	870	-930	0.06	0.48	3	1	-2
0047	3F	20	123	157	39	15700	13270	-2430	0.25	0.85	27	23	-4
0047	3F	20	124	176	36	17600	9510	-8090	0.20	0.54	31	16	-15
0047	3F	20	125	116	17	11600	11000	-600	0.15	0.95	20	19	-1
0047	3F	20	126	95	9	9500	13230	3730	0.09	1.39	16	23	7
0047	3F	20	134	83	12	8300	5200	-3100	0.14	0.63	14	9	-5
0047	3F	20	135	74	9	7400	5480	-1920	0.12	0.74	13	9	-4
0047	3F	20	136	49	6	4900	4590	-310	0.12	0.94	8	8	0
0047	3F	20	145	65	5	6500	5600	-900	0.08	0.86	11	9	-2
0047	3F	20	146	53	2	5300	2440	-2860	0.04	0.46	9	4	-5
0047	3F	20	156	37	2	3700	1550	-2150	0.05	0.42	6	2	-4
0047	3F	20	234	19	2	1900	930	-970	0.11	0.49	3	1	-2
0047	3F	20	235	17	1	1700	1100	-600	0.06	0.65	3	1	-2
0047	3F	20	236	18	1	1800	1210	-590	0.06	0.67	3	2	-1
0047	3F	20	245	18	2	1800	1030	-770	0.11	0.57	3	1	-2
0047	3F	20	246	17	1	1700	3460	1760	0.06	2.04	3	6	3
0047	3F	20	256	21	0	2100	0	-2100	0.00	0.00	3	0	-3
0047	3F	21	123	166	43	16600	15150	-1450	0.26	0.91	29	26	-3
0047	3F	21	124	170	40	17000	12220	-4780	0.24	0.72	30	21	-9
0047	3F	21	125	160	27	16000	16490	490	0.17	1.03	28	29	1
0047	3F	21	126	84	11	8400	7510	-890	0.13	0.89	14	13	-1
0047	3F	21	134	139	25	13900	11020	-2880	0.18	0.79	24	19	-5
0047	3F	21	135	109	21	10900	11400	500	0.19	1.05	19	20	1
0047	3F	21	136	60	6	6000	18830	12830	0.10	3.14	10	33	23
0047	3F	21	145	83	8	8300	4170	-4130	0.10	0.50	14	7	-7
0047	3F	21	146	45	7	4500	5890	1390	0.16	1.31	7	10	3
0047	3F	21	156	43	0	4300	0	-4300	0.00	0.00	7	0	-7
0047	3F	21	234	17	1	1700	380	-1320	0.06	0.22	3	0	-3
0047	3F	21	235	21	0	2100	0	-2100	0.00	0.00	3	0	-3
0047	3F	21	236	22	1	2200	220	-1980	0.05	0.10	3	0	-3
0047	3F	21	245	16	1	1600	1450	-150	0.06	0.91	2	2	0
0047	3F	21	246	16	0	1600	0	-1600	0.00	0.00	2	0	-2
0047	3F	21	256	13	2	1300	3490	2190	0.15	2.68	2	6	4
0047	3F	22	123	181	43	18100	18340	240	0.24	1.01	32	32	0
0047	3F	22	124	175	45	17500	22080	4580	0.26	1.26	30	39	9
0047	3F	22	125	121	7	12100	3940	-8160	0.06	0.33	21	6	-15
0047	3F	22	126	80	3	8000	4850	-3150	0.04	0.61	14	8	-6
0047	3F	22	134	102	15	10200	7800	-2400	0.15	0.76	18	13	-5
0047	3F	22	135	80	7	8000	4460	-3540	0.09	0.56	14	7	-7
0047	3F	22	136	58	2	5800	1610	-4190	0.03	0.28	10	2	-8
0047	3F	22	145	50	1	5000	2100	-2900	0.02	0.42	8	3	-5
0047	3F	22	146	45	1	4500	1930	-2570	0.02	0.43	7	3	-4
0047	3F	22	156	26	0	2600	0	-2600	0.00	0.00	4	0	-4
0047	3F	22	234	48	2	4800	2000	-2800	0.04	0.42	8	3	-5
0047	3F	22	235	28	0	2800	0	-2800	0.00	0.00	4	0	-4
0047	3F	22	236	35	0	3500	0	-3500	0.00	0.00	6	0	-6
0047	3F	22	245	28	1	2800	1150	-1650	0.04	0.41	4	2	-2
0047	3F	22	246	22	0	2200	0	-2200	0.00	0.00	3	0	-3
0047	3F	22	256	19	0	1900	0	-1900	0.00	0.00	3	0	-3
0047	3F	23	123	184	42	18400	14780	-3620	0.23	0.80	32	26	-6
0047	3F	23	124	139	21	13900	7850	-6050	0.15	0.56	24	13	-11
0047	3F	23	125	123	15	12300	8230	-4070	0.12	0.67	21	14	-7
0047	3F	23	126	94	7	9400	6510	-2890	0.07	0.69	16	11	-5
0047	3F	23	134	89	9	8900	5310	-3590	0.10	0.60	15	9	-6
0047	3F	23	135	67	9	6700	8500	1800	0.13	1.27	11	15	4
0047	3F	23	136	63	4	6300	3710	-2590	0.06	0.59	11	6	-5
0047	3F	23	145	46	8	4600	6760	2160	0.17	1.47	8	11	3
0047	3F	23	146	48	1	4800	1570	-3230	0.02	0.33	8	2	-6
0047	3F	23	156	31	0	3100	0	-3100	0.00	0.00	5	0	-5
0047	3F	23	234	41	2	4100	1470	-2630	0.05	0.36	7	2	-5
0047	3F	23	235	46	2	4600	1790	-2810	0.04	0.39	8	3	-5
0047	3F	23	236	23	1	2300	1040	-1260	0.04	0.45	4	1	-3
0047	3F	23	245	31	1	3100	480	-2620	0.03	0.15	5	0	-5
0047	3F	23	246	24	1	2400	600	-1800	0.04	0.25	4	1	-3
0047	3F	23	256	27	0	2700	0	-2700	0.00	0.00	4	0	-4
0047	3F	24	123	203	47	20300	15330	-4970	0.23	0.76	35	27	-8
0047	3F	24	124	186	35	18600	16650	-1950	0.19	0.90	32	29	-3
0047	3F	24	125	145	19	14500	7830	-6670	0.13	0.54	25	13	-12
0047	3F	24	126	126	14	12600	7160	-5440	0.11	0.57	22	12	-10
0047	3F	24	134	147	24	14700	11490	-3210	0.16	0.78	26	20	-6
0047	3F	24	135	90	10	9000	11100	2100	0.11	1.23	15	19	4
0047	3F	24	136	85	7	8500	6670	-1830	0.08	0.78	15	11	-4
0047	3F	24	145	95	10	9500	11650	2150	0.11	1.23	16	20	4
0047	3F	24	146	69	3	6900	4010	-2890	0.04	0.58	12	7	-5
0047	3F	24	156	55	4	5500	3470	-2030	0.07	0.63	9	6	-3
0047	3F	24	234	26	2	2600	2830	230	0.08	1.09	4	5	1
0047	3F	24	235	26	0	2600	0	-2600	0.00	0.00	4	0	-4
0047	3F	24	236	21	0	2100	0	-2100	0.00	0.00	3	0	-3
0047	3F	24	245	27	1	2700	9900	7200	0.04	3.67	4	17	13
0047	3F	24	246	18	4	1800	12360	10560	0.22	6.87	3	21	18
0047	3F	24	256	7	0	700	0	-700	0.00	0.00	1	0	-1
0047	3T	01	123	74	5	7400	4360	-3040	0.07	0.59	13	7	-6
0047	3T	01	124	58	2	5800	4600	-1200	0.03	0.79	10	8	-2
0047	3T	01	125	45	0	4500	0	-4500	0.00	0.00	7	0	-7
0047	3T	01	126	34	5	3400	17510	14110	0.15	5.15	6	30	24
0047	3T	01	132	39	3	3900	3290	-610	0.08	0.84	6	5	-1
0047	3T	01	134	44	4	4400	5690	1290	0.09	1.29	7	10	3
0047	3T	01	135	33	6	3300	7210	3910	0.18	2.18	5	12	7
0047	3T	01	136	34	2	3400	11910	8510	0.06	3.50	6	21	15
0047	3T	01	142	36	1	3600	2370	-1230	0.03	0.66	6	4	-2
0047	3T	01	143	33	1	3300	890	-2410	0.03	0.27	5	1	-4
0047	3T	01	145	32	1	3200	5120	1920	0.03	1.60	5	9	4
0047	3T	01	146	31	1	3100	7080	3980	0.03	2.28	5	12	7
0047	3T	01	152	38	1	3800	1220	-2580	0.03	0.32	6	2	-4
0047	3T	01	153	51	2	5100	4570	-530	0.04	0.90	9	8	-1
0047	3T	01	154	34	2	3400	2840	-560	0.06	0.84	6	5	-1
0047	3T	01	156	32	1	3200	2010	-1190	0.03	0.63	5	3	-2
0047	3T	01	162	25	1	2500	2380	-120	0.04	0.95	4	4	0
0047	3T	01	163	26	1	2600	2190	-410	0.04	0.84	4	3	-1
0047	3T	01	164	17	1	1700	1010	-690	0.06	0.59	3	1	-2
0047	3T	01	165	18	0	1800	0	-1800	0.00	0.00	3	0	-3
0047	3T	01	213	31	2	3100	3820	720	0.06	1.23	5	6	1
0047	3T	01	214	36	0	3600	0	-3600	0.00	0.00	6	0	-6
0047	3T	01	215	34	1	3400	9400	6000	0.03	2.76	6	16	10
0047	3T	01	216	22	1	2200	3240	1040	0.05	1.47	3	5	2
0047	3T	01	231	13	0	1300	0	-1300	0.00	0.00	2	0	-2
0047	3T	01	234	29	2	2900	25980	23080	0.07	8.96	5	45	40
0047	3T	01	235	22	1	2200	1220	-980	0.05	0.55	3	2	-1
0047	3T	01	236	24	0	2400	0	-2400	0.00	0.00	4	0	-4
0047	3T	01	241	15	0	1500	0	-1500	0.00	0.00	2	0	-2
0047	3T	01	243	15	0	1500	0	-1500	0.00	0.00	2	0	-2
0047	3T	01	245	8	0	800	0	-800	0.00	0.00	1	0	-1
0047	3T	01	246	18	0	1800	0	-1800	0.00	0.00	3	0	-3
0047	3T	01	251	21	0	2100	0	-2100	0.00	0.00	3	0	-3
0047	3T	01	253	19	0	1900	0	-1900	0.00	0.00	3	0	-3
0047	3T	01	254	11	0	1100	0	-1100	0.00	0.00	1	0	-1
0047	3T	01	256	19	0	1900	0	-1900	0.00	0.00	3	0	-3
0047	3T	01	261	14	0	1400	0	-1400	0.00	0.00	2	0	-2
0047	3T	01	263	15	0	1500	0	-1500	0.00	0.00	2	0	-2
0047	3T	01	264	11	0	1100	0	-1100	0.00	0.00	1	0	-1
0047	3T	01	265	8	0	800	0	-800	0.00	0.00	1	0	-1
0047	3T	02	123	44	1	4400	790	-3610	0.02	0.18	7	1	-6
0047	3T	02	124	48	3	4800	6130	1330	0.06	1.28	8	10	2
0047	3T	02	125	33	5	3300	9030	5730	0.15	2.74	5	15	10
0047	3T	02	126	34	2	3400	3580	180	0.06	1.05	6	6	0
0047	3T	02	132	29	2	2900	1350	-1550	0.07	0.47	5	2	-3
0047	3T	02	134	40	1	4000	560	-3440	0.03	0.14	7	0	-7
0047	3T	02	135	36	1	3600	3160	-440	0.03	0.88	6	5	-1
0047	3T	02	136	24	3	2400	3330	930	0.13	1.39	4	5	1
0047	3T	02	142	25	1	2500	3940	1440	0.04	1.58	4	6	2
0047	3T	02	143	25	2	2500	8920	6420	0.08	3.57	4	15	11
0047	3T	02	145	22	0	2200	0	-2200	0.00	0.00	3	0	-3
0047	3T	02	146	29	1	2900	5800	2900	0.03	2.00	5	10	5
0047	3T	02	152	32	0	3200	0	-3200	0.00	0.00	5	0	-5
0047	3T	02	153	27	1	2700	1790	-910	0.04	0.66	4	3	-1
0047	3T	02	154	33	0	3300	0	-3300	0.00	0.00	5	0	-5
0047	3T	02	156	27	0	2700	0	-2700	0.00	0.00	4	0	-4
0047	3T	02	162	26	0	2600	0	-2600	0.00	0.00	4	0	-4
0047	3T	02	163	24	0	2400	0	-2400	0.00	0.00	4	0	-4
0047	3T	02	164	26	0	2600	0	-2600	0.00	0.00	4	0	-4
0047	3T	02	165	25	1	2500	8020	5520	0.04	3.21	4	14	10
0047	3T	02	213	23	1	2300	3470	1170	0.04	1.51	4	6	2
0047	3T	02	214	23	0	2300	0	-2300	0.00	0.00	4	0	-4
0047	3T	02	215	27	2	2700	4330	1630	0.07	1.60	4	7	3
0047	3T	02	216	24	0	2400	0	-2400	0.00	0.00	4	0	-4
0047	3T	02	231	15	1	1500	4810	3310	0.07	3.21	2	8	6
0047	3T	02	234	12	0	1200	0	-1200	0.00	0.00	2	0	-2
0047	3T	02	235	21	0	2100	0	-2100	0.00	0.00	3	0	-3
0047	3T	02	236	14	0	1400	0	-1400	0.00	0.00	2	0	-2
0047	3T	02	241	9	0	900	0	-900	0.00	0.00	1	0	-1
0047	3T	02	243	16	0	1600	0	-1600	0.00	0.00	2	0	-2
0047	3T	02	245	10	1	1000	1570	570	0.10	1.57	1	2	1
0047	3T	02	246	11	0	1100	0	-1100	0.00	0.00	1	0	-1
0047	3T	02	251	21	0	2100	0	-2100	0.00	0.00	3	0	-3
0047	3T	02	253	26	1	2600	1910	-690	0.04	0.73	4	3	-1
0047	3T	02	254	19	0	1900	0	-1900	0.00	0.00	3	0	-3
0047	3T	02	256	13	0	1300	0	-1300	0.00	0.00	2	0	-2
0047	3T	02	261	19	0	1900	0	-1900	0.00	0.00	3	0	-3
0047	3T	02	263	19	0	1900	0	-1900	0.00	0.00	3	0	-3
0047	3T	02	264	28	0	2800	0	-2800	0.00	0.00	4	0	-4
0047	3T	02	265	11	0	1100	0	-1100	0.00	0.00	1	0	-1
0047	3T	03	123	25	1	2500	1070	-1430	0.04	0.43	4	1	-3
0047	3T	03	124	20	3	2000	1960	-40	0.15	0.98	3	3	0
0047	3T	03	125	22	1	2200	1090	-1110	0.05	0.50	3	1	-2
0047	3T	03	126	11	1	1100	2660	1560	0.09	2.42	1	4	3
0047	3T	03	132	22	1	2200	1170	-1030	0.05	0.53	3	2	-1
0047	3T	03	134	21	1	2100	1440	-660	0.05	0.69	3	2	-1
0047	3T	03	135	18	3	1800	4490	2690	0.17	2.49	3	7	4
0047	3T	03	136	13	0	1300	0	-1300	0.00	0.00	2	0	-2
0047	3T	03	142	22	0	2200	0	-2200	0.00	0.00	3	0	-3
0047	3T	03	143	14	3	1400	4940	3540	0.21	3.53	2	8	6
0047	3T	03	145	17	0	1700	0	-1700	0.00	0.00	3	0	-3
0047	3T	03	146	16	1	1600	9230	7630	0.06	5.77	2	16	14
0047	3T	03	152	19	1	1900	790	-1110	0.05	0.42	3	1	-2
0047	3T	03	153	15	0	1500	0	-1500	0.00	0.00	2	0	-2
0047	3T	03	154	18	0	1800	0	-1800	0.00	0.00	3	0	-3
0047	3T	03	156	18	1	1800	1500	-300	0.06	0.83	3	2	-1
0047	3T	03	162	16	0	1600	0	-1600	0.00	0.00	2	0	-2
0047	3T	03	163	14	0	1400	0	-1400	0.00	0.00	2	0	-2
0047	3T	03	164	10	0	1000	0	-1000	0.00	0.00	1	0	-1
0047	3T	03	165	14	0	1400	0	-1400	0.00	0.00	2	0	-2
0047	3T	03	213	26	2	2600	2400	-200	0.08	0.92	4	4	0
0047	3T	03	214	11	0	1100	0	-1100	0.00	0.00	1	0	-1
0047	3T	03	215	21	0	2100	0	-2100	0.00	0.00	3	0	-3
0047	3T	03	216	26	0	2600	0	-2600	0.00	0.00	4	0	-4
0047	3T	03	231	16	0	1600	0	-1600	0.00	0.00	2	0	-2
0047	3T	03	234	5	0	500	0	-500	0.00	0.00	0	0	0
0047	3T	03	235	8	0	800	0	-800	0.00	0.00	1	0	-1
0047	3T	03	236	16	0	1600	0	-1600	0.00	0.00	2	0	-2
0047	3T	03	241	16	0	1600	0	-1600	0.00	0.00	2	0	-2
0047	3T	03	243	13	0	1300	0	-1300	0.00	0.00	2	0	-2
0047	3T	03	245	8	1	800	26960	26160	0.13	33.70	1	47	46
0047	3T	03	246	6	0	600	0	-600	0.00	0.00	1	0	-1
0047	3T	03	251	22	0	2200	0	-2200	0.00	0.00	3	0	-3
0047	3T	03	253	11	0	1100	0	-1100	0.00	0.00	1	0	-1
0047	3T	03	254	14	2	1400	6810	5410	0.14	4.86	2	12	10
0047	3T	03	256	10	1	1000	1380	380	0.10	1.38	1	2	1
0047	3T	03	261	18	0	1800	0	-1800	0.00	0.00	3	0	-3
0047	3T	03	263	15	0	1500	0	-1500	0.00	0.00	2	0	-2
0047	3T	03	264	9	0	900	0	-900	0.00	0.00	1	0	-1
0047	3T	03	265	19	0	1900	0	-1900	0.00	0.00	3	0	-3
0047	3T	04	123	30	3	3000	1850	-1150	0.10	0.62	5	3	-2
0047	3T	04	124	31	1	3100	690	-2410	0.03	0.22	5	1	-4
0047	3T	04	125	21	1	2100	1880	-220	0.05	0.90	3	3	0
0047	3T	04	126	28	2	2800	6390	3590	0.07	2.28	4	11	7
0047	3T	04	132	16	3	1600	4840	3240	0.19	3.03	2	8	6
0047	3T	04	134	19	2	1900	2340	440	0.11	1.23	3	4	1
0047	3T	04	135	20	2	2000	2380	380	0.10	1.19	3	4	1
0047	3T	04	136	22	1	2200	1670	-530	0.05	0.76	3	2	-1
0047	3T	04	142	29	1	2900	990	-1910	0.03	0.34	5	1	-4
0047	3T	04	143	18	0	1800	0	-1800	0.00	0.00	3	0	-3
0047	3T	04	145	18	0	1800	0	-1800	0.00	0.00	3	0	-3
0047	3T	04	146	14	0	1400	0	-1400	0.00	0.00	2	0	-2
0047	3T	04	152	24	1	2400	3140	740	0.04	1.31	4	5	1
0047	3T	04	153	21	0	2100	0	-2100	0.00	0.00	3	0	-3
0047	3T	04	154	18	0	1800	0	-1800	0.00	0.00	3	0	-3
0047	3T	04	156	18	0	1800	0	-1800	0.00	0.00	3	0	-3
0047	3T	04	162	25	0	2500	0	-2500	0.00	0.00	4	0	-4
0047	3T	04	163	22	0	2200	0	-2200	0.00	0.00	3	0	-3
0047	3T	04	164	12	1	1200	3560	2360	0.08	2.97	2	6	4
0047	3T	04	165	19	0	1900	0	-1900	0.00	0.00	3	0	-3
0047	3T	04	213	24	3	2400	4420	2020	0.13	1.84	4	7	3
0047	3T	04	214	23	1	2300	1250	-1050	0.04	0.54	4	2	-2
0047	3T	04	215	19	1	1900	740	-1160	0.05	0.39	3	1	-2
0047	3T	04	216	18	0	1800	0	-1800	0.00	0.00	3	0	-3
0047	3T	04	231	12	1	1200	17060	15860	0.08	14.22	2	30	28
0047	3T	04	234	13	0	1300	0	-1300	0.00	0.00	2	0	-2
0047	3T	04	235	12	0	1200	0	-1200	0.00	0.00	2	0	-2
0047	3T	04	236	9	0	900	0	-900	0.00	0.00	1	0	-1
0047	3T	04	241	17	0	1700	0	-1700	0.00	0.00	3	0	-3
0047	3T	04	243	9	0	900	0	-900	0.00	0.00	1	0	-1
0047	3T	04	245	8	1	800	1930	1130	0.13	2.41	1	3	2
0047	3T	04	246	18	0	1800	0	-1800	0.00	0.00	3	0	-3
0047	3T	04	251	10	0	1000	0	-1000	0.00	0.00	1	0	-1
0047	3T	04	253	10	0	1000	0	-1000	0.00	0.00	1	0	-1
0047	3T	04	254	12	0	1200	0	-1200	0.00	0.00	2	0	-2
0047	3T	04	256	16	0	1600	0	-1600	0.00	0.00	2	0	-2
0047	3T	04	261	20	0	2000	0	-2000	0.00	0.00	3	0	-3
0047	3T	04	263	20	0	2000	0	-2000	0.00	0.00	3	0	-3
0047	3T	04	264	13	1	1300	7100	5800	0.08	5.46	2	12	10
0047	3T	04	265	9	0	900	0	-900	0.00	0.00	1	0	-1
0047	3T	05	123	43	8	4300	9120	4820	0.19	2.12	7	16	9
0047	3T	05	124	32	3	3200	2460	-740	0.09	0.77	5	4	-1
0047	3T	05	125	21	1	2100	730	-1370	0.05	0.35	3	1	-2
0047	3T	05	126	30	3	3000	3330	330	0.10	1.11	5	5	0
0047	3T	05	132	40	3	4000	3360	-640	0.08	0.84	7	5	-2
0047	3T	05	134	18	1	1800	650	-1150	0.06	0.36	3	1	-2
0047	3T	05	135	23	3	2300	4430	2130	0.13	1.93	4	7	3
0047	3T	05	136	25	1	2500	1020	-1480	0.04	0.41	4	1	-3
0047	3T	05	142	28	4	2800	5900	3100	0.14	2.11	4	10	6
0047	3T	05	143	23	2	2300	1530	-770	0.09	0.67	4	2	-2
0047	3T	05	145	20	1	2000	1450	-550	0.05	0.73	3	2	-1
0047	3T	05	146	29	3	2900	7950	5050	0.10	2.74	5	14	9
0047	3T	05	152	29	2	2900	4780	1880	0.07	1.65	5	8	3
0047	3T	05	153	19	1	1900	3800	1900	0.05	2.00	3	6	3
0047	3T	05	154	12	0	1200	0	-1200	0.00	0.00	2	0	-2
0047	3T	05	156	25	2	2500	5350	2850	0.08	2.14	4	9	5
0047	3T	05	162	21	1	2100	1910	-190	0.05	0.91	3	3	0
0047	3T	05	163	18	0	1800	0	-1800	0.00	0.00	3	0	-3
0047	3T	05	164	16	0	1600	0	-1600	0.00	0.00	2	0	-2
0047	3T	05	165	13	0	1300	0	-1300	0.00	0.00	2	0	-2
0047	3T	05	213	25	0	2500	0	-2500	0.00	0.00	4	0	-4
0047	3T	05	214	14	1	1400	2620	1220	0.07	1.87	2	4	2
0047	3T	05	215	23	1	2300	19630	17330	0.04	8.53	4	34	30
0047	3T	05	216	27	1	2700	9160	6460	0.04	3.39	4	16	12
0047	3T	05	231	18	1	1800	4590	2790	0.06	2.55	3	8	5
0047	3T	05	234	15	2	1500	5470	3970	0.13	3.65	2	9	7
0047	3T	05	235	20	1	2000	1610	-390	0.05	0.81	3	2	-1
0047	3T	05	236	18	0	1800	0	-1800	0.00	0.00	3	0	-3
0047	3T	05	241	18	1	1800	9520	7720	0.06	5.29	3	16	13
0047	3T	05	243	9	0	900	0	-900	0.00	0.00	1	0	-1
0047	3T	05	245	11	0	1100	0	-1100	0.00	0.00	1	0	-1
0047	3T	05	246	6	0	600	0	-600	0.00	0.00	1	0	-1
0047	3T	05	251	20	0	2000	0	-2000	0.00	0.00	3	0	-3
0047	3T	05	253	7	0	700	0	-700	0.00	0.00	1	0	-1
0047	3T	05	254	9	0	900	0	-900	0.00	0.00	1	0	-1
0047	3T	05	256	21	0	2100	0	-2100	0.00	0.00	3	0	-3
0047	3T	05	261	23	0	2300	0	-2300	0.00	0.00	4	0	-4
0047	3T	05	263	16	0	1600	0	-1600	0.00	0.00	2	0	-2
0047	3T	05	264	10	0	1000	0	-1000	0.00	0.00	1	0	-1
0047	3T	05	265	8	0	800	0	-800	0.00	0.00	1	0	-1
0047	3T	06	123	39	6	3900	2970	-930	0.15	0.76	6	5	-1
0047	3T	06	124	41	3	4100	2280	-1820	0.07	0.56	7	4	-3
0047	3T	06	125	34	0	3400	0	-3400	0.00	0.00	6	0	-6
0047	3T	06	126	26	2	2600	4090	1490	0.08	1.57	4	7	3
0047	3T	06	132	34	4	3400	3490	90	0.12	1.03	6	6	0
0047	3T	06	134	35	2	3500	1960	-1540	0.06	0.56	6	3	-3
0047	3T	06	135	34	2	3400	1820	-1580	0.06	0.54	6	3	-3
0047	3T	06	136	36	1	3600	8650	5050	0.03	2.40	6	15	9
0047	3T	06	142	23	1	2300	1290	-1010	0.04	0.56	4	2	-2
0047	3T	06	143	27	0	2700	0	-2700	0.00	0.00	4	0	-4
0047	3T	06	145	28	1	2800	5390	2590	0.04	1.93	4	9	5
0047	3T	06	146	25	2	2500	2410	-90	0.08	0.96	4	4	0
0047	3T	06	152	31	0	3100	0	-3100	0.00	0.00	5	0	-5
0047	3T	06	153	25	1	2500	1600	-900	0.04	0.64	4	2	-2
0047	3T	06	154	27	2	2700	9630	6930	0.07	3.57	4	17	13
0047	3T	06	156	27	1	2700	2070	-630	0.04	0.77	4	3	-1
0047	3T	06	162	29	2	2900	5840	2940	0.07	2.01	5	10	5
0047	3T	06	163	24	0	2400	0	-2400	0.00	0.00	4	0	-4
0047	3T	06	164	25	0	2500	0	-2500	0.00	0.00	4	0	-4
0047	3T	06	165	20	0	2000	0	-2000	0.00	0.00	3	0	-3
0047	3T	06	213	19	1	1900	1000	-900	0.05	0.53	3	1	-2
0047	3T	06	214	23	3	2300	3930	1630	0.13	1.71	4	6	2
0047	3T	06	215	20	2	2000	25650	23650	0.10	12.83	3	45	42
0047	3T	06	216	21	0	2100	0	-2100	0.00	0.00	3	0	-3
0047	3T	06	231	20	0	2000	0	-2000	0.00	0.00	3	0	-3
0047	3T	06	234	11	1	1100	5470	4370	0.09	4.97	1	9	8
0047	3T	06	235	14	0	1400	0	-1400	0.00	0.00	2	0	-2
0047	3T	06	236	11	0	1100	0	-1100	0.00	0.00	1	0	-1
0047	3T	06	241	15	1	1500	2050	550	0.07	1.37	2	3	1
0047	3T	06	243	10	2	1000	3490	2490	0.20	3.49	1	6	5
0047	3T	06	245	13	0	1300	0	-1300	0.00	0.00	2	0	-2
0047	3T	06	246	15	0	1500	0	-1500	0.00	0.00	2	0	-2
0047	3T	06	251	19	0	1900	0	-1900	0.00	0.00	3	0	-3
0047	3T	06	253	8	0	800	0	-800	0.00	0.00	1	0	-1
0047	3T	06	254	7	0	700	0	-700	0.00	0.00	1	0	-1
0047	3T	06	256	14	0	1400	0	-1400	0.00	0.00	2	0	-2
0047	3T	06	261	22	0	2200	0	-2200	0.00	0.00	3	0	-3
0047	3T	06	263	17	0	1700	0	-1700	0.00	0.00	3	0	-3
0047	3T	06	264	18	0	1800	0	-1800	0.00	0.00	3	0	-3
0047	3T	06	265	17	0	1700	0	-1700	0.00	0.00	3	0	-3
0047	3T	07	123	46	0	4600	0	-4600	0.00	0.00	8	0	-8
0047	3T	07	124	47	3	4700	2610	-2090	0.06	0.56	8	4	-4
0047	3T	07	125	26	1	2600	1230	-1370	0.04	0.47	4	2	-2
0047	3T	07	126	36	3	3600	9260	5660	0.08	2.57	6	16	10
0047	3T	07	132	38	4	3800	4010	210	0.11	1.06	6	7	1
0047	3T	07	134	33	4	3300	2880	-420	0.12	0.87	5	5	0
0047	3T	07	135	39	3	3900	4660	760	0.08	1.19	6	8	2
0047	3T	07	136	31	0	3100	0	-3100	0.00	0.00	5	0	-5
0047	3T	07	142	33	0	3300	0	-3300	0.00	0.00	5	0	-5
0047	3T	07	143	37	3	3700	3950	250	0.08	1.07	6	6	0
0047	3T	07	145	32	0	3200	0	-3200	0.00	0.00	5	0	-5
0047	3T	07	146	28	1	2800	860	-1940	0.04	0.31	4	1	-3
0047	3T	07	152	26	0	2600	0	-2600	0.00	0.00	4	0	-4
0047	3T	07	153	27	2	2700	2660	-40	0.07	0.99	4	4	0
0047	3T	07	154	31	2	3100	5460	2360	0.06	1.76	5	9	4
0047	3T	07	156	29	1	2900	3670	770	0.03	1.27	5	6	1
0047	3T	07	162	16	0	1600	0	-1600	0.00	0.00	2	0	-2
0047	3T	07	163	14	2	1400	4250	2850	0.14	3.04	2	7	5
0047	3T	07	164	21	0	2100	0	-2100	0.00	0.00	3	0	-3
0047	3T	07	165	11	0	1100	0	-1100	0.00	0.00	1	0	-1
0047	3T	07	213	18	0	1800	0	-1800	0.00	0.00	3	0	-3
0047	3T	07	214	19	1	1900	1330	-570	0.05	0.70	3	2	-1
0047	3T	07	215	17	1	1700	1800	100	0.06	1.06	3	3	0
0047	3T	07	216	23	0	2300	0	-2300	0.00	0.00	4	0	-4
0047	3T	07	231	18	1	1800	1600	-200	0.06	0.89	3	2	-1
0047	3T	07	234	14	0	1400	0	-1400	0.00	0.00	2	0	-2
0047	3T	07	235	11	0	1100	0	-1100	0.00	0.00	1	0	-1
0047	3T	07	236	12	0	1200	0	-1200	0.00	0.00	2	0	-2
0047	3T	07	241	8	0	800	0	-800	0.00	0.00	1	0	-1
0047	3T	07	243	7	1	700	1070	370	0.14	1.53	1	1	0
0047	3T	07	245	13	1	1300	1230	-70	0.08	0.95	2	2	0
0047	3T	07	246	13	0	1300	0	-1300	0.00	0.00	2	0	-2
0047	3T	07	251	20	0	2000	0	-2000	0.00	0.00	3	0	-3
0047	3T	07	253	14	0	1400	0	-1400	0.00	0.00	2	0	-2
0047	3T	07	254	8	1	800	3220	2420	0.13	4.03	1	5	4
0047	3T	07	256	8	0	800	0	-800	0.00	0.00	1	0	-1
0047	3T	07	261	27	0	2700	0	-2700	0.00	0.00	4	0	-4
0047	3T	07	263	24	1	2400	680	-1720	0.04	0.28	4	1	-3
0047	3T	07	264	13	0	1300	0	-1300	0.00	0.00	2	0	-2
0047	3T	07	265	10	0	1000	0	-1000	0.00	0.00	1	0	-1
0047	3T	08	123	53	6	5300	3740	-1560	0.11	0.71	9	6	-3
0047	3T	08	124	47	5	4700	4580	-120	0.11	0.97	8	8	0
0047	3T	08	125	45	1	4500	660	-3840	0.02	0.15	7	1	-6
0047	3T	08	126	25	0	2500	0	-2500	0.00	0.00	4	0	-4
0047	3T	08	132	38	5	3800	5620	1820	0.13	1.48	6	9	3
0047	3T	08	134	51	6	5100	6930	1830	0.12	1.36	9	12	3
0047	3T	08	135	39	3	3900	4850	950	0.08	1.24	6	8	2
0047	3T	08	136	27	0	2700	0	-2700	0.00	0.00	4	0	-4
0047	3T	08	142	32	1	3200	610	-2590	0.03	0.19	5	1	-4
0047	3T	08	143	28	2	2800	3510	710	0.07	1.25	4	6	2
0047	3T	08	145	35	1	3500	900	-2600	0.03	0.26	6	1	-5
0047	3T	08	146	26	2	2600	2170	-430	0.08	0.83	4	3	-1
0047	3T	08	152	31	0	3100	0	-3100	0.00	0.00	5	0	-5
0047	3T	08	153	25	1	2500	790	-1710	0.04	0.32	4	1	-3
0047	3T	08	154	27	0	2700	0	-2700	0.00	0.00	4	0	-4
0047	3T	08	156	28	1	2800	930	-1870	0.04	0.33	4	1	-3
0047	3T	08	162	20	2	2000	6680	4680	0.10	3.34	3	11	8
0047	3T	08	163	21	0	2100	0	-2100	0.00	0.00	3	0	-3
0047	3T	08	164	26	1	2600	4730	2130	0.04	1.82	4	8	4
0047	3T	08	165	13	0	1300	0	-1300	0.00	0.00	2	0	-2
0047	3T	08	213	15	1	1500	14320	12820	0.07	9.55	2	25	23
0047	3T	08	214	18	0	1800	0	-1800	0.00	0.00	3	0	-3
0047	3T	08	215	25	0	2500	0	-2500	0.00	0.00	4	0	-4
0047	3T	08	216	16	2	1600	3830	2230	0.13	2.39	2	6	4
0047	3T	08	231	11	2	1100	6000	4900	0.18	5.45	1	10	9
0047	3T	08	234	11	0	1100	0	-1100	0.00	0.00	1	0	-1
0047	3T	08	235	8	0	800	0	-800	0.00	0.00	1	0	-1
0047	3T	08	236	11	0	1100	0	-1100	0.00	0.00	1	0	-1
0047	3T	08	241	14	0	1400	0	-1400	0.00	0.00	2	0	-2
0047	3T	08	243	14	1	1400	1380	-20	0.07	0.99	2	2	0
0047	3T	08	245	10	0	1000	0	-1000	0.00	0.00	1	0	-1
0047	3T	08	246	9	0	900	0	-900	0.00	0.00	1	0	-1
0047	3T	08	251	22	0	2200	0	-2200	0.00	0.00	3	0	-3
0047	3T	08	253	13	0	1300	0	-1300	0.00	0.00	2	0	-2
0047	3T	08	254	9	1	900	5630	4730	0.11	6.26	1	9	8
0047	3T	08	256	10	0	1000	0	-1000	0.00	0.00	1	0	-1
0047	3T	08	261	19	0	1900	0	-1900	0.00	0.00	3	0	-3
0047	3T	08	263	16	0	1600	0	-1600	0.00	0.00	2	0	-2
0047	3T	08	264	9	0	900	0	-900	0.00	0.00	1	0	-1
0047	3T	08	265	12	0	1200	0	-1200	0.00	0.00	2	0	-2
0047	3T	09	123	60	10	6000	6190	190	0.17	1.03	10	10	0
0047	3T	09	124	49	7	4900	5700	800	0.14	1.16	8	10	2
0047	3T	09	125	35	2	3500	2880	-620	0.06	0.82	6	5	-1
0047	3T	09	126	48	0	4800	0	-4800	0.00	0.00	8	0	-8
0047	3T	09	132	44	6	4400	4720	320	0.14	1.07	7	8	1
0047	3T	09	134	40	5	4000	4920	920	0.13	1.23	7	8	1
0047	3T	09	135	47	1	4700	1160	-3540	0.02	0.25	8	2	-6
0047	3T	09	136	42	1	4200	1180	-3020	0.02	0.28	7	2	-5
0047	3T	09	142	38	5	3800	7680	3880	0.13	2.02	6	13	7
0047	3T	09	143	34	0	3400	0	-3400	0.00	0.00	6	0	-6
0047	3T	09	145	33	1	3300	2150	-1150	0.03	0.65	5	3	-2
0047	3T	09	146	36	4	3600	8080	4480	0.11	2.24	6	14	8
0047	3T	09	152	34	3	3400	5140	1740	0.09	1.51	6	9	3
0047	3T	09	153	29	0	2900	0	-2900	0.00	0.00	5	0	-5
0047	3T	09	154	33	1	3300	2720	-580	0.03	0.82	5	4	-1
0047	3T	09	156	22	0	2200	0	-2200	0.00	0.00	3	0	-3
0047	3T	09	162	17	0	1700	0	-1700	0.00	0.00	3	0	-3
0047	3T	09	163	27	1	2700	2000	-700	0.04	0.74	4	3	-1
0047	3T	09	164	24	0	2400	0	-2400	0.00	0.00	4	0	-4
0047	3T	09	165	14	0	1400	0	-1400	0.00	0.00	2	0	-2
0047	3T	09	213	25	2	2500	2750	250	0.08	1.10	4	4	0
0047	3T	09	214	23	0	2300	0	-2300	0.00	0.00	4	0	-4
0047	3T	09	215	29	0	2900	0	-2900	0.00	0.00	5	0	-5
0047	3T	09	216	21	1	2100	2160	60	0.05	1.03	3	3	0
0047	3T	09	231	18	1	1800	7850	6050	0.06	4.36	3	13	10
0047	3T	09	234	16	1	1600	1830	230	0.06	1.14	2	3	1
0047	3T	09	235	9	0	900	0	-900	0.00	0.00	1	0	-1
0047	3T	09	236	9	0	900	0	-900	0.00	0.00	1	0	-1
0047	3T	09	241	11	1	1100	6150	5050	0.09	5.59	1	10	9
0047	3T	09	243	10	0	1000	0	-1000	0.00	0.00	1	0	-1
0047	3T	09	245	9	0	900	0	-900	0.00	0.00	1	0	-1
0047	3T	09	246	14	0	1400	0	-1400	0.00	0.00	2	0	-2
0047	3T	09	251	20	0	2000	0	-2000	0.00	0.00	3	0	-3
0047	3T	09	253	21	0	2100	0	-2100	0.00	0.00	3	0	-3
0047	3T	09	254	16	0	1600	0	-1600	0.00	0.00	2	0	-2
0047	3T	09	256	13	0	1300	0	-1300	0.00	0.00	2	0	-2
0047	3T	09	261	26	2	2600	8550	5950	0.08	3.29	4	15	11
0047	3T	09	263	5	0	500	0	-500	0.00	0.00	0	0	0
0047	3T	09	264	10	0	1000	0	-1000	0.00	0.00	1	0	-1
0047	3T	09	265	13	0	1300	0	-1300	0.00	0.00	2	0	-2
0047	3T	10	123	72	11	7200	5710	-1490	0.15	0.79	12	10	-2
0047	3T	10	124	69	2	6900	1330	-5570	0.03	0.19	12	2	-10
0047	3T	10	125	49	3	4900	2350	-2550	0.06	0.48	8	4	-4
0047	3T	10	126	27	2	2700	3240	540	0.07	1.20	4	5	1
0047	3T	10	132	55	6	5500	5630	130	0.11	1.02	9	9	0
0047	3T	10	134	42	4	4200	4490	290	0.10	1.07	7	7	0
0047	3T	10	135	54	4	5400	2760	-2640	0.07	0.51	9	4	-5
0047	3T	10	136	24	0	2400	0	-2400	0.00	0.00	4	0	-4
0047	3T	10	142	38	1	3800	500	-3300	0.03	0.13	6	0	-6
0047	3T	10	143	37	4	3700	7210	3510	0.11	1.95	6	12	6
0047	3T	10	145	43	2	4300	5320	1020	0.05	1.24	7	9	2
0047	3T	10	146	23	2	2300	4800	2500	0.09	2.09	4	8	4
0047	3T	10	152	32	1	3200	720	-2480	0.03	0.23	5	1	-4
0047	3T	10	153	19	0	1900	0	-1900	0.00	0.00	3	0	-3
0047	3T	10	154	26	2	2600	21250	18650	0.08	8.17	4	37	33
0047	3T	10	156	19	1	1900	4670	2770	0.05	2.46	3	8	5
0047	3T	10	162	27	1	2700	2830	130	0.04	1.05	4	5	1
0047	3T	10	163	24	1	2400	3610	1210	0.04	1.50	4	6	2
0047	3T	10	164	14	0	1400	0	-1400	0.00	0.00	2	0	-2
0047	3T	10	165	6	0	600	0	-600	0.00	0.00	1	0	-1
0047	3T	10	213	33	1	3300	810	-2490	0.03	0.25	5	1	-4
0047	3T	10	214	31	2	3100	1780	-1320	0.06	0.57	5	3	-2
0047	3T	10	215	25	2	2500	5670	3170	0.08	2.27	4	10	6
0047	3T	10	216	24	1	2400	7370	4970	0.04	3.07	4	13	9
0047	3T	10	231	19	1	1900	2750	850	0.05	1.45	3	4	1
0047	3T	10	234	9	0	900	0	-900	0.00	0.00	1	0	-1
0047	3T	10	235	15	2	1500	2900	1400	0.13	1.93	2	5	3
0047	3T	10	236	5	0	500	0	-500	0.00	0.00	0	0	0
0047	3T	10	241	17	2	1700	3040	1340	0.12	1.79	3	5	2
0047	3T	10	243	9	0	900	0	-900	0.00	0.00	1	0	-1
0047	3T	10	245	16	0	1600	0	-1600	0.00	0.00	2	0	-2
0047	3T	10	246	6	0	600	0	-600	0.00	0.00	1	0	-1
0047	3T	10	251	20	0	2000	0	-2000	0.00	0.00	3	0	-3
0047	3T	10	253	10	0	1000	0	-1000	0.00	0.00	1	0	-1
0047	3T	10	254	9	0	900	0	-900	0.00	0.00	1	0	-1
0047	3T	10	256	8	0	800	0	-800	0.00	0.00	1	0	-1
0047	3T	10	261	25	3	2500	21160	18660	0.12	8.46	4	37	33
0047	3T	10	263	12	1	1200	4720	3520	0.08	3.93	2	8	6
0047	3T	10	264	4	0	400	0	-400	0.00	0.00	0	0	0
0047	3T	10	265	9	1	900	4630	3730	0.11	5.14	1	8	7
0047	3T	11	123	76	5	7600	4490	-3110	0.07	0.59	13	7	-6
0047	3T	11	124	64	4	6400	3830	-2570	0.06	0.60	11	6	-5
0047	3T	11	125	38	1	3800	910	-2890	0.03	0.24	6	1	-5
0047	3T	11	126	40	1	4000	4100	100	0.03	1.03	7	7	0
0047	3T	11	132	50	2	5000	2560	-2440	0.04	0.51	8	4	-4
0047	3T	11	134	30	0	3000	0	-3000	0.00	0.00	5	0	-5
0047	3T	11	135	24	0	2400	0	-2400	0.00	0.00	4	0	-4
0047	3T	11	136	26	1	2600	2960	360	0.04	1.14	4	5	1
0047	3T	11	142	50	1	5000	2590	-2410	0.02	0.52	8	4	-4
0047	3T	11	143	44	2	4400	2070	-2330	0.05	0.47	7	3	-4
0047	3T	11	145	23	1	2300	1620	-680	0.04	0.70	4	2	-2
0047	3T	11	146	39	0	3900	0	-3900	0.00	0.00	6	0	-6
0047	3T	11	152	23	0	2300	0	-2300	0.00	0.00	4	0	-4
0047	3T	11	153	22	1	2200	3870	1670	0.05	1.76	3	6	3
0047	3T	11	154	25	0	2500	0	-2500	0.00	0.00	4	0	-4
0047	3T	11	156	30	0	3000	0	-3000	0.00	0.00	5	0	-5
0047	3T	11	162	16	0	1600	0	-1600	0.00	0.00	2	0	-2
0047	3T	11	163	15	0	1500	0	-1500	0.00	0.00	2	0	-2
0047	3T	11	164	21	0	2100	0	-2100	0.00	0.00	3	0	-3
0047	3T	11	165	18	0	1800	0	-1800	0.00	0.00	3	0	-3
0047	3T	11	213	31	1	3100	1960	-1140	0.03	0.63	5	3	-2
0047	3T	11	214	41	3	4100	5380	1280	0.07	1.31	7	9	2
0047	3T	11	215	27	0	2700	0	-2700	0.00	0.00	4	0	-4
0047	3T	11	216	25	1	2500	2160	-340	0.04	0.86	4	3	-1
0047	3T	11	231	17	0	1700	0	-1700	0.00	0.00	3	0	-3
0047	3T	11	234	26	0	2600	0	-2600	0.00	0.00	4	0	-4
0047	3T	11	235	10	0	1000	0	-1000	0.00	0.00	1	0	-1
0047	3T	11	236	20	1	2000	1860	-140	0.05	0.93	3	3	0
0047	3T	11	241	19	0	1900	0	-1900	0.00	0.00	3	0	-3
0047	3T	11	243	28	0	2800	0	-2800	0.00	0.00	4	0	-4
0047	3T	11	245	17	0	1700	0	-1700	0.00	0.00	3	0	-3
0047	3T	11	246	11	0	1100	0	-1100	0.00	0.00	1	0	-1
0047	3T	11	251	18	0	1800	0	-1800	0.00	0.00	3	0	-3
0047	3T	11	253	21	0	2100	0	-2100	0.00	0.00	3	0	-3
0047	3T	11	254	17	0	1700	0	-1700	0.00	0.00	3	0	-3
0047	3T	11	256	23	0	2300	0	-2300	0.00	0.00	4	0	-4
0047	3T	11	261	10	0	1000	0	-1000	0.00	0.00	1	0	-1
0047	3T	11	263	11	0	1100	0	-1100	0.00	0.00	1	0	-1
0047	3T	11	264	13	0	1300	0	-1300	0.00	0.00	2	0	-2
0047	3T	11	265	10	0	1000	0	-1000	0.00	0.00	1	0	-1
0047	3T	12	123	68	11	6800	16970	10170	0.16	2.50	12	30	18
0047	3T	12	124	59	1	5900	1200	-4700	0.02	0.20	10	2	-8
0047	3T	12	125	35	2	3500	2540	-960	0.06	0.73	6	4	-2
0047	3T	12	126	58	6	5800	8960	3160	0.10	1.54	10	15	5
0047	3T	12	132	42	4	4200	3540	-660	0.10	0.84	7	6	-1
0047	3T	12	134	58	6	5800	4520	-1280	0.10	0.78	10	8	-2
0047	3T	12	135	34	2	3400	1520	-1880	0.06	0.45	6	2	-4
0047	3T	12	136	40	3	4000	4300	300	0.08	1.08	7	7	0
0047	3T	12	142	27	2	2700	1930	-770	0.07	0.71	4	3	-1
0047	3T	12	143	34	2	3400	3080	-320	0.06	0.91	6	5	-1
0047	3T	12	145	28	2	2800	2300	-500	0.07	0.82	4	4	0
0047	3T	12	146	26	1	2600	850	-1750	0.04	0.33	4	1	-3
0047	3T	12	152	27	1	2700	1750	-950	0.04	0.65	4	3	-1
0047	3T	12	153	29	0	2900	0	-2900	0.00	0.00	5	0	-5
0047	3T	12	154	34	0	3400	0	-3400	0.00	0.00	6	0	-6
0047	3T	12	156	37	1	3700	14780	11080	0.03	3.99	6	26	20
0047	3T	12	162	37	1	3700	2660	-1040	0.03	0.72	6	4	-2
0047	3T	12	163	31	2	3100	2560	-540	0.06	0.83	5	4	-1
0047	3T	12	164	30	2	3000	3840	840	0.07	1.28	5	6	1
0047	3T	12	165	25	0	2500	0	-2500	0.00	0.00	4	0	-4
0047	3T	12	213	30	0	3000	0	-3000	0.00	0.00	5	0	-5
0047	3T	12	214	22	0	2200	0	-2200	0.00	0.00	3	0	-3
0047	3T	12	215	21	0	2100	0	-2100	0.00	0.00	3	0	-3
0047	3T	12	216	22	0	2200	0	-2200	0.00	0.00	3	0	-3
0047	3T	12	231	29	0	2900	0	-2900	0.00	0.00	5	0	-5
0047	3T	12	234	24	1	2400	1020	-1380	0.04	0.43	4	1	-3
0047	3T	12	235	19	1	1900	1650	-250	0.05	0.87	3	2	-1
0047	3T	12	236	16	0	1600	0	-1600	0.00	0.00	2	0	-2
0047	3T	12	241	22	0	2200	0	-2200	0.00	0.00	3	0	-3
0047	3T	12	243	18	0	1800	0	-1800	0.00	0.00	3	0	-3
0047	3T	12	245	18	0	1800	0	-1800	0.00	0.00	3	0	-3
0047	3T	12	246	21	0	2100	0	-2100	0.00	0.00	3	0	-3
0047	3T	12	251	14	0	1400	0	-1400	0.00	0.00	2	0	-2
0047	3T	12	253	23	1	2300	2880	580	0.04	1.25	4	5	1
0047	3T	12	254	8	0	800	0	-800	0.00	0.00	1	0	-1
0047	3T	12	256	10	0	1000	0	-1000	0.00	0.00	1	0	-1
0047	3T	12	261	27	0	2700	0	-2700	0.00	0.00	4	0	-4
0047	3T	12	263	22	0	2200	0	-2200	0.00	0.00	3	0	-3
0047	3T	12	264	10	0	1000	0	-1000	0.00	0.00	1	0	-1
0047	3T	12	265	15	0	1500	0	-1500	0.00	0.00	2	0	-2
0047	3T	13	123	51	6	5100	4480	-620	0.12	0.88	9	7	-2
0047	3T	13	124	60	12	6000	8290	2290	0.20	1.38	10	14	4
0047	3T	13	125	48	2	4800	2560	-2240	0.04	0.53	8	4	-4
0047	3T	13	126	49	2	4900	5040	140	0.04	1.03	8	8	0
0047	3T	13	132	47	6	4700	5820	1120	0.13	1.24	8	10	2
0047	3T	13	134	53	3	5300	3260	-2040	0.06	0.62	9	5	-4
0047	3T	13	135	39	1	3900	970	-2930	0.03	0.25	6	1	-5
0047	3T	13	136	27	3	2700	2220	-480	0.11	0.82	4	3	-1
0047	3T	13	142	49	3	4900	2980	-1920	0.06	0.61	8	5	-3
0047	3T	13	143	47	1	4700	1130	-3570	0.02	0.24	8	2	-6
0047	3T	13	145	50	3	5000	5400	400	0.06	1.08	8	9	1
0047	3T	13	146	30	1	3000	2170	-830	0.03	0.72	5	3	-2
0047	3T	13	152	28	2	2800	2640	-160	0.07	0.94	4	4	0
0047	3T	13	153	22	0	2200	0	-2200	0.00	0.00	3	0	-3
0047	3T	13	154	21	0	2100	0	-2100	0.00	0.00	3	0	-3
0047	3T	13	156	24	0	2400	0	-2400	0.00	0.00	4	0	-4
0047	3T	13	162	28	0	2800	0	-2800	0.00	0.00	4	0	-4
0047	3T	13	163	33	0	3300	0	-3300	0.00	0.00	5	0	-5
0047	3T	13	164	23	0	2300	0	-2300	0.00	0.00	4	0	-4
0047	3T	13	165	18	0	1800	0	-1800	0.00	0.00	3	0	-3
0047	3T	13	213	21	4	2100	8490	6390	0.19	4.04	3	15	12
0047	3T	13	214	25	0	2500	0	-2500	0.00	0.00	4	0	-4
0047	3T	13	215	24	2	2400	6330	3930	0.08	2.64	4	11	7
0047	3T	13	216	24	0	2400	0	-2400	0.00	0.00	4	0	-4
0047	3T	13	231	20	0	2000	0	-2000	0.00	0.00	3	0	-3
0047	3T	13	234	28	1	2800	3840	1040	0.04	1.37	4	6	2
0047	3T	13	235	12	0	1200	0	-1200	0.00	0.00	2	0	-2
0047	3T	13	236	12	0	1200	0	-1200	0.00	0.00	2	0	-2
0047	3T	13	241	17	0	1700	0	-1700	0.00	0.00	3	0	-3
0047	3T	13	243	18	0	1800	0	-1800	0.00	0.00	3	0	-3
0047	3T	13	245	18	0	1800	0	-1800	0.00	0.00	3	0	-3
0047	3T	13	246	13	0	1300	0	-1300	0.00	0.00	2	0	-2
0047	3T	13	251	9	0	900	0	-900	0.00	0.00	1	0	-1
0047	3T	13	253	12	0	1200	0	-1200	0.00	0.00	2	0	-2
0047	3T	13	254	9	0	900	0	-900	0.00	0.00	1	0	-1
0047	3T	13	256	15	0	1500	0	-1500	0.00	0.00	2	0	-2
0047	3T	13	261	12	0	1200	0	-1200	0.00	0.00	2	0	-2
0047	3T	13	263	17	1	1700	1870	170	0.06	1.10	3	3	0
0047	3T	13	264	16	0	1600	0	-1600	0.00	0.00	2	0	-2
0047	3T	13	265	16	0	1600	0	-1600	0.00	0.00	2	0	-2
0047	3T	14	123	40	3	4000	2570	-1430	0.08	0.64	7	4	-3
0047	3T	14	124	36	2	3600	990	-2610	0.06	0.28	6	1	-5
0047	3T	14	125	35	1	3500	1550	-1950	0.03	0.44	6	2	-4
0047	3T	14	126	17	0	1700	0	-1700	0.00	0.00	3	0	-3
0047	3T	14	132	32	0	3200	0	-3200	0.00	0.00	5	0	-5
0047	3T	14	134	36	4	3600	2790	-810	0.11	0.78	6	4	-2
0047	3T	14	135	31	1	3100	8090	4990	0.03	2.61	5	14	9
0047	3T	14	136	23	2	2300	2290	-10	0.09	1.00	4	4	0
0047	3T	14	142	38	3	3800	4520	720	0.08	1.19	6	8	2
0047	3T	14	143	41	2	4100	3620	-480	0.05	0.88	7	6	-1
0047	3T	14	145	25	2	2500	5940	3440	0.08	2.38	4	10	6
0047	3T	14	146	29	2	2900	2780	-120	0.07	0.96	5	4	-1
0047	3T	14	152	26	2	2600	3920	1320	0.08	1.51	4	6	2
0047	3T	14	153	25	0	2500	0	-2500	0.00	0.00	4	0	-4
0047	3T	14	154	28	0	2800	0	-2800	0.00	0.00	4	0	-4
0047	3T	14	156	24	1	2400	5480	3080	0.04	2.28	4	9	5
0047	3T	14	162	18	2	1800	2230	430	0.11	1.24	3	3	0
0047	3T	14	163	24	0	2400	0	-2400	0.00	0.00	4	0	-4
0047	3T	14	164	16	0	1600	0	-1600	0.00	0.00	2	0	-2
0047	3T	14	165	15	0	1500	0	-1500	0.00	0.00	2	0	-2
0047	3T	14	213	16	0	1600	0	-1600	0.00	0.00	2	0	-2
0047	3T	14	214	29	4	2900	16120	13220	0.14	5.56	5	28	23
0047	3T	14	215	16	0	1600	0	-1600	0.00	0.00	2	0	-2
0047	3T	14	216	27	0	2700	0	-2700	0.00	0.00	4	0	-4
0047	3T	14	231	19	0	1900	0	-1900	0.00	0.00	3	0	-3
0047	3T	14	234	18	0	1800	0	-1800	0.00	0.00	3	0	-3
0047	3T	14	235	15	0	1500	0	-1500	0.00	0.00	2	0	-2
0047	3T	14	236	23	0	2300	0	-2300	0.00	0.00	4	0	-4
0047	3T	14	241	18	0	1800	0	-1800	0.00	0.00	3	0	-3
0047	3T	14	243	16	0	1600	0	-1600	0.00	0.00	2	0	-2
0047	3T	14	245	15	0	1500	0	-1500	0.00	0.00	2	0	-2
0047	3T	14	246	13	0	1300	0	-1300	0.00	0.00	2	0	-2
0047	3T	14	251	27	0	2700	0	-2700	0.00	0.00	4	0	-4
0047	3T	14	253	13	0	1300	0	-1300	0.00	0.00	2	0	-2
0047	3T	14	254	15	0	1500	0	-1500	0.00	0.00	2	0	-2
0047	3T	14	256	15	0	1500	0	-1500	0.00	0.00	2	0	-2
0047	3T	14	261	15	0	1500	0	-1500	0.00	0.00	2	0	-2
0047	3T	14	263	7	0	700	0	-700	0.00	0.00	1	0	-1
0047	3T	14	264	13	1	1300	2230	930	0.08	1.72	2	3	1
0047	3T	14	265	11	0	1100	0	-1100	0.00	0.00	1	0	-1
0047	3T	15	123	63	2	6300	800	-5500	0.03	0.13	11	1	-10
0047	3T	15	124	75	6	7500	3760	-3740	0.08	0.50	13	6	-7
0047	3T	15	125	33	1	3300	1280	-2020	0.03	0.39	5	2	-3
0047	3T	15	126	31	5	3100	4530	1430	0.16	1.46	5	8	3
0047	3T	15	132	45	8	4500	8310	3810	0.18	1.85	7	14	7
0047	3T	15	134	41	4	4100	5350	1250	0.10	1.30	7	9	2
0047	3T	15	135	22	1	2200	1630	-570	0.05	0.74	3	2	-1
0047	3T	15	136	31	1	3100	1640	-1460	0.03	0.53	5	2	-3
0047	3T	15	142	56	6	5600	4230	-1370	0.11	0.76	9	7	-2
0047	3T	15	143	51	4	5100	4490	-610	0.08	0.88	9	7	-2
0047	3T	15	145	45	3	4500	6380	1880	0.07	1.42	7	11	4
0047	3T	15	146	30	1	3000	2160	-840	0.03	0.72	5	3	-2
0047	3T	15	152	29	1	2900	2280	-620	0.03	0.79	5	4	-1
0047	3T	15	153	27	0	2700	0	-2700	0.00	0.00	4	0	-4
0047	3T	15	154	38	0	3800	0	-3800	0.00	0.00	6	0	-6
0047	3T	15	156	35	1	3500	4000	500	0.03	1.14	6	7	1
0047	3T	15	162	25	1	2500	4190	1690	0.04	1.68	4	7	3
0047	3T	15	163	27	0	2700	0	-2700	0.00	0.00	4	0	-4
0047	3T	15	164	20	1	2000	2190	190	0.05	1.10	3	3	0
0047	3T	15	165	8	0	800	0	-800	0.00	0.00	1	0	-1
0047	3T	15	213	30	2	3000	6380	3380	0.07	2.13	5	11	6
0047	3T	15	214	21	3	2100	4770	2670	0.14	2.27	3	8	5
0047	3T	15	215	23	1	2300	1230	-1070	0.04	0.53	4	2	-2
0047	3T	15	216	24	0	2400	0	-2400	0.00	0.00	4	0	-4
0047	3T	15	231	9	0	900	0	-900	0.00	0.00	1	0	-1
0047	3T	15	234	11	0	1100	0	-1100	0.00	0.00	1	0	-1
0047	3T	15	235	14	0	1400	0	-1400	0.00	0.00	2	0	-2
0047	3T	15	236	12	0	1200	0	-1200	0.00	0.00	2	0	-2
0047	3T	15	241	15	0	1500	0	-1500	0.00	0.00	2	0	-2
0047	3T	15	243	13	0	1300	0	-1300	0.00	0.00	2	0	-2
0047	3T	15	245	16	0	1600	0	-1600	0.00	0.00	2	0	-2
0047	3T	15	246	12	1	1200	1540	340	0.08	1.28	2	2	0
0047	3T	15	251	20	0	2000	0	-2000	0.00	0.00	3	0	-3
0047	3T	15	253	11	0	1100	0	-1100	0.00	0.00	1	0	-1
0047	3T	15	254	13	0	1300	0	-1300	0.00	0.00	2	0	-2
0047	3T	15	256	16	0	1600	0	-1600	0.00	0.00	2	0	-2
0047	3T	15	261	22	0	2200	0	-2200	0.00	0.00	3	0	-3
0047	3T	15	263	16	0	1600	0	-1600	0.00	0.00	2	0	-2
0047	3T	15	264	8	0	800	0	-800	0.00	0.00	1	0	-1
0047	3T	15	265	16	0	1600	0	-1600	0.00	0.00	2	0	-2
0047	3T	16	123	85	17	8500	10200	1700	0.20	1.20	15	18	3
0047	3T	16	124	72	8	7200	12050	4850	0.11	1.67	12	21	9
0047	3T	16	125	50	2	5000	3410	-1590	0.04	0.68	8	6	-2
0047	3T	16	126	57	1	5700	3360	-2340	0.02	0.59	10	5	-5
0047	3T	16	132	52	2	5200	1340	-3860	0.04	0.26	9	2	-7
0047	3T	16	134	68	2	6800	1600	-5200	0.03	0.24	12	2	-10
0047	3T	16	135	44	3	4400	2580	-1820	0.07	0.59	7	4	-3
0047	3T	16	136	33	0	3300	0	-3300	0.00	0.00	5	0	-5
0047	3T	16	142	62	6	6200	7240	1040	0.10	1.17	10	12	2
0047	3T	16	143	46	4	4600	4170	-430	0.09	0.91	8	7	-1
0047	3T	16	145	52	2	5200	1750	-3450	0.04	0.34	9	3	-6
0047	3T	16	146	33	3	3300	3790	490	0.09	1.15	5	6	1
0047	3T	16	152	30	0	3000	0	-3000	0.00	0.00	5	0	-5
0047	3T	16	153	29	0	2900	0	-2900	0.00	0.00	5	0	-5
0047	3T	16	154	33	0	3300	0	-3300	0.00	0.00	5	0	-5
0047	3T	16	156	24	1	2400	7190	4790	0.04	3.00	4	12	8
0047	3T	16	162	20	1	2000	2080	80	0.05	1.04	3	3	0
0047	3T	16	163	22	0	2200	0	-2200	0.00	0.00	3	0	-3
0047	3T	16	164	23	0	2300	0	-2300	0.00	0.00	4	0	-4
0047	3T	16	165	17	0	1700	0	-1700	0.00	0.00	3	0	-3
0047	3T	16	213	27	2	2700	2170	-530	0.07	0.80	4	3	-1
0047	3T	16	214	26	0	2600	0	-2600	0.00	0.00	4	0	-4
0047	3T	16	215	21	1	2100	3990	1890	0.05	1.90	3	7	4
0047	3T	16	216	19	1	1900	960	-940	0.05	0.51	3	1	-2
0047	3T	16	231	12	0	1200	0	-1200	0.00	0.00	2	0	-2
0047	3T	16	234	12	0	1200	0	-1200	0.00	0.00	2	0	-2
0047	3T	16	235	13	0	1300	0	-1300	0.00	0.00	2	0	-2
0047	3T	16	236	21	0	2100	0	-2100	0.00	0.00	3	0	-3
0047	3T	16	241	22	2	2200	5060	2860	0.09	2.30	3	8	5
0047	3T	16	243	10	0	1000	0	-1000	0.00	0.00	1	0	-1
0047	3T	16	245	8	0	800	0	-800	0.00	0.00	1	0	-1
0047	3T	16	246	12	0	1200	0	-1200	0.00	0.00	2	0	-2
0047	3T	16	251	20	0	2000	0	-2000	0.00	0.00	3	0	-3
0047	3T	16	253	12	0	1200	0	-1200	0.00	0.00	2	0	-2
0047	3T	16	254	7	0	700	0	-700	0.00	0.00	1	0	-1
0047	3T	16	256	9	0	900	0	-900	0.00	0.00	1	0	-1
0047	3T	16	261	18	0	1800	0	-1800	0.00	0.00	3	0	-3
0047	3T	16	263	12	0	1200	0	-1200	0.00	0.00	2	0	-2
0047	3T	16	264	15	1	1500	1770	270	0.07	1.18	2	3	1
0047	3T	16	265	9	0	900	0	-900	0.00	0.00	1	0	-1
0047	3T	17	123	76	9	7600	4280	-3320	0.12	0.56	13	7	-6
0047	3T	17	124	60	4	6000	3190	-2810	0.07	0.53	10	5	-5
0047	3T	17	125	45	3	4500	2850	-1650	0.07	0.63	7	5	-2
0047	3T	17	126	43	3	4300	2910	-1390	0.07	0.68	7	5	-2
0047	3T	17	132	59	10	5900	10890	4990	0.17	1.85	10	19	9
0047	3T	17	134	48	7	4800	4880	80	0.15	1.02	8	8	0
0047	3T	17	135	42	2	4200	2580	-1620	0.05	0.61	7	4	-3
0047	3T	17	136	34	4	3400	10180	6780	0.12	2.99	6	18	12
0047	3T	17	142	52	3	5200	5910	710	0.06	1.14	9	10	1
0047	3T	17	143	57	1	5700	2790	-2910	0.02	0.49	10	4	-6
0047	3T	17	145	50	2	5000	3520	-1480	0.04	0.70	8	6	-2
0047	3T	17	146	34	2	3400	4020	620	0.06	1.18	6	7	1
0047	3T	17	152	32	3	3200	3470	270	0.09	1.08	5	6	1
0047	3T	17	153	26	0	2600	0	-2600	0.00	0.00	4	0	-4
0047	3T	17	154	27	0	2700	0	-2700	0.00	0.00	4	0	-4
0047	3T	17	156	21	1	2100	3760	1660	0.05	1.79	3	6	3
0047	3T	17	162	24	1	2400	3340	940	0.04	1.39	4	5	1
0047	3T	17	163	28	0	2800	0	-2800	0.00	0.00	4	0	-4
0047	3T	17	164	22	0	2200	0	-2200	0.00	0.00	3	0	-3
0047	3T	17	165	19	0	1900	0	-1900	0.00	0.00	3	0	-3
0047	3T	17	213	33	1	3300	3280	-20	0.03	0.99	5	5	0
0047	3T	17	214	22	2	2200	2720	520	0.09	1.24	3	4	1
0047	3T	17	215	24	1	2400	710	-1690	0.04	0.30	4	1	-3
0047	3T	17	216	22	0	2200	0	-2200	0.00	0.00	3	0	-3
0047	3T	17	231	19	0	1900	0	-1900	0.00	0.00	3	0	-3
0047	3T	17	234	26	1	2600	830	-1770	0.04	0.32	4	1	-3
0047	3T	17	235	14	0	1400	0	-1400	0.00	0.00	2	0	-2
0047	3T	17	236	15	0	1500	0	-1500	0.00	0.00	2	0	-2
0047	3T	17	241	12	0	1200	0	-1200	0.00	0.00	2	0	-2
0047	3T	17	243	14	0	1400	0	-1400	0.00	0.00	2	0	-2
0047	3T	17	245	13	0	1300	0	-1300	0.00	0.00	2	0	-2
0047	3T	17	246	20	0	2000	0	-2000	0.00	0.00	3	0	-3
0047	3T	17	251	23	0	2300	0	-2300	0.00	0.00	4	0	-4
0047	3T	17	253	6	0	600	0	-600	0.00	0.00	1	0	-1
0047	3T	17	254	15	0	1500	0	-1500	0.00	0.00	2	0	-2
0047	3T	17	256	11	0	1100	0	-1100	0.00	0.00	1	0	-1
0047	3T	17	261	25	0	2500	0	-2500	0.00	0.00	4	0	-4
0047	3T	17	263	19	0	1900	0	-1900	0.00	0.00	3	0	-3
0047	3T	17	264	12	0	1200	0	-1200	0.00	0.00	2	0	-2
0047	3T	17	265	9	0	900	0	-900	0.00	0.00	1	0	-1
0047	3T	18	123	92	12	9200	8930	-270	0.13	0.97	16	15	-1
0047	3T	18	124	82	6	8200	2660	-5540	0.07	0.32	14	4	-10
0047	3T	18	125	80	6	8000	5400	-2600	0.08	0.68	14	9	-5
0047	3T	18	126	63	5	6300	6090	-210	0.08	0.97	11	10	-1
0047	3T	18	132	61	3	6100	3450	-2650	0.05	0.57	10	6	-4
0047	3T	18	134	67	7	6700	4870	-1830	0.10	0.73	11	8	-3
0047	3T	18	135	85	2	8500	1090	-7410	0.02	0.13	15	1	-14
0047	3T	18	136	38	0	3800	0	-3800	0.00	0.00	6	0	-6
0047	3T	18	142	61	7	6100	7130	1030	0.11	1.17	10	12	2
0047	3T	18	143	53	4	5300	5430	130	0.08	1.02	9	9	0
0047	3T	18	145	59	1	5900	800	-5100	0.02	0.14	10	1	-9
0047	3T	18	146	42	4	4200	14690	10490	0.10	3.50	7	26	19
0047	3T	18	152	47	2	4700	2820	-1880	0.04	0.60	8	4	-4
0047	3T	18	153	37	3	3700	4070	370	0.08	1.10	6	7	1
0047	3T	18	154	48	2	4800	4040	-760	0.04	0.84	8	7	-1
0047	3T	18	156	25	2	2500	7400	4900	0.08	2.96	4	13	9
0047	3T	18	162	16	0	1600	0	-1600	0.00	0.00	2	0	-2
0047	3T	18	163	20	0	2000	0	-2000	0.00	0.00	3	0	-3
0047	3T	18	164	20	0	2000	0	-2000	0.00	0.00	3	0	-3
0047	3T	18	165	13	0	1300	0	-1300	0.00	0.00	2	0	-2
0047	3T	18	213	27	0	2700	0	-2700	0.00	0.00	4	0	-4
0047	3T	18	214	18	1	1800	1620	-180	0.06	0.90	3	2	-1
0047	3T	18	215	20	2	2000	2090	90	0.10	1.05	3	3	0
0047	3T	18	216	14	1	1400	1440	40	0.07	1.03	2	2	0
0047	3T	18	231	13	0	1300	0	-1300	0.00	0.00	2	0	-2
0047	3T	18	234	10	0	1000	0	-1000	0.00	0.00	1	0	-1
0047	3T	18	235	15	1	1500	1780	280	0.07	1.19	2	3	1
0047	3T	18	236	10	0	1000	0	-1000	0.00	0.00	1	0	-1
0047	3T	18	241	18	0	1800	0	-1800	0.00	0.00	3	0	-3
0047	3T	18	243	12	0	1200	0	-1200	0.00	0.00	2	0	-2
0047	3T	18	245	16	0	1600	0	-1600	0.00	0.00	2	0	-2
0047	3T	18	246	16	0	1600	0	-1600	0.00	0.00	2	0	-2
0047	3T	18	251	24	0	2400	0	-2400	0.00	0.00	4	0	-4
0047	3T	18	253	10	0	1000	0	-1000	0.00	0.00	1	0	-1
0047	3T	18	254	11	0	1100	0	-1100	0.00	0.00	1	0	-1
0047	3T	18	256	7	0	700	0	-700	0.00	0.00	1	0	-1
0047	3T	18	261	23	0	2300	0	-2300	0.00	0.00	4	0	-4
0047	3T	18	263	12	0	1200	0	-1200	0.00	0.00	2	0	-2
0047	3T	18	264	15	1	1500	2840	1340	0.07	1.89	2	5	3
0047	3T	18	265	7	0	700	0	-700	0.00	0.00	1	0	-1
0047	3T	19	123	82	6	8200	4670	-3530	0.07	0.57	14	8	-6
0047	3T	19	124	74	11	7400	11250	3850	0.15	1.52	13	19	6
0047	3T	19	125	42	4	4200	2910	-1290	0.10	0.69	7	5	-2
0047	3T	19	126	42	2	4200	4000	-200	0.05	0.95	7	7	0
0047	3T	19	132	55	7	5500	10540	5040	0.13	1.92	9	18	9
0047	3T	19	134	57	11	5700	9550	3850	0.19	1.68	10	16	6
0047	3T	19	135	27	1	2700	440	-2260	0.04	0.16	4	0	-4
0047	3T	19	136	37	1	3700	1140	-2560	0.03	0.31	6	2	-4
0047	3T	19	142	72	11	7200	8380	1180	0.15	1.16	12	14	2
0047	3T	19	143	54	4	5400	5850	450	0.07	1.08	9	10	1
0047	3T	19	145	37	3	3700	6330	2630	0.08	1.71	6	11	5
0047	3T	19	146	31	2	3100	1880	-1220	0.06	0.61	5	3	-2
0047	3T	19	152	28	3	2800	6550	3750	0.11	2.34	4	11	7
0047	3T	19	153	24	0	2400	0	-2400	0.00	0.00	4	0	-4
0047	3T	19	154	21	1	2100	1930	-170	0.05	0.92	3	3	0
0047	3T	19	156	20	0	2000	0	-2000	0.00	0.00	3	0	-3
0047	3T	19	162	19	2	1900	5850	3950	0.11	3.08	3	10	7
0047	3T	19	163	16	1	1600	6760	5160	0.06	4.23	2	11	9
0047	3T	19	164	21	1	2100	2260	160	0.05	1.08	3	4	1
0047	3T	19	165	9	0	900	0	-900	0.00	0.00	1	0	-1
0047	3T	19	213	18	1	1800	6340	4540	0.06	3.52	3	11	8
0047	3T	19	214	13	1	1300	6720	5420	0.08	5.17	2	11	9
0047	3T	19	215	17	0	1700	0	-1700	0.00	0.00	3	0	-3
0047	3T	19	216	16	1	1600	920	-680	0.06	0.58	2	1	-1
0047	3T	19	231	18	2	1800	2890	1090	0.11	1.61	3	5	2
0047	3T	19	234	17	1	1700	4310	2610	0.06	2.54	3	7	4
0047	3T	19	235	13	0	1300	0	-1300	0.00	0.00	2	0	-2
0047	3T	19	236	22	1	2200	1270	-930	0.05	0.58	3	2	-1
0047	3T	19	241	20	0	2000	0	-2000	0.00	0.00	3	0	-3
0047	3T	19	243	8	0	800	0	-800	0.00	0.00	1	0	-1
0047	3T	19	245	7	0	700	0	-700	0.00	0.00	1	0	-1
0047	3T	19	246	7	0	700	0	-700	0.00	0.00	1	0	-1
0047	3T	19	251	13	0	1300	0	-1300	0.00	0.00	2	0	-2
0047	3T	19	253	4	0	400	0	-400	0.00	0.00	0	0	0
0047	3T	19	254	6	0	600	0	-600	0.00	0.00	1	0	-1
0047	3T	19	256	11	0	1100	0	-1100	0.00	0.00	1	0	-1
0047	3T	19	261	20	1	2000	5250	3250	0.05	2.63	3	9	6
0047	3T	19	263	7	2	700	13720	13020	0.29	19.60	1	24	23
0047	3T	19	264	9	0	900	0	-900	0.00	0.00	1	0	-1
0047	3T	19	265	7	0	700	0	-700	0.00	0.00	1	0	-1
0047	3T	20	123	64	8	6400	4490	-1910	0.13	0.70	11	7	-4
0047	3T	20	124	68	3	6800	2130	-4670	0.04	0.31	12	3	-9
0047	3T	20	125	52	3	5200	4880	-320	0.06	0.94	9	8	-1
0047	3T	20	126	47	4	4700	11550	6850	0.09	2.46	8	20	12
0047	3T	20	132	53	3	5300	2700	-2600	0.06	0.51	9	4	-5
0047	3T	20	134	46	2	4600	2860	-1740	0.04	0.62	8	5	-3
0047	3T	20	135	48	3	4800	2140	-2660	0.06	0.45	8	3	-5
0047	3T	20	136	23	2	2300	2880	580	0.09	1.25	4	5	1
0047	3T	20	142	47	7	4700	5410	710	0.15	1.15	8	9	1
0047	3T	20	143	37	0	3700	0	-3700	0.00	0.00	6	0	-6
0047	3T	20	145	42	1	4200	800	-3400	0.02	0.19	7	1	-6
0047	3T	20	146	41	0	4100	0	-4100	0.00	0.00	7	0	-7
0047	3T	20	152	38	1	3800	2500	-1300	0.03	0.66	6	4	-2
0047	3T	20	153	26	1	2600	2290	-310	0.04	0.88	4	4	0
0047	3T	20	154	23	0	2300	0	-2300	0.00	0.00	4	0	-4
0047	3T	20	156	23	1	2300	1640	-660	0.04	0.71	4	2	-2
0047	3T	20	162	21	2	2100	9950	7850	0.10	4.74	3	17	14
0047	3T	20	163	26	0	2600	0	-2600	0.00	0.00	4	0	-4
0047	3T	20	164	12	0	1200	0	-1200	0.00	0.00	2	0	-2
0047	3T	20	165	14	0	1400	0	-1400	0.00	0.00	2	0	-2
0047	3T	20	213	25	0	2500	0	-2500	0.00	0.00	4	0	-4
0047	3T	20	214	36	1	3600	540	-3060	0.03	0.15	6	0	-6
0047	3T	20	215	16	0	1600	0	-1600	0.00	0.00	2	0	-2
0047	3T	20	216	14	0	1400	0	-1400	0.00	0.00	2	0	-2
0047	3T	20	231	15	0	1500	0	-1500	0.00	0.00	2	0	-2
0047	3T	20	234	9	0	900	0	-900	0.00	0.00	1	0	-1
0047	3T	20	235	5	0	500	0	-500	0.00	0.00	0	0	0
0047	3T	20	236	6	0	600	0	-600	0.00	0.00	1	0	-1
0047	3T	20	241	25	0	2500	0	-2500	0.00	0.00	4	0	-4
0047	3T	20	243	10	1	1000	2230	1230	0.10	2.23	1	3	2
0047	3T	20	245	10	1	1000	1260	260	0.10	1.26	1	2	1
0047	3T	20	246	8	0	800	0	-800	0.00	0.00	1	0	-1
0047	3T	20	251	10	0	1000	0	-1000	0.00	0.00	1	0	-1
0047	3T	20	253	12	0	1200	0	-1200	0.00	0.00	2	0	-2
0047	3T	20	254	8	0	800	0	-800	0.00	0.00	1	0	-1
0047	3T	20	256	17	0	1700	0	-1700	0.00	0.00	3	0	-3
0047	3T	20	261	13	0	1300	0	-1300	0.00	0.00	2	0	-2
0047	3T	20	263	12	0	1200	0	-1200	0.00	0.00	2	0	-2
0047	3T	20	264	9	0	900	0	-900	0.00	0.00	1	0	-1
0047	3T	20	265	4	0	400	0	-400	0.00	0.00	0	0	0
0047	3T	21	123	71	11	7100	9530	2430	0.15	1.34	12	16	4
0047	3T	21	124	82	10	8200	7120	-1080	0.12	0.87	14	12	-2
0047	3T	21	125	77	8	7700	8710	1010	0.10	1.13	13	15	2
0047	3T	21	126	39	3	3900	8760	4860	0.08	2.25	6	15	9
0047	3T	21	132	60	4	6000	5690	-310	0.07	0.95	10	10	0
0047	3T	21	134	79	8	7900	7280	-620	0.10	0.92	13	12	-1
0047	3T	21	135	65	4	6500	2050	-4450	0.06	0.32	11	3	-8
0047	3T	21	136	41	2	4100	4130	30	0.05	1.01	7	7	0
0047	3T	21	142	60	4	6000	4310	-1690	0.07	0.72	10	7	-3
0047	3T	21	143	60	3	6000	3730	-2270	0.05	0.62	10	6	-4
0047	3T	21	145	57	7	5700	6000	300	0.12	1.05	10	10	0
0047	3T	21	146	28	3	2800	4050	1250	0.11	1.45	4	7	3
0047	3T	21	152	45	3	4500	5410	910	0.07	1.20	7	9	2
0047	3T	21	153	44	2	4400	5900	1500	0.05	1.34	7	10	3
0047	3T	21	154	26	0	2600	0	-2600	0.00	0.00	4	0	-4
0047	3T	21	156	33	0	3300	0	-3300	0.00	0.00	5	0	-5
0047	3T	21	162	17	0	1700	0	-1700	0.00	0.00	3	0	-3
0047	3T	21	163	19	0	1900	0	-1900	0.00	0.00	3	0	-3
0047	3T	21	164	17	1	1700	6500	4800	0.06	3.82	3	11	8
0047	3T	21	165	10	0	1000	0	-1000	0.00	0.00	1	0	-1
0047	3T	21	213	17	0	1700	0	-1700	0.00	0.00	3	0	-3
0047	3T	21	214	17	1	1700	2260	560	0.06	1.33	3	4	1
0047	3T	21	215	20	0	2000	0	-2000	0.00	0.00	3	0	-3
0047	3T	21	216	19	1	1900	1070	-830	0.05	0.56	3	1	-2
0047	3T	21	231	18	0	1800	0	-1800	0.00	0.00	3	0	-3
0047	3T	21	234	12	0	1200	0	-1200	0.00	0.00	2	0	-2
0047	3T	21	235	10	0	1000	0	-1000	0.00	0.00	1	0	-1
0047	3T	21	236	9	1	900	490	-410	0.11	0.54	1	0	-1
0047	3T	21	241	11	2	1100	8870	7770	0.18	8.06	1	15	14
0047	3T	21	243	5	0	500	0	-500	0.00	0.00	0	0	0
0047	3T	21	245	9	0	900	0	-900	0.00	0.00	1	0	-1
0047	3T	21	246	7	0	700	0	-700	0.00	0.00	1	0	-1
0047	3T	21	251	18	0	1800	0	-1800	0.00	0.00	3	0	-3
0047	3T	21	253	11	0	1100	0	-1100	0.00	0.00	1	0	-1
0047	3T	21	254	7	0	700	0	-700	0.00	0.00	1	0	-1
0047	3T	21	256	6	0	600	0	-600	0.00	0.00	1	0	-1
0047	3T	21	261	9	0	900	0	-900	0.00	0.00	1	0	-1
0047	3T	21	263	13	0	1300	0	-1300	0.00	0.00	2	0	-2
0047	3T	21	264	9	0	900	0	-900	0.00	0.00	1	0	-1
0047	3T	21	265	7	1	700	1750	1050	0.14	2.50	1	3	2
0047	3T	22	123	70	7	7000	6780	-220	0.10	0.97	12	12	0
0047	3T	22	124	72	9	7200	11370	4170	0.13	1.58	12	20	8
0047	3T	22	125	50	0	5000	0	-5000	0.00	0.00	8	0	-8
0047	3T	22	126	29	1	2900	3070	170	0.03	1.06	5	5	0
0047	3T	22	132	53	5	5300	5900	600	0.09	1.11	9	10	1
0047	3T	22	134	54	4	5400	4680	-720	0.07	0.87	9	8	-1
0047	3T	22	135	45	1	4500	1770	-2730	0.02	0.39	7	3	-4
0047	3T	22	136	36	0	3600	0	-3600	0.00	0.00	6	0	-6
0047	3T	22	142	46	5	4600	9740	5140	0.11	2.12	8	17	9
0047	3T	22	143	48	1	4800	990	-3810	0.02	0.21	8	1	-7
0047	3T	22	145	26	0	2600	0	-2600	0.00	0.00	4	0	-4
0047	3T	22	146	25	0	2500	0	-2500	0.00	0.00	4	0	-4
0047	3T	22	152	26	0	2600	0	-2600	0.00	0.00	4	0	-4
0047	3T	22	153	35	0	3500	0	-3500	0.00	0.00	6	0	-6
0047	3T	22	154	24	0	2400	0	-2400	0.00	0.00	4	0	-4
0047	3T	22	156	14	0	1400	0	-1400	0.00	0.00	2	0	-2
0047	3T	22	162	23	0	2300	0	-2300	0.00	0.00	4	0	-4
0047	3T	22	163	22	1	2200	2170	-30	0.05	0.99	3	3	0
0047	3T	22	164	20	0	2000	0	-2000	0.00	0.00	3	0	-3
0047	3T	22	165	12	0	1200	0	-1200	0.00	0.00	2	0	-2
0047	3T	22	213	32	1	3200	1510	-1690	0.03	0.47	5	2	-3
0047	3T	22	214	39	2	3900	2750	-1150	0.05	0.71	6	4	-2
0047	3T	22	215	24	2	2400	4520	2120	0.08	1.88	4	8	4
0047	3T	22	216	19	0	1900	0	-1900	0.00	0.00	3	0	-3
0047	3T	22	231	26	0	2600	0	-2600	0.00	0.00	4	0	-4
0047	3T	22	234	17	0	1700	0	-1700	0.00	0.00	3	0	-3
0047	3T	22	235	17	0	1700	0	-1700	0.00	0.00	3	0	-3
0047	3T	22	236	18	0	1800	0	-1800	0.00	0.00	3	0	-3
0047	3T	22	241	18	1	1800	3100	1300	0.06	1.72	3	5	2
0047	3T	22	243	31	0	3100	0	-3100	0.00	0.00	5	0	-5
0047	3T	22	245	13	0	1300	0	-1300	0.00	0.00	2	0	-2
0047	3T	22	246	11	0	1100	0	-1100	0.00	0.00	1	0	-1
0047	3T	22	251	21	0	2100	0	-2100	0.00	0.00	3	0	-3
0047	3T	22	253	11	0	1100	0	-1100	0.00	0.00	1	0	-1
0047	3T	22	254	15	0	1500	0	-1500	0.00	0.00	2	0	-2
0047	3T	22	256	8	0	800	0	-800	0.00	0.00	1	0	-1
0047	3T	22	261	9	0	900	0	-900	0.00	0.00	1	0	-1
0047	3T	22	263	17	0	1700	0	-1700	0.00	0.00	3	0	-3
0047	3T	22	264	11	0	1100	0	-1100	0.00	0.00	1	0	-1
0047	3T	22	265	11	0	1100	0	-1100	0.00	0.00	1	0	-1
0047	3T	23	123	74	9	7400	6470	-930	0.12	0.87	13	11	-2
0047	3T	23	124	42	4	4200	3430	-770	0.10	0.82	7	6	-1
0047	3T	23	125	49	5	4900	6220	1320	0.10	1.27	8	11	3
0047	3T	23	126	38	2	3800	3550	-250	0.05	0.93	6	6	0
0047	3T	23	132	52	6	5200	4810	-390	0.12	0.93	9	8	-1
0047	3T	23	134	45	2	4500	3650	-850	0.04	0.81	7	6	-1
0047	3T	23	135	36	3	3600	4840	1240	0.08	1.34	6	8	2
0047	3T	23	136	36	2	3600	1900	-1700	0.06	0.53	6	3	-3
0047	3T	23	142	43	2	4300	3290	-1010	0.05	0.77	7	5	-2
0047	3T	23	143	44	2	4400	4190	-210	0.05	0.95	7	7	0
0047	3T	23	145	29	1	2900	3570	670	0.03	1.23	5	6	1
0047	3T	23	146	28	0	2800	0	-2800	0.00	0.00	4	0	-4
0047	3T	23	152	22	0	2200	0	-2200	0.00	0.00	3	0	-3
0047	3T	23	153	31	2	3100	8940	5840	0.06	2.88	5	15	10
0047	3T	23	154	17	0	1700	0	-1700	0.00	0.00	3	0	-3
0047	3T	23	156	18	0	1800	0	-1800	0.00	0.00	3	0	-3
0047	3T	23	162	16	0	1600	0	-1600	0.00	0.00	2	0	-2
0047	3T	23	163	27	0	2700	0	-2700	0.00	0.00	4	0	-4
0047	3T	23	164	20	0	2000	0	-2000	0.00	0.00	3	0	-3
0047	3T	23	165	13	0	1300	0	-1300	0.00	0.00	2	0	-2
0047	3T	23	213	38	1	3800	5890	2090	0.03	1.55	6	10	4
0047	3T	23	214	28	0	2800	0	-2800	0.00	0.00	4	0	-4
0047	3T	23	215	31	1	3100	5410	2310	0.03	1.75	5	9	4
0047	3T	23	216	27	0	2700	0	-2700	0.00	0.00	4	0	-4
0047	3T	23	231	20	1	2000	4200	2200	0.05	2.10	3	7	4
0047	3T	23	234	22	1	2200	880	-1320	0.05	0.40	3	1	-2
0047	3T	23	235	30	1	3000	520	-2480	0.03	0.17	5	0	-5
0047	3T	23	236	14	0	1400	0	-1400	0.00	0.00	2	0	-2
0047	3T	23	241	26	0	2600	0	-2600	0.00	0.00	4	0	-4
0047	3T	23	243	19	0	1900	0	-1900	0.00	0.00	3	0	-3
0047	3T	23	245	16	1	1600	1070	-530	0.06	0.67	2	1	-1
0047	3T	23	246	9	1	900	1310	410	0.11	1.46	1	2	1
0047	3T	23	251	21	0	2100	0	-2100	0.00	0.00	3	0	-3
0047	3T	23	253	16	0	1600	0	-1600	0.00	0.00	2	0	-2
0047	3T	23	254	15	0	1500	0	-1500	0.00	0.00	2	0	-2
0047	3T	23	256	12	0	1200	0	-1200	0.00	0.00	2	0	-2
0047	3T	23	261	13	0	1300	0	-1300	0.00	0.00	2	0	-2
0047	3T	23	263	9	0	900	0	-900	0.00	0.00	1	0	-1
0047	3T	23	264	15	0	1500	0	-1500	0.00	0.00	2	0	-2
0047	3T	23	265	15	0	1500	0	-1500	0.00	0.00	2	0	-2
0047	3T	24	123	113	18	11300	13570	2270	0.16	1.20	20	24	4
0047	3T	24	124	88	7	8800	3650	-5150	0.08	0.41	15	6	-9
0047	3T	24	125	71	6	7100	5210	-1890	0.08	0.73	12	9	-3
0047	3T	24	126	63	3	6300	4430	-1870	0.05	0.70	11	7	-4
0047	3T	24	132	58	8	5800	6680	880	0.14	1.15	10	11	1
0047	3T	24	134	77	12	7700	14090	6390	0.16	1.83	13	24	11
0047	3T	24	135	50	5	5000	10340	5340	0.10	2.07	8	18	10
0047	3T	24	136	52	3	5200	5220	20	0.06	1.00	9	9	0
0047	3T	24	142	57	7	5700	10210	4510	0.12	1.79	10	18	8
0047	3T	24	143	70	2	7000	4360	-2640	0.03	0.62	12	7	-5
0047	3T	24	145	49	3	4900	10450	5550	0.06	2.13	8	18	10
0047	3T	24	146	34	0	3400	0	-3400	0.00	0.00	6	0	-6
0047	3T	24	152	39	2	3900	2320	-1580	0.05	0.59	6	4	-2
0047	3T	24	153	40	0	4000	0	-4000	0.00	0.00	7	0	-7
0047	3T	24	154	46	0	4600	0	-4600	0.00	0.00	8	0	-8
0047	3T	24	156	31	0	3100	0	-3100	0.00	0.00	5	0	-5
0047	3T	24	162	30	1	3000	620	-2380	0.03	0.21	5	1	-4
0047	3T	24	163	33	2	3300	11650	8350	0.06	3.53	5	20	15
0047	3T	24	164	35	0	3500	0	-3500	0.00	0.00	6	0	-6
0047	3T	24	165	24	0	2400	0	-2400	0.00	0.00	4	0	-4
0047	3T	24	213	18	1	1800	800	-1000	0.06	0.44	3	1	-2
0047	3T	24	214	23	0	2300	0	-2300	0.00	0.00	4	0	-4
0047	3T	24	215	19	2	1900	2080	180	0.11	1.09	3	3	0
0047	3T	24	216	18	1	1800	4750	2950	0.06	2.64	3	8	5
0047	3T	24	231	14	0	1400	0	-1400	0.00	0.00	2	0	-2
0047	3T	24	234	11	0	1100	0	-1100	0.00	0.00	1	0	-1
0047	3T	24	235	15	0	1500	0	-1500	0.00	0.00	2	0	-2
0047	3T	24	236	12	0	1200	0	-1200	0.00	0.00	2	0	-2
0047	3T	24	241	18	0	1800	0	-1800	0.00	0.00	3	0	-3
0047	3T	24	243	15	0	1500	0	-1500	0.00	0.00	2	0	-2
0047	3T	24	245	17	1	1700	72950	71250	0.06	42.91	3	129	126
0047	3T	24	246	9	3	900	62580	61680	0.33	69.53	1	110	109
0047	3T	24	251	16	0	1600	0	-1600	0.00	0.00	2	0	-2
0047	3T	24	253	11	0	1100	0	-1100	0.00	0.00	1	0	-1
0047	3T	24	254	10	0	1000	0	-1000	0.00	0.00	1	0	-1
0047	3T	24	256	4	0	400	0	-400	0.00	0.00	0	0	0
0047	3T	24	261	15	0	1500	0	-1500	0.00	0.00	2	0	-2
0047	3T	24	263	9	0	900	0	-900	0.00	0.00	1	0	-1
0047	3T	24	264	9	0	900	0	-900	0.00	0.00	1	0	-1
0047	3T	24	265	3	0	300	0	-300	0.00	0.00	0	0	0
0048	1T	01	1	955	673	95500	88270	-7230	0.70	0.92	169	156	-13
0048	1T	01	2	356	110	35600	34540	-1060	0.31	0.97	63	61	-2
0048	1T	02	1	813	488	81300	70980	-10320	0.60	0.87	143	125	-18
0048	1T	02	2	454	140	45400	32860	-12540	0.31	0.72	80	58	-22
0048	1T	03	1	460	277	46000	40760	-5240	0.60	0.89	81	72	-9
0048	1T	03	2	371	130	37100	32490	-4610	0.35	0.88	65	57	-8
0048	1T	04	1	646	416	64600	56050	-8550	0.64	0.87	114	99	-15
0048	1T	04	2	327	116	32700	29940	-2760	0.35	0.92	57	52	-5
0048	1T	05	1	863	596	86300	83370	-2930	0.69	0.97	152	147	-5
0048	1T	05	2	428	147	42800	39470	-3330	0.34	0.92	75	69	-6
0048	1T	06	1	894	588	89400	77080	-12320	0.66	0.86	158	136	-22
0048	1T	06	2	446	156	44600	41060	-3540	0.35	0.92	78	72	-6
0048	1T	07	1	888	617	88800	80120	-8680	0.69	0.90	157	141	-16
0048	1T	07	2	421	131	42100	37100	-5000	0.31	0.88	74	65	-9
0048	1T	08	1	914	668	91400	86280	-5120	0.73	0.94	161	152	-9
0048	1T	08	2	342	96	34200	24050	-10150	0.28	0.70	60	42	-18
0048	1T	09	1	1133	820	113300	104960	-8340	0.72	0.93	200	185	-15
0048	1T	09	2	457	185	45700	45660	-40	0.40	1.00	80	80	0
0048	1T	10	1	1003	709	100300	91910	-8390	0.71	0.92	177	162	-15
0048	1T	10	2	513	183	51300	50080	-1220	0.36	0.98	90	88	-2
0048	1T	11	1	873	560	87300	76190	-11110	0.64	0.87	154	134	-20
0048	1T	11	2	421	125	42100	43150	1050	0.30	1.02	74	76	2
0048	1T	12	1	875	623	87500	81360	-6140	0.71	0.93	154	144	-10
0048	1T	12	2	422	136	42200	36210	-5990	0.32	0.86	74	64	-10
0048	1T	13	1	791	585	79100	74250	-4850	0.74	0.94	140	131	-9
0048	1T	13	2	379	126	37900	31680	-6220	0.33	0.84	67	56	-11
0048	1T	14	1	818	546	81800	74460	-7340	0.67	0.91	144	131	-13
0048	1T	14	2	354	128	35400	39300	3900	0.36	1.11	62	69	7
0048	1T	15	1	963	648	96300	83570	-12730	0.67	0.87	170	147	-23
0048	1T	15	2	366	111	36600	36730	130	0.30	1.00	64	65	1
0048	1T	16	1	1060	758	106000	97050	-8950	0.72	0.92	187	171	-16
0048	1T	16	2	400	117	40000	34300	-5700	0.29	0.86	70	60	-10
0048	1T	17	1	1076	756	107600	98770	-8830	0.70	0.92	190	174	-16
0048	1T	17	2	433	147	43300	38390	-4910	0.34	0.89	76	67	-9
0048	1T	18	1	1276	984	127600	115430	-12170	0.77	0.90	225	204	-21
0048	1T	18	2	385	132	38500	25900	-12600	0.34	0.67	68	45	-23
0048	1T	19	1	919	632	91900	80350	-11550	0.69	0.87	162	142	-20
0048	1T	19	2	311	91	31100	23050	-8050	0.29	0.74	55	40	-15
0048	1T	20	1	981	688	98100	89450	-8650	0.70	0.91	173	158	-15
0048	1T	20	2	395	122	39500	31590	-7910	0.31	0.80	69	55	-14
0048	1T	21	1	1140	839	114000	105320	-8680	0.74	0.92	201	186	-15
0048	1T	21	2	372	110	37200	28750	-8450	0.30	0.77	65	50	-15
0048	1T	22	1	844	545	84400	73600	-10800	0.65	0.87	149	130	-19
0048	1T	22	2	418	129	41800	30930	-10870	0.31	0.74	73	54	-19
0048	1T	23	1	910	640	91000	79990	-11010	0.70	0.88	161	141	-20
0048	1T	23	2	463	152	46300	39970	-6330	0.33	0.86	81	70	-11
0048	1T	24	1	1139	907	113900	110700	-3200	0.80	0.97	201	195	-6
0048	1T	24	2	343	117	34300	31430	-2870	0.34	0.92	60	55	-5
0048	2F	01	12	341	125	34100	30180	-3920	0.37	0.89	60	53	-7
0048	2F	01	13	227	58	22700	16350	-6350	0.26	0.72	40	28	-12
0048	2F	01	14	73	15	7300	4720	-2580	0.21	0.65	12	8	-4
0048	2F	01	15	164	23	16400	13250	-3150	0.14	0.81	29	23	-6
0048	2F	01	16	154	10	15400	10230	-5170	0.06	0.66	27	18	-9
0048	2F	01	23	53	14	5300	5110	-190	0.26	0.96	9	9	0
0048	2F	01	24	59	8	5900	4460	-1440	0.14	0.76	10	7	-3
0048	2F	01	25	56	3	5600	1560	-4040	0.05	0.28	9	2	-7
0048	2F	01	26	69	2	6900	880	-6020	0.03	0.13	12	1	-11
0048	2F	02	12	314	106	31400	28170	-3230	0.34	0.90	55	49	-6
0048	2F	02	13	175	43	17500	12890	-4610	0.25	0.74	30	22	-8
0048	2F	02	14	97	19	9700	7080	-2620	0.20	0.73	17	12	-5
0048	2F	02	15	113	14	11300	10900	-400	0.12	0.96	20	19	-1
0048	2F	02	16	146	15	14600	13830	-770	0.10	0.95	25	24	-1
0048	2F	02	23	53	14	5300	6800	1500	0.26	1.28	9	12	3
0048	2F	02	24	45	5	4500	1960	-2540	0.11	0.44	7	3	-4
0048	2F	02	25	85	11	8500	8490	-10	0.13	1.00	15	15	0
0048	2F	02	26	98	6	9800	2770	-7030	0.06	0.28	17	4	-13
0048	2F	03	12	225	80	22500	19240	-3260	0.36	0.86	39	34	-5
0048	2F	03	13	89	25	8900	7270	-1630	0.28	0.82	15	12	-3
0048	2F	03	14	64	17	6400	6320	-80	0.27	0.99	11	11	0
0048	2F	03	15	59	12	5900	6210	310	0.20	1.05	10	10	0
0048	2F	03	16	51	6	5100	4790	-310	0.12	0.94	9	8	-1
0048	2F	03	23	30	7	3000	2400	-600	0.23	0.80	5	4	-1
0048	2F	03	24	41	6	4100	2820	-1280	0.15	0.69	7	4	-3
0048	2F	03	25	68	11	6800	6920	120	0.16	1.02	12	12	0
0048	2F	03	26	70	2	7000	670	-6330	0.03	0.10	12	1	-11
0048	2F	04	12	248	90	24800	24120	-680	0.36	0.97	43	42	-1
0048	2F	04	13	130	38	13000	10240	-2760	0.29	0.79	23	18	-5
0048	2F	04	14	102	25	10200	8410	-1790	0.25	0.82	18	14	-4
0048	2F	04	15	110	14	11000	7710	-3290	0.13	0.70	19	13	-6
0048	2F	04	16	84	9	8400	5940	-2460	0.11	0.71	14	10	-4
0048	2F	04	23	23	6	2300	1900	-400	0.26	0.83	4	3	-1
0048	2F	04	24	39	5	3900	1400	-2500	0.13	0.36	6	2	-4
0048	2F	04	25	60	8	6000	5970	-30	0.13	1.00	10	10	0
0048	2F	04	26	72	7	7200	5250	-1950	0.10	0.73	12	9	-3
0048	2F	05	12	319	111	31900	28010	-3890	0.35	0.88	56	49	-7
0048	2F	05	13	160	57	16000	16390	390	0.36	1.02	28	29	1
0048	2F	05	14	143	30	14300	7770	-6530	0.21	0.54	25	13	-12
0048	2F	05	15	155	21	15500	10810	-4690	0.14	0.70	27	19	-8
0048	2F	05	16	107	12	10700	10070	-630	0.11	0.94	18	17	-1
0048	2F	05	23	51	12	5100	3180	-1920	0.24	0.62	9	5	-4
0048	2F	05	24	59	15	5900	6220	320	0.25	1.05	10	11	1
0048	2F	05	25	96	14	9600	8910	-690	0.15	0.93	16	15	-1
0048	2F	05	26	69	5	6900	2450	-4450	0.07	0.36	12	4	-8
0048	2F	06	12	308	104	30800	25620	-5180	0.34	0.83	54	45	-9
0048	2F	06	13	219	73	21900	18700	-3200	0.33	0.85	38	33	-5
0048	2F	06	14	163	31	16300	11230	-5070	0.19	0.69	28	19	-9
0048	2F	06	15	131	18	13100	11070	-2030	0.14	0.85	23	19	-4
0048	2F	06	16	112	15	11200	11720	520	0.13	1.05	19	20	1
0048	2F	06	23	21	8	2100	3030	930	0.38	1.44	3	5	2
0048	2F	06	24	62	4	6200	2260	-3940	0.06	0.36	10	4	-6
0048	2F	06	25	109	14	10900	10300	-600	0.13	0.94	19	18	-1
0048	2F	06	26	88	6	8800	5750	-3050	0.07	0.65	15	10	-5
0048	2F	07	12	253	89	25300	19530	-5770	0.35	0.77	44	34	-10
0048	2F	07	13	200	68	20000	15620	-4380	0.34	0.78	35	27	-8
0048	2F	07	14	218	47	21800	15130	-6670	0.22	0.69	38	26	-12
0048	2F	07	15	152	28	15200	16260	1060	0.18	1.07	26	28	2
0048	2F	07	16	82	7	8200	4720	-3480	0.09	0.58	14	8	-6
0048	2F	07	23	34	3	3400	1270	-2130	0.09	0.37	6	2	-4
0048	2F	07	24	44	4	4400	1910	-2490	0.09	0.43	7	3	-4
0048	2F	07	25	77	9	7700	6010	-1690	0.12	0.78	13	10	-3
0048	2F	07	26	97	8	9700	10770	1070	0.08	1.11	17	19	2
0048	2F	08	12	293	110	29300	24590	-4710	0.38	0.84	51	43	-8
0048	2F	08	13	191	61	19100	17380	-1720	0.32	0.91	33	30	-3
0048	2F	08	14	220	53	22000	15850	-6150	0.24	0.72	38	28	-10
0048	2F	08	15	133	15	13300	8660	-4640	0.11	0.65	23	15	-8
0048	2F	08	16	92	11	9200	9950	750	0.12	1.08	16	17	1
0048	2F	08	23	18	0	1800	0	-1800	0.00	0.00	3	0	-3
0048	2F	08	24	42	7	4200	6760	2560	0.17	1.61	7	11	4
0048	2F	08	25	66	5	6600	4460	-2140	0.08	0.68	11	7	-4
0048	2F	08	26	70	6	7000	5760	-1240	0.09	0.82	12	10	-2
0048	2F	09	12	469	169	46900	34590	-12310	0.36	0.74	83	61	-22
0048	2F	09	13	230	69	23000	18580	-4420	0.30	0.81	40	32	-8
0048	2F	09	14	188	44	18800	16750	-2050	0.23	0.89	33	29	-4
0048	2F	09	15	157	18	15700	11680	-4020	0.11	0.74	27	20	-7
0048	2F	09	16	108	8	10800	8960	-1840	0.07	0.83	19	15	-4
0048	2F	09	23	26	5	2600	1820	-780	0.19	0.70	4	3	-1
0048	2F	09	24	63	8	6300	2820	-3480	0.13	0.45	11	4	-7
0048	2F	09	25	123	17	12300	11510	-790	0.14	0.94	21	20	-1
0048	2F	09	26	85	10	8500	9500	1000	0.12	1.12	15	16	1
0048	2F	10	12	373	150	37300	28370	-8930	0.40	0.76	66	50	-16
0048	2F	10	13	263	75	26300	16980	-9320	0.29	0.65	46	30	-16
0048	2F	10	14	167	35	16700	12230	-4470	0.21	0.73	29	21	-8
0048	2F	10	15	133	16	13300	10360	-2940	0.12	0.78	23	18	-5
0048	2F	10	16	81	5	8100	3590	-4510	0.06	0.44	14	6	-8
0048	2F	10	23	30	4	3000	1320	-1680	0.13	0.44	5	2	-3
0048	2F	10	24	57	15	5700	7050	1350	0.26	1.24	10	12	2
0048	2F	10	25	105	16	10500	9530	-970	0.15	0.91	18	16	-2
0048	2F	10	26	77	5	7700	3190	-4510	0.06	0.41	13	5	-8
0048	2F	11	12	398	184	39800	33470	-6330	0.46	0.84	70	59	-11
0048	2F	11	13	217	56	21700	18380	-3320	0.26	0.85	38	32	-6
0048	2F	11	14	77	11	7700	3270	-4430	0.14	0.42	13	5	-8
0048	2F	11	15	76	9	7600	5140	-2460	0.12	0.68	13	9	-4
0048	2F	11	16	101	3	10100	1280	-8820	0.03	0.13	17	2	-15
0048	2F	11	23	72	7	7200	2990	-4210	0.10	0.42	12	5	-7
0048	2F	11	24	31	4	3100	1740	-1360	0.13	0.56	5	3	-2
0048	2F	11	25	131	9	13100	7350	-5750	0.07	0.56	23	13	-10
0048	2F	11	26	114	7	11400	17000	5600	0.06	1.49	20	30	10
0048	2F	12	12	420	160	42000	36700	-5300	0.38	0.87	74	64	-10
0048	2F	12	13	208	56	20800	16600	-4200	0.27	0.80	36	29	-7
0048	2F	12	14	56	13	5600	4420	-1180	0.23	0.79	9	7	-2
0048	2F	12	15	81	10	8100	5830	-2270	0.12	0.72	14	10	-4
0048	2F	12	16	127	17	12700	8760	-3940	0.13	0.69	22	15	-7
0048	2F	12	23	64	11	6400	3740	-2660	0.17	0.58	11	6	-5
0048	2F	12	24	59	8	5900	2940	-2960	0.14	0.50	10	5	-5
0048	2F	12	25	72	9	7200	6980	-220	0.13	0.97	12	12	0
0048	2F	12	26	55	4	5500	2490	-3010	0.07	0.45	9	4	-5
0048	2F	13	12	293	110	29300	24460	-4840	0.38	0.83	51	43	-8
0048	2F	13	13	141	47	14100	10880	-3220	0.33	0.77	24	19	-5
0048	2F	13	14	130	31	13000	7370	-5630	0.24	0.57	23	13	-10
0048	2F	13	15	101	18	10100	7930	-2170	0.18	0.79	17	14	-3
0048	2F	13	16	166	19	16600	16120	-480	0.11	0.97	29	28	-1
0048	2F	13	23	20	5	2000	1800	-200	0.25	0.90	3	3	0
0048	2F	13	24	60	3	6000	1540	-4460	0.05	0.26	10	2	-8
0048	2F	13	25	55	6	5500	2340	-3160	0.11	0.43	9	4	-5
0048	2F	13	26	66	6	6600	7090	490	0.09	1.07	11	12	1
0048	2F	14	12	331	105	33100	24870	-8230	0.32	0.75	58	44	-14
0048	2F	14	13	177	50	17700	12920	-4780	0.28	0.73	31	22	-9
0048	2F	14	14	141	38	14100	12040	-2060	0.27	0.85	24	21	-3
0048	2F	14	15	102	10	10200	7330	-2870	0.10	0.72	18	12	-6
0048	2F	14	16	64	9	6400	8100	1700	0.14	1.27	11	14	3
0048	2F	14	23	30	7	3000	3180	180	0.23	1.06	5	5	0
0048	2F	14	24	49	2	4900	1450	-3450	0.04	0.30	8	2	-6
0048	2F	14	25	66	9	6600	10000	3400	0.14	1.52	11	17	6
0048	2F	14	26	81	6	8100	4510	-3590	0.07	0.56	14	7	-7
0048	2F	15	12	402	145	40200	31730	-8470	0.36	0.79	71	56	-15
0048	2F	15	13	210	69	21000	16920	-4080	0.33	0.81	37	29	-8
0048	2F	15	14	181	40	18100	12020	-6080	0.22	0.66	32	21	-11
0048	2F	15	15	111	17	11100	11170	70	0.15	1.01	19	19	0
0048	2F	15	16	78	8	7800	6170	-1630	0.10	0.79	13	10	-3
0048	2F	15	23	33	6	3300	2840	-460	0.18	0.86	5	5	0
0048	2F	15	24	64	6	6400	6450	50	0.09	1.01	11	11	0
0048	2F	15	25	70	3	7000	2830	-4170	0.04	0.40	12	5	-7
0048	2F	15	26	71	8	7100	8270	1170	0.11	1.16	12	14	2
0048	2F	16	12	406	160	40600	33900	-6700	0.39	0.83	71	60	-11
0048	2F	16	13	254	74	25400	19200	-6200	0.29	0.76	44	33	-11
0048	2F	16	14	193	55	19300	18520	-780	0.28	0.96	34	32	-2
0048	2F	16	15	149	21	14900	11580	-3320	0.14	0.78	26	20	-6
0048	2F	16	16	68	9	6800	7320	520	0.13	1.08	12	12	0
0048	2F	16	23	33	6	3300	2200	-1100	0.18	0.67	5	3	-2
0048	2F	16	24	42	10	4200	6620	2420	0.24	1.58	7	11	4
0048	2F	16	25	73	10	7300	4810	-2490	0.14	0.66	12	8	-4
0048	2F	16	26	92	6	9200	6410	-2790	0.07	0.70	16	11	-5
0048	2F	17	12	420	151	42000	30960	-11040	0.36	0.74	74	54	-20
0048	2F	17	13	262	100	26200	24620	-1580	0.38	0.94	46	43	-3
0048	2F	17	14	170	45	17000	14620	-2380	0.26	0.86	30	25	-5
0048	2F	17	15	136	19	13600	10030	-3570	0.14	0.74	24	17	-7
0048	2F	17	16	111	16	11100	14480	3380	0.14	1.30	19	25	6
0048	2F	17	23	34	5	3400	2200	-1200	0.15	0.65	6	3	-3
0048	2F	17	24	57	7	5700	2110	-3590	0.12	0.37	10	3	-7
0048	2F	17	25	89	13	8900	7090	-1810	0.15	0.80	15	12	-3
0048	2F	17	26	72	5	7200	4800	-2400	0.07	0.67	12	8	-4
0048	2F	18	12	495	229	49500	40180	-9320	0.46	0.81	87	71	-16
0048	2F	18	13	191	55	19100	15800	-3300	0.29	0.83	33	27	-6
0048	2F	18	14	302	78	30200	23570	-6630	0.26	0.78	53	41	-12
0048	2F	18	15	211	33	21100	16930	-4170	0.16	0.80	37	29	-8
0048	2F	18	16	87	6	8700	4720	-3980	0.07	0.54	15	8	-7
0048	2F	18	23	12	0	1200	0	-1200	0.00	0.00	2	0	-2
0048	2F	18	24	54	7	5400	3690	-1710	0.13	0.68	9	6	-3
0048	2F	18	25	112	15	11200	10480	-720	0.13	0.94	19	18	-1
0048	2F	18	26	98	13	9800	10120	320	0.13	1.03	17	17	0
0048	2F	19	12	279	98	27900	22310	-5590	0.35	0.80	49	39	-10
0048	2F	19	13	201	61	20100	14510	-5590	0.30	0.72	35	25	-10
0048	2F	19	14	249	68	24900	23500	-1400	0.27	0.94	44	41	-3
0048	2F	19	15	121	13	12100	5910	-6190	0.11	0.49	21	10	-11
0048	2F	19	16	60	8	6000	3660	-2340	0.13	0.61	10	6	-4
0048	2F	19	23	16	1	1600	270	-1330	0.06	0.17	2	0	-2
0048	2F	19	24	52	7	5200	2580	-2620	0.13	0.50	9	4	-5
0048	2F	19	25	54	1	5400	1390	-4010	0.02	0.26	9	2	-7
0048	2F	19	26	72	3	7200	1920	-5280	0.04	0.27	12	3	-9
0048	2F	20	12	369	137	36900	27750	-9150	0.37	0.75	65	49	-16
0048	2F	20	13	226	93	22600	22300	-300	0.41	0.99	40	39	-1
0048	2F	20	14	183	36	18300	11500	-6800	0.20	0.63	32	20	-12
0048	2F	20	15	150	33	15000	16990	1990	0.22	1.13	26	30	4
0048	2F	20	16	69	6	6900	2980	-3920	0.09	0.43	12	5	-7
0048	2F	20	23	25	5	2500	3560	1060	0.20	1.42	4	6	2
0048	2F	20	24	74	9	7400	3930	-3470	0.12	0.53	13	6	-7
0048	2F	20	25	55	4	5500	2860	-2640	0.07	0.52	9	5	-4
0048	2F	20	26	41	1	4100	1510	-2590	0.02	0.37	7	2	-5
0048	2F	21	12	347	135	34700	28020	-6680	0.39	0.81	61	49	-12
0048	2F	21	13	252	95	25200	22040	-3160	0.38	0.87	44	39	-5
0048	2F	21	14	266	68	26600	23220	-3380	0.26	0.87	47	41	-6
0048	2F	21	15	212	39	21200	21690	490	0.18	1.02	37	38	1
0048	2F	21	16	75	10	7500	8530	1030	0.13	1.14	13	15	2
0048	2F	21	23	13	2	1300	1260	-40	0.15	0.97	2	2	0
0048	2F	21	24	39	4	3900	1690	-2210	0.10	0.43	6	2	-4
0048	2F	21	25	54	4	5400	4900	-500	0.07	0.91	9	8	-1
0048	2F	21	26	72	3	7200	3990	-3210	0.04	0.55	12	7	-5
0048	2F	22	12	311	133	31100	32130	1030	0.43	1.03	55	56	1
0048	2F	22	13	155	49	15500	14700	-800	0.32	0.95	27	26	-1
0048	2F	22	14	172	34	17200	10140	-7060	0.20	0.59	30	17	-13
0048	2F	22	15	79	8	7900	7110	-790	0.10	0.90	13	12	-1
0048	2F	22	16	133	10	13300	13030	-270	0.08	0.98	23	23	0
0048	2F	22	23	54	9	5400	3520	-1880	0.17	0.65	9	6	-3
0048	2F	22	24	40	11	4000	4050	50	0.28	1.01	7	7	0
0048	2F	22	25	87	5	8700	7840	-860	0.06	0.90	15	13	-2
0048	2F	22	26	60	4	6000	2550	-3450	0.07	0.43	10	4	-6
0048	2F	23	12	419	145	41900	30130	-11770	0.35	0.72	74	53	-21
0048	2F	23	13	206	58	20600	15310	-5290	0.28	0.74	36	27	-9
0048	2F	23	14	103	22	10300	6680	-3620	0.21	0.65	18	11	-7
0048	2F	23	15	122	25	12200	15590	3390	0.20	1.28	21	27	6
0048	2F	23	16	108	9	10800	8400	-2400	0.08	0.78	19	14	-5
0048	2F	23	23	43	5	4300	2590	-1710	0.12	0.60	7	4	-3
0048	2F	23	24	54	12	5400	4880	-520	0.22	0.90	9	8	-1
0048	2F	23	25	67	6	6700	4820	-1880	0.09	0.72	11	8	-3
0048	2F	23	26	51	3	5100	5050	-50	0.06	0.99	9	8	-1
0048	2F	24	12	457	176	45700	33930	-11770	0.39	0.74	80	60	-20
0048	2F	24	13	245	79	24500	19520	-4980	0.32	0.80	43	34	-9
0048	2F	24	14	172	43	17200	14170	-3030	0.25	0.82	30	25	-5
0048	2F	24	15	164	26	16400	14320	-2080	0.16	0.87	29	25	-4
0048	2F	24	16	122	12	12200	13220	1020	0.10	1.08	21	23	2
0048	2F	24	23	15	4	1500	1820	320	0.27	1.21	2	3	1
0048	2F	24	24	25	4	2500	1980	-520	0.16	0.79	4	3	-1
0048	2F	24	25	54	4	5400	1720	-3680	0.07	0.32	9	3	-6
0048	2F	24	26	71	5	7100	3350	-3750	0.07	0.47	12	5	-7
0048	2T	01	12	331	102	33100	28830	-4270	0.31	0.87	58	51	-7
0048	2T	01	13	227	48	22700	16440	-6260	0.21	0.72	40	29	-11
0048	2T	01	14	73	14	7300	5160	-2140	0.19	0.71	12	9	-3
0048	2T	01	15	164	20	16400	11490	-4910	0.12	0.70	29	20	-9
0048	2T	01	16	154	6	15400	9270	-6130	0.04	0.60	27	16	-11
0048	2T	01	21	10	0	1000	0	-1000	0.00	0.00	1	0	-1
0048	2T	01	23	53	7	5300	3380	-1920	0.13	0.64	9	5	-4
0048	2T	01	24	59	3	5900	1330	-4570	0.05	0.23	10	2	-8
0048	2T	01	25	56	2	5600	1700	-3900	0.04	0.30	9	3	-6
0048	2T	01	26	69	1	6900	420	-6480	0.01	0.06	12	0	-12
0048	2T	02	12	268	73	26800	24600	-2200	0.27	0.92	47	43	-4
0048	2T	02	13	175	24	17500	9140	-8360	0.14	0.52	30	16	-14
0048	2T	02	14	97	12	9700	5790	-3910	0.12	0.60	17	10	-7
0048	2T	02	15	113	12	11300	13320	2020	0.11	1.18	20	23	3
0048	2T	02	16	146	14	14600	16300	1700	0.10	1.12	25	28	3
0048	2T	02	21	46	4	4600	2110	-2490	0.09	0.46	8	3	-5
0048	2T	02	23	53	8	5300	3920	-1380	0.15	0.74	9	6	-3
0048	2T	02	24	45	3	4500	1260	-3240	0.07	0.28	7	2	-5
0048	2T	02	25	85	5	8500	6800	-1700	0.06	0.80	15	12	-3
0048	2T	02	26	98	5	9800	3930	-5870	0.05	0.40	17	6	-11
0048	2T	03	12	191	54	19100	17330	-1770	0.28	0.91	33	30	-3
0048	2T	03	13	89	20	8900	7310	-1590	0.22	0.82	15	12	-3
0048	2T	03	14	64	15	6400	6900	500	0.23	1.08	11	12	1
0048	2T	03	15	59	11	5900	7430	1530	0.19	1.26	10	13	3
0048	2T	03	16	51	3	5100	3790	-1310	0.06	0.74	9	6	-3
0048	2T	03	21	34	4	3400	2130	-1270	0.12	0.63	6	3	-3
0048	2T	03	23	30	4	3000	2310	-690	0.13	0.77	5	4	-1
0048	2T	03	24	41	4	4100	2980	-1120	0.10	0.73	7	5	-2
0048	2T	03	25	68	11	6800	9970	3170	0.16	1.47	12	17	5
0048	2T	03	26	70	1	7000	710	-6290	0.01	0.10	12	1	-11
0048	2T	04	12	209	55	20900	17360	-3540	0.26	0.83	36	30	-6
0048	2T	04	13	130	31	13000	10260	-2740	0.24	0.79	23	18	-5
0048	2T	04	14	102	17	10200	8000	-2200	0.17	0.78	18	14	-4
0048	2T	04	15	110	9	11000	6490	-4510	0.08	0.59	19	11	-8
0048	2T	04	16	84	8	8400	6930	-1470	0.10	0.83	14	12	-2
0048	2T	04	21	39	8	3900	4860	960	0.21	1.25	6	8	2
0048	2T	04	23	23	0	2300	0	-2300	0.00	0.00	4	0	-4
0048	2T	04	24	39	3	3900	1200	-2700	0.08	0.31	6	2	-4
0048	2T	04	25	60	3	6000	4620	-1380	0.05	0.77	10	8	-2
0048	2T	04	26	72	6	7200	8290	1090	0.08	1.15	12	14	2
0048	2T	05	12	273	76	27300	23560	-3740	0.28	0.86	48	41	-7
0048	2T	05	13	160	41	16000	13330	-2670	0.26	0.83	28	23	-5
0048	2T	05	14	143	21	14300	7220	-7080	0.15	0.50	25	12	-13
0048	2T	05	15	155	17	15500	9800	-5700	0.11	0.63	27	17	-10
0048	2T	05	16	107	10	10700	10350	-350	0.09	0.97	18	18	0
0048	2T	05	21	46	9	4600	5800	1200	0.20	1.26	8	10	2
0048	2T	05	23	51	7	5100	3290	-1810	0.14	0.65	9	5	-4
0048	2T	05	24	59	11	5900	8940	3040	0.19	1.52	10	15	5
0048	2T	05	25	96	13	9600	11140	1540	0.14	1.16	16	19	3
0048	2T	05	26	69	3	6900	2190	-4710	0.04	0.32	12	3	-9
0048	2T	06	12	257	70	25700	19850	-5850	0.27	0.77	45	35	-10
0048	2T	06	13	219	54	21900	17600	-4300	0.25	0.80	38	31	-7
0048	2T	06	14	163	26	16300	12410	-3890	0.16	0.76	28	21	-7
0048	2T	06	15	131	13	13100	9070	-4030	0.10	0.69	23	16	-7
0048	2T	06	16	112	14	11200	11880	680	0.13	1.06	19	21	2
0048	2T	06	21	51	9	5100	6680	1580	0.18	1.31	9	11	2
0048	2T	06	23	21	4	2100	2340	240	0.19	1.11	3	4	1
0048	2T	06	24	62	2	6200	1140	-5060	0.03	0.18	10	2	-8
0048	2T	06	25	109	11	10900	6790	-4110	0.10	0.62	19	12	-7
0048	2T	06	26	88	4	8800	6760	-2040	0.05	0.77	15	11	-4
0048	2T	07	12	224	62	22400	16760	-5640	0.28	0.75	39	29	-10
0048	2T	07	13	200	54	20000	15560	-4440	0.27	0.78	35	27	-8
0048	2T	07	14	218	37	21800	14050	-7750	0.17	0.64	38	24	-14
0048	2T	07	15	152	19	15200	16080	880	0.13	1.06	26	28	2
0048	2T	07	16	82	6	8200	4600	-3600	0.07	0.56	14	8	-6
0048	2T	07	21	29	4	2900	3080	180	0.14	1.06	5	5	0
0048	2T	07	23	34	1	3400	1070	-2330	0.03	0.31	6	1	-5
0048	2T	07	24	44	4	4400	3690	-710	0.09	0.84	7	6	-1
0048	2T	07	25	77	8	7700	7630	-70	0.10	0.99	13	13	0
0048	2T	07	26	97	5	9700	7260	-2440	0.05	0.75	17	12	-5
0048	2T	08	12	264	80	26400	20110	-6290	0.30	0.76	46	35	-11
0048	2T	08	13	191	46	19100	15240	-3860	0.24	0.80	33	26	-7
0048	2T	08	14	220	45	22000	16620	-5380	0.20	0.76	38	29	-9
0048	2T	08	15	133	12	13300	10760	-2540	0.09	0.81	23	19	-4
0048	2T	08	16	92	11	9200	14450	5250	0.12	1.57	16	25	9
0048	2T	08	21	29	3	2900	1390	-1510	0.10	0.48	5	2	-3
0048	2T	08	23	18	0	1800	0	-1800	0.00	0.00	3	0	-3
0048	2T	08	24	42	6	4200	11690	7490	0.14	2.78	7	20	13
0048	2T	08	25	66	2	6600	3640	-2960	0.03	0.55	11	6	-5
0048	2T	08	26	70	3	7000	3050	-3950	0.04	0.44	12	5	-7
0048	2T	09	12	426	129	42600	29170	-13430	0.30	0.68	75	51	-24
0048	2T	09	13	230	51	23000	16270	-6730	0.22	0.71	40	28	-12
0048	2T	09	14	188	38	18800	16040	-2760	0.20	0.85	33	28	-5
0048	2T	09	15	157	17	15700	13010	-2690	0.11	0.83	27	23	-4
0048	2T	09	16	108	8	10800	9080	-1720	0.07	0.84	19	16	-3
0048	2T	09	21	43	7	4300	5390	1090	0.16	1.25	7	9	2
0048	2T	09	23	26	3	2600	1770	-830	0.12	0.68	4	3	-1
0048	2T	09	24	63	5	6300	2280	-4020	0.08	0.36	11	4	-7
0048	2T	09	25	123	11	12300	9490	-2810	0.09	0.77	21	16	-5
0048	2T	09	26	85	8	8500	9710	1210	0.09	1.14	15	17	2
0048	2T	10	12	346	110	34600	25030	-9570	0.32	0.72	61	44	-17
0048	2T	10	13	263	58	26300	15830	-10470	0.22	0.60	46	28	-18
0048	2T	10	14	167	30	16700	12090	-4610	0.18	0.72	29	21	-8
0048	2T	10	15	133	14	13300	11560	-1740	0.11	0.87	23	20	-3
0048	2T	10	16	81	5	8100	3690	-4410	0.06	0.46	14	6	-8
0048	2T	10	21	27	2	2700	740	-1960	0.07	0.27	4	1	-3
0048	2T	10	23	30	2	3000	1070	-1930	0.07	0.36	5	1	-4
0048	2T	10	24	57	10	5700	5380	-320	0.18	0.94	10	9	-1
0048	2T	10	25	105	10	10500	7170	-3330	0.10	0.68	18	12	-6
0048	2T	10	26	77	1	7700	550	-7150	0.01	0.07	13	0	-13
0048	2T	11	12	396	129	39600	28160	-11440	0.33	0.71	70	49	-21
0048	2T	11	13	217	42	21700	17560	-4140	0.19	0.81	38	31	-7
0048	2T	11	14	77	7	7700	2550	-5150	0.09	0.33	13	4	-9
0048	2T	11	15	76	8	7600	5730	-1870	0.11	0.75	13	10	-3
0048	2T	11	16	101	2	10100	1600	-8500	0.02	0.16	17	2	-15
0048	2T	11	21	2	0	200	0	-200	0.00	0.00	0	0	0
0048	2T	11	23	72	7	7200	4150	-3050	0.10	0.58	12	7	-5
0048	2T	11	24	31	2	3100	1410	-1690	0.06	0.45	5	2	-3
0048	2T	11	25	131	7	13100	8070	-5030	0.05	0.62	23	14	-9
0048	2T	11	26	114	5	11400	17830	6430	0.04	1.56	20	31	11
0048	2T	12	12	384	120	38400	33070	-5330	0.31	0.86	67	58	-9
0048	2T	12	13	208	48	20800	16510	-4290	0.23	0.79	36	29	-7
0048	2T	12	14	56	12	5600	5050	-550	0.21	0.90	9	8	-1
0048	2T	12	15	81	9	8100	5260	-2840	0.11	0.65	14	9	-5
0048	2T	12	16	127	15	12700	8430	-4270	0.12	0.66	22	14	-8
0048	2T	12	21	36	4	3600	2870	-730	0.11	0.80	6	5	-1
0048	2T	12	23	64	6	6400	2490	-3910	0.09	0.39	11	4	-7
0048	2T	12	24	59	5	5900	2410	-3490	0.08	0.41	10	4	-6
0048	2T	12	25	72	8	7200	9890	2690	0.11	1.37	12	17	5
0048	2T	12	26	55	3	5500	2140	-3360	0.05	0.39	9	3	-6
0048	2T	13	12	245	77	24500	19200	-5300	0.31	0.78	43	33	-10
0048	2T	13	13	141	42	14100	11150	-2950	0.30	0.79	24	19	-5
0048	2T	13	14	130	29	13000	8970	-4030	0.22	0.69	23	15	-8
0048	2T	13	15	101	13	10100	7240	-2860	0.13	0.72	17	12	-5
0048	2T	13	16	166	15	16600	16890	290	0.09	1.02	29	29	0
0048	2T	13	21	48	11	4800	9310	4510	0.23	1.94	8	16	8
0048	2T	13	23	20	3	2000	1550	-450	0.15	0.78	3	2	-1
0048	2T	13	24	60	2	6000	1720	-4280	0.03	0.29	10	3	-7
0048	2T	13	25	55	5	5500	2280	-3220	0.09	0.41	9	4	-5
0048	2T	13	26	66	4	6600	7740	1140	0.06	1.17	11	13	2
0048	2T	14	12	301	68	30100	16740	-13360	0.23	0.56	53	29	-24
0048	2T	14	13	177	39	17700	11510	-6190	0.22	0.65	31	20	-11
0048	2T	14	14	141	33	14100	12020	-2080	0.23	0.85	24	21	-3
0048	2T	14	15	102	9	10200	7520	-2680	0.09	0.74	18	13	-5
0048	2T	14	16	64	9	6400	9030	2630	0.14	1.41	11	15	4
0048	2T	14	21	30	6	3000	3960	960	0.20	1.32	5	7	2
0048	2T	14	23	30	4	3000	2610	-390	0.13	0.87	5	4	-1
0048	2T	14	24	49	2	4900	2490	-2410	0.04	0.51	8	4	-4
0048	2T	14	25	66	6	6600	7090	490	0.09	1.07	11	12	1
0048	2T	14	26	81	5	8100	5560	-2540	0.06	0.69	14	9	-5
0048	2T	15	12	366	101	36600	25750	-10850	0.28	0.70	64	45	-19
0048	2T	15	13	210	49	21000	14360	-6640	0.23	0.68	37	25	-12
0048	2T	15	14	181	34	18100	12960	-5140	0.19	0.72	32	22	-10
0048	2T	15	15	111	15	11100	10770	-330	0.14	0.97	19	19	0
0048	2T	15	16	78	6	7800	6760	-1040	0.08	0.87	13	11	-2
0048	2T	15	21	36	4	3600	4380	780	0.11	1.22	6	7	1
0048	2T	15	23	33	3	3300	4810	1510	0.09	1.46	5	8	3
0048	2T	15	24	64	2	6400	1010	-5390	0.03	0.16	11	1	-10
0048	2T	15	25	70	1	7000	610	-6390	0.01	0.09	12	1	-11
0048	2T	15	26	71	6	7100	7020	-80	0.08	0.99	12	12	0
0048	2T	16	12	373	127	37300	32410	-4890	0.34	0.87	66	57	-9
0048	2T	16	13	254	59	25400	17530	-7870	0.23	0.69	44	31	-13
0048	2T	16	14	193	46	19300	18660	-640	0.24	0.97	34	33	-1
0048	2T	16	15	149	16	14900	9530	-5370	0.11	0.64	26	16	-10
0048	2T	16	16	68	8	6800	7850	1050	0.12	1.15	12	13	1
0048	2T	16	21	33	6	3300	3530	230	0.18	1.07	5	6	1
0048	2T	16	23	33	4	3300	2670	-630	0.12	0.81	5	4	-1
0048	2T	16	24	42	8	4200	8160	3960	0.19	1.94	7	14	7
0048	2T	16	25	73	3	7300	1720	-5580	0.04	0.24	12	3	-9
0048	2T	16	26	92	3	9200	4760	-4440	0.03	0.52	16	8	-8
0048	2T	17	12	380	116	38000	28620	-9380	0.31	0.75	67	50	-17
0048	2T	17	13	262	81	26200	24230	-1970	0.31	0.92	46	42	-4
0048	2T	17	14	170	35	17000	13860	-3140	0.21	0.82	30	24	-6
0048	2T	17	15	136	17	13600	10820	-2780	0.13	0.80	24	19	-5
0048	2T	17	16	111	14	11100	15470	4370	0.13	1.39	19	27	8
0048	2T	17	21	40	6	4000	4060	60	0.15	1.02	7	7	0
0048	2T	17	23	34	4	3400	2130	-1270	0.12	0.63	6	3	-3
0048	2T	17	24	57	6	5700	3370	-2330	0.11	0.59	10	5	-5
0048	2T	17	25	89	8	8900	5990	-2910	0.09	0.67	15	10	-5
0048	2T	17	26	72	4	7200	7170	-30	0.06	1.00	12	12	0
0048	2T	18	12	467	183	46700	37140	-9560	0.39	0.80	82	65	-17
0048	2T	18	13	191	46	19100	14820	-4280	0.24	0.78	33	26	-7
0048	2T	18	14	302	66	30200	24510	-5690	0.22	0.81	53	43	-10
0048	2T	18	15	211	28	21100	14670	-6430	0.13	0.70	37	25	-12
0048	2T	18	16	87	6	8700	4930	-3770	0.07	0.57	15	8	-7
0048	2T	18	21	28	2	2800	760	-2040	0.07	0.27	4	1	-3
0048	2T	18	23	12	0	1200	0	-1200	0.00	0.00	2	0	-2
0048	2T	18	24	54	5	5400	2790	-2610	0.09	0.52	9	4	-5
0048	2T	18	25	112	11	11200	6020	-5180	0.10	0.54	19	10	-9
0048	2T	18	26	98	8	9800	6190	-3610	0.08	0.63	17	10	-7
0048	2T	19	12	261	76	26100	20560	-5540	0.29	0.79	46	36	-10
0048	2T	19	13	201	52	20100	14280	-5820	0.26	0.71	35	25	-10
0048	2T	19	14	249	54	24900	21220	-3680	0.22	0.85	44	37	-7
0048	2T	19	15	121	11	12100	6310	-5790	0.09	0.52	21	11	-10
0048	2T	19	16	60	7	6000	4560	-1440	0.12	0.76	10	8	-2
0048	2T	19	21	18	1	1800	610	-1190	0.06	0.34	3	1	-2
0048	2T	19	23	16	1	1600	480	-1120	0.06	0.30	2	0	-2
0048	2T	19	24	52	5	5200	2380	-2820	0.10	0.46	9	4	-5
0048	2T	19	25	54	0	5400	0	-5400	0.00	0.00	9	0	-9
0048	2T	19	26	72	3	7200	2610	-4590	0.04	0.36	12	4	-8
0048	2T	20	12	347	109	34700	26660	-8040	0.31	0.77	61	47	-14
0048	2T	20	13	226	79	22600	23130	530	0.35	1.02	40	40	0
0048	2T	20	14	183	28	18300	10870	-7430	0.15	0.59	32	19	-13
0048	2T	20	15	150	31	15000	19170	4170	0.21	1.28	26	33	7
0048	2T	20	16	69	6	6900	4090	-2810	0.09	0.59	12	7	-5
0048	2T	20	21	22	1	2200	360	-1840	0.05	0.16	3	0	-3
0048	2T	20	23	25	2	2500	2470	-30	0.08	0.99	4	4	0
0048	2T	20	24	74	6	7400	3960	-3440	0.08	0.54	13	7	-6
0048	2T	20	25	55	2	5500	3030	-2470	0.04	0.55	9	5	-4
0048	2T	20	26	41	1	4100	1490	-2610	0.02	0.36	7	2	-5
0048	2T	21	12	309	101	30900	25040	-5860	0.33	0.81	54	44	-10
0048	2T	21	13	252	79	25200	20980	-4220	0.31	0.83	44	37	-7
0048	2T	21	14	266	57	26600	22930	-3670	0.21	0.86	47	40	-7
0048	2T	21	15	212	35	21200	25630	4430	0.17	1.21	37	45	8
0048	2T	21	16	75	10	7500	9960	2460	0.13	1.33	13	17	4
0048	2T	21	21	38	9	3800	5080	1280	0.24	1.34	6	8	2
0048	2T	21	23	13	1	1300	2140	840	0.08	1.65	2	3	1
0048	2T	21	24	39	1	3900	400	-3500	0.03	0.10	6	0	-6
0048	2T	21	25	54	3	5400	4960	-440	0.06	0.92	9	8	-1
0048	2T	21	26	72	3	7200	6500	-700	0.04	0.90	12	11	-1
0048	2T	22	12	289	96	28900	27600	-1300	0.33	0.96	51	48	-3
0048	2T	22	13	155	36	15500	12560	-2940	0.23	0.81	27	22	-5
0048	2T	22	14	172	26	17200	9260	-7940	0.15	0.54	30	16	-14
0048	2T	22	15	79	5	7900	7970	70	0.06	1.01	13	14	1
0048	2T	22	16	133	9	13300	14440	1140	0.07	1.09	23	25	2
0048	2T	22	21	22	3	2200	2380	180	0.14	1.08	3	4	1
0048	2T	22	23	54	3	5400	2720	-2680	0.06	0.50	9	4	-5
0048	2T	22	24	40	5	4000	4140	140	0.13	1.04	7	7	0
0048	2T	22	25	87	3	8700	9290	590	0.03	1.07	15	16	1
0048	2T	22	26	60	3	6000	2490	-3510	0.05	0.42	10	4	-6
0048	2T	23	12	352	98	35200	24090	-11110	0.28	0.68	62	42	-20
0048	2T	23	13	206	46	20600	14170	-6430	0.22	0.69	36	25	-11
0048	2T	23	14	103	19	10300	7460	-2840	0.18	0.72	18	13	-5
0048	2T	23	15	122	23	12200	17010	4810	0.19	1.39	21	30	9
0048	2T	23	16	108	9	10800	9600	-1200	0.08	0.89	19	16	-3
0048	2T	23	21	67	7	6700	3740	-2960	0.10	0.56	11	6	-5
0048	2T	23	23	43	2	4300	950	-3350	0.05	0.22	7	1	-6
0048	2T	23	24	54	10	5400	6570	1170	0.19	1.22	9	11	2
0048	2T	23	25	67	5	6700	8050	1350	0.07	1.20	11	14	3
0048	2T	23	26	51	0	5100	0	-5100	0.00	0.00	9	0	-9
0048	2T	24	12	416	141	41600	30460	-11140	0.34	0.73	73	53	-20
0048	2T	24	13	245	65	24500	17430	-7070	0.27	0.71	43	30	-13
0048	2T	24	14	172	32	17200	10600	-6600	0.19	0.62	30	18	-12
0048	2T	24	15	164	20	16400	12400	-4000	0.12	0.76	29	21	-8
0048	2T	24	16	122	12	12200	15360	3160	0.10	1.26	21	27	6
0048	2T	24	21	41	1	4100	500	-3600	0.02	0.12	7	0	-7
0048	2T	24	23	15	4	1500	3650	2150	0.27	2.43	2	6	4
0048	2T	24	24	25	4	2500	3340	840	0.16	1.34	4	5	1
0048	2T	24	25	54	2	5400	810	-4590	0.04	0.15	9	1	-8
0048	2T	24	26	71	4	7100	3320	-3780	0.06	0.47	12	5	-7
0048	3F	01	123	70	18	7000	4130	-2870	0.26	0.59	12	7	-5
0048	3F	01	124	134	18	13400	6770	-6630	0.13	0.51	23	11	-12
0048	3F	01	125	66	11	6600	6120	-480	0.17	0.93	11	10	-1
0048	3F	01	126	167	20	16700	22510	5810	0.12	1.35	29	39	10
0048	3F	01	134	38	2	3800	1720	-2080	0.05	0.45	6	3	-3
0048	3F	01	135	65	9	6500	5730	-770	0.14	0.88	11	10	-1
0048	3F	01	136	140	11	14000	13210	-790	0.08	0.94	24	23	-1
0048	3F	01	145	29	4	2900	2860	-40	0.14	0.99	5	5	0
0048	3F	01	146	20	2	2000	1100	-900	0.10	0.55	3	1	-2
0048	3F	01	156	25	1	2500	330	-2170	0.04	0.13	4	0	-4
0048	3F	01	234	8	1	800	220	-580	0.13	0.28	1	0	-1
0048	3F	01	235	13	0	1300	0	-1300	0.00	0.00	2	0	-2
0048	3F	01	236	12	3	1200	2930	1730	0.25	2.44	2	5	3
0048	3F	01	245	15	3	1500	3260	1760	0.20	2.17	2	5	3
0048	3F	01	246	11	0	1100	0	-1100	0.00	0.00	1	0	-1
0048	3F	01	256	9	0	900	0	-900	0.00	0.00	1	0	-1
0048	3F	02	123	53	15	5300	5000	-300	0.28	0.94	9	8	-1
0048	3F	02	124	115	23	11500	11330	-170	0.20	0.99	20	20	0
0048	3F	02	125	71	10	7100	6260	-840	0.14	0.88	12	11	-1
0048	3F	02	126	121	6	12100	4990	-7110	0.05	0.41	21	8	-13
0048	3F	02	134	53	3	5300	1210	-4090	0.06	0.23	9	2	-7
0048	3F	02	135	27	3	2700	1280	-1420	0.11	0.47	4	2	-2
0048	3F	02	136	83	9	8300	7260	-1040	0.11	0.87	14	12	-2
0048	3F	02	145	25	3	2500	1690	-810	0.12	0.68	4	2	-2
0048	3F	02	146	47	6	4700	7220	2520	0.13	1.54	8	12	4
0048	3F	02	156	47	2	4700	3050	-1650	0.04	0.65	8	5	-3
0048	3F	02	234	12	1	1200	340	-860	0.08	0.28	2	0	-2
0048	3F	02	235	11	2	1100	1430	330	0.18	1.30	1	2	1
0048	3F	02	236	11	1	1100	660	-440	0.09	0.60	1	1	0
0048	3F	02	245	4	0	400	0	-400	0.00	0.00	0	0	0
0048	3F	02	246	16	1	1600	300	-1300	0.06	0.19	2	0	-2
0048	3F	02	256	22	1	2200	1290	-910	0.05	0.59	3	2	-1
0048	3F	03	123	59	22	5900	6140	240	0.37	1.04	10	10	0
0048	3F	03	124	81	14	8100	4860	-3240	0.17	0.60	14	8	-6
0048	3F	03	125	77	11	7700	9900	2200	0.14	1.29	13	17	4
0048	3F	03	126	87	7	8700	6530	-2170	0.08	0.75	15	11	-4
0048	3F	03	134	26	1	2600	330	-2270	0.04	0.13	4	0	-4
0048	3F	03	135	17	4	1700	2880	1180	0.24	1.69	3	5	2
0048	3F	03	136	23	2	2300	1360	-940	0.09	0.59	4	2	-2
0048	3F	03	145	13	2	1300	1170	-130	0.15	0.90	2	2	0
0048	3F	03	146	12	1	1200	2020	820	0.08	1.68	2	3	1
0048	3F	03	156	18	1	1800	1730	-70	0.06	0.96	3	3	0
0048	3F	03	234	2	1	200	1800	1600	0.50	9.00	0	3	3
0048	3F	03	235	5	0	500	0	-500	0.00	0.00	0	0	0
0048	3F	03	236	1	0	100	0	-100	0.00	0.00	0	0	0
0048	3F	03	245	7	1	700	260	-440	0.14	0.37	1	0	-1
0048	3F	03	246	5	1	500	620	120	0.20	1.24	0	1	1
0048	3F	03	256	5	1	500	450	-50	0.20	0.90	0	0	0
0048	3F	04	123	50	18	5000	5840	840	0.36	1.17	8	10	2
0048	3F	04	124	108	29	10800	10300	-500	0.27	0.95	19	18	-1
0048	3F	04	125	55	5	5500	2040	-3460	0.09	0.37	9	3	-6
0048	3F	04	126	102	10	10200	8550	-1650	0.10	0.84	18	15	-3
0048	3F	04	134	33	6	3300	1710	-1590	0.18	0.52	5	3	-2
0048	3F	04	135	31	4	3100	1730	-1370	0.13	0.56	5	3	-2
0048	3F	04	136	44	4	4400	2390	-2010	0.09	0.54	7	4	-3
0048	3F	04	145	31	2	3100	1490	-1610	0.06	0.48	5	2	-3
0048	3F	04	146	38	1	3800	2010	-1790	0.03	0.53	6	3	-3
0048	3F	04	156	44	1	4400	1480	-2920	0.02	0.34	7	2	-5
0048	3F	04	234	2	0	200	0	-200	0.00	0.00	0	0	0
0048	3F	04	235	5	2	500	1150	650	0.40	2.30	0	2	2
0048	3F	04	236	2	1	200	1450	1250	0.50	7.25	0	2	2
0048	3F	04	245	6	0	600	0	-600	0.00	0.00	1	0	-1
0048	3F	04	246	3	0	300	0	-300	0.00	0.00	0	0	0
0048	3F	04	256	9	0	900	0	-900	0.00	0.00	1	0	-1
0048	3F	05	123	61	20	6100	6730	630	0.33	1.10	10	11	1
0048	3F	05	124	139	37	13900	12520	-1380	0.27	0.90	24	22	-2
0048	3F	05	125	74	8	7400	3670	-3730	0.11	0.50	13	6	-7
0048	3F	05	126	141	10	14100	9900	-4200	0.07	0.70	24	17	-7
0048	3F	05	134	43	9	4300	5620	1320	0.21	1.31	7	9	2
0048	3F	05	135	31	0	3100	0	-3100	0.00	0.00	5	0	-5
0048	3F	05	136	64	10	6400	11560	5160	0.16	1.81	11	20	9
0048	3F	05	145	22	3	2200	2050	-150	0.14	0.93	3	3	0
0048	3F	05	146	37	3	3700	2070	-1630	0.08	0.56	6	3	-3
0048	3F	05	156	73	3	7300	3240	-4060	0.04	0.44	12	5	-7
0048	3F	05	234	4	0	400	0	-400	0.00	0.00	0	0	0
0048	3F	05	235	4	0	400	0	-400	0.00	0.00	0	0	0
0048	3F	05	236	9	1	900	2000	1100	0.11	2.22	1	3	2
0048	3F	05	245	5	0	500	0	-500	0.00	0.00	0	0	0
0048	3F	05	246	6	0	600	0	-600	0.00	0.00	1	0	-1
0048	3F	05	256	14	1	1400	420	-980	0.07	0.30	2	0	-2
0048	3F	06	123	69	23	6900	6550	-350	0.33	0.95	12	11	-1
0048	3F	06	124	119	27	11900	9700	-2200	0.23	0.82	21	17	-4
0048	3F	06	125	83	14	8300	7070	-1230	0.17	0.85	14	12	-2
0048	3F	06	126	137	14	13700	11640	-2060	0.10	0.85	24	20	-4
0048	3F	06	134	37	9	3700	4680	980	0.24	1.26	6	8	2
0048	3F	06	135	44	4	4400	1300	-3100	0.09	0.30	7	2	-5
0048	3F	06	136	73	8	7300	3990	-3310	0.11	0.55	12	7	-5
0048	3F	06	145	36	3	3600	2700	-900	0.08	0.75	6	4	-2
0048	3F	06	146	61	4	6100	3650	-2450	0.07	0.60	10	6	-4
0048	3F	06	156	45	3	4500	3790	-710	0.07	0.84	7	6	-1
0048	3F	06	235	1	0	100	0	-100	0.00	0.00	0	0	0
0048	3F	06	236	4	0	400	0	-400	0.00	0.00	0	0	0
0048	3F	06	245	6	0	600	0	-600	0.00	0.00	1	0	-1
0048	3F	06	246	9	0	900	0	-900	0.00	0.00	1	0	-1
0048	3F	06	256	16	1	1600	450	-1150	0.06	0.28	2	0	-2
0048	3F	07	123	48	11	4800	3710	-1090	0.23	0.77	8	6	-2
0048	3F	07	124	92	21	9200	5970	-3230	0.23	0.65	16	10	-6
0048	3F	07	125	59	5	5900	2470	-3430	0.08	0.42	10	4	-6
0048	3F	07	126	132	12	13200	8490	-4710	0.09	0.64	23	15	-8
0048	3F	07	134	74	18	7400	5660	-1740	0.24	0.76	13	10	-3
0048	3F	07	135	52	7	5200	4890	-310	0.13	0.94	9	8	-1
0048	3F	07	136	55	7	5500	4630	-870	0.13	0.84	9	8	-1
0048	3F	07	145	65	5	6500	4560	-1940	0.08	0.70	11	8	-3
0048	3F	07	146	76	6	7600	3480	-4120	0.08	0.46	13	6	-7
0048	3F	07	156	54	3	5400	2230	-3170	0.06	0.41	9	3	-6
0048	3F	07	234	3	0	300	0	-300	0.00	0.00	0	0	0
0048	3F	07	235	4	0	400	0	-400	0.00	0.00	0	0	0
0048	3F	07	236	3	0	300	0	-300	0.00	0.00	0	0	0
0048	3F	07	245	5	0	500	0	-500	0.00	0.00	0	0	0
0048	3F	07	246	12	3	1200	4320	3120	0.25	3.60	2	7	5
0048	3F	07	256	15	0	1500	0	-1500	0.00	0.00	2	0	-2
0048	3F	08	123	46	17	4600	4230	-370	0.37	0.92	8	7	-1
0048	3F	08	124	106	25	10600	8350	-2250	0.24	0.79	18	14	-4
0048	3F	08	125	75	10	7500	4620	-2880	0.13	0.62	13	8	-5
0048	3F	08	126	130	13	13000	10280	-2720	0.10	0.79	23	18	-5
0048	3F	08	134	52	13	5200	4930	-270	0.25	0.95	9	8	-1
0048	3F	08	135	41	5	4100	2600	-1500	0.12	0.63	7	4	-3
0048	3F	08	136	67	6	6700	4330	-2370	0.09	0.65	11	7	-4
0048	3F	08	145	55	4	5500	3830	-1670	0.07	0.70	9	6	-3
0048	3F	08	146	74	5	7400	5790	-1610	0.07	0.78	13	10	-3
0048	3F	08	156	50	3	5000	5260	260	0.06	1.05	8	9	1
0048	3F	08	236	4	1	400	1530	1130	0.25	3.83	0	2	2
0048	3F	08	245	3	0	300	0	-300	0.00	0.00	0	0	0
0048	3F	08	246	6	0	600	0	-600	0.00	0.00	1	0	-1
0048	3F	08	256	10	1	1000	360	-640	0.10	0.36	1	0	-1
0048	3F	09	123	101	30	10100	7520	-2580	0.30	0.74	17	13	-4
0048	3F	09	124	150	35	15000	14180	-820	0.23	0.95	26	25	-1
0048	3F	09	125	143	26	14300	11630	-2670	0.18	0.81	25	20	-5
0048	3F	09	126	134	16	13400	8400	-5000	0.12	0.63	23	14	-9
0048	3F	09	134	54	9	5400	4630	-770	0.17	0.86	9	8	-1
0048	3F	09	135	49	8	4900	4200	-700	0.16	0.86	8	7	-1
0048	3F	09	136	57	6	5700	3900	-1800	0.11	0.68	10	6	-4
0048	3F	09	145	56	3	5600	1880	-3720	0.05	0.34	9	3	-6
0048	3F	09	146	34	2	3400	1250	-2150	0.06	0.37	6	2	-4
0048	3F	09	156	37	1	3700	1220	-2480	0.03	0.33	6	2	-4
0048	3F	09	234	2	0	200	0	-200	0.00	0.00	0	0	0
0048	3F	09	236	10	1	1000	650	-350	0.10	0.65	1	1	0
0048	3F	09	245	8	1	800	300	-500	0.13	0.38	1	0	-1
0048	3F	09	246	8	0	800	0	-800	0.00	0.00	1	0	-1
0048	3F	09	256	25	0	2500	0	-2500	0.00	0.00	4	0	-4
0048	3F	10	123	112	35	11200	7490	-3710	0.31	0.67	19	13	-6
0048	3F	10	124	107	26	10700	8540	-2160	0.24	0.80	18	15	-3
0048	3F	10	125	126	14	12600	7640	-4960	0.11	0.61	22	13	-9
0048	3F	10	126	80	6	8000	4470	-3530	0.08	0.56	14	7	-7
0048	3F	10	134	51	4	5100	1420	-3680	0.08	0.28	9	2	-7
0048	3F	10	135	52	7	5200	3290	-1910	0.13	0.63	9	5	-4
0048	3F	10	136	50	7	5000	5160	160	0.14	1.03	8	9	1
0048	3F	10	145	42	8	4200	5490	1290	0.19	1.31	7	9	2
0048	3F	10	146	35	2	3500	1480	-2020	0.06	0.42	6	2	-4
0048	3F	10	156	34	0	3400	0	-3400	0.00	0.00	6	0	-6
0048	3F	10	234	5	0	500	0	-500	0.00	0.00	0	0	0
0048	3F	10	235	3	1	300	670	370	0.33	2.23	0	1	1
0048	3F	10	236	4	0	400	0	-400	0.00	0.00	0	0	0
0048	3F	10	245	7	0	700	0	-700	0.00	0.00	1	0	-1
0048	3F	10	246	6	0	600	0	-600	0.00	0.00	1	0	-1
0048	3F	10	256	7	0	700	0	-700	0.00	0.00	1	0	-1
0048	3F	11	123	71	19	7100	5060	-2040	0.27	0.71	12	8	-4
0048	3F	11	124	125	28	12500	10360	-2140	0.22	0.83	22	18	-4
0048	3F	11	125	146	26	14600	10170	-4430	0.18	0.70	25	18	-7
0048	3F	11	126	107	16	10700	12320	1620	0.15	1.15	18	21	3
0048	3F	11	134	97	19	9700	7580	-2120	0.20	0.78	17	13	-4
0048	3F	11	135	32	5	3200	3420	220	0.16	1.07	5	6	1
0048	3F	11	136	104	6	10400	9870	-530	0.06	0.95	18	17	-1
0048	3F	11	145	32	5	3200	4080	880	0.16	1.28	5	7	2
0048	3F	11	146	35	1	3500	1130	-2370	0.03	0.32	6	2	-4
0048	3F	11	156	16	1	1600	1240	-360	0.06	0.78	2	2	0
0048	3F	11	234	20	0	2000	0	-2000	0.00	0.00	3	0	-3
0048	3F	11	235	15	1	1500	690	-810	0.07	0.46	2	1	-1
0048	3F	11	236	31	0	3100	0	-3100	0.00	0.00	5	0	-5
0048	3F	11	245	14	1	1400	490	-910	0.07	0.35	2	0	-2
0048	3F	11	246	19	1	1900	2090	190	0.05	1.10	3	3	0
0048	3F	11	256	43	1	4300	930	-3370	0.02	0.22	7	1	-6
0048	3F	12	123	48	14	4800	4390	-410	0.29	0.91	8	7	-1
0048	3F	12	124	192	44	19200	18400	-800	0.23	0.96	33	32	-1
0048	3F	12	125	44	8	4400	4650	250	0.18	1.06	7	8	1
0048	3F	12	126	176	18	17600	16280	-1320	0.10	0.93	31	28	-3
0048	3F	12	134	103	17	10300	10520	220	0.17	1.02	18	18	0
0048	3F	12	135	30	6	3000	3480	480	0.20	1.16	5	6	1
0048	3F	12	136	69	9	6900	9230	2330	0.13	1.34	12	16	4
0048	3F	12	145	27	4	2700	3470	770	0.15	1.29	4	6	2
0048	3F	12	146	33	7	3300	5800	2500	0.21	1.76	5	10	5
0048	3F	12	156	19	1	1900	1520	-380	0.05	0.80	3	2	-1
0048	3F	12	234	23	3	2300	790	-1510	0.13	0.34	4	1	-3
0048	3F	12	235	19	2	1900	1790	-110	0.11	0.94	3	3	0
0048	3F	12	236	3	0	300	0	-300	0.00	0.00	0	0	0
0048	3F	12	245	21	1	2100	540	-1560	0.05	0.26	3	0	-3
0048	3F	12	246	10	2	1000	2990	1990	0.20	2.99	1	5	4
0048	3F	12	256	22	0	2200	0	-2200	0.00	0.00	3	0	-3
0048	3F	13	123	44	10	4400	2910	-1490	0.23	0.66	7	5	-2
0048	3F	13	124	102	28	10200	9340	-860	0.27	0.92	18	16	-2
0048	3F	13	125	47	7	4700	4910	210	0.15	1.04	8	8	0
0048	3F	13	126	145	11	14500	7510	-6990	0.08	0.52	25	13	-12
0048	3F	13	134	31	11	3100	4380	1280	0.35	1.41	5	7	2
0048	3F	13	135	25	2	2500	1290	-1210	0.08	0.52	4	2	-2
0048	3F	13	136	72	6	7200	4510	-2690	0.08	0.63	12	7	-5
0048	3F	13	145	17	0	1700	0	-1700	0.00	0.00	3	0	-3
0048	3F	13	146	67	1	6700	760	-5940	0.01	0.11	11	1	-10
0048	3F	13	156	48	1	4800	430	-4370	0.02	0.09	8	0	-8
0048	3F	13	234	2	0	200	0	-200	0.00	0.00	0	0	0
0048	3F	13	235	7	2	700	760	60	0.29	1.09	1	1	0
0048	3F	13	236	2	0	200	0	-200	0.00	0.00	0	0	0
0048	3F	13	245	6	1	600	380	-220	0.17	0.63	1	0	-1
0048	3F	13	246	10	0	1000	0	-1000	0.00	0.00	1	0	-1
0048	3F	13	256	7	0	700	0	-700	0.00	0.00	1	0	-1
0048	3F	14	123	89	31	8900	11970	3070	0.35	1.34	15	21	6
0048	3F	14	124	147	31	14700	10040	-4660	0.21	0.68	26	17	-9
0048	3F	14	125	69	5	6900	3220	-3680	0.07	0.47	12	5	-7
0048	3F	14	126	111	10	11100	8700	-2400	0.09	0.78	19	15	-4
0048	3F	14	134	59	12	5900	3940	-1960	0.20	0.67	10	6	-4
0048	3F	14	135	35	6	3500	2720	-780	0.17	0.78	6	4	-2
0048	3F	14	136	50	4	5000	6250	1250	0.08	1.25	8	11	3
0048	3F	14	145	27	3	2700	2390	-310	0.11	0.89	4	4	0
0048	3F	14	146	37	2	3700	2360	-1340	0.05	0.64	6	4	-2
0048	3F	14	156	25	1	2500	3210	710	0.04	1.28	4	5	1
0048	3F	14	234	1	0	100	0	-100	0.00	0.00	0	0	0
0048	3F	14	235	4	1	400	1070	670	0.25	2.68	0	1	1
0048	3F	14	236	8	0	800	0	-800	0.00	0.00	1	0	-1
0048	3F	14	245	5	1	500	890	390	0.20	1.78	0	1	1
0048	3F	14	246	8	0	800	0	-800	0.00	0.00	1	0	-1
0048	3F	14	256	10	2	1000	5000	4000	0.20	5.00	1	8	7
0048	3F	15	123	72	15	7200	3970	-3230	0.21	0.55	12	7	-5
0048	3F	15	124	194	48	19400	13120	-6280	0.25	0.68	34	23	-11
0048	3F	15	125	69	6	6900	4060	-2840	0.09	0.59	12	7	-5
0048	3F	15	126	150	12	15000	9550	-5450	0.08	0.64	26	16	-10
0048	3F	15	134	75	16	7500	5350	-2150	0.21	0.71	13	9	-4
0048	3F	15	135	34	4	3400	1930	-1470	0.12	0.57	6	3	-3
0048	3F	15	136	68	7	6800	4440	-2360	0.10	0.65	12	7	-5
0048	3F	15	145	31	4	3100	2950	-150	0.13	0.95	5	5	0
0048	3F	15	146	41	4	4100	3320	-780	0.10	0.81	7	5	-2
0048	3F	15	156	36	3	3600	6630	3030	0.08	1.84	6	11	5
0048	3F	15	234	3	0	300	0	-300	0.00	0.00	0	0	0
0048	3F	15	235	5	0	500	0	-500	0.00	0.00	0	0	0
0048	3F	15	236	4	0	400	0	-400	0.00	0.00	0	0	0
0048	3F	15	245	8	0	800	0	-800	0.00	0.00	1	0	-1
0048	3F	15	246	8	1	800	480	-320	0.13	0.60	1	0	-1
0048	3F	15	256	13	1	1300	460	-840	0.08	0.35	2	0	-2
0048	3F	16	123	116	40	11600	7860	-3740	0.34	0.68	20	13	-7
0048	3F	16	124	149	35	14900	14290	-610	0.23	0.96	26	25	-1
0048	3F	16	125	87	10	8700	6510	-2190	0.11	0.75	15	11	-4
0048	3F	16	126	128	8	12800	8230	-4570	0.06	0.64	22	14	-8
0048	3F	16	134	71	16	7100	6080	-1020	0.23	0.86	12	10	-2
0048	3F	16	135	49	6	4900	2920	-1980	0.12	0.60	8	5	-3
0048	3F	16	136	61	7	6100	6290	190	0.11	1.03	10	11	1
0048	3F	16	145	43	3	4300	1090	-3210	0.07	0.25	7	1	-6
0048	3F	16	146	44	3	4400	2130	-2270	0.07	0.48	7	3	-4
0048	3F	16	156	72	3	7200	5250	-1950	0.04	0.73	12	9	-3
0048	3F	16	234	3	1	300	860	560	0.33	2.87	0	1	1
0048	3F	16	235	3	1	300	570	270	0.33	1.90	0	1	1
0048	3F	16	236	8	0	800	0	-800	0.00	0.00	1	0	-1
0048	3F	16	245	4	1	400	1010	610	0.25	2.53	0	1	1
0048	3F	16	246	6	0	600	0	-600	0.00	0.00	1	0	-1
0048	3F	16	256	19	1	1900	1550	-350	0.05	0.82	3	2	-1
0048	3F	17	123	127	44	12700	11470	-1230	0.35	0.90	22	20	-2
0048	3F	17	124	138	23	13800	8170	-5630	0.17	0.59	24	14	-10
0048	3F	17	125	93	16	9300	7100	-2200	0.17	0.76	16	12	-4
0048	3F	17	126	160	12	16000	9990	-6010	0.08	0.62	28	17	-11
0048	3F	17	134	55	12	5500	3860	-1640	0.22	0.70	9	6	-3
0048	3F	17	135	60	7	6000	5030	-970	0.12	0.84	10	8	-2
0048	3F	17	136	56	5	5600	3780	-1820	0.09	0.68	9	6	-3
0048	3F	17	145	33	2	3300	1200	-2100	0.06	0.36	5	2	-3
0048	3F	17	146	51	3	5100	3330	-1770	0.06	0.65	9	5	-4
0048	3F	17	156	67	0	6700	0	-6700	0.00	0.00	11	0	-11
0048	3F	17	234	7	1	700	1280	580	0.14	1.83	1	2	1
0048	3F	17	235	2	0	200	0	-200	0.00	0.00	0	0	0
0048	3F	17	236	4	0	400	0	-400	0.00	0.00	0	0	0
0048	3F	17	245	4	0	400	0	-400	0.00	0.00	0	0	0
0048	3F	17	246	7	1	700	440	-260	0.14	0.63	1	0	-1
0048	3F	17	256	13	0	1300	0	-1300	0.00	0.00	2	0	-2
0048	3F	18	123	91	24	9100	7760	-1340	0.26	0.85	16	13	-3
0048	3F	18	124	157	37	15700	11790	-3910	0.24	0.75	27	20	-7
0048	3F	18	125	148	24	14800	12740	-2060	0.16	0.86	26	22	-4
0048	3F	18	126	143	13	14300	9470	-4830	0.09	0.66	25	16	-9
0048	3F	18	134	55	11	5500	3980	-1520	0.20	0.72	9	7	-2
0048	3F	18	135	66	6	6600	4190	-2410	0.09	0.63	11	7	-4
0048	3F	18	136	45	4	4500	2970	-1530	0.09	0.66	7	5	-2
0048	3F	18	145	110	15	11000	8330	-2670	0.14	0.76	19	14	-5
0048	3F	18	146	39	6	3900	8290	4390	0.15	2.13	6	14	8
0048	3F	18	156	44	1	4400	2180	-2220	0.02	0.50	7	3	-4
0048	3F	18	235	1	0	100	0	-100	0.00	0.00	0	0	0
0048	3F	18	236	5	0	500	0	-500	0.00	0.00	0	0	0
0048	3F	18	245	3	0	300	0	-300	0.00	0.00	0	0	0
0048	3F	18	246	6	1	600	410	-190	0.17	0.68	1	0	-1
0048	3F	18	256	23	3	2300	1640	-660	0.13	0.71	4	2	-2
0048	3F	19	123	41	7	4100	2560	-1540	0.17	0.62	7	4	-3
0048	3F	19	124	131	30	13100	9440	-3660	0.23	0.72	23	16	-7
0048	3F	19	125	58	5	5800	3010	-2790	0.09	0.52	10	5	-5
0048	3F	19	126	101	7	10100	5560	-4540	0.07	0.55	17	9	-8
0048	3F	19	134	47	8	4700	2140	-2560	0.17	0.46	8	3	-5
0048	3F	19	135	45	6	4500	3410	-1090	0.13	0.76	7	6	-1
0048	3F	19	136	59	7	5900	3560	-2340	0.12	0.60	10	6	-4
0048	3F	19	145	52	7	5200	3330	-1870	0.13	0.64	9	5	-4
0048	3F	19	146	53	5	5300	3800	-1500	0.09	0.72	9	6	-3
0048	3F	19	156	46	1	4600	1710	-2890	0.02	0.37	8	3	-5
0048	3F	19	234	1	0	100	0	-100	0.00	0.00	0	0	0
0048	3F	19	235	2	0	200	0	-200	0.00	0.00	0	0	0
0048	3F	19	236	3	0	300	0	-300	0.00	0.00	0	0	0
0048	3F	19	245	4	0	400	0	-400	0.00	0.00	0	0	0
0048	3F	19	246	8	0	800	0	-800	0.00	0.00	1	0	-1
0048	3F	19	256	7	1	700	360	-340	0.14	0.51	1	0	-1
0048	3F	20	123	81	26	8100	6310	-1790	0.32	0.78	14	11	-3
0048	3F	20	124	127	32	12700	10220	-2480	0.25	0.80	22	18	-4
0048	3F	20	125	82	9	8200	4380	-3820	0.11	0.53	14	7	-7
0048	3F	20	126	115	8	11500	8050	-3450	0.07	0.70	20	14	-6
0048	3F	20	134	53	13	5300	4070	-1230	0.25	0.77	9	7	-2
0048	3F	20	135	46	12	4600	6650	2050	0.26	1.45	8	11	3
0048	3F	20	136	60	8	6000	5870	-130	0.13	0.98	10	10	0
0048	3F	20	145	49	7	4900	3930	-970	0.14	0.80	8	6	-2
0048	3F	20	146	56	5	5600	4470	-1130	0.09	0.80	9	7	-2
0048	3F	20	156	55	3	5500	5030	-470	0.05	0.91	9	8	-1
0048	3F	20	234	3	1	300	3510	3210	0.33	11.70	0	6	6
0048	3F	20	235	4	0	400	0	-400	0.00	0.00	0	0	0
0048	3F	20	236	1	0	100	0	-100	0.00	0.00	0	0	0
0048	3F	20	245	7	1	700	1380	680	0.14	1.97	1	2	1
0048	3F	20	246	5	1	500	920	420	0.20	1.84	0	1	1
0048	3F	20	256	9	0	900	0	-900	0.00	0.00	1	0	-1
0048	3F	21	123	57	20	5700	5520	-180	0.35	0.97	10	9	-1
0048	3F	21	124	105	20	10500	5680	-4820	0.19	0.54	18	10	-8
0048	3F	21	125	111	16	11100	10360	-740	0.14	0.93	19	18	-1
0048	3F	21	126	91	7	9100	3880	-5220	0.08	0.43	16	6	-10
0048	3F	21	134	54	10	5400	2600	-2800	0.19	0.48	9	4	-5
0048	3F	21	135	75	9	7500	5990	-1510	0.12	0.80	13	10	-3
0048	3F	21	136	51	6	5100	4620	-480	0.12	0.91	9	8	-1
0048	3F	21	145	58	10	5800	5500	-300	0.17	0.95	10	9	-1
0048	3F	21	146	57	4	5700	5290	-410	0.07	0.93	10	9	-1
0048	3F	21	156	60	3	6000	8550	2550	0.05	1.43	10	15	5
0048	3F	21	234	1	0	100	0	-100	0.00	0.00	0	0	0
0048	3F	21	235	3	0	300	0	-300	0.00	0.00	0	0	0
0048	3F	21	236	2	1	200	2190	1990	0.50	10.95	0	3	3
0048	3F	21	245	2	0	200	0	-200	0.00	0.00	0	0	0
0048	3F	21	246	8	0	800	0	-800	0.00	0.00	1	0	-1
0048	3F	21	256	6	0	600	0	-600	0.00	0.00	1	0	-1
0048	3F	22	123	85	20	8500	5870	-2630	0.24	0.69	15	10	-5
0048	3F	22	124	116	24	11600	7380	-4220	0.21	0.64	20	13	-7
0048	3F	22	125	86	12	8600	4590	-4010	0.14	0.53	15	8	-7
0048	3F	22	126	106	6	10600	5220	-5380	0.06	0.49	18	9	-9
0048	3F	22	134	52	13	5200	4980	-220	0.25	0.96	9	8	-1
0048	3F	22	135	49	9	4900	6670	1770	0.18	1.36	8	11	3
0048	3F	22	136	60	1	6000	2370	-3630	0.02	0.40	10	4	-6
0048	3F	22	145	35	1	3500	420	-3080	0.03	0.12	6	0	-6
0048	3F	22	146	53	2	5300	920	-4380	0.04	0.17	9	1	-8
0048	3F	22	156	13	0	1300	0	-1300	0.00	0.00	2	0	-2
0048	3F	22	234	4	1	400	1300	900	0.25	3.25	0	2	2
0048	3F	22	235	15	0	1500	0	-1500	0.00	0.00	2	0	-2
0048	3F	22	236	10	0	1000	0	-1000	0.00	0.00	1	0	-1
0048	3F	22	245	6	1	600	380	-220	0.17	0.63	1	0	-1
0048	3F	22	246	8	1	800	1690	890	0.13	2.11	1	2	1
0048	3F	22	256	9	0	900	0	-900	0.00	0.00	1	0	-1
0048	3F	23	123	72	25	7200	7060	-140	0.35	0.98	12	12	0
0048	3F	23	124	181	26	18100	9000	-9100	0.14	0.50	32	15	-17
0048	3F	23	125	56	4	5600	1710	-3890	0.07	0.31	9	3	-6
0048	3F	23	126	170	15	17000	18460	1460	0.09	1.09	30	32	2
0048	3F	23	134	80	14	8000	6290	-1710	0.18	0.79	14	11	-3
0048	3F	23	135	32	4	3200	1820	-1380	0.13	0.57	5	3	-2
0048	3F	23	136	69	3	6900	4950	-1950	0.04	0.72	12	8	-4
0048	3F	23	145	41	6	4100	5700	1600	0.15	1.39	7	10	3
0048	3F	23	146	46	5	4600	4350	-250	0.11	0.95	8	7	-1
0048	3F	23	156	32	4	3200	3280	80	0.13	1.03	5	5	0
0048	3F	23	234	15	0	1500	0	-1500	0.00	0.00	2	0	-2
0048	3F	23	235	8	0	800	0	-800	0.00	0.00	1	0	-1
0048	3F	23	236	6	0	600	0	-600	0.00	0.00	1	0	-1
0048	3F	23	245	16	1	1600	480	-1120	0.06	0.30	2	0	-2
0048	3F	23	246	11	2	1100	1550	450	0.18	1.41	1	2	1
0048	3F	23	256	16	1	1600	3890	2290	0.06	2.43	2	6	4
0048	3F	24	123	111	35	11100	9140	-1960	0.32	0.82	19	16	-3
0048	3F	24	124	144	39	14400	10950	-3450	0.27	0.76	25	19	-6
0048	3F	24	125	89	14	8900	6570	-2330	0.16	0.74	15	11	-4
0048	3F	24	126	172	9	17200	5200	-12000	0.05	0.30	30	9	-21
0048	3F	24	134	72	15	7200	6710	-490	0.21	0.93	12	11	-1
0048	3F	24	135	73	5	7300	2580	-4720	0.07	0.35	12	4	-8
0048	3F	24	136	72	1	7200	620	-6580	0.01	0.09	12	1	-11
0048	3F	24	145	46	1	4600	1380	-3220	0.02	0.30	8	2	-6
0048	3F	24	146	44	3	4400	1160	-3240	0.07	0.26	7	2	-5
0048	3F	24	156	34	0	3400	0	-3400	0.00	0.00	6	0	-6
0048	3F	24	234	1	0	100	0	-100	0.00	0.00	0	0	0
0048	3F	24	235	4	0	400	0	-400	0.00	0.00	0	0	0
0048	3F	24	236	5	2	500	1490	990	0.40	2.98	0	2	2
0048	3F	24	245	2	0	200	0	-200	0.00	0.00	0	0	0
0048	3F	24	246	1	0	100	0	-100	0.00	0.00	0	0	0
0048	3F	24	256	5	0	500	0	-500	0.00	0.00	0	0	0
0048	3T	01	123	44	5	4400	2370	-2030	0.11	0.54	7	4	-3
0048	3T	01	124	91	7	9100	4390	-4710	0.08	0.48	16	7	-9
0048	3T	01	125	32	7	3200	7570	4370	0.22	2.37	5	13	8
0048	3T	01	126	150	10	15000	27030	12030	0.07	1.80	26	47	21
0048	3T	01	132	6	2	600	1010	410	0.33	1.68	1	1	0
0048	3T	01	134	37	0	3700	0	-3700	0.00	0.00	6	0	-6
0048	3T	01	135	31	2	3100	2220	-880	0.06	0.72	5	3	-2
0048	3T	01	136	132	7	13200	20190	6990	0.05	1.53	23	35	12
0048	3T	01	142	12	0	1200	0	-1200	0.00	0.00	2	0	-2
0048	3T	01	143	1	0	100	0	-100	0.00	0.00	0	0	0
0048	3T	01	145	10	0	1000	0	-1000	0.00	0.00	1	0	-1
0048	3T	01	146	17	1	1700	680	-1020	0.06	0.40	3	1	-2
0048	3T	01	152	25	0	2500	0	-2500	0.00	0.00	4	0	-4
0048	3T	01	153	34	2	3400	3510	110	0.06	1.03	6	6	0
0048	3T	01	154	19	1	1900	1690	-210	0.05	0.89	3	2	-1
0048	3T	01	156	19	0	1900	0	-1900	0.00	0.00	3	0	-3
0048	3T	01	162	5	0	500	0	-500	0.00	0.00	0	0	0
0048	3T	01	163	8	0	800	0	-800	0.00	0.00	1	0	-1
0048	3T	01	164	3	0	300	0	-300	0.00	0.00	0	0	0
0048	3T	01	165	6	0	600	0	-600	0.00	0.00	1	0	-1
0048	3T	01	213	3	0	300	0	-300	0.00	0.00	0	0	0
0048	3T	01	215	1	0	100	0	-100	0.00	0.00	0	0	0
0048	3T	01	216	4	0	400	0	-400	0.00	0.00	0	0	0
0048	3T	01	231	17	0	1700	0	-1700	0.00	0.00	3	0	-3
0048	3T	01	234	8	0	800	0	-800	0.00	0.00	1	0	-1
0048	3T	01	235	12	0	1200	0	-1200	0.00	0.00	2	0	-2
0048	3T	01	236	5	2	500	6180	5680	0.40	12.36	0	10	10
0048	3T	01	241	31	0	3100	0	-3100	0.00	0.00	5	0	-5
0048	3T	01	245	10	0	1000	0	-1000	0.00	0.00	1	0	-1
0048	3T	01	246	10	0	1000	0	-1000	0.00	0.00	1	0	-1
0048	3T	01	251	8	0	800	0	-800	0.00	0.00	1	0	-1
0048	3T	01	253	1	0	100	0	-100	0.00	0.00	0	0	0
0048	3T	01	254	5	0	500	0	-500	0.00	0.00	0	0	0
0048	3T	01	256	6	0	600	0	-600	0.00	0.00	1	0	-1
0048	3T	01	261	8	0	800	0	-800	0.00	0.00	1	0	-1
0048	3T	01	263	7	1	700	1140	440	0.14	1.63	1	2	1
0048	3T	01	264	1	0	100	0	-100	0.00	0.00	0	0	0
0048	3T	01	265	3	0	300	0	-300	0.00	0.00	0	0	0
0048	3T	02	123	29	5	2900	4850	1950	0.17	1.67	5	8	3
0048	3T	02	124	78	6	7800	5910	-1890	0.08	0.76	13	10	-3
0048	3T	02	125	39	4	3900	6220	2320	0.10	1.59	6	11	5
0048	3T	02	126	95	2	9500	4520	-4980	0.02	0.48	16	8	-8
0048	3T	02	132	7	0	700	0	-700	0.00	0.00	1	0	-1
0048	3T	02	134	50	2	5000	1810	-3190	0.04	0.36	8	3	-5
0048	3T	02	135	23	1	2300	960	-1340	0.04	0.42	4	1	-3
0048	3T	02	136	73	3	7300	3190	-4110	0.04	0.44	12	5	-7
0048	3T	02	142	7	0	700	0	-700	0.00	0.00	1	0	-1
0048	3T	02	143	3	0	300	0	-300	0.00	0.00	0	0	0
0048	3T	02	145	14	1	1400	1890	490	0.07	1.35	2	3	1
0048	3T	02	146	36	2	3600	6670	3070	0.06	1.85	6	11	5
0048	3T	02	152	5	0	500	0	-500	0.00	0.00	0	0	0
0048	3T	02	153	4	0	400	0	-400	0.00	0.00	0	0	0
0048	3T	02	154	11	0	1100	0	-1100	0.00	0.00	1	0	-1
0048	3T	02	156	42	1	4200	5760	1560	0.02	1.37	7	10	3
0048	3T	02	162	3	0	300	0	-300	0.00	0.00	0	0	0
0048	3T	02	163	10	0	1000	0	-1000	0.00	0.00	1	0	-1
0048	3T	02	164	11	0	1100	0	-1100	0.00	0.00	1	0	-1
0048	3T	02	165	5	0	500	0	-500	0.00	0.00	0	0	0
0048	3T	02	213	5	0	500	0	-500	0.00	0.00	0	0	0
0048	3T	02	214	9	0	900	0	-900	0.00	0.00	1	0	-1
0048	3T	02	215	11	1	1100	2860	1760	0.09	2.60	1	5	4
0048	3T	02	216	11	0	1100	0	-1100	0.00	0.00	1	0	-1
0048	3T	02	231	12	0	1200	0	-1200	0.00	0.00	2	0	-2
0048	3T	02	234	12	1	1200	940	-260	0.08	0.78	2	1	-1
0048	3T	02	235	10	1	1000	1000	0	0.10	1.00	1	1	0
0048	3T	02	236	8	0	800	0	-800	0.00	0.00	1	0	-1
0048	3T	02	241	21	0	2100	0	-2100	0.00	0.00	3	0	-3
0048	3T	02	245	3	0	300	0	-300	0.00	0.00	0	0	0
0048	3T	02	246	12	0	1200	0	-1200	0.00	0.00	2	0	-2
0048	3T	02	251	16	0	1600	0	-1600	0.00	0.00	2	0	-2
0048	3T	02	253	1	0	100	0	-100	0.00	0.00	0	0	0
0048	3T	02	254	1	0	100	0	-100	0.00	0.00	0	0	0
0048	3T	02	256	20	0	2000	0	-2000	0.00	0.00	3	0	-3
0048	3T	02	261	12	0	1200	0	-1200	0.00	0.00	2	0	-2
0048	3T	02	263	3	0	300	0	-300	0.00	0.00	0	0	0
0048	3T	02	264	4	0	400	0	-400	0.00	0.00	0	0	0
0048	3T	02	265	2	0	200	0	-200	0.00	0.00	0	0	0
0048	3T	03	123	37	8	3700	5770	2070	0.22	1.56	6	10	4
0048	3T	03	124	54	3	5400	2830	-2570	0.06	0.52	9	5	-4
0048	3T	03	125	29	1	2900	1340	-1560	0.03	0.46	5	2	-3
0048	3T	03	126	59	3	5900	8120	2220	0.05	1.38	10	14	4
0048	3T	03	132	3	0	300	0	-300	0.00	0.00	0	0	0
0048	3T	03	134	22	0	2200	0	-2200	0.00	0.00	3	0	-3
0048	3T	03	135	14	2	1400	2890	1490	0.14	2.06	2	5	3
0048	3T	03	136	19	0	1900	0	-1900	0.00	0.00	3	0	-3
0048	3T	03	143	4	0	400	0	-400	0.00	0.00	0	0	0
0048	3T	03	145	10	0	1000	0	-1000	0.00	0.00	1	0	-1
0048	3T	03	146	11	0	1100	0	-1100	0.00	0.00	1	0	-1
0048	3T	03	152	5	1	500	790	290	0.20	1.58	0	1	1
0048	3T	03	153	3	0	300	0	-300	0.00	0.00	0	0	0
0048	3T	03	154	3	0	300	0	-300	0.00	0.00	0	0	0
0048	3T	03	156	16	1	1600	3300	1700	0.06	2.06	2	5	3
0048	3T	03	163	4	1	400	2480	2080	0.25	6.20	0	4	4
0048	3T	03	164	1	0	100	0	-100	0.00	0.00	0	0	0
0048	3T	03	165	2	0	200	0	-200	0.00	0.00	0	0	0
0048	3T	03	213	4	1	400	620	220	0.25	1.55	0	1	1
0048	3T	03	214	8	0	800	0	-800	0.00	0.00	1	0	-1
0048	3T	03	215	6	0	600	0	-600	0.00	0.00	1	0	-1
0048	3T	03	216	4	0	400	0	-400	0.00	0.00	0	0	0
0048	3T	03	231	15	1	1500	830	-670	0.07	0.55	2	1	-1
0048	3T	03	234	1	1	100	5380	5280	1.00	53.80	0	9	9
0048	3T	03	235	5	0	500	0	-500	0.00	0.00	0	0	0
0048	3T	03	236	1	0	100	0	-100	0.00	0.00	0	0	0
0048	3T	03	241	19	1	1900	1970	70	0.05	1.04	3	3	0
0048	3T	03	243	1	0	100	0	-100	0.00	0.00	0	0	0
0048	3T	03	245	6	0	600	0	-600	0.00	0.00	1	0	-1
0048	3T	03	246	5	0	500	0	-500	0.00	0.00	0	0	0
0048	3T	03	251	37	1	3700	3500	-200	0.03	0.95	6	6	0
0048	3T	03	254	1	0	100	0	-100	0.00	0.00	0	0	0
0048	3T	03	256	4	1	400	880	480	0.25	2.20	0	1	1
0048	3T	03	261	24	0	2400	0	-2400	0.00	0.00	4	0	-4
0048	3T	03	265	1	0	100	0	-100	0.00	0.00	0	0	0
0048	3T	04	123	29	4	2900	2330	-570	0.14	0.80	5	4	-1
0048	3T	04	124	73	8	7300	6670	-630	0.11	0.91	12	11	-1
0048	3T	04	125	32	1	3200	700	-2500	0.03	0.22	5	1	-4
0048	3T	04	126	68	4	6800	6270	-530	0.06	0.92	12	11	-1
0048	3T	04	132	7	0	700	0	-700	0.00	0.00	1	0	-1
0048	3T	04	134	26	2	2600	1460	-1140	0.08	0.56	4	2	-2
0048	3T	04	135	28	2	2800	2080	-720	0.07	0.74	4	3	-1
0048	3T	04	136	41	3	4100	3630	-470	0.07	0.89	7	6	-1
0048	3T	04	142	5	1	500	790	290	0.20	1.58	0	1	1
0048	3T	04	143	7	0	700	0	-700	0.00	0.00	1	0	-1
0048	3T	04	145	17	1	1700	740	-960	0.06	0.44	3	1	-2
0048	3T	04	146	34	0	3400	0	-3400	0.00	0.00	6	0	-6
0048	3T	04	152	3	0	300	0	-300	0.00	0.00	0	0	0
0048	3T	04	153	3	0	300	0	-300	0.00	0.00	0	0	0
0048	3T	04	154	14	1	1400	6080	4680	0.07	4.34	2	10	8
0048	3T	04	156	43	1	4300	2760	-1540	0.02	0.64	7	4	-3
0048	3T	04	162	2	0	200	0	-200	0.00	0.00	0	0	0
0048	3T	04	163	3	0	300	0	-300	0.00	0.00	0	0	0
0048	3T	04	164	4	0	400	0	-400	0.00	0.00	0	0	0
0048	3T	04	165	1	0	100	0	-100	0.00	0.00	0	0	0
0048	3T	04	213	4	1	400	790	390	0.25	1.98	0	1	1
0048	3T	04	214	8	1	800	1250	450	0.13	1.56	1	2	1
0048	3T	04	215	5	0	500	0	-500	0.00	0.00	0	0	0
0048	3T	04	216	13	1	1300	3060	1760	0.08	2.35	2	5	3
0048	3T	04	231	10	0	1000	0	-1000	0.00	0.00	1	0	-1
0048	3T	04	234	2	0	200	0	-200	0.00	0.00	0	0	0
0048	3T	04	235	5	0	500	0	-500	0.00	0.00	0	0	0
0048	3T	04	236	2	0	200	0	-200	0.00	0.00	0	0	0
0048	3T	04	241	22	2	2200	3690	1490	0.09	1.68	3	6	3
0048	3T	04	245	3	0	300	0	-300	0.00	0.00	0	0	0
0048	3T	04	246	2	0	200	0	-200	0.00	0.00	0	0	0
0048	3T	04	251	15	0	1500	0	-1500	0.00	0.00	2	0	-2
0048	3T	04	254	3	0	300	0	-300	0.00	0.00	0	0	0
0048	3T	04	256	9	0	900	0	-900	0.00	0.00	1	0	-1
0048	3T	04	261	19	0	1900	0	-1900	0.00	0.00	3	0	-3
0048	3T	04	264	1	0	100	0	-100	0.00	0.00	0	0	0
0048	3T	05	123	21	2	2100	900	-1200	0.10	0.43	3	1	-2
0048	3T	05	124	77	12	7700	8200	500	0.16	1.06	13	14	1
0048	3T	05	125	33	2	3300	1600	-1700	0.06	0.48	5	2	-3
0048	3T	05	126	104	5	10400	8310	-2090	0.05	0.80	18	14	-4
0048	3T	05	132	12	2	1200	1570	370	0.17	1.31	2	2	0
0048	3T	05	134	36	4	3600	5460	1860	0.11	1.52	6	9	3
0048	3T	05	135	23	0	2300	0	-2300	0.00	0.00	4	0	-4
0048	3T	05	136	62	3	6200	12010	5810	0.05	1.94	10	21	11
0048	3T	05	142	22	2	2200	1800	-400	0.09	0.82	3	3	0
0048	3T	05	143	7	1	700	1120	420	0.14	1.60	1	1	0
0048	3T	05	145	16	0	1600	0	-1600	0.00	0.00	2	0	-2
0048	3T	05	146	36	0	3600	0	-3600	0.00	0.00	6	0	-6
0048	3T	05	152	11	1	1100	750	-350	0.09	0.68	1	1	0
0048	3T	05	153	8	0	800	0	-800	0.00	0.00	1	0	-1
0048	3T	05	154	6	1	600	3360	2760	0.17	5.60	1	5	4
0048	3T	05	156	68	0	6800	0	-6800	0.00	0.00	12	0	-12
0048	3T	05	162	4	0	400	0	-400	0.00	0.00	0	0	0
0048	3T	05	163	2	1	200	860	660	0.50	4.30	0	1	1
0048	3T	05	164	1	0	100	0	-100	0.00	0.00	0	0	0
0048	3T	05	165	5	0	500	0	-500	0.00	0.00	0	0	0
0048	3T	05	213	2	0	200	0	-200	0.00	0.00	0	0	0
0048	3T	05	214	6	0	600	0	-600	0.00	0.00	1	0	-1
0048	3T	05	215	8	0	800	0	-800	0.00	0.00	1	0	-1
0048	3T	05	216	22	0	2200	0	-2200	0.00	0.00	3	0	-3
0048	3T	05	231	26	1	2600	3380	780	0.04	1.30	4	5	1
0048	3T	05	234	4	0	400	0	-400	0.00	0.00	0	0	0
0048	3T	05	235	3	0	300	0	-300	0.00	0.00	0	0	0
0048	3T	05	236	9	1	900	4310	3410	0.11	4.79	1	7	6
0048	3T	05	241	34	2	3400	6630	3230	0.06	1.95	6	11	5
0048	3T	05	245	1	0	100	0	-100	0.00	0.00	0	0	0
0048	3T	05	246	6	0	600	0	-600	0.00	0.00	1	0	-1
0048	3T	05	251	22	2	2200	6860	4660	0.09	3.12	3	12	9
0048	3T	05	253	1	0	100	0	-100	0.00	0.00	0	0	0
0048	3T	05	254	4	0	400	0	-400	0.00	0.00	0	0	0
0048	3T	05	256	14	1	1400	1170	-230	0.07	0.84	2	2	0
0048	3T	05	261	11	0	1100	0	-1100	0.00	0.00	1	0	-1
0048	3T	06	123	29	6	2900	2890	-10	0.21	1.00	5	5	0
0048	3T	06	124	69	7	6900	4600	-2300	0.10	0.67	12	8	-4
0048	3T	06	125	30	3	3000	3210	210	0.10	1.07	5	5	0
0048	3T	06	126	94	3	9400	7370	-2030	0.03	0.78	16	13	-3
0048	3T	06	132	24	3	2400	2480	80	0.13	1.03	4	4	0
0048	3T	06	134	33	3	3300	3560	260	0.09	1.08	5	6	1
0048	3T	06	135	39	1	3900	650	-3250	0.03	0.17	6	1	-5
0048	3T	06	136	71	4	7100	3550	-3550	0.06	0.50	12	6	-6
0048	3T	06	142	15	3	1500	5240	3740	0.20	3.49	2	9	7
0048	3T	06	143	4	0	400	0	-400	0.00	0.00	0	0	0
0048	3T	06	145	28	1	2800	3570	770	0.04	1.28	4	6	2
0048	3T	06	146	59	2	5900	3740	-2160	0.03	0.63	10	6	-4
0048	3T	06	152	7	0	700	0	-700	0.00	0.00	1	0	-1
0048	3T	06	153	5	0	500	0	-500	0.00	0.00	0	0	0
0048	3T	06	154	8	0	800	0	-800	0.00	0.00	1	0	-1
0048	3T	06	156	39	0	3900	0	-3900	0.00	0.00	6	0	-6
0048	3T	06	162	6	0	600	0	-600	0.00	0.00	1	0	-1
0048	3T	06	163	2	0	200	0	-200	0.00	0.00	0	0	0
0048	3T	06	164	2	0	200	0	-200	0.00	0.00	0	0	0
0048	3T	06	165	6	0	600	0	-600	0.00	0.00	1	0	-1
0048	3T	06	213	3	0	300	0	-300	0.00	0.00	0	0	0
0048	3T	06	214	5	0	500	0	-500	0.00	0.00	0	0	0
0048	3T	06	215	8	0	800	0	-800	0.00	0.00	1	0	-1
0048	3T	06	216	11	0	1100	0	-1100	0.00	0.00	1	0	-1
0048	3T	06	231	13	1	1300	1650	350	0.08	1.27	2	2	0
0048	3T	06	235	1	0	100	0	-100	0.00	0.00	0	0	0
0048	3T	06	236	4	0	400	0	-400	0.00	0.00	0	0	0
0048	3T	06	241	30	0	3000	0	-3000	0.00	0.00	5	0	-5
0048	3T	06	245	4	0	400	0	-400	0.00	0.00	0	0	0
0048	3T	06	246	8	0	800	0	-800	0.00	0.00	1	0	-1
0048	3T	06	251	38	2	3800	3800	0	0.05	1.00	6	6	0
0048	3T	06	254	2	0	200	0	-200	0.00	0.00	0	0	0
0048	3T	06	256	15	0	1500	0	-1500	0.00	0.00	2	0	-2
0048	3T	06	261	26	0	2600	0	-2600	0.00	0.00	4	0	-4
0048	3T	06	264	1	0	100	0	-100	0.00	0.00	0	0	0
0048	3T	06	265	1	0	100	0	-100	0.00	0.00	0	0	0
0048	3T	07	123	16	2	1600	1040	-560	0.13	0.65	2	1	-1
0048	3T	07	124	72	10	7200	5760	-1440	0.14	0.80	12	10	-2
0048	3T	07	125	21	0	2100	0	-2100	0.00	0.00	3	0	-3
0048	3T	07	126	107	4	10700	6270	-4430	0.04	0.59	18	11	-7
0048	3T	07	132	6	0	600	0	-600	0.00	0.00	1	0	-1
0048	3T	07	134	73	10	7300	6260	-1040	0.14	0.86	12	11	-1
0048	3T	07	135	48	3	4800	4970	170	0.06	1.04	8	8	0
0048	3T	07	136	53	2	5300	2400	-2900	0.04	0.45	9	4	-5
0048	3T	07	142	2	0	200	0	-200	0.00	0.00	0	0	0
0048	3T	07	143	1	1	100	1910	1810	1.00	19.10	0	3	3
0048	3T	07	145	56	4	5600	6910	1310	0.07	1.23	9	12	3
0048	3T	07	146	74	4	7400	3210	-4190	0.05	0.43	13	5	-8
0048	3T	07	153	4	0	400	0	-400	0.00	0.00	0	0	0
0048	3T	07	154	9	0	900	0	-900	0.00	0.00	1	0	-1
0048	3T	07	156	48	0	4800	0	-4800	0.00	0.00	8	0	-8
0048	3T	07	162	1	0	100	0	-100	0.00	0.00	0	0	0
0048	3T	07	163	2	0	200	0	-200	0.00	0.00	0	0	0
0048	3T	07	164	2	0	200	0	-200	0.00	0.00	0	0	0
0048	3T	07	165	6	0	600	0	-600	0.00	0.00	1	0	-1
0048	3T	07	213	2	0	200	0	-200	0.00	0.00	0	0	0
0048	3T	07	214	2	0	200	0	-200	0.00	0.00	0	0	0
0048	3T	07	215	4	0	400	0	-400	0.00	0.00	0	0	0
0048	3T	07	216	9	0	900	0	-900	0.00	0.00	1	0	-1
0048	3T	07	231	24	0	2400	0	-2400	0.00	0.00	4	0	-4
0048	3T	07	234	3	0	300	0	-300	0.00	0.00	0	0	0
0048	3T	07	235	4	0	400	0	-400	0.00	0.00	0	0	0
0048	3T	07	236	2	0	200	0	-200	0.00	0.00	0	0	0
0048	3T	07	241	16	1	1600	680	-920	0.06	0.43	2	1	-1
0048	3T	07	245	5	0	500	0	-500	0.00	0.00	0	0	0
0048	3T	07	246	10	2	1000	11610	10610	0.20	11.61	1	20	19
0048	3T	07	251	34	0	3400	0	-3400	0.00	0.00	6	0	-6
0048	3T	07	256	12	0	1200	0	-1200	0.00	0.00	2	0	-2
0048	3T	07	261	15	0	1500	0	-1500	0.00	0.00	2	0	-2
0048	3T	07	263	1	0	100	0	-100	0.00	0.00	0	0	0
0048	3T	07	264	2	0	200	0	-200	0.00	0.00	0	0	0
0048	3T	07	265	3	0	300	0	-300	0.00	0.00	0	0	0
0048	3T	08	123	26	6	2600	3220	620	0.23	1.24	4	5	1
0048	3T	08	124	80	11	8000	6680	-1320	0.14	0.84	14	11	-3
0048	3T	08	125	41	3	4100	1970	-2130	0.07	0.48	7	3	-4
0048	3T	08	126	104	2	10400	2700	-7700	0.02	0.26	18	4	-14
0048	3T	08	132	6	1	600	1040	440	0.17	1.73	1	1	0
0048	3T	08	134	51	6	5100	5130	30	0.12	1.01	9	9	0
0048	3T	08	135	38	4	3800	3840	40	0.11	1.01	6	6	0
0048	3T	08	136	66	1	6600	770	-5830	0.02	0.12	11	1	-10
0048	3T	08	142	3	0	300	0	-300	0.00	0.00	0	0	0
0048	3T	08	143	1	1	100	910	810	1.00	9.10	0	1	1
0048	3T	08	145	45	1	4500	2170	-2330	0.02	0.48	7	3	-4
0048	3T	08	146	73	3	7300	4290	-3010	0.04	0.59	12	7	-5
0048	3T	08	153	3	0	300	0	-300	0.00	0.00	0	0	0
0048	3T	08	154	10	1	1000	5280	4280	0.10	5.28	1	9	8
0048	3T	08	156	49	0	4900	0	-4900	0.00	0.00	8	0	-8
0048	3T	08	163	1	0	100	0	-100	0.00	0.00	0	0	0
0048	3T	08	164	1	0	100	0	-100	0.00	0.00	0	0	0
0048	3T	08	165	1	0	100	0	-100	0.00	0.00	0	0	0
0048	3T	08	213	1	0	100	0	-100	0.00	0.00	0	0	0
0048	3T	08	214	2	1	200	590	390	0.50	2.95	0	1	1
0048	3T	08	215	5	0	500	0	-500	0.00	0.00	0	0	0
0048	3T	08	216	4	0	400	0	-400	0.00	0.00	0	0	0
0048	3T	08	231	13	0	1300	0	-1300	0.00	0.00	2	0	-2
0048	3T	08	236	3	0	300	0	-300	0.00	0.00	0	0	0
0048	3T	08	241	21	0	2100	0	-2100	0.00	0.00	3	0	-3
0048	3T	08	245	3	0	300	0	-300	0.00	0.00	0	0	0
0048	3T	08	246	6	0	600	0	-600	0.00	0.00	1	0	-1
0048	3T	08	251	29	0	2900	0	-2900	0.00	0.00	5	0	-5
0048	3T	08	256	8	0	800	0	-800	0.00	0.00	1	0	-1
0048	3T	08	261	22	0	2200	0	-2200	0.00	0.00	3	0	-3
0048	3T	08	263	1	0	100	0	-100	0.00	0.00	0	0	0
0048	3T	08	265	2	0	200	0	-200	0.00	0.00	0	0	0
0048	3T	09	123	59	8	5900	3370	-2530	0.14	0.57	10	5	-5
0048	3T	09	124	105	12	10500	8220	-2280	0.11	0.78	18	14	-4
0048	3T	09	125	81	5	8100	3880	-4220	0.06	0.48	14	6	-8
0048	3T	09	126	102	4	10200	4400	-5800	0.04	0.43	18	7	-11
0048	3T	09	132	29	2	2900	1610	-1290	0.07	0.56	5	2	-3
0048	3T	09	134	49	4	4900	3150	-1750	0.08	0.64	8	5	-3
0048	3T	09	135	43	3	4300	3010	-1290	0.07	0.70	7	5	-2
0048	3T	09	136	54	3	5400	4260	-1140	0.06	0.79	9	7	-2
0048	3T	09	142	11	1	1100	550	-550	0.09	0.50	1	0	-1
0048	3T	09	143	5	0	500	0	-500	0.00	0.00	0	0	0
0048	3T	09	145	35	2	3500	3600	100	0.06	1.03	6	6	0
0048	3T	09	146	33	0	3300	0	-3300	0.00	0.00	5	0	-5
0048	3T	09	152	6	0	600	0	-600	0.00	0.00	1	0	-1
0048	3T	09	153	6	0	600	0	-600	0.00	0.00	1	0	-1
0048	3T	09	154	21	0	2100	0	-2100	0.00	0.00	3	0	-3
0011	2F	1_8	16	18	0	1800	0	-1800	0.00	0.00	3	0	-3
0011	2F	1_8	23	17	3	1700	1150	-550	0.18	0.68	3	2	-1
0011	2F	1_8	24	15	2	1500	780	-720	0.13	0.52	2	1	-1
0011	2F	1_8	25	10	0	1000	0	-1000	0.00	0.00	1	0	-1
0011	2F	1_8	26	7	1	700	890	190	0.14	1.27	1	1	0
0011	2F	1_9	12	360	128	36000	36650	650	0.36	1.02	63	64	1
0011	2F	1_9	13	267	71	26700	24390	-2310	0.27	0.91	47	43	-4
0011	2F	1_9	14	138	29	13800	9180	-4620	0.21	0.67	24	16	-8
0011	2F	1_9	15	54	9	5400	8690	3290	0.17	1.61	9	15	6
0011	2F	1_9	16	24	1	2400	540	-1860	0.04	0.23	4	0	-4
0011	2F	1_9	23	17	3	1700	1110	-590	0.18	0.65	3	1	-2
0011	2F	1_9	24	12	2	1200	1130	-70	0.17	0.94	2	2	0
0011	2F	1_9	25	4	0	400	0	-400	0.00	0.00	0	0	0
0011	2F	1_9	26	1	0	100	0	-100	0.00	0.00	0	0	0
0011	2F	2_1	12	365	124	36500	33320	-3180	0.34	0.91	64	58	-6
0011	2F	2_1	13	205	54	20500	17420	-3080	0.26	0.85	36	30	-6
0011	2F	2_1	14	148	41	14800	13710	-1090	0.28	0.93	26	24	-2
0011	2F	2_1	15	53	7	5300	2460	-2840	0.13	0.46	9	4	-5
0011	2F	2_1	16	35	3	3500	1150	-2350	0.09	0.33	6	2	-4
0011	2F	2_1	23	13	0	1300	0	-1300	0.00	0.00	2	0	-2
0011	2F	2_1	24	10	2	1000	2690	1690	0.20	2.69	1	4	3
0011	2F	2_1	25	10	1	1000	1250	250	0.10	1.25	1	2	1
0011	2F	2_1	26	6	0	600	0	-600	0.00	0.00	1	0	-1
0011	2F	2_10	12	461	134	46100	36780	-9320	0.29	0.80	81	65	-16
0011	2F	2_10	13	247	67	24700	19700	-5000	0.27	0.80	43	34	-9
0011	2F	2_10	14	123	19	12300	6240	-6060	0.15	0.51	21	11	-10
0011	2F	2_10	15	43	8	4300	3020	-1280	0.19	0.70	7	5	-2
0011	2F	2_10	16	46	5	4600	2840	-1760	0.11	0.62	8	5	-3
0011	2F	2_10	23	6	1	600	240	-360	0.17	0.40	1	0	-1
0011	2F	2_10	24	5	1	500	360	-140	0.20	0.72	0	0	0
0011	2F	2_10	25	4	0	400	0	-400	0.00	0.00	0	0	0
0011	2F	2_10	26	4	0	400	0	-400	0.00	0.00	0	0	0
0011	2F	2_11	12	502	138	50200	40550	-9650	0.27	0.81	88	71	-17
0011	2F	2_11	13	244	78	24400	18890	-5510	0.32	0.77	43	33	-10
0011	2F	2_11	14	172	37	17200	13850	-3350	0.22	0.81	30	24	-6
0011	2F	2_11	15	48	13	4800	5960	1160	0.27	1.24	8	10	2
0011	2F	2_11	16	20	0	2000	0	-2000	0.00	0.00	3	0	-3
0011	2F	2_11	23	3	1	300	550	250	0.33	1.83	0	0	0
0011	2F	2_11	24	2	0	200	0	-200	0.00	0.00	0	0	0
0011	2F	2_11	26	1	0	100	0	-100	0.00	0.00	0	0	0
0011	2F	2_12	12	550	175	55000	48030	-6970	0.32	0.87	97	85	-12
0011	2F	2_12	13	270	75	27000	21570	-5430	0.28	0.80	47	38	-9
0011	2F	2_12	14	182	39	18200	12420	-5780	0.21	0.68	32	21	-11
0011	2F	2_12	15	42	8	4200	3580	-620	0.19	0.85	7	6	-1
0011	2F	2_12	16	6	0	600	0	-600	0.00	0.00	1	0	-1
0011	2F	2_12	23	4	0	400	0	-400	0.00	0.00	0	0	0
0011	2F	2_12	24	1	0	100	0	-100	0.00	0.00	0	0	0
0011	2F	2_2	12	299	111	29900	32560	2660	0.37	1.09	52	57	5
0011	2F	2_2	13	158	30	15800	13880	-1920	0.19	0.88	27	24	-3
0011	2F	2_2	14	138	32	13800	10330	-3470	0.23	0.75	24	18	-6
0011	2F	2_2	15	59	6	5900	2490	-3410	0.10	0.42	10	4	-6
0011	2F	2_2	16	42	6	4200	2720	-1480	0.14	0.65	7	4	-3
0011	2F	2_2	23	34	6	3400	3940	540	0.18	1.16	6	6	0
0011	2F	2_2	24	14	2	1400	4130	2730	0.14	2.95	2	7	5
0011	2F	2_2	25	5	1	500	440	-60	0.20	0.88	0	0	0
0011	2F	2_2	26	11	0	1100	0	-1100	0.00	0.00	1	0	-1
0011	2F	2_3	12	298	94	29800	35260	5460	0.32	1.18	52	62	10
0011	2F	2_3	13	200	57	20000	15320	-4680	0.29	0.77	35	27	-8
0011	2F	2_3	14	103	16	10300	6920	-3380	0.16	0.67	18	12	-6
0011	2F	2_3	15	61	10	6100	5460	-640	0.16	0.90	10	9	-1
0011	2F	2_3	16	55	9	5500	4450	-1050	0.16	0.81	9	7	-2
0011	2F	2_3	23	26	4	2600	2040	-560	0.15	0.78	4	3	-1
0011	2F	2_3	24	20	3	2000	1630	-370	0.15	0.82	3	2	-1
0011	2F	2_3	25	10	1	1000	670	-330	0.10	0.67	1	1	0
0011	2F	2_3	26	18	3	1800	2250	450	0.17	1.25	3	3	0
0011	2F	2_4	12	353	103	35300	28140	-7160	0.29	0.80	62	49	-13
0011	2F	2_4	13	196	40	19600	16980	-2620	0.20	0.87	34	30	-4
0011	2F	2_4	14	113	17	11300	6270	-5030	0.15	0.55	20	11	-9
0011	2F	2_4	15	63	13	6300	11370	5070	0.21	1.80	11	20	9
0011	2F	2_4	16	48	8	4800	5680	880	0.17	1.18	8	10	2
0011	2F	2_4	23	25	7	2500	5340	2840	0.28	2.14	4	9	5
0011	2F	2_4	24	24	6	2400	1750	-650	0.25	0.73	4	3	-1
0011	2F	2_4	25	14	1	1400	820	-580	0.07	0.59	2	1	-1
0048	3T	09	156	35	1	3500	2510	-990	0.03	0.72	6	4	-2
0048	3T	09	162	5	0	500	0	-500	0.00	0.00	0	0	0
0048	3T	09	163	3	1	300	3000	2700	0.33	10.00	0	5	5
0048	3T	09	164	1	0	100	0	-100	0.00	0.00	0	0	0
0048	3T	09	165	2	0	200	0	-200	0.00	0.00	0	0	0
0048	3T	09	213	2	1	200	590	390	0.50	2.95	0	1	1
0048	3T	09	214	3	1	300	3890	3590	0.33	12.97	0	6	6
0048	3T	09	215	10	1	1000	1030	30	0.10	1.03	1	1	0
0048	3T	09	216	7	0	700	0	-700	0.00	0.00	1	0	-1
0048	3T	09	231	11	0	1100	0	-1100	0.00	0.00	1	0	-1
0048	3T	09	234	2	0	200	0	-200	0.00	0.00	0	0	0
0048	3T	09	236	10	0	1000	0	-1000	0.00	0.00	1	0	-1
0048	3T	09	241	31	2	3100	3190	90	0.06	1.03	5	5	0
0048	3T	09	245	8	1	800	980	180	0.13	1.23	1	1	0
0048	3T	09	246	8	0	800	0	-800	0.00	0.00	1	0	-1
0048	3T	09	251	46	2	4600	5300	700	0.04	1.15	8	9	1
0048	3T	09	256	24	0	2400	0	-2400	0.00	0.00	4	0	-4
0048	3T	09	261	20	1	2000	1900	-100	0.05	0.95	3	3	0
0048	3T	09	265	1	0	100	0	-100	0.00	0.00	0	0	0
0048	3T	10	123	82	15	8200	6330	-1870	0.18	0.77	14	11	-3
0048	3T	10	124	61	7	6100	4950	-1150	0.11	0.81	10	8	-2
0048	3T	10	125	70	4	7000	3300	-3700	0.06	0.47	12	5	-7
0048	3T	10	126	63	4	6300	6280	-20	0.06	1.00	11	11	0
0048	3T	10	132	16	0	1600	0	-1600	0.00	0.00	2	0	-2
0048	3T	10	134	48	2	4800	1410	-3390	0.04	0.29	8	2	-6
0048	3T	10	135	44	4	4400	4170	-230	0.09	0.95	7	7	0
0048	3T	10	136	45	2	4500	2940	-1560	0.04	0.65	7	5	-2
0048	3T	10	142	9	0	900	0	-900	0.00	0.00	1	0	-1
0048	3T	10	143	3	0	300	0	-300	0.00	0.00	0	0	0
0048	3T	10	145	39	1	3900	1910	-1990	0.03	0.49	6	3	-3
0048	3T	10	146	32	2	3200	3020	-180	0.06	0.94	5	5	0
0048	3T	10	153	8	1	800	1650	850	0.13	2.06	1	2	1
0048	3T	10	154	3	0	300	0	-300	0.00	0.00	0	0	0
0048	3T	10	156	31	0	3100	0	-3100	0.00	0.00	5	0	-5
0048	3T	10	162	3	0	300	0	-300	0.00	0.00	0	0	0
0048	3T	10	163	5	0	500	0	-500	0.00	0.00	0	0	0
0048	3T	10	164	3	0	300	0	-300	0.00	0.00	0	0	0
0048	3T	10	165	3	0	300	0	-300	0.00	0.00	0	0	0
0048	3T	10	213	1	0	100	0	-100	0.00	0.00	0	0	0
0048	3T	10	214	3	0	300	0	-300	0.00	0.00	0	0	0
0048	3T	10	215	9	0	900	0	-900	0.00	0.00	1	0	-1
0048	3T	10	216	4	0	400	0	-400	0.00	0.00	0	0	0
0048	3T	10	231	13	0	1300	0	-1300	0.00	0.00	2	0	-2
0048	3T	10	234	5	0	500	0	-500	0.00	0.00	0	0	0
0048	3T	10	235	2	0	200	0	-200	0.00	0.00	0	0	0
0048	3T	10	236	4	0	400	0	-400	0.00	0.00	0	0	0
0048	3T	10	241	34	5	3400	8580	5180	0.15	2.52	6	15	9
0048	3T	10	245	6	0	600	0	-600	0.00	0.00	1	0	-1
0048	3T	10	246	4	0	400	0	-400	0.00	0.00	0	0	0
0048	3T	10	251	47	2	4700	7530	2830	0.04	1.60	8	13	5
0048	3T	10	253	1	0	100	0	-100	0.00	0.00	0	0	0
0048	3T	10	254	1	0	100	0	-100	0.00	0.00	0	0	0
0048	3T	10	256	7	0	700	0	-700	0.00	0.00	1	0	-1
0048	3T	10	261	10	0	1000	0	-1000	0.00	0.00	1	0	-1
0048	3T	10	264	2	0	200	0	-200	0.00	0.00	0	0	0
0048	3T	11	123	61	9	6100	3940	-2160	0.15	0.65	10	6	-4
0048	3T	11	124	112	11	11200	10140	-1060	0.10	0.91	19	17	-2
0048	3T	11	125	120	11	12000	5860	-6140	0.09	0.49	21	10	-11
0048	3T	11	126	98	9	9800	12510	2710	0.09	1.28	17	22	5
0048	3T	11	132	1	0	100	0	-100	0.00	0.00	0	0	0
0048	3T	11	134	88	8	8800	6890	-1910	0.09	0.78	15	12	-3
0048	3T	11	135	19	2	1900	3050	1150	0.11	1.61	3	5	2
0048	3T	11	136	104	2	10400	5230	-5170	0.02	0.50	18	9	-9
0048	3T	11	143	9	0	900	0	-900	0.00	0.00	1	0	-1
0048	3T	11	145	13	0	1300	0	-1300	0.00	0.00	2	0	-2
0048	3T	11	146	15	0	1500	0	-1500	0.00	0.00	2	0	-2
0048	3T	11	153	13	1	1300	1170	-130	0.08	0.90	2	2	0
0048	3T	11	154	19	1	1900	3280	1380	0.05	1.73	3	5	2
0048	3T	11	156	16	0	1600	0	-1600	0.00	0.00	2	0	-2
0048	3T	11	164	20	0	2000	0	-2000	0.00	0.00	3	0	-3
0048	3T	11	216	2	0	200	0	-200	0.00	0.00	0	0	0
0048	3T	11	231	9	0	900	0	-900	0.00	0.00	1	0	-1
0048	3T	11	234	19	0	1900	0	-1900	0.00	0.00	3	0	-3
0048	3T	11	235	13	0	1300	0	-1300	0.00	0.00	2	0	-2
0048	3T	11	236	31	0	3100	0	-3100	0.00	0.00	5	0	-5
0048	3T	11	241	13	0	1300	0	-1300	0.00	0.00	2	0	-2
0048	3T	11	243	1	0	100	0	-100	0.00	0.00	0	0	0
0048	3T	11	245	1	0	100	0	-100	0.00	0.00	0	0	0
0048	3T	11	246	11	0	1100	0	-1100	0.00	0.00	1	0	-1
0048	3T	11	251	26	0	2600	0	-2600	0.00	0.00	4	0	-4
0048	3T	11	253	2	0	200	0	-200	0.00	0.00	0	0	0
0048	3T	11	254	13	0	1300	0	-1300	0.00	0.00	2	0	-2
0048	3T	11	256	42	1	4200	2070	-2130	0.02	0.49	7	3	-4
0048	3T	11	261	7	0	700	0	-700	0.00	0.00	1	0	-1
0048	3T	11	264	8	0	800	0	-800	0.00	0.00	1	0	-1
0048	3T	11	265	1	0	100	0	-100	0.00	0.00	0	0	0
0048	3T	12	123	33	5	3300	3130	-170	0.15	0.95	5	5	0
0048	3T	12	124	165	21	16500	14880	-1620	0.13	0.90	29	26	-3
0048	3T	12	125	32	3	3200	6270	3070	0.09	1.96	5	11	6
0048	3T	12	126	152	8	15200	13770	-1430	0.05	0.91	26	24	-2
0048	3T	12	132	1	0	100	0	-100	0.00	0.00	0	0	0
0048	3T	12	134	101	9	10100	11050	950	0.09	1.09	17	19	2
0048	3T	12	135	27	1	2700	830	-1870	0.04	0.31	4	1	-3
0048	3T	12	136	62	4	6200	9540	3340	0.06	1.54	10	16	6
0048	3T	12	142	1	0	100	0	-100	0.00	0.00	0	0	0
0048	3T	12	143	2	0	200	0	-200	0.00	0.00	0	0	0
0048	3T	12	145	13	2	1300	4230	2930	0.15	3.25	2	7	5
0048	3T	12	146	14	1	1400	2550	1150	0.07	1.82	2	4	2
0048	3T	12	152	2	0	200	0	-200	0.00	0.00	0	0	0
0048	3T	12	153	3	0	300	0	-300	0.00	0.00	0	0	0
0048	3T	12	154	14	0	1400	0	-1400	0.00	0.00	2	0	-2
0048	3T	12	156	17	1	1700	4260	2560	0.06	2.51	3	7	4
0048	3T	12	162	1	0	100	0	-100	0.00	0.00	0	0	0
0048	3T	12	163	7	0	700	0	-700	0.00	0.00	1	0	-1
0048	3T	12	164	19	1	1900	2660	760	0.05	1.40	3	4	1
0048	3T	12	165	2	0	200	0	-200	0.00	0.00	0	0	0
0048	3T	12	213	3	0	300	0	-300	0.00	0.00	0	0	0
0048	3T	12	214	9	0	900	0	-900	0.00	0.00	1	0	-1
0048	3T	12	215	3	0	300	0	-300	0.00	0.00	0	0	0
0048	3T	12	216	14	0	1400	0	-1400	0.00	0.00	2	0	-2
0048	3T	12	231	11	0	1100	0	-1100	0.00	0.00	1	0	-1
0048	3T	12	234	23	0	2300	0	-2300	0.00	0.00	4	0	-4
0048	3T	12	235	19	0	1900	0	-1900	0.00	0.00	3	0	-3
0048	3T	12	236	1	0	100	0	-100	0.00	0.00	0	0	0
0048	3T	12	241	17	1	1700	950	-750	0.06	0.56	3	1	-2
0048	3T	12	245	6	0	600	0	-600	0.00	0.00	1	0	-1
0048	3T	12	246	7	1	700	5390	4690	0.14	7.70	1	9	8
0048	3T	12	251	7	0	700	0	-700	0.00	0.00	1	0	-1
0048	3T	12	254	15	1	1500	1540	40	0.07	1.03	2	2	0
0048	3T	12	256	13	0	1300	0	-1300	0.00	0.00	2	0	-2
0048	3T	12	261	9	0	900	0	-900	0.00	0.00	1	0	-1
0048	3T	12	263	2	0	200	0	-200	0.00	0.00	0	0	0
0048	3T	12	264	3	0	300	0	-300	0.00	0.00	0	0	0
0048	3T	12	265	9	0	900	0	-900	0.00	0.00	1	0	-1
0048	3T	13	123	29	3	2900	1280	-1620	0.10	0.44	5	2	-3
0048	3T	13	124	50	9	5000	4870	-130	0.18	0.97	8	8	0
0048	3T	13	125	34	2	3400	2000	-1400	0.06	0.59	6	3	-3
0048	3T	13	126	120	3	12000	4590	-7410	0.03	0.38	21	8	-13
0048	3T	13	132	3	1	300	280	-20	0.33	0.93	0	0	0
0048	3T	13	134	31	3	3100	1590	-1510	0.10	0.51	5	2	-3
0048	3T	13	135	21	0	2100	0	-2100	0.00	0.00	3	0	-3
0048	3T	13	136	67	3	6700	3220	-3480	0.04	0.48	11	5	-6
0048	3T	13	142	10	1	1000	750	-250	0.10	0.75	1	1	0
0048	3T	13	145	13	0	1300	0	-1300	0.00	0.00	2	0	-2
0048	3T	13	146	59	0	5900	0	-5900	0.00	0.00	10	0	-10
0048	3T	13	152	2	0	200	0	-200	0.00	0.00	0	0	0
0048	3T	13	153	4	0	400	0	-400	0.00	0.00	0	0	0
0048	3T	13	154	4	0	400	0	-400	0.00	0.00	0	0	0
0048	3T	13	156	48	1	4800	700	-4100	0.02	0.15	8	1	-7
0048	3T	13	163	5	0	500	0	-500	0.00	0.00	0	0	0
0048	3T	13	164	8	0	800	0	-800	0.00	0.00	1	0	-1
0048	3T	13	213	2	0	200	0	-200	0.00	0.00	0	0	0
0048	3T	13	214	10	0	1000	0	-1000	0.00	0.00	1	0	-1
0048	3T	13	215	7	1	700	4830	4130	0.14	6.90	1	8	7
0048	3T	13	216	17	1	1700	2630	930	0.06	1.55	3	4	1
0048	3T	13	231	10	1	1000	1780	780	0.10	1.78	1	3	2
0048	3T	13	234	2	0	200	0	-200	0.00	0.00	0	0	0
0048	3T	13	235	6	0	600	0	-600	0.00	0.00	1	0	-1
0048	3T	13	241	32	0	3200	0	-3200	0.00	0.00	5	0	-5
0048	3T	13	245	6	0	600	0	-600	0.00	0.00	1	0	-1
0048	3T	13	246	8	0	800	0	-800	0.00	0.00	1	0	-1
0048	3T	13	251	4	0	400	0	-400	0.00	0.00	0	0	0
0048	3T	13	253	1	0	100	0	-100	0.00	0.00	0	0	0
0048	3T	13	256	7	0	700	0	-700	0.00	0.00	1	0	-1
0048	3T	13	261	8	0	800	0	-800	0.00	0.00	1	0	-1
0048	3T	13	263	2	0	200	0	-200	0.00	0.00	0	0	0
0048	3T	13	264	2	0	200	0	-200	0.00	0.00	0	0	0
0048	3T	14	123	54	5	5400	2590	-2810	0.09	0.48	9	4	-5
0048	3T	14	124	99	6	9900	4200	-5700	0.06	0.42	17	7	-10
0048	3T	14	125	32	3	3200	2830	-370	0.09	0.88	5	5	0
0048	3T	14	126	72	2	7200	3360	-3840	0.03	0.47	12	5	-7
0048	3T	14	132	17	3	1700	2440	740	0.18	1.44	3	4	1
0048	3T	14	134	44	7	4400	5230	830	0.16	1.19	7	9	2
0048	3T	14	135	30	2	3000	1790	-1210	0.07	0.60	5	3	-2
0048	3T	14	136	46	3	4600	8280	3680	0.07	1.80	8	14	6
0048	3T	14	142	20	3	2000	2710	710	0.15	1.36	3	4	1
0048	3T	14	143	15	1	1500	450	-1050	0.07	0.30	2	0	-2
0048	3T	14	145	11	0	1100	0	-1100	0.00	0.00	1	0	-1
0048	3T	14	146	34	0	3400	0	-3400	0.00	0.00	6	0	-6
0048	3T	14	152	12	1	1200	2420	1220	0.08	2.02	2	4	2
0048	3T	14	153	5	0	500	0	-500	0.00	0.00	0	0	0
0048	3T	14	154	16	1	1600	3530	1930	0.06	2.21	2	6	4
0048	3T	14	156	23	1	2300	6640	4340	0.04	2.89	4	11	7
0048	3T	14	162	7	0	700	0	-700	0.00	0.00	1	0	-1
0048	3T	14	163	4	0	400	0	-400	0.00	0.00	0	0	0
0048	3T	14	164	3	0	300	0	-300	0.00	0.00	0	0	0
0048	3T	14	165	2	0	200	0	-200	0.00	0.00	0	0	0
0048	3T	14	213	4	2	400	2180	1780	0.50	5.45	0	3	3
0048	3T	14	214	7	1	700	1410	710	0.14	2.01	1	2	1
0048	3T	14	215	2	0	200	0	-200	0.00	0.00	0	0	0
0048	3T	14	216	14	0	1400	0	-1400	0.00	0.00	2	0	-2
0048	3T	14	231	14	2	1400	4910	3510	0.14	3.51	2	8	6
0048	3T	14	234	1	0	100	0	-100	0.00	0.00	0	0	0
0048	3T	14	235	3	0	300	0	-300	0.00	0.00	0	0	0
0048	3T	14	236	7	0	700	0	-700	0.00	0.00	1	0	-1
0048	3T	14	241	21	0	2100	0	-2100	0.00	0.00	3	0	-3
0048	3T	14	245	4	0	400	0	-400	0.00	0.00	0	0	0
0048	3T	14	246	7	0	700	0	-700	0.00	0.00	1	0	-1
0048	3T	14	251	23	0	2300	0	-2300	0.00	0.00	4	0	-4
0048	3T	14	253	1	0	100	0	-100	0.00	0.00	0	0	0
0048	3T	14	254	1	0	100	0	-100	0.00	0.00	0	0	0
0048	3T	14	256	8	1	800	1690	890	0.13	2.11	1	2	1
0048	3T	14	261	18	0	1800	0	-1800	0.00	0.00	3	0	-3
0048	3T	14	263	1	0	100	0	-100	0.00	0.00	0	0	0
0048	3T	14	264	1	0	100	0	-100	0.00	0.00	0	0	0
0048	3T	14	265	2	0	200	0	-200	0.00	0.00	0	0	0
0048	3T	15	123	38	3	3800	1610	-2190	0.08	0.42	6	2	-4
0048	3T	15	124	147	20	14700	12420	-2280	0.14	0.84	26	21	-5
0048	3T	15	125	44	1	4400	1470	-2930	0.02	0.33	7	2	-5
0048	3T	15	126	119	3	11900	2800	-9100	0.03	0.24	21	4	-17
0048	3T	15	132	11	1	1100	430	-670	0.09	0.39	1	0	-1
0048	3T	15	134	71	5	7100	3660	-3440	0.07	0.52	12	6	-6
0048	3T	15	135	31	1	3100	1070	-2030	0.03	0.35	5	1	-4
0048	3T	15	136	68	3	6800	3710	-3090	0.04	0.55	12	6	-6
0048	3T	15	142	15	2	1500	900	-600	0.13	0.60	2	1	-1
0048	3T	15	143	4	0	400	0	-400	0.00	0.00	0	0	0
0048	3T	15	145	18	0	1800	0	-1800	0.00	0.00	3	0	-3
0048	3T	15	146	39	2	3900	2480	-1420	0.05	0.64	6	4	-2
0048	3T	15	152	5	0	500	0	-500	0.00	0.00	0	0	0
0048	3T	15	153	3	0	300	0	-300	0.00	0.00	0	0	0
0048	3T	15	154	13	0	1300	0	-1300	0.00	0.00	2	0	-2
0048	3T	15	156	36	2	3600	10160	6560	0.06	2.82	6	17	11
0048	3T	15	162	4	0	400	0	-400	0.00	0.00	0	0	0
0048	3T	15	164	2	0	200	0	-200	0.00	0.00	0	0	0
0048	3T	15	213	2	0	200	0	-200	0.00	0.00	0	0	0
0048	3T	15	214	7	0	700	0	-700	0.00	0.00	1	0	-1
0048	3T	15	215	7	0	700	0	-700	0.00	0.00	1	0	-1
0048	3T	15	216	13	1	1300	9920	8620	0.08	7.63	2	17	15
0048	3T	15	231	21	1	2100	8160	6060	0.05	3.89	3	14	11
0048	3T	15	234	3	0	300	0	-300	0.00	0.00	0	0	0
0048	3T	15	235	4	0	400	0	-400	0.00	0.00	0	0	0
0048	3T	15	236	4	0	400	0	-400	0.00	0.00	0	0	0
0048	3T	15	241	25	1	2500	1520	-980	0.04	0.61	4	2	-2
0048	3T	15	245	6	0	600	0	-600	0.00	0.00	1	0	-1
0048	3T	15	246	6	1	600	1190	590	0.17	1.98	1	2	1
0048	3T	15	251	13	0	1300	0	-1300	0.00	0.00	2	0	-2
0048	3T	15	253	1	0	100	0	-100	0.00	0.00	0	0	0
0048	3T	15	254	2	0	200	0	-200	0.00	0.00	0	0	0
0048	3T	15	256	11	0	1100	0	-1100	0.00	0.00	1	0	-1
0048	3T	15	261	14	0	1400	0	-1400	0.00	0.00	2	0	-2
0048	3T	15	264	2	0	200	0	-200	0.00	0.00	0	0	0
0048	3T	15	265	2	0	200	0	-200	0.00	0.00	0	0	0
0048	3T	16	123	88	16	8800	6410	-2390	0.18	0.73	15	11	-4
0048	3T	16	124	107	17	10700	11480	780	0.16	1.07	18	20	2
0048	3T	16	125	45	3	4500	2810	-1690	0.07	0.62	7	4	-3
0048	3T	16	126	94	4	9400	7790	-1610	0.04	0.83	16	13	-3
0048	3T	16	132	17	2	1700	1380	-320	0.12	0.81	3	2	-1
0048	3T	16	134	63	6	6300	4300	-2000	0.10	0.68	11	7	-4
0048	3T	16	135	44	2	4400	1800	-2600	0.05	0.41	7	3	-4
0048	3T	16	136	60	2	6000	2560	-3440	0.03	0.43	10	4	-6
0048	3T	16	142	18	0	1800	0	-1800	0.00	0.00	3	0	-3
0048	3T	16	143	8	2	800	1800	1000	0.25	2.25	1	3	2
0048	3T	16	145	40	2	4000	1730	-2270	0.05	0.43	7	3	-4
0048	3T	16	146	42	3	4200	3820	-380	0.07	0.91	7	6	-1
0048	3T	16	152	5	0	500	0	-500	0.00	0.00	0	0	0
0048	3T	16	153	5	0	500	0	-500	0.00	0.00	0	0	0
0048	3T	16	154	3	0	300	0	-300	0.00	0.00	0	0	0
0048	3T	16	156	68	3	6800	8690	1890	0.04	1.28	12	15	3
0048	3T	16	162	4	0	400	0	-400	0.00	0.00	0	0	0
0048	3T	16	163	1	0	100	0	-100	0.00	0.00	0	0	0
0048	3T	16	164	2	0	200	0	-200	0.00	0.00	0	0	0
0048	3T	16	165	4	0	400	0	-400	0.00	0.00	0	0	0
0048	3T	16	213	4	0	400	0	-400	0.00	0.00	0	0	0
0048	3T	16	214	3	0	300	0	-300	0.00	0.00	0	0	0
0048	3T	16	215	8	0	800	0	-800	0.00	0.00	1	0	-1
0048	3T	16	216	7	0	700	0	-700	0.00	0.00	1	0	-1
0048	3T	16	231	7	1	700	1690	990	0.14	2.41	1	2	1
0048	3T	16	234	3	0	300	0	-300	0.00	0.00	0	0	0
0048	3T	16	235	3	0	300	0	-300	0.00	0.00	0	0	0
0048	3T	16	236	8	0	800	0	-800	0.00	0.00	1	0	-1
0048	3T	16	241	21	2	2100	7320	5220	0.10	3.49	3	12	9
0048	3T	16	245	3	1	300	2900	2600	0.33	9.67	0	5	5
0048	3T	16	246	6	0	600	0	-600	0.00	0.00	1	0	-1
0048	3T	16	251	29	0	2900	0	-2900	0.00	0.00	5	0	-5
0048	3T	16	254	1	0	100	0	-100	0.00	0.00	0	0	0
0048	3T	16	256	17	0	1700	0	-1700	0.00	0.00	3	0	-3
0048	3T	16	261	23	0	2300	0	-2300	0.00	0.00	4	0	-4
0048	3T	16	265	2	0	200	0	-200	0.00	0.00	0	0	0
0048	3T	17	123	65	14	6500	5910	-590	0.22	0.91	11	10	-1
0048	3T	17	124	99	10	9900	6220	-3680	0.10	0.63	17	11	-6
0048	3T	17	125	47	6	4700	3800	-900	0.13	0.81	8	6	-2
0048	3T	17	126	127	6	12700	6840	-5860	0.05	0.54	22	12	-10
0048	3T	17	132	44	6	4400	4160	-240	0.14	0.95	7	7	0
0048	3T	17	134	52	8	5200	5140	-60	0.15	0.99	9	9	0
0048	3T	17	135	55	2	5500	3980	-1520	0.04	0.72	9	7	-2
0048	3T	17	136	51	3	5100	5100	0	0.06	1.00	9	9	0
0048	3T	17	142	7	0	700	0	-700	0.00	0.00	1	0	-1
0048	3T	17	143	3	0	300	0	-300	0.00	0.00	0	0	0
0048	3T	17	145	30	2	3000	2400	-600	0.07	0.80	5	4	-1
0048	3T	17	146	49	2	4900	3010	-1890	0.04	0.61	8	5	-3
0048	3T	17	152	3	0	300	0	-300	0.00	0.00	0	0	0
0048	3T	17	153	5	0	500	0	-500	0.00	0.00	0	0	0
0048	3T	17	154	3	0	300	0	-300	0.00	0.00	0	0	0
0048	3T	17	156	63	0	6300	0	-6300	0.00	0.00	11	0	-11
0048	3T	17	162	2	1	200	1130	930	0.50	5.65	0	2	2
0048	3T	17	163	5	0	500	0	-500	0.00	0.00	0	0	0
0048	3T	17	164	2	0	200	0	-200	0.00	0.00	0	0	0
0048	3T	17	165	4	0	400	0	-400	0.00	0.00	0	0	0
0048	3T	17	213	3	0	300	0	-300	0.00	0.00	0	0	0
0048	3T	17	214	4	0	400	0	-400	0.00	0.00	0	0	0
0048	3T	17	215	4	0	400	0	-400	0.00	0.00	0	0	0
0048	3T	17	216	9	0	900	0	-900	0.00	0.00	1	0	-1
0048	3T	17	231	15	1	1500	1730	230	0.07	1.15	2	3	1
0048	3T	17	234	7	0	700	0	-700	0.00	0.00	1	0	-1
0048	3T	17	235	2	0	200	0	-200	0.00	0.00	0	0	0
0048	3T	17	236	4	0	400	0	-400	0.00	0.00	0	0	0
0048	3T	17	241	28	2	2800	2140	-660	0.07	0.76	4	3	-1
0048	3T	17	245	4	0	400	0	-400	0.00	0.00	0	0	0
0048	3T	17	246	4	0	400	0	-400	0.00	0.00	0	0	0
0048	3T	17	251	39	0	3900	0	-3900	0.00	0.00	6	0	-6
0048	3T	17	256	12	0	1200	0	-1200	0.00	0.00	2	0	-2
0048	3T	17	261	22	0	2200	0	-2200	0.00	0.00	3	0	-3
0048	3T	17	264	3	0	300	0	-300	0.00	0.00	0	0	0
0048	3T	17	265	1	0	100	0	-100	0.00	0.00	0	0	0
0048	3T	18	123	68	7	6800	4520	-2280	0.10	0.66	12	8	-4
0048	3T	18	124	110	9	11000	4960	-6040	0.08	0.45	19	8	-11
0048	3T	18	125	92	10	9200	7280	-1920	0.11	0.79	16	12	-4
0048	3T	18	126	108	6	10800	6980	-3820	0.06	0.65	19	12	-7
0048	3T	18	132	18	3	1800	2840	1040	0.17	1.58	3	5	2
0048	3T	18	134	48	6	4800	4370	-430	0.13	0.91	8	7	-1
0048	3T	18	135	55	3	5500	6550	1050	0.05	1.19	9	11	2
0048	3T	18	136	43	3	4300	3220	-1080	0.07	0.75	7	5	-2
0048	3T	18	142	12	0	1200	0	-1200	0.00	0.00	2	0	-2
0048	3T	18	143	7	0	700	0	-700	0.00	0.00	1	0	-1
0048	3T	18	145	96	5	9600	6970	-2630	0.05	0.73	16	12	-4
0048	3T	18	146	38	3	3800	8460	4660	0.08	2.23	6	14	8
0048	3T	18	152	13	3	1300	8930	7630	0.23	6.87	2	15	13
0048	3T	18	153	11	0	1100	0	-1100	0.00	0.00	1	0	-1
0048	3T	18	154	14	0	1400	0	-1400	0.00	0.00	2	0	-2
0048	3T	18	156	42	1	4200	4530	330	0.02	1.08	7	8	1
0048	3T	18	162	2	1	200	980	780	0.50	4.90	0	1	1
0048	3T	18	163	2	0	200	0	-200	0.00	0.00	0	0	0
0048	3T	18	164	1	0	100	0	-100	0.00	0.00	0	0	0
0048	3T	18	165	2	0	200	0	-200	0.00	0.00	0	0	0
0048	3T	18	214	1	0	100	0	-100	0.00	0.00	0	0	0
0048	3T	18	215	4	0	400	0	-400	0.00	0.00	0	0	0
0048	3T	18	216	9	0	900	0	-900	0.00	0.00	1	0	-1
0048	3T	18	231	5	0	500	0	-500	0.00	0.00	0	0	0
0048	3T	18	235	1	0	100	0	-100	0.00	0.00	0	0	0
0048	3T	18	236	4	0	400	0	-400	0.00	0.00	0	0	0
0048	3T	18	241	34	2	3400	4350	950	0.06	1.28	6	7	1
0048	3T	18	245	3	0	300	0	-300	0.00	0.00	0	0	0
0048	3T	18	246	4	0	400	0	-400	0.00	0.00	0	0	0
0048	3T	18	251	39	2	3900	3400	-500	0.05	0.87	6	6	0
0048	3T	18	256	22	2	2200	2240	40	0.09	1.02	3	3	0
0048	3T	18	261	24	0	2400	0	-2400	0.00	0.00	4	0	-4
0048	3T	18	263	1	0	100	0	-100	0.00	0.00	0	0	0
0048	3T	18	264	2	0	200	0	-200	0.00	0.00	0	0	0
0048	3T	18	265	1	0	100	0	-100	0.00	0.00	0	0	0
0048	3T	19	123	26	5	2600	2990	390	0.19	1.15	4	5	1
0048	3T	19	124	98	10	9800	7070	-2730	0.10	0.72	17	12	-5
0048	3T	19	125	43	1	4300	480	-3820	0.02	0.11	7	0	-7
0048	3T	19	126	74	2	7400	2940	-4460	0.03	0.40	13	5	-8
0048	3T	19	132	7	0	700	0	-700	0.00	0.00	1	0	-1
0048	3T	19	134	44	5	4400	2990	-1410	0.11	0.68	7	5	-2
0048	3T	19	135	41	2	4100	900	-3200	0.05	0.22	7	1	-6
0048	3T	19	136	57	5	5700	5190	-510	0.09	0.91	10	9	-1
0048	3T	19	142	5	0	500	0	-500	0.00	0.00	0	0	0
0048	3T	19	143	3	0	300	0	-300	0.00	0.00	0	0	0
0048	3T	19	145	45	2	4500	3130	-1370	0.04	0.70	7	5	-2
0048	3T	19	146	50	4	5000	6700	1700	0.08	1.34	8	11	3
0048	3T	19	152	1	0	100	0	-100	0.00	0.00	0	0	0
0048	3T	19	153	4	1	400	4880	4480	0.25	12.20	0	8	8
0048	3T	19	154	7	0	700	0	-700	0.00	0.00	1	0	-1
0048	3T	19	156	43	1	4300	3630	-670	0.02	0.84	7	6	-1
0048	3T	19	162	4	0	400	0	-400	0.00	0.00	0	0	0
0048	3T	19	163	2	0	200	0	-200	0.00	0.00	0	0	0
0048	3T	19	164	3	0	300	0	-300	0.00	0.00	0	0	0
0048	3T	19	165	3	0	300	0	-300	0.00	0.00	0	0	0
0048	3T	19	214	3	0	300	0	-300	0.00	0.00	0	0	0
0048	3T	19	215	2	0	200	0	-200	0.00	0.00	0	0	0
0048	3T	19	216	2	0	200	0	-200	0.00	0.00	0	0	0
0048	3T	19	231	8	0	800	0	-800	0.00	0.00	1	0	-1
0048	3T	19	234	1	0	100	0	-100	0.00	0.00	0	0	0
0048	3T	19	235	2	0	200	0	-200	0.00	0.00	0	0	0
0048	3T	19	236	3	0	300	0	-300	0.00	0.00	0	0	0
0048	3T	19	241	25	0	2500	0	-2500	0.00	0.00	4	0	-4
0048	3T	19	245	4	0	400	0	-400	0.00	0.00	0	0	0
0048	3T	19	246	6	0	600	0	-600	0.00	0.00	1	0	-1
0048	3T	19	251	12	0	1200	0	-1200	0.00	0.00	2	0	-2
0048	3T	19	256	7	0	700	0	-700	0.00	0.00	1	0	-1
0048	3T	19	261	21	1	2100	4680	2580	0.05	2.23	3	8	5
0048	3T	19	264	2	0	200	0	-200	0.00	0.00	0	0	0
0048	3T	20	123	60	11	6000	5800	-200	0.18	0.97	10	10	0
0048	3T	20	124	104	6	10400	3680	-6720	0.06	0.35	18	6	-12
0048	3T	20	125	60	5	6000	5660	-340	0.08	0.94	10	10	0
0048	3T	20	126	96	3	9600	5250	-4350	0.03	0.55	16	9	-7
0048	3T	20	132	10	3	1000	2210	1210	0.30	2.21	1	3	2
0048	3T	20	134	52	8	5200	5530	330	0.15	1.06	9	9	0
0048	3T	20	135	43	7	4300	7960	3660	0.16	1.85	7	14	7
0048	3T	20	136	60	5	6000	6300	300	0.08	1.05	10	11	1
0048	3T	20	142	2	0	200	0	-200	0.00	0.00	0	0	0
0048	3T	20	143	1	0	100	0	-100	0.00	0.00	0	0	0
0048	3T	20	145	40	0	4000	0	-4000	0.00	0.00	7	0	-7
0048	3T	20	146	56	1	5600	2740	-2860	0.02	0.49	9	4	-5
0048	3T	20	152	2	0	200	0	-200	0.00	0.00	0	0	0
0048	3T	20	153	3	1	300	2580	2280	0.33	8.60	0	4	4
0048	3T	20	154	9	0	900	0	-900	0.00	0.00	1	0	-1
0048	3T	20	156	54	2	5400	9320	3920	0.04	1.73	9	16	7
0048	3T	20	165	1	0	100	0	-100	0.00	0.00	0	0	0
0048	3T	20	214	2	0	200	0	-200	0.00	0.00	0	0	0
0048	3T	20	215	4	0	400	0	-400	0.00	0.00	0	0	0
0048	3T	20	216	6	0	600	0	-600	0.00	0.00	1	0	-1
0048	3T	20	231	11	0	1100	0	-1100	0.00	0.00	1	0	-1
0048	3T	20	234	3	0	300	0	-300	0.00	0.00	0	0	0
0048	3T	20	235	3	0	300	0	-300	0.00	0.00	0	0	0
0048	3T	20	236	1	0	100	0	-100	0.00	0.00	0	0	0
0048	3T	20	241	19	0	1900	0	-1900	0.00	0.00	3	0	-3
0048	3T	20	245	7	0	700	0	-700	0.00	0.00	1	0	-1
0048	3T	20	246	5	0	500	0	-500	0.00	0.00	0	0	0
0048	3T	20	251	16	0	1600	0	-1600	0.00	0.00	2	0	-2
0048	3T	20	253	1	0	100	0	-100	0.00	0.00	0	0	0
0048	3T	20	256	8	0	800	0	-800	0.00	0.00	1	0	-1
0048	3T	20	261	13	0	1300	0	-1300	0.00	0.00	2	0	-2
0048	3T	20	265	1	0	100	0	-100	0.00	0.00	0	0	0
0048	3T	21	123	36	5	3600	2810	-790	0.14	0.78	6	4	-2
0048	3T	21	124	76	6	7600	3260	-4340	0.08	0.43	13	5	-8
0048	3T	21	125	90	9	9000	11320	2320	0.10	1.26	15	20	5
0048	3T	21	126	70	2	7000	2190	-4810	0.03	0.31	12	3	-9
0048	3T	21	132	12	2	1200	1470	270	0.17	1.23	2	2	0
0048	3T	21	134	51	6	5100	3570	-1530	0.12	0.70	9	6	-3
0048	3T	21	135	69	4	6900	4860	-2040	0.06	0.70	12	8	-4
0048	3T	21	136	50	3	5000	3860	-1140	0.06	0.77	8	6	-2
0048	3T	21	142	7	1	700	1170	470	0.14	1.67	1	2	1
0048	3T	21	143	3	0	300	0	-300	0.00	0.00	0	0	0
0048	3T	21	145	50	4	5000	3440	-1560	0.08	0.69	8	6	-2
0048	3T	21	146	54	2	5400	5510	110	0.04	1.02	9	9	0
0048	3T	21	152	2	0	200	0	-200	0.00	0.00	0	0	0
0048	3T	21	153	6	1	600	1870	1270	0.17	3.12	1	3	2
0048	3T	21	154	8	0	800	0	-800	0.00	0.00	1	0	-1
0048	3T	21	156	58	0	5800	0	-5800	0.00	0.00	10	0	-10
0048	3T	21	162	2	0	200	0	-200	0.00	0.00	0	0	0
0048	3T	21	163	1	0	100	0	-100	0.00	0.00	0	0	0
0048	3T	21	164	3	1	300	2490	2190	0.33	8.30	0	4	4
0048	3T	21	165	2	2	200	14550	14350	1.00	72.75	0	25	25
0048	3T	21	213	2	0	200	0	-200	0.00	0.00	0	0	0
0048	3T	21	214	5	1	500	760	260	0.20	1.52	0	1	1
0048	3T	21	215	5	0	500	0	-500	0.00	0.00	0	0	0
0048	3T	21	216	8	0	800	0	-800	0.00	0.00	1	0	-1
0048	3T	21	231	7	0	700	0	-700	0.00	0.00	1	0	-1
0048	3T	21	234	1	0	100	0	-100	0.00	0.00	0	0	0
0048	3T	21	235	3	0	300	0	-300	0.00	0.00	0	0	0
0048	3T	21	236	2	1	200	9020	8820	0.50	45.10	0	15	15
0048	3T	21	241	17	0	1700	0	-1700	0.00	0.00	3	0	-3
0048	3T	21	245	2	0	200	0	-200	0.00	0.00	0	0	0
0048	3T	21	246	6	0	600	0	-600	0.00	0.00	1	0	-1
0048	3T	21	251	14	1	1400	1040	-360	0.07	0.74	2	1	-1
0048	3T	21	256	5	0	500	0	-500	0.00	0.00	0	0	0
0048	3T	21	261	11	0	1100	0	-1100	0.00	0.00	1	0	-1
0048	3T	21	264	2	0	200	0	-200	0.00	0.00	0	0	0
0048	3T	21	265	1	0	100	0	-100	0.00	0.00	0	0	0
0048	3T	22	123	53	9	5300	5770	470	0.17	1.09	9	10	1
0048	3T	22	124	93	7	9300	5360	-3940	0.08	0.58	16	9	-7
0048	3T	22	125	58	4	5800	3250	-2550	0.07	0.56	10	5	-5
0048	3T	22	126	85	6	8500	9350	850	0.07	1.10	15	16	1
0048	3T	22	132	1	0	100	0	-100	0.00	0.00	0	0	0
0048	3T	22	134	41	6	4100	4360	260	0.15	1.06	7	7	0
0048	3T	22	135	41	3	4100	5220	1120	0.07	1.27	7	9	2
0048	3T	22	136	49	1	4900	4950	50	0.02	1.01	8	8	0
0048	3T	22	143	11	2	1100	3150	2050	0.18	2.86	1	5	4
0048	3T	22	145	22	0	2200	0	-2200	0.00	0.00	3	0	-3
0048	3T	22	146	38	1	3800	1530	-2270	0.03	0.40	6	2	-4
0048	3T	22	152	1	0	100	0	-100	0.00	0.00	0	0	0
0048	3T	22	153	8	0	800	0	-800	0.00	0.00	1	0	-1
0048	3T	22	154	13	0	1300	0	-1300	0.00	0.00	2	0	-2
0048	3T	22	156	11	0	1100	0	-1100	0.00	0.00	1	0	-1
0048	3T	22	162	1	0	100	0	-100	0.00	0.00	0	0	0
0048	3T	22	163	11	0	1100	0	-1100	0.00	0.00	1	0	-1
0048	3T	22	164	15	0	1500	0	-1500	0.00	0.00	2	0	-2
0048	3T	22	165	2	0	200	0	-200	0.00	0.00	0	0	0
0048	3T	22	213	7	0	700	0	-700	0.00	0.00	1	0	-1
0048	3T	22	215	2	0	200	0	-200	0.00	0.00	0	0	0
0048	3T	22	216	5	0	500	0	-500	0.00	0.00	0	0	0
0048	3T	22	231	24	2	2400	4300	1900	0.08	1.79	4	7	3
0048	3T	22	234	4	0	400	0	-400	0.00	0.00	0	0	0
0048	3T	22	235	13	0	1300	0	-1300	0.00	0.00	2	0	-2
0048	3T	22	236	9	0	900	0	-900	0.00	0.00	1	0	-1
0048	3T	22	241	23	0	2300	0	-2300	0.00	0.00	4	0	-4
0048	3T	22	245	6	0	600	0	-600	0.00	0.00	1	0	-1
0048	3T	22	246	8	0	800	0	-800	0.00	0.00	1	0	-1
0048	3T	22	251	25	0	2500	0	-2500	0.00	0.00	4	0	-4
0048	3T	22	253	2	0	200	0	-200	0.00	0.00	0	0	0
0048	3T	22	256	8	0	800	0	-800	0.00	0.00	1	0	-1
0048	3T	22	261	15	0	1500	0	-1500	0.00	0.00	2	0	-2
0048	3T	22	263	1	0	100	0	-100	0.00	0.00	0	0	0
0048	3T	22	265	1	0	100	0	-100	0.00	0.00	0	0	0
0048	3T	23	123	45	7	4500	3660	-840	0.16	0.81	7	6	-1
0048	3T	23	124	126	8	12600	4620	-7980	0.06	0.37	22	8	-14
0048	3T	23	125	23	1	2300	370	-1930	0.04	0.16	4	0	-4
0048	3T	23	126	124	5	12400	10100	-2300	0.04	0.81	21	17	-4
0048	3T	23	132	12	0	1200	0	-1200	0.00	0.00	2	0	-2
0048	3T	23	134	80	8	8000	8150	150	0.10	1.02	14	14	0
0048	3T	23	135	27	1	2700	590	-2110	0.04	0.22	4	1	-3
0048	3T	23	136	66	2	6600	6930	330	0.03	1.05	11	12	1
0048	3T	23	142	15	3	1500	2710	1210	0.20	1.81	2	4	2
0048	3T	23	145	17	0	1700	0	-1700	0.00	0.00	3	0	-3
0048	3T	23	146	31	1	3100	1630	-1470	0.03	0.53	5	2	-3
0048	3T	23	152	11	0	1100	0	-1100	0.00	0.00	1	0	-1
0048	3T	23	153	5	0	500	0	-500	0.00	0.00	0	0	0
0048	3T	23	154	24	1	2400	5170	2770	0.04	2.15	4	9	5
0048	3T	23	156	30	4	3000	7130	4130	0.13	2.38	5	12	7
0048	3T	23	162	4	0	400	0	-400	0.00	0.00	0	0	0
0048	3T	23	163	3	0	300	0	-300	0.00	0.00	0	0	0
0048	3T	23	164	15	0	1500	0	-1500	0.00	0.00	2	0	-2
0048	3T	23	165	2	0	200	0	-200	0.00	0.00	0	0	0
0048	3T	23	213	1	0	100	0	-100	0.00	0.00	0	0	0
0048	3T	23	214	17	0	1700	0	-1700	0.00	0.00	3	0	-3
0048	3T	23	215	10	0	1000	0	-1000	0.00	0.00	1	0	-1
0048	3T	23	216	20	0	2000	0	-2000	0.00	0.00	3	0	-3
0048	3T	23	231	14	0	1400	0	-1400	0.00	0.00	2	0	-2
0048	3T	23	234	15	0	1500	0	-1500	0.00	0.00	2	0	-2
0048	3T	23	235	5	0	500	0	-500	0.00	0.00	0	0	0
0048	3T	23	236	3	0	300	0	-300	0.00	0.00	0	0	0
0048	3T	23	241	23	2	2300	1820	-480	0.09	0.79	4	3	-1
0048	3T	23	245	3	0	300	0	-300	0.00	0.00	0	0	0
0048	3T	23	246	11	1	1100	1310	210	0.09	1.19	1	2	1
0048	3T	23	251	12	0	1200	0	-1200	0.00	0.00	2	0	-2
0048	3T	23	253	3	0	300	0	-300	0.00	0.00	0	0	0
0048	3T	23	254	13	0	1300	0	-1300	0.00	0.00	2	0	-2
0048	3T	23	256	13	0	1300	0	-1300	0.00	0.00	2	0	-2
0048	3T	23	261	22	0	2200	0	-2200	0.00	0.00	3	0	-3
0048	3T	23	263	3	0	300	0	-300	0.00	0.00	0	0	0
0048	3T	23	265	3	0	300	0	-300	0.00	0.00	0	0	0
0048	3T	24	123	78	15	7800	6780	-1020	0.19	0.87	13	12	-1
0048	3T	24	124	100	11	10000	5650	-4350	0.11	0.57	17	10	-7
0048	3T	24	125	46	9	4600	6710	2110	0.20	1.46	8	11	3
0048	3T	24	126	138	2	13800	2790	-11010	0.01	0.20	24	4	-20
0048	3T	24	132	24	1	2400	440	-1960	0.04	0.18	4	0	-4
0048	3T	24	134	51	6	5100	3880	-1220	0.12	0.76	9	6	-3
0048	3T	24	135	55	0	5500	0	-5500	0.00	0.00	9	0	-9
0048	3T	24	136	70	1	7000	1250	-5750	0.01	0.18	12	2	-10
0048	3T	24	142	18	1	1800	680	-1120	0.06	0.38	3	1	-2
0048	3T	24	143	21	0	2100	0	-2100	0.00	0.00	3	0	-3
0048	3T	24	145	31	0	3100	0	-3100	0.00	0.00	5	0	-5
0048	3T	24	146	44	1	4400	880	-3520	0.02	0.20	7	1	-6
0048	3T	24	152	16	0	1600	0	-1600	0.00	0.00	2	0	-2
0048	3T	24	153	18	0	1800	0	-1800	0.00	0.00	3	0	-3
0048	3T	24	154	15	0	1500	0	-1500	0.00	0.00	2	0	-2
0048	3T	24	156	31	0	3100	0	-3100	0.00	0.00	5	0	-5
0048	3T	24	162	1	0	100	0	-100	0.00	0.00	0	0	0
0048	3T	24	163	2	0	200	0	-200	0.00	0.00	0	0	0
0048	3T	24	165	3	0	300	0	-300	0.00	0.00	0	0	0
0048	3T	24	213	3	0	300	0	-300	0.00	0.00	0	0	0
0048	3T	24	214	8	0	800	0	-800	0.00	0.00	1	0	-1
0048	3T	24	215	6	0	600	0	-600	0.00	0.00	1	0	-1
0048	3T	24	216	14	0	1400	0	-1400	0.00	0.00	2	0	-2
0048	3T	24	231	6	0	600	0	-600	0.00	0.00	1	0	-1
0048	3T	24	235	3	0	300	0	-300	0.00	0.00	0	0	0
0048	3T	24	236	4	2	400	6870	6470	0.50	17.18	0	12	12
0048	3T	24	241	18	2	1800	5180	3380	0.11	2.88	3	9	6
0048	3T	24	243	1	0	100	0	-100	0.00	0.00	0	0	0
0048	3T	24	245	1	0	100	0	-100	0.00	0.00	0	0	0
0048	3T	24	246	1	0	100	0	-100	0.00	0.00	0	0	0
0048	3T	24	251	21	1	2100	2080	-20	0.05	0.99	3	3	0
0048	3T	24	253	1	0	100	0	-100	0.00	0.00	0	0	0
0048	3T	24	254	1	0	100	0	-100	0.00	0.00	0	0	0
0048	3T	24	256	4	0	400	0	-400	0.00	0.00	0	0	0
0048	3T	24	261	19	1	1900	2140	240	0.05	1.13	3	3	0
0048	3T	24	263	1	0	100	0	-100	0.00	0.00	0	0	0
0048	3T	24	265	1	0	100	0	-100	0.00	0.00	0	0	0
0049	1T	01	1	933	686	93300	88910	-4390	0.74	0.95	165	157	-8
0049	1T	01	2	404	132	40400	38140	-2260	0.33	0.94	71	67	-4
0049	1T	02	1	791	493	79100	69320	-9780	0.62	0.88	140	122	-18
0049	1T	02	2	465	148	46500	34590	-11910	0.32	0.74	82	61	-21
0049	1T	03	1	452	284	45200	41490	-3710	0.63	0.92	80	73	-7
0049	1T	03	2	393	138	39300	35860	-3440	0.35	0.91	69	63	-6
0049	1T	04	1	653	436	65300	57330	-7970	0.67	0.88	115	101	-14
0049	1T	04	2	349	121	34900	29240	-5660	0.35	0.84	61	51	-10
0049	1T	05	1	851	603	85100	80570	-4530	0.71	0.95	150	142	-8
0049	1T	05	2	416	135	41600	34870	-6730	0.32	0.84	73	61	-12
0049	1T	06	1	851	574	85100	73900	-11200	0.67	0.87	150	130	-20
0049	1T	06	2	465	166	46500	41750	-4750	0.36	0.90	82	73	-9
0049	1T	07	1	906	644	90600	82920	-7680	0.71	0.92	160	146	-14
0049	1T	07	2	436	147	43600	39210	-4390	0.34	0.90	77	69	-8
0049	1T	08	1	910	657	91000	83190	-7810	0.72	0.91	161	147	-14
0049	1T	08	2	351	102	35100	25830	-9270	0.29	0.74	62	45	-17
0049	1T	09	1	1104	837	110400	103200	-7200	0.76	0.93	195	182	-13
0049	1T	09	2	493	189	49300	46960	-2340	0.38	0.95	87	83	-4
0049	1T	10	1	1007	738	100700	94980	-5720	0.73	0.94	178	168	-10
0049	1T	10	2	531	198	53100	48220	-4880	0.37	0.91	93	85	-8
0049	1T	11	1	868	563	86800	75660	-11140	0.65	0.87	153	133	-20
0049	1T	11	2	353	109	35300	33660	-1640	0.31	0.95	62	59	-3
0049	1T	12	1	853	622	85300	79100	-6200	0.73	0.93	150	140	-10
0049	1T	12	2	441	148	44100	37340	-6760	0.34	0.85	78	66	-12
0049	1T	13	1	819	617	81900	78110	-3790	0.75	0.95	144	138	-6
0049	1T	13	2	381	137	38100	35820	-2280	0.36	0.94	67	63	-4
0049	1T	14	1	816	570	81600	75310	-6290	0.70	0.92	144	133	-11
0049	1T	14	2	377	137	37700	37690	-10	0.36	1.00	66	66	0
0049	1T	15	1	980	664	98000	84300	-13700	0.68	0.86	173	149	-24
0049	1T	15	2	372	110	37200	31670	-5530	0.30	0.85	65	56	-9
0049	1T	16	1	1069	773	106900	96680	-10220	0.72	0.90	189	171	-18
0049	1T	16	2	414	128	41400	32250	-9150	0.31	0.78	73	57	-16
0049	1T	17	1	1098	781	109800	100430	-9370	0.71	0.91	194	177	-17
0049	1T	17	2	455	148	45500	36030	-9470	0.33	0.79	80	63	-17
0049	1T	18	1	1284	1012	128400	118590	-9810	0.79	0.92	227	209	-18
0049	1T	18	2	416	154	41600	30320	-11280	0.37	0.73	73	53	-20
0049	1T	19	1	943	660	94300	83060	-11240	0.70	0.88	166	147	-19
0049	1T	19	2	308	105	30800	32960	2160	0.34	1.07	54	58	4
0049	1T	20	1	959	696	95900	89000	-6900	0.73	0.93	169	157	-12
0049	1T	20	2	412	124	41200	29030	-12170	0.30	0.70	72	51	-21
0049	1T	21	1	1115	837	111500	101870	-9630	0.75	0.91	197	180	-17
0049	1T	21	2	403	123	40300	31200	-9100	0.31	0.77	71	55	-16
0049	1T	22	1	847	559	84700	73840	-10860	0.66	0.87	149	130	-19
0049	1T	22	2	439	136	43900	31360	-12540	0.31	0.71	77	55	-22
0049	1T	23	1	939	654	93900	80900	-13000	0.70	0.86	166	143	-23
0049	1T	23	2	503	172	50300	44730	-5570	0.34	0.89	89	79	-10
0049	1T	24	1	1216	977	121600	117850	-3750	0.80	0.97	215	208	-7
0049	1T	24	2	348	106	34800	24550	-10250	0.30	0.71	61	43	-18
0049	2F	01	12	420	157	42000	35490	-6510	0.37	0.85	74	62	-12
0049	2F	01	13	196	52	19600	14790	-4810	0.27	0.75	34	26	-8
0049	2F	01	14	97	20	9700	7600	-2100	0.21	0.78	17	13	-4
0049	2F	01	15	134	19	13400	9960	-3440	0.14	0.74	23	17	-6
0049	2F	01	16	86	8	8600	10370	1770	0.09	1.21	15	18	3
0049	2F	01	23	55	11	5500	3950	-1550	0.20	0.72	9	6	-3
0049	2F	01	24	81	15	8100	9130	1030	0.19	1.13	14	16	2
0049	2F	01	25	64	8	6400	5910	-490	0.13	0.92	11	10	-1
0049	2F	01	26	85	4	8500	2620	-5880	0.05	0.31	15	4	-11
0049	2F	02	12	281	97	28100	25640	-2460	0.35	0.91	49	45	-4
0049	2F	02	13	212	66	21200	18500	-2700	0.31	0.87	37	32	-5
0049	2F	02	14	106	26	10600	8960	-1640	0.25	0.85	18	15	-3
0049	2F	02	15	93	11	9300	5520	-3780	0.12	0.59	16	9	-7
0049	2F	02	16	108	6	10800	5130	-5670	0.06	0.48	19	9	-10
0049	2F	02	23	39	10	3900	3720	-180	0.26	0.95	6	6	0
0049	2F	02	24	80	10	8000	4170	-3830	0.13	0.52	14	7	-7
0049	2F	02	25	91	10	9100	6410	-2690	0.11	0.70	16	11	-5
0049	2F	02	26	108	9	10800	5730	-5070	0.08	0.53	19	10	-9
0049	2F	03	12	190	80	19000	17870	-1130	0.42	0.94	33	31	-2
0049	2F	03	13	102	26	10200	6930	-3270	0.25	0.68	18	12	-6
0049	2F	03	14	71	18	7100	6980	-120	0.25	0.98	12	12	0
0049	2F	03	15	56	8	5600	4550	-1050	0.14	0.81	9	8	-1
0049	2F	03	16	53	7	5300	7540	2240	0.13	1.42	9	13	4
0049	2F	03	23	46	7	4600	2880	-1720	0.15	0.63	8	5	-3
0049	2F	03	24	53	6	5300	2650	-2650	0.11	0.50	9	4	-5
0049	2F	03	25	66	4	6600	2780	-3820	0.06	0.42	11	4	-7
0049	2F	03	26	74	7	7400	5730	-1670	0.09	0.77	13	10	-3
0049	2F	04	12	271	96	27100	25990	-1110	0.35	0.96	47	46	-1
0049	2F	04	13	152	47	15200	13350	-1850	0.31	0.88	26	23	-3
0049	2F	04	14	103	24	10300	8820	-1480	0.23	0.86	18	15	-3
0049	2F	04	15	101	17	10100	10480	380	0.17	1.04	17	18	1
0049	2F	04	16	80	8	8000	8940	940	0.10	1.12	14	15	1
0049	2F	04	23	24	6	2400	2260	-140	0.25	0.94	4	4	0
0049	2F	04	24	32	7	3200	2660	-540	0.22	0.83	5	4	-1
0049	2F	04	25	50	9	5000	5080	80	0.18	1.02	8	8	0
0049	2F	04	26	68	10	6800	9080	2280	0.15	1.34	12	16	4
0049	2F	05	12	328	112	32800	26360	-6440	0.34	0.80	58	46	-12
0049	2F	05	13	140	49	14000	13870	-130	0.35	0.99	24	24	0
0049	2F	05	14	155	35	15500	11230	-4270	0.23	0.72	27	19	-8
0049	2F	05	15	136	25	13600	13290	-310	0.18	0.98	24	23	-1
0049	2F	05	16	114	18	11400	14650	3250	0.16	1.29	20	25	5
0049	2F	05	23	30	6	3000	2420	-580	0.20	0.81	5	4	-1
0049	2F	05	24	51	7	5100	3230	-1870	0.14	0.63	9	5	-4
0049	2F	05	25	87	10	8700	5640	-3060	0.11	0.65	15	9	-6
0049	2F	05	26	69	4	6900	2520	-4380	0.06	0.37	12	4	-8
0049	2F	06	12	314	104	31400	24760	-6640	0.33	0.79	55	43	-12
0049	2F	06	13	199	64	19900	15190	-4710	0.32	0.76	35	26	-9
0049	2F	06	14	156	32	15600	10150	-5450	0.21	0.65	27	17	-10
0049	2F	06	15	131	19	13100	11750	-1350	0.15	0.90	23	20	-3
0049	2F	06	16	95	11	9500	9160	-340	0.12	0.96	16	16	0
0049	2F	06	23	35	16	3500	5700	2200	0.46	1.63	6	10	4
0049	2F	06	24	55	6	5500	3110	-2390	0.11	0.57	9	5	-4
0049	2F	06	25	93	12	9300	6060	-3240	0.13	0.65	16	10	-6
0049	2F	06	26	89	6	8900	5870	-3030	0.07	0.66	15	10	-5
0049	2F	07	12	278	104	27800	24350	-3450	0.37	0.88	49	43	-6
0049	2F	07	13	214	80	21400	18540	-2860	0.37	0.87	37	32	-5
0049	2F	07	14	222	50	22200	14630	-7570	0.23	0.66	39	25	-14
0049	2F	07	15	131	19	13100	9310	-3790	0.15	0.71	23	16	-7
0049	2F	07	16	91	6	9100	4010	-5090	0.07	0.44	16	7	-9
0049	2F	07	23	25	1	2500	430	-2070	0.04	0.17	4	0	-4
0049	2F	07	24	33	6	3300	3520	220	0.18	1.07	5	6	1
0049	2F	07	25	73	5	7300	4210	-3090	0.07	0.58	12	7	-5
0049	2F	07	26	96	4	9600	2400	-7200	0.04	0.25	16	4	-12
0049	2F	08	12	354	128	35400	27270	-8130	0.36	0.77	62	48	-14
0049	2F	08	13	166	58	16600	14020	-2580	0.35	0.84	29	24	-5
0049	2F	08	14	235	47	23500	14620	-8880	0.20	0.62	41	25	-16
0049	2F	08	15	114	13	11400	8590	-2810	0.11	0.75	20	15	-5
0049	2F	08	16	76	7	7600	4680	-2920	0.09	0.62	13	8	-5
0049	2F	08	23	23	2	2300	500	-1800	0.09	0.22	4	0	-4
0049	2F	08	24	30	6	3000	2640	-360	0.20	0.88	5	4	-1
0049	2F	08	25	50	4	5000	2310	-2690	0.08	0.46	8	4	-4
0049	2F	08	26	66	3	6600	1520	-5080	0.05	0.23	11	2	-9
0049	2F	09	12	526	206	52600	41120	-11480	0.39	0.78	93	72	-21
0049	2F	09	13	226	61	22600	15360	-7240	0.27	0.68	40	27	-13
0049	2F	09	14	201	42	20100	15170	-4930	0.21	0.75	35	26	-9
0049	2F	09	15	143	23	14300	12740	-1560	0.16	0.89	25	22	-3
0049	2F	09	16	66	8	6600	6810	210	0.12	1.03	11	12	1
0049	2F	09	23	28	6	2800	2210	-590	0.21	0.79	4	3	-1
0049	2F	09	24	57	10	5700	3990	-1710	0.18	0.70	10	7	-3
0049	2F	09	25	97	15	9700	9240	-460	0.15	0.95	17	16	-1
0049	2F	09	26	92	8	9200	5370	-3830	0.09	0.58	16	9	-7
0049	2F	10	12	446	191	44600	36250	-8350	0.43	0.81	78	64	-14
0049	2F	10	13	254	79	25400	17900	-7500	0.31	0.70	44	31	-13
0049	2F	10	14	183	41	18300	16120	-2180	0.22	0.88	32	28	-4
0049	2F	10	15	104	18	10400	10600	200	0.17	1.02	18	18	0
0049	2F	10	16	53	3	5300	1710	-3590	0.06	0.32	9	3	-6
0049	2F	10	23	25	3	2500	950	-1550	0.12	0.38	4	1	-3
0049	2F	10	24	48	13	4800	6520	1720	0.27	1.36	8	11	3
0049	2F	10	25	96	15	9600	12560	2960	0.16	1.31	16	22	6
0049	2F	10	26	73	6	7300	5320	-1980	0.08	0.73	12	9	-3
0049	2F	11	12	411	202	41100	36800	-4300	0.49	0.90	72	65	-7
0049	2F	11	13	204	32	20400	11380	-9020	0.16	0.56	36	20	-16
0049	2F	11	14	70	9	7000	2900	-4100	0.13	0.41	12	5	-7
0049	2F	11	15	78	6	7800	3450	-4350	0.08	0.44	13	6	-7
0049	2F	11	16	86	6	8600	6760	-1840	0.07	0.79	15	11	-4
0049	2F	11	23	66	12	6600	9570	2970	0.18	1.45	11	16	5
0049	2F	11	24	29	2	2900	1000	-1900	0.07	0.34	5	1	-4
0049	2F	11	25	121	10	12100	7620	-4480	0.08	0.63	21	13	-8
0049	2F	11	26	81	4	8100	7250	-850	0.05	0.90	14	12	-2
0049	2F	12	12	389	147	38900	33380	-5520	0.38	0.86	68	59	-9
0049	2F	12	13	221	76	22100	19500	-2600	0.34	0.88	39	34	-5
0049	2F	12	14	65	17	6500	6780	280	0.26	1.04	11	12	1
0049	2F	12	15	68	7	6800	3790	-3010	0.10	0.56	12	6	-6
0049	2F	12	16	126	12	12600	6390	-6210	0.10	0.51	22	11	-11
0049	2F	12	23	60	13	6000	4590	-1410	0.22	0.77	10	8	-2
0049	2F	12	24	70	7	7000	4040	-2960	0.10	0.58	12	7	-5
0049	2F	12	25	81	9	8100	4970	-3130	0.11	0.61	14	8	-6
0049	2F	12	26	51	3	5100	2160	-2940	0.06	0.42	9	3	-6
0049	2F	13	12	253	96	25300	20100	-5200	0.38	0.79	44	35	-9
0049	2F	13	13	199	55	19900	12260	-7640	0.28	0.62	35	21	-14
0049	2F	13	14	110	35	11000	9090	-1910	0.32	0.83	19	16	-3
0049	2F	13	15	93	16	9300	8720	-580	0.17	0.94	16	15	-1
0049	2F	13	16	162	19	16200	10380	-5820	0.12	0.64	28	18	-10
0049	2F	13	23	27	7	2700	3240	540	0.26	1.20	4	5	1
0049	2F	13	24	78	4	7800	1340	-6460	0.05	0.17	13	2	-11
0049	2F	13	25	74	9	7400	6200	-1200	0.12	0.84	13	10	-3
0049	2F	13	26	68	5	6800	15760	8960	0.07	2.32	12	27	15
0049	2F	14	12	322	106	32200	23420	-8780	0.33	0.73	56	41	-15
0049	2F	14	13	184	48	18400	12250	-6150	0.26	0.67	32	21	-11
0049	2F	14	14	168	54	16800	16030	-770	0.32	0.95	29	28	-1
0049	2F	14	15	91	12	9100	7910	-1190	0.13	0.87	16	14	-2
0049	2F	14	16	73	5	7300	3120	-4180	0.07	0.43	12	5	-7
0049	2F	14	23	31	4	3100	2090	-1010	0.13	0.67	5	3	-2
0049	2F	14	24	37	3	3700	1430	-2270	0.08	0.39	6	2	-4
0049	2F	14	25	69	7	6900	5680	-1220	0.10	0.82	12	10	-2
0049	2F	14	26	73	4	7300	4990	-2310	0.05	0.68	12	8	-4
0049	2F	15	12	406	154	40600	32110	-8490	0.38	0.79	71	56	-15
0049	2F	15	13	171	53	17100	13730	-3370	0.31	0.80	30	24	-6
0049	2F	15	14	227	60	22700	17430	-5270	0.26	0.77	40	30	-10
0049	2F	15	15	121	21	12100	10720	-1380	0.17	0.89	21	18	-3
0049	2F	15	16	72	8	7200	5600	-1600	0.11	0.78	12	9	-3
0049	2F	15	23	36	8	3600	2060	-1540	0.22	0.57	6	3	-3
0049	2F	15	24	46	6	4600	2750	-1850	0.13	0.60	8	4	-4
0049	2F	15	25	64	4	6400	5720	-680	0.06	0.89	11	10	-1
0049	2F	15	26	83	10	8300	7450	-850	0.12	0.90	14	13	-1
0049	2F	16	12	398	168	39800	35790	-4010	0.42	0.90	70	63	-7
0049	2F	16	13	257	78	25700	18580	-7120	0.30	0.72	45	32	-13
0049	2F	16	14	200	56	20000	17510	-2490	0.28	0.88	35	30	-5
0049	2F	16	15	180	32	18000	18790	790	0.18	1.04	31	33	2
0049	2F	16	16	64	5	6400	4690	-1710	0.08	0.73	11	8	-3
0049	2F	16	23	42	6	4200	2730	-1470	0.14	0.65	7	4	-3
0049	2F	16	24	29	4	2900	1730	-1170	0.14	0.60	5	3	-2
0049	2F	16	25	59	11	5900	4890	-1010	0.19	0.83	10	8	-2
0049	2F	16	26	99	5	9900	4720	-5180	0.05	0.48	17	8	-9
0049	2F	17	12	408	153	40800	29840	-10960	0.38	0.73	72	52	-20
0049	2F	17	13	247	97	24700	23170	-1530	0.39	0.94	43	41	-2
0049	2F	17	14	223	48	22300	15050	-7250	0.22	0.67	39	26	-13
0049	2F	17	15	126	18	12600	10300	-2300	0.14	0.82	22	18	-4
0049	2F	17	16	115	20	11500	22530	11030	0.17	1.96	20	39	19
0049	2F	17	23	26	2	2600	940	-1660	0.08	0.36	4	1	-3
0049	2F	17	24	71	9	7100	2620	-4480	0.13	0.37	12	4	-8
0049	2F	17	25	74	12	7400	6700	-700	0.16	0.91	13	11	-2
0049	2F	17	26	70	3	7000	1740	-5260	0.04	0.25	12	3	-9
0049	2F	18	12	530	244	53000	43460	-9540	0.46	0.82	93	76	-17
0049	2F	18	13	162	49	16200	13020	-3180	0.30	0.80	28	23	-5
0049	2F	18	14	303	65	30300	20930	-9370	0.21	0.69	53	37	-16
0049	2F	18	15	246	37	24600	18570	-6030	0.15	0.75	43	32	-11
0049	2F	18	16	75	12	7500	6380	-1120	0.16	0.85	13	11	-2
0049	2F	18	23	13	0	1300	0	-1300	0.00	0.00	2	0	-2
0049	2F	18	24	50	8	5000	3560	-1440	0.16	0.71	8	6	-2
0049	2F	18	25	106	13	10600	5820	-4780	0.12	0.55	18	10	-8
0049	2F	18	26	105	10	10500	7780	-2720	0.10	0.74	18	13	-5
0049	2F	19	12	302	114	30200	24750	-5450	0.38	0.82	53	43	-10
0049	2F	19	13	211	71	21100	15440	-5660	0.34	0.73	37	27	-10
0049	2F	19	14	273	74	27300	21330	-5970	0.27	0.78	48	37	-11
0049	2F	19	15	113	15	11300	9270	-2030	0.13	0.82	20	16	-4
0049	2F	19	16	49	6	4900	2940	-1960	0.12	0.60	8	5	-3
0049	2F	19	23	18	1	1800	140	-1660	0.06	0.08	3	0	-3
0049	2F	19	24	33	4	3300	1610	-1690	0.12	0.49	5	2	-3
0049	2F	19	25	48	3	4800	2950	-1850	0.06	0.61	8	5	-3
0049	2F	19	26	65	5	6500	3740	-2760	0.08	0.58	11	6	-5
0049	2F	20	12	403	154	40300	32030	-8270	0.38	0.79	71	56	-15
0049	2F	20	13	186	89	18600	20260	1660	0.48	1.09	32	35	3
0049	2F	20	14	191	39	19100	11380	-7720	0.20	0.60	33	20	-13
0049	2F	20	15	146	31	14600	13680	-920	0.21	0.94	25	24	-1
0049	2F	20	16	64	9	6400	5420	-980	0.14	0.85	11	9	-2
0049	2F	20	23	20	4	2000	2920	920	0.20	1.46	3	5	2
0049	2F	20	24	55	9	5500	4750	-750	0.16	0.86	9	8	-1
0049	2F	20	25	38	1	3800	1250	-2550	0.03	0.33	6	2	-4
0049	2F	20	26	25	2	2500	3000	500	0.08	1.20	4	5	1
0049	2F	21	12	416	158	41600	32870	-8730	0.38	0.79	73	58	-15
0049	2F	21	13	259	105	25900	22760	-3140	0.41	0.88	45	40	-5
0049	2F	21	14	231	66	23100	18970	-4130	0.29	0.82	40	33	-7
0049	2F	21	15	186	29	18600	16420	-2180	0.16	0.88	32	29	-3
0049	2F	21	16	56	5	5600	2970	-2630	0.09	0.53	9	5	-4
0049	2F	21	23	10	1	1000	290	-710	0.10	0.29	1	0	-1
0049	2F	21	24	41	7	4100	4210	110	0.17	1.03	7	7	0
0049	2F	21	25	66	6	6600	3260	-3340	0.09	0.49	11	5	-6
0049	2F	21	26	67	5	6700	8620	1920	0.07	1.29	11	15	4
0049	2F	22	12	255	107	25500	27550	2050	0.42	1.08	45	48	3
0049	2F	22	13	151	52	15100	14090	-1010	0.34	0.93	26	24	-2
0049	2F	22	14	221	53	22100	16270	-5830	0.24	0.74	39	28	-11
0049	2F	22	15	105	11	10500	7430	-3070	0.10	0.71	18	13	-5
0049	2F	22	16	101	9	10100	6780	-3320	0.09	0.67	17	12	-5
0049	2F	22	23	78	17	7800	7500	-300	0.22	0.96	13	13	0
0049	2F	22	24	60	9	6000	3430	-2570	0.15	0.57	10	6	-4
0049	2F	22	25	94	6	9400	3440	-5960	0.06	0.37	16	6	-10
0049	2F	22	26	77	3	7700	1850	-5850	0.04	0.24	13	3	-10
0049	2F	23	12	406	152	40600	31210	-9390	0.37	0.77	71	55	-16
0049	2F	23	13	216	66	21600	19290	-2310	0.31	0.89	38	34	-4
0049	2F	23	14	116	26	11600	7970	-3630	0.22	0.69	20	14	-6
0049	2F	23	15	117	15	11700	8890	-2810	0.13	0.76	20	15	-5
0049	2F	23	16	82	6	8200	5720	-2480	0.07	0.70	14	10	-4
0049	2F	23	23	32	7	3200	2880	-320	0.22	0.90	5	5	0
0049	2F	23	24	115	16	11500	6890	-4610	0.14	0.60	20	12	-8
0049	2F	23	25	78	10	7800	7720	-80	0.13	0.99	13	13	0
0049	2F	23	26	56	2	5600	1070	-4530	0.04	0.19	9	1	-8
0049	2F	24	12	457	182	45700	35240	-10460	0.40	0.77	80	62	-18
0049	2F	24	13	324	119	32400	30820	-1580	0.37	0.95	57	54	-3
0049	2F	24	14	180	39	18000	13080	-4920	0.22	0.73	31	23	-8
0049	2F	24	15	145	24	14500	13990	-510	0.17	0.96	25	24	-1
0049	2F	24	16	132	15	13200	12110	-1090	0.11	0.92	23	21	-2
0049	2F	24	23	26	0	2600	0	-2600	0.00	0.00	4	0	-4
0049	2F	24	24	57	10	5700	7820	2120	0.18	1.37	10	13	3
0049	2F	24	25	57	5	5700	1650	-4050	0.09	0.29	10	2	-8
0049	2F	24	26	63	4	6300	4200	-2100	0.06	0.67	11	7	-4
0049	2T	01	12	406	130	40600	35360	-5240	0.32	0.87	71	62	-9
0049	2T	01	13	196	43	19600	14620	-4980	0.22	0.75	34	25	-9
0049	2T	01	14	97	19	9700	8130	-1570	0.20	0.84	17	14	-3
0049	2T	01	15	134	18	13400	12900	-500	0.13	0.96	23	22	-1
0049	2T	01	16	86	7	8600	9560	960	0.08	1.11	15	16	1
0049	2T	01	21	14	2	1400	3030	1630	0.14	2.16	2	5	3
0049	2T	01	23	55	5	5500	2780	-2720	0.09	0.51	9	4	-5
0049	2T	01	24	81	5	8100	4360	-3740	0.06	0.54	14	7	-7
0049	2T	01	25	64	6	6400	3920	-2480	0.09	0.61	11	6	-5
0049	2T	01	26	85	3	8500	3320	-5180	0.04	0.39	15	5	-10
0049	2T	02	12	256	74	25600	22920	-2680	0.29	0.90	45	40	-5
0049	2T	02	13	212	49	21200	17160	-4040	0.23	0.81	37	30	-7
0049	2T	02	14	106	22	10600	9930	-670	0.21	0.94	18	17	-1
0049	2T	02	15	93	10	9300	5300	-4000	0.11	0.57	16	9	-7
0049	2T	02	16	108	4	10800	4360	-6440	0.04	0.40	19	7	-12
0049	2T	02	21	25	2	2500	1110	-1390	0.08	0.44	4	1	-3
0049	2T	02	23	39	8	3900	4860	960	0.21	1.25	6	8	2
0049	2T	02	24	80	6	8000	3900	-4100	0.08	0.49	14	6	-8
0049	2T	02	25	91	8	9100	7030	-2070	0.09	0.77	16	12	-4
0049	2T	02	26	108	7	10800	7910	-2890	0.06	0.73	19	14	-5
0049	2T	03	12	160	54	16000	16750	750	0.34	1.05	28	29	1
0049	2T	03	13	102	24	10200	7700	-2500	0.24	0.75	18	13	-5
0049	2T	03	14	71	14	7100	6570	-530	0.20	0.93	12	11	-1
0049	2T	03	15	56	5	5600	3410	-2190	0.09	0.61	9	6	-3
0049	2T	03	16	53	5	5300	5940	640	0.09	1.12	9	10	1
0049	2T	03	21	30	5	3000	2980	-20	0.17	0.99	5	5	0
0049	2T	03	23	46	3	4600	1690	-2910	0.07	0.37	8	2	-6
0049	2T	03	24	53	5	5300	3720	-1580	0.09	0.70	9	6	-3
0049	2T	03	25	66	4	6600	3180	-3420	0.06	0.48	11	5	-6
0049	2T	03	26	74	4	7400	5700	-1700	0.05	0.77	13	10	-3
0049	2T	04	12	208	53	20800	15970	-4830	0.25	0.77	36	28	-8
0049	2T	04	13	152	37	15200	13370	-1830	0.24	0.88	26	23	-3
0049	2T	04	14	103	20	10300	8890	-1410	0.19	0.86	18	15	-3
0049	2T	04	15	101	11	10100	11010	910	0.11	1.09	17	19	2
0049	2T	04	16	80	7	8000	9750	1750	0.09	1.22	14	17	3
0049	2T	04	21	63	10	6300	5170	-1130	0.16	0.82	11	9	-2
0049	2T	04	23	24	2	2400	1770	-630	0.08	0.74	4	3	-1
0049	2T	04	24	32	7	3200	4140	940	0.22	1.29	5	7	2
0049	2T	04	25	50	3	5000	2380	-2620	0.06	0.48	8	4	-4
0049	2T	04	26	68	8	6800	24820	18020	0.12	3.65	12	43	31
0049	2T	05	12	275	79	27500	21890	-5610	0.29	0.80	48	38	-10
0049	2T	05	13	140	36	14000	11840	-2160	0.26	0.85	24	20	-4
0049	2T	05	14	155	28	15500	9950	-5550	0.18	0.64	27	17	-10
0049	2T	05	15	136	22	13600	14910	1310	0.16	1.10	24	26	2
0049	2T	05	16	114	16	11400	15010	3610	0.14	1.32	20	26	6
0049	2T	05	21	53	8	5300	4190	-1110	0.15	0.79	9	7	-2
0049	2T	05	23	30	3	3000	2430	-570	0.10	0.81	5	4	-1
0049	2T	05	24	51	4	5100	2640	-2460	0.08	0.52	9	4	-5
0049	2T	05	25	87	9	8700	6380	-2320	0.10	0.73	15	11	-4
0049	2T	05	26	69	3	6900	4210	-2690	0.04	0.61	12	7	-5
0049	2T	06	12	259	73	25900	19620	-6280	0.28	0.76	45	34	-11
0049	2T	06	13	199	49	19900	14840	-5060	0.25	0.75	35	26	-9
0049	2T	06	14	156	25	15600	9650	-5950	0.16	0.62	27	17	-10
0049	2T	06	15	131	14	13100	9900	-3200	0.11	0.76	23	17	-6
0049	2T	06	16	95	11	9500	11090	1590	0.12	1.17	16	19	3
0049	2T	06	21	55	8	5500	5180	-320	0.15	0.94	9	9	0
0049	2T	06	23	35	12	3500	7180	3680	0.34	2.05	6	12	6
0049	2T	06	24	55	4	5500	2480	-3020	0.07	0.45	9	4	-5
0049	2T	06	25	93	8	9300	4020	-5280	0.09	0.43	16	7	-9
0049	2T	06	26	89	4	8900	6810	-2090	0.04	0.77	15	12	-3
0049	2T	07	12	240	73	24000	20950	-3050	0.30	0.87	42	37	-5
0049	2T	07	13	214	62	21400	16740	-4660	0.29	0.78	37	29	-8
0049	2T	07	14	222	42	22200	14620	-7580	0.19	0.66	39	25	-14
0049	2T	07	15	131	15	13100	9290	-3810	0.11	0.71	23	16	-7
0049	2T	07	16	91	6	9100	5910	-3190	0.07	0.65	16	10	-6
0049	2T	07	21	38	10	3800	6590	2790	0.26	1.73	6	11	5
0049	2T	07	23	25	0	2500	0	-2500	0.00	0.00	4	0	-4
0049	2T	07	24	33	3	3300	3220	-80	0.09	0.98	5	5	0
0049	2T	07	25	73	4	7300	2420	-4880	0.05	0.33	12	4	-8
0049	2T	07	26	96	4	9600	3300	-6300	0.04	0.34	16	5	-11
0049	2T	08	12	310	94	31000	24050	-6950	0.30	0.78	54	42	-12
0049	2T	08	13	166	44	16600	13320	-3280	0.27	0.80	29	23	-6
0049	2T	08	14	235	44	23500	16370	-7130	0.19	0.70	41	28	-13
0049	2T	08	15	114	9	11400	6770	-4630	0.08	0.59	20	11	-9
0049	2T	08	16	76	6	7600	4860	-2740	0.08	0.64	13	8	-5
0049	2T	08	21	44	4	4400	2760	-1640	0.09	0.63	7	4	-3
0049	2T	08	23	23	1	2300	810	-1490	0.04	0.35	4	1	-3
0049	2T	08	24	30	4	3000	4810	1810	0.13	1.60	5	8	3
0049	2T	08	25	50	3	5000	2560	-2440	0.06	0.51	8	4	-4
0049	2T	08	26	66	2	6600	1030	-5570	0.03	0.16	11	1	-10
0049	2T	09	12	454	145	45400	33250	-12150	0.32	0.73	80	58	-22
0049	2T	09	13	226	48	22600	13820	-8780	0.21	0.61	40	24	-16
0049	2T	09	14	201	40	20100	15700	-4400	0.20	0.78	35	27	-8
0049	2T	09	15	143	23	14300	14600	300	0.16	1.02	25	25	0
0049	2T	09	16	66	8	6600	6440	-160	0.12	0.98	11	11	0
0049	2T	09	21	72	10	7200	4440	-2760	0.14	0.62	12	7	-5
0049	2T	09	23	28	3	2800	1500	-1300	0.11	0.54	4	2	-2
0049	2T	09	24	57	3	5700	1300	-4400	0.05	0.23	10	2	-8
0049	2T	09	25	97	11	9700	7050	-2650	0.11	0.73	17	12	-5
0049	2T	09	26	92	6	9200	3280	-5920	0.07	0.36	16	5	-11
0049	2T	10	12	406	139	40600	31140	-9460	0.34	0.77	71	55	-16
0049	2T	10	13	254	61	25400	16330	-9070	0.24	0.64	44	28	-16
0049	2T	10	14	183	31	18300	12790	-5510	0.17	0.70	32	22	-10
0049	2T	10	15	104	17	10400	12810	2410	0.16	1.23	18	22	4
0049	2T	10	16	53	3	5300	2310	-2990	0.06	0.44	9	4	-5
0049	2T	10	21	40	7	4000	2570	-1430	0.18	0.64	7	4	-3
0049	2T	10	23	25	2	2500	1280	-1220	0.08	0.51	4	2	-2
0049	2T	10	24	48	10	4800	7580	2780	0.21	1.58	8	13	5
0049	2T	10	25	96	13	9600	14270	4670	0.14	1.49	16	25	9
0049	2T	10	26	73	3	7300	5320	-1980	0.04	0.73	12	9	-3
0049	2T	11	12	410	145	41000	30910	-10090	0.35	0.75	72	54	-18
0049	2T	11	13	204	28	20400	12990	-7410	0.14	0.64	36	22	-14
0049	2T	11	14	70	8	7000	2530	-4470	0.11	0.36	12	4	-8
0049	2T	11	15	78	6	7800	4050	-3750	0.08	0.52	13	7	-6
0049	2T	11	16	86	4	8600	6230	-2370	0.05	0.72	15	11	-4
0049	2T	11	21	1	1	100	800	700	1.00	8.00	0	1	1
0049	2T	11	23	66	9	6600	19670	13070	0.14	2.98	11	34	23
0049	2T	11	24	29	2	2900	1660	-1240	0.07	0.57	5	2	-3
0049	2T	11	25	121	8	12100	7610	-4490	0.07	0.63	21	13	-8
0049	2T	11	26	81	2	8100	2380	-5720	0.02	0.29	14	4	-10
0049	2T	12	12	364	114	36400	31050	-5350	0.31	0.85	64	54	-10
0049	2T	12	13	221	62	22100	19220	-2880	0.28	0.87	39	34	-5
0049	2T	12	14	65	17	6500	7540	1040	0.26	1.16	11	13	2
0049	2T	12	15	68	5	6800	3810	-2990	0.07	0.56	12	6	-6
0049	2T	12	16	126	11	12600	6330	-6270	0.09	0.50	22	11	-11
0049	2T	12	21	25	3	2500	1120	-1380	0.12	0.45	4	1	-3
0049	2T	12	23	60	9	6000	4460	-1540	0.15	0.74	10	7	-3
0049	2T	12	24	70	3	7000	1100	-5900	0.04	0.16	12	1	-11
0049	2T	12	25	81	8	8100	6190	-1910	0.10	0.76	14	10	-4
0049	2T	12	26	51	3	5100	2470	-2630	0.06	0.48	9	4	-5
0049	2T	13	12	237	76	23700	19620	-4080	0.32	0.83	41	34	-7
0049	2T	13	13	199	49	19900	12450	-7450	0.25	0.63	35	22	-13
0049	2T	13	14	110	28	11000	8790	-2210	0.25	0.80	19	15	-4
0049	2T	13	15	93	11	9300	6670	-2630	0.12	0.72	16	11	-5
0049	2T	13	16	162	13	16200	9370	-6830	0.08	0.58	28	16	-12
0049	2T	13	21	16	2	1600	2110	510	0.13	1.32	2	3	1
0049	2T	13	23	27	4	2700	1830	-870	0.15	0.68	4	3	-1
0049	2T	13	24	78	3	7800	2500	-5300	0.04	0.32	13	4	-9
0049	2T	13	25	74	6	7400	5350	-2050	0.08	0.72	13	9	-4
0049	2T	13	26	68	5	6800	17280	10480	0.07	2.54	12	30	18
0049	2T	14	12	263	65	26300	15910	-10390	0.25	0.60	46	28	-18
0049	2T	14	13	184	45	18400	13070	-5330	0.24	0.71	32	23	-9
0049	2T	14	14	168	44	16800	15770	-1030	0.26	0.94	29	27	-2
0049	2T	14	15	91	9	9100	8430	-670	0.10	0.93	16	14	-2
0049	2T	14	16	73	5	7300	3190	-4110	0.07	0.44	12	5	-7
0049	2T	14	21	59	10	5900	5970	70	0.17	1.01	10	10	0
0049	2T	14	23	31	2	3100	1330	-1770	0.06	0.43	5	2	-3
0049	2T	14	24	37	2	3700	1630	-2070	0.05	0.44	6	2	-4
0049	2T	14	25	69	5	6900	3840	-3060	0.07	0.56	12	6	-6
0049	2T	14	26	73	4	7300	3600	-3700	0.05	0.49	12	6	-6
0049	2T	15	12	375	111	37500	27180	-10320	0.30	0.72	66	48	-18
0049	2T	15	13	171	38	17100	12200	-4900	0.22	0.71	30	21	-9
0049	2T	15	14	227	43	22700	15270	-7430	0.19	0.67	40	27	-13
0049	2T	15	15	121	17	12100	9940	-2160	0.14	0.82	21	17	-4
0049	2T	15	16	72	6	7200	5920	-1280	0.08	0.82	12	10	-2
0049	2T	15	21	31	4	3100	2500	-600	0.13	0.81	5	4	-1
0049	2T	15	23	36	4	3600	2120	-1480	0.11	0.59	6	3	-3
0049	2T	15	24	46	5	4600	3490	-1110	0.11	0.76	8	6	-2
0049	2T	15	25	64	3	6400	8390	1990	0.05	1.31	11	14	3
0049	2T	15	26	83	8	8300	7200	-1100	0.10	0.87	14	12	-2
0049	2T	16	12	348	128	34800	31360	-3440	0.37	0.90	61	55	-6
0049	2T	16	13	257	64	25700	18980	-6720	0.25	0.74	45	33	-12
0049	2T	16	14	200	46	20000	16370	-3630	0.23	0.82	35	28	-7
0049	2T	16	15	180	26	18000	17470	-530	0.14	0.97	31	30	-1
0049	2T	16	16	64	5	6400	4850	-1550	0.08	0.76	11	8	-3
0049	2T	16	21	50	6	5000	4840	-160	0.12	0.97	8	8	0
0049	2T	16	23	42	5	4200	3860	-340	0.12	0.92	7	6	-1
0049	2T	16	24	29	2	2900	1260	-1640	0.07	0.43	5	2	-3
0049	2T	16	25	59	8	5900	6350	450	0.14	1.08	10	11	1
0049	2T	16	26	99	4	9900	5430	-4470	0.04	0.55	17	9	-8
0049	2T	17	12	371	113	37100	26520	-10580	0.30	0.71	65	46	-19
0049	2T	17	13	247	82	24700	23550	-1150	0.33	0.95	43	41	-2
0049	2T	17	14	223	36	22300	13480	-8820	0.16	0.60	39	23	-16
0049	2T	17	15	126	13	12600	7850	-4750	0.10	0.62	22	13	-9
0049	2T	17	16	115	16	11500	19480	7980	0.14	1.69	20	34	14
0049	2T	17	21	37	5	3700	2880	-820	0.14	0.78	6	5	-1
0049	2T	17	23	26	1	2600	400	-2200	0.04	0.15	4	0	-4
0049	2T	17	24	71	6	7100	3160	-3940	0.08	0.45	12	5	-7
0049	2T	17	25	74	6	7400	4380	-3020	0.08	0.59	13	7	-6
0049	2T	17	26	70	3	7000	2080	-4920	0.04	0.30	12	3	-9
0049	2T	18	12	484	197	48400	39430	-8970	0.41	0.81	85	69	-16
0049	2T	18	13	162	43	16200	12630	-3570	0.27	0.78	28	22	-6
0049	2T	18	14	303	55	30300	20370	-9930	0.18	0.67	53	36	-17
0049	2T	18	15	246	35	24600	19020	-5580	0.14	0.77	43	33	-10
0049	2T	18	16	75	11	7500	6850	-650	0.15	0.91	13	12	-1
0049	2T	18	21	46	6	4600	3410	-1190	0.13	0.74	8	6	-2
0049	2T	18	23	13	0	1300	0	-1300	0.00	0.00	2	0	-2
0049	2T	18	24	50	6	5000	3230	-1770	0.12	0.65	8	5	-3
0049	2T	18	25	106	9	10600	4810	-5790	0.08	0.45	18	8	-10
0049	2T	18	26	105	8	10500	7920	-2580	0.08	0.75	18	14	-4
0049	2T	19	12	269	87	26900	22940	-3960	0.32	0.85	47	40	-7
0049	2T	19	13	211	56	21100	14680	-6420	0.27	0.70	37	25	-12
0049	2T	19	14	273	61	27300	20700	-6600	0.22	0.76	48	36	-12
0049	2T	19	15	113	15	11300	11600	300	0.13	1.03	20	20	0
0049	2T	19	16	49	5	4900	2860	-2040	0.10	0.58	8	5	-3
0049	2T	19	21	33	4	3300	2200	-1100	0.12	0.67	5	3	-2
0049	2T	19	23	18	1	1800	370	-1430	0.06	0.21	3	0	-3
0049	2T	19	24	33	4	3300	2430	-870	0.12	0.74	5	4	-1
0049	2T	19	25	48	0	4800	0	-4800	0.00	0.00	8	0	-8
0049	2T	19	26	65	5	6500	5100	-1400	0.08	0.78	11	9	-2
0049	2T	20	12	365	116	36500	28750	-7750	0.32	0.79	64	50	-14
0049	2T	20	13	186	78	18600	21450	2850	0.42	1.15	32	37	5
0049	2T	20	14	191	30	19100	11500	-7600	0.16	0.60	33	20	-13
0049	2T	20	15	146	28	14600	13750	-850	0.19	0.94	25	24	-1
0049	2T	20	16	64	8	6400	5570	-830	0.13	0.87	11	9	-2
0049	2T	20	21	38	7	3800	3000	-800	0.18	0.79	6	5	-1
0049	2T	20	23	20	1	2000	1130	-870	0.05	0.57	3	2	-1
0049	2T	20	24	55	6	5500	4680	-820	0.11	0.85	9	8	-1
0049	2T	20	25	38	1	3800	1310	-2490	0.03	0.34	6	2	-4
0049	2T	20	26	25	2	2500	3640	1140	0.08	1.46	4	6	2
0049	2T	21	12	368	119	36800	28970	-7830	0.32	0.79	65	51	-14
0049	2T	21	13	259	91	25900	23250	-2650	0.35	0.90	45	41	-4
0049	2T	21	14	231	56	23100	18120	-4980	0.24	0.78	40	32	-8
0049	2T	21	15	186	26	18600	17680	-920	0.14	0.95	32	31	-1
0049	2T	21	16	56	3	5600	2370	-3230	0.05	0.42	9	4	-5
0049	2T	21	21	48	6	4800	3890	-910	0.13	0.81	8	6	-2
0049	2T	21	23	10	1	1000	370	-630	0.10	0.37	1	0	-1
0049	2T	21	24	41	3	4100	3530	-570	0.07	0.86	7	6	-1
0049	2T	21	25	66	4	6600	3460	-3140	0.06	0.52	11	6	-5
0049	2T	21	26	67	4	6700	4660	-2040	0.06	0.70	11	8	-3
0049	2T	22	12	248	77	24800	22830	-1970	0.31	0.92	43	40	-3
0049	2T	22	13	151	37	15100	11110	-3990	0.25	0.74	26	19	-7
0049	2T	22	14	221	40	22100	14310	-7790	0.18	0.65	39	25	-14
0049	2T	22	15	105	7	10500	6740	-3760	0.07	0.64	18	11	-7
0049	2T	22	16	101	7	10100	7760	-2340	0.07	0.77	17	13	-4
0049	2T	22	21	7	1	700	860	160	0.14	1.23	1	1	0
0049	2T	22	23	78	8	7800	5360	-2440	0.10	0.69	13	9	-4
0049	2T	22	24	60	6	6000	5120	-880	0.10	0.85	10	9	-1
0049	2T	22	25	94	4	9400	2550	-6850	0.04	0.27	16	4	-12
0049	2T	22	26	77	3	7700	2490	-5210	0.04	0.32	13	4	-9
0049	2T	23	12	382	112	38200	26820	-11380	0.29	0.70	67	47	-20
0049	2T	23	13	216	53	21600	16850	-4750	0.25	0.78	38	29	-9
0049	2T	23	14	116	17	11600	6020	-5580	0.15	0.52	20	10	-10
0049	2T	23	15	117	14	11700	8630	-3070	0.12	0.74	20	15	-5
0049	2T	23	16	82	6	8200	5920	-2280	0.07	0.72	14	10	-4
0049	2T	23	21	24	4	2400	1850	-550	0.17	0.77	4	3	-1
0049	2T	23	23	32	2	3200	1780	-1420	0.06	0.56	5	3	-2
0049	2T	23	24	115	13	11500	8770	-2730	0.11	0.76	20	15	-5
0049	2T	23	25	78	8	7800	11540	3740	0.10	1.48	13	20	7
0049	2T	23	26	56	1	5600	950	-4650	0.02	0.17	9	1	-8
0049	2T	24	12	423	150	42300	33040	-9260	0.35	0.78	74	58	-16
0049	2T	24	13	324	104	32400	30030	-2370	0.32	0.93	57	53	-4
0049	2T	24	14	180	30	18000	10670	-7330	0.17	0.59	31	18	-13
0049	2T	24	15	145	20	14500	13970	-530	0.14	0.96	25	24	-1
0049	2T	24	16	132	14	13200	13220	20	0.11	1.00	23	23	0
0049	2T	24	21	34	4	3400	1630	-1770	0.12	0.48	6	2	-4
0049	2T	24	23	26	0	2600	0	-2600	0.00	0.00	4	0	-4
0049	2T	24	24	57	7	5700	7230	1530	0.12	1.27	10	12	2
0049	2T	24	25	57	5	5700	1980	-3720	0.09	0.35	10	3	-7
0049	2T	24	26	63	4	6300	4030	-2270	0.06	0.64	11	7	-4
0049	3F	01	123	45	15	4500	3140	-1360	0.33	0.70	7	5	-2
0049	3F	01	124	153	34	15300	10850	-4450	0.22	0.71	27	19	-8
0049	3F	01	125	98	11	9800	7490	-2310	0.11	0.76	17	13	-4
0049	3F	01	126	203	16	20300	14960	-5340	0.08	0.74	35	26	-9
0049	3F	01	134	33	4	3300	1770	-1530	0.12	0.54	5	3	-2
0049	3F	01	135	62	5	6200	2630	-3570	0.08	0.42	10	4	-6
0049	3F	01	136	108	8	10800	10190	-610	0.07	0.94	19	18	-1
0049	3F	01	145	34	3	3400	2710	-690	0.09	0.80	6	4	-2
0049	3F	01	146	12	1	1200	390	-810	0.08	0.33	2	0	-2
0049	3F	01	156	21	3	2100	6660	4560	0.14	3.17	3	11	8
0049	3F	01	234	18	4	1800	1560	-240	0.22	0.87	3	2	-1
0049	3F	01	235	11	0	1100	0	-1100	0.00	0.00	1	0	-1
0049	3F	01	236	19	1	1900	2040	140	0.05	1.07	3	3	0
0049	3F	01	245	19	4	1900	2840	940	0.21	1.49	3	5	2
0049	3F	01	246	11	0	1100	0	-1100	0.00	0.00	1	0	-1
0049	3F	01	256	15	0	1500	0	-1500	0.00	0.00	2	0	-2
0049	3F	02	123	58	13	5800	4430	-1370	0.22	0.76	10	7	-3
0049	3F	02	124	127	24	12700	8400	-4300	0.19	0.66	22	14	-8
0049	3F	02	125	69	11	6900	6420	-480	0.16	0.93	12	11	-1
0049	3F	02	126	92	6	9200	6160	-3040	0.07	0.67	16	10	-6
0049	3F	02	134	56	11	5600	4370	-1230	0.20	0.78	9	7	-2
0049	3F	02	135	30	6	3000	2610	-390	0.20	0.87	5	4	-1
0049	3F	02	136	101	12	10100	10270	170	0.12	1.02	17	18	1
0049	3F	02	145	25	3	2500	1690	-810	0.12	0.68	4	2	-2
0049	3F	02	146	58	5	5800	6530	730	0.09	1.13	10	11	1
0049	3F	02	156	25	1	2500	970	-1530	0.04	0.39	4	1	-3
0049	3F	02	234	8	3	800	1460	660	0.38	1.83	1	2	1
0049	3F	02	235	5	0	500	0	-500	0.00	0.00	0	0	0
0049	3F	02	236	9	0	900	0	-900	0.00	0.00	1	0	-1
0049	3F	02	245	17	1	1700	570	-1130	0.06	0.34	3	1	-2
0049	3F	02	246	19	1	1900	420	-1480	0.05	0.22	3	0	-3
0049	3F	02	256	25	2	2500	2260	-240	0.08	0.90	4	4	0
0049	3F	03	123	57	20	5700	4990	-710	0.35	0.88	10	8	-2
0049	3F	03	124	91	19	9100	6810	-2290	0.21	0.75	16	12	-4
0049	3F	03	125	56	11	5600	7480	1880	0.20	1.34	9	13	4
0049	3F	03	126	64	7	6400	3980	-2420	0.11	0.62	11	7	-4
0049	3F	03	134	32	5	3200	2020	-1180	0.16	0.63	5	3	-2
0049	3F	03	135	24	5	2400	2760	360	0.21	1.15	4	4	0
0049	3F	03	136	36	0	3600	0	-3600	0.00	0.00	6	0	-6
0049	3F	03	145	11	1	1100	690	-410	0.09	0.63	1	1	0
0049	3F	03	146	29	1	2900	2090	-810	0.03	0.72	5	3	-2
0049	3F	03	156	20	0	2000	0	-2000	0.00	0.00	3	0	-3
0049	3F	03	234	6	0	600	0	-600	0.00	0.00	1	0	-1
0049	3F	03	235	3	0	300	0	-300	0.00	0.00	0	0	0
0049	3F	03	236	6	1	600	940	340	0.17	1.57	1	1	0
0049	3F	03	245	4	0	400	0	-400	0.00	0.00	0	0	0
0049	3F	03	246	10	1	1000	620	-380	0.10	0.62	1	1	0
0049	3F	03	256	8	1	800	450	-350	0.13	0.56	1	0	-1
0049	3F	04	123	38	10	3800	3300	-500	0.26	0.87	6	5	-1
0049	3F	04	124	98	19	9800	7260	-2540	0.19	0.74	17	12	-5
0049	3F	04	125	60	8	6000	4360	-1640	0.13	0.73	10	7	-3
0049	3F	04	126	124	10	12400	7810	-4590	0.08	0.63	21	13	-8
0049	3F	04	134	47	10	4700	3630	-1070	0.21	0.77	8	6	-2
0049	3F	04	135	37	7	3700	3200	-500	0.19	0.86	6	5	-1
0049	3F	04	136	50	2	5000	1280	-3720	0.04	0.26	8	2	-6
0049	3F	04	145	26	3	2600	1490	-1110	0.12	0.57	4	2	-2
0049	3F	04	146	34	5	3400	5990	2590	0.15	1.76	6	10	4
0049	3F	04	156	25	0	2500	0	-2500	0.00	0.00	4	0	-4
0049	3F	04	234	1	0	100	0	-100	0.00	0.00	0	0	0
0049	3F	04	235	1	0	100	0	-100	0.00	0.00	0	0	0
0049	3F	04	236	2	0	200	0	-200	0.00	0.00	0	0	0
0049	3F	04	245	3	0	300	0	-300	0.00	0.00	0	0	0
0049	3F	04	246	3	0	300	0	-300	0.00	0.00	0	0	0
0049	3F	04	256	6	0	600	0	-600	0.00	0.00	1	0	-1
0049	3F	05	123	46	10	4600	2470	-2130	0.22	0.54	8	4	-4
0049	3F	05	124	99	23	9900	8830	-1070	0.23	0.89	17	15	-2
0049	3F	05	125	89	9	8900	4840	-4060	0.10	0.54	15	8	-7
0049	3F	05	126	164	11	16400	8500	-7900	0.07	0.52	29	15	-14
0049	3F	05	134	28	7	2800	3690	890	0.25	1.32	4	6	2
0049	3F	05	135	30	0	3000	0	-3000	0.00	0.00	5	0	-5
0049	3F	05	136	66	7	6600	10030	3430	0.11	1.52	11	17	6
0049	3F	05	145	39	4	3900	2010	-1890	0.10	0.52	6	3	-3
0049	3F	05	146	59	9	5900	7880	1980	0.15	1.34	10	13	3
0049	3F	05	156	70	6	7000	7850	850	0.09	1.12	12	13	1
0049	3F	05	234	4	0	400	0	-400	0.00	0.00	0	0	0
0049	3F	05	235	1	1	100	1220	1120	1.00	12.20	0	2	2
0049	3F	05	236	6	1	600	1950	1350	0.17	3.25	1	3	2
0049	3F	05	245	3	0	300	0	-300	0.00	0.00	0	0	0
0049	3F	05	246	6	0	600	0	-600	0.00	0.00	1	0	-1
0049	3F	05	256	8	1	800	2580	1780	0.13	3.23	1	4	3
0049	3F	06	123	60	20	6000	5580	-420	0.33	0.93	10	9	-1
0049	3F	06	124	103	20	10300	6080	-4220	0.19	0.59	18	10	-8
0049	3F	06	125	79	15	7900	7130	-770	0.19	0.90	13	12	-1
0049	3F	06	126	143	15	14300	10790	-3510	0.10	0.75	25	19	-6
0049	3F	06	134	48	8	4800	3380	-1420	0.17	0.70	8	5	-3
0049	3F	06	135	36	6	3600	1710	-1890	0.17	0.48	6	3	-3
0049	3F	06	136	72	10	7200	5570	-1630	0.14	0.77	12	9	-3
0049	3F	06	145	38	6	3800	3620	-180	0.16	0.95	6	6	0
0049	3F	06	146	53	4	5300	2900	-2400	0.08	0.55	9	5	-4
0049	3F	06	156	63	4	6300	5590	-710	0.06	0.89	11	9	-2
0049	3F	06	234	3	0	300	0	-300	0.00	0.00	0	0	0
0049	3F	06	235	6	1	600	440	-160	0.17	0.73	1	0	-1
0049	3F	06	236	2	0	200	0	-200	0.00	0.00	0	0	0
0049	3F	06	245	5	1	500	420	-80	0.20	0.84	0	0	0
0049	3F	06	246	1	0	100	0	-100	0.00	0.00	0	0	0
0049	3F	06	256	8	1	800	450	-350	0.13	0.56	1	0	-1
0049	3F	07	123	40	8	4000	2020	-1980	0.20	0.51	7	3	-4
0049	3F	07	124	93	19	9300	5900	-3400	0.20	0.63	16	10	-6
0049	3F	07	125	78	11	7800	5460	-2340	0.14	0.70	13	9	-4
0049	3F	07	126	132	12	13200	11180	-2020	0.09	0.85	23	19	-4
0049	3F	07	134	59	12	5900	4530	-1370	0.20	0.77	10	8	-2
0049	3F	07	135	48	4	4800	2300	-2500	0.08	0.48	8	4	-4
0049	3F	07	136	84	5	8400	3340	-5060	0.06	0.40	14	5	-9
0049	3F	07	145	65	6	6500	3510	-2990	0.09	0.54	11	6	-5
0049	3F	07	146	88	6	8800	4060	-4740	0.07	0.46	15	7	-8
0049	3F	07	156	50	2	5000	3560	-1440	0.04	0.71	8	6	-2
0049	3F	07	234	1	0	100	0	-100	0.00	0.00	0	0	0
0049	3F	07	235	4	2	400	460	60	0.50	1.15	0	0	0
0049	3F	07	236	3	0	300	0	-300	0.00	0.00	0	0	0
0049	3F	07	245	3	0	300	0	-300	0.00	0.00	0	0	0
0049	3F	07	246	5	0	500	0	-500	0.00	0.00	0	0	0
0049	3F	07	256	7	0	700	0	-700	0.00	0.00	1	0	-1
0049	3F	08	123	40	13	4000	3300	-700	0.33	0.83	7	5	-2
0049	3F	08	124	123	21	12300	6240	-6060	0.17	0.51	21	11	-10
0049	3F	08	125	81	13	8100	8480	380	0.16	1.05	14	15	1
0049	3F	08	126	141	12	14100	11020	-3080	0.09	0.78	24	19	-5
0049	3F	08	134	49	17	4900	6880	1980	0.35	1.40	8	12	4
0049	3F	08	135	34	4	3400	1270	-2130	0.12	0.37	6	2	-4
0049	3F	08	136	59	7	5900	5330	-570	0.12	0.90	10	9	-1
0049	3F	08	145	62	5	6200	2280	-3920	0.08	0.37	10	4	-6
0049	3F	08	146	92	10	9200	13180	3980	0.11	1.43	16	23	7
0049	3F	08	156	52	0	5200	0	-5200	0.00	0.00	9	0	-9
0049	3F	08	234	4	0	400	0	-400	0.00	0.00	0	0	0
0049	3F	08	235	2	0	200	0	-200	0.00	0.00	0	0	0
0049	3F	08	236	1	0	100	0	-100	0.00	0.00	0	0	0
0049	3F	08	245	5	0	500	0	-500	0.00	0.00	0	0	0
0049	3F	08	256	6	0	600	0	-600	0.00	0.00	1	0	-1
0049	3F	09	123	90	24	9000	5910	-3090	0.27	0.66	15	10	-5
0049	3F	09	124	178	34	17800	10880	-6920	0.19	0.61	31	19	-12
0049	3F	09	125	127	19	12700	10440	-2260	0.15	0.82	22	18	-4
0049	3F	09	126	150	14	15000	11290	-3710	0.09	0.75	26	19	-7
0049	3F	09	134	67	7	6700	2760	-3940	0.10	0.41	11	4	-7
0049	3F	09	135	44	3	4400	1720	-2680	0.07	0.39	7	3	-4
0049	3F	09	136	57	2	5700	1460	-4240	0.04	0.26	10	2	-8
0049	3F	09	145	55	2	5500	1720	-3780	0.04	0.31	9	3	-6
0049	3F	09	146	45	2	4500	2490	-2010	0.04	0.55	7	4	-3
0049	3F	09	156	52	1	5200	1220	-3980	0.02	0.23	9	2	-7
0049	3F	09	234	2	0	200	0	-200	0.00	0.00	0	0	0
0049	3F	09	235	5	0	500	0	-500	0.00	0.00	0	0	0
0049	3F	09	236	2	0	200	0	-200	0.00	0.00	0	0	0
0049	3F	09	245	7	1	700	580	-120	0.14	0.83	1	1	0
0049	3F	09	246	8	0	800	0	-800	0.00	0.00	1	0	-1
0049	3F	09	256	11	2	1100	970	-130	0.18	0.88	1	1	0
0049	3F	10	123	133	48	13300	11070	-2230	0.36	0.83	23	19	-4
0049	3F	10	124	163	45	16300	14990	-1310	0.28	0.92	28	26	-2
0049	3F	10	125	121	13	12100	7320	-4780	0.11	0.60	21	12	-9
0049	3F	10	126	99	11	9900	14400	4500	0.11	1.45	17	25	8
0049	3F	10	134	61	7	6100	2170	-3930	0.11	0.36	10	3	-7
0049	3F	10	135	61	6	6100	2830	-3270	0.10	0.46	10	5	-5
0049	3F	10	136	46	1	4600	2030	-2570	0.02	0.44	8	3	-5
0049	3F	10	145	50	2	5000	1210	-3790	0.04	0.24	8	2	-6
0049	3F	10	146	37	2	3700	3590	-110	0.05	0.97	6	6	0
0049	3F	10	156	30	0	3000	0	-3000	0.00	0.00	5	0	-5
0049	3F	10	234	1	0	100	0	-100	0.00	0.00	0	0	0
0049	3F	10	235	2	0	200	0	-200	0.00	0.00	0	0	0
0049	3F	10	236	5	0	500	0	-500	0.00	0.00	0	0	0
0049	3F	10	245	3	0	300	0	-300	0.00	0.00	0	0	0
0049	3F	10	246	2	1	200	610	410	0.50	3.05	0	1	1
0049	3F	10	256	5	0	500	0	-500	0.00	0.00	0	0	0
0049	3F	11	123	120	38	12000	10290	-1710	0.32	0.86	21	18	-3
0049	3F	11	124	123	35	12300	9700	-2600	0.28	0.79	21	17	-4
0049	3F	11	125	105	17	10500	8340	-2160	0.16	0.79	18	14	-4
0049	3F	11	126	95	21	9500	17820	8320	0.22	1.88	16	31	15
0049	3F	11	134	132	13	13200	6840	-6360	0.10	0.52	23	12	-11
0049	3F	11	135	33	3	3300	2360	-940	0.09	0.72	5	4	-1
0049	3F	11	136	45	4	4500	3220	-1280	0.09	0.72	7	5	-2
0049	3F	11	145	46	6	4600	6030	1430	0.13	1.31	8	10	2
0049	3F	11	146	36	2	3600	1490	-2110	0.06	0.41	6	2	-4
0049	3F	11	156	12	0	1200	0	-1200	0.00	0.00	2	0	-2
0049	3F	11	234	14	3	1400	4070	2670	0.21	2.91	2	7	5
0049	3F	11	235	16	1	1600	560	-1040	0.06	0.35	2	0	-2
0049	3F	11	236	27	0	2700	0	-2700	0.00	0.00	4	0	-4
0049	3F	11	245	23	2	2300	1260	-1040	0.09	0.55	4	2	-2
0049	3F	11	246	11	0	1100	0	-1100	0.00	0.00	1	0	-1
0049	3F	11	256	42	3	4200	3740	-460	0.07	0.89	7	6	-1
0049	3F	12	123	30	10	3000	2540	-460	0.33	0.85	5	4	-1
0049	3F	12	124	177	35	17700	12300	-5400	0.20	0.69	31	21	-10
0049	3F	12	125	43	7	4300	2830	-1470	0.16	0.66	7	5	-2
0049	3F	12	126	178	17	17800	16760	-1040	0.10	0.94	31	29	-2
0049	3F	12	134	109	19	10900	9560	-1340	0.17	0.88	19	16	-3
0049	3F	12	135	32	4	3200	1800	-1400	0.13	0.56	5	3	-2
0049	3F	12	136	77	10	7700	8840	1140	0.13	1.15	13	15	2
0049	3F	12	145	27	0	2700	0	-2700	0.00	0.00	4	0	-4
0049	3F	12	146	43	3	4300	1890	-2410	0.07	0.44	7	3	-4
0049	3F	12	156	28	2	2800	840	-1960	0.07	0.30	4	1	-3
0049	3F	12	234	20	4	2000	2240	240	0.20	1.12	3	3	0
0049	3F	12	235	16	2	1600	1150	-450	0.13	0.72	2	2	0
0049	3F	12	236	11	1	1100	310	-790	0.09	0.28	1	0	-1
0049	3F	12	245	29	1	2900	540	-2360	0.03	0.19	5	0	-5
0049	3F	12	246	12	0	1200	0	-1200	0.00	0.00	2	0	-2
0049	3F	12	256	14	1	1400	570	-830	0.07	0.41	2	1	-1
0049	3F	13	123	34	4	3400	1460	-1940	0.12	0.43	6	2	-4
0049	3F	13	124	99	30	9900	10430	530	0.30	1.05	17	18	1
0049	3F	13	125	46	5	4600	2540	-2060	0.11	0.55	8	4	-4
0049	3F	13	126	127	9	12700	7660	-5040	0.07	0.60	22	13	-9
0049	3F	13	134	53	11	5300	3640	-1660	0.21	0.69	9	6	-3
0049	3F	13	135	32	4	3200	2290	-910	0.13	0.72	5	4	-1
0049	3F	13	136	102	6	10200	6280	-3920	0.06	0.62	18	11	-7
0049	3F	13	145	22	1	2200	730	-1470	0.05	0.33	3	1	-2
0049	3F	13	146	43	3	4300	2520	-1780	0.07	0.59	7	4	-3
0049	3F	13	156	27	1	2700	430	-2270	0.04	0.16	4	0	-4
0049	3F	13	234	2	0	200	0	-200	0.00	0.00	0	0	0
0049	3F	13	235	3	0	300	0	-300	0.00	0.00	0	0	0
0049	3F	13	236	10	1	1000	920	-80	0.10	0.92	1	1	0
0049	3F	13	245	9	1	900	380	-520	0.11	0.42	1	0	-1
0049	3F	13	246	9	0	900	0	-900	0.00	0.00	1	0	-1
0049	3F	13	256	9	0	900	0	-900	0.00	0.00	1	0	-1
0049	3F	14	123	50	19	5000	6260	1260	0.38	1.25	8	11	3
0049	3F	14	124	139	32	13900	11260	-2640	0.23	0.81	24	19	-5
0049	3F	14	125	78	8	7800	3470	-4330	0.10	0.44	13	6	-7
0049	3F	14	126	128	14	12800	10910	-1890	0.11	0.85	22	19	-3
0049	3F	14	134	73	9	7300	3900	-3400	0.12	0.53	12	6	-6
0049	3F	14	135	32	5	3200	2700	-500	0.16	0.84	5	4	-1
0049	3F	14	136	53	5	5300	5680	380	0.09	1.07	9	10	1
0049	3F	14	145	31	1	3100	1440	-1660	0.03	0.46	5	2	-3
0049	3F	14	146	50	6	5000	6290	1290	0.12	1.26	8	11	3
0049	3F	14	156	18	2	1800	2520	720	0.11	1.40	3	4	1
0049	3F	14	234	8	0	800	0	-800	0.00	0.00	1	0	-1
0049	3F	14	235	10	0	1000	0	-1000	0.00	0.00	1	0	-1
0049	3F	14	236	4	0	400	0	-400	0.00	0.00	0	0	0
0049	3F	14	245	3	0	300	0	-300	0.00	0.00	0	0	0
0049	3F	14	246	6	0	600	0	-600	0.00	0.00	1	0	-1
0049	3F	14	256	3	0	300	0	-300	0.00	0.00	0	0	0
0049	3F	15	123	57	9	5700	2330	-3370	0.16	0.41	10	4	-6
0049	3F	15	124	177	47	17700	13360	-4340	0.27	0.75	31	23	-8
0049	3F	15	125	78	10	7800	6580	-1220	0.13	0.84	13	11	-2
0049	3F	15	126	160	14	16000	11320	-4680	0.09	0.71	28	20	-8
0049	3F	15	134	55	12	5500	3980	-1520	0.22	0.72	9	7	-2
0049	3F	15	135	40	3	4000	1370	-2630	0.08	0.34	7	2	-5
0049	3F	15	136	56	6	5600	2490	-3110	0.11	0.44	9	4	-5
0049	3F	15	145	39	4	3900	2440	-1460	0.10	0.63	6	4	-2
0049	3F	15	146	42	3	4200	2370	-1830	0.07	0.56	7	4	-3
0049	3F	15	156	42	2	4200	3730	-470	0.05	0.89	7	6	-1
0049	3F	15	234	5	0	500	0	-500	0.00	0.00	0	0	0
0049	3F	15	235	2	1	200	470	270	0.50	2.35	0	0	0
0049	3F	15	236	3	0	300	0	-300	0.00	0.00	0	0	0
0049	3F	15	245	6	0	600	0	-600	0.00	0.00	1	0	-1
0049	3F	15	246	3	0	300	0	-300	0.00	0.00	0	0	0
0049	3F	15	256	11	2	1100	2030	930	0.18	1.85	1	3	2
0049	3F	16	123	94	30	9400	5650	-3750	0.32	0.60	16	10	-6
0049	3F	16	124	136	27	13600	10680	-2920	0.20	0.79	24	18	-6
0049	3F	16	125	87	15	8700	9380	680	0.17	1.08	15	16	1
0049	3F	16	126	118	10	11800	10050	-1750	0.08	0.85	20	17	-3
0049	3F	16	134	74	10	7400	3590	-3810	0.14	0.49	13	6	-7
0049	3F	16	135	68	10	6800	4350	-2450	0.15	0.64	12	7	-5
0049	3F	16	136	58	6	5800	6120	320	0.10	1.06	10	10	0
0049	3F	16	145	55	7	5500	3370	-2130	0.13	0.61	9	5	-4
0049	3F	16	146	51	5	5100	3890	-1210	0.10	0.76	9	6	-3
0049	3F	16	156	78	2	7800	4430	-3370	0.03	0.57	13	7	-6
0049	3F	16	234	3	0	300	0	-300	0.00	0.00	0	0	0
0049	3F	16	235	5	1	500	240	-260	0.20	0.48	0	0	0
0049	3F	16	236	6	0	600	0	-600	0.00	0.00	1	0	-1
0049	3F	16	245	4	0	400	0	-400	0.00	0.00	0	0	0
0049	3F	16	246	5	0	500	0	-500	0.00	0.00	0	0	0
0049	3F	16	256	5	0	500	0	-500	0.00	0.00	0	0	0
0049	3F	17	123	90	35	9000	9090	90	0.39	1.01	15	16	1
0049	3F	17	124	134	26	13400	10230	-3170	0.19	0.76	23	18	-5
0049	3F	17	125	90	19	9000	8120	-880	0.21	0.90	15	14	-1
0049	3F	17	126	153	12	15300	11060	-4240	0.08	0.72	27	19	-8
0049	3F	17	134	79	16	7900	6640	-1260	0.20	0.84	13	11	-2
0049	3F	17	135	43	6	4300	3110	-1190	0.14	0.72	7	5	-2
0049	3F	17	136	45	5	4500	3220	-1280	0.11	0.72	7	5	-2
0049	3F	17	145	40	4	4000	2450	-1550	0.10	0.61	7	4	-3
0049	3F	17	146	73	4	7300	4570	-2730	0.05	0.63	12	8	-4
0049	3F	17	156	56	3	5600	6780	1180	0.05	1.21	9	12	3
0049	3F	17	235	7	0	700	0	-700	0.00	0.00	1	0	-1
0049	3F	17	236	2	0	200	0	-200	0.00	0.00	0	0	0
0049	3F	17	245	5	0	500	0	-500	0.00	0.00	0	0	0
0049	3F	17	246	3	0	300	0	-300	0.00	0.00	0	0	0
0049	3F	17	256	10	1	1000	880	-120	0.10	0.88	1	1	0
0049	3F	18	123	72	14	7200	3900	-3300	0.19	0.54	12	6	-6
0049	3F	18	124	159	40	15900	12970	-2930	0.25	0.82	28	22	-6
0049	3F	18	125	159	25	15900	10940	-4960	0.16	0.69	28	19	-9
0049	3F	18	126	166	21	16600	12790	-3810	0.13	0.77	29	22	-7
0049	3F	18	134	52	10	5200	4640	-560	0.19	0.89	9	8	-1
0049	3F	18	135	52	7	5200	3730	-1470	0.13	0.72	9	6	-3
0049	3F	18	136	43	2	4300	2740	-1560	0.05	0.64	7	4	-3
0049	3F	18	145	102	9	10200	5440	-4760	0.09	0.53	18	9	-9
0049	3F	18	146	63	6	6300	6900	600	0.10	1.10	11	12	1
0049	3F	18	156	61	3	6100	5470	-630	0.05	0.90	10	9	-1
0049	3F	18	234	2	0	200	0	-200	0.00	0.00	0	0	0
0049	3F	18	235	1	0	100	0	-100	0.00	0.00	0	0	0
0049	3F	18	245	8	1	800	190	-610	0.13	0.24	1	0	-1
0049	3F	18	246	1	0	100	0	-100	0.00	0.00	0	0	0
0049	3F	18	256	8	1	800	530	-270	0.13	0.66	1	0	-1
0049	3F	19	123	34	9	3400	2620	-780	0.26	0.77	6	4	-2
0049	3F	19	124	122	34	12200	10060	-2140	0.28	0.82	21	17	-4
0049	3F	19	125	73	10	7300	6680	-620	0.14	0.92	12	11	-1
0049	3F	19	126	119	9	11900	9350	-2550	0.08	0.79	21	16	-5
0049	3F	19	134	60	10	6000	4070	-1930	0.17	0.68	10	7	-3
0049	3F	19	135	43	3	4300	1250	-3050	0.07	0.29	7	2	-5
0049	3F	19	136	69	6	6900	2980	-3920	0.09	0.43	12	5	-7
0049	3F	19	145	68	5	6800	2270	-4530	0.07	0.33	12	4	-8
0049	3F	19	146	74	8	7400	6280	-1120	0.11	0.85	13	11	-2
0049	3F	19	156	41	0	4100	0	-4100	0.00	0.00	7	0	-7
0049	3F	19	234	2	0	200	0	-200	0.00	0.00	0	0	0
0049	3F	19	235	3	0	300	0	-300	0.00	0.00	0	0	0
0049	3F	19	236	3	0	300	0	-300	0.00	0.00	0	0	0
0049	3F	19	245	4	0	400	0	-400	0.00	0.00	0	0	0
0049	3F	19	246	1	0	100	0	-100	0.00	0.00	0	0	0
0049	3F	19	256	4	1	400	360	-40	0.25	0.90	0	0	0
0049	3F	20	123	97	26	9700	5510	-4190	0.27	0.57	17	9	-8
0049	3F	20	124	118	25	11800	7290	-4510	0.21	0.62	20	12	-8
0049	3F	20	125	80	8	8000	3430	-4570	0.10	0.43	14	6	-8
0049	3F	20	126	133	8	13300	7840	-5460	0.06	0.59	23	13	-10
0049	3F	20	134	43	4	4300	1400	-2900	0.09	0.33	7	2	-5
0049	3F	20	135	36	8	3600	4470	870	0.22	1.24	6	7	1
0049	3F	20	136	59	10	5900	10130	4230	0.17	1.72	10	17	7
0049	3F	20	145	50	5	5000	3500	-1500	0.10	0.70	8	6	-2
0049	3F	20	146	62	2	6200	1570	-4630	0.03	0.25	10	2	-8
0049	3F	20	156	67	3	6700	4360	-2340	0.04	0.65	11	7	-4
0049	3F	20	235	2	1	200	1890	1690	0.50	9.45	0	3	3
0049	3F	20	236	3	0	300	0	-300	0.00	0.00	0	0	0
0049	3F	20	245	6	1	600	590	-10	0.17	0.98	1	1	0
0049	3F	20	246	3	0	300	0	-300	0.00	0.00	0	0	0
0049	3F	20	256	5	0	500	0	-500	0.00	0.00	0	0	0
0049	3F	21	123	63	25	6300	6580	280	0.40	1.04	11	11	0
0049	3F	21	124	128	27	12800	10100	-2700	0.21	0.79	22	17	-5
0049	3F	21	125	106	17	10600	7480	-3120	0.16	0.71	18	13	-5
0049	3F	21	126	133	10	13300	7280	-6020	0.08	0.55	23	12	-11
0049	3F	21	134	67	10	6700	3160	-3540	0.15	0.47	11	5	-6
0049	3F	21	135	68	11	6800	4200	-2600	0.16	0.62	12	7	-5
0049	3F	21	136	67	8	6700	7710	1010	0.12	1.15	11	13	2
0049	3F	21	145	49	4	4900	3270	-1630	0.08	0.67	8	5	-3
0049	3F	21	146	54	6	5400	5020	-380	0.11	0.93	9	8	-1
0049	3F	21	156	70	2	7000	6010	-990	0.03	0.86	12	10	-2
0049	3F	21	235	1	0	100	0	-100	0.00	0.00	0	0	0
0049	3F	21	245	3	0	300	0	-300	0.00	0.00	0	0	0
0049	3F	21	246	7	0	700	0	-700	0.00	0.00	1	0	-1
0049	3F	21	256	11	1	1100	640	-460	0.09	0.58	1	1	0
0049	3F	22	123	56	14	5600	3030	-2570	0.25	0.54	9	5	-4
0049	3F	22	124	98	20	9800	5560	-4240	0.20	0.57	17	9	-8
0049	3F	22	125	60	6	6000	2650	-3350	0.10	0.44	10	4	-6
0049	3F	22	126	71	6	7100	2990	-4110	0.08	0.42	12	5	-7
0049	3F	22	134	28	9	2800	3170	370	0.32	1.13	4	5	1
0049	3F	22	135	90	12	9000	7000	-2000	0.13	0.78	15	12	-3
0049	3F	22	136	44	0	4400	0	-4400	0.00	0.00	7	0	-7
0049	3F	22	145	55	6	5500	3160	-2340	0.11	0.57	9	5	-4
0049	3F	22	146	68	4	6800	2040	-4760	0.06	0.30	12	3	-9
0049	3F	22	156	61	3	6100	7170	1070	0.05	1.18	10	12	2
0049	3F	22	234	5	0	500	0	-500	0.00	0.00	0	0	0
0049	3F	22	235	23	1	2300	510	-1790	0.04	0.22	4	0	-4
0049	3F	22	236	32	2	3200	2730	-470	0.06	0.85	5	4	-1
0049	3F	22	245	7	1	700	980	280	0.14	1.40	1	1	0
0049	3F	22	246	27	1	2700	700	-2000	0.04	0.26	4	1	-3
0049	3F	22	256	38	1	3800	1020	-2780	0.03	0.27	6	1	-5
0049	3F	23	123	66	20	6600	5700	-900	0.30	0.86	11	10	-1
0049	3F	23	124	207	35	20700	13190	-7510	0.17	0.64	36	23	-13
0049	3F	23	125	69	5	6900	2330	-4570	0.07	0.34	12	4	-8
0049	3F	23	126	161	18	16100	24120	8020	0.11	1.50	28	42	14
0049	3F	23	134	72	16	7200	8030	830	0.22	1.12	12	14	2
0049	3F	23	135	34	3	3400	2020	-1380	0.09	0.59	6	3	-3
0049	3F	23	136	79	3	7900	1950	-5950	0.04	0.25	13	3	-10
0049	3F	23	145	46	3	4600	1820	-2780	0.07	0.40	8	3	-5
0049	3F	23	146	45	4	4500	2100	-2400	0.09	0.47	7	3	-4
0049	3F	23	156	32	2	3200	1490	-1710	0.06	0.47	5	2	-3
0049	3F	23	234	5	1	500	290	-210	0.20	0.58	0	0	0
0049	3F	23	235	7	2	700	930	230	0.29	1.33	1	1	0
0049	3F	23	236	10	0	1000	0	-1000	0.00	0.00	1	0	-1
0049	3F	23	245	18	0	1800	0	-1800	0.00	0.00	3	0	-3
0049	3F	23	246	19	0	1900	0	-1900	0.00	0.00	3	0	-3
0049	3F	23	256	13	0	1300	0	-1300	0.00	0.00	2	0	-2
0049	3F	24	123	93	39	9300	10810	1510	0.42	1.16	16	19	3
0049	3F	24	124	154	31	15400	9160	-6240	0.20	0.59	27	16	-11
0049	3F	24	125	117	24	11700	11810	110	0.21	1.01	20	20	0
0049	3F	24	126	171	12	17100	7980	-9120	0.07	0.47	30	14	-16
0049	3F	24	134	87	26	8700	11130	2430	0.30	1.28	15	19	4
0049	3F	24	135	77	8	7700	4390	-3310	0.10	0.57	13	7	-6
0049	3F	24	136	102	9	10200	10530	330	0.09	1.03	18	18	0
0049	3F	24	145	43	5	4300	2860	-1440	0.12	0.67	7	5	-2
0049	3F	24	146	51	5	5100	4880	-220	0.10	0.96	9	8	-1
0049	3F	24	156	37	2	3700	1260	-2440	0.05	0.34	6	2	-4
0049	3F	24	234	2	0	200	0	-200	0.00	0.00	0	0	0
0049	3F	24	235	4	0	400	0	-400	0.00	0.00	0	0	0
0049	3F	24	236	4	0	400	0	-400	0.00	0.00	0	0	0
0049	3F	24	245	12	0	1200	0	-1200	0.00	0.00	2	0	-2
0049	3F	24	246	11	0	1100	0	-1100	0.00	0.00	1	0	-1
0049	3F	24	256	6	0	600	0	-600	0.00	0.00	1	0	-1
0049	3T	01	123	32	6	3200	2580	-620	0.19	0.81	5	4	-1
0049	3T	01	124	110	16	11000	12040	1040	0.15	1.09	19	21	2
0049	3T	01	125	68	4	6800	4520	-2280	0.06	0.66	12	8	-4
0049	3T	01	126	174	6	17400	9740	-7660	0.03	0.56	30	17	-13
0049	3T	01	132	2	0	200	0	-200	0.00	0.00	0	0	0
0049	3T	01	134	33	2	3300	2360	-940	0.06	0.72	5	4	-1
0049	3T	01	135	35	3	3500	3810	310	0.09	1.09	6	6	0
0049	3T	01	136	105	7	10500	18800	8300	0.07	1.79	18	33	15
0049	3T	01	142	8	2	800	1360	560	0.25	1.70	1	2	1
0049	3T	01	145	25	0	2500	0	-2500	0.00	0.00	4	0	-4
0049	3T	01	146	7	1	700	680	-20	0.14	0.97	1	1	0
0049	3T	01	152	18	0	1800	0	-1800	0.00	0.00	3	0	-3
0049	3T	01	153	27	0	2700	0	-2700	0.00	0.00	4	0	-4
0049	3T	01	154	9	0	900	0	-900	0.00	0.00	1	0	-1
0049	3T	01	156	14	1	1400	12480	11080	0.07	8.91	2	22	20
0049	3T	01	162	2	0	200	0	-200	0.00	0.00	0	0	0
0049	3T	01	163	3	0	300	0	-300	0.00	0.00	0	0	0
0049	3T	01	164	5	0	500	0	-500	0.00	0.00	0	0	0
0049	3T	01	165	7	0	700	0	-700	0.00	0.00	1	0	-1
0049	3T	01	214	1	0	100	0	-100	0.00	0.00	0	0	0
0049	3T	01	215	5	0	500	0	-500	0.00	0.00	0	0	0
0049	3T	01	216	4	0	400	0	-400	0.00	0.00	0	0	0
0049	3T	01	231	11	1	1100	980	-120	0.09	0.89	1	1	0
0049	3T	01	234	18	1	1800	2630	830	0.06	1.46	3	4	1
0049	3T	01	235	8	0	800	0	-800	0.00	0.00	1	0	-1
0049	3T	01	236	14	1	1400	4400	3000	0.07	3.14	2	7	5
0049	3T	01	241	34	1	3400	1250	-2150	0.03	0.37	6	2	-4
0049	3T	01	245	13	1	1300	2060	760	0.08	1.58	2	3	1
0049	3T	01	246	9	0	900	0	-900	0.00	0.00	1	0	-1
0049	3T	01	251	7	0	700	0	-700	0.00	0.00	1	0	-1
0049	3T	01	253	3	0	300	0	-300	0.00	0.00	0	0	0
0049	3T	01	254	6	0	600	0	-600	0.00	0.00	1	0	-1
0049	3T	01	256	10	0	1000	0	-1000	0.00	0.00	1	0	-1
0049	3T	01	261	23	0	2300	0	-2300	0.00	0.00	4	0	-4
0049	3T	01	263	5	0	500	0	-500	0.00	0.00	0	0	0
0049	3T	01	264	2	0	200	0	-200	0.00	0.00	0	0	0
0049	3T	01	265	5	0	500	0	-500	0.00	0.00	0	0	0
0049	3T	02	123	36	3	3600	2440	-1160	0.08	0.68	6	4	-2
0049	3T	02	124	83	8	8300	5630	-2670	0.10	0.68	14	9	-5
0049	3T	02	125	38	6	3800	7760	3960	0.16	2.04	6	13	7
0049	3T	02	126	75	3	7500	6910	-590	0.04	0.92	13	12	-1
0049	3T	02	132	9	1	900	800	-100	0.11	0.89	1	1	0
0049	3T	02	134	56	5	5600	4260	-1340	0.09	0.76	9	7	-2
0049	3T	02	135	23	4	2300	2990	690	0.17	1.30	4	5	1
0049	3T	02	136	92	5	9200	13350	4150	0.05	1.45	16	23	7
0049	3T	02	142	5	2	500	1360	860	0.40	2.72	0	2	2
0049	3T	02	145	18	2	1800	2200	400	0.11	1.22	3	3	0
0049	3T	02	146	40	1	4000	4130	130	0.03	1.03	7	7	0
0049	3T	02	152	8	0	800	0	-800	0.00	0.00	1	0	-1
0049	3T	02	153	7	0	700	0	-700	0.00	0.00	1	0	-1
0049	3T	02	154	7	0	700	0	-700	0.00	0.00	1	0	-1
0049	3T	02	156	24	1	2400	2100	-300	0.04	0.88	4	3	-1
0049	3T	02	162	1	0	100	0	-100	0.00	0.00	0	0	0
0049	3T	02	163	9	0	900	0	-900	0.00	0.00	1	0	-1
0049	3T	02	164	18	2	1800	4870	3070	0.11	2.71	3	8	5
0049	3T	02	165	1	0	100	0	-100	0.00	0.00	0	0	0
0049	3T	02	213	3	0	300	0	-300	0.00	0.00	0	0	0
0049	3T	02	214	4	0	400	0	-400	0.00	0.00	0	0	0
0049	3T	02	215	5	0	500	0	-500	0.00	0.00	0	0	0
0049	3T	02	216	4	0	400	0	-400	0.00	0.00	0	0	0
0049	3T	02	231	10	0	1000	0	-1000	0.00	0.00	1	0	-1
0049	3T	02	234	8	3	800	4620	3820	0.38	5.78	1	8	7
0049	3T	02	235	4	0	400	0	-400	0.00	0.00	0	0	0
0049	3T	02	236	6	0	600	0	-600	0.00	0.00	1	0	-1
0049	3T	02	241	35	1	3500	1270	-2230	0.03	0.36	6	2	-4
0049	3T	02	245	13	1	1300	1570	270	0.08	1.21	2	2	0
0049	3T	02	246	17	0	1700	0	-1700	0.00	0.00	3	0	-3
0049	3T	02	251	18	0	1800	0	-1800	0.00	0.00	3	0	-3
0049	3T	02	253	1	0	100	0	-100	0.00	0.00	0	0	0
0049	3T	02	254	4	0	400	0	-400	0.00	0.00	0	0	0
0049	3T	02	256	24	0	2400	0	-2400	0.00	0.00	4	0	-4
0049	3T	02	261	12	0	1200	0	-1200	0.00	0.00	2	0	-2
0049	3T	02	263	3	0	300	0	-300	0.00	0.00	0	0	0
0049	3T	02	264	2	0	200	0	-200	0.00	0.00	0	0	0
0049	3T	02	265	1	0	100	0	-100	0.00	0.00	0	0	0
0049	3T	03	123	25	6	2500	4130	1630	0.24	1.65	4	7	3
0049	3T	03	124	60	8	6000	7460	1460	0.13	1.24	10	13	3
0049	3T	03	125	24	3	2400	3460	1060	0.13	1.44	4	6	2
0049	3T	03	126	45	0	4500	0	-4500	0.00	0.00	7	0	-7
0049	3T	03	132	1	0	100	0	-100	0.00	0.00	0	0	0
0049	3T	03	134	32	3	3200	1800	-1400	0.09	0.56	5	3	-2
0049	3T	03	135	20	2	2000	1710	-290	0.10	0.86	3	3	0
0049	3T	03	136	35	0	3500	0	-3500	0.00	0.00	6	0	-6
0049	3T	03	142	3	0	300	0	-300	0.00	0.00	0	0	0
0049	3T	03	145	8	0	800	0	-800	0.00	0.00	1	0	-1
0049	3T	03	146	24	0	2400	0	-2400	0.00	0.00	4	0	-4
0049	3T	03	152	2	0	200	0	-200	0.00	0.00	0	0	0
0049	3T	03	153	4	0	400	0	-400	0.00	0.00	0	0	0
0049	3T	03	154	3	0	300	0	-300	0.00	0.00	0	0	0
0049	3T	03	156	18	0	1800	0	-1800	0.00	0.00	3	0	-3
0049	3T	03	163	1	0	100	0	-100	0.00	0.00	0	0	0
0049	3T	03	164	5	0	500	0	-500	0.00	0.00	0	0	0
0049	3T	03	165	2	0	200	0	-200	0.00	0.00	0	0	0
0049	3T	03	214	5	0	500	0	-500	0.00	0.00	0	0	0
0049	3T	03	215	1	0	100	0	-100	0.00	0.00	0	0	0
0049	3T	03	216	2	0	200	0	-200	0.00	0.00	0	0	0
0049	3T	03	231	31	1	3100	830	-2270	0.03	0.27	5	1	-4
0049	3T	03	234	6	0	600	0	-600	0.00	0.00	1	0	-1
0049	3T	03	235	1	0	100	0	-100	0.00	0.00	0	0	0
0049	3T	03	236	4	1	400	3260	2860	0.25	8.15	0	5	5
0049	3T	03	241	23	0	2300	0	-2300	0.00	0.00	4	0	-4
0049	3T	03	245	4	0	400	0	-400	0.00	0.00	0	0	0
0049	3T	03	246	10	0	1000	0	-1000	0.00	0.00	1	0	-1
0049	3T	03	251	29	0	2900	0	-2900	0.00	0.00	5	0	-5
0049	3T	03	253	2	0	200	0	-200	0.00	0.00	0	0	0
0049	3T	03	256	6	0	600	0	-600	0.00	0.00	1	0	-1
0049	3T	03	261	17	0	1700	0	-1700	0.00	0.00	3	0	-3
0049	3T	03	263	2	0	200	0	-200	0.00	0.00	0	0	0
0049	3T	03	265	2	0	200	0	-200	0.00	0.00	0	0	0
0049	3T	04	123	17	3	1700	2370	670	0.18	1.39	3	4	1
0049	3T	04	124	67	5	6700	4230	-2470	0.07	0.63	11	7	-4
0049	3T	04	125	28	1	2800	700	-2100	0.04	0.25	4	1	-3
0049	3T	04	126	86	4	8600	6330	-2270	0.05	0.74	15	11	-4
0049	3T	04	132	5	0	500	0	-500	0.00	0.00	0	0	0
0049	3T	04	134	44	6	4400	5050	650	0.14	1.15	7	8	1
0049	3T	04	135	31	2	3100	2940	-160	0.06	0.95	5	5	0
0049	3T	04	136	48	2	4800	2570	-2230	0.04	0.54	8	4	-4
0049	3T	04	142	1	0	100	0	-100	0.00	0.00	0	0	0
0049	3T	04	143	3	0	300	0	-300	0.00	0.00	0	0	0
0049	3T	04	145	22	2	2200	3060	860	0.09	1.39	3	5	2
0049	3T	04	146	28	1	2800	1890	-910	0.04	0.68	4	3	-1
0049	3T	04	152	2	0	200	0	-200	0.00	0.00	0	0	0
0049	3T	04	153	6	0	600	0	-600	0.00	0.00	1	0	-1
0049	3T	04	154	4	0	400	0	-400	0.00	0.00	0	0	0
0049	3T	04	156	25	0	2500	0	-2500	0.00	0.00	4	0	-4
0049	3T	04	163	2	0	200	0	-200	0.00	0.00	0	0	0
0049	3T	04	164	6	0	600	0	-600	0.00	0.00	1	0	-1
0049	3T	04	213	1	0	100	0	-100	0.00	0.00	0	0	0
0049	3T	04	214	10	0	1000	0	-1000	0.00	0.00	1	0	-1
0049	3T	04	215	12	0	1200	0	-1200	0.00	0.00	2	0	-2
0049	3T	04	216	16	0	1600	0	-1600	0.00	0.00	2	0	-2
0049	3T	04	231	15	0	1500	0	-1500	0.00	0.00	2	0	-2
0049	3T	04	234	1	0	100	0	-100	0.00	0.00	0	0	0
0049	3T	04	235	1	0	100	0	-100	0.00	0.00	0	0	0
0049	3T	04	236	2	0	200	0	-200	0.00	0.00	0	0	0
0049	3T	04	241	20	3	2000	9650	7650	0.15	4.83	3	17	14
0049	3T	04	245	1	0	100	0	-100	0.00	0.00	0	0	0
0049	3T	04	246	3	0	300	0	-300	0.00	0.00	0	0	0
0049	3T	04	251	18	2	1800	5070	3270	0.11	2.82	3	8	5
0049	3T	04	254	2	0	200	0	-200	0.00	0.00	0	0	0
0049	3T	04	256	6	0	600	0	-600	0.00	0.00	1	0	-1
0049	3T	04	261	22	2	2200	4110	1910	0.09	1.87	3	7	4
0049	3T	05	123	15	2	1500	1220	-280	0.13	0.81	2	2	0
0049	3T	05	124	55	6	5500	4440	-1060	0.11	0.81	9	7	-2
0049	3T	05	125	39	2	3900	2710	-1190	0.05	0.69	6	4	-2
0049	3T	05	126	125	7	12500	8950	-3550	0.06	0.72	22	15	-7
0049	3T	05	132	9	1	900	610	-290	0.11	0.68	1	1	0
0049	3T	05	134	24	3	2400	3590	1190	0.13	1.50	4	6	2
0049	3T	05	135	27	0	2700	0	-2700	0.00	0.00	4	0	-4
0049	3T	05	136	59	4	5900	11980	6080	0.07	2.03	10	21	11
0049	3T	05	142	9	1	900	610	-290	0.11	0.68	1	1	0
0049	3T	05	143	4	0	400	0	-400	0.00	0.00	0	0	0
0049	3T	05	145	35	0	3500	0	-3500	0.00	0.00	6	0	-6
0049	3T	05	146	55	3	5500	5670	170	0.05	1.03	9	10	1
0049	3T	05	152	13	1	1300	750	-550	0.08	0.58	2	1	-1
0049	3T	05	153	3	0	300	0	-300	0.00	0.00	0	0	0
0049	3T	05	154	4	0	400	0	-400	0.00	0.00	0	0	0
0049	3T	05	156	68	5	6800	15480	8680	0.07	2.28	12	27	15
0049	3T	05	162	3	0	300	0	-300	0.00	0.00	0	0	0
0049	3T	05	163	7	0	700	0	-700	0.00	0.00	1	0	-1
0049	3T	05	164	4	0	400	0	-400	0.00	0.00	0	0	0
0049	3T	05	165	2	0	200	0	-200	0.00	0.00	0	0	0
0049	3T	05	213	3	1	300	880	580	0.33	2.93	0	1	1
0049	3T	05	214	4	0	400	0	-400	0.00	0.00	0	0	0
0049	3T	05	215	10	0	1000	0	-1000	0.00	0.00	1	0	-1
0049	3T	05	216	19	0	1900	0	-1900	0.00	0.00	3	0	-3
0049	3T	05	231	19	0	1900	0	-1900	0.00	0.00	3	0	-3
0049	3T	05	234	3	0	300	0	-300	0.00	0.00	0	0	0
0049	3T	05	236	6	0	600	0	-600	0.00	0.00	1	0	-1
0049	3T	05	241	31	0	3100	0	-3100	0.00	0.00	5	0	-5
0049	3T	05	243	1	0	100	0	-100	0.00	0.00	0	0	0
0049	3T	05	245	2	0	200	0	-200	0.00	0.00	0	0	0
0049	3T	05	246	6	0	600	0	-600	0.00	0.00	1	0	-1
0049	3T	05	251	27	0	2700	0	-2700	0.00	0.00	4	0	-4
0049	3T	05	253	1	0	100	0	-100	0.00	0.00	0	0	0
0049	3T	05	254	1	0	100	0	-100	0.00	0.00	0	0	0
0049	3T	05	256	8	0	800	0	-800	0.00	0.00	1	0	-1
0049	3T	05	261	17	0	1700	0	-1700	0.00	0.00	3	0	-3
0049	3T	06	123	29	9	2900	5770	2870	0.31	1.99	5	10	5
0049	3T	06	124	54	3	5400	1940	-3460	0.06	0.36	9	3	-6
0049	3T	06	125	37	4	3700	2880	-820	0.11	0.78	6	5	-1
0049	3T	06	126	109	5	10900	7500	-3400	0.05	0.69	19	13	-6
0049	3T	06	132	6	1	600	760	160	0.17	1.27	1	1	0
0049	3T	06	134	43	5	4300	3700	-600	0.12	0.86	7	6	-1
0049	3T	06	135	29	1	2900	470	-2430	0.03	0.16	5	0	-5
0049	3T	06	136	64	5	6400	6850	450	0.08	1.07	11	12	1
0049	3T	06	142	7	2	700	1350	650	0.29	1.93	1	2	1
0049	3T	06	143	5	0	500	0	-500	0.00	0.00	0	0	0
0049	3T	06	145	30	1	3000	740	-2260	0.03	0.25	5	1	-4
0049	3T	06	146	52	2	5200	2500	-2700	0.04	0.48	9	4	-5
0049	3T	06	152	6	0	600	0	-600	0.00	0.00	1	0	-1
0049	3T	06	153	7	0	700	0	-700	0.00	0.00	1	0	-1
0049	3T	06	154	8	1	800	3170	2370	0.13	3.96	1	5	4
0049	3T	06	156	62	0	6200	0	-6200	0.00	0.00	10	0	-10
0049	3T	06	162	5	0	500	0	-500	0.00	0.00	0	0	0
0049	3T	06	163	8	0	800	0	-800	0.00	0.00	1	0	-1
0049	3T	06	164	1	0	100	0	-100	0.00	0.00	0	0	0
0049	3T	06	165	1	0	100	0	-100	0.00	0.00	0	0	0
0049	3T	06	213	2	0	200	0	-200	0.00	0.00	0	0	0
0049	3T	06	214	10	0	1000	0	-1000	0.00	0.00	1	0	-1
0049	3T	06	215	7	1	700	1730	1030	0.14	2.47	1	3	2
0049	3T	06	216	15	1	1500	4110	2610	0.07	2.74	2	7	5
0049	3T	06	231	23	1	2300	1650	-650	0.04	0.72	4	2	-2
0049	3T	06	234	3	0	300	0	-300	0.00	0.00	0	0	0
0049	3T	06	235	6	1	600	1410	810	0.17	2.35	1	2	1
0049	3T	06	236	2	0	200	0	-200	0.00	0.00	0	0	0
0049	3T	06	241	32	0	3200	0	-3200	0.00	0.00	5	0	-5
0049	3T	06	245	5	0	500	0	-500	0.00	0.00	0	0	0
0049	3T	06	246	1	0	100	0	-100	0.00	0.00	0	0	0
0049	3T	06	251	29	1	2900	1180	-1720	0.03	0.41	5	2	-3
0049	3T	06	256	8	0	800	0	-800	0.00	0.00	1	0	-1
0049	3T	06	261	14	0	1400	0	-1400	0.00	0.00	2	0	-2
0049	3T	07	123	19	2	1900	900	-1000	0.11	0.47	3	1	-2
0049	3T	07	124	64	9	6400	5360	-1040	0.14	0.84	11	9	-2
0049	3T	07	125	47	4	4700	4320	-380	0.09	0.92	8	7	-1
0049	3T	07	126	101	5	10100	10840	740	0.05	1.07	17	19	2
0049	3T	07	132	2	0	200	0	-200	0.00	0.00	0	0	0
0049	3T	07	134	59	6	5900	3770	-2130	0.10	0.64	10	6	-4
0049	3T	07	135	44	1	4400	1930	-2470	0.02	0.44	7	3	-4
0049	3T	07	136	81	4	8100	4900	-3200	0.05	0.60	14	8	-6
0049	3T	07	142	3	1	300	1170	870	0.33	3.90	0	2	2
0049	3T	07	145	58	4	5800	3990	-1810	0.07	0.69	10	7	-3
0049	3T	07	146	86	5	8600	5140	-3460	0.06	0.60	15	9	-6
0049	3T	07	152	1	0	100	0	-100	0.00	0.00	0	0	0
0049	3T	07	153	4	0	400	0	-400	0.00	0.00	0	0	0
0049	3T	07	154	7	0	700	0	-700	0.00	0.00	1	0	-1
0049	3T	07	156	49	1	4900	3160	-1740	0.02	0.64	8	5	-3
0049	3T	07	163	3	0	300	0	-300	0.00	0.00	0	0	0
0049	3T	07	164	2	0	200	0	-200	0.00	0.00	0	0	0
0049	3T	07	165	1	0	100	0	-100	0.00	0.00	0	0	0
0049	3T	07	213	3	0	300	0	-300	0.00	0.00	0	0	0
0049	3T	07	214	7	0	700	0	-700	0.00	0.00	1	0	-1
0049	3T	07	215	4	0	400	0	-400	0.00	0.00	0	0	0
0049	3T	07	216	15	0	1500	0	-1500	0.00	0.00	2	0	-2
0049	3T	07	231	16	0	1600	0	-1600	0.00	0.00	2	0	-2
0049	3T	07	234	1	0	100	0	-100	0.00	0.00	0	0	0
0049	3T	07	235	4	0	400	0	-400	0.00	0.00	0	0	0
0049	3T	07	236	3	0	300	0	-300	0.00	0.00	0	0	0
0049	3T	07	241	19	0	1900	0	-1900	0.00	0.00	3	0	-3
0049	3T	07	245	3	0	300	0	-300	0.00	0.00	0	0	0
0049	3T	07	246	4	0	400	0	-400	0.00	0.00	0	0	0
0049	3T	07	251	26	0	2600	0	-2600	0.00	0.00	4	0	-4
0049	3T	07	256	7	0	700	0	-700	0.00	0.00	1	0	-1
0049	3T	07	261	16	0	1600	0	-1600	0.00	0.00	2	0	-2
0049	3T	07	264	1	0	100	0	-100	0.00	0.00	0	0	0
0049	3T	08	123	22	4	2200	1760	-440	0.18	0.80	3	3	0
0049	3T	08	124	102	10	10200	5340	-4860	0.10	0.52	18	9	-9
0049	3T	08	125	53	4	5300	3200	-2100	0.08	0.60	9	5	-4
0049	3T	08	126	121	3	12100	7510	-4590	0.02	0.62	21	13	-8
0049	3T	08	132	2	1	200	740	540	0.50	3.70	0	1	1
0049	3T	08	134	49	11	4900	9500	4600	0.22	1.94	8	16	8
0049	3T	08	135	34	2	3400	1380	-2020	0.06	0.41	6	2	-4
0049	3T	08	136	58	2	5800	2190	-3610	0.03	0.38	10	3	-7
0049	3T	08	145	54	0	5400	0	-5400	0.00	0.00	9	0	-9
0049	3T	08	146	92	4	9200	10140	940	0.04	1.10	16	17	1
0049	3T	08	152	2	0	200	0	-200	0.00	0.00	0	0	0
0049	3T	08	154	8	0	800	0	-800	0.00	0.00	1	0	-1
0049	3T	08	156	52	0	5200	0	-5200	0.00	0.00	9	0	-9
0049	3T	08	163	1	0	100	0	-100	0.00	0.00	0	0	0
0049	3T	08	213	4	0	400	0	-400	0.00	0.00	0	0	0
0049	3T	08	214	4	0	400	0	-400	0.00	0.00	0	0	0
0049	3T	08	215	7	0	700	0	-700	0.00	0.00	1	0	-1
0049	3T	08	216	8	1	800	2910	2110	0.13	3.64	1	5	4
0049	3T	08	231	12	0	1200	0	-1200	0.00	0.00	2	0	-2
0049	3T	08	234	4	0	400	0	-400	0.00	0.00	0	0	0
0049	3T	08	235	2	0	200	0	-200	0.00	0.00	0	0	0
0049	3T	08	236	1	0	100	0	-100	0.00	0.00	0	0	0
0049	3T	08	241	17	0	1700	0	-1700	0.00	0.00	3	0	-3
0049	3T	08	245	5	0	500	0	-500	0.00	0.00	0	0	0
0049	3T	08	251	19	0	1900	0	-1900	0.00	0.00	3	0	-3
0049	3T	08	256	6	0	600	0	-600	0.00	0.00	1	0	-1
0049	3T	08	261	12	0	1200	0	-1200	0.00	0.00	2	0	-2
0049	3T	09	123	68	11	6800	4560	-2240	0.16	0.67	12	8	-4
0049	3T	09	124	134	16	13400	9360	-4040	0.12	0.70	23	16	-7
0049	3T	09	125	78	4	7800	2610	-5190	0.05	0.33	13	4	-9
0049	3T	09	126	113	4	11300	6180	-5120	0.04	0.55	20	10	-10
0049	3T	09	132	7	0	700	0	-700	0.00	0.00	1	0	-1
0049	3T	09	134	64	2	6400	1710	-4690	0.03	0.27	11	3	-8
0049	3T	09	135	40	1	4000	1390	-2610	0.03	0.35	7	2	-5
0049	3T	09	136	52	2	5200	2410	-2790	0.04	0.46	9	4	-5
0049	3T	09	142	14	2	1400	1070	-330	0.14	0.76	2	1	-1
0049	3T	09	143	3	0	300	0	-300	0.00	0.00	0	0	0
0049	3T	09	145	36	0	3600	0	-3600	0.00	0.00	6	0	-6
0049	3T	09	146	44	1	4400	2710	-1690	0.02	0.62	7	4	-3
0049	3T	09	152	4	0	400	0	-400	0.00	0.00	0	0	0
0049	3T	09	153	4	0	400	0	-400	0.00	0.00	0	0	0
0049	3T	09	154	19	0	1900	0	-1900	0.00	0.00	3	0	-3
0049	3T	09	156	51	1	5100	2510	-2590	0.02	0.49	9	4	-5
0049	3T	09	162	4	0	400	0	-400	0.00	0.00	0	0	0
0049	3T	09	163	5	0	500	0	-500	0.00	0.00	0	0	0
0049	3T	09	164	1	1	100	4390	4290	1.00	43.90	0	7	7
0049	3T	09	165	1	0	100	0	-100	0.00	0.00	0	0	0
0049	3T	09	213	3	0	300	0	-300	0.00	0.00	0	0	0
0049	3T	09	214	5	1	500	1150	650	0.20	2.30	0	2	2
0049	3T	09	215	15	1	1500	1530	30	0.07	1.02	2	2	0
0049	3T	09	216	16	0	1600	0	-1600	0.00	0.00	2	0	-2
0049	3T	09	231	12	1	1200	2070	870	0.08	1.73	2	3	1
0049	3T	09	234	2	0	200	0	-200	0.00	0.00	0	0	0
0049	3T	09	235	5	0	500	0	-500	0.00	0.00	0	0	0
0049	3T	09	236	2	0	200	0	-200	0.00	0.00	0	0	0
0049	3T	09	241	25	1	2500	1730	-770	0.04	0.69	4	3	-1
0049	3T	09	245	6	0	600	0	-600	0.00	0.00	1	0	-1
0049	3T	09	246	7	0	700	0	-700	0.00	0.00	1	0	-1
0049	3T	09	251	30	0	3000	0	-3000	0.00	0.00	5	0	-5
0049	3T	09	254	1	0	100	0	-100	0.00	0.00	0	0	0
0049	3T	09	256	11	1	1100	1190	90	0.09	1.08	1	2	1
0049	3T	09	261	17	1	1700	1900	200	0.06	1.12	3	3	0
0049	3T	09	264	1	0	100	0	-100	0.00	0.00	0	0	0
0049	3T	10	123	100	18	10000	8700	-1300	0.18	0.87	17	15	-2
0049	3T	10	124	113	17	11300	12360	1060	0.15	1.09	20	21	1
0049	3T	10	125	67	6	6700	5390	-1310	0.09	0.80	11	9	-2
0049	3T	10	126	85	7	8500	13550	5050	0.08	1.59	15	23	8
0049	3T	10	132	11	1	1100	840	-260	0.09	0.76	1	1	0
0049	3T	10	134	55	3	5500	2320	-3180	0.05	0.42	9	4	-5
0049	3T	10	135	51	5	5100	4260	-840	0.10	0.84	9	7	-2
0049	3T	10	136	42	1	4200	2170	-2030	0.02	0.52	7	3	-4
0049	3T	10	142	14	1	1400	1150	-250	0.07	0.82	2	2	0
0049	3T	10	143	6	0	600	0	-600	0.00	0.00	1	0	-1
0049	3T	10	145	40	0	4000	0	-4000	0.00	0.00	7	0	-7
0049	3T	10	146	37	1	3700	3560	-140	0.03	0.96	6	6	0
0049	3T	10	152	3	0	300	0	-300	0.00	0.00	0	0	0
0049	3T	10	153	10	0	1000	0	-1000	0.00	0.00	1	0	-1
0049	3T	10	154	10	1	1000	4580	3580	0.10	4.58	1	8	7
0049	3T	10	156	30	0	3000	0	-3000	0.00	0.00	5	0	-5
0049	3T	10	162	1	0	100	0	-100	0.00	0.00	0	0	0
0049	3T	10	163	4	0	400	0	-400	0.00	0.00	0	0	0
0049	3T	10	213	9	0	900	0	-900	0.00	0.00	1	0	-1
0049	3T	10	214	3	0	300	0	-300	0.00	0.00	0	0	0
0049	3T	10	215	8	0	800	0	-800	0.00	0.00	1	0	-1
0049	3T	10	216	5	1	500	1850	1350	0.20	3.70	0	3	3
0049	3T	10	231	13	0	1300	0	-1300	0.00	0.00	2	0	-2
0049	3T	10	234	1	0	100	0	-100	0.00	0.00	0	0	0
0049	3T	10	235	1	0	100	0	-100	0.00	0.00	0	0	0
0049	3T	10	236	4	0	400	0	-400	0.00	0.00	0	0	0
0049	3T	10	241	33	3	3300	4900	1600	0.09	1.48	5	8	3
0049	3T	10	245	3	0	300	0	-300	0.00	0.00	0	0	0
0049	3T	10	246	2	1	200	1700	1500	0.50	8.50	0	3	3
0049	3T	10	251	43	1	4300	5380	1080	0.02	1.25	7	9	2
0049	3T	10	253	1	0	100	0	-100	0.00	0.00	0	0	0
0049	3T	10	256	5	0	500	0	-500	0.00	0.00	0	0	0
0049	3T	10	261	8	0	800	0	-800	0.00	0.00	1	0	-1
0049	3T	10	263	1	0	100	0	-100	0.00	0.00	0	0	0
0049	3T	11	123	109	19	10900	9140	-1760	0.17	0.84	19	16	-3
0049	3T	11	124	119	15	11900	7900	-4000	0.13	0.66	21	13	-8
0049	3T	11	125	93	7	9300	4070	-5230	0.08	0.44	16	7	-9
0049	3T	11	126	78	15	7800	21880	14080	0.19	2.81	13	38	25
0049	3T	11	134	122	4	12200	6680	-5520	0.03	0.55	21	11	-10
0049	3T	11	135	22	0	2200	0	-2200	0.00	0.00	3	0	-3
0049	3T	11	136	45	3	4500	6050	1550	0.07	1.34	7	10	3
0049	3T	11	142	1	0	100	0	-100	0.00	0.00	0	0	0
0049	3T	11	143	10	0	1000	0	-1000	0.00	0.00	1	0	-1
0049	3T	11	145	15	1	1500	700	-800	0.07	0.47	2	1	-1
0049	3T	11	146	6	2	600	3550	2950	0.33	5.92	1	6	5
0049	3T	11	153	11	1	1100	1170	70	0.09	1.06	1	2	1
0049	3T	11	154	31	1	3100	6400	3300	0.03	2.06	5	11	6
0049	3T	11	156	11	0	1100	0	-1100	0.00	0.00	1	0	-1
0049	3T	11	162	2	0	200	0	-200	0.00	0.00	0	0	0
0049	3T	11	164	30	0	3000	0	-3000	0.00	0.00	5	0	-5
0049	3T	11	165	1	0	100	0	-100	0.00	0.00	0	0	0
0049	3T	11	216	1	1	100	4710	4610	1.00	47.10	0	8	8
0049	3T	11	231	11	0	1100	0	-1100	0.00	0.00	1	0	-1
0049	3T	11	234	12	2	1200	18030	16830	0.17	15.03	2	31	29
0049	3T	11	235	16	1	1600	1370	-230	0.06	0.86	2	2	0
0049	3T	11	236	27	0	2700	0	-2700	0.00	0.00	4	0	-4
0049	3T	11	241	3	0	300	0	-300	0.00	0.00	0	0	0
0049	3T	11	243	2	1	200	3010	2810	0.50	15.05	0	5	5
0049	3T	11	245	6	0	600	0	-600	0.00	0.00	1	0	-1
0049	3T	11	246	6	0	600	0	-600	0.00	0.00	1	0	-1
0049	3T	11	251	12	0	1200	0	-1200	0.00	0.00	2	0	-2
0049	3T	11	254	17	1	1700	3840	2140	0.06	2.26	3	6	3
0049	3T	11	256	42	2	4200	4760	560	0.05	1.13	7	8	1
0049	3T	11	261	14	0	1400	0	-1400	0.00	0.00	2	0	-2
0049	3T	11	264	5	0	500	0	-500	0.00	0.00	0	0	0
0049	3T	12	123	17	2	1700	930	-770	0.12	0.55	3	1	-2
0049	3T	12	124	151	14	15100	8470	-6630	0.09	0.56	26	14	-12
0049	3T	12	125	27	4	2700	5160	2460	0.15	1.91	4	9	5
0049	3T	12	126	164	9	16400	17100	700	0.05	1.04	29	30	1
0049	3T	12	132	1	0	100	0	-100	0.00	0.00	0	0	0
0049	3T	12	134	107	11	10700	11360	660	0.10	1.06	18	20	2
0049	3T	12	135	29	2	2900	1530	-1370	0.07	0.53	5	2	-3
0049	3T	12	136	76	6	7600	12160	4560	0.08	1.60	13	21	8
0049	3T	12	142	1	0	100	0	-100	0.00	0.00	0	0	0
0049	3T	12	143	2	0	200	0	-200	0.00	0.00	0	0	0
0049	3T	12	145	11	0	1100	0	-1100	0.00	0.00	1	0	-1
0049	3T	12	146	29	0	2900	0	-2900	0.00	0.00	5	0	-5
0049	3T	12	152	2	0	200	0	-200	0.00	0.00	0	0	0
0049	3T	12	153	3	1	300	3270	2970	0.33	10.90	0	5	5
0049	3T	12	154	16	0	1600	0	-1600	0.00	0.00	2	0	-2
0049	3T	12	156	17	0	1700	0	-1700	0.00	0.00	3	0	-3
0049	3T	12	162	3	0	300	0	-300	0.00	0.00	0	0	0
0049	3T	12	163	1	0	100	0	-100	0.00	0.00	0	0	0
0049	3T	12	164	14	0	1400	0	-1400	0.00	0.00	2	0	-2
0049	3T	12	165	11	1	1100	1240	140	0.09	1.13	1	2	1
0049	3T	12	213	3	0	300	0	-300	0.00	0.00	0	0	0
0049	3T	12	214	7	0	700	0	-700	0.00	0.00	1	0	-1
0049	3T	12	215	3	0	300	0	-300	0.00	0.00	0	0	0
0049	3T	12	216	5	0	500	0	-500	0.00	0.00	0	0	0
0049	3T	12	231	9	0	900	0	-900	0.00	0.00	1	0	-1
0049	3T	12	234	20	1	2000	990	-1010	0.05	0.50	3	1	-2
0049	3T	12	235	13	1	1300	3150	1850	0.08	2.42	2	5	3
0049	3T	12	236	9	1	900	780	-120	0.11	0.87	1	1	0
0049	3T	12	241	18	0	1800	0	-1800	0.00	0.00	3	0	-3
0049	3T	12	245	7	0	700	0	-700	0.00	0.00	1	0	-1
0049	3T	12	246	5	0	500	0	-500	0.00	0.00	0	0	0
0049	3T	12	251	11	1	1100	2190	1090	0.09	1.99	1	3	2
0049	3T	12	253	3	0	300	0	-300	0.00	0.00	0	0	0
0049	3T	12	254	22	1	2200	1540	-660	0.05	0.70	3	2	-1
0049	3T	12	256	11	1	1100	2060	960	0.09	1.87	1	3	2
0049	3T	12	261	6	0	600	0	-600	0.00	0.00	1	0	-1
0049	3T	12	263	2	0	200	0	-200	0.00	0.00	0	0	0
0049	3T	12	264	7	0	700	0	-700	0.00	0.00	1	0	-1
0049	3T	12	265	3	0	300	0	-300	0.00	0.00	0	0	0
0049	3T	13	123	19	0	1900	0	-1900	0.00	0.00	3	0	-3
0049	3T	13	124	58	12	5800	8570	2770	0.21	1.48	10	15	5
0049	3T	13	125	33	3	3300	3440	140	0.09	1.04	5	6	1
0049	3T	13	126	115	4	11500	5870	-5630	0.03	0.51	20	10	-10
0049	3T	13	132	6	0	600	0	-600	0.00	0.00	1	0	-1
0049	3T	13	134	53	8	5300	5140	-160	0.15	0.97	9	9	0
0049	3T	13	135	30	2	3000	2310	-690	0.07	0.77	5	4	-1
0049	3T	13	136	100	4	10000	6090	-3910	0.04	0.61	17	10	-7
0049	3T	13	142	5	0	500	0	-500	0.00	0.00	0	0	0
0049	3T	13	145	15	0	1500	0	-1500	0.00	0.00	2	0	-2
0049	3T	13	146	38	0	3800	0	-3800	0.00	0.00	6	0	-6
0049	3T	13	152	1	0	100	0	-100	0.00	0.00	0	0	0
0049	3T	13	153	2	0	200	0	-200	0.00	0.00	0	0	0
0049	3T	13	154	7	0	700	0	-700	0.00	0.00	1	0	-1
0049	3T	13	156	26	1	2600	700	-1900	0.04	0.27	4	1	-3
0049	3T	13	162	1	0	100	0	-100	0.00	0.00	0	0	0
0049	3T	13	163	2	0	200	0	-200	0.00	0.00	0	0	0
0049	3T	13	164	5	0	500	0	-500	0.00	0.00	0	0	0
0049	3T	13	165	1	0	100	0	-100	0.00	0.00	0	0	0
0049	3T	13	213	2	0	200	0	-200	0.00	0.00	0	0	0
0049	3T	13	214	6	0	600	0	-600	0.00	0.00	1	0	-1
0049	3T	13	215	2	0	200	0	-200	0.00	0.00	0	0	0
0049	3T	13	216	3	0	300	0	-300	0.00	0.00	0	0	0
0049	3T	13	231	7	0	700	0	-700	0.00	0.00	1	0	-1
0049	3T	13	234	2	0	200	0	-200	0.00	0.00	0	0	0
0049	3T	13	235	2	0	200	0	-200	0.00	0.00	0	0	0
0049	3T	13	236	10	0	1000	0	-1000	0.00	0.00	1	0	-1
0049	3T	13	241	30	0	3000	0	-3000	0.00	0.00	5	0	-5
0049	3T	13	245	9	0	900	0	-900	0.00	0.00	1	0	-1
0049	3T	13	246	7	0	700	0	-700	0.00	0.00	1	0	-1
0049	3T	13	251	10	0	1000	0	-1000	0.00	0.00	1	0	-1
0049	3T	13	253	1	0	100	0	-100	0.00	0.00	0	0	0
0049	3T	13	256	8	0	800	0	-800	0.00	0.00	1	0	-1
0049	3T	13	261	8	0	800	0	-800	0.00	0.00	1	0	-1
0049	3T	13	264	2	0	200	0	-200	0.00	0.00	0	0	0
0049	3T	13	265	1	0	100	0	-100	0.00	0.00	0	0	0
0049	3T	14	123	25	6	2500	3230	730	0.24	1.29	4	5	1
0049	3T	14	124	89	5	8900	4520	-4380	0.06	0.51	15	8	-7
0049	3T	14	125	33	3	3300	2550	-750	0.09	0.77	5	4	-1
0049	3T	14	126	90	4	9000	5830	-3170	0.04	0.65	15	10	-5
0049	3T	14	132	9	1	900	1030	130	0.11	1.14	1	1	0
0049	3T	14	134	70	5	7000	4430	-2570	0.07	0.63	12	7	-5
0049	3T	14	135	28	1	2800	980	-1820	0.04	0.35	4	1	-3
0049	3T	14	136	52	4	5200	8090	2890	0.08	1.56	9	14	5
0049	3T	14	142	15	2	1500	1390	-110	0.13	0.93	2	2	0
0049	3T	14	143	3	0	300	0	-300	0.00	0.00	0	0	0
0049	3T	14	145	21	0	2100	0	-2100	0.00	0.00	3	0	-3
0049	3T	14	146	44	4	4400	7630	3230	0.09	1.73	7	13	6
0049	3T	14	152	7	1	700	2420	1720	0.14	3.46	1	4	3
0049	3T	14	153	4	0	400	0	-400	0.00	0.00	0	0	0
0049	3T	14	154	10	1	1000	6720	5720	0.10	6.72	1	11	10
0049	3T	14	156	18	1	1800	2390	590	0.06	1.33	3	4	1
0049	3T	14	162	7	0	700	0	-700	0.00	0.00	1	0	-1
0049	3T	14	163	1	0	100	0	-100	0.00	0.00	0	0	0
0049	3T	14	164	6	0	600	0	-600	0.00	0.00	1	0	-1
0049	3T	14	213	6	2	600	3180	2580	0.33	5.30	1	5	4
0049	3T	14	214	15	2	1500	2380	880	0.13	1.59	2	4	2
0049	3T	14	215	9	0	900	0	-900	0.00	0.00	1	0	-1
0049	3T	14	216	13	1	1300	2690	1390	0.08	2.07	2	4	2
0049	3T	14	231	10	0	1000	0	-1000	0.00	0.00	1	0	-1
0049	3T	14	234	8	0	800	0	-800	0.00	0.00	1	0	-1
0049	3T	14	235	9	0	900	0	-900	0.00	0.00	1	0	-1
0049	3T	14	236	3	0	300	0	-300	0.00	0.00	0	0	0
0049	3T	14	241	20	0	2000	0	-2000	0.00	0.00	3	0	-3
0049	3T	14	245	2	0	200	0	-200	0.00	0.00	0	0	0
0049	3T	14	246	6	0	600	0	-600	0.00	0.00	1	0	-1
0049	3T	14	251	29	1	2900	1500	-1400	0.03	0.52	5	2	-3
0049	3T	14	253	1	0	100	0	-100	0.00	0.00	0	0	0
0049	3T	14	254	1	0	100	0	-100	0.00	0.00	0	0	0
0049	3T	14	256	3	0	300	0	-300	0.00	0.00	0	0	0
0049	3T	14	261	18	0	1800	0	-1800	0.00	0.00	3	0	-3
0049	3T	14	263	1	0	100	0	-100	0.00	0.00	0	0	0
0049	3T	15	123	25	2	2500	750	-1750	0.08	0.30	4	1	-3
0049	3T	15	124	143	19	14300	9200	-5100	0.13	0.64	25	16	-9
0049	3T	15	125	48	1	4800	1470	-3330	0.02	0.31	8	2	-6
0049	3T	15	126	135	9	13500	11600	-1900	0.07	0.86	23	20	-3
0049	3T	15	132	10	2	1000	1330	330	0.20	1.33	1	2	1
0049	3T	15	134	55	3	5500	2500	-3000	0.05	0.45	9	4	-5
0049	3T	15	135	36	1	3600	1070	-2530	0.03	0.30	6	1	-5
0049	3T	15	136	54	1	5400	510	-4890	0.02	0.09	9	0	-9
0049	3T	15	142	8	4	800	3180	2380	0.50	3.98	1	5	4
0049	3T	15	145	35	3	3500	4200	700	0.09	1.20	6	7	1
0049	3T	15	146	42	3	4200	4130	-70	0.07	0.98	7	7	0
0049	3T	15	152	3	0	300	0	-300	0.00	0.00	0	0	0
0049	3T	15	153	4	0	400	0	-400	0.00	0.00	0	0	0
0049	3T	15	154	4	0	400	0	-400	0.00	0.00	0	0	0
0049	3T	15	156	39	1	3900	4240	340	0.03	1.09	6	7	1
0049	3T	15	162	1	0	100	0	-100	0.00	0.00	0	0	0
0049	3T	15	163	2	0	200	0	-200	0.00	0.00	0	0	0
0049	3T	15	165	3	0	300	0	-300	0.00	0.00	0	0	0
0049	3T	15	213	1	0	100	0	-100	0.00	0.00	0	0	0
0049	3T	15	214	4	0	400	0	-400	0.00	0.00	0	0	0
0049	3T	15	215	7	1	700	890	190	0.14	1.27	1	1	0
0049	3T	15	216	10	0	1000	0	-1000	0.00	0.00	1	0	-1
0049	3T	15	231	21	1	2100	1170	-930	0.05	0.56	3	2	-1
0049	3T	15	234	5	0	500	0	-500	0.00	0.00	0	0	0
0049	3T	15	235	2	0	200	0	-200	0.00	0.00	0	0	0
0049	3T	15	236	3	0	300	0	-300	0.00	0.00	0	0	0
0049	3T	15	241	22	1	2200	1520	-680	0.05	0.69	3	2	-1
0049	3T	15	245	3	0	300	0	-300	0.00	0.00	0	0	0
0049	3T	15	246	3	0	300	0	-300	0.00	0.00	0	0	0
0049	3T	15	251	20	0	2000	0	-2000	0.00	0.00	3	0	-3
0049	3T	15	254	3	0	300	0	-300	0.00	0.00	0	0	0
0049	3T	15	256	11	1	1100	1050	-50	0.09	0.95	1	1	0
0049	3T	15	261	14	0	1400	0	-1400	0.00	0.00	2	0	-2
0049	3T	16	123	73	14	7300	5000	-2300	0.19	0.68	12	8	-4
0049	3T	16	124	102	11	10200	6910	-3290	0.11	0.68	18	12	-6
0049	3T	16	125	53	5	5300	3990	-1310	0.09	0.75	9	7	-2
0049	3T	16	126	88	4	8800	8250	-550	0.05	0.94	15	14	-1
0049	3T	16	132	7	1	700	550	-150	0.14	0.79	1	0	-1
0049	3T	16	134	65	4	6500	2810	-3690	0.06	0.43	11	4	-7
0049	3T	16	135	58	4	5800	2940	-2860	0.07	0.51	10	5	-5
0049	3T	16	136	51	3	5100	6250	1150	0.06	1.23	9	11	2
0049	3T	16	142	13	0	1300	0	-1300	0.00	0.00	2	0	-2
0049	3T	16	143	9	2	900	1640	740	0.22	1.82	1	2	1
0049	3T	16	145	46	2	4600	1640	-2960	0.04	0.36	8	2	-6
0049	3T	16	146	49	3	4900	4320	-580	0.06	0.88	8	7	-1
0049	3T	16	152	7	0	700	0	-700	0.00	0.00	1	0	-1
0049	3T	16	153	10	1	1000	1100	100	0.10	1.10	1	1	0
0049	3T	16	154	9	0	900	0	-900	0.00	0.00	1	0	-1
0049	3T	16	156	78	2	7800	7040	-760	0.03	0.90	13	12	-1
0049	3T	16	162	7	0	700	0	-700	0.00	0.00	1	0	-1
0049	3T	16	163	7	0	700	0	-700	0.00	0.00	1	0	-1
0049	3T	16	164	2	0	200	0	-200	0.00	0.00	0	0	0
0049	3T	16	213	6	1	600	730	130	0.17	1.22	1	1	0
0049	3T	16	214	8	1	800	3120	2320	0.13	3.90	1	5	4
0049	3T	16	215	6	0	600	0	-600	0.00	0.00	1	0	-1
0049	3T	16	216	9	0	900	0	-900	0.00	0.00	1	0	-1
0049	3T	16	231	8	0	800	0	-800	0.00	0.00	1	0	-1
0049	3T	16	234	3	0	300	0	-300	0.00	0.00	0	0	0
0049	3T	16	235	5	0	500	0	-500	0.00	0.00	0	0	0
0049	3T	16	236	6	0	600	0	-600	0.00	0.00	1	0	-1
0049	3T	16	241	13	1	1300	2760	1460	0.08	2.12	2	4	2
0049	3T	16	245	4	0	400	0	-400	0.00	0.00	0	0	0
0049	3T	16	246	5	0	500	0	-500	0.00	0.00	0	0	0
0049	3T	16	251	21	0	2100	0	-2100	0.00	0.00	3	0	-3
0049	3T	16	256	4	0	400	0	-400	0.00	0.00	0	0	0
0049	3T	16	261	14	0	1400	0	-1400	0.00	0.00	2	0	-2
0049	3T	16	265	1	0	100	0	-100	0.00	0.00	0	0	0
0049	3T	17	123	61	10	6100	4410	-1690	0.16	0.72	10	7	-3
0049	3T	17	124	75	7	7500	3810	-3690	0.09	0.51	13	6	-7
0049	3T	17	125	60	7	6000	4490	-1510	0.12	0.75	10	7	-3
0049	3T	17	126	134	6	13400	6950	-6450	0.04	0.52	23	12	-11
0049	3T	17	132	13	3	1300	1720	420	0.23	1.32	2	3	1
0049	3T	17	134	74	10	7400	8960	1560	0.14	1.21	13	15	2
0049	3T	17	135	34	1	3400	800	-2600	0.03	0.24	6	1	-5
0049	3T	17	136	42	4	4200	4070	-130	0.10	0.97	7	7	0
0049	3T	17	142	7	1	700	2190	1490	0.14	3.13	1	3	2
0049	3T	17	143	5	1	500	450	-50	0.20	0.90	0	0	0
0049	3T	17	145	34	1	3400	2300	-1100	0.03	0.68	6	4	-2
0049	3T	17	146	71	2	7100	3330	-3770	0.03	0.47	12	5	-7
0049	3T	17	152	4	0	400	0	-400	0.00	0.00	0	0	0
0049	3T	17	153	9	1	900	1040	140	0.11	1.16	1	1	0
0049	3T	17	154	6	0	600	0	-600	0.00	0.00	1	0	-1
0049	3T	17	156	56	1	5600	4870	-730	0.02	0.87	9	8	-1
0049	3T	17	162	2	0	200	0	-200	0.00	0.00	0	0	0
0049	3T	17	163	3	0	300	0	-300	0.00	0.00	0	0	0
0049	3T	17	164	2	0	200	0	-200	0.00	0.00	0	0	0
0049	3T	17	213	3	0	300	0	-300	0.00	0.00	0	0	0
0049	3T	17	214	6	0	600	0	-600	0.00	0.00	1	0	-1
0049	3T	17	215	1	0	100	0	-100	0.00	0.00	0	0	0
0049	3T	17	216	6	0	600	0	-600	0.00	0.00	1	0	-1
0049	3T	17	231	13	0	1300	0	-1300	0.00	0.00	2	0	-2
0049	3T	17	235	6	0	600	0	-600	0.00	0.00	1	0	-1
0049	3T	17	236	2	0	200	0	-200	0.00	0.00	0	0	0
0049	3T	17	241	46	2	4600	2140	-2460	0.04	0.47	8	3	-5
0049	3T	17	245	4	0	400	0	-400	0.00	0.00	0	0	0
0049	3T	17	246	2	0	200	0	-200	0.00	0.00	0	0	0
0049	3T	17	251	25	1	2500	2810	310	0.04	1.12	4	4	0
0049	3T	17	253	1	0	100	0	-100	0.00	0.00	0	0	0
0049	3T	17	254	1	0	100	0	-100	0.00	0.00	0	0	0
0049	3T	17	256	10	0	1000	0	-1000	0.00	0.00	1	0	-1
0049	3T	17	261	11	0	1100	0	-1100	0.00	0.00	1	0	-1
0049	3T	17	264	1	0	100	0	-100	0.00	0.00	0	0	0
0049	3T	18	123	61	7	6100	3960	-2140	0.11	0.65	10	7	-3
0049	3T	18	124	112	12	11200	5750	-5450	0.11	0.51	19	10	-9
0049	3T	18	125	104	13	10400	8740	-1660	0.13	0.84	18	15	-3
0049	3T	18	126	136	11	13600	10930	-2670	0.08	0.80	24	19	-5
0049	3T	18	132	2	0	200	0	-200	0.00	0.00	0	0	0
0049	3T	18	134	48	4	4800	3710	-1090	0.08	0.77	8	6	-2
0049	3T	18	135	44	2	4400	1570	-2830	0.05	0.36	7	2	-5
0049	3T	18	136	42	0	4200	0	-4200	0.00	0.00	7	0	-7
0049	3T	18	142	14	1	1400	1080	-320	0.07	0.77	2	1	-1
0049	3T	18	143	4	2	400	2970	2570	0.50	7.43	0	5	5
0049	3T	18	145	90	1	9000	580	-8420	0.01	0.06	15	1	-14
0049	3T	18	146	62	5	6200	9090	2890	0.08	1.47	10	16	6
0049	3T	18	152	12	0	1200	0	-1200	0.00	0.00	2	0	-2
0049	3T	18	153	8	0	800	0	-800	0.00	0.00	1	0	-1
0049	3T	18	154	12	1	1200	1910	710	0.08	1.59	2	3	1
0049	3T	18	156	61	3	6100	10460	4360	0.05	1.71	10	18	8
0049	3T	18	162	1	0	100	0	-100	0.00	0.00	0	0	0
0049	3T	18	163	1	0	100	0	-100	0.00	0.00	0	0	0
0049	3T	18	164	1	0	100	0	-100	0.00	0.00	0	0	0
0049	3T	18	214	3	0	300	0	-300	0.00	0.00	0	0	0
0049	3T	18	215	14	0	1400	0	-1400	0.00	0.00	2	0	-2
0049	3T	18	216	9	0	900	0	-900	0.00	0.00	1	0	-1
0049	3T	18	231	9	0	900	0	-900	0.00	0.00	1	0	-1
0049	3T	18	234	2	0	200	0	-200	0.00	0.00	0	0	0
0049	3T	18	235	1	0	100	0	-100	0.00	0.00	0	0	0
0049	3T	18	241	30	1	3000	1730	-1270	0.03	0.58	5	3	-2
0049	3T	18	245	7	0	700	0	-700	0.00	0.00	1	0	-1
0049	3T	18	246	1	0	100	0	-100	0.00	0.00	0	0	0
0049	3T	18	251	29	1	2900	2700	-200	0.03	0.93	5	4	-1
0049	3T	18	254	1	0	100	0	-100	0.00	0.00	0	0	0
0049	3T	18	256	8	1	800	1210	410	0.13	1.51	1	2	1
0049	3T	18	261	20	0	2000	0	-2000	0.00	0.00	3	0	-3
0049	3T	19	123	23	4	2300	1780	-520	0.17	0.77	4	3	-1
0049	3T	19	124	88	11	8800	7010	-1790	0.13	0.80	15	12	-3
0049	3T	19	125	47	2	4700	2100	-2600	0.04	0.45	8	3	-5
0049	3T	19	126	91	4	9100	8990	-110	0.04	0.99	16	15	-1
0049	3T	19	132	2	0	200	0	-200	0.00	0.00	0	0	0
0049	3T	19	134	57	6	5700	4940	-760	0.11	0.87	10	8	-2
0049	3T	19	135	42	1	4200	720	-3480	0.02	0.17	7	1	-6
0049	3T	19	136	65	2	6500	2160	-4340	0.03	0.33	11	3	-8
0049	3T	19	142	10	0	1000	0	-1000	0.00	0.00	1	0	-1
0049	3T	19	143	3	0	300	0	-300	0.00	0.00	0	0	0
0049	3T	19	145	58	3	5800	1930	-3870	0.05	0.33	10	3	-7
0049	3T	19	146	73	4	7300	5680	-1620	0.05	0.78	12	10	-2
0049	3T	19	152	1	0	100	0	-100	0.00	0.00	0	0	0
0049	3T	19	153	1	0	100	0	-100	0.00	0.00	0	0	0
0049	3T	19	154	10	1	1000	880	-120	0.10	0.88	1	1	0
0049	3T	19	156	41	0	4100	0	-4100	0.00	0.00	7	0	-7
0049	3T	19	162	2	0	200	0	-200	0.00	0.00	0	0	0
0049	3T	19	163	4	1	400	2120	1720	0.25	5.30	0	3	3
0049	3T	19	164	1	0	100	0	-100	0.00	0.00	0	0	0
0049	3T	19	213	1	0	100	0	-100	0.00	0.00	0	0	0
0049	3T	19	214	4	0	400	0	-400	0.00	0.00	0	0	0
0049	3T	19	215	6	0	600	0	-600	0.00	0.00	1	0	-1
0049	3T	19	216	10	1	1000	1950	950	0.10	1.95	1	3	2
0049	3T	19	231	8	1	800	660	-140	0.13	0.83	1	1	0
0049	3T	19	234	2	0	200	0	-200	0.00	0.00	0	0	0
0049	3T	19	235	3	0	300	0	-300	0.00	0.00	0	0	0
0049	3T	19	236	3	0	300	0	-300	0.00	0.00	0	0	0
0049	3T	19	241	20	0	2000	0	-2000	0.00	0.00	3	0	-3
0049	3T	19	245	4	0	400	0	-400	0.00	0.00	0	0	0
0049	3T	19	246	1	0	100	0	-100	0.00	0.00	0	0	0
0049	3T	19	251	19	0	1900	0	-1900	0.00	0.00	3	0	-3
0049	3T	19	256	4	0	400	0	-400	0.00	0.00	0	0	0
0049	3T	19	261	16	0	1600	0	-1600	0.00	0.00	2	0	-2
0049	3T	20	123	81	15	8100	7780	-320	0.19	0.96	14	13	-1
0049	3T	20	124	93	6	9300	3730	-5570	0.06	0.40	16	6	-10
0049	3T	20	125	58	1	5800	780	-5020	0.02	0.13	10	1	-9
0049	3T	20	126	113	4	11300	8060	-3240	0.04	0.71	20	14	-6
0049	3T	20	132	6	2	600	770	170	0.33	1.28	1	1	0
0049	3T	20	134	38	4	3800	3010	-790	0.11	0.79	6	5	-1
0049	3T	20	135	34	5	3400	3730	330	0.15	1.10	6	6	0
0049	3T	20	136	59	6	5900	7290	1390	0.10	1.24	10	12	2
0049	3T	20	142	3	0	300	0	-300	0.00	0.00	0	0	0
0049	3T	20	143	5	0	500	0	-500	0.00	0.00	0	0	0
0049	3T	20	145	41	1	4100	2030	-2070	0.02	0.50	7	3	-4
0049	3T	20	146	62	1	6200	1330	-4870	0.02	0.21	10	2	-8
0049	3T	20	152	3	0	300	0	-300	0.00	0.00	0	0	0
0049	3T	20	153	2	0	200	0	-200	0.00	0.00	0	0	0
0049	3T	20	154	9	1	900	2070	1170	0.11	2.30	1	3	2
0049	3T	20	156	66	2	6600	3400	-3200	0.03	0.52	11	6	-5
0049	3T	20	165	1	0	100	0	-100	0.00	0.00	0	0	0
0049	3T	20	213	3	0	300	0	-300	0.00	0.00	0	0	0
0049	3T	20	214	7	3	700	2130	1430	0.43	3.04	1	3	2
0049	3T	20	215	6	1	600	1550	950	0.17	2.58	1	2	1
0049	3T	20	216	9	0	900	0	-900	0.00	0.00	1	0	-1
0049	3T	20	231	7	0	700	0	-700	0.00	0.00	1	0	-1
0049	3T	20	235	2	0	200	0	-200	0.00	0.00	0	0	0
0049	3T	20	236	3	0	300	0	-300	0.00	0.00	0	0	0
0049	3T	20	241	15	0	1500	0	-1500	0.00	0.00	2	0	-2
0049	3T	20	245	6	1	600	3280	2680	0.17	5.47	1	5	4
0049	3T	20	246	3	0	300	0	-300	0.00	0.00	0	0	0
0049	3T	20	251	13	0	1300	0	-1300	0.00	0.00	2	0	-2
0049	3T	20	256	5	0	500	0	-500	0.00	0.00	0	0	0
0049	3T	20	261	11	0	1100	0	-1100	0.00	0.00	1	0	-1
0049	3T	21	123	45	7	4500	4320	-180	0.16	0.96	7	7	0
0049	3T	21	124	96	9	9600	6290	-3310	0.09	0.66	16	11	-5
0049	3T	21	125	77	9	7700	8220	520	0.12	1.07	13	14	1
0049	3T	21	126	109	5	10900	9340	-1560	0.05	0.86	19	16	-3
0049	3T	21	132	6	0	600	0	-600	0.00	0.00	1	0	-1
0049	3T	21	134	64	5	6400	3310	-3090	0.08	0.52	11	5	-6
0049	3T	21	135	60	5	6000	2990	-3010	0.08	0.50	10	5	-5
0049	3T	21	136	64	4	6400	3430	-2970	0.06	0.54	11	6	-5
0049	3T	21	142	4	0	400	0	-400	0.00	0.00	0	0	0
0049	3T	21	143	3	1	300	570	270	0.33	1.90	0	1	1
0049	3T	21	145	41	2	4100	1970	-2130	0.05	0.48	7	3	-4
0049	3T	21	146	52	4	5200	4020	-1180	0.08	0.77	9	7	-2
0049	3T	21	152	2	0	200	0	-200	0.00	0.00	0	0	0
0049	3T	21	153	8	1	800	1580	780	0.13	1.98	1	2	1
0049	3T	21	154	8	0	800	0	-800	0.00	0.00	1	0	-1
0049	3T	21	156	69	1	6900	2970	-3930	0.01	0.43	12	5	-7
0049	3T	21	162	2	0	200	0	-200	0.00	0.00	0	0	0
0049	3T	21	163	3	0	300	0	-300	0.00	0.00	0	0	0
0049	3T	21	164	2	0	200	0	-200	0.00	0.00	0	0	0
0049	3T	21	165	1	0	100	0	-100	0.00	0.00	0	0	0
0049	3T	21	213	4	1	400	1070	670	0.25	2.68	0	1	1
0049	3T	21	214	7	1	700	1060	360	0.14	1.51	1	1	0
0049	3T	21	215	7	1	700	630	-70	0.14	0.90	1	1	0
0049	3T	21	216	11	0	1100	0	-1100	0.00	0.00	1	0	-1
0049	3T	21	231	8	0	800	0	-800	0.00	0.00	1	0	-1
0049	3T	21	235	1	0	100	0	-100	0.00	0.00	0	0	0
0049	3T	21	241	21	0	2100	0	-2100	0.00	0.00	3	0	-3
0049	3T	21	245	2	0	200	0	-200	0.00	0.00	0	0	0
0049	3T	21	246	6	0	600	0	-600	0.00	0.00	1	0	-1
0049	3T	21	251	20	1	2000	1040	-960	0.05	0.52	3	1	-2
0049	3T	21	254	1	0	100	0	-100	0.00	0.00	0	0	0
0049	3T	21	256	11	1	1100	1410	310	0.09	1.28	1	2	1
0049	3T	21	261	11	0	1100	0	-1100	0.00	0.00	1	0	-1
0049	3T	21	264	1	0	100	0	-100	0.00	0.00	0	0	0
0049	3T	22	123	38	5	3800	2380	-1420	0.13	0.63	6	4	-2
0049	3T	22	124	78	10	7800	6620	-1180	0.13	0.85	13	11	-2
0049	3T	22	125	53	1	5300	860	-4440	0.02	0.16	9	1	-8
0049	3T	22	126	65	3	6500	2320	-4180	0.05	0.36	11	4	-7
0049	3T	22	134	27	3	2700	2740	40	0.11	1.01	4	4	0
0049	3T	22	135	64	6	6400	6800	400	0.09	1.06	11	12	1
0049	3T	22	136	37	0	3700	0	-3700	0.00	0.00	6	0	-6
0049	3T	22	143	1	1	100	540	440	1.00	5.40	0	0	0
0049	3T	22	145	51	3	5100	3360	-1740	0.06	0.66	9	5	-4
0049	3T	22	146	65	2	6500	1900	-4600	0.03	0.29	11	3	-8
0049	3T	22	153	26	1	2600	550	-2050	0.04	0.21	4	0	-4
0049	3T	22	154	4	0	400	0	-400	0.00	0.00	0	0	0
0049	3T	22	156	21	0	2100	0	-2100	0.00	0.00	3	0	-3
0049	3T	22	163	7	0	700	0	-700	0.00	0.00	1	0	-1
0049	3T	22	164	3	0	300	0	-300	0.00	0.00	0	0	0
0049	3T	22	165	40	1	4000	7320	3320	0.03	1.83	7	12	5
0049	3T	22	213	4	0	400	0	-400	0.00	0.00	0	0	0
0049	3T	22	216	2	0	200	0	-200	0.00	0.00	0	0	0
0049	3T	22	231	14	0	1400	0	-1400	0.00	0.00	2	0	-2
0049	3T	22	234	5	0	500	0	-500	0.00	0.00	0	0	0
0049	3T	22	235	7	0	700	0	-700	0.00	0.00	1	0	-1
0049	3T	22	236	32	2	3200	6130	2930	0.06	1.92	5	10	5
0049	3T	22	241	20	0	2000	0	-2000	0.00	0.00	3	0	-3
0049	3T	22	245	4	0	400	0	-400	0.00	0.00	0	0	0
0049	3T	22	246	26	1	2600	1570	-1030	0.04	0.60	4	2	-2
0049	3T	22	251	7	0	700	0	-700	0.00	0.00	1	0	-1
0049	3T	22	253	16	0	1600	0	-1600	0.00	0.00	2	0	-2
0049	3T	22	254	3	0	300	0	-300	0.00	0.00	0	0	0
0049	3T	22	256	29	0	2900	0	-2900	0.00	0.00	5	0	-5
0049	3T	22	261	4	0	400	0	-400	0.00	0.00	0	0	0
0049	3T	22	264	1	0	100	0	-100	0.00	0.00	0	0	0
0049	3T	22	265	9	0	900	0	-900	0.00	0.00	1	0	-1
0049	3T	23	123	31	3	3100	1310	-1790	0.10	0.42	5	2	-3
0049	3T	23	124	144	11	14400	6850	-7550	0.08	0.48	25	12	-13
0049	3T	23	125	29	1	2900	370	-2530	0.03	0.13	5	0	-5
0049	3T	23	126	138	8	13800	12620	-1180	0.06	0.91	24	22	-2
0049	3T	23	132	17	2	1700	1510	-190	0.12	0.89	3	2	-1
0049	3T	23	134	72	7	7200	6900	-300	0.10	0.96	12	12	0
0049	3T	23	135	27	1	2700	3280	580	0.04	1.21	4	5	1
0049	3T	23	136	75	1	7500	1010	-6490	0.01	0.13	13	1	-12
0049	3T	23	142	10	1	1000	890	-110	0.10	0.89	1	1	0
0049	3T	23	145	21	0	2100	0	-2100	0.00	0.00	3	0	-3
0049	3T	23	146	31	2	3100	2650	-450	0.06	0.85	5	4	-1
0049	3T	23	152	14	0	1400	0	-1400	0.00	0.00	2	0	-2
0049	3T	23	153	7	0	700	0	-700	0.00	0.00	1	0	-1
0049	3T	23	154	25	2	2500	5350	2850	0.08	2.14	4	9	5
0049	3T	23	156	28	1	2800	2220	-580	0.04	0.79	4	3	-1
0049	3T	23	162	7	0	700	0	-700	0.00	0.00	1	0	-1
0049	3T	23	163	4	0	400	0	-400	0.00	0.00	0	0	0
0049	3T	23	164	14	0	1400	0	-1400	0.00	0.00	2	0	-2
0049	3T	23	165	4	0	400	0	-400	0.00	0.00	0	0	0
0049	3T	23	213	3	2	300	1170	870	0.67	3.90	0	2	2
0049	3T	23	214	8	1	800	1690	890	0.13	2.11	1	2	1
0049	3T	23	215	5	0	500	0	-500	0.00	0.00	0	0	0
0049	3T	23	216	3	0	300	0	-300	0.00	0.00	0	0	0
0049	3T	23	231	15	0	1500	0	-1500	0.00	0.00	2	0	-2
0049	3T	23	234	5	0	500	0	-500	0.00	0.00	0	0	0
0049	3T	23	235	2	0	200	0	-200	0.00	0.00	0	0	0
0049	3T	23	236	4	0	400	0	-400	0.00	0.00	0	0	0
0049	3T	23	241	45	4	4500	8230	3730	0.09	1.83	7	14	7
0049	3T	23	245	12	0	1200	0	-1200	0.00	0.00	2	0	-2
0049	3T	23	246	18	0	1800	0	-1800	0.00	0.00	3	0	-3
0049	3T	23	251	21	0	2100	0	-2100	0.00	0.00	3	0	-3
0049	3T	23	253	5	0	500	0	-500	0.00	0.00	0	0	0
0049	3T	23	254	6	0	600	0	-600	0.00	0.00	1	0	-1
0049	3T	23	256	12	0	1200	0	-1200	0.00	0.00	2	0	-2
0049	3T	23	261	13	0	1300	0	-1300	0.00	0.00	2	0	-2
0049	3T	23	263	6	0	600	0	-600	0.00	0.00	1	0	-1
0049	3T	23	264	1	0	100	0	-100	0.00	0.00	0	0	0
0049	3T	23	265	1	0	100	0	-100	0.00	0.00	0	0	0
0049	3T	24	123	46	12	4600	6200	1600	0.26	1.35	8	10	2
0049	3T	24	124	103	12	10300	4910	-5390	0.12	0.48	18	8	-10
0049	3T	24	125	63	9	6300	6620	320	0.14	1.05	11	11	0
0049	3T	24	126	148	6	14800	5590	-9210	0.04	0.38	26	9	-17
0049	3T	24	132	32	4	3200	3130	-70	0.13	0.98	5	5	0
0049	3T	24	134	82	12	8200	9180	980	0.15	1.12	14	16	2
0049	3T	24	135	71	5	7100	5730	-1370	0.07	0.81	12	10	-2
0049	3T	24	136	100	5	10000	10330	330	0.05	1.03	17	18	1
0049	3T	24	142	20	2	2000	1640	-360	0.10	0.82	3	2	-1
0049	3T	24	143	5	0	500	0	-500	0.00	0.00	0	0	0
0049	3T	24	145	29	2	2900	3800	900	0.07	1.31	5	6	1
0049	3T	24	146	47	3	4700	5290	590	0.06	1.13	8	9	1
0049	3T	24	152	19	0	1900	0	-1900	0.00	0.00	3	0	-3
0049	3T	24	153	6	0	600	0	-600	0.00	0.00	1	0	-1
0049	3T	24	154	14	0	1400	0	-1400	0.00	0.00	2	0	-2
0049	3T	24	156	37	2	3700	2580	-1120	0.05	0.70	6	4	-2
0049	3T	24	162	2	0	200	0	-200	0.00	0.00	0	0	0
0049	3T	24	163	2	1	200	1910	1710	0.50	9.55	0	3	3
0049	3T	24	164	4	0	400	0	-400	0.00	0.00	0	0	0
0049	3T	24	213	5	1	500	1320	820	0.20	2.64	0	2	2
0049	3T	24	214	6	0	600	0	-600	0.00	0.00	1	0	-1
0049	3T	24	215	6	0	600	0	-600	0.00	0.00	1	0	-1
0049	3T	24	216	8	0	800	0	-800	0.00	0.00	1	0	-1
0049	3T	24	231	10	0	1000	0	-1000	0.00	0.00	1	0	-1
0049	3T	24	234	2	0	200	0	-200	0.00	0.00	0	0	0
0049	3T	24	235	4	0	400	0	-400	0.00	0.00	0	0	0
0049	3T	24	236	4	0	400	0	-400	0.00	0.00	0	0	0
0049	3T	24	241	25	1	2500	1050	-1450	0.04	0.42	4	1	-3
0049	3T	24	245	9	0	900	0	-900	0.00	0.00	1	0	-1
0049	3T	24	246	10	0	1000	0	-1000	0.00	0.00	1	0	-1
0049	3T	24	251	29	1	2900	2080	-820	0.03	0.72	5	3	-2
0049	3T	24	254	3	0	300	0	-300	0.00	0.00	0	0	0
0049	3T	24	256	6	0	600	0	-600	0.00	0.00	1	0	-1
0049	3T	24	261	13	0	1300	0	-1300	0.00	0.00	2	0	-2
0049	3T	24	264	1	0	100	0	-100	0.00	0.00	0	0	0
0050	1T	nopattern	1	59073	35246	5907300	5432120	-475180	0.60	0.92	10455	9614	-841
0050	1T	nopattern	2	7905	2488	790500	718200	-72300	0.31	0.91	1399	1271	-128
0050	2F	nopattern	12	20372	6315	2037200	1728810	-308390	0.31	0.85	3605	3059	-546
0050	2F	nopattern	13	13132	3285	1313200	1045690	-267510	0.25	0.80	2324	1850	-474
0050	2F	nopattern	14	9388	1955	938800	738470	-200330	0.21	0.79	1661	1307	-354
0050	2F	nopattern	15	5194	727	519400	442890	-76510	0.14	0.85	919	783	-136
0050	2F	nopattern	16	3062	351	306200	223720	-82480	0.11	0.73	541	395	-146
0050	2F	nopattern	23	1430	216	143000	122690	-20310	0.15	0.86	253	217	-36
0050	2F	nopattern	24	1075	146	107500	81080	-26420	0.14	0.75	190	143	-47
0050	2F	nopattern	25	751	69	75100	44690	-30410	0.09	0.60	132	79	-53
0050	2F	nopattern	26	576	55	57600	43060	-14540	0.10	0.75	101	76	-25
0050	2T	nopattern	12	18713	4468	1871300	1524330	-346970	0.24	0.81	3312	2697	-615
0050	2T	nopattern	13	13132	2558	1313200	1030220	-282980	0.19	0.78	2324	1823	-501
0050	2T	nopattern	14	9388	1460	938800	722300	-216500	0.16	0.77	1661	1278	-383
0050	2T	nopattern	15	5194	570	519400	455490	-63910	0.11	0.88	919	806	-113
0050	2T	nopattern	16	3062	267	306200	239870	-66330	0.09	0.78	541	424	-117
0050	2T	nopattern	21	1659	195	165900	148310	-17590	0.12	0.89	293	262	-31
0050	2T	nopattern	23	1430	131	143000	133610	-9390	0.09	0.93	253	236	-17
0050	2T	nopattern	24	1075	89	107500	74150	-33350	0.08	0.69	190	131	-59
0050	2T	nopattern	25	751	41	75100	40360	-34740	0.05	0.54	132	71	-61
0050	2T	nopattern	26	576	31	57600	40040	-17560	0.05	0.70	101	70	-31
0050	3F	nopattern	123	7401	1642	740100	626730	-113370	0.22	0.85	1309	1109	-200
0050	3F	nopattern	124	6517	1140	651700	477760	-173940	0.17	0.73	1153	845	-308
0050	3F	nopattern	125	4353	573	435300	357640	-77660	0.13	0.82	770	632	-138
0050	3F	nopattern	126	3479	337	347900	259010	-88890	0.10	0.74	615	458	-157
0050	3F	nopattern	134	4826	722	482600	367130	-115470	0.15	0.76	854	649	-205
0050	3F	nopattern	135	3210	369	321000	255570	-65430	0.11	0.80	568	452	-116
0050	3F	nopattern	136	2486	228	248600	150590	-98010	0.09	0.61	440	266	-174
0050	3F	nopattern	145	2548	247	254800	181220	-73580	0.10	0.71	450	320	-130
0050	3F	nopattern	146	1854	149	185400	145970	-39430	0.08	0.79	328	258	-70
0050	3F	nopattern	156	1132	80	113200	94320	-18880	0.07	0.83	200	166	-34
0050	3F	nopattern	234	507	49	50700	38350	-12350	0.10	0.76	89	67	-22
0050	3F	nopattern	235	370	31	37000	28140	-8860	0.08	0.76	65	49	-16
0050	3F	nopattern	236	328	23	32800	21950	-10850	0.07	0.67	58	38	-20
0050	3F	nopattern	245	296	20	29600	31570	1970	0.07	1.07	52	55	3
0050	3F	nopattern	246	286	25	28600	16670	-11930	0.09	0.58	50	29	-21
0050	3F	nopattern	256	218	13	21800	33840	12040	0.06	1.55	38	59	21
0050	3T	nopattern	123	4384	452	438400	385730	-52670	0.10	0.88	775	682	-93
0050	3T	nopattern	124	4353	342	435300	298370	-136930	0.08	0.69	770	528	-242
0050	3T	nopattern	125	3044	194	304400	274070	-30330	0.06	0.90	538	485	-53
0050	3T	nopattern	126	2572	107	257200	182530	-74670	0.04	0.71	455	323	-132
0050	3T	nopattern	132	2542	177	254200	195650	-58550	0.07	0.77	449	346	-103
0050	3T	nopattern	134	2901	201	290100	238200	-51900	0.07	0.82	513	421	-92
0050	3T	nopattern	135	2222	107	222200	137180	-85020	0.05	0.62	393	242	-151
0050	3T	nopattern	136	1907	75	190700	103140	-87560	0.04	0.54	337	182	-155
0050	3T	nopattern	142	1726	100	172600	115280	-57320	0.06	0.67	305	204	-101
0050	3T	nopattern	143	1925	91	192500	149480	-43020	0.05	0.78	340	264	-76
0050	3T	nopattern	145	1542	44	154200	77290	-76910	0.03	0.50	272	136	-136
0050	3T	nopattern	146	1304	47	130400	109470	-20930	0.04	0.84	230	193	-37
0050	3T	nopattern	152	947	38	94700	74940	-19760	0.04	0.79	167	132	-35
0050	3T	nopattern	153	988	36	98800	100180	1380	0.04	1.01	174	177	3
0050	3T	nopattern	154	1006	25	100600	80280	-20320	0.02	0.80	178	142	-36
0050	3T	nopattern	156	736	25	73600	72390	-1210	0.03	0.98	130	128	-2
0050	3T	nopattern	162	538	22	53800	57470	3670	0.04	1.07	95	101	6
0050	3T	nopattern	163	579	15	57900	32610	-25290	0.03	0.56	102	57	-45
0050	3T	nopattern	164	550	6	55000	24060	-30940	0.01	0.44	97	42	-55
0050	3T	nopattern	165	396	7	39600	27330	-12270	0.02	0.69	70	48	-22
0050	3T	nopattern	213	334	9	33400	22130	-11270	0.03	0.66	59	39	-20
0050	3T	nopattern	214	329	11	32900	32110	-790	0.03	0.98	58	56	-2
0050	3T	nopattern	215	289	5	28900	5460	-23440	0.02	0.19	51	9	-42
0050	3T	nopattern	216	304	8	30400	30750	350	0.03	1.01	53	54	1
0050	3T	nopattern	231	141	1	14100	3510	-10590	0.01	0.25	24	6	-18
0050	3T	nopattern	234	301	11	30100	43810	13710	0.04	1.46	53	77	24
0050	3T	nopattern	235	248	5	24800	18920	-5880	0.02	0.76	43	33	-10
0050	3T	nopattern	236	219	4	21900	12650	-9250	0.02	0.58	38	22	-16
0050	3T	nopattern	241	109	2	10900	5770	-5130	0.02	0.53	19	10	-9
0050	3T	nopattern	243	206	6	20600	16050	-4550	0.03	0.78	36	28	-8
0050	3T	nopattern	245	159	1	15900	2040	-13860	0.01	0.13	28	3	-25
0050	3T	nopattern	246	204	4	20400	5050	-15350	0.02	0.25	36	8	-28
0050	3T	nopattern	251	73	2	7300	4910	-2390	0.03	0.67	12	8	-4
0050	3T	nopattern	253	122	1	12200	1260	-10940	0.01	0.10	21	2	-19
0050	3T	nopattern	254	137	2	13700	5030	-8670	0.01	0.37	24	8	-16
0050	3T	nopattern	256	137	0	13700	0	-13700	0.00	0.00	24	0	-24
0050	3T	nopattern	261	65	1	6500	37600	31100	0.02	5.78	11	66	55
0050	3T	nopattern	263	109	4	10900	16360	5460	0.04	1.50	19	28	9
0050	3T	nopattern	264	82	3	8200	4600	-3600	0.04	0.56	14	8	-6
0050	3T	nopattern	265	81	2	8100	16420	8320	0.02	2.03	14	29	15
0051	1T	1	1	9583	5625	958300	880770	-77530	0.59	0.92	1696	1558	-138
0051	1T	1	2	1881	644	188100	171500	-16600	0.34	0.91	332	303	-29
0051	1T	2	1	8942	5076	894200	801460	-92740	0.57	0.90	1582	1418	-164
0051	1T	2	2	2080	662	208000	178810	-29190	0.32	0.86	368	316	-52
0051	1T	3	1	9047	5376	904700	856350	-48350	0.59	0.95	1601	1515	-86
0051	1T	3	2	2117	661	211700	194410	-17290	0.31	0.92	374	344	-30
0051	1T	4	1	7677	4785	767700	703020	-64680	0.62	0.92	1358	1244	-114
0051	1T	4	2	1612	533	161200	151320	-9880	0.33	0.94	285	267	-18
0051	1T	5	1	6688	4350	668800	611050	-57750	0.65	0.91	1183	1081	-102
0051	1T	5	2	729	177	72900	62240	-10660	0.24	0.85	129	110	-19
0051	1T	6	1	526	328	52600	45260	-7340	0.62	0.86	93	80	-13
0051	1T	6	2	56	20	5600	8310	2710	0.36	1.48	9	14	5
0051	1T	7	1	11092	7097	1109200	1016440	-92760	0.64	0.92	1963	1799	-164
0051	1T	7	2	1215	311	121500	100100	-21400	0.26	0.82	215	177	-38
0051	2F	1	12	3094	944	309400	273780	-35620	0.31	0.88	547	484	-63
0051	2F	1	13	2010	522	201000	169150	-31850	0.26	0.84	355	299	-56
0051	2F	1	14	1528	325	152800	132270	-20530	0.21	0.87	270	234	-36
0051	2F	1	15	932	110	93200	74560	-18640	0.12	0.80	164	131	-33
0051	2F	1	16	580	72	58000	58300	300	0.12	1.01	102	103	1
0051	2F	1	23	380	59	38000	28430	-9570	0.16	0.75	67	50	-17
0051	2F	1	24	292	33	29200	19050	-10150	0.11	0.65	51	33	-18
0051	2F	1	25	176	18	17600	13280	-4320	0.10	0.75	31	23	-8
0051	2F	1	26	122	15	12200	8700	-3500	0.12	0.71	21	15	-6
0051	2F	2	12	2864	818	286400	225750	-60650	0.29	0.79	506	399	-107
0051	2F	2	13	1972	473	197200	149240	-47960	0.24	0.76	349	264	-85
0051	2F	2	14	1436	330	143600	120710	-22890	0.23	0.84	254	213	-41
0051	2F	2	15	823	119	82300	67450	-14850	0.14	0.82	145	119	-26
0051	2F	2	16	607	84	60700	53890	-6810	0.14	0.89	107	95	-12
0051	2F	2	23	372	51	37200	31310	-5890	0.14	0.84	65	55	-10
0051	2F	2	24	266	35	26600	19980	-6620	0.13	0.75	47	35	-12
0051	2F	2	25	222	24	22200	19300	-2900	0.11	0.87	39	34	-5
0051	2F	2	26	170	18	17000	10090	-6910	0.11	0.59	30	17	-13
0051	2F	3	12	2971	875	297100	242160	-54940	0.29	0.82	525	428	-97
0051	2F	3	13	2032	527	203200	166810	-36390	0.26	0.82	359	295	-64
0051	2F	3	14	1396	261	139600	98710	-40890	0.19	0.71	247	174	-73
0051	2F	3	15	904	138	90400	69260	-21140	0.15	0.77	160	122	-38
0051	2F	3	16	574	66	57400	44430	-12970	0.11	0.77	101	78	-23
0051	2F	3	23	417	62	41700	35010	-6690	0.15	0.84	73	61	-12
0051	2F	3	24	268	32	26800	20440	-6360	0.12	0.76	47	36	-11
0051	2F	3	25	205	18	20500	15200	-5300	0.09	0.74	36	26	-10
0051	2F	3	26	146	10	14600	3970	-10630	0.07	0.27	25	7	-18
0051	2F	4	12	2545	812	254500	210920	-43580	0.32	0.83	450	373	-77
0051	2F	4	13	1734	481	173400	148880	-24520	0.28	0.86	306	263	-43
0051	2F	4	14	1235	274	123500	97650	-25850	0.22	0.79	218	172	-46
0051	2F	4	15	755	113	75500	60050	-15450	0.15	0.80	133	106	-27
0051	2F	4	16	425	40	42500	38700	-3800	0.09	0.91	75	68	-7
0051	2F	4	23	336	70	33600	37570	3970	0.21	1.12	59	66	7
0051	2F	4	24	217	25	21700	12750	-8950	0.12	0.59	38	22	-16
0051	2F	4	25	177	17	17700	13740	-3960	0.10	0.78	31	24	-7
0051	2F	4	26	122	13	12200	12840	640	0.11	1.05	21	22	1
0051	2F	5	12	2343	842	234300	201870	-32430	0.36	0.86	414	357	-57
0051	2F	5	13	1490	399	149000	134130	-14870	0.27	0.90	263	237	-26
0051	2F	5	14	1057	248	105700	89370	-16330	0.23	0.85	187	158	-29
0051	2F	5	15	533	82	53300	53190	-110	0.15	1.00	94	94	0
0051	2F	5	16	288	35	28800	17090	-11710	0.12	0.59	50	30	-20
0051	2F	5	23	131	13	13100	10190	-2910	0.10	0.78	23	18	-5
0051	2F	5	24	103	9	10300	6330	-3970	0.09	0.61	18	11	-7
0051	2F	5	25	72	3	7200	1320	-5880	0.04	0.18	12	2	-10
0051	2F	5	26	42	2	4200	1160	-3040	0.05	0.28	7	2	-5
0051	2F	6	12	179	61	17900	14370	-3530	0.34	0.80	31	25	-6
0051	2F	6	13	115	33	11500	9600	-1900	0.29	0.83	20	16	-4
0051	2F	6	14	79	8	7900	2460	-5440	0.10	0.31	13	4	-9
0051	2F	6	15	41	4	4100	2210	-1890	0.10	0.54	7	3	-4
0051	2F	6	16	27	5	2700	2690	-10	0.19	1.00	4	4	0
0051	2F	6	23	11	2	1100	2110	1010	0.18	1.92	1	3	2
0051	2F	6	24	8	0	800	0	-800	0.00	0.00	1	0	-1
0051	2F	6	25	9	0	900	0	-900	0.00	0.00	1	0	-1
0051	2F	6	26	1	0	100	0	-100	0.00	0.00	0	0	0
0051	2F	7	12	3892	1252	389200	329360	-59840	0.32	0.85	688	582	-106
0051	2F	7	13	2413	626	241300	201930	-39370	0.26	0.84	427	357	-70
0051	2F	7	14	1805	387	180500	150170	-30330	0.21	0.83	319	265	-54
0051	2F	7	15	955	120	95500	79610	-15890	0.13	0.83	169	140	-29
0051	2F	7	16	571	67	57100	43000	-14100	0.12	0.75	101	76	-25
0051	2F	7	23	248	29	24800	17430	-7370	0.12	0.70	43	30	-13
0051	2F	7	24	160	14	16000	11230	-4770	0.09	0.70	28	19	-9
0051	2F	7	25	107	7	10700	6270	-4430	0.07	0.59	18	11	-7
0051	2F	7	26	77	4	7700	5070	-2630	0.05	0.66	13	8	-5
0051	2T	1	12	2675	613	267500	224930	-42570	0.23	0.84	473	398	-75
0051	2T	1	13	2010	412	201000	169180	-31820	0.20	0.84	355	299	-56
0051	2T	1	14	1528	255	152800	129290	-23510	0.17	0.85	270	228	-42
0051	2T	1	15	932	75	93200	63120	-30080	0.08	0.68	164	111	-53
0051	2T	1	16	580	46	58000	46470	-11530	0.08	0.80	102	82	-20
0051	2T	1	21	419	60	41900	35100	-6800	0.14	0.84	74	62	-12
0051	2T	1	23	380	33	38000	24610	-13390	0.09	0.65	67	43	-24
0051	2T	1	24	292	18	29200	17240	-11960	0.06	0.59	51	30	-21
0051	2T	1	25	176	14	17600	10380	-7220	0.08	0.59	31	18	-13
0051	2T	1	26	122	8	12200	5710	-6490	0.07	0.47	21	10	-11
0051	2T	2	12	2364	522	236400	182160	-54240	0.22	0.77	418	322	-96
0051	2T	2	13	1972	356	197200	146050	-51150	0.18	0.74	349	258	-91
0051	2T	2	14	1436	245	143600	116990	-26610	0.17	0.81	254	207	-47
0051	2T	2	15	823	79	82300	51910	-30390	0.10	0.63	145	91	-54
0051	2T	2	16	607	60	60700	46330	-14370	0.10	0.76	107	82	-25
0051	2T	2	21	500	74	50000	39530	-10470	0.15	0.79	88	69	-19
0051	2T	2	23	372	31	37200	36060	-1140	0.08	0.97	65	63	-2
0051	2T	2	24	266	21	26600	18620	-7980	0.08	0.70	47	32	-15
0051	2T	2	25	222	14	22200	12630	-9570	0.06	0.57	39	22	-17
0051	2T	2	26	170	13	17000	12420	-4580	0.08	0.73	30	21	-9
0051	2T	3	12	2502	576	250200	205230	-44970	0.23	0.82	442	363	-79
0051	2T	3	13	2032	410	203200	168200	-35000	0.20	0.83	359	297	-62
0051	2T	3	14	1396	203	139600	98540	-41060	0.15	0.71	247	174	-73
0051	2T	3	15	904	103	90400	74440	-15960	0.11	0.82	160	131	-29
0051	2T	3	16	574	54	57400	50810	-6590	0.09	0.89	101	89	-12
0051	2T	3	21	469	45	46900	26850	-20050	0.10	0.57	83	47	-36
0051	2T	3	23	417	27	41700	30400	-11300	0.06	0.73	73	53	-20
0051	2T	3	24	268	21	26800	20420	-6380	0.08	0.76	47	36	-11
0051	2T	3	25	205	12	20500	13100	-7400	0.06	0.64	36	23	-13
0051	2T	3	26	146	6	14600	3410	-11190	0.04	0.23	25	6	-19
0051	2T	4	12	2229	552	222900	179060	-43840	0.25	0.80	394	316	-78
0051	2T	4	13	1734	388	173400	148000	-25400	0.22	0.85	306	261	-45
0051	2T	4	14	1235	217	123500	96530	-26970	0.18	0.78	218	170	-48
0051	2T	4	15	755	88	75500	59160	-16340	0.12	0.78	133	104	-29
0051	2T	4	16	425	30	42500	38740	-3760	0.07	0.91	75	68	-7
0051	2T	4	21	316	43	31600	23050	-8550	0.14	0.73	55	40	-15
0051	2T	4	23	336	41	33600	30680	-2920	0.12	0.91	59	54	-5
0051	2T	4	24	217	17	21700	12710	-8990	0.08	0.59	38	22	-16
0051	2T	4	25	177	12	17700	13120	-4580	0.07	0.74	31	23	-8
0051	2T	4	26	122	10	12200	15990	3790	0.08	1.31	21	28	7
0051	2T	5	12	2188	620	218800	177450	-41350	0.28	0.81	387	314	-73
0051	2T	5	13	1490	306	149000	124960	-24040	0.21	0.84	263	221	-42
0051	2T	5	14	1057	200	105700	92370	-13330	0.19	0.87	187	163	-24
0051	2T	5	15	533	64	53300	55470	2170	0.12	1.04	94	98	4
0051	2T	5	16	288	27	28800	19730	-9070	0.09	0.69	50	34	-16
0051	2T	5	21	155	22	15500	22160	6660	0.14	1.43	27	39	12
0051	2T	5	23	131	7	13100	9310	-3790	0.05	0.71	23	16	-7
0051	2T	5	24	103	7	10300	9040	-1260	0.07	0.88	18	16	-2
0051	2T	5	25	72	3	7200	1770	-5430	0.04	0.25	12	3	-9
0051	2T	5	26	42	1	4200	1520	-2680	0.02	0.36	7	2	-5
0051	2T	6	12	170	46	17000	13690	-3310	0.27	0.81	30	24	-6
0051	2T	6	13	115	21	11500	7290	-4210	0.18	0.63	20	12	-8
0051	2T	6	14	79	8	7900	3100	-4800	0.10	0.39	13	5	-8
0051	2T	6	15	41	3	4100	2310	-1790	0.07	0.56	7	4	-3
0051	2T	6	16	27	5	2700	3760	1060	0.19	1.39	4	6	2
0051	2T	6	21	9	1	900	1650	750	0.11	1.83	1	2	1
0051	2T	6	23	11	2	1100	5600	4500	0.18	5.09	1	9	8
0051	2T	6	24	8	0	800	0	-800	0.00	0.00	1	0	-1
0051	2T	6	25	9	0	900	0	-900	0.00	0.00	1	0	-1
0051	2T	6	26	1	0	100	0	-100	0.00	0.00	0	0	0
0051	2T	7	12	3616	926	361600	294090	-67510	0.26	0.81	640	520	-120
0051	2T	7	13	2413	498	241300	194560	-46740	0.21	0.81	427	344	-83
0051	2T	7	14	1805	315	180500	151880	-28620	0.17	0.84	319	268	-51
0051	2T	7	15	955	96	95500	83310	-12190	0.10	0.87	169	147	-22
0051	2T	7	16	571	51	57100	40380	-16720	0.09	0.71	101	71	-30
0051	2T	7	21	276	32	27600	27380	-220	0.12	0.99	48	48	0
0051	2T	7	23	248	15	24800	12620	-12180	0.06	0.51	43	22	-21
0051	2T	7	24	160	7	16000	4790	-11210	0.04	0.30	28	8	-20
0051	2T	7	25	107	5	10700	7750	-2950	0.05	0.72	18	13	-5
0051	2T	7	26	77	3	7700	4230	-3470	0.04	0.55	13	7	-6
0051	3F	1	123	973	207	97300	82930	-14370	0.21	0.85	172	146	-26
0051	3F	1	124	1212	185	121200	89000	-32200	0.15	0.73	214	157	-57
0051	3F	1	125	663	85	66300	59050	-7250	0.13	0.89	117	104	-13
0051	3F	1	126	540	48	54000	37160	-16840	0.09	0.69	95	65	-30
0051	3F	1	134	807	114	80700	58240	-22460	0.14	0.72	142	103	-39
0051	3F	1	135	491	49	49100	35770	-13330	0.10	0.73	86	63	-23
0051	3F	1	136	403	32	40300	26670	-13630	0.08	0.66	71	47	-24
0051	3F	1	145	468	49	46800	37810	-8990	0.10	0.81	82	66	-16
0051	3F	1	146	373	30	37300	34750	-2550	0.08	0.93	66	61	-5
0051	3F	1	156	231	11	23100	18560	-4540	0.05	0.80	40	32	-8
0051	3F	1	234	118	10	11800	8030	-3770	0.08	0.68	20	14	-6
0051	3F	1	235	91	6	9100	6030	-3070	0.07	0.66	16	10	-6
0051	3F	1	236	70	5	7000	3150	-3850	0.07	0.45	12	5	-7
0051	3F	1	245	94	5	9400	5510	-3890	0.05	0.59	16	9	-7
0051	3F	1	246	60	2	6000	3780	-2220	0.03	0.63	10	6	-4
0051	3F	1	256	37	1	3700	450	-3250	0.03	0.12	6	0	-6
0051	3F	2	123	982	196	98200	76470	-21730	0.20	0.78	173	135	-38
0051	3F	2	124	872	152	87200	68390	-18810	0.17	0.78	154	121	-33
0051	3F	2	125	652	92	65200	56610	-8590	0.14	0.87	115	100	-15
0051	3F	2	126	599	63	59900	43140	-16760	0.11	0.72	106	76	-30
0051	3F	2	134	621	94	62100	48410	-13690	0.15	0.78	109	85	-24
0051	3F	2	135	536	67	53600	40570	-13030	0.13	0.76	94	71	-23
0051	3F	2	136	445	58	44500	39350	-5150	0.13	0.88	78	69	-9
0051	3F	2	145	386	29	38600	16340	-22260	0.08	0.42	68	28	-40
0051	3F	2	146	347	43	34700	32930	-1770	0.12	0.95	61	58	-3
0051	3F	2	156	228	14	22800	14950	-7850	0.06	0.66	40	26	-14
0051	3F	2	234	118	16	11800	18240	6440	0.14	1.55	20	32	12
0051	3F	2	235	98	8	9800	7490	-2310	0.08	0.76	17	13	-4
0051	3F	2	236	103	10	10300	12810	2510	0.10	1.24	18	22	4
0051	3F	2	245	78	3	7800	2900	-4900	0.04	0.37	13	5	-8
0051	3F	2	246	68	3	6800	4280	-2520	0.04	0.63	12	7	-5
0051	3F	2	256	50	1	5000	220	-4780	0.02	0.04	8	0	-8
0051	3F	3	123	1002	215	100200	80910	-19290	0.21	0.81	177	143	-34
0051	3F	3	124	916	136	91600	64420	-27180	0.15	0.70	162	114	-48
0051	3F	3	125	682	91	68200	47460	-20740	0.13	0.70	120	84	-36
0051	3F	3	126	636	76	63600	54750	-8850	0.12	0.86	112	96	-16
0051	3F	3	134	687	119	68700	58190	-10510	0.17	0.85	121	102	-19
0051	3F	3	135	530	78	53000	46440	-6560	0.15	0.88	93	82	-11
0051	3F	3	136	466	47	46600	30630	-15970	0.10	0.66	82	54	-28
0051	3F	3	145	429	51	42900	34130	-8770	0.12	0.80	75	60	-15
0051	3F	3	146	290	22	29000	27190	-1810	0.08	0.94	51	48	-3
0051	3F	3	156	212	13	21200	10070	-11130	0.06	0.48	37	17	-20
0051	3F	3	234	130	12	13000	7070	-5930	0.09	0.54	23	12	-11
0051	3F	3	235	115	4	11500	1200	-10300	0.03	0.10	20	2	-18
0051	3F	3	236	74	9	7400	6910	-490	0.12	0.93	13	12	-1
0051	3F	3	245	71	6	7100	5130	-1970	0.08	0.72	12	9	-3
0051	3F	3	246	63	4	6300	2520	-3780	0.06	0.40	11	4	-7
0051	3F	3	256	46	1	4600	1460	-3140	0.02	0.32	8	2	-6
0051	3F	4	123	915	229	91500	83940	-7560	0.25	0.92	161	148	-13
0051	3F	4	124	816	156	81600	62990	-18610	0.19	0.77	144	111	-33
0051	3F	4	125	582	85	58200	49430	-8770	0.15	0.85	103	87	-16
0051	3F	4	126	522	35	52200	21190	-31010	0.07	0.41	92	37	-55
0051	3F	4	134	603	99	60300	43190	-17110	0.16	0.72	106	76	-30
0051	3F	4	135	440	46	44000	30360	-13640	0.10	0.69	77	53	-24
0051	3F	4	136	332	43	33200	30040	-3160	0.13	0.90	58	53	-5
0051	3F	4	145	399	40	39900	30020	-9880	0.10	0.75	70	53	-17
0051	3F	4	146	247	23	24700	25260	560	0.09	1.02	43	44	1
0051	3F	4	156	167	9	16700	10010	-6690	0.05	0.60	29	17	-12
0051	3F	4	234	101	13	10100	8970	-1130	0.13	0.89	17	15	-2
0051	3F	4	235	78	11	7800	9170	1370	0.14	1.18	13	16	3
0051	3F	4	236	79	11	7900	9360	1460	0.14	1.18	13	16	3
0051	3F	4	245	60	3	6000	1470	-4530	0.05	0.25	10	2	-8
0051	3F	4	246	53	1	5300	390	-4910	0.02	0.07	9	0	-9
0051	3F	4	256	43	3	4300	1450	-2850	0.07	0.34	7	2	-5
0051	3F	5	123	913	236	91300	77710	-13590	0.26	0.85	161	137	-24
0051	3F	5	124	696	124	69600	47790	-21810	0.18	0.69	123	84	-39
0051	3F	5	125	481	62	48100	35750	-12350	0.13	0.74	85	63	-22
0051	3F	5	126	393	43	39300	36000	-3300	0.11	0.92	69	63	-6
0051	3F	5	134	519	89	51900	47380	-4520	0.17	0.91	91	83	-8
0051	3F	5	135	372	33	37200	20750	-16450	0.09	0.56	65	36	-29
0051	3F	5	136	260	25	26000	22170	-3830	0.10	0.85	46	39	-7
0051	3F	5	145	267	31	26700	25550	-1150	0.12	0.96	47	45	-2
0051	3F	5	146	189	15	18900	11360	-7540	0.08	0.60	33	20	-13
0051	3F	5	156	105	6	10500	7780	-2720	0.06	0.74	18	13	-5
0051	3F	5	234	44	3	4400	3690	-710	0.07	0.84	7	6	-1
0051	3F	5	235	41	1	4100	520	-3580	0.02	0.13	7	0	-7
0051	3F	5	236	24	1	2400	1300	-1100	0.04	0.54	4	2	-2
0051	3F	5	245	33	0	3300	0	-3300	0.00	0.00	5	0	-5
0051	3F	5	246	24	0	2400	0	-2400	0.00	0.00	4	0	-4
0051	3F	5	256	20	1	2000	1470	-530	0.05	0.74	3	2	-1
0051	3F	6	123	57	9	5700	3160	-2540	0.16	0.55	10	5	-5
0051	3F	6	124	54	14	5400	4750	-650	0.26	0.88	9	8	-1
0051	3F	6	125	34	5	3400	1910	-1490	0.15	0.56	6	3	-3
0051	3F	6	126	31	4	3100	3980	880	0.13	1.28	5	7	2
0051	3F	6	134	37	10	3700	3850	150	0.27	1.04	6	6	0
0051	3F	6	135	33	7	3300	4760	1460	0.21	1.44	5	8	3
0051	3F	6	136	21	2	2100	2420	320	0.10	1.15	3	4	1
0051	3F	6	145	28	1	2800	2480	-320	0.04	0.89	4	4	0
0051	3F	6	146	17	0	1700	0	-1700	0.00	0.00	3	0	-3
0051	3F	6	156	5	1	500	1120	620	0.20	2.24	0	1	1
0051	3F	6	234	3	1	300	4150	3850	0.33	13.83	0	7	7
0051	3F	6	235	3	1	300	770	470	0.33	2.57	0	1	1
0051	3F	6	236	2	0	200	0	-200	0.00	0.00	0	0	0
0051	3F	6	245	2	0	200	0	-200	0.00	0.00	0	0	0
0051	3F	6	246	5	0	500	0	-500	0.00	0.00	0	0	0
0051	3F	6	256	1	0	100	0	-100	0.00	0.00	0	0	0
0051	3F	7	123	1360	321	136000	126180	-9820	0.24	0.93	240	223	-17
0051	3F	7	124	1317	231	131700	103040	-28660	0.18	0.78	233	182	-51
0051	3F	7	125	828	106	82800	66750	-16050	0.13	0.81	146	118	-28
0051	3F	7	126	627	67	62700	55990	-6710	0.11	0.89	110	99	-11
0051	3F	7	134	843	132	84300	71030	-13270	0.16	0.84	149	125	-24
0051	3F	7	135	555	61	55500	38400	-17100	0.11	0.69	98	67	-31
0051	3F	7	136	475	46	47500	47140	-360	0.10	0.99	84	83	-1
0051	3F	7	145	474	48	47400	41990	-5410	0.10	0.89	83	74	-9
0051	3F	7	146	384	30	38400	30130	-8270	0.08	0.78	67	53	-14
0051	3F	7	156	218	17	21800	17860	-3940	0.08	0.82	38	31	-7
0051	3F	7	234	74	4	7400	4180	-3220	0.05	0.56	13	7	-6
0051	3F	7	235	60	3	6000	2510	-3490	0.05	0.42	10	4	-6
0051	3F	7	236	58	2	5800	3630	-2170	0.03	0.63	10	6	-4
0051	3F	7	245	42	1	4200	1030	-3170	0.02	0.25	7	1	-6
0051	3F	7	246	50	0	5000	0	-5000	0.00	0.00	8	0	-8
0051	3F	7	256	24	0	2400	0	-2400	0.00	0.00	4	0	-4
0051	3T	1	123	479	39	47900	38310	-9590	0.08	0.80	84	67	-17
0051	3T	1	124	829	50	82900	47350	-35550	0.06	0.57	146	83	-63
0051	3T	1	125	411	25	41100	40790	-310	0.06	0.99	72	72	0
0051	3T	1	126	386	12	38600	30900	-7700	0.03	0.80	68	54	-14
0051	3T	1	132	351	26	35100	30180	-4920	0.07	0.86	62	53	-9
0051	3T	1	134	549	32	54900	36630	-18270	0.06	0.67	97	64	-33
0051	3T	1	135	347	23	34700	34300	-400	0.07	0.99	61	60	-1
0051	3T	1	136	294	8	29400	16140	-13260	0.03	0.55	52	28	-24
0051	3T	1	142	275	16	27500	24970	-2530	0.06	0.91	48	44	-4
0051	3T	1	143	258	12	25800	23880	-1920	0.05	0.93	45	42	-3
0051	3T	1	145	242	14	24200	20120	-4080	0.06	0.83	42	35	-7
0051	3T	1	146	236	12	23600	29490	5890	0.05	1.25	41	52	11
0051	3T	1	152	145	4	14500	9210	-5290	0.03	0.64	25	16	-9
0051	3T	1	153	144	3	14400	11040	-3360	0.02	0.77	25	19	-6
0051	3T	1	154	226	5	22600	18170	-4430	0.02	0.80	40	32	-8
0051	3T	1	156	154	2	15400	4850	-10550	0.01	0.31	27	8	-19
0051	3T	1	162	83	4	8300	11710	3410	0.05	1.41	14	20	6
0051	3T	1	163	109	5	10900	30510	19610	0.05	2.80	19	54	35
0051	3T	1	164	137	3	13700	5730	-7970	0.02	0.42	24	10	-14
0051	3T	1	165	77	1	7700	1850	-5850	0.01	0.24	13	3	-10
0051	3T	1	213	98	10	9800	19440	9640	0.10	1.98	17	34	17
0051	3T	1	214	79	8	7900	14740	6840	0.10	1.87	13	26	13
0051	3T	1	215	81	2	8100	5350	-2750	0.02	0.66	14	9	-5
0051	3T	1	216	60	1	6000	1580	-4420	0.02	0.26	10	2	-8
0051	3T	1	231	45	0	4500	0	-4500	0.00	0.00	7	0	-7
0051	3T	1	234	76	1	7600	1520	-6080	0.01	0.20	13	2	-11
0051	3T	1	235	67	2	6700	3860	-2840	0.03	0.58	11	6	-5
0051	3T	1	236	51	0	5100	0	-5100	0.00	0.00	9	0	-9
0051	3T	1	241	29	0	2900	0	-2900	0.00	0.00	5	0	-5
0051	3T	1	243	42	1	4200	960	-3240	0.02	0.23	7	1	-6
0051	3T	1	245	68	0	6800	0	-6800	0.00	0.00	12	0	-12
0051	3T	1	246	39	1	3900	2610	-1290	0.03	0.67	6	4	-2
0051	3T	1	251	26	1	2600	1040	-1560	0.04	0.40	4	1	-3
0051	3T	1	253	24	1	2400	1590	-810	0.04	0.66	4	2	-2
0051	3T	1	254	26	1	2600	2610	10	0.04	1.00	4	4	0
0051	3T	1	256	22	0	2200	0	-2200	0.00	0.00	3	0	-3
0051	3T	1	261	11	0	1100	0	-1100	0.00	0.00	1	0	-1
0051	3T	1	263	19	0	1900	0	-1900	0.00	0.00	3	0	-3
0051	3T	1	264	21	0	2100	0	-2100	0.00	0.00	3	0	-3
0051	3T	1	265	15	0	1500	0	-1500	0.00	0.00	2	0	-2
0051	3T	2	123	481	46	48100	41770	-6330	0.10	0.87	85	73	-12
0051	3T	2	124	460	33	46000	34410	-11590	0.07	0.75	81	60	-21
0051	3T	2	125	398	24	39800	39590	-210	0.06	0.99	70	70	0
0051	3T	2	126	385	8	38500	9840	-28660	0.02	0.26	68	17	-51
0051	3T	2	132	372	23	37200	26080	-11120	0.06	0.70	65	46	-19
0051	3T	2	134	355	16	35500	16800	-18700	0.05	0.47	62	29	-33
0051	3T	2	135	391	22	39100	25580	-13520	0.06	0.65	69	45	-24
0051	3T	2	136	321	21	32100	35450	3350	0.07	1.10	56	62	6
0051	3T	2	142	275	12	27500	12680	-14820	0.04	0.46	48	22	-26
0051	3T	2	143	266	17	26600	22130	-4470	0.06	0.83	47	39	-8
0051	3T	2	145	250	8	25000	13880	-11120	0.03	0.56	44	24	-20
0051	3T	2	146	241	11	24100	21770	-2330	0.05	0.90	42	38	-4
0051	3T	2	152	150	6	15000	17660	2660	0.04	1.18	26	31	5
0051	3T	2	153	145	7	14500	11070	-3430	0.05	0.76	25	19	-6
0051	3T	2	154	136	1	13600	3650	-9950	0.01	0.27	24	6	-18
0051	3T	2	156	143	1	14300	2120	-12180	0.01	0.15	25	3	-22
0051	3T	2	162	97	5	9700	11680	1980	0.05	1.20	17	20	3
0051	3T	2	163	124	5	12400	8440	-3960	0.04	0.68	21	14	-7
0051	3T	2	164	106	7	10600	25270	14670	0.07	2.38	18	44	26
0051	3T	2	165	85	3	8500	15130	6630	0.04	1.78	15	26	11
0051	3T	2	213	84	5	8400	3930	-4470	0.06	0.47	14	6	-8
0051	3T	2	214	97	0	9700	0	-9700	0.00	0.00	17	0	-17
0051	3T	2	215	77	4	7700	9620	1920	0.05	1.25	13	17	4
0051	3T	2	216	94	6	9400	15850	6450	0.06	1.69	16	28	12
0051	3T	2	231	45	1	4500	1680	-2820	0.02	0.37	7	2	-5
0051	3T	2	234	73	3	7300	17100	9800	0.04	2.34	12	30	18
0051	3T	2	235	63	0	6300	0	-6300	0.00	0.00	11	0	-11
0051	3T	2	236	72	1	7200	8860	1660	0.01	1.23	12	15	3
0051	3T	2	241	40	1	4000	1100	-2900	0.03	0.28	7	1	-6
0051	3T	2	243	45	2	4500	1450	-3050	0.04	0.32	7	2	-5
0051	3T	2	245	47	1	4700	2140	-2560	0.02	0.46	8	3	-5
0051	3T	2	246	46	0	4600	0	-4600	0.00	0.00	8	0	-8
0051	3T	2	251	27	1	2700	850	-1850	0.04	0.31	4	1	-3
0051	3T	2	253	35	1	3500	2970	-530	0.03	0.85	6	5	-1
0051	3T	2	254	31	0	3100	0	-3100	0.00	0.00	5	0	-5
0051	3T	2	256	32	0	3200	0	-3200	0.00	0.00	5	0	-5
0051	3T	2	261	23	0	2300	0	-2300	0.00	0.00	4	0	-4
0051	3T	2	263	31	0	3100	0	-3100	0.00	0.00	5	0	-5
0051	3T	2	264	22	0	2200	0	-2200	0.00	0.00	3	0	-3
0051	3T	2	265	18	0	1800	0	-1800	0.00	0.00	3	0	-3
0051	3T	3	123	505	47	50500	40060	-10440	0.09	0.79	89	70	-19
0051	3T	3	124	539	35	53900	35810	-18090	0.06	0.66	95	63	-32
0051	3T	3	125	401	19	40100	23190	-16910	0.05	0.58	70	41	-29
0051	3T	3	126	411	19	41100	25030	-16070	0.05	0.61	72	44	-28
0051	3T	3	132	367	25	36700	25450	-11250	0.07	0.69	64	45	-19
0051	3T	3	134	440	40	44000	45070	1070	0.09	1.02	77	79	2
0051	3T	3	135	366	23	36600	30680	-5920	0.06	0.84	64	54	-10
0051	3T	3	136	351	11	35100	22190	-12910	0.03	0.63	62	39	-23
0051	3T	3	142	278	11	27800	17530	-10270	0.04	0.63	49	31	-18
0051	3T	3	143	247	15	24700	19880	-4820	0.06	0.80	43	35	-8
0051	3T	3	145	250	10	25000	22890	-2110	0.04	0.92	44	40	-4
0051	3T	3	146	201	5	20100	10450	-9650	0.02	0.52	35	18	-17
0051	3T	3	152	168	3	16800	6280	-10520	0.02	0.37	29	11	-18
0051	3T	3	153	164	9	16400	18190	1790	0.05	1.11	29	32	3
0051	3T	3	154	179	7	17900	17340	-560	0.04	0.97	31	30	-1
0051	3T	3	156	136	3	13600	5210	-8390	0.02	0.38	24	9	-15
0051	3T	3	162	104	4	10400	9310	-1090	0.04	0.90	18	16	-2
0051	3T	3	163	115	2	11500	3730	-7770	0.02	0.32	20	6	-14
0051	3T	3	164	89	2	8900	2960	-5940	0.02	0.33	15	5	-10
0051	3T	3	165	76	2	7600	5340	-2260	0.03	0.70	13	9	-4
0051	3T	3	213	88	0	8800	0	-8800	0.00	0.00	15	0	-15
0051	3T	3	214	75	1	7500	1450	-6050	0.01	0.19	13	2	-11
0051	3T	3	215	87	4	8700	4130	-4570	0.05	0.47	15	7	-8
0051	3T	3	216	98	0	9800	0	-9800	0.00	0.00	17	0	-17
0051	3T	3	231	42	0	4200	0	-4200	0.00	0.00	7	0	-7
0051	3T	3	234	92	4	9200	8650	-550	0.04	0.94	16	15	-1
0051	3T	3	235	75	0	7500	0	-7500	0.00	0.00	13	0	-13
0051	3T	3	236	58	2	5800	2160	-3640	0.03	0.37	10	3	-7
0051	3T	3	241	24	0	2400	0	-2400	0.00	0.00	4	0	-4
0051	3T	3	243	38	2	3800	2180	-1620	0.05	0.57	6	3	-3
0051	3T	3	245	41	0	4100	0	-4100	0.00	0.00	7	0	-7
0051	3T	3	246	47	0	4700	0	-4700	0.00	0.00	8	0	-8
0051	3T	3	251	26	0	2600	0	-2600	0.00	0.00	4	0	-4
0051	3T	3	253	40	0	4000	0	-4000	0.00	0.00	7	0	-7
0051	3T	3	254	30	0	3000	0	-3000	0.00	0.00	5	0	-5
0051	3T	3	256	25	0	2500	0	-2500	0.00	0.00	4	0	-4
0051	3T	3	261	23	0	2300	0	-2300	0.00	0.00	4	0	-4
0051	3T	3	263	16	0	1600	0	-1600	0.00	0.00	2	0	-2
0051	3T	3	264	16	0	1600	0	-1600	0.00	0.00	2	0	-2
0051	3T	3	265	21	0	2100	0	-2100	0.00	0.00	3	0	-3
0051	3T	4	123	474	53	47400	36650	-10750	0.11	0.77	83	64	-19
0051	3T	4	124	481	41	48100	43190	-4910	0.09	0.90	85	76	-9
0051	3T	4	125	380	25	38000	30560	-7440	0.07	0.80	67	54	-13
0051	3T	4	126	371	11	37100	13620	-23480	0.03	0.37	65	24	-41
0051	3T	4	132	335	25	33500	36990	3490	0.07	1.10	59	65	6
0051	3T	4	134	377	33	37700	39920	2220	0.09	1.06	66	70	4
0051	3T	4	135	309	17	30900	32270	1370	0.06	1.04	54	57	3
0051	3T	4	136	250	15	25000	24720	-280	0.06	0.99	44	43	-1
0051	3T	4	142	255	16	25500	13530	-11970	0.06	0.53	45	23	-22
0051	3T	4	143	226	10	22600	16470	-6130	0.04	0.73	40	29	-11
0051	3T	4	145	231	8	23100	11870	-11230	0.03	0.51	40	21	-19
0051	3T	4	146	161	5	16100	12690	-3410	0.03	0.79	28	22	-6
0051	3T	4	152	132	5	13200	7140	-6060	0.04	0.54	23	12	-11
0051	3T	4	153	131	2	13100	3510	-9590	0.02	0.27	23	6	-17
0051	3T	4	154	168	3	16800	7710	-9090	0.02	0.46	29	13	-16
0051	3T	4	156	109	1	10900	3350	-7550	0.01	0.31	19	5	-14
0051	3T	4	162	70	2	7000	2150	-4850	0.03	0.31	12	3	-9
0051	3T	4	163	82	2	8200	10790	2590	0.02	1.32	14	19	5
0051	3T	4	164	86	4	8600	20360	11760	0.05	2.37	15	36	21
0051	3T	4	165	58	1	5800	670	-5130	0.02	0.12	10	1	-9
0051	3T	4	213	71	3	7100	3460	-3640	0.04	0.49	12	6	-6
0051	3T	4	214	52	2	5200	2480	-2720	0.04	0.48	9	4	-5
0051	3T	4	215	50	4	5000	5040	40	0.08	1.01	8	8	0
0051	3T	4	216	64	1	6400	1460	-4940	0.02	0.23	11	2	-9
0051	3T	4	231	35	2	3500	9430	5930	0.06	2.69	6	16	10
0051	3T	4	234	62	3	6200	3980	-2220	0.05	0.64	10	7	-3
0051	3T	4	235	48	0	4800	0	-4800	0.00	0.00	8	0	-8
0051	3T	4	236	56	1	5600	1000	-4600	0.02	0.18	9	1	-8
0051	3T	4	241	28	0	2800	0	-2800	0.00	0.00	4	0	-4
0051	3T	4	243	39	1	3900	1520	-2380	0.03	0.39	6	2	-4
0051	3T	4	245	29	0	2900	0	-2900	0.00	0.00	5	0	-5
0051	3T	4	246	39	1	3900	1190	-2710	0.03	0.31	6	2	-4
0051	3T	4	251	20	0	2000	0	-2000	0.00	0.00	3	0	-3
0051	3T	4	253	30	1	3000	1300	-1700	0.03	0.43	5	2	-3
0051	3T	4	254	31	0	3100	0	-3100	0.00	0.00	5	0	-5
0051	3T	4	256	26	0	2600	0	-2600	0.00	0.00	4	0	-4
0051	3T	4	261	17	0	1700	0	-1700	0.00	0.00	3	0	-3
0051	3T	4	263	23	1	2300	2480	180	0.04	1.08	4	4	0
0051	3T	4	264	14	0	1400	0	-1400	0.00	0.00	2	0	-2
0051	3T	4	265	17	0	1700	0	-1700	0.00	0.00	3	0	-3
0051	3T	5	123	563	65	56300	47260	-9040	0.12	0.84	99	83	-16
0051	3T	5	124	456	35	45600	28470	-17130	0.08	0.62	80	50	-30
0051	3T	5	125	332	18	33200	17180	-16020	0.05	0.52	58	30	-28
0051	3T	5	126	303	19	30300	32280	1980	0.06	1.07	53	57	4
0051	3T	5	132	312	24	31200	22120	-9080	0.08	0.71	55	39	-16
0051	3T	5	134	299	24	29900	31040	1140	0.08	1.04	52	54	2
0051	3T	5	135	266	11	26600	12180	-14420	0.04	0.46	47	21	-26
0051	3T	5	136	207	9	20700	9840	-10860	0.04	0.48	36	17	-19
0051	3T	5	142	197	13	19700	14810	-4890	0.07	0.75	34	26	-8
0051	3T	5	143	220	15	22000	21210	-790	0.07	0.96	38	37	-1
0051	3T	5	145	171	8	17100	19880	2780	0.05	1.16	30	35	5
0051	3T	5	146	144	3	14400	3730	-10670	0.02	0.26	25	6	-19
0051	3T	5	152	106	2	10600	6880	-3720	0.02	0.65	18	12	-6
0051	3T	5	153	106	4	10600	23250	12650	0.04	2.19	18	41	23
0051	3T	5	154	96	3	9600	11250	1650	0.03	1.17	16	19	3
0051	3T	5	156	68	1	6800	3760	-3040	0.01	0.55	12	6	-6
0051	3T	5	162	60	1	6000	6410	410	0.02	1.07	10	11	1
0051	3T	5	163	53	1	5300	850	-4450	0.02	0.16	9	1	-8
0051	3T	5	164	45	2	4500	1430	-3070	0.04	0.32	7	2	-5
0051	3T	5	165	37	0	3700	0	-3700	0.00	0.00	6	0	-6
0051	3T	5	213	29	2	2900	5880	2980	0.07	2.03	5	10	5
0051	3T	5	214	35	1	3500	1110	-2390	0.03	0.32	6	1	-5
0051	3T	5	215	37	2	3700	6850	3150	0.05	1.85	6	12	6
0051	3T	5	216	27	2	2700	22970	20270	0.07	8.51	4	40	36
0051	3T	5	231	9	0	900	0	-900	0.00	0.00	1	0	-1
0051	3T	5	234	31	1	3100	6810	3710	0.03	2.20	5	12	7
0051	3T	5	235	33	1	3300	2060	-1240	0.03	0.62	5	3	-2
0051	3T	5	236	17	0	1700	0	-1700	0.00	0.00	3	0	-3
0051	3T	5	241	8	0	800	0	-800	0.00	0.00	1	0	-1
0051	3T	5	243	13	0	1300	0	-1300	0.00	0.00	2	0	-2
0051	3T	5	245	24	0	2400	0	-2400	0.00	0.00	4	0	-4
0051	3T	5	246	21	0	2100	0	-2100	0.00	0.00	3	0	-3
0051	3T	5	251	6	1	600	1660	1060	0.17	2.77	1	2	1
0051	3T	5	253	8	0	800	0	-800	0.00	0.00	1	0	-1
0051	3T	5	254	9	0	900	0	-900	0.00	0.00	1	0	-1
0051	3T	5	256	13	0	1300	0	-1300	0.00	0.00	2	0	-2
0051	3T	5	261	3	0	300	0	-300	0.00	0.00	0	0	0
0051	3T	5	263	7	0	700	0	-700	0.00	0.00	1	0	-1
0051	3T	5	264	3	0	300	0	-300	0.00	0.00	0	0	0
0051	3T	5	265	7	0	700	0	-700	0.00	0.00	1	0	-1
0051	3T	6	123	39	3	3900	1650	-2250	0.08	0.42	6	2	-4
0051	3T	6	124	40	4	4000	2430	-1570	0.10	0.61	7	4	-3
0051	3T	6	125	24	2	2400	2980	580	0.08	1.24	4	5	1
0051	3T	6	126	25	1	2500	2360	-140	0.04	0.94	4	4	0
0051	3T	6	132	15	2	1500	2440	940	0.13	1.63	2	4	2
0051	3T	6	134	25	2	2500	1530	-970	0.08	0.61	4	2	-2
0051	3T	6	135	25	2	2500	980	-1520	0.08	0.39	4	1	-3
0051	3T	6	136	16	1	1600	2830	1230	0.06	1.77	2	5	3
0051	3T	6	142	14	2	1400	2220	820	0.14	1.59	2	3	1
0051	3T	6	143	12	0	1200	0	-1200	0.00	0.00	2	0	-2
0051	3T	6	145	16	0	1600	0	-1600	0.00	0.00	2	0	-2
0051	3T	6	146	14	0	1400	0	-1400	0.00	0.00	2	0	-2
0051	3T	6	152	6	0	600	0	-600	0.00	0.00	1	0	-1
0051	3T	6	153	8	0	800	0	-800	0.00	0.00	1	0	-1
0051	3T	6	154	12	0	1200	0	-1200	0.00	0.00	2	0	-2
0051	3T	6	156	2	0	200	0	-200	0.00	0.00	0	0	0
0051	3T	6	162	5	0	500	0	-500	0.00	0.00	0	0	0
0051	3T	6	163	5	0	500	0	-500	0.00	0.00	0	0	0
0051	3T	6	164	3	0	300	0	-300	0.00	0.00	0	0	0
0051	3T	6	165	3	0	300	0	-300	0.00	0.00	0	0	0
0051	3T	6	213	1	0	100	0	-100	0.00	0.00	0	0	0
0051	3T	6	215	3	0	300	0	-300	0.00	0.00	0	0	0
0051	3T	6	216	1	0	100	0	-100	0.00	0.00	0	0	0
0051	3T	6	231	2	0	200	0	-200	0.00	0.00	0	0	0
0051	3T	6	234	3	0	300	0	-300	0.00	0.00	0	0	0
0051	3T	6	236	1	0	100	0	-100	0.00	0.00	0	0	0
0051	3T	6	245	1	0	100	0	-100	0.00	0.00	0	0	0
0051	3T	6	246	5	0	500	0	-500	0.00	0.00	0	0	0
0051	3T	6	251	1	0	100	0	-100	0.00	0.00	0	0	0
0051	3T	6	253	3	0	300	0	-300	0.00	0.00	0	0	0
0051	3T	6	254	1	0	100	0	-100	0.00	0.00	0	0	0
0051	3T	6	256	1	0	100	0	-100	0.00	0.00	0	0	0
0051	3T	6	263	1	0	100	0	-100	0.00	0.00	0	0	0
0051	3T	7	123	826	86	82600	71960	-10640	0.10	0.87	146	127	-19
0051	3T	7	124	838	55	83800	56520	-27280	0.07	0.67	148	100	-48
0051	3T	7	125	566	33	56600	40890	-15710	0.06	0.72	100	72	-28
0051	3T	7	126	480	21	48000	40720	-7280	0.04	0.85	84	72	-12
0051	3T	7	132	471	36	47100	42620	-4480	0.08	0.90	83	75	-8
0051	3T	7	134	530	43	53000	53590	590	0.08	1.01	93	94	1
0051	3T	7	135	373	17	37300	23930	-13370	0.05	0.64	66	42	-24
0051	3T	7	136	377	21	37700	37700	0	0.06	1.00	66	66	0
0051	3T	7	142	386	25	38600	28340	-10260	0.06	0.73	68	50	-18
0051	3T	7	143	313	13	31300	23920	-7380	0.04	0.76	55	42	-13
0051	3T	7	145	279	7	27900	15190	-12710	0.03	0.54	49	26	-23
0051	3T	7	146	280	8	28000	24530	-3470	0.03	0.88	49	43	-6
0051	3T	7	152	188	7	18800	14820	-3980	0.04	0.79	33	26	-7
0051	3T	7	153	182	7	18200	20700	2500	0.04	1.14	32	36	4
0051	3T	7	154	195	5	19500	13270	-6230	0.03	0.68	34	23	-11
0051	3T	7	156	136	3	13600	5500	-8100	0.02	0.40	24	9	-15
0051	3T	7	162	95	4	9500	8410	-1090	0.04	0.89	16	14	-2
0051	3T	7	163	98	1	9800	3120	-6680	0.01	0.32	17	5	-12
0051	3T	7	164	104	1	10400	1080	-9320	0.01	0.10	18	1	-17
0051	3T	7	165	82	3	8200	7840	-360	0.04	0.96	14	13	-1
0051	3T	7	213	42	1	4200	1350	-2850	0.02	0.32	7	2	-5
0051	3T	7	214	70	3	7000	6430	-570	0.04	0.92	12	11	-1
0051	3T	7	215	65	1	6500	1500	-5000	0.02	0.23	11	2	-9
0051	3T	7	216	44	2	4400	3730	-670	0.05	0.85	7	6	-1
0051	3T	7	231	21	1	2100	1650	-450	0.05	0.79	3	2	-1
0051	3T	7	234	42	1	4200	8350	4150	0.02	1.99	7	14	7
0051	3T	7	235	39	0	3900	0	-3900	0.00	0.00	6	0	-6
0051	3T	7	236	45	1	4500	5750	1250	0.02	1.28	7	10	3
0051	3T	7	241	23	0	2300	0	-2300	0.00	0.00	4	0	-4
0051	3T	7	243	32	1	3200	820	-2380	0.03	0.26	5	1	-4
0051	3T	7	245	21	0	2100	0	-2100	0.00	0.00	3	0	-3
0051	3T	7	246	34	0	3400	0	-3400	0.00	0.00	6	0	-6
0051	3T	7	251	9	0	900	0	-900	0.00	0.00	1	0	-1
0051	3T	7	253	21	0	2100	0	-2100	0.00	0.00	3	0	-3
0051	3T	7	254	21	0	2100	0	-2100	0.00	0.00	3	0	-3
0051	3T	7	256	16	0	1600	0	-1600	0.00	0.00	2	0	-2
0051	3T	7	261	8	0	800	0	-800	0.00	0.00	1	0	-1
0051	3T	7	263	13	0	1300	0	-1300	0.00	0.00	2	0	-2
0051	3T	7	264	16	0	1600	0	-1600	0.00	0.00	2	0	-2
0051	3T	7	265	8	0	800	0	-800	0.00	0.00	1	0	-1
0052	1T	01	1	2087	1269	208700	195080	-13620	0.61	0.93	369	345	-24
0052	1T	01	2	441	126	44100	38420	-5680	0.29	0.87	78	68	-10
0052	1T	02	1	1977	992	197700	170410	-27290	0.50	0.86	349	301	-48
0052	1T	02	2	477	122	47700	30960	-16740	0.26	0.65	84	54	-30
0052	1T	03	1	1509	789	150900	143720	-7180	0.52	0.95	267	254	-13
0052	1T	03	2	369	112	36900	34530	-2370	0.30	0.94	65	61	-4
0052	1T	04	1	1746	925	174600	154600	-20000	0.53	0.89	309	273	-36
0052	1T	04	2	454	125	45400	37050	-8350	0.28	0.82	80	65	-15
0052	1T	05	1	2101	1273	210100	204540	-5560	0.61	0.97	371	362	-9
0052	1T	05	2	479	146	47900	46870	-1030	0.30	0.98	84	82	-2
0052	1T	06	1	2244	1250	224400	198640	-25760	0.56	0.89	397	351	-46
0052	1T	06	2	471	156	47100	45850	-1250	0.33	0.97	83	81	-2
0052	1T	07	1	2337	1426	233700	219370	-14330	0.61	0.94	413	388	-25
0052	1T	07	2	417	113	41700	33810	-7890	0.27	0.81	73	59	-14
0052	1T	08	1	2300	1399	230000	208240	-21760	0.61	0.91	407	368	-39
0052	1T	08	2	342	86	34200	27250	-6950	0.25	0.80	60	48	-12
0052	1T	09	1	2379	1558	237900	230640	-7260	0.65	0.97	421	408	-13
0052	1T	09	2	454	158	45400	41020	-4380	0.35	0.90	80	72	-8
0052	1T	10	1	2137	1310	213700	191300	-22400	0.61	0.90	378	338	-40
0052	1T	10	2	458	158	45800	44190	-1610	0.34	0.96	81	78	-3
0052	1T	11	1	1839	1021	183900	158250	-25650	0.56	0.86	325	280	-45
0052	1T	11	2	441	130	44100	33710	-10390	0.29	0.76	78	59	-19
0052	1T	12	1	2083	1293	208300	185830	-22470	0.62	0.89	368	328	-40
0052	1T	12	2	417	123	41700	33580	-8120	0.29	0.81	73	59	-14
0052	1T	13	1	2013	1304	201300	194030	-7270	0.65	0.96	356	343	-13
0052	1T	13	2	394	123	39400	37650	-1750	0.31	0.96	69	66	-3
0052	1T	14	1	1938	1097	193800	171160	-22640	0.57	0.88	343	302	-41
0052	1T	14	2	443	143	44300	45020	720	0.32	1.02	78	79	1
0052	1T	15	1	2333	1390	233300	206900	-26400	0.60	0.89	412	366	-46
0052	1T	15	2	435	123	43500	40410	-3090	0.28	0.93	76	71	-5
0052	1T	16	1	2406	1504	240600	219540	-21060	0.63	0.91	425	388	-37
0052	1T	16	2	468	120	46800	34970	-11830	0.26	0.75	82	61	-21
0052	1T	17	1	2397	1509	239700	225360	-14340	0.63	0.94	424	398	-26
0052	1T	17	2	414	144	41400	42130	730	0.35	1.02	73	74	1
0052	1T	18	1	2580	1831	258000	244690	-13310	0.71	0.95	456	433	-23
0052	1T	18	2	435	153	43500	44030	530	0.35	1.01	76	77	1
0052	1T	19	1	2197	1407	219700	203520	-16180	0.64	0.93	388	360	-28
0052	1T	19	2	351	108	35100	39260	4160	0.31	1.12	62	69	7
0052	1T	20	1	2346	1414	234600	212590	-22010	0.60	0.91	415	376	-39
0052	1T	20	2	360	102	36000	37150	1150	0.28	1.03	63	65	2
0052	1T	21	1	2603	1716	260300	236230	-24070	0.66	0.91	460	418	-42
0052	1T	21	2	266	75	26600	21470	-5130	0.28	0.81	47	38	-9
0052	1T	22	1	1818	1078	181800	164390	-17410	0.59	0.90	321	290	-31
0052	1T	22	2	470	134	47000	36120	-10880	0.29	0.77	83	63	-20
0052	1T	23	1	2147	1294	214700	191040	-23660	0.60	0.89	380	338	-42
0052	1T	23	2	406	111	40600	30900	-9700	0.27	0.76	71	54	-17
0052	1T	24	1	2487	1818	248700	243720	-4980	0.73	0.98	440	431	-9
0052	1T	24	2	313	99	31300	30790	-510	0.32	0.98	55	54	-1
0052	2F	01	12	710	204	71000	55030	-15970	0.29	0.78	125	97	-28
0052	2F	01	13	410	106	41000	39450	-1550	0.26	0.96	72	69	-3
0052	2F	01	14	289	54	28900	20250	-8650	0.19	0.70	51	35	-16
0052	2F	01	15	228	41	22800	15900	-6900	0.18	0.70	40	28	-12
0052	2F	01	16	106	8	10600	3430	-7170	0.08	0.32	18	6	-12
0052	2F	01	23	95	19	9500	6720	-2780	0.20	0.71	16	11	-5
0052	2F	01	24	72	7	7200	3570	-3630	0.10	0.50	12	6	-6
0052	2F	01	25	34	1	3400	630	-2770	0.03	0.19	6	1	-5
0052	2F	01	26	18	2	1800	1240	-560	0.11	0.69	3	2	-1
0052	2F	02	12	731	197	73100	63110	-9990	0.27	0.86	129	111	-18
0052	2F	02	13	412	84	41200	33430	-7770	0.20	0.81	72	59	-13
0052	2F	02	14	295	52	29500	25600	-3900	0.18	0.87	52	45	-7
0052	2F	02	15	181	26	18100	17640	-460	0.14	0.97	32	31	-1
0052	2F	02	16	123	13	12300	8690	-3610	0.11	0.71	21	15	-6
0052	2F	02	23	83	8	8300	3710	-4590	0.10	0.45	14	6	-8
0052	2F	02	24	52	7	5200	4480	-720	0.13	0.86	9	7	-2
0052	2F	02	25	41	7	4100	3210	-890	0.17	0.78	7	5	-2
0052	2F	02	26	36	2	3600	1670	-1930	0.06	0.46	6	2	-4
0052	2F	03	12	501	143	50100	42400	-7700	0.29	0.85	88	75	-13
0052	2F	03	13	306	74	30600	30130	-470	0.24	0.98	54	53	-1
0052	2F	03	14	234	40	23400	22070	-1330	0.17	0.94	41	39	-2
0052	2F	03	15	149	21	14900	11310	-3590	0.14	0.76	26	20	-6
0052	2F	03	16	97	9	9700	13230	3530	0.09	1.36	17	23	6
0052	2F	03	23	70	6	7000	4770	-2230	0.09	0.68	12	8	-4
0052	2F	03	24	55	4	5500	3010	-2490	0.07	0.55	9	5	-4
0052	2F	03	25	39	6	3900	2900	-1000	0.15	0.74	6	5	-1
0052	2F	03	26	33	0	3300	0	-3300	0.00	0.00	5	0	-5
0052	2F	04	12	593	174	59300	59230	-70	0.29	1.00	104	104	0
0052	2F	04	13	356	81	35600	30570	-5030	0.23	0.86	63	54	-9
0052	2F	04	14	273	41	27300	16170	-11130	0.15	0.59	48	28	-20
0052	2F	04	15	175	23	17500	12120	-5380	0.13	0.69	30	21	-9
0052	2F	04	16	136	19	13600	12300	-1300	0.14	0.90	24	21	-3
0052	2F	04	23	85	10	8500	6460	-2040	0.12	0.76	15	11	-4
0052	2F	04	24	58	6	5800	3630	-2170	0.10	0.63	10	6	-4
0052	2F	04	25	39	2	3900	1810	-2090	0.05	0.46	6	3	-3
0052	2F	04	26	35	2	3500	780	-2720	0.06	0.22	6	1	-5
0052	2F	05	12	718	197	71800	60620	-11180	0.27	0.84	127	107	-20
0052	2F	05	13	436	96	43600	32750	-10850	0.22	0.75	77	57	-20
0052	2F	05	14	353	83	35300	27170	-8130	0.24	0.77	62	48	-14
0052	2F	05	15	209	37	20900	19770	-1130	0.18	0.95	36	34	-2
0052	2F	05	16	127	14	12700	13940	1240	0.11	1.10	22	24	2
0052	2F	05	23	99	13	9900	4730	-5170	0.13	0.48	17	8	-9
0052	2F	05	24	55	7	5500	2710	-2790	0.13	0.49	9	4	-5
0052	2F	05	25	61	7	6100	4840	-1260	0.11	0.79	10	8	-2
0052	2F	05	26	34	3	3400	2780	-620	0.09	0.82	6	4	-2
0052	2F	06	12	737	210	73700	64700	-9000	0.28	0.88	130	114	-16
0052	2F	06	13	449	107	44900	33210	-11690	0.24	0.74	79	58	-21
0052	2F	06	14	354	63	35400	26690	-8710	0.18	0.75	62	47	-15
0052	2F	06	15	215	34	21500	18990	-2510	0.16	0.88	38	33	-5
0052	2F	06	16	166	19	16600	15520	-1080	0.11	0.93	29	27	-2
0052	2F	06	23	79	13	7900	5390	-2510	0.16	0.68	13	9	-4
0052	2F	06	24	59	10	5900	5760	-140	0.17	0.98	10	10	0
0052	2F	06	25	50	5	5000	3860	-1140	0.10	0.77	8	6	-2
0052	2F	06	26	37	2	3700	990	-2710	0.05	0.27	6	1	-5
0052	2F	07	12	715	218	71500	66350	-5150	0.30	0.93	126	117	-9
0052	2F	07	13	472	136	47200	46050	-1150	0.29	0.98	83	81	-2
0052	2F	07	14	375	78	37500	28140	-9360	0.21	0.75	66	49	-17
0052	2F	07	15	267	37	26700	19730	-6970	0.14	0.74	47	34	-13
0052	2F	07	16	163	22	16300	15200	-1100	0.13	0.93	28	26	-2
0052	2F	07	23	65	8	6500	2900	-3600	0.12	0.45	11	5	-6
0052	2F	07	24	56	2	5600	740	-4860	0.04	0.13	9	1	-8
0052	2F	07	25	58	2	5800	1040	-4760	0.03	0.18	10	1	-9
0052	2F	07	26	41	5	4100	4740	640	0.12	1.16	7	8	1
0052	2F	08	12	717	227	71700	66210	-5490	0.32	0.92	126	117	-9
0052	2F	08	13	468	100	46800	30050	-16750	0.21	0.64	82	53	-29
0052	2F	08	14	364	71	36400	23700	-12700	0.20	0.65	64	41	-23
0052	2F	08	15	214	27	21400	19530	-1870	0.13	0.91	37	34	-3
0052	2F	08	16	161	19	16100	8740	-7360	0.12	0.54	28	15	-13
0052	2F	08	23	70	8	7000	4970	-2030	0.11	0.71	12	8	-4
0052	2F	08	24	38	2	3800	2850	-950	0.05	0.75	6	5	-1
0052	2F	08	25	46	4	4600	5540	940	0.09	1.20	8	9	1
0052	2F	08	26	31	1	3100	130	-2970	0.03	0.04	5	0	-5
0052	2F	09	12	864	319	86400	83710	-2690	0.37	0.97	152	148	-4
0052	2F	09	13	526	143	52600	44400	-8200	0.27	0.84	93	78	-15
0052	2F	09	14	378	64	37800	24870	-12930	0.17	0.66	66	44	-22
0052	2F	09	15	230	33	23000	20140	-2860	0.14	0.88	40	35	-5
0052	2F	09	16	123	17	12300	11990	-310	0.14	0.97	21	21	0
0052	2F	09	23	86	11	8600	4570	-4030	0.13	0.53	15	8	-7
0052	2F	09	24	69	11	6900	4530	-2370	0.16	0.66	12	8	-4
0052	2F	09	25	41	2	4100	1450	-2650	0.05	0.35	7	2	-5
0052	2F	09	26	41	5	4100	5480	1380	0.12	1.34	7	9	2
0052	2F	10	12	742	233	74200	57630	-16570	0.31	0.78	131	102	-29
0052	2F	10	13	517	145	51700	47480	-4220	0.28	0.92	91	84	-7
0052	2F	10	14	324	60	32400	29090	-3310	0.19	0.90	57	51	-6
0052	2F	10	15	177	26	17700	18280	580	0.15	1.03	31	32	1
0052	2F	10	16	110	13	11000	11170	170	0.12	1.02	19	19	0
0052	2F	10	23	82	7	8200	4340	-3860	0.09	0.53	14	7	-7
0052	2F	10	24	70	8	7000	6600	-400	0.11	0.94	12	11	-1
0052	2F	10	25	38	4	3800	1650	-2150	0.11	0.43	6	2	-4
0052	2F	10	26	41	6	4100	2930	-1170	0.15	0.71	7	5	-2
0052	2F	11	12	689	254	68900	70040	1140	0.37	1.02	121	123	2
0052	2F	11	13	323	73	32300	24560	-7740	0.23	0.76	57	43	-14
0052	2F	11	14	327	57	32700	24020	-8680	0.17	0.73	57	42	-15
0052	2F	11	15	174	17	17400	14150	-3250	0.10	0.81	30	25	-5
0052	2F	11	16	77	6	7700	8510	810	0.08	1.11	13	15	2
0052	2F	11	23	76	13	7600	11130	3530	0.17	1.46	13	19	6
0052	2F	11	24	56	5	5600	2150	-3450	0.09	0.38	9	3	-6
0052	2F	11	25	61	3	6100	1440	-4660	0.05	0.24	10	2	-8
0052	2F	11	26	33	6	3300	4900	1600	0.18	1.48	5	8	3
0052	2F	12	12	725	226	72500	58100	-14400	0.31	0.80	128	102	-26
0052	2F	12	13	414	107	41400	37730	-3670	0.26	0.91	73	66	-7
0052	2F	12	14	292	54	29200	20980	-8220	0.18	0.72	51	37	-14
0052	2F	12	15	194	27	19400	15270	-4130	0.14	0.79	34	27	-7
0052	2F	12	16	149	17	14900	11420	-3480	0.11	0.77	26	20	-6
0052	2F	12	23	79	5	7900	1280	-6620	0.06	0.16	13	2	-11
0052	2F	12	24	62	4	6200	2410	-3790	0.06	0.39	10	4	-6
0052	2F	12	25	34	3	3400	1930	-1470	0.09	0.57	6	3	-3
0052	2F	12	26	32	1	3200	730	-2470	0.03	0.23	5	1	-4
0052	2F	13	12	682	228	68200	66670	-1530	0.33	0.98	120	118	-2
0052	2F	13	13	408	102	40800	31510	-9290	0.25	0.77	72	55	-17
0052	2F	13	14	327	66	32700	21220	-11480	0.20	0.65	57	37	-20
0052	2F	13	15	178	27	17800	16790	-1010	0.15	0.94	31	29	-2
0052	2F	13	16	133	20	13300	10430	-2870	0.15	0.78	23	18	-5
0052	2F	13	23	67	9	6700	5820	-880	0.13	0.87	11	10	-1
0052	2F	13	24	52	6	5200	3070	-2130	0.12	0.59	9	5	-4
0052	2F	13	25	35	3	3500	1100	-2400	0.09	0.31	6	1	-5
0052	2F	13	26	25	2	2500	1330	-1170	0.08	0.53	4	2	-2
0052	2F	14	12	671	184	67100	51330	-15770	0.27	0.76	118	90	-28
0052	2F	14	13	372	76	37200	23840	-13360	0.20	0.64	65	42	-23
0052	2F	14	14	307	61	30700	22550	-8150	0.20	0.73	54	39	-15
0052	2F	14	15	195	19	19500	11840	-7660	0.10	0.61	34	20	-14
0052	2F	14	16	119	15	11900	9650	-2250	0.13	0.81	21	17	-4
0052	2F	14	23	88	12	8800	7550	-1250	0.14	0.86	15	13	-2
0052	2F	14	24	61	7	6100	3830	-2270	0.11	0.63	10	6	-4
0052	2F	14	25	47	6	4700	4930	230	0.13	1.05	8	8	0
0052	2F	14	26	30	5	3000	2700	-300	0.17	0.90	5	4	-1
0052	2F	15	12	803	231	80300	63610	-16690	0.29	0.79	142	112	-30
0052	2F	15	13	444	109	44400	32630	-11770	0.25	0.73	78	57	-21
0052	2F	15	14	404	92	40400	35980	-4420	0.23	0.89	71	63	-8
0052	2F	15	15	217	29	21700	15540	-6160	0.13	0.72	38	27	-11
0052	2F	15	16	140	14	14000	10770	-3230	0.10	0.77	24	19	-5
0052	2F	15	23	82	4	8200	3230	-4970	0.05	0.39	14	5	-9
0052	2F	15	24	64	8	6400	9030	2630	0.13	1.41	11	15	4
0052	2F	15	25	35	1	3500	400	-3100	0.03	0.11	6	0	-6
0052	2F	15	26	36	6	3600	6760	3160	0.17	1.88	6	11	5
0052	2F	16	12	815	261	81500	68490	-13010	0.32	0.84	144	121	-23
0052	2F	16	13	506	110	50600	32730	-17870	0.22	0.65	89	57	-32
0052	2F	16	14	423	115	42300	42470	170	0.27	1.00	74	75	1
0052	2F	16	15	199	24	19900	13870	-6030	0.12	0.70	35	24	-11
0052	2F	16	16	134	11	13400	8740	-4660	0.08	0.65	23	15	-8
0052	2F	16	23	80	10	8000	9610	1610	0.13	1.20	14	17	3
0052	2F	16	24	71	3	7100	2650	-4450	0.04	0.37	12	4	-8
0052	2F	16	25	47	7	4700	6610	1910	0.15	1.41	8	11	3
0052	2F	16	26	39	3	3900	4030	130	0.08	1.03	6	7	1
0052	2F	17	12	845	246	84500	64120	-20380	0.29	0.76	149	113	-36
0052	2F	17	13	526	145	52600	40260	-12340	0.28	0.77	93	71	-22
0052	2F	17	14	385	71	38500	25170	-13330	0.18	0.65	68	44	-24
0052	2F	17	15	194	16	19400	9460	-9940	0.08	0.49	34	16	-18
0052	2F	17	16	107	12	10700	13750	3050	0.11	1.29	18	24	6
0052	2F	17	23	71	7	7100	4040	-3060	0.10	0.57	12	7	-5
0052	2F	17	24	51	4	5100	3270	-1830	0.08	0.64	9	5	-4
0052	2F	17	25	42	3	4200	1060	-3140	0.07	0.25	7	1	-6
0052	2F	17	26	30	3	3000	1560	-1440	0.10	0.52	5	2	-3
0052	2F	18	12	921	357	92100	83150	-8950	0.39	0.90	163	147	-16
0052	2F	18	13	511	128	51100	39650	-11450	0.25	0.78	90	70	-20
0052	2F	18	14	448	101	44800	42580	-2220	0.23	0.95	79	75	-4
0052	2F	18	15	265	50	26500	30050	3550	0.19	1.13	46	53	7
0052	2F	18	16	122	12	12200	5680	-6520	0.10	0.47	21	10	-11
0052	2F	18	23	75	9	7500	4500	-3000	0.12	0.60	13	7	-6
0052	2F	18	24	48	3	4800	6040	1240	0.06	1.26	8	10	2
0052	2F	18	25	41	3	4100	1100	-3000	0.07	0.27	7	1	-6
0052	2F	18	26	24	4	2400	3050	650	0.17	1.27	4	5	1
0052	2F	19	12	757	244	75700	67380	-8320	0.32	0.89	133	119	-14
0052	2F	19	13	479	140	47900	37400	-10500	0.29	0.78	84	66	-18
0052	2F	19	14	396	113	39600	35900	-3700	0.29	0.91	70	63	-7
0052	2F	19	15	173	22	17300	13710	-3590	0.13	0.79	30	24	-6
0052	2F	19	16	98	14	9800	8560	-1240	0.14	0.87	17	15	-2
0052	2F	19	23	62	7	6200	3590	-2610	0.11	0.58	10	6	-4
0052	2F	19	24	59	7	5900	2540	-3360	0.12	0.43	10	4	-6
0052	2F	19	25	28	2	2800	2540	-260	0.07	0.91	4	4	0
0052	2F	19	26	39	5	3900	2200	-1700	0.13	0.56	6	3	-3
0052	2F	20	12	784	249	78400	62280	-16120	0.32	0.79	138	110	-28
0052	2F	20	13	471	147	47100	46190	-910	0.31	0.98	83	81	-2
0052	2F	20	14	381	75	38100	28270	-9830	0.20	0.74	67	50	-17
0052	2F	20	15	229	44	22900	19310	-3590	0.19	0.84	40	34	-6
0052	2F	20	16	140	20	14000	9990	-4010	0.14	0.71	24	17	-7
0052	2F	20	23	60	9	6000	4380	-1620	0.15	0.73	10	7	-3
0052	2F	20	24	39	4	3900	3820	-80	0.10	0.98	6	6	0
0052	2F	20	25	40	2	4000	3400	-600	0.05	0.85	7	6	-1
0052	2F	20	26	23	4	2300	7060	4760	0.17	3.07	4	12	8
0052	2F	21	12	889	296	88900	71770	-17130	0.33	0.81	157	127	-30
0052	2F	21	13	604	196	60400	56530	-3870	0.32	0.94	106	100	-6
0052	2F	21	14	404	106	40400	35380	-5020	0.26	0.88	71	62	-9
0052	2F	21	15	258	40	25800	18890	-6910	0.16	0.73	45	33	-12
0052	2F	21	16	98	6	9800	3610	-6190	0.06	0.37	17	6	-11
0052	2F	21	23	39	10	3900	7000	3100	0.26	1.79	6	12	6
0052	2F	21	24	33	4	3300	2300	-1000	0.12	0.70	5	4	-1
0052	2F	21	25	21	1	2100	280	-1820	0.05	0.13	3	0	-3
0052	2F	21	26	13	0	1300	0	-1300	0.00	0.00	2	0	-2
0052	2F	22	12	621	200	62100	55750	-6350	0.32	0.90	109	98	-11
0052	2F	22	13	388	101	38800	31320	-7480	0.26	0.81	68	55	-13
0052	2F	22	14	275	47	27500	21070	-6430	0.17	0.77	48	37	-11
0052	2F	22	15	166	23	16600	19360	2760	0.14	1.17	29	34	5
0052	2F	22	16	99	3	9900	1180	-8720	0.03	0.12	17	2	-15
0052	2F	22	23	91	17	9100	9480	380	0.19	1.04	16	16	0
0052	2F	22	24	56	5	5600	3920	-1680	0.09	0.70	9	6	-3
0052	2F	22	25	55	9	5500	4300	-1200	0.16	0.78	9	7	-2
0052	2F	22	26	22	0	2200	0	-2200	0.00	0.00	3	0	-3
0052	2F	23	12	724	225	72400	54530	-17870	0.31	0.75	128	96	-32
0052	2F	23	13	463	140	46300	44520	-1780	0.30	0.96	81	78	-3
0052	2F	23	14	315	56	31500	25710	-5790	0.18	0.82	55	45	-10
0052	2F	23	15	179	23	17900	11380	-6520	0.13	0.64	31	20	-11
0052	2F	23	16	104	16	10400	10500	100	0.15	1.01	18	18	0
0052	2F	23	23	84	13	8400	7210	-1190	0.15	0.86	14	12	-2
0052	2F	23	24	64	7	6400	2810	-3590	0.11	0.44	11	4	-7
0052	2F	23	25	31	3	3100	1570	-1530	0.10	0.51	5	2	-3
0052	2F	23	26	27	1	2700	690	-2010	0.04	0.26	4	1	-3
0052	2F	24	12	907	307	90700	71320	-19380	0.34	0.79	160	126	-34
0052	2F	24	13	533	168	53300	45260	-8040	0.32	0.85	94	80	-14
0052	2F	24	14	389	86	38900	29820	-9080	0.22	0.77	68	52	-16
0052	2F	24	15	170	28	17000	17370	370	0.16	1.02	30	30	0
0052	2F	24	16	138	27	13800	19210	5410	0.20	1.39	24	34	10
0052	2F	24	23	68	7	6800	4100	-2700	0.10	0.60	12	7	-5
0052	2F	24	24	32	3	3200	1380	-1820	0.09	0.43	5	2	-3
0052	2F	24	25	21	1	2100	290	-1810	0.05	0.14	3	0	-3
0052	2F	24	26	21	4	2100	2690	590	0.19	1.28	3	4	1
0052	2T	01	12	603	148	60300	52390	-7910	0.25	0.87	106	92	-14
0052	2T	01	13	410	83	41000	38390	-2610	0.20	0.94	72	67	-5
0052	2T	01	14	289	43	28900	21000	-7900	0.15	0.73	51	37	-14
0052	2T	01	15	228	29	22800	15430	-7370	0.13	0.68	40	27	-13
0052	2T	01	16	106	6	10600	4490	-6110	0.06	0.42	18	7	-11
0052	2T	01	21	107	15	10700	17560	6860	0.14	1.64	18	31	13
0052	2T	01	23	95	10	9500	5180	-4320	0.11	0.55	16	9	-7
0052	2T	01	24	72	3	7200	4040	-3160	0.04	0.56	12	7	-5
0052	2T	01	25	34	1	3400	1300	-2100	0.03	0.38	6	2	-4
0052	2T	01	26	18	2	1800	1350	-450	0.11	0.75	3	2	-1
0052	2T	02	12	597	128	59700	52450	-7250	0.21	0.88	105	92	-13
0052	2T	02	13	412	58	41200	31880	-9320	0.14	0.77	72	56	-16
0052	2T	02	14	295	36	29500	24430	-5070	0.12	0.83	52	43	-9
0052	2T	02	15	181	17	18100	16540	-1560	0.09	0.91	32	29	-3
0052	2T	02	16	123	9	12300	9030	-3270	0.07	0.73	21	15	-6
0052	2T	02	21	134	13	13400	8940	-4460	0.10	0.67	23	15	-8
0052	2T	02	23	83	2	8300	720	-7580	0.02	0.09	14	1	-13
0052	2T	02	24	52	5	5200	5510	310	0.10	1.06	9	9	0
0052	2T	02	25	41	5	4100	3150	-950	0.12	0.77	7	5	-2
0052	2T	02	26	36	2	3600	3480	-120	0.06	0.97	6	6	0
0052	2T	03	12	422	87	42200	35340	-6860	0.21	0.84	74	62	-12
0052	2T	03	13	306	56	30600	29100	-1500	0.18	0.95	54	51	-3
0052	2T	03	14	234	29	23400	22150	-1250	0.12	0.95	41	39	-2
0052	2T	03	15	149	14	14900	9400	-5500	0.09	0.63	26	16	-10
0052	2T	03	16	97	6	9700	11780	2080	0.06	1.21	17	20	3
0052	2T	03	21	79	8	7900	5710	-2190	0.10	0.72	13	10	-3
0052	2T	03	23	70	5	7000	6040	-960	0.07	0.86	12	10	-2
0052	2T	03	24	55	3	5500	2210	-3290	0.05	0.40	9	3	-6
0052	2T	03	25	39	4	3900	3290	-610	0.10	0.84	6	5	-1
0052	2T	03	26	33	0	3300	0	-3300	0.00	0.00	5	0	-5
0052	2T	04	12	494	106	49400	46000	-3400	0.21	0.93	87	81	-6
0052	2T	04	13	356	62	35600	31000	-4600	0.17	0.87	63	54	-9
0052	2T	04	14	273	27	27300	13820	-13480	0.10	0.51	48	24	-24
0052	2T	04	15	175	18	17500	13420	-4080	0.10	0.77	30	23	-7
0052	2T	04	16	136	12	13600	13040	-560	0.09	0.96	24	23	-1
0052	2T	04	21	99	11	9900	8930	-970	0.11	0.90	17	15	-2
0052	2T	04	23	85	6	8500	5090	-3410	0.07	0.60	15	9	-6
0052	2T	04	24	58	4	5800	1820	-3980	0.07	0.31	10	3	-7
0052	2T	04	25	39	1	3900	1200	-2700	0.03	0.31	6	2	-4
0052	2T	04	26	35	0	3500	0	-3500	0.00	0.00	6	0	-6
0052	2T	05	12	610	134	61000	55370	-5630	0.22	0.91	107	98	-9
0052	2T	05	13	436	72	43600	32130	-11470	0.17	0.74	77	56	-21
0052	2T	05	14	353	62	35300	29210	-6090	0.18	0.83	62	51	-11
0052	2T	05	15	209	31	20900	22380	1480	0.15	1.07	36	39	3
0052	2T	05	16	127	10	12700	11260	-1440	0.08	0.89	22	19	-3
0052	2T	05	21	108	13	10800	9790	-1010	0.12	0.91	19	17	-2
0052	2T	05	23	99	10	9900	6030	-3870	0.10	0.61	17	10	-7
0052	2T	05	24	55	2	5500	1390	-4110	0.04	0.25	9	2	-7
0052	2T	05	25	61	6	6100	5990	-110	0.10	0.98	10	10	0
0052	2T	05	26	34	2	3400	2590	-810	0.06	0.76	6	4	-2
0052	2T	06	12	649	144	64900	60570	-4330	0.22	0.93	114	107	-7
0052	2T	06	13	449	81	44900	33790	-11110	0.18	0.75	79	59	-20
0052	2T	06	14	354	47	35400	27580	-7820	0.13	0.78	62	48	-14
0052	2T	06	15	215	21	21500	17860	-3640	0.10	0.83	38	31	-7
0052	2T	06	16	166	14	16600	13510	-3090	0.08	0.81	29	23	-6
0052	2T	06	21	88	7	8800	5220	-3580	0.08	0.59	15	9	-6
0052	2T	06	23	79	8	7900	7040	-860	0.10	0.89	13	12	-1
0052	2T	06	24	59	6	5900	5420	-480	0.10	0.92	10	9	-1
0052	2T	06	25	50	5	5000	4530	-470	0.10	0.91	8	8	0
0052	2T	06	26	37	1	3700	810	-2890	0.03	0.22	6	1	-5
0052	2T	07	12	626	137	62600	50510	-12090	0.22	0.81	110	89	-21
0052	2T	07	13	472	107	47200	45240	-1960	0.23	0.96	83	80	-3
0052	2T	07	14	375	60	37500	27770	-9730	0.16	0.74	66	49	-17
0052	2T	07	15	267	27	26700	17390	-9310	0.10	0.65	47	30	-17
0052	2T	07	16	163	16	16300	15160	-1140	0.10	0.93	28	26	-2
0052	2T	07	21	89	9	8900	6940	-1960	0.10	0.78	15	12	-3
0052	2T	07	23	65	4	6500	1760	-4740	0.06	0.27	11	3	-8
0052	2T	07	24	56	1	5600	430	-5170	0.02	0.08	9	0	-9
0052	2T	07	25	58	1	5800	1090	-4710	0.02	0.19	10	1	-9
0052	2T	07	26	41	4	4100	3740	-360	0.10	0.91	7	6	-1
0052	2T	08	12	656	170	65600	62010	-3590	0.26	0.95	116	109	-7
0052	2T	08	13	468	77	46800	28460	-18340	0.16	0.61	82	50	-32
0052	2T	08	14	364	54	36400	22750	-13650	0.15	0.63	64	40	-24
0052	2T	08	15	214	21	21400	18360	-3040	0.10	0.86	37	32	-5
0052	2T	08	16	161	14	16100	10260	-5840	0.09	0.64	28	18	-10
0052	2T	08	21	61	10	6100	10320	4220	0.16	1.69	10	18	8
0052	2T	08	23	70	6	7000	8340	1340	0.09	1.19	12	14	2
0052	2T	08	24	38	1	3800	350	-3450	0.03	0.09	6	0	-6
0052	2T	08	25	46	1	4600	1410	-3190	0.02	0.31	8	2	-6
0052	2T	08	26	31	1	3100	780	-2320	0.03	0.25	5	1	-4
0052	2T	09	12	770	220	77000	68690	-8310	0.29	0.89	136	121	-15
0052	2T	09	13	526	113	52600	42400	-10200	0.21	0.81	93	75	-18
0052	2T	09	14	378	54	37800	23870	-13930	0.14	0.63	66	42	-24
0052	2T	09	15	230	25	23000	14660	-8340	0.11	0.64	40	25	-15
0052	2T	09	16	123	11	12300	10850	-1450	0.09	0.88	21	19	-2
0052	2T	09	21	94	19	9400	13610	4210	0.20	1.45	16	24	8
0052	2T	09	23	86	9	8600	7120	-1480	0.10	0.83	15	12	-3
0052	2T	09	24	69	6	6900	3070	-3830	0.09	0.44	12	5	-7
0052	2T	09	25	41	1	4100	1070	-3030	0.02	0.26	7	1	-6
0052	2T	09	26	41	3	4100	4020	-80	0.07	0.98	7	7	0
0052	2T	10	12	650	157	65000	49540	-15460	0.24	0.76	115	87	-28
0052	2T	10	13	517	111	51700	46660	-5040	0.21	0.90	91	82	-9
0052	2T	10	14	324	50	32400	29650	-2750	0.15	0.92	57	52	-5
0052	2T	10	15	177	20	17700	19210	1510	0.11	1.09	31	34	3
0052	2T	10	16	110	6	11000	6780	-4220	0.05	0.62	19	12	-7
0052	2T	10	21	92	10	9200	5520	-3680	0.11	0.60	16	9	-7
0052	2T	10	23	82	4	8200	1620	-6580	0.05	0.20	14	2	-12
0052	2T	10	24	70	4	7000	8320	1320	0.06	1.19	12	14	2
0052	2T	10	25	38	3	3800	2130	-1670	0.08	0.56	6	3	-3
0052	2T	10	26	41	4	4100	3100	-1000	0.10	0.76	7	5	-2
0052	2T	11	12	578	155	57800	50380	-7420	0.27	0.87	102	89	-13
0052	2T	11	13	323	52	32300	22200	-10100	0.16	0.69	57	39	-18
0052	2T	11	14	327	46	32700	28150	-4550	0.14	0.86	57	49	-8
0052	2T	11	15	174	11	17400	12950	-4450	0.06	0.74	30	22	-8
0052	2T	11	16	77	4	7700	5570	-2130	0.05	0.72	13	9	-4
0052	2T	11	21	111	12	11100	10330	-770	0.11	0.93	19	18	-1
0052	2T	11	23	76	10	7600	20720	13120	0.13	2.73	13	36	23
0052	2T	11	24	56	3	5600	2110	-3490	0.05	0.38	9	3	-6
0052	2T	11	25	61	2	6100	1620	-4480	0.03	0.27	10	2	-8
0052	2T	11	26	33	5	3300	4510	1210	0.15	1.37	5	7	2
0052	2T	12	12	633	154	63300	48740	-14560	0.24	0.77	112	86	-26
0052	2T	12	13	414	86	41400	37590	-3810	0.21	0.91	73	66	-7
0052	2T	12	14	292	38	29200	21310	-7890	0.13	0.73	51	37	-14
0052	2T	12	15	194	25	19400	19280	-120	0.13	0.99	34	34	0
0052	2T	12	16	149	14	14900	10400	-4500	0.09	0.70	26	18	-8
0052	2T	12	21	92	10	9200	6910	-2290	0.11	0.75	16	12	-4
0052	2T	12	23	79	2	7900	860	-7040	0.03	0.11	13	1	-12
0052	2T	12	24	62	2	6200	1830	-4370	0.03	0.30	10	3	-7
0052	2T	12	25	34	2	3400	870	-2530	0.06	0.26	6	1	-5
0052	2T	12	26	32	1	3200	580	-2620	0.03	0.18	5	1	-4
0052	2T	13	12	585	157	58500	53420	-5080	0.27	0.91	103	94	-9
0052	2T	13	13	408	81	40800	29950	-10850	0.20	0.73	72	53	-19
0052	2T	13	14	327	56	32700	24510	-8190	0.17	0.75	57	43	-14
0052	2T	13	15	178	24	17800	17940	140	0.13	1.01	31	31	0
0052	2T	13	16	133	15	13300	10480	-2820	0.11	0.79	23	18	-5
0052	2T	13	21	97	17	9700	13560	3860	0.18	1.40	17	24	7
0052	2T	13	23	67	7	6700	11670	4970	0.10	1.74	11	20	9
0052	2T	13	24	52	4	5200	3390	-1810	0.08	0.65	9	6	-3
0052	2T	13	25	35	1	3500	250	-3250	0.03	0.07	6	0	-6
0052	2T	13	26	25	2	2500	2000	-500	0.08	0.80	4	3	-1
0023	2T	20_12	16	1	0	100	0	-100	0.00	0.00	0	0	0
0023	2T	20_2	12	81	13	8100	6730	-1370	0.16	0.83	14	11	-3
0023	2T	20_2	13	42	7	4200	2580	-1620	0.17	0.61	7	4	-3
0023	2T	20_2	14	35	4	3500	1550	-1950	0.11	0.44	6	2	-4
0023	2T	20_2	15	19	3	1900	2110	210	0.16	1.11	3	3	0
0023	2T	20_2	16	17	2	1700	880	-820	0.12	0.52	3	1	-2
0023	2T	20_2	23	4	0	400	0	-400	0.00	0.00	0	0	0
0023	2T	20_2	24	2	0	200	0	-200	0.00	0.00	0	0	0
0023	2T	20_2	25	2	0	200	0	-200	0.00	0.00	0	0	0
0023	2T	20_2	26	1	0	100	0	-100	0.00	0.00	0	0	0
0023	2T	20_3	12	68	17	6800	7680	880	0.25	1.13	12	13	1
0023	2T	20_3	13	39	5	3900	2950	-950	0.13	0.76	6	5	-1
0023	2T	20_3	14	30	7	3000	3010	10	0.23	1.00	5	5	0
0023	2T	20_3	15	26	5	2600	3050	450	0.19	1.17	4	5	1
0023	2T	20_3	16	18	3	1800	1880	80	0.17	1.04	3	3	0
0023	2T	20_3	21	2	0	200	0	-200	0.00	0.00	0	0	0
0023	2T	20_3	23	4	1	400	480	80	0.25	1.20	0	0	0
0023	2T	20_3	24	2	0	200	0	-200	0.00	0.00	0	0	0
0023	2T	20_3	25	1	0	100	0	-100	0.00	0.00	0	0	0
0023	2T	20_4	12	54	9	5400	3990	-1410	0.17	0.74	9	7	-2
0023	2T	20_4	13	47	5	4700	1830	-2870	0.11	0.39	8	3	-5
0023	2T	20_4	14	35	3	3500	1690	-1810	0.09	0.48	6	2	-4
0023	2T	20_4	15	20	2	2000	720	-1280	0.10	0.36	3	1	-2
0023	2T	20_4	16	21	2	2100	910	-1190	0.10	0.43	3	1	-2
0023	2T	20_4	21	4	0	400	0	-400	0.00	0.00	0	0	0
0023	2T	20_4	23	4	0	400	0	-400	0.00	0.00	0	0	0
0023	2T	20_4	24	6	1	600	1770	1170	0.17	2.95	1	3	2
0023	2T	20_4	26	2	0	200	0	-200	0.00	0.00	0	0	0
0023	2T	20_5	12	228	71	22800	18510	-4290	0.31	0.81	40	32	-8
0023	2T	20_5	13	3	2	300	700	400	0.67	2.33	0	1	1
0023	2T	20_5	14	4	1	400	330	-70	0.25	0.83	0	0	0
0023	2T	20_6	12	82	17	8200	6490	-1710	0.21	0.79	14	11	-3
0023	2T	20_6	13	88	18	8800	5800	-3000	0.20	0.66	15	10	-5
0023	2T	20_6	14	66	15	6600	4390	-2210	0.23	0.67	11	7	-4
0023	2T	20_6	15	14	5	1400	1920	520	0.36	1.37	2	3	1
0023	2T	20_6	16	4	2	400	1940	1540	0.50	4.85	0	3	3
0023	2T	20_6	26	1	1	100	650	550	1.00	6.50	0	1	1
0023	2T	20_7	12	104	20	10400	8340	-2060	0.19	0.80	18	14	-4
0023	2T	20_7	13	75	20	7500	6810	-690	0.27	0.91	13	12	-1
0023	2T	20_7	14	68	19	6800	6480	-320	0.28	0.95	12	11	-1
0023	2T	20_7	15	11	1	1100	660	-440	0.09	0.60	1	1	0
0023	2T	20_7	16	2	1	200	420	220	0.50	2.10	0	0	0
0023	2T	20_8	12	174	57	17400	14690	-2710	0.33	0.84	30	26	-4
0023	2T	20_8	13	82	31	8200	8570	370	0.38	1.05	14	15	1
0023	2T	20_8	14	5	1	500	260	-240	0.20	0.52	0	0	0
0023	2T	20_8	15	1	1	100	320	220	1.00	3.20	0	0	0
0023	2T	20_8	16	1	0	100	0	-100	0.00	0.00	0	0	0
0023	2T	20_8	21	1	0	100	0	-100	0.00	0.00	0	0	0
0023	2T	20_9	12	106	32	10600	9760	-840	0.30	0.92	18	17	-1
0023	2T	20_9	13	88	20	8800	5990	-2810	0.23	0.68	15	10	-5
0023	2T	20_9	14	54	11	5400	3430	-1970	0.20	0.64	9	6	-3
0023	2T	20_9	15	8	3	800	1510	710	0.38	1.89	1	2	1
0023	2T	20_9	16	8	2	800	830	30	0.25	1.04	1	1	0
0023	2T	21_1	12	157	41	15700	11100	-4600	0.26	0.71	27	19	-8
0023	2T	21_1	13	94	31	9400	8290	-1110	0.33	0.88	16	14	-2
0023	2T	21_1	14	15	6	1500	1600	100	0.40	1.07	2	2	0
0023	2T	21_1	15	6	0	600	0	-600	0.00	0.00	1	0	-1
0023	2T	21_10	12	155	39	15500	12420	-3080	0.25	0.80	27	21	-6
0023	2T	21_10	13	73	20	7300	6320	-980	0.27	0.87	12	11	-1
0023	2T	21_10	14	25	8	2500	3020	520	0.32	1.21	4	5	1
0023	2T	21_10	15	4	0	400	0	-400	0.00	0.00	0	0	0
0023	2T	21_11	12	191	46	19100	12280	-6820	0.24	0.64	33	21	-12
0023	2T	21_11	13	54	12	5400	3370	-2030	0.22	0.62	9	5	-4
0023	2T	21_11	14	18	5	1800	1520	-280	0.28	0.84	3	2	-1
0023	2T	21_11	15	2	0	200	0	-200	0.00	0.00	0	0	0
0023	2T	21_11	23	1	0	100	0	-100	0.00	0.00	0	0	0
0023	2T	21_12	12	226	54	22600	16520	-6080	0.24	0.73	40	29	-11
0023	2T	21_12	13	32	10	3200	2500	-700	0.31	0.78	5	4	-1
0023	2T	21_12	14	8	4	800	1080	280	0.50	1.35	1	1	0
0023	2T	21_2	12	64	7	6400	2800	-3600	0.11	0.44	11	4	-7
0023	2T	21_2	13	24	7	2400	5070	2670	0.29	2.11	4	8	4
0023	2T	21_2	14	175	46	17500	11610	-5890	0.26	0.66	30	20	-10
0023	2T	21_2	16	2	1	200	820	620	0.50	4.10	0	1	1
0023	2T	21_3	12	20	2	2000	1130	-870	0.10	0.57	3	2	-1
0023	2T	21_3	13	220	73	22000	19760	-2240	0.33	0.90	38	34	-4
0023	2T	21_3	15	20	3	2000	1230	-770	0.15	0.62	3	2	-1
0023	2T	21_4	12	143	51	14300	13080	-1220	0.36	0.91	25	23	-2
0023	2T	21_4	13	114	38	11400	9450	-1950	0.33	0.83	20	16	-4
0023	2T	21_4	14	14	5	1400	1510	110	0.36	1.08	2	2	0
0023	2T	21_4	15	2	1	200	270	70	0.50	1.35	0	0	0
0023	2T	21_5	12	216	82	21600	19680	-1920	0.38	0.91	38	34	-4
0023	2T	21_5	13	4	0	400	0	-400	0.00	0.00	0	0	0
0023	2T	21_5	14	1	0	100	0	-100	0.00	0.00	0	0	0
0023	2T	21_5	16	1	0	100	0	-100	0.00	0.00	0	0	0
0023	2T	21_5	21	4	1	400	360	-40	0.25	0.90	0	0	0
0023	2T	21_5	23	1	0	100	0	-100	0.00	0.00	0	0	0
0023	2T	21_5	26	2	1	200	540	340	0.50	2.70	0	0	0
0023	2T	21_6	12	94	16	9400	5880	-3520	0.17	0.63	16	10	-6
0023	2T	21_6	13	39	9	3900	4040	140	0.23	1.04	6	7	1
0023	2T	21_6	14	18	1	1800	1000	-800	0.06	0.56	3	1	-2
0023	2T	21_6	15	3	0	300	0	-300	0.00	0.00	0	0	0
0023	2T	21_6	16	3	1	300	1240	940	0.33	4.13	0	2	2
0023	2T	21_6	21	13	1	1300	640	-660	0.08	0.49	2	1	-1
0023	2T	21_6	23	2	0	200	0	-200	0.00	0.00	0	0	0
0023	2T	21_6	24	6	2	600	1890	1290	0.33	3.15	1	3	2
0023	2T	21_6	26	3	0	300	0	-300	0.00	0.00	0	0	0
0023	2T	21_7	12	145	37	14500	11200	-3300	0.26	0.77	25	19	-6
0023	2T	21_7	13	70	16	7000	5760	-1240	0.23	0.82	12	10	-2
0023	2T	21_7	14	28	4	2800	1840	-960	0.14	0.66	4	3	-1
0023	2T	21_7	15	6	1	600	580	-20	0.17	0.97	1	1	0
0023	2T	21_7	21	1	0	100	0	-100	0.00	0.00	0	0	0
0023	2T	21_7	23	4	1	400	860	460	0.25	2.15	0	1	1
0023	2T	21_7	24	1	0	100	0	-100	0.00	0.00	0	0	0
0023	2T	21_7	26	1	0	100	0	-100	0.00	0.00	0	0	0
0023	2T	21_8	12	100	27	10000	9860	-140	0.27	0.99	17	17	0
0023	2T	21_8	13	89	29	8900	7250	-1650	0.33	0.81	15	12	-3
0023	2T	21_8	14	49	13	4900	4230	-670	0.27	0.86	8	7	-1
0023	2T	21_8	15	9	2	900	600	-300	0.22	0.67	1	1	0
0023	2T	21_8	16	4	1	400	390	-10	0.25	0.98	0	0	0
0023	2T	21_8	25	1	0	100	0	-100	0.00	0.00	0	0	0
0023	2T	21_9	12	102	27	10200	8830	-1370	0.26	0.87	18	15	-3
0023	2T	21_9	13	40	7	4000	2740	-1260	0.18	0.69	7	4	-3
0023	2T	21_9	14	25	6	2500	1870	-630	0.24	0.75	4	3	-1
0023	2T	21_9	15	3	1	300	740	440	0.33	2.47	0	1	1
0023	2T	21_9	16	2	1	200	980	780	0.50	4.90	0	1	1
0023	2T	21_9	21	4	0	400	0	-400	0.00	0.00	0	0	0
0023	2T	21_9	23	2	0	200	0	-200	0.00	0.00	0	0	0
0023	2T	21_9	24	3	0	300	0	-300	0.00	0.00	0	0	0
0023	2T	21_9	25	2	0	200	0	-200	0.00	0.00	0	0	0
0023	2T	21_9	26	1	0	100	0	-100	0.00	0.00	0	0	0
0023	2T	22_1	12	128	35	12800	9610	-3190	0.27	0.75	22	17	-5
0023	2T	22_1	13	56	18	5600	5880	280	0.32	1.05	9	10	1
0023	2T	22_1	14	25	7	2500	1840	-660	0.28	0.74	4	3	-1
0023	2T	22_1	15	4	1	400	380	-20	0.25	0.95	0	0	0
0023	2T	22_1	16	2	0	200	0	-200	0.00	0.00	0	0	0
0023	2T	22_10	12	136	39	13600	11940	-1660	0.29	0.88	24	21	-3
0023	2T	22_10	13	63	16	6300	4730	-1570	0.25	0.75	11	8	-3
0023	2T	22_10	14	32	11	3200	3740	540	0.34	1.17	5	6	1
0023	2T	22_10	16	1	0	100	0	-100	0.00	0.00	0	0	0
0023	2T	22_11	12	150	43	15000	13310	-1690	0.29	0.89	26	23	-3
0023	2T	22_11	13	63	12	6300	3670	-2630	0.19	0.58	11	6	-5
0023	2T	22_11	14	31	6	3100	2270	-830	0.19	0.73	5	4	-1
0023	2T	22_12	12	175	58	17500	17720	220	0.33	1.01	30	31	1
0023	2T	22_12	13	50	16	5000	5370	370	0.32	1.07	8	9	1
0023	2T	22_12	14	15	3	1500	1280	-220	0.20	0.85	2	2	0
0023	2T	22_12	21	1	0	100	0	-100	0.00	0.00	0	0	0
0023	2T	22_2	12	66	14	6600	6720	120	0.21	1.02	11	11	0
0023	2T	22_2	13	51	6	5100	2060	-3040	0.12	0.40	9	3	-6
0023	2T	22_2	14	28	4	2800	1700	-1100	0.14	0.61	4	3	-1
0023	2T	22_2	15	5	3	500	1830	1330	0.60	3.66	0	3	3
0023	2T	22_2	16	4	0	400	0	-400	0.00	0.00	0	0	0
0023	2T	22_2	23	3	0	300	0	-300	0.00	0.00	0	0	0
0023	2T	22_2	24	1	0	100	0	-100	0.00	0.00	0	0	0
0023	2T	22_2	25	3	0	300	0	-300	0.00	0.00	0	0	0
0023	2T	22_2	26	1	0	100	0	-100	0.00	0.00	0	0	0
0023	2T	22_3	12	70	17	7000	5760	-1240	0.24	0.82	12	10	-2
0023	2T	22_3	13	48	13	4800	3980	-820	0.27	0.83	8	7	-1
0023	2T	22_3	14	24	1	2400	450	-1950	0.04	0.19	4	0	-4
0023	2T	22_3	15	12	3	1200	1980	780	0.25	1.65	2	3	1
0023	2T	22_3	16	8	1	800	740	-60	0.13	0.93	1	1	0
0023	2T	22_3	23	3	0	300	0	-300	0.00	0.00	0	0	0
0023	2T	22_3	24	3	0	300	0	-300	0.00	0.00	0	0	0
0023	2T	22_3	25	2	0	200	0	-200	0.00	0.00	0	0	0
0023	2T	22_3	26	1	0	100	0	-100	0.00	0.00	0	0	0
0023	2T	22_4	12	72	13	7200	4530	-2670	0.18	0.63	12	8	-4
0023	2T	22_4	13	48	12	4800	5230	430	0.25	1.09	8	9	1
0023	2T	22_4	14	24	3	2400	1250	-1150	0.13	0.52	4	2	-2
0023	2T	22_4	15	10	2	1000	2490	1490	0.20	2.49	1	4	3
0023	2T	22_4	16	9	0	900	0	-900	0.00	0.00	1	0	-1
0023	2T	22_4	21	2	1	200	2060	1860	0.50	10.30	0	3	3
0023	2T	22_4	23	3	0	300	0	-300	0.00	0.00	0	0	0
0023	2T	22_4	24	2	0	200	0	-200	0.00	0.00	0	0	0
0023	2T	22_5	12	65	11	6500	3760	-2740	0.17	0.58	11	6	-5
0023	2T	22_5	13	55	11	5500	4870	-630	0.20	0.89	9	8	-1
0023	2T	22_5	14	33	6	3300	2320	-980	0.18	0.70	5	4	-1
0023	2T	22_5	15	11	3	1100	1780	680	0.27	1.62	1	3	2
0023	2T	22_5	16	5	1	500	650	150	0.20	1.30	0	1	1
0023	2T	22_5	21	2	0	200	0	-200	0.00	0.00	0	0	0
0023	2T	22_5	23	5	1	500	380	-120	0.20	0.76	0	0	0
0023	2T	22_5	24	2	0	200	0	-200	0.00	0.00	0	0	0
0023	2T	22_5	25	2	0	200	0	-200	0.00	0.00	0	0	0
0023	2T	22_5	26	4	1	400	740	340	0.25	1.85	0	1	1
0023	2T	22_6	12	73	16	7300	6160	-1140	0.22	0.84	12	10	-2
0023	2T	22_6	13	43	9	4300	2530	-1770	0.21	0.59	7	4	-3
0023	2T	22_6	14	29	6	2900	2600	-300	0.21	0.90	5	4	-1
0023	2T	22_6	15	14	3	1400	1370	-30	0.21	0.98	2	2	0
0023	2T	22_6	16	4	0	400	0	-400	0.00	0.00	0	0	0
0023	2T	22_6	23	4	1	400	520	120	0.25	1.30	0	0	0
0023	2T	22_6	24	2	0	200	0	-200	0.00	0.00	0	0	0
0023	2T	22_6	25	4	1	400	370	-30	0.25	0.93	0	0	0
0023	2T	22_6	26	3	0	300	0	-300	0.00	0.00	0	0	0
0023	2T	22_7	12	87	20	8700	8260	-440	0.23	0.95	15	14	-1
0023	2T	22_7	13	50	13	5000	4680	-320	0.26	0.94	8	8	0
0023	2T	22_7	14	20	2	2000	900	-1100	0.10	0.45	3	1	-2
0023	2T	22_7	15	8	2	800	850	50	0.25	1.06	1	1	0
0023	2T	22_7	16	3	0	300	0	-300	0.00	0.00	0	0	0
0023	2T	22_7	23	1	0	100	0	-100	0.00	0.00	0	0	0
0023	2T	22_7	24	4	1	400	300	-100	0.25	0.75	0	0	0
0023	2T	22_7	25	3	1	300	520	220	0.33	1.73	0	0	0
0023	2T	22_8	12	94	35	9400	9820	420	0.37	1.04	16	17	1
0023	2T	22_8	13	41	11	4100	3220	-880	0.27	0.79	7	5	-2
0023	2T	22_8	14	94	25	9400	6850	-2550	0.27	0.73	16	12	-4
0023	2T	22_8	15	1	0	100	0	-100	0.00	0.00	0	0	0
0023	2T	22_9	12	105	27	10500	10820	320	0.26	1.03	18	19	1
0023	2T	22_9	13	52	9	5200	4130	-1070	0.17	0.79	9	7	-2
0023	2T	22_9	14	19	3	1900	960	-940	0.16	0.51	3	1	-2
0023	2T	22_9	15	8	1	800	310	-490	0.13	0.39	1	0	-1
0023	2T	22_9	16	4	0	400	0	-400	0.00	0.00	0	0	0
0023	2T	22_9	21	1	0	100	0	-100	0.00	0.00	0	0	0
0023	2T	22_9	23	2	1	200	1190	990	0.50	5.95	0	2	2
0023	2T	22_9	24	2	1	200	480	280	0.50	2.40	0	0	0
0023	2T	22_9	25	3	0	300	0	-300	0.00	0.00	0	0	0
0023	2T	22_9	26	1	0	100	0	-100	0.00	0.00	0	0	0
0023	2T	23_1	12	187	61	18700	15750	-2950	0.33	0.84	33	27	-6
0023	2T	23_1	13	54	9	5400	2520	-2880	0.17	0.47	9	4	-5
0023	2T	23_1	14	19	4	1900	1530	-370	0.21	0.81	3	2	-1
0023	2T	23_1	15	4	0	400	0	-400	0.00	0.00	0	0	0
0023	2T	23_1	16	1	0	100	0	-100	0.00	0.00	0	0	0
0023	2T	23_10	12	171	35	17100	10300	-6800	0.20	0.60	30	18	-12
0023	2T	23_10	13	54	12	5400	3960	-1440	0.22	0.73	9	7	-2
0023	2T	23_10	14	24	3	2400	3290	890	0.13	1.37	4	5	1
0023	2T	23_10	23	1	0	100	0	-100	0.00	0.00	0	0	0
0023	2T	23_10	24	7	0	700	0	-700	0.00	0.00	1	0	-1
0023	2T	23_11	12	147	37	14700	10710	-3990	0.25	0.73	26	18	-8
0023	2T	23_11	13	72	13	7200	6310	-890	0.18	0.88	12	11	-1
0023	2T	23_11	14	8	0	800	0	-800	0.00	0.00	1	0	-1
0023	2T	23_11	16	1	0	100	0	-100	0.00	0.00	0	0	0
0023	2T	23_11	21	2	0	200	0	-200	0.00	0.00	0	0	0
0023	2T	23_12	12	209	54	20900	16890	-4010	0.26	0.81	36	29	-7
0023	2T	23_12	13	34	10	3400	3180	-220	0.29	0.94	6	5	-1
0023	2T	23_12	14	1	1	100	1020	920	1.00	10.20	0	1	1
0023	2T	23_12	21	1	0	100	0	-100	0.00	0.00	0	0	0
0023	2T	23_2	12	257	75	25700	15950	-9750	0.29	0.62	45	28	-17
0023	2T	23_2	13	3	0	300	0	-300	0.00	0.00	0	0	0
0023	2T	23_2	14	3	0	300	0	-300	0.00	0.00	0	0	0
0023	2T	23_3	12	20	6	2000	2040	40	0.30	1.02	3	3	0
0023	2T	23_3	13	236	79	23600	20400	-3200	0.33	0.86	41	36	-5
0023	2T	23_3	14	4	1	400	320	-80	0.25	0.80	0	0	0
0023	2T	23_3	15	1	0	100	0	-100	0.00	0.00	0	0	0
0023	2T	23_3	23	1	0	100	0	-100	0.00	0.00	0	0	0
0023	2T	23_4	12	65	11	6500	4090	-2410	0.17	0.63	11	7	-4
0023	2T	23_4	13	80	24	8000	6880	-1120	0.30	0.86	14	12	-2
0023	2T	23_4	14	98	21	9800	6700	-3100	0.21	0.68	17	11	-6
0023	2T	23_4	15	17	6	1700	2820	1120	0.35	1.66	3	4	1
0023	2T	23_4	16	8	3	800	1680	880	0.38	2.10	1	2	1
0023	2T	23_5	12	89	17	8900	7960	-940	0.19	0.89	15	14	-1
0023	2T	23_5	13	44	9	4400	3670	-730	0.20	0.83	7	6	-1
0023	2T	23_5	14	30	6	3000	3090	90	0.20	1.03	5	5	0
0023	2T	23_5	15	13	1	1300	430	-870	0.08	0.33	2	0	-2
0023	2T	23_5	16	4	0	400	0	-400	0.00	0.00	0	0	0
0023	2T	23_5	21	2	0	200	0	-200	0.00	0.00	0	0	0
0023	2T	23_5	23	3	0	300	0	-300	0.00	0.00	0	0	0
0023	2T	23_5	24	7	0	700	0	-700	0.00	0.00	1	0	-1
0023	2T	23_5	25	2	0	200	0	-200	0.00	0.00	0	0	0
0023	2T	23_5	26	1	0	100	0	-100	0.00	0.00	0	0	0
0023	2T	23_6	12	62	9	6200	3340	-2860	0.15	0.54	10	5	-5
0023	2T	23_6	13	48	8	4800	4340	-460	0.17	0.90	8	7	-1
0023	2T	23_6	14	42	5	4200	2670	-1530	0.12	0.64	7	4	-3
0023	2T	23_6	15	2	0	200	0	-200	0.00	0.00	0	0	0
0023	2T	23_6	16	10	1	1000	1440	440	0.10	1.44	1	2	1
0023	2T	23_6	21	2	0	200	0	-200	0.00	0.00	0	0	0
0023	2T	23_6	23	4	1	400	850	450	0.25	2.13	0	1	1
0023	2T	23_6	24	5	0	500	0	-500	0.00	0.00	0	0	0
0023	2T	23_6	25	5	0	500	0	-500	0.00	0.00	0	0	0
0023	2T	23_6	26	3	0	300	0	-300	0.00	0.00	0	0	0
0023	2T	23_7	12	72	14	7200	6260	-940	0.19	0.87	12	11	-1
0023	2T	23_7	13	47	2	4700	1380	-3320	0.04	0.29	8	2	-6
0023	2T	23_7	14	26	4	2600	1520	-1080	0.15	0.58	4	2	-2
0023	2T	23_7	15	8	0	800	0	-800	0.00	0.00	1	0	-1
0023	2T	23_7	16	7	1	700	690	-10	0.14	0.99	1	1	0
0023	2T	23_7	23	1	0	100	0	-100	0.00	0.00	0	0	0
0023	2T	23_7	24	5	1	500	840	340	0.20	1.68	0	1	1
0023	2T	23_7	25	1	0	100	0	-100	0.00	0.00	0	0	0
0023	2T	23_7	26	1	0	100	0	-100	0.00	0.00	0	0	0
0023	2T	23_8	12	37	7	3700	1990	-1710	0.19	0.54	6	3	-3
0023	2T	23_8	13	34	7	3400	2590	-810	0.21	0.76	6	4	-2
0023	2T	23_8	14	46	9	4600	4580	-20	0.20	1.00	8	8	0
0023	2T	23_8	15	14	0	1400	0	-1400	0.00	0.00	2	0	-2
0023	2T	23_8	16	1	0	100	0	-100	0.00	0.00	0	0	0
0023	2T	23_8	23	2	1	200	370	170	0.50	1.85	0	0	0
0023	2T	23_8	24	2	0	200	0	-200	0.00	0.00	0	0	0
0023	2T	23_8	25	2	0	200	0	-200	0.00	0.00	0	0	0
0023	2T	23_9	12	101	16	10100	5800	-4300	0.16	0.57	17	10	-7
0023	2T	23_9	13	55	10	5500	3010	-2490	0.18	0.55	9	5	-4
0023	2T	23_9	14	30	4	3000	1710	-1290	0.13	0.57	5	3	-2
0023	2T	23_9	15	13	3	1300	2020	720	0.23	1.55	2	3	1
0023	2T	23_9	16	3	0	300	0	-300	0.00	0.00	0	0	0
0023	2T	23_9	21	2	0	200	0	-200	0.00	0.00	0	0	0
0023	2T	23_9	23	4	0	400	0	-400	0.00	0.00	0	0	0
0023	2T	23_9	24	2	0	200	0	-200	0.00	0.00	0	0	0
0023	2T	23_9	25	5	1	500	2070	1570	0.20	4.14	0	3	3
0023	2T	24_1	12	130	43	13000	10530	-2470	0.33	0.81	23	18	-5
0023	2T	24_1	13	49	12	4900	3710	-1190	0.24	0.76	8	6	-2
0023	2T	24_1	14	22	4	2200	1930	-270	0.18	0.88	3	3	0
0023	2T	24_1	15	10	1	1000	580	-420	0.10	0.58	1	1	0
0023	2T	24_1	16	7	0	700	0	-700	0.00	0.00	1	0	-1
0023	2T	24_1	23	3	0	300	0	-300	0.00	0.00	0	0	0
0023	2T	24_1	25	1	0	100	0	-100	0.00	0.00	0	0	0
0023	2T	24_10	12	201	59	20100	14680	-5420	0.29	0.73	35	25	-10
0023	2T	24_10	13	53	11	5300	3360	-1940	0.21	0.63	9	5	-4
0023	2T	24_10	14	15	4	1500	1420	-80	0.27	0.95	2	2	0
0023	2T	24_10	15	2	0	200	0	-200	0.00	0.00	0	0	0
0023	2T	24_10	16	1	0	100	0	-100	0.00	0.00	0	0	0
0023	2T	24_11	12	217	57	21700	14010	-7690	0.26	0.65	38	24	-14
0023	2T	24_11	13	44	15	4400	3980	-420	0.34	0.90	7	7	0
0023	2T	24_11	14	10	5	1000	1470	470	0.50	1.47	1	2	1
0023	2T	24_11	15	1	0	100	0	-100	0.00	0.00	0	0	0
0023	2T	24_11	16	1	0	100	0	-100	0.00	0.00	0	0	0
0023	2T	24_11	21	1	0	100	0	-100	0.00	0.00	0	0	0
0023	2T	24_12	12	210	58	21000	15200	-5800	0.28	0.72	37	26	-11
0023	2T	24_12	13	38	15	3800	4430	630	0.39	1.17	6	7	1
0023	2T	24_12	14	14	2	1400	520	-880	0.14	0.37	2	0	-2
0023	2T	24_12	16	1	1	100	560	460	1.00	5.60	0	0	0
0023	2T	24_2	12	119	38	11900	9900	-2000	0.32	0.83	21	17	-4
0023	2T	24_2	13	65	12	6500	3710	-2790	0.18	0.57	11	6	-5
0023	2T	24_2	14	30	3	3000	1450	-1550	0.10	0.48	5	2	-3
0023	2T	24_2	15	6	0	600	0	-600	0.00	0.00	1	0	-1
0023	2T	24_2	16	5	1	500	230	-270	0.20	0.46	0	0	0
0023	2T	24_2	23	3	0	300	0	-300	0.00	0.00	0	0	0
0023	2T	24_2	24	1	0	100	0	-100	0.00	0.00	0	0	0
0023	2T	24_2	26	2	0	200	0	-200	0.00	0.00	0	0	0
0023	2T	24_3	12	91	19	9100	6090	-3010	0.21	0.67	16	10	-6
0023	2T	24_3	13	55	11	5500	4000	-1500	0.20	0.73	9	7	-2
0023	2T	24_3	14	29	9	2900	2930	30	0.31	1.01	5	5	0
0023	2T	24_3	15	8	2	800	890	90	0.25	1.11	1	1	0
0023	2T	24_3	16	11	1	1100	540	-560	0.09	0.49	1	0	-1
0023	2T	24_3	23	1	0	100	0	-100	0.00	0.00	0	0	0
0023	2T	24_3	26	5	1	500	620	120	0.20	1.24	0	1	1
0023	2T	24_4	12	91	24	9100	8080	-1020	0.26	0.89	16	14	-2
0023	2T	24_4	13	60	14	6000	4140	-1860	0.23	0.69	10	7	-3
0023	2T	24_4	14	27	5	2700	1670	-1030	0.19	0.62	4	2	-2
0023	2T	24_4	15	8	3	800	800	0	0.38	1.00	1	1	0
0023	2T	24_4	16	11	4	1100	1350	250	0.36	1.23	1	2	1
0023	2T	24_4	21	1	0	100	0	-100	0.00	0.00	0	0	0
0023	2T	24_4	23	2	0	200	0	-200	0.00	0.00	0	0	0
0023	2T	24_4	24	1	1	100	710	610	1.00	7.10	0	1	1
0023	2T	24_4	26	4	1	400	920	520	0.25	2.30	0	1	1
0023	2T	24_5	12	113	48	11300	11140	-160	0.42	0.99	20	19	-1
0023	2T	24_5	13	93	36	9300	8920	-380	0.39	0.96	16	15	-1
0023	2T	24_5	14	47	18	4700	4550	-150	0.38	0.97	8	8	0
0023	2T	24_5	15	8	3	800	800	0	0.38	1.00	1	1	0
0023	2T	24_5	16	4	0	400	0	-400	0.00	0.00	0	0	0
0023	2T	24_6	12	128	44	12800	11010	-1790	0.34	0.86	22	19	-3
0023	2T	24_6	13	67	21	6700	5080	-1620	0.31	0.76	11	8	-3
0023	2T	24_6	14	34	10	3400	3280	-120	0.29	0.96	6	5	-1
0023	2T	24_6	15	8	3	800	1140	340	0.38	1.43	1	2	1
0023	2T	24_6	16	9	1	900	190	-710	0.11	0.21	1	0	-1
0023	2T	24_6	23	1	0	100	0	-100	0.00	0.00	0	0	0
0023	2T	24_6	26	1	0	100	0	-100	0.00	0.00	0	0	0
0023	2T	24_7	12	68	23	6800	7520	720	0.34	1.11	12	13	1
0023	2T	24_7	13	61	21	6100	6020	-80	0.34	0.99	10	10	0
0023	2T	24_7	14	45	16	4500	4210	-290	0.36	0.94	7	7	0
0023	2T	24_7	15	11	7	1100	2450	1350	0.64	2.23	1	4	3
0023	2T	24_7	16	27	6	2700	2940	240	0.22	1.09	4	5	1
0023	2T	24_8	12	100	39	10000	11900	1900	0.39	1.19	17	21	4
0023	2T	24_8	13	68	17	6800	4370	-2430	0.25	0.64	12	7	-5
0023	2T	24_8	14	29	9	2900	2780	-120	0.31	0.96	5	4	-1
0023	2T	24_8	15	4	1	400	300	-100	0.25	0.75	0	0	0
0023	2T	24_8	16	10	1	1000	220	-780	0.10	0.22	1	0	-1
0023	2T	24_8	21	1	1	100	530	430	1.00	5.30	0	0	0
0023	2T	24_8	24	1	0	100	0	-100	0.00	0.00	0	0	0
0023	2T	24_9	12	153	44	15300	10040	-5260	0.29	0.66	27	17	-10
0023	2T	24_9	13	67	13	6700	3360	-3340	0.19	0.50	11	5	-6
0023	2T	24_9	14	16	4	1600	1150	-450	0.25	0.72	2	2	0
0023	2T	24_9	15	9	2	900	780	-120	0.22	0.87	1	1	0
0023	2T	24_9	16	7	1	700	240	-460	0.14	0.34	1	0	-1
0023	2T	24_9	23	1	0	100	0	-100	0.00	0.00	0	0	0
0023	2T	24_9	26	1	0	100	0	-100	0.00	0.00	0	0	0
0023	3F	01_1	123	1	0	100	0	-100	0.00	0.00	0	0	0
0023	3F	01_1	124	11	2	1100	760	-340	0.18	0.69	1	1	0
0023	3F	01_1	125	3	0	300	0	-300	0.00	0.00	0	0	0
0023	3F	01_1	126	2	0	200	0	-200	0.00	0.00	0	0	0
0023	3F	01_1	145	5	1	500	520	20	0.20	1.04	0	0	0
0023	3F	01_1	146	5	1	500	570	70	0.20	1.14	0	1	1
0023	3F	01_10	123	42	12	4200	3220	-980	0.29	0.77	7	5	-2
0023	3F	01_10	124	70	18	7000	6900	-100	0.26	0.99	12	12	0
0023	3F	01_10	125	48	9	4800	3980	-820	0.19	0.83	8	7	-1
0023	3F	01_10	126	24	5	2400	4240	1840	0.21	1.77	4	7	3
0023	3F	01_10	134	26	4	2600	1630	-970	0.15	0.63	4	2	-2
0023	3F	01_10	135	15	2	1500	710	-790	0.13	0.47	2	1	-1
0023	3F	01_10	136	11	2	1100	540	-560	0.18	0.49	1	0	-1
0023	3F	01_10	145	1	1	100	650	550	1.00	6.50	0	1	1
0023	3F	01_10	146	5	1	500	330	-170	0.20	0.66	0	0	0
0023	3F	01_10	235	1	0	100	0	-100	0.00	0.00	0	0	0
0023	3F	01_11	123	47	9	4700	3010	-1690	0.19	0.64	8	5	-3
0023	3F	01_11	124	120	18	12000	6860	-5140	0.15	0.57	21	12	-9
0023	3F	01_11	125	28	3	2800	1820	-980	0.11	0.65	4	3	-1
0023	3F	01_11	126	25	1	2500	850	-1650	0.04	0.34	4	1	-3
0023	3F	01_11	134	17	1	1700	350	-1350	0.06	0.21	3	0	-3
0023	3F	01_11	135	19	2	1900	900	-1000	0.11	0.47	3	1	-2
0023	3F	01_11	136	4	1	400	590	190	0.25	1.48	0	1	1
0023	3F	01_11	145	2	0	200	0	-200	0.00	0.00	0	0	0
0023	3F	01_12	123	54	13	5400	4100	-1300	0.24	0.76	9	7	-2
0023	3F	01_12	124	147	16	14700	7080	-7620	0.11	0.48	26	12	-14
0023	3F	01_12	125	18	5	1800	5810	4010	0.28	3.23	3	10	7
0023	3F	01_12	126	24	2	2400	3510	1110	0.08	1.46	4	6	2
0023	3F	01_12	134	17	7	1700	4000	2300	0.41	2.35	3	7	4
0023	3F	01_12	135	2	0	200	0	-200	0.00	0.00	0	0	0
0023	3F	01_12	136	3	0	300	0	-300	0.00	0.00	0	0	0
0023	3F	01_12	146	1	0	100	0	-100	0.00	0.00	0	0	0
0023	3F	01_2	123	13	2	1300	420	-880	0.15	0.32	2	0	-2
0023	3F	01_2	124	17	2	1700	580	-1120	0.12	0.34	3	1	-2
0023	3F	01_2	125	13	1	1300	890	-410	0.08	0.68	2	1	-1
0023	3F	01_2	126	17	1	1700	580	-1120	0.06	0.34	3	1	-2
0023	3F	01_2	134	9	1	900	280	-620	0.11	0.31	1	0	-1
0023	3F	01_2	135	13	4	1300	2290	990	0.31	1.76	2	4	2
0023	3F	01_2	136	8	3	800	1280	480	0.38	1.60	1	2	1
0023	3F	01_2	145	3	1	300	440	140	0.33	1.47	0	0	0
0023	3F	01_2	146	5	0	500	0	-500	0.00	0.00	0	0	0
0023	3F	01_2	156	5	1	500	360	-140	0.20	0.72	0	0	0
0023	3F	01_2	234	1	0	100	0	-100	0.00	0.00	0	0	0
0023	3F	01_2	235	1	0	100	0	-100	0.00	0.00	0	0	0
0023	3F	01_2	236	1	0	100	0	-100	0.00	0.00	0	0	0
0023	3F	01_2	246	1	0	100	0	-100	0.00	0.00	0	0	0
0023	3F	01_2	256	1	0	100	0	-100	0.00	0.00	0	0	0
0023	3F	01_3	123	19	4	1900	1390	-510	0.21	0.73	3	2	-1
0023	3F	01_3	124	20	5	2000	2990	990	0.25	1.50	3	5	2
0023	3F	01_3	125	13	1	1300	380	-920	0.08	0.29	2	0	-2
0023	3F	01_3	126	22	4	2200	1450	-750	0.18	0.66	3	2	-1
0023	3F	01_3	134	12	4	1200	1400	200	0.33	1.17	2	2	0
0023	3F	01_3	135	16	6	1600	2290	690	0.38	1.43	2	4	2
0023	3F	01_3	136	19	4	1900	1950	50	0.21	1.03	3	3	0
0023	3F	01_3	145	4	1	400	920	520	0.25	2.30	0	1	1
0023	3F	01_3	146	3	0	300	0	-300	0.00	0.00	0	0	0
0023	3F	01_3	156	2	0	200	0	-200	0.00	0.00	0	0	0
0023	3F	01_3	234	2	0	200	0	-200	0.00	0.00	0	0	0
0023	3F	01_3	235	2	0	200	0	-200	0.00	0.00	0	0	0
0023	3F	01_3	236	2	1	200	190	-10	0.50	0.95	0	0	0
0023	3F	01_3	246	1	0	100	0	-100	0.00	0.00	0	0	0
0023	3F	01_3	256	1	0	100	0	-100	0.00	0.00	0	0	0
0023	3F	01_4	123	8	2	800	650	-150	0.25	0.81	1	1	0
0023	3F	01_4	124	34	4	3400	1260	-2140	0.12	0.37	6	2	-4
0023	3F	01_4	125	16	1	1600	360	-1240	0.06	0.23	2	0	-2
0023	3F	01_4	126	21	3	2100	1640	-460	0.14	0.78	3	2	-1
0023	3F	01_4	134	15	2	1500	520	-980	0.13	0.35	2	0	-2
0023	3F	01_4	135	15	1	1500	230	-1270	0.07	0.15	2	0	-2
0023	3F	01_4	136	22	3	2200	1380	-820	0.14	0.63	3	2	-1
0023	3F	01_4	145	5	1	500	400	-100	0.20	0.80	0	0	0
0023	3F	01_4	146	7	2	700	1070	370	0.29	1.53	1	1	0
0023	3F	01_4	156	3	0	300	0	-300	0.00	0.00	0	0	0
0023	3F	01_4	234	2	0	200	0	-200	0.00	0.00	0	0	0
0023	3F	01_4	235	1	0	100	0	-100	0.00	0.00	0	0	0
0023	3F	01_4	236	1	0	100	0	-100	0.00	0.00	0	0	0
0023	3F	01_4	245	1	0	100	0	-100	0.00	0.00	0	0	0
0023	3F	01_4	246	2	0	200	0	-200	0.00	0.00	0	0	0
0023	3F	01_5	123	18	5	1800	1270	-530	0.28	0.71	3	2	-1
0023	3F	01_5	124	30	7	3000	2100	-900	0.23	0.70	5	3	-2
0023	3F	01_5	125	21	4	2100	1740	-360	0.19	0.83	3	3	0
0023	3F	01_5	126	33	4	3300	1550	-1750	0.12	0.47	5	2	-3
0023	3F	01_5	134	16	3	1600	630	-970	0.19	0.39	2	1	-1
0023	3F	01_5	135	19	1	1900	190	-1710	0.05	0.10	3	0	-3
0023	3F	01_5	136	26	4	2600	2230	-370	0.15	0.86	4	3	-1
0023	3F	01_5	145	3	1	300	310	10	0.33	1.03	0	0	0
0023	3F	01_5	146	4	0	400	0	-400	0.00	0.00	0	0	0
0023	3F	01_5	156	3	0	300	0	-300	0.00	0.00	0	0	0
0023	3F	01_5	234	1	1	100	230	130	1.00	2.30	0	0	0
0023	3F	01_5	235	1	0	100	0	-100	0.00	0.00	0	0	0
0023	3F	01_5	236	3	0	300	0	-300	0.00	0.00	0	0	0
0023	3F	01_5	245	2	0	200	0	-200	0.00	0.00	0	0	0
0023	3F	01_5	246	1	0	100	0	-100	0.00	0.00	0	0	0
0023	3F	01_5	256	1	0	100	0	-100	0.00	0.00	0	0	0
0023	3F	01_6	123	38	6	3800	1380	-2420	0.16	0.36	6	2	-4
0023	3F	01_6	124	39	7	3900	1780	-2120	0.18	0.46	6	3	-3
0023	3F	01_6	125	9	1	900	420	-480	0.11	0.47	1	0	-1
0023	3F	01_6	126	2	0	200	0	-200	0.00	0.00	0	0	0
0023	3F	01_6	134	7	1	700	240	-460	0.14	0.34	1	0	-1
0023	3F	01_6	135	3	0	300	0	-300	0.00	0.00	0	0	0
0023	3F	01_6	136	3	0	300	0	-300	0.00	0.00	0	0	0
0023	3F	01_7	123	29	14	2900	3320	420	0.48	1.14	5	5	0
0023	3F	01_7	124	32	11	3200	3320	120	0.34	1.04	5	5	0
0023	3F	01_7	125	21	3	2100	700	-1400	0.14	0.33	3	1	-2
0023	3F	01_7	126	44	11	4400	3550	-850	0.25	0.81	7	6	-1
0023	3F	01_7	134	8	2	800	360	-440	0.25	0.45	1	0	-1
0023	3F	01_7	135	4	2	400	520	120	0.50	1.30	0	0	0
0023	3F	01_7	136	13	3	1300	950	-350	0.23	0.73	2	1	-1
0023	3F	01_7	145	5	0	500	0	-500	0.00	0.00	0	0	0
0023	3F	01_7	146	6	2	600	630	30	0.33	1.05	1	1	0
0023	3F	01_7	156	1	0	100	0	-100	0.00	0.00	0	0	0
0023	3F	01_7	236	1	0	100	0	-100	0.00	0.00	0	0	0
0023	3F	01_7	246	1	0	100	0	-100	0.00	0.00	0	0	0
0023	3F	01_8	123	3	0	300	0	-300	0.00	0.00	0	0	0
0023	3F	01_8	124	4	1	400	240	-160	0.25	0.60	0	0	0
0023	3F	01_8	125	74	27	7400	7920	520	0.36	1.07	13	14	1
0023	3F	01_8	126	5	0	500	0	-500	0.00	0.00	0	0	0
0023	3F	01_8	134	3	0	300	0	-300	0.00	0.00	0	0	0
0023	3F	01_8	135	25	6	2500	1700	-800	0.24	0.68	4	3	-1
0023	3F	01_8	145	7	0	700	0	-700	0.00	0.00	1	0	-1
0023	3F	01_8	146	1	0	100	0	-100	0.00	0.00	0	0	0
0023	3F	01_8	156	1	0	100	0	-100	0.00	0.00	0	0	0
0023	3F	01_9	123	52	20	5200	5540	340	0.38	1.07	9	9	0
0023	3F	01_9	124	68	13	6800	3930	-2870	0.19	0.58	12	6	-6
0023	3F	01_9	125	30	4	3000	1020	-1980	0.13	0.34	5	1	-4
0023	3F	01_9	126	29	5	2900	1790	-1110	0.17	0.62	5	3	-2
0023	3F	01_9	134	16	3	1600	1550	-50	0.19	0.97	2	2	0
0023	3F	01_9	135	12	4	1200	1120	-80	0.33	0.93	2	1	-1
0023	3F	01_9	136	10	1	1000	450	-550	0.10	0.45	1	0	-1
0023	3F	01_9	145	1	0	100	0	-100	0.00	0.00	0	0	0
0023	3F	01_9	146	1	0	100	0	-100	0.00	0.00	0	0	0
0023	3F	01_9	156	2	1	200	560	360	0.50	2.80	0	0	0
0023	3F	02_1	123	36	11	3600	4680	1080	0.31	1.30	6	8	2
0023	3F	02_1	124	16	0	1600	0	-1600	0.00	0.00	2	0	-2
0023	3F	02_1	125	7	1	700	480	-220	0.14	0.69	1	0	-1
0023	3F	02_1	126	13	1	1300	420	-880	0.08	0.32	2	0	-2
0023	3F	02_1	134	7	1	700	360	-340	0.14	0.51	1	0	-1
0023	3F	02_1	135	4	0	400	0	-400	0.00	0.00	0	0	0
0023	3F	02_1	136	8	1	800	380	-420	0.13	0.48	1	0	-1
0023	3F	02_1	145	3	0	300	0	-300	0.00	0.00	0	0	0
0023	3F	02_1	146	3	0	300	0	-300	0.00	0.00	0	0	0
0023	3F	02_1	156	1	1	100	1100	1000	1.00	11.00	0	1	1
0023	3F	02_1	234	1	0	100	0	-100	0.00	0.00	0	0	0
0023	3F	02_1	235	1	0	100	0	-100	0.00	0.00	0	0	0
0023	3F	02_1	236	1	0	100	0	-100	0.00	0.00	0	0	0
0023	3F	02_10	123	41	11	4100	2990	-1110	0.27	0.73	7	5	-2
0023	3F	02_10	124	57	7	5700	2690	-3010	0.12	0.47	10	4	-6
0023	3F	02_10	125	26	2	2600	750	-1850	0.08	0.29	4	1	-3
0023	3F	02_10	126	36	0	3600	0	-3600	0.00	0.00	6	0	-6
0023	3F	02_10	134	19	2	1900	650	-1250	0.11	0.34	3	1	-2
0023	3F	02_10	135	21	6	2100	2060	-40	0.29	0.98	3	3	0
0023	3F	02_10	136	18	0	1800	0	-1800	0.00	0.00	3	0	-3
0023	3F	02_10	145	2	0	200	0	-200	0.00	0.00	0	0	0
0023	3F	02_10	146	4	1	400	620	220	0.25	1.55	0	1	1
0023	3F	02_10	156	2	1	200	1030	830	0.50	5.15	0	1	1
0023	3F	02_10	256	1	0	100	0	-100	0.00	0.00	0	0	0
0023	3F	02_11	123	38	9	3800	4040	240	0.24	1.06	6	7	1
0023	3F	02_11	124	67	9	6700	3950	-2750	0.13	0.59	11	6	-5
0023	3F	02_11	125	27	3	2700	1030	-1670	0.11	0.38	4	1	-3
0023	3F	02_11	126	40	2	4000	3000	-1000	0.05	0.75	7	5	-2
0023	3F	02_11	134	16	2	1600	990	-610	0.13	0.62	2	1	-1
0023	3F	02_11	135	24	7	2400	3450	1050	0.29	1.44	4	6	2
0023	3F	02_11	136	15	2	1500	1520	20	0.13	1.01	2	2	0
0023	3F	02_11	145	2	0	200	0	-200	0.00	0.00	0	0	0
0023	3F	02_11	146	10	1	1000	1060	60	0.10	1.06	1	1	0
0023	3F	02_12	123	65	10	6500	4110	-2390	0.15	0.63	11	7	-4
0023	3F	02_12	124	97	21	9700	9850	150	0.22	1.02	17	17	0
0023	3F	02_12	125	15	2	1500	720	-780	0.13	0.48	2	1	-1
0023	3F	02_12	126	28	0	2800	0	-2800	0.00	0.00	4	0	-4
0023	3F	02_12	134	19	3	1900	1060	-840	0.16	0.56	3	1	-2
0023	3F	02_12	135	8	1	800	440	-360	0.13	0.55	1	0	-1
0023	3F	02_12	136	6	1	600	440	-160	0.17	0.73	1	0	-1
0023	3F	02_12	145	4	1	400	770	370	0.25	1.93	0	1	1
0023	3F	02_12	246	1	0	100	0	-100	0.00	0.00	0	0	0
0023	3F	02_2	123	2	1	200	280	80	0.50	1.40	0	0	0
0023	3F	02_2	124	21	6	2100	2480	380	0.29	1.18	3	4	1
0023	3F	02_2	125	4	0	400	0	-400	0.00	0.00	0	0	0
0023	3F	02_2	126	4	2	400	610	210	0.50	1.53	0	1	1
0023	3F	02_2	134	5	0	500	0	-500	0.00	0.00	0	0	0
0023	3F	02_2	135	1	0	100	0	-100	0.00	0.00	0	0	0
0023	3F	02_2	145	5	1	500	340	-160	0.20	0.68	0	0	0
0023	3F	02_2	146	6	2	600	540	-60	0.33	0.90	1	0	-1
0023	3F	02_2	234	1	0	100	0	-100	0.00	0.00	0	0	0
0023	3F	02_2	246	1	0	100	0	-100	0.00	0.00	0	0	0
0023	3F	02_3	123	22	6	2200	2070	-130	0.27	0.94	3	3	0
0023	3F	02_3	124	17	3	1700	1020	-680	0.18	0.60	3	1	-2
0023	3F	02_3	125	29	4	2900	2310	-590	0.14	0.80	5	4	-1
0023	3F	02_3	126	25	2	2500	1220	-1280	0.08	0.49	4	2	-2
0023	3F	02_3	134	8	5	800	1690	890	0.63	2.11	1	2	1
0023	3F	02_3	135	13	6	1300	3410	2110	0.46	2.62	2	6	4
0023	3F	02_3	136	17	1	1700	380	-1320	0.06	0.22	3	0	-3
0023	3F	02_3	145	4	1	400	460	60	0.25	1.15	0	0	0
0023	3F	02_3	146	7	1	700	1310	610	0.14	1.87	1	2	1
0023	3F	02_3	156	1	0	100	0	-100	0.00	0.00	0	0	0
0023	3F	02_3	234	1	1	100	320	220	1.00	3.20	0	0	0
0023	3F	02_3	235	1	0	100	0	-100	0.00	0.00	0	0	0
0023	3F	02_3	236	1	0	100	0	-100	0.00	0.00	0	0	0
0023	3F	02_3	246	3	0	300	0	-300	0.00	0.00	0	0	0
0023	3F	02_3	256	1	0	100	0	-100	0.00	0.00	0	0	0
0023	3F	02_4	123	22	2	2200	500	-1700	0.09	0.23	3	0	-3
0023	3F	02_4	124	33	5	3300	1910	-1390	0.15	0.58	5	3	-2
0023	3F	02_4	125	19	5	1900	2950	1050	0.26	1.55	3	5	2
0023	3F	02_4	126	29	2	2900	620	-2280	0.07	0.21	5	1	-4
0023	3F	02_4	134	15	5	1500	1480	-20	0.33	0.99	2	2	0
0023	3F	02_4	135	23	4	2300	1070	-1230	0.17	0.47	4	1	-3
0023	3F	02_4	136	15	4	1500	2930	1430	0.27	1.95	2	5	3
0023	3F	02_4	145	6	0	600	0	-600	0.00	0.00	1	0	-1
0023	3F	02_4	146	5	1	500	1190	690	0.20	2.38	0	2	2
0023	3F	02_4	156	3	1	300	1260	960	0.33	4.20	0	2	2
0023	3F	02_4	234	1	0	100	0	-100	0.00	0.00	0	0	0
0023	3F	02_4	236	1	0	100	0	-100	0.00	0.00	0	0	0
0023	3F	02_4	245	2	1	200	340	140	0.50	1.70	0	0	0
0023	3F	02_4	246	1	1	100	820	720	1.00	8.20	0	1	1
0023	3F	02_5	123	29	8	2900	2130	-770	0.28	0.73	5	3	-2
0023	3F	02_5	124	29	6	2900	2580	-320	0.21	0.89	5	4	-1
0023	3F	02_5	125	24	8	2400	2450	50	0.33	1.02	4	4	0
0023	3F	02_5	126	29	4	2900	1800	-1100	0.14	0.62	5	3	-2
0023	3F	02_5	134	9	2	900	650	-250	0.22	0.72	1	1	0
0023	3F	02_5	135	15	0	1500	0	-1500	0.00	0.00	2	0	-2
0023	3F	02_5	136	9	1	900	680	-220	0.11	0.76	1	1	0
0023	3F	02_5	145	4	0	400	0	-400	0.00	0.00	0	0	0
0023	3F	02_5	146	6	1	600	410	-190	0.17	0.68	1	0	-1
0023	3F	02_5	156	2	1	200	630	430	0.50	3.15	0	1	1
0023	3F	02_5	235	1	0	100	0	-100	0.00	0.00	0	0	0
0023	3F	02_5	256	1	0	100	0	-100	0.00	0.00	0	0	0
0023	3F	02_6	123	20	9	2000	2390	390	0.45	1.20	3	4	1
0023	3F	02_6	124	27	6	2700	1990	-710	0.22	0.74	4	3	-1
0023	3F	02_6	125	20	3	2000	1850	-150	0.15	0.93	3	3	0
0023	3F	02_6	126	25	6	2500	3690	1190	0.24	1.48	4	6	2
0023	3F	02_6	134	9	1	900	380	-520	0.11	0.42	1	0	-1
0023	3F	02_6	135	13	4	1300	1310	10	0.31	1.01	2	2	0
0023	3F	02_6	136	16	5	1600	2820	1220	0.31	1.76	2	4	2
0023	3F	02_6	145	2	0	200	0	-200	0.00	0.00	0	0	0
0023	3F	02_6	146	4	2	400	1840	1440	0.50	4.60	0	3	3
0023	3F	02_6	156	3	0	300	0	-300	0.00	0.00	0	0	0
0023	3F	02_6	235	1	0	100	0	-100	0.00	0.00	0	0	0
0023	3F	02_6	256	2	1	200	300	100	0.50	1.50	0	0	0
0023	3F	02_7	123	58	13	5800	5710	-90	0.22	0.98	10	10	0
0023	3F	02_7	124	40	7	4000	2010	-1990	0.18	0.50	7	3	-4
0023	3F	02_7	125	12	0	1200	0	-1200	0.00	0.00	2	0	-2
0023	3F	02_7	126	12	1	1200	450	-750	0.08	0.38	2	0	-2
0023	3F	02_7	134	5	0	500	0	-500	0.00	0.00	0	0	0
0023	3F	02_7	135	5	1	500	750	250	0.20	1.50	0	1	1
0023	3F	02_7	136	6	2	600	540	-60	0.33	0.90	1	0	-1
0023	3F	02_7	145	2	0	200	0	-200	0.00	0.00	0	0	0
0023	3F	02_7	146	1	0	100	0	-100	0.00	0.00	0	0	0
0023	3F	02_8	123	28	5	2800	1270	-1530	0.18	0.45	4	2	-2
0023	3F	02_8	124	24	4	2400	1470	-930	0.17	0.61	4	2	-2
0023	3F	02_8	125	24	2	2400	470	-1930	0.08	0.20	4	0	-4
0023	3F	02_8	126	24	6	2400	3460	1060	0.25	1.44	4	6	2
0023	3F	02_8	134	16	2	1600	740	-860	0.13	0.46	2	1	-1
0023	3F	02_8	135	6	0	600	0	-600	0.00	0.00	1	0	-1
0023	3F	02_8	136	22	8	2200	4210	2010	0.36	1.91	3	7	4
0023	3F	02_8	145	3	0	300	0	-300	0.00	0.00	0	0	0
0023	3F	02_8	146	9	1	900	750	-150	0.11	0.83	1	1	0
0023	3F	02_8	156	1	0	100	0	-100	0.00	0.00	0	0	0
0023	3F	02_8	235	1	0	100	0	-100	0.00	0.00	0	0	0
0023	3F	02_8	236	1	0	100	0	-100	0.00	0.00	0	0	0
0023	3F	02_8	245	1	0	100	0	-100	0.00	0.00	0	0	0
0023	3F	02_9	123	42	12	4200	3800	-400	0.29	0.90	7	6	-1
0023	3F	02_9	124	31	3	3100	1080	-2020	0.10	0.35	5	1	-4
0023	3F	02_9	125	39	7	3900	3930	30	0.18	1.01	6	6	0
0023	3F	02_9	126	30	5	3000	3060	60	0.17	1.02	5	5	0
0023	3F	02_9	134	17	2	1700	530	-1170	0.12	0.31	3	0	-3
0023	3F	02_9	135	23	3	2300	980	-1320	0.13	0.43	4	1	-3
0023	3F	02_9	136	20	3	2000	1090	-910	0.15	0.55	3	1	-2
0023	3F	02_9	145	3	1	300	690	390	0.33	2.30	0	1	1
0023	3F	02_9	146	7	1	700	790	90	0.14	1.13	1	1	0
0023	3F	02_9	156	2	0	200	0	-200	0.00	0.00	0	0	0
0023	3F	03_1	123	22	6	2200	2190	-10	0.27	1.00	3	3	0
0023	3F	03_1	124	13	2	1300	1360	60	0.15	1.05	2	2	0
0023	3F	03_1	125	7	0	700	0	-700	0.00	0.00	1	0	-1
0023	3F	03_1	126	9	0	900	0	-900	0.00	0.00	1	0	-1
0023	3F	03_1	134	6	0	600	0	-600	0.00	0.00	1	0	-1
0023	3F	03_1	135	2	0	200	0	-200	0.00	0.00	0	0	0
0023	3F	03_1	136	5	1	500	440	-60	0.20	0.88	0	0	0
0023	3F	03_1	145	2	0	200	0	-200	0.00	0.00	0	0	0
0023	3F	03_10	123	22	6	2200	1450	-750	0.27	0.66	3	2	-1
0023	3F	03_10	124	44	12	4400	4230	-170	0.27	0.96	7	7	0
0023	3F	03_10	125	21	5	2100	1490	-610	0.24	0.71	3	2	-1
0023	3F	03_10	126	21	5	2100	2140	40	0.24	1.02	3	3	0
0023	3F	03_10	134	17	3	1700	1160	-540	0.18	0.68	3	2	-1
0023	3F	03_10	135	10	3	1000	1890	890	0.30	1.89	1	3	2
0023	3F	03_10	136	3	0	300	0	-300	0.00	0.00	0	0	0
0023	3F	03_10	146	6	0	600	0	-600	0.00	0.00	1	0	-1
0023	3F	03_10	156	2	0	200	0	-200	0.00	0.00	0	0	0
0023	3F	03_11	123	28	14	2800	4410	1610	0.50	1.58	4	7	3
0023	3F	03_11	124	51	10	5100	3860	-1240	0.20	0.76	9	6	-3
0023	3F	03_11	125	21	0	2100	0	-2100	0.00	0.00	3	0	-3
0023	3F	03_11	126	19	1	1900	3220	1320	0.05	1.69	3	5	2
0023	3F	03_11	134	13	3	1300	1240	-60	0.23	0.95	2	2	0
0023	3F	03_11	135	16	5	1600	1920	320	0.31	1.20	2	3	1
0023	3F	03_11	136	15	3	1500	3390	1890	0.20	2.26	2	6	4
0023	3F	03_12	123	33	13	3300	5430	2130	0.39	1.65	5	9	4
0023	3F	03_12	124	86	10	8600	4860	-3740	0.12	0.57	15	8	-7
0023	3F	03_12	125	15	2	1500	960	-540	0.13	0.64	2	1	-1
0023	3F	03_12	126	13	1	1300	1420	120	0.08	1.09	2	2	0
0023	3F	03_12	134	13	4	1300	1560	260	0.31	1.20	2	2	0
0023	3F	03_12	135	3	0	300	0	-300	0.00	0.00	0	0	0
0023	3F	03_12	136	3	1	300	740	440	0.33	2.47	0	1	1
0023	3F	03_12	146	1	1	100	1050	950	1.00	10.50	0	1	1
0023	3F	03_12	156	1	0	100	0	-100	0.00	0.00	0	0	0
0023	3F	03_12	246	1	0	100	0	-100	0.00	0.00	0	0	0
0023	3F	03_2	123	15	3	1500	860	-640	0.20	0.57	2	1	-1
0023	3F	03_2	124	15	2	1500	660	-840	0.13	0.44	2	1	-1
0023	3F	03_2	125	19	2	1900	1080	-820	0.11	0.57	3	1	-2
0023	3F	03_2	126	9	2	900	1530	630	0.22	1.70	1	2	1
0023	3F	03_2	134	9	4	900	1210	310	0.44	1.34	1	2	1
0023	3F	03_2	135	8	1	800	950	150	0.13	1.19	1	1	0
0023	3F	03_2	136	11	2	1100	2880	1780	0.18	2.62	1	5	4
0023	3F	03_2	145	1	0	100	0	-100	0.00	0.00	0	0	0
0023	3F	03_2	146	6	0	600	0	-600	0.00	0.00	1	0	-1
0023	3F	03_2	156	2	0	200	0	-200	0.00	0.00	0	0	0
0023	3F	03_2	245	1	0	100	0	-100	0.00	0.00	0	0	0
0023	3F	03_2	246	1	0	100	0	-100	0.00	0.00	0	0	0
0023	3F	03_3	123	12	4	1200	850	-350	0.33	0.71	2	1	-1
0023	3F	03_3	124	6	2	600	1030	430	0.33	1.72	1	1	0
0023	3F	03_3	125	16	7	1600	3380	1780	0.44	2.11	2	5	3
0023	3F	03_3	126	15	3	1500	1290	-210	0.20	0.86	2	2	0
0023	3F	03_3	134	16	2	1600	450	-1150	0.13	0.28	2	0	-2
0023	3F	03_3	135	9	2	900	800	-100	0.22	0.89	1	1	0
0023	3F	03_3	136	6	1	600	440	-160	0.17	0.73	1	0	-1
0023	3F	03_3	145	4	0	400	0	-400	0.00	0.00	0	0	0
0023	3F	03_3	146	5	0	500	0	-500	0.00	0.00	0	0	0
0023	3F	03_3	156	3	0	300	0	-300	0.00	0.00	0	0	0
0023	3F	03_3	235	2	0	200	0	-200	0.00	0.00	0	0	0
0023	3F	03_3	246	3	0	300	0	-300	0.00	0.00	0	0	0
0023	3F	03_3	256	1	0	100	0	-100	0.00	0.00	0	0	0
0023	3F	03_4	123	12	0	1200	0	-1200	0.00	0.00	2	0	-2
0023	3F	03_4	124	12	6	1200	2870	1670	0.50	2.39	2	5	3
0023	3F	03_4	125	14	2	1400	710	-690	0.14	0.51	2	1	-1
0023	3F	03_4	126	13	1	1300	470	-830	0.08	0.36	2	0	-2
0023	3F	03_4	134	7	1	700	330	-370	0.14	0.47	1	0	-1
0023	3F	03_4	135	9	1	900	540	-360	0.11	0.60	1	0	-1
0023	3F	03_4	136	10	0	1000	0	-1000	0.00	0.00	1	0	-1
0023	3F	03_4	145	6	1	600	220	-380	0.17	0.37	1	0	-1
0023	3F	03_4	146	7	1	700	400	-300	0.14	0.57	1	0	-1
0023	3F	03_4	156	5	1	500	360	-140	0.20	0.72	0	0	0
0023	3F	03_4	236	1	0	100	0	-100	0.00	0.00	0	0	0
0023	3F	03_4	245	1	0	100	0	-100	0.00	0.00	0	0	0
0023	3F	03_4	246	2	0	200	0	-200	0.00	0.00	0	0	0
0023	3F	03_5	123	10	3	1000	850	-150	0.30	0.85	1	1	0
0023	3F	03_5	124	11	2	1100	460	-640	0.18	0.42	1	0	-1
0023	3F	03_5	125	10	2	1000	550	-450	0.20	0.55	1	0	-1
0023	3F	03_5	126	16	2	1600	1140	-460	0.13	0.71	2	2	0
0023	3F	03_5	134	13	3	1300	1710	410	0.23	1.32	2	3	1
0023	3F	03_5	135	13	2	1300	680	-620	0.15	0.52	2	1	-1
0023	3F	03_5	136	13	1	1300	500	-800	0.08	0.38	2	0	-2
0023	3F	03_5	145	6	1	600	570	-30	0.17	0.95	1	1	0
0023	3F	03_5	146	4	0	400	0	-400	0.00	0.00	0	0	0
0023	3F	03_5	156	1	0	100	0	-100	0.00	0.00	0	0	0
0023	3F	03_5	236	1	0	100	0	-100	0.00	0.00	0	0	0
0023	3F	03_5	245	2	0	200	0	-200	0.00	0.00	0	0	0
0023	3F	03_5	246	1	0	100	0	-100	0.00	0.00	0	0	0
0023	3F	03_5	256	1	0	100	0	-100	0.00	0.00	0	0	0
0023	3F	03_6	123	9	3	900	980	80	0.33	1.09	1	1	0
0023	3F	03_6	124	18	4	1800	1730	-70	0.22	0.96	3	3	0
0023	3F	03_6	125	7	4	700	2100	1400	0.57	3.00	1	3	2
0023	3F	03_6	126	16	5	1600	3550	1950	0.31	2.22	2	6	4
0023	3F	03_6	134	9	3	900	1560	660	0.33	1.73	1	2	1
0023	3F	03_6	135	11	0	1100	0	-1100	0.00	0.00	1	0	-1
0023	3F	03_6	136	15	2	1500	1370	-130	0.13	0.91	2	2	0
0023	3F	03_6	145	8	3	800	1300	500	0.38	1.63	1	2	1
0023	3F	03_6	146	5	0	500	0	-500	0.00	0.00	0	0	0
0023	3F	03_6	156	5	1	500	1020	520	0.20	2.04	0	1	1
0023	3F	03_6	234	2	1	200	620	420	0.50	3.10	0	1	1
0023	3F	03_6	235	1	0	100	0	-100	0.00	0.00	0	0	0
0023	3F	03_6	236	1	0	100	0	-100	0.00	0.00	0	0	0
0023	3F	03_7	123	17	4	1700	1430	-270	0.24	0.84	3	2	-1
0023	3F	03_7	124	17	3	1700	1050	-650	0.18	0.62	3	1	-2
0023	3F	03_7	125	14	2	1400	590	-810	0.14	0.42	2	1	-1
0023	3F	03_7	126	17	1	1700	500	-1200	0.06	0.29	3	0	-3
0023	3F	03_7	134	5	2	500	830	330	0.40	1.66	0	1	1
0023	3F	03_7	135	8	2	800	700	-100	0.25	0.88	1	1	0
0023	3F	03_7	136	10	2	1000	760	-240	0.20	0.76	1	1	0
0023	3F	03_7	145	8	4	800	1640	840	0.50	2.05	1	2	1
0023	3F	03_7	146	6	0	600	0	-600	0.00	0.00	1	0	-1
0023	3F	03_7	156	3	1	300	780	480	0.33	2.60	0	1	1
0023	3F	03_7	236	1	0	100	0	-100	0.00	0.00	0	0	0
0023	3F	03_7	256	1	0	100	0	-100	0.00	0.00	0	0	0
0023	3F	03_8	123	17	6	1700	1540	-160	0.35	0.91	3	2	-1
0023	3F	03_8	124	20	4	2000	1860	-140	0.20	0.93	3	3	0
0023	3F	03_8	125	10	2	1000	440	-560	0.20	0.44	1	0	-1
0023	3F	03_8	126	14	3	1400	1600	200	0.21	1.14	2	2	0
0023	3F	03_8	134	7	0	700	0	-700	0.00	0.00	1	0	-1
0023	3F	03_8	135	8	0	800	0	-800	0.00	0.00	1	0	-1
0023	3F	03_8	136	18	2	1800	630	-1170	0.11	0.35	3	1	-2
0023	3F	03_8	145	5	2	500	630	130	0.40	1.26	0	1	1
0023	3F	03_8	146	6	0	600	0	-600	0.00	0.00	1	0	-1
0023	3F	03_8	156	3	0	300	0	-300	0.00	0.00	0	0	0
0023	3F	03_9	123	26	9	2600	2640	40	0.35	1.02	4	4	0
0023	3F	03_9	124	19	3	1900	2580	680	0.16	1.36	3	4	1
0023	3F	03_9	125	16	1	1600	380	-1220	0.06	0.24	2	0	-2
0023	3F	03_9	126	16	5	1600	1660	60	0.31	1.04	2	2	0
0023	3F	03_9	134	13	3	1300	1160	-140	0.23	0.89	2	2	0
0023	3F	03_9	135	16	3	1600	1300	-300	0.19	0.81	2	2	0
0023	3F	03_9	136	11	1	1100	260	-840	0.09	0.24	1	0	-1
0023	3F	03_9	145	4	1	400	260	-140	0.25	0.65	0	0	0
0023	3F	03_9	146	1	0	100	0	-100	0.00	0.00	0	0	0
0023	3F	03_9	156	1	0	100	0	-100	0.00	0.00	0	0	0
0023	3F	04_1	123	20	2	2000	630	-1370	0.10	0.32	3	1	-2
0023	3F	04_1	124	11	2	1100	1290	190	0.18	1.17	1	2	1
0023	3F	04_1	125	4	0	400	0	-400	0.00	0.00	0	0	0
0023	3F	04_1	126	8	2	800	890	90	0.25	1.11	1	1	0
0023	3F	04_1	134	11	1	1100	180	-920	0.09	0.16	1	0	-1
0023	3F	04_1	135	6	2	600	1330	730	0.33	2.22	1	2	1
0023	3F	04_1	136	4	2	400	700	300	0.50	1.75	0	1	1
0023	3F	04_1	145	2	0	200	0	-200	0.00	0.00	0	0	0
0023	3F	04_1	146	3	2	300	840	540	0.67	2.80	0	1	1
0023	3F	04_1	234	1	0	100	0	-100	0.00	0.00	0	0	0
0023	3F	04_1	235	1	1	100	290	190	1.00	2.90	0	0	0
0023	3F	04_10	123	17	6	1700	1740	40	0.35	1.02	3	3	0
0023	3F	04_10	124	58	11	5800	4690	-1110	0.19	0.81	10	8	-2
0023	3F	04_10	125	29	8	2900	3860	960	0.28	1.33	5	6	1
0023	3F	04_10	126	13	1	1300	760	-540	0.08	0.58	2	1	-1
0023	3F	04_10	134	26	3	2600	1090	-1510	0.12	0.42	4	1	-3
0023	3F	04_10	135	30	2	3000	930	-2070	0.07	0.31	5	1	-4
0023	3F	04_10	136	6	0	600	0	-600	0.00	0.00	1	0	-1
0023	3F	04_10	145	9	1	900	510	-390	0.11	0.57	1	0	-1
0023	3F	04_10	146	3	0	300	0	-300	0.00	0.00	0	0	0
0023	3F	04_10	156	1	0	100	0	-100	0.00	0.00	0	0	0
0023	3F	04_10	246	1	1	100	650	550	1.00	6.50	0	1	1
0023	3F	04_11	123	14	5	1400	1320	-80	0.36	0.94	2	2	0
0023	3F	04_11	124	56	10	5600	4320	-1280	0.18	0.77	9	7	-2
0023	3F	04_11	125	38	5	3800	2910	-890	0.13	0.77	6	5	-1
0023	3F	04_11	126	17	0	1700	0	-1700	0.00	0.00	3	0	-3
0023	3F	04_11	134	26	5	2600	1850	-750	0.19	0.71	4	3	-1
0023	3F	04_11	135	31	7	3100	2220	-880	0.23	0.72	5	3	-2
0023	3F	04_11	136	6	0	600	0	-600	0.00	0.00	1	0	-1
0023	3F	04_11	145	13	2	1300	860	-440	0.15	0.66	2	1	-1
0023	3F	04_11	146	5	1	500	1380	880	0.20	2.76	0	2	2
0023	3F	04_11	156	1	0	100	0	-100	0.00	0.00	0	0	0
0023	3F	04_12	123	11	2	1100	680	-420	0.18	0.62	1	1	0
0023	3F	04_12	124	87	12	8700	4530	-4170	0.14	0.52	15	8	-7
0023	3F	04_12	125	48	7	4800	5000	200	0.15	1.04	8	8	0
0023	3F	04_12	126	11	0	1100	0	-1100	0.00	0.00	1	0	-1
0023	3F	04_12	134	20	5	2000	3040	1040	0.25	1.52	3	5	2
0023	3F	04_12	135	27	3	2700	1880	-820	0.11	0.70	4	3	-1
0023	3F	04_12	136	3	0	300	0	-300	0.00	0.00	0	0	0
0023	3F	04_12	145	9	0	900	0	-900	0.00	0.00	1	0	-1
0023	3F	04_12	146	1	1	100	1290	1190	1.00	12.90	0	2	2
0023	3F	04_2	123	13	2	1300	870	-430	0.15	0.67	2	1	-1
0023	3F	04_2	124	10	1	1000	280	-720	0.10	0.28	1	0	-1
0023	3F	04_2	125	10	3	1000	1120	120	0.30	1.12	1	1	0
0023	3F	04_2	126	8	2	800	2470	1670	0.25	3.09	1	4	3
0023	3F	04_2	134	6	1	600	580	-20	0.17	0.97	1	1	0
0023	3F	04_2	135	7	1	700	310	-390	0.14	0.44	1	0	-1
0023	3F	04_2	136	6	1	600	290	-310	0.17	0.48	1	0	-1
0023	3F	04_2	145	5	0	500	0	-500	0.00	0.00	0	0	0
0023	3F	04_2	146	8	1	800	880	80	0.13	1.10	1	1	0
0023	3F	04_2	156	1	0	100	0	-100	0.00	0.00	0	0	0
0023	3F	04_2	236	1	1	100	290	190	1.00	2.90	0	0	0
0023	3F	04_2	246	1	0	100	0	-100	0.00	0.00	0	0	0
0023	3F	04_3	123	16	6	1600	2000	400	0.38	1.25	2	3	1
0023	3F	04_3	124	23	7	2300	2570	270	0.30	1.12	4	4	0
0023	3F	04_3	125	9	1	900	220	-680	0.11	0.24	1	0	-1
0023	3F	04_3	126	20	3	2000	1220	-780	0.15	0.61	3	2	-1
0023	3F	04_3	134	5	1	500	930	430	0.20	1.86	0	1	1
0023	3F	04_3	135	10	1	1000	480	-520	0.10	0.48	1	0	-1
0023	3F	04_3	136	10	0	1000	0	-1000	0.00	0.00	1	0	-1
0023	3F	04_3	145	5	1	500	590	90	0.20	1.18	0	1	1
0023	3F	04_3	236	1	0	100	0	-100	0.00	0.00	0	0	0
0023	3F	04_3	245	1	0	100	0	-100	0.00	0.00	0	0	0
0023	3F	04_3	246	2	0	200	0	-200	0.00	0.00	0	0	0
0023	3F	04_4	123	7	2	700	970	270	0.29	1.39	1	1	0
0023	3F	04_4	124	20	3	2000	800	-1200	0.15	0.40	3	1	-2
0023	3F	04_4	125	18	4	1800	2810	1010	0.22	1.56	3	4	1
0023	3F	04_4	126	19	2	1900	2550	650	0.11	1.34	3	4	1
0023	3F	04_4	134	9	0	900	0	-900	0.00	0.00	1	0	-1
0023	3F	04_4	135	16	2	1600	770	-830	0.13	0.48	2	1	-1
0023	3F	04_4	136	7	2	700	950	250	0.29	1.36	1	1	0
0023	3F	04_4	145	6	0	600	0	-600	0.00	0.00	1	0	-1
0023	3F	04_4	146	10	0	1000	0	-1000	0.00	0.00	1	0	-1
0023	3F	04_4	156	2	0	200	0	-200	0.00	0.00	0	0	0
0023	3F	04_4	236	1	1	100	1450	1350	1.00	14.50	0	2	2
0023	3F	04_4	245	1	0	100	0	-100	0.00	0.00	0	0	0
0023	3F	04_4	246	1	0	100	0	-100	0.00	0.00	0	0	0
0023	3F	04_5	123	23	7	2300	2000	-300	0.30	0.87	4	3	-1
0023	3F	04_5	124	32	7	3200	2590	-610	0.22	0.81	5	4	-1
0023	3F	04_5	125	25	5	2500	2070	-430	0.20	0.83	4	3	-1
0023	3F	04_5	126	12	4	1200	1840	640	0.33	1.53	2	3	1
0023	3F	04_5	134	10	3	1000	1000	0	0.30	1.00	1	1	0
0023	3F	04_5	135	9	0	900	0	-900	0.00	0.00	1	0	-1
0023	3F	04_5	136	5	2	500	770	270	0.40	1.54	0	1	1
0023	3F	04_5	145	5	2	500	710	210	0.40	1.42	0	1	1
0023	3F	04_5	146	5	0	500	0	-500	0.00	0.00	0	0	0
0023	3F	04_5	156	1	1	100	390	290	1.00	3.90	0	0	0
0023	3F	04_5	234	1	1	100	210	110	1.00	2.10	0	0	0
0023	3F	04_5	236	3	1	300	1140	840	0.33	3.80	0	2	2
0023	3F	04_5	246	1	0	100	0	-100	0.00	0.00	0	0	0
0023	3F	04_5	256	1	0	100	0	-100	0.00	0.00	0	0	0
0023	3F	04_6	123	11	5	1100	1730	630	0.45	1.57	1	3	2
0023	3F	04_6	124	13	4	1300	930	-370	0.31	0.72	2	1	-1
0023	3F	04_6	125	13	6	1300	2410	1110	0.46	1.85	2	4	2
0023	3F	04_6	126	16	4	1600	1520	-80	0.25	0.95	2	2	0
0023	3F	04_6	134	11	3	1100	660	-440	0.27	0.60	1	1	0
0023	3F	04_6	135	10	5	1000	1950	950	0.50	1.95	1	3	2
0023	3F	04_6	136	7	1	700	330	-370	0.14	0.47	1	0	-1
0023	3F	04_6	145	8	2	800	970	170	0.25	1.21	1	1	0
0023	3F	04_6	146	11	1	1100	360	-740	0.09	0.33	1	0	-1
0023	3F	04_6	156	1	1	100	890	790	1.00	8.90	0	1	1
0023	3F	04_6	235	3	2	300	430	130	0.67	1.43	0	0	0
0023	3F	04_6	245	1	0	100	0	-100	0.00	0.00	0	0	0
0023	3F	04_7	123	10	0	1000	0	-1000	0.00	0.00	1	0	-1
0023	3F	04_7	124	24	2	2400	680	-1720	0.08	0.28	4	1	-3
0023	3F	04_7	125	15	0	1500	0	-1500	0.00	0.00	2	0	-2
0023	3F	04_7	126	23	5	2300	1340	-960	0.22	0.58	4	2	-2
0023	3F	04_7	134	13	4	1300	1340	40	0.31	1.03	2	2	0
0023	3F	04_7	135	17	1	1700	650	-1050	0.06	0.38	3	1	-2
0023	3F	04_7	136	5	3	500	3110	2610	0.60	6.22	0	5	5
0023	3F	04_7	145	5	0	500	0	-500	0.00	0.00	0	0	0
0023	3F	04_7	146	5	1	500	200	-300	0.20	0.40	0	0	0
0023	3F	04_7	156	5	1	500	740	240	0.20	1.48	0	1	1
0023	3F	04_7	235	1	0	100	0	-100	0.00	0.00	0	0	0
0023	3F	04_7	246	1	0	100	0	-100	0.00	0.00	0	0	0
0023	3F	04_8	123	13	3	1300	750	-550	0.23	0.58	2	1	-1
0023	3F	04_8	124	26	7	2600	3120	520	0.27	1.20	4	5	1
0023	3F	04_8	125	19	5	1900	1520	-380	0.26	0.80	3	2	-1
0023	3F	04_8	126	27	5	2700	2490	-210	0.19	0.92	4	4	0
0023	3F	04_8	134	15	2	1500	820	-680	0.13	0.55	2	1	-1
0023	3F	04_8	135	17	4	1700	2360	660	0.24	1.39	3	4	1
0023	3F	04_8	136	12	1	1200	310	-890	0.08	0.26	2	0	-2
0023	3F	04_8	145	7	1	700	290	-410	0.14	0.41	1	0	-1
0023	3F	04_8	146	7	3	700	1360	660	0.43	1.94	1	2	1
0023	3F	04_8	156	1	0	100	0	-100	0.00	0.00	0	0	0
0023	3F	04_8	246	1	0	100	0	-100	0.00	0.00	0	0	0
0023	3F	04_9	123	7	3	700	890	190	0.43	1.27	1	1	0
0023	3F	04_9	124	32	9	3200	3270	70	0.28	1.02	5	5	0
0023	3F	04_9	125	31	3	3100	1370	-1730	0.10	0.44	5	2	-3
0023	3F	04_9	126	23	6	2300	2840	540	0.26	1.23	4	5	1
0023	3F	04_9	134	10	1	1000	260	-740	0.10	0.26	1	0	-1
0023	3F	04_9	135	21	4	2100	1640	-460	0.19	0.78	3	2	-1
0023	3F	04_9	136	20	3	2000	1260	-740	0.15	0.63	3	2	-1
0023	3F	04_9	145	6	2	600	530	-70	0.33	0.88	1	0	-1
0023	3F	04_9	146	2	1	200	270	70	0.50	1.35	0	0	0
0023	3F	04_9	156	7	2	700	740	40	0.29	1.06	1	1	0
0023	3F	05_1	123	1	0	100	0	-100	0.00	0.00	0	0	0
0023	3F	05_1	124	76	24	7600	6720	-880	0.32	0.88	13	11	-2
0023	3F	05_1	125	2	0	200	0	-200	0.00	0.00	0	0	0
0023	3F	05_1	126	1	0	100	0	-100	0.00	0.00	0	0	0
0023	3F	05_1	134	26	2	2600	570	-2030	0.08	0.22	4	1	-3
0023	3F	05_1	135	3	1	300	360	60	0.33	1.20	0	0	0
0023	3F	05_1	136	1	0	100	0	-100	0.00	0.00	0	0	0
0023	3F	05_1	145	2	0	200	0	-200	0.00	0.00	0	0	0
0023	3F	05_1	146	7	0	700	0	-700	0.00	0.00	1	0	-1
0023	3F	05_10	123	25	5	2500	1420	-1080	0.20	0.57	4	2	-2
0023	3F	05_10	124	54	15	5400	4450	-950	0.28	0.82	9	7	-2
0023	3F	05_10	125	46	6	4600	3970	-630	0.13	0.86	8	7	-1
0023	3F	05_10	126	7	1	700	1220	520	0.14	1.74	1	2	1
0023	3F	05_10	134	29	3	2900	1730	-1170	0.10	0.60	5	3	-2
0023	3F	05_10	135	29	5	2900	1530	-1370	0.17	0.53	5	2	-3
0023	3F	05_10	136	8	2	800	1520	720	0.25	1.90	1	2	1
0023	3F	05_10	145	1	0	100	0	-100	0.00	0.00	0	0	0
0023	3F	05_10	146	1	0	100	0	-100	0.00	0.00	0	0	0
0023	3F	05_10	235	1	0	100	0	-100	0.00	0.00	0	0	0
0023	3F	05_10	246	1	0	100	0	-100	0.00	0.00	0	0	0
0023	3F	05_11	123	9	3	900	660	-240	0.33	0.73	1	1	0
0023	3F	05_11	124	48	8	4800	2990	-1810	0.17	0.62	8	5	-3
0023	3F	05_11	125	63	8	6300	5010	-1290	0.13	0.80	11	8	-3
0023	3F	05_11	126	20	4	2000	2200	200	0.20	1.10	3	3	0
0023	3F	05_11	134	19	5	1900	2440	540	0.26	1.28	3	4	1
0023	3F	05_11	135	39	9	3900	4250	350	0.23	1.09	6	7	1
0023	3F	05_11	136	9	1	900	860	-40	0.11	0.96	1	1	0
0023	3F	05_11	145	8	2	800	1000	200	0.25	1.25	1	1	0
0023	3F	05_11	146	4	0	400	0	-400	0.00	0.00	0	0	0
0023	3F	05_12	123	22	3	2200	690	-1510	0.14	0.31	3	1	-2
0023	3F	05_12	124	53	11	5300	4860	-440	0.21	0.92	9	8	-1
0023	3F	05_12	125	65	10	6500	5670	-830	0.15	0.87	11	10	-1
0023	3F	05_12	126	5	1	500	960	460	0.20	1.92	0	1	1
0023	3F	05_12	134	25	2	2500	870	-1630	0.08	0.35	4	1	-3
0023	3F	05_12	135	57	5	5700	2250	-3450	0.09	0.39	10	3	-7
0023	3F	05_12	136	3	1	300	330	30	0.33	1.10	0	0	0
0023	3F	05_12	145	4	3	400	1230	830	0.75	3.08	0	2	2
0023	3F	05_2	123	8	1	800	310	-490	0.13	0.39	1	0	-1
0023	3F	05_2	124	14	2	1400	860	-540	0.14	0.61	2	1	-1
0023	3F	05_2	125	17	3	1700	1490	-210	0.18	0.88	3	2	-1
0023	3F	05_2	126	13	0	1300	0	-1300	0.00	0.00	2	0	-2
0023	3F	05_2	134	20	3	2000	1070	-930	0.15	0.54	3	1	-2
0023	3F	05_2	135	13	4	1300	1820	520	0.31	1.40	2	3	1
0023	3F	05_2	136	12	1	1200	520	-680	0.08	0.43	2	0	-2
0023	3F	05_2	145	6	2	600	1000	400	0.33	1.67	1	1	0
0023	3F	05_2	146	2	2	200	2190	1990	1.00	10.95	0	3	3
0023	3F	05_2	156	1	1	100	580	480	1.00	5.80	0	1	1
0023	3F	05_2	245	1	0	100	0	-100	0.00	0.00	0	0	0
0023	3F	05_3	123	6	2	600	950	350	0.33	1.58	1	1	0
0023	3F	05_3	124	15	0	1500	0	-1500	0.00	0.00	2	0	-2
0023	3F	05_3	125	28	9	2800	3610	810	0.32	1.29	4	6	2
0023	3F	05_3	126	20	2	2000	1070	-930	0.10	0.54	3	1	-2
0023	3F	05_3	134	13	2	1300	430	-870	0.15	0.33	2	0	-2
0023	3F	05_3	135	11	2	1100	930	-170	0.18	0.85	1	1	0
0023	3F	05_3	136	6	0	600	0	-600	0.00	0.00	1	0	-1
0023	3F	05_3	145	8	2	800	1200	400	0.25	1.50	1	2	1
0023	3F	05_3	146	4	0	400	0	-400	0.00	0.00	0	0	0
0023	3F	05_3	156	6	0	600	0	-600	0.00	0.00	1	0	-1
0023	3F	05_3	235	4	0	400	0	-400	0.00	0.00	0	0	0
0023	3F	05_3	236	3	1	300	320	20	0.33	1.07	0	0	0
0023	3F	05_3	245	2	0	200	0	-200	0.00	0.00	0	0	0
0023	3F	05_3	246	1	0	100	0	-100	0.00	0.00	0	0	0
0023	3F	05_4	123	4	2	400	480	80	0.50	1.20	0	0	0
0023	3F	05_4	124	25	5	2500	1860	-640	0.20	0.74	4	3	-1
0023	3F	05_4	125	14	0	1400	0	-1400	0.00	0.00	2	0	-2
0023	3F	05_4	126	18	4	1800	1550	-250	0.22	0.86	3	2	-1
0023	3F	05_4	134	8	1	800	470	-330	0.13	0.59	1	0	-1
0023	3F	05_4	135	18	2	1800	680	-1120	0.11	0.38	3	1	-2
0023	3F	05_4	136	8	4	800	1480	680	0.50	1.85	1	2	1
0023	3F	05_4	145	8	1	800	470	-330	0.13	0.59	1	0	-1
0023	3F	05_4	146	9	0	900	0	-900	0.00	0.00	1	0	-1
0023	3F	05_4	156	3	0	300	0	-300	0.00	0.00	0	0	0
0023	3F	05_4	235	4	0	400	0	-400	0.00	0.00	0	0	0
0023	3F	05_4	256	2	0	200	0	-200	0.00	0.00	0	0	0
0023	3F	05_5	123	4	0	400	0	-400	0.00	0.00	0	0	0
0023	3F	05_5	124	23	3	2300	1650	-650	0.13	0.72	4	2	-2
0023	3F	05_5	125	19	6	1900	2780	880	0.32	1.46	3	4	1
0023	3F	05_5	126	26	0	2600	0	-2600	0.00	0.00	4	0	-4
0023	3F	05_5	134	4	1	400	160	-240	0.25	0.40	0	0	0
0023	3F	05_5	135	16	2	1600	360	-1240	0.13	0.23	2	0	-2
0023	3F	05_5	136	12	1	1200	560	-640	0.08	0.47	2	0	-2
0023	3F	05_5	145	6	0	600	0	-600	0.00	0.00	1	0	-1
0023	3F	05_5	146	8	0	800	0	-800	0.00	0.00	1	0	-1
0023	3F	05_5	156	1	0	100	0	-100	0.00	0.00	0	0	0
0023	3F	05_5	235	1	0	100	0	-100	0.00	0.00	0	0	0
0023	3F	05_5	245	1	1	100	240	140	1.00	2.40	0	0	0
0023	3F	05_5	246	1	0	100	0	-100	0.00	0.00	0	0	0
0023	3F	05_6	123	5	1	500	140	-360	0.20	0.28	0	0	0
0023	3F	05_6	124	16	3	1600	970	-630	0.19	0.61	2	1	-1
0023	3F	05_6	125	33	4	3300	930	-2370	0.12	0.28	5	1	-4
0023	3F	05_6	126	23	3	2300	1440	-860	0.13	0.63	4	2	-2
0023	3F	05_6	134	8	1	800	270	-530	0.13	0.34	1	0	-1
0023	3F	05_6	135	12	0	1200	0	-1200	0.00	0.00	2	0	-2
0023	3F	05_6	136	13	1	1300	250	-1050	0.08	0.19	2	0	-2
0023	3F	05_6	145	15	4	1500	1650	150	0.27	1.10	2	2	0
0023	3F	05_6	146	4	0	400	0	-400	0.00	0.00	0	0	0
0023	3F	05_6	156	3	0	300	0	-300	0.00	0.00	0	0	0
0023	3F	05_6	234	2	0	200	0	-200	0.00	0.00	0	0	0
0023	3F	05_6	235	4	0	400	0	-400	0.00	0.00	0	0	0
0023	3F	05_6	236	2	2	200	1220	1020	1.00	6.10	0	2	2
0023	3F	05_6	246	1	0	100	0	-100	0.00	0.00	0	0	0
0023	3F	05_6	256	1	0	100	0	-100	0.00	0.00	0	0	0
0023	3F	05_7	123	11	5	1100	1820	720	0.45	1.65	1	3	2
0023	3F	05_7	124	42	9	4200	2520	-1680	0.21	0.60	7	4	-3
0023	3F	05_7	125	42	6	4200	3860	-340	0.14	0.92	7	6	-1
0023	3F	05_7	126	20	2	2000	1900	-100	0.10	0.95	3	3	0
0023	3F	05_7	134	15	2	1500	550	-950	0.13	0.37	2	0	-2
0023	3F	05_7	135	27	5	2700	1550	-1150	0.19	0.57	4	2	-2
0023	3F	05_7	136	10	0	1000	0	-1000	0.00	0.00	1	0	-1
0023	3F	05_7	145	8	0	800	0	-800	0.00	0.00	1	0	-1
0023	3F	05_7	146	4	1	400	220	-180	0.25	0.55	0	0	0
0023	3F	05_7	156	1	0	100	0	-100	0.00	0.00	0	0	0
0023	3F	05_7	235	1	0	100	0	-100	0.00	0.00	0	0	0
0023	3F	05_7	236	1	0	100	0	-100	0.00	0.00	0	0	0
0023	3F	05_7	245	1	0	100	0	-100	0.00	0.00	0	0	0
0023	3F	05_7	246	1	0	100	0	-100	0.00	0.00	0	0	0
0023	3F	05_8	123	7	1	700	720	20	0.14	1.03	1	1	0
0023	3F	05_8	124	34	7	3400	3120	-280	0.21	0.92	6	5	-1
0023	3F	05_8	125	40	6	4000	2250	-1750	0.15	0.56	7	3	-4
0023	3F	05_8	126	30	8	3000	6070	3070	0.27	2.02	5	10	5
0023	3F	05_8	134	18	1	1800	280	-1520	0.06	0.16	3	0	-3
0023	3F	05_8	135	26	3	2600	1530	-1070	0.12	0.59	4	2	-2
0023	3F	05_8	136	14	5	1400	1840	440	0.36	1.31	2	3	1
0023	3F	05_8	145	5	3	500	1240	740	0.60	2.48	0	2	2
0023	3F	05_8	146	3	1	300	350	50	0.33	1.17	0	0	0
0023	3F	05_8	156	1	0	100	0	-100	0.00	0.00	0	0	0
0023	3F	05_8	234	2	0	200	0	-200	0.00	0.00	0	0	0
0023	3F	05_8	235	2	0	200	0	-200	0.00	0.00	0	0	0
0023	3F	05_8	236	1	0	100	0	-100	0.00	0.00	0	0	0
0023	3F	05_9	123	50	14	5000	5150	150	0.28	1.03	8	9	1
0023	3F	05_9	124	50	7	5000	3510	-1490	0.14	0.70	8	6	-2
0023	3F	05_9	125	27	3	2700	1130	-1570	0.11	0.42	4	2	-2
0023	3F	05_9	126	16	5	1600	2470	870	0.31	1.54	2	4	2
0023	3F	05_9	134	14	2	1400	450	-950	0.14	0.32	2	0	-2
0023	3F	05_9	135	11	2	1100	1000	-100	0.18	0.91	1	1	0
0023	3F	05_9	136	3	0	300	0	-300	0.00	0.00	0	0	0
0023	3F	05_9	145	1	0	100	0	-100	0.00	0.00	0	0	0
0023	3F	06_1	123	22	1	2200	180	-2020	0.05	0.08	3	0	-3
0023	3F	06_1	124	64	8	6400	3390	-3010	0.13	0.53	11	6	-5
0023	3F	06_1	125	23	1	2300	370	-1930	0.04	0.16	4	0	-4
0023	3F	06_1	126	20	2	2000	1080	-920	0.10	0.54	3	1	-2
0023	3F	06_1	134	13	5	1300	1520	220	0.38	1.17	2	2	0
0023	3F	06_1	135	9	5	900	1590	690	0.56	1.77	1	2	1
0023	3F	06_1	136	4	1	400	460	60	0.25	1.15	0	0	0
0023	3F	06_1	145	3	0	300	0	-300	0.00	0.00	0	0	0
0023	3F	06_1	146	1	0	100	0	-100	0.00	0.00	0	0	0
0023	3F	06_1	156	1	0	100	0	-100	0.00	0.00	0	0	0
0023	3F	06_1	234	1	0	100	0	-100	0.00	0.00	0	0	0
0023	3F	06_1	235	2	0	200	0	-200	0.00	0.00	0	0	0
0023	3F	06_10	123	7	1	700	600	-100	0.14	0.86	1	1	0
0023	3F	06_10	124	54	16	5400	4700	-700	0.30	0.87	9	8	-1
0023	3F	06_10	125	69	16	6900	7850	950	0.23	1.14	12	13	1
0023	3F	06_10	126	12	2	1200	580	-620	0.17	0.48	2	1	-1
0023	3F	06_10	134	25	7	2500	2270	-230	0.28	0.91	4	4	0
0023	3F	06_10	135	42	3	4200	910	-3290	0.07	0.22	7	1	-6
0023	3F	06_10	136	11	2	1100	660	-440	0.18	0.60	1	1	0
0023	3F	06_10	145	9	0	900	0	-900	0.00	0.00	1	0	-1
0023	3F	06_10	146	2	1	200	450	250	0.50	2.25	0	0	0
0023	3F	06_10	156	1	0	100	0	-100	0.00	0.00	0	0	0
0023	3F	06_10	256	1	0	100	0	-100	0.00	0.00	0	0	0
0023	3F	06_11	123	16	6	1600	1410	-190	0.38	0.88	2	2	0
0023	3F	06_11	124	51	15	5100	4840	-260	0.29	0.95	9	8	-1
0023	3F	06_11	125	64	8	6400	3780	-2620	0.13	0.59	11	6	-5
0023	3F	06_11	126	8	3	800	2660	1860	0.38	3.33	1	4	3
0023	3F	06_11	134	40	7	4000	3270	-730	0.18	0.82	7	5	-2
0023	3F	06_11	135	53	8	5300	3720	-1580	0.15	0.70	9	6	-3
0023	3F	06_11	136	3	0	300	0	-300	0.00	0.00	0	0	0
0023	3F	06_11	145	11	2	1100	970	-130	0.18	0.88	1	1	0
0023	3F	06_11	146	2	1	200	460	260	0.50	2.30	0	0	0
0023	3F	06_12	123	6	2	600	440	-160	0.33	0.73	1	0	-1
0023	3F	06_12	124	41	8	4100	3500	-600	0.20	0.85	7	6	-1
0023	3F	06_12	125	115	15	11500	10520	-980	0.13	0.91	20	18	-2
0023	3F	06_12	134	20	6	2000	2700	700	0.30	1.35	3	4	1
0023	3F	06_12	135	73	13	7300	6890	-410	0.18	0.94	12	12	0
0023	3F	06_12	136	2	0	200	0	-200	0.00	0.00	0	0	0
0023	3F	06_12	145	7	2	700	1280	580	0.29	1.83	1	2	1
0023	3F	06_12	146	1	0	100	0	-100	0.00	0.00	0	0	0
0023	3F	06_2	123	6	1	600	360	-240	0.17	0.60	1	0	-1
0023	3F	06_2	124	21	2	2100	790	-1310	0.10	0.38	3	1	-2
0023	3F	06_2	125	23	4	2300	1390	-910	0.17	0.60	4	2	-2
0023	3F	06_2	126	27	2	2700	1340	-1360	0.07	0.50	4	2	-2
0023	3F	06_2	134	10	0	1000	0	-1000	0.00	0.00	1	0	-1
0023	3F	06_2	135	18	3	1800	1260	-540	0.17	0.70	3	2	-1
0023	3F	06_2	136	10	0	1000	0	-1000	0.00	0.00	1	0	-1
0023	3F	06_2	145	4	1	400	330	-70	0.25	0.83	0	0	0
0023	3F	06_2	146	4	0	400	0	-400	0.00	0.00	0	0	0
0023	3F	06_2	156	1	1	100	270	170	1.00	2.70	0	0	0
0023	3F	06_2	234	2	0	200	0	-200	0.00	0.00	0	0	0
0023	3F	06_2	235	4	0	400	0	-400	0.00	0.00	0	0	0
0023	3F	06_2	236	2	0	200	0	-200	0.00	0.00	0	0	0
0023	3F	06_2	246	1	0	100	0	-100	0.00	0.00	0	0	0
0023	3F	06_3	123	7	3	700	870	170	0.43	1.24	1	1	0
0023	3F	06_3	124	9	1	900	390	-510	0.11	0.43	1	0	-1
0023	3F	06_3	125	25	3	2500	1560	-940	0.12	0.62	4	2	-2
0023	3F	06_3	126	25	5	2500	2710	210	0.20	1.08	4	4	0
0023	3F	06_3	134	8	1	800	200	-600	0.13	0.25	1	0	-1
0023	3F	06_3	135	13	1	1300	2000	700	0.08	1.54	2	3	1
0023	3F	06_3	136	19	6	1900	4770	2870	0.32	2.51	3	8	5
0023	3F	06_3	145	5	0	500	0	-500	0.00	0.00	0	0	0
0023	3F	06_3	146	6	1	600	3140	2540	0.17	5.23	1	5	4
0023	3F	06_3	234	1	0	100	0	-100	0.00	0.00	0	0	0
0023	3F	06_3	235	3	0	300	0	-300	0.00	0.00	0	0	0
0023	3F	06_3	245	2	0	200	0	-200	0.00	0.00	0	0	0
0023	3F	06_3	246	3	1	300	210	-90	0.33	0.70	0	0	0
0023	3F	06_3	256	1	0	100	0	-100	0.00	0.00	0	0	0
0023	3F	06_4	123	47	16	4700	5540	840	0.34	1.18	8	9	1
0023	3F	06_4	124	72	18	7200	7720	520	0.25	1.07	12	13	1
0023	3F	06_4	125	20	4	2000	1290	-710	0.20	0.65	3	2	-1
0023	3F	06_4	126	13	4	1300	1890	590	0.31	1.45	2	3	1
0023	3F	06_4	134	22	5	2200	1280	-920	0.23	0.58	3	2	-1
0023	3F	06_4	135	8	4	800	1040	240	0.50	1.30	1	1	0
0023	3F	06_4	136	3	0	300	0	-300	0.00	0.00	0	0	0
0023	3F	06_4	145	1	0	100	0	-100	0.00	0.00	0	0	0
0023	3F	06_5	123	5	0	500	0	-500	0.00	0.00	0	0	0
0023	3F	06_5	124	15	6	1500	3440	1940	0.40	2.29	2	6	4
0023	3F	06_5	125	18	4	1800	1890	90	0.22	1.05	3	3	0
0023	3F	06_5	126	22	2	2200	670	-1530	0.09	0.30	3	1	-2
0023	3F	06_5	134	12	3	1200	800	-400	0.25	0.67	2	1	-1
0023	3F	06_5	135	19	2	1900	470	-1430	0.11	0.25	3	0	-3
0023	3F	06_5	136	14	1	1400	410	-990	0.07	0.29	2	0	-2
0023	3F	06_5	145	7	3	700	910	210	0.43	1.30	1	1	0
0023	3F	06_5	146	6	1	600	250	-350	0.17	0.42	1	0	-1
0023	3F	06_5	235	3	2	300	690	390	0.67	2.30	0	1	1
0023	3F	06_5	236	4	0	400	0	-400	0.00	0.00	0	0	0
0023	3F	06_5	246	3	1	300	160	-140	0.33	0.53	0	0	0
0023	3F	06_5	256	1	0	100	0	-100	0.00	0.00	0	0	0
0023	3F	06_6	123	8	3	800	1310	510	0.38	1.64	1	2	1
0023	3F	06_6	124	16	3	1600	710	-890	0.19	0.44	2	1	-1
0023	3F	06_6	125	27	4	2700	1670	-1030	0.15	0.62	4	2	-2
0023	3F	06_6	126	23	1	2300	190	-2110	0.04	0.08	4	0	-4
0023	3F	06_6	134	13	4	1300	1200	-100	0.31	0.92	2	2	0
0023	3F	06_6	135	15	5	1500	1250	-250	0.33	0.83	2	2	0
0023	3F	06_6	136	17	4	1700	1230	-470	0.24	0.72	3	2	-1
0023	3F	06_6	145	6	0	600	0	-600	0.00	0.00	1	0	-1
0023	3F	06_6	146	6	1	600	190	-410	0.17	0.32	1	0	-1
0023	3F	06_6	156	1	0	100	0	-100	0.00	0.00	0	0	0
0023	3F	06_6	234	2	0	200	0	-200	0.00	0.00	0	0	0
0023	3F	06_6	235	1	1	100	1050	950	1.00	10.50	0	1	1
0023	3F	06_6	245	1	0	100	0	-100	0.00	0.00	0	0	0
0023	3F	06_6	246	1	0	100	0	-100	0.00	0.00	0	0	0
0023	3F	06_6	256	1	0	100	0	-100	0.00	0.00	0	0	0
0023	3F	06_7	123	8	3	800	1540	740	0.38	1.93	1	2	1
0023	3F	06_7	124	36	6	3600	2320	-1280	0.17	0.64	6	4	-2
0023	3F	06_7	125	40	12	4000	3570	-430	0.30	0.89	7	6	-1
0023	3F	06_7	126	27	5	2700	2910	210	0.19	1.08	4	5	1
0023	3F	06_7	134	19	1	1900	360	-1540	0.05	0.19	3	0	-3
0023	3F	06_7	135	24	3	2400	760	-1640	0.13	0.32	4	1	-3
0023	3F	06_7	136	27	3	2700	1240	-1460	0.11	0.46	4	2	-2
0023	3F	06_7	145	8	2	800	440	-360	0.25	0.55	1	0	-1
0023	3F	06_7	146	10	1	1000	360	-640	0.10	0.36	1	0	-1
0023	3F	06_7	156	4	1	400	250	-150	0.25	0.63	0	0	0
0023	3F	06_7	236	1	0	100	0	-100	0.00	0.00	0	0	0
0023	3F	06_7	246	2	2	200	1510	1310	1.00	7.55	0	2	2
0023	3F	06_8	123	9	4	900	1470	570	0.44	1.63	1	2	1
0023	3F	06_8	124	23	2	2300	820	-1480	0.09	0.36	4	1	-3
0023	3F	06_8	125	32	6	3200	4190	990	0.19	1.31	5	7	2
0023	3F	06_8	126	30	6	3000	2680	-320	0.20	0.89	5	4	-1
0023	3F	06_8	134	29	4	2900	1530	-1370	0.14	0.53	5	2	-3
0023	3F	06_8	135	33	10	3300	3230	-70	0.30	0.98	5	5	0
0023	3F	06_8	136	11	0	1100	0	-1100	0.00	0.00	1	0	-1
0023	3F	06_8	145	8	4	800	1390	590	0.50	1.74	1	2	1
0023	3F	06_8	146	11	1	1100	710	-390	0.09	0.65	1	1	0
0023	3F	06_8	156	1	0	100	0	-100	0.00	0.00	0	0	0
0023	3F	06_9	123	15	4	1500	1050	-450	0.27	0.70	2	1	-1
0023	3F	06_9	124	54	18	5400	4900	-500	0.33	0.91	9	8	-1
0023	3F	06_9	125	37	6	3700	2280	-1420	0.16	0.62	6	4	-2
0023	3F	06_9	126	5	0	500	0	-500	0.00	0.00	0	0	0
0023	3F	06_9	134	24	5	2400	1480	-920	0.21	0.62	4	2	-2
0023	3F	06_9	135	28	9	2800	2490	-310	0.32	0.89	4	4	0
0023	3F	06_9	136	5	0	500	0	-500	0.00	0.00	0	0	0
0023	3F	06_9	145	11	2	1100	590	-510	0.18	0.54	1	1	0
0023	3F	06_9	146	2	0	200	0	-200	0.00	0.00	0	0	0
0023	3F	06_9	235	2	1	200	250	50	0.50	1.25	0	0	0
0023	3F	07_1	123	26	4	2600	1670	-930	0.15	0.64	4	2	-2
0023	3F	07_1	124	16	2	1600	670	-930	0.13	0.42	2	1	-1
0023	3F	07_1	125	16	4	1600	2530	930	0.25	1.58	2	4	2
0023	3F	07_1	126	7	0	700	0	-700	0.00	0.00	1	0	-1
0023	3F	07_1	134	13	6	1300	2330	1030	0.46	1.79	2	4	2
0023	3F	07_1	135	7	1	700	280	-420	0.14	0.40	1	0	-1
0023	3F	07_1	136	5	0	500	0	-500	0.00	0.00	0	0	0
0023	3F	07_1	145	5	0	500	0	-500	0.00	0.00	0	0	0
0023	3F	07_1	156	1	0	100	0	-100	0.00	0.00	0	0	0
0023	3F	07_10	123	40	13	4000	3440	-560	0.33	0.86	7	6	-1
0023	3F	07_10	124	87	15	8700	4270	-4430	0.17	0.49	15	7	-8
0023	3F	07_10	125	34	4	3400	2580	-820	0.12	0.76	6	4	-2
0023	3F	07_10	126	15	3	1500	2590	1090	0.20	1.73	2	4	2
0023	3F	07_10	134	31	8	3100	4500	1400	0.26	1.45	5	7	2
0023	3F	07_10	135	20	1	2000	520	-1480	0.05	0.26	3	0	-3
0023	3F	07_10	136	9	0	900	0	-900	0.00	0.00	1	0	-1
0023	3F	07_10	145	4	2	400	750	350	0.50	1.88	0	1	1
0023	3F	07_10	146	4	0	400	0	-400	0.00	0.00	0	0	0
0023	3F	07_10	156	1	0	100	0	-100	0.00	0.00	0	0	0
0023	3F	07_10	235	1	0	100	0	-100	0.00	0.00	0	0	0
0023	3F	07_11	123	31	8	3100	2650	-450	0.26	0.85	5	4	-1
0023	3F	07_11	124	95	15	9500	5720	-3780	0.16	0.60	16	10	-6
0023	3F	07_11	125	26	4	2600	2770	170	0.15	1.07	4	4	0
0023	3F	07_11	126	12	2	1200	2210	1010	0.17	1.84	2	3	1
0023	3F	07_11	134	39	8	3900	2710	-1190	0.21	0.69	6	4	-2
0023	3F	07_11	135	33	4	3300	1930	-1370	0.12	0.58	5	3	-2
0023	3F	07_11	136	6	1	600	790	190	0.17	1.32	1	1	0
0023	3F	07_11	145	2	0	200	0	-200	0.00	0.00	0	0	0
0023	3F	07_11	146	2	1	200	380	180	0.50	1.90	0	0	0
0023	3F	07_11	156	1	0	100	0	-100	0.00	0.00	0	0	0
0023	3F	07_12	123	17	5	1700	1870	170	0.29	1.10	3	3	0
0023	3F	07_12	124	114	16	11400	6460	-4940	0.14	0.57	20	11	-9
0023	3F	07_12	125	22	4	2200	1960	-240	0.18	0.89	3	3	0
0023	3F	07_12	126	28	4	2800	3750	950	0.14	1.34	4	6	2
0023	3F	07_12	134	29	2	2900	1070	-1830	0.07	0.37	5	1	-4
0023	3F	07_12	135	14	0	1400	0	-1400	0.00	0.00	2	0	-2
0023	3F	07_12	136	6	0	600	0	-600	0.00	0.00	1	0	-1
0023	3F	07_12	145	8	1	800	540	-260	0.13	0.68	1	0	-1
0023	3F	07_12	146	3	2	300	1540	1240	0.67	5.13	0	2	2
0023	3F	07_2	123	20	5	2000	1820	-180	0.25	0.91	3	3	0
0023	3F	07_2	124	17	3	1700	1040	-660	0.18	0.61	3	1	-2
0023	3F	07_2	125	14	4	1400	1930	530	0.29	1.38	2	3	1
0023	3F	07_2	126	24	3	2400	1750	-650	0.13	0.73	4	3	-1
0023	3F	07_2	134	7	1	700	340	-360	0.14	0.49	1	0	-1
0023	3F	07_2	135	4	0	400	0	-400	0.00	0.00	0	0	0
0023	3F	07_2	136	12	4	1200	1700	500	0.33	1.42	2	3	1
0023	3F	07_2	145	2	0	200	0	-200	0.00	0.00	0	0	0
0023	3F	07_2	146	3	0	300	0	-300	0.00	0.00	0	0	0
0023	3F	07_2	156	3	0	300	0	-300	0.00	0.00	0	0	0
0023	3F	07_2	235	2	0	200	0	-200	0.00	0.00	0	0	0
0023	3F	07_2	245	1	0	100	0	-100	0.00	0.00	0	0	0
0023	3F	07_2	256	1	0	100	0	-100	0.00	0.00	0	0	0
0023	3F	07_3	123	14	5	1400	1240	-160	0.36	0.89	2	2	0
0023	3F	07_3	124	21	3	2100	1030	-1070	0.14	0.49	3	1	-2
0023	3F	07_3	125	26	2	2600	1690	-910	0.08	0.65	4	2	-2
0023	3F	07_3	126	24	3	2400	1690	-710	0.13	0.70	4	2	-2
0023	3F	07_3	134	12	2	1200	950	-250	0.17	0.79	2	1	-1
0023	3F	07_3	135	22	4	2200	1410	-790	0.18	0.64	3	2	-1
0023	3F	07_3	136	10	2	1000	860	-140	0.20	0.86	1	1	0
0023	3F	07_3	145	4	1	400	240	-160	0.25	0.60	0	0	0
0023	3F	07_3	146	4	1	400	620	220	0.25	1.55	0	1	1
0023	3F	07_3	156	5	1	500	330	-170	0.20	0.66	0	0	0
0023	3F	07_3	234	1	0	100	0	-100	0.00	0.00	0	0	0
0023	3F	07_3	235	1	0	100	0	-100	0.00	0.00	0	0	0
0023	3F	07_3	236	1	0	100	0	-100	0.00	0.00	0	0	0
0023	3F	07_3	245	1	0	100	0	-100	0.00	0.00	0	0	0
0023	3F	07_4	123	13	4	1300	1350	50	0.31	1.04	2	2	0
0023	3F	07_4	124	21	5	2100	1530	-570	0.24	0.73	3	2	-1
0023	3F	07_4	125	32	8	3200	4710	1510	0.25	1.47	5	8	3
0023	3F	07_4	126	34	6	3400	3550	150	0.18	1.04	6	6	0
0023	3F	07_4	134	15	3	1500	1010	-490	0.20	0.67	2	1	-1
0023	3F	07_4	135	17	3	1700	990	-710	0.18	0.58	3	1	-2
0023	3F	07_4	136	15	2	1500	1520	20	0.13	1.01	2	2	0
0023	3F	07_4	145	6	3	600	1350	750	0.50	2.25	1	2	1
0023	3F	07_4	146	2	0	200	0	-200	0.00	0.00	0	0	0
0023	3F	07_4	156	6	1	600	500	-100	0.17	0.83	1	0	-1
0023	3F	07_4	235	1	0	100	0	-100	0.00	0.00	0	0	0
0023	3F	07_4	236	1	0	100	0	-100	0.00	0.00	0	0	0
0023	3F	07_4	245	1	0	100	0	-100	0.00	0.00	0	0	0
0023	3F	07_4	246	1	0	100	0	-100	0.00	0.00	0	0	0
0023	3F	07_5	123	19	4	1900	1110	-790	0.21	0.58	3	1	-2
0023	3F	07_5	124	29	7	2900	2350	-550	0.24	0.81	5	4	-1
0023	3F	07_5	125	19	4	1900	1250	-650	0.21	0.66	3	2	-1
0023	3F	07_5	126	26	2	2600	1360	-1240	0.08	0.52	4	2	-2
0023	3F	07_5	134	11	0	1100	0	-1100	0.00	0.00	1	0	-1
0023	3F	07_5	135	5	0	500	0	-500	0.00	0.00	0	0	0
0023	3F	07_5	136	15	4	1500	1800	300	0.27	1.20	2	3	1
0023	3F	07_5	145	2	0	200	0	-200	0.00	0.00	0	0	0
0023	3F	07_5	146	5	2	500	2020	1520	0.40	4.04	0	3	3
0023	3F	07_5	156	4	3	400	1630	1230	0.75	4.08	0	2	2
0023	3F	07_5	235	3	2	300	460	160	0.67	1.53	0	0	0
0023	3F	07_5	236	4	1	400	400	0	0.25	1.00	0	0	0
0023	3F	07_5	256	2	0	200	0	-200	0.00	0.00	0	0	0
0023	3F	07_6	123	14	4	1400	1330	-70	0.29	0.95	2	2	0
0023	3F	07_6	124	23	5	2300	2020	-280	0.22	0.88	4	3	-1
0023	3F	07_6	125	28	8	2800	2160	-640	0.29	0.77	4	3	-1
0023	3F	07_6	126	38	9	3800	3720	-80	0.24	0.98	6	6	0
0023	3F	07_6	134	8	4	800	1670	870	0.50	2.09	1	2	1
0023	3F	07_6	135	18	4	1800	840	-960	0.22	0.47	3	1	-2
0023	3F	07_6	136	15	5	1500	1890	390	0.33	1.26	2	3	1
0023	3F	07_6	145	5	1	500	190	-310	0.20	0.38	0	0	0
0023	3F	07_6	146	6	1	600	1570	970	0.17	2.62	1	2	1
0023	3F	07_6	156	8	4	800	1580	780	0.50	1.98	1	2	1
0023	3F	07_6	235	1	0	100	0	-100	0.00	0.00	0	0	0
0023	3F	07_6	236	2	0	200	0	-200	0.00	0.00	0	0	0
0023	3F	07_7	123	5	1	500	420	-80	0.20	0.84	0	0	0
0023	3F	07_7	124	30	7	3000	1740	-1260	0.23	0.58	5	3	-2
0023	3F	07_7	125	13	2	1300	1860	560	0.15	1.43	2	3	1
0023	3F	07_7	134	84	32	8400	7060	-1340	0.38	0.84	14	12	-2
0023	3F	07_7	135	12	2	1200	860	-340	0.17	0.72	2	1	-1
0023	3F	07_7	145	58	16	5800	5090	-710	0.28	0.88	10	9	-1
0023	3F	07_7	146	1	0	100	0	-100	0.00	0.00	0	0	0
0023	3F	07_8	123	38	2	3800	580	-3220	0.05	0.15	6	1	-5
0023	3F	07_8	124	46	12	4600	3620	-980	0.26	0.79	8	6	-2
0023	3F	07_8	125	29	7	2900	2700	-200	0.24	0.93	5	4	-1
0023	3F	07_8	126	13	1	1300	200	-1100	0.08	0.15	2	0	-2
0023	3F	07_8	134	24	3	2400	2400	0	0.13	1.00	4	4	0
0023	3F	07_8	135	22	3	2200	680	-1520	0.14	0.31	3	1	-2
0023	3F	07_8	136	6	2	600	790	190	0.33	1.32	1	1	0
0023	3F	07_8	145	5	1	500	480	-20	0.20	0.96	0	0	0
0023	3F	07_8	146	8	2	800	710	-90	0.25	0.89	1	1	0
0023	3F	07_8	156	2	0	200	0	-200	0.00	0.00	0	0	0
0023	3F	07_8	245	1	0	100	0	-100	0.00	0.00	0	0	0
0023	3F	07_9	123	26	4	2600	1140	-1460	0.15	0.44	4	2	-2
0023	3F	07_9	124	76	14	7600	4450	-3150	0.18	0.59	13	7	-6
0023	3F	07_9	125	25	9	2500	3950	1450	0.36	1.58	4	6	2
0023	3F	07_9	126	7	1	700	460	-240	0.14	0.66	1	0	-1
0023	3F	07_9	134	42	7	4200	2240	-1960	0.17	0.53	7	3	-4
0023	3F	07_9	135	16	5	1600	1750	150	0.31	1.09	2	3	1
0023	3F	07_9	136	1	0	100	0	-100	0.00	0.00	0	0	0
0023	3F	07_9	145	6	2	600	760	160	0.33	1.27	1	1	0
0023	3F	07_9	146	2	1	200	540	340	0.50	2.70	0	0	0
0023	3F	07_9	236	1	0	100	0	-100	0.00	0.00	0	0	0
0023	3F	07_9	246	1	0	100	0	-100	0.00	0.00	0	0	0
0023	3F	08_1	123	23	1	2300	290	-2010	0.04	0.13	4	0	-4
0023	3F	08_1	124	25	5	2500	1970	-530	0.20	0.79	4	3	-1
0023	3F	08_1	125	20	3	2000	840	-1160	0.15	0.42	3	1	-2
0023	3F	08_1	126	6	2	600	720	120	0.33	1.20	1	1	0
0023	3F	08_1	134	10	2	1000	890	-110	0.20	0.89	1	1	0
0023	3F	08_1	135	8	1	800	320	-480	0.13	0.40	1	0	-1
0023	3F	08_1	136	7	0	700	0	-700	0.00	0.00	1	0	-1
0023	3F	08_1	145	7	1	700	230	-470	0.14	0.33	1	0	-1
0023	3F	08_1	146	2	0	200	0	-200	0.00	0.00	0	0	0
0023	3F	08_1	156	2	1	200	1300	1100	0.50	6.50	0	2	2
0023	3F	08_1	235	1	0	100	0	-100	0.00	0.00	0	0	0
0023	3F	08_10	123	31	11	3100	3010	-90	0.35	0.97	5	5	0
0023	3F	08_10	124	95	23	9500	7010	-2490	0.24	0.74	16	12	-4
0023	3F	08_10	125	33	2	3300	1710	-1590	0.06	0.52	5	3	-2
0023	3F	08_10	126	29	5	2900	2010	-890	0.17	0.69	5	3	-2
0023	3F	08_10	134	24	7	2400	2150	-250	0.29	0.90	4	3	-1
0023	3F	08_10	135	10	3	1000	790	-210	0.30	0.79	1	1	0
0023	3F	08_10	136	12	1	1200	250	-950	0.08	0.21	2	0	-2
0023	3F	08_10	146	3	1	300	1290	990	0.33	4.30	0	2	2
0023	3F	08_10	156	1	0	100	0	-100	0.00	0.00	0	0	0
0023	3F	08_10	236	1	1	100	360	260	1.00	3.60	0	0	0
0023	3F	08_11	123	34	11	3400	3200	-200	0.32	0.94	6	5	-1
0023	3F	08_11	124	119	25	11900	7790	-4110	0.21	0.65	21	13	-8
0023	3F	08_11	125	26	2	2600	720	-1880	0.08	0.28	4	1	-3
0023	3F	08_11	126	12	1	1200	1090	-110	0.08	0.91	2	1	-1
0023	3F	08_11	134	25	3	2500	1420	-1080	0.12	0.57	4	2	-2
0023	3F	08_11	135	12	2	1200	720	-480	0.17	0.60	2	1	-1
0023	3F	08_11	136	5	0	500	0	-500	0.00	0.00	0	0	0
0023	3F	08_11	145	3	1	300	310	10	0.33	1.03	0	0	0
0023	3F	08_11	146	2	1	200	340	140	0.50	1.70	0	0	0
0023	3F	08_12	123	27	15	2700	4020	1320	0.56	1.49	4	7	3
0023	3F	08_12	124	194	49	19400	20260	860	0.25	1.04	34	35	1
0023	3F	08_12	125	16	2	1600	1100	-500	0.13	0.69	2	1	-1
0023	3F	08_12	126	1	0	100	0	-100	0.00	0.00	0	0	0
0023	3F	08_12	134	16	5	1600	1800	200	0.31	1.13	2	3	1
0023	3F	08_12	135	6	0	600	0	-600	0.00	0.00	1	0	-1
0023	3F	08_12	136	4	0	400	0	-400	0.00	0.00	0	0	0
0023	3F	08_2	123	26	5	2600	2370	-230	0.19	0.91	4	4	0
0023	3F	08_2	124	16	1	1600	360	-1240	0.06	0.23	2	0	-2
0023	3F	08_2	125	24	7	2400	2200	-200	0.29	0.92	4	3	-1
0023	3F	08_2	126	24	7	2400	3410	1010	0.29	1.42	4	6	2
0023	3F	08_2	134	13	3	1300	1080	-220	0.23	0.83	2	1	-1
0023	3F	08_2	135	13	1	1300	230	-1070	0.08	0.18	2	0	-2
0023	3F	08_2	136	9	2	900	610	-290	0.22	0.68	1	1	0
0023	3F	08_2	145	8	1	800	260	-540	0.13	0.33	1	0	-1
0023	3F	08_2	146	5	0	500	0	-500	0.00	0.00	0	0	0
0023	3F	08_2	156	2	0	200	0	-200	0.00	0.00	0	0	0
0023	3F	08_2	234	1	0	100	0	-100	0.00	0.00	0	0	0
0023	3F	08_3	123	15	3	1500	820	-680	0.20	0.55	2	1	-1
0023	3F	08_3	124	27	4	2700	1160	-1540	0.15	0.43	4	2	-2
0023	3F	08_3	125	23	1	2300	330	-1970	0.04	0.14	4	0	-4
0023	3F	08_3	126	29	4	2900	1630	-1270	0.14	0.56	5	2	-3
0023	3F	08_3	134	8	2	800	620	-180	0.25	0.78	1	1	0
0023	3F	08_3	135	10	0	1000	0	-1000	0.00	0.00	1	0	-1
0023	3F	08_3	136	22	5	2200	1930	-270	0.23	0.88	3	3	0
0023	3F	08_3	145	7	1	700	550	-150	0.14	0.79	1	0	-1
0023	3F	08_3	146	11	1	1100	400	-700	0.09	0.36	1	0	-1
0023	3F	08_3	156	5	0	500	0	-500	0.00	0.00	0	0	0
0023	3F	08_3	236	2	0	200	0	-200	0.00	0.00	0	0	0
0023	3F	08_3	246	1	1	100	600	500	1.00	6.00	0	1	1
0023	3F	08_4	123	18	4	1800	720	-1080	0.22	0.40	3	1	-2
0023	3F	08_4	124	32	7	3200	3050	-150	0.22	0.95	5	5	0
0023	3F	08_4	125	21	6	2100	2070	-30	0.29	0.99	3	3	0
0023	3F	08_4	126	42	6	4200	2570	-1630	0.14	0.61	7	4	-3
0023	3F	08_4	134	19	6	1900	1610	-290	0.32	0.85	3	2	-1
0023	3F	08_4	135	23	4	2300	2140	-160	0.17	0.93	4	3	-1
0023	3F	08_4	136	17	4	1700	2260	560	0.24	1.33	3	4	1
0023	3F	08_4	145	8	1	800	310	-490	0.13	0.39	1	0	-1
0023	3F	08_4	146	10	1	1000	650	-350	0.10	0.65	1	1	0
0023	3F	08_4	156	4	0	400	0	-400	0.00	0.00	0	0	0
0023	3F	08_4	246	1	0	100	0	-100	0.00	0.00	0	0	0
0023	3F	08_5	123	25	6	2500	1980	-520	0.24	0.79	4	3	-1
0023	3F	08_5	124	35	13	3500	3900	400	0.37	1.11	6	6	0
0023	3F	08_5	125	29	5	2900	1790	-1110	0.17	0.62	5	3	-2
0023	3F	08_5	126	22	3	2200	950	-1250	0.14	0.43	3	1	-2
0023	3F	08_5	134	21	6	2100	1760	-340	0.29	0.84	3	3	0
0023	3F	08_5	135	19	3	1900	1360	-540	0.16	0.72	3	2	-1
0023	3F	08_5	136	22	5	2200	2000	-200	0.23	0.91	3	3	0
0023	3F	08_5	145	6	0	600	0	-600	0.00	0.00	1	0	-1
0023	3F	08_5	146	7	0	700	0	-700	0.00	0.00	1	0	-1
0023	3F	08_5	156	3	1	300	390	90	0.33	1.30	0	0	0
0023	3F	08_5	246	1	0	100	0	-100	0.00	0.00	0	0	0
0023	3F	08_6	123	10	2	1000	420	-580	0.20	0.42	1	0	-1
0023	3F	08_6	124	22	3	2200	5440	3240	0.14	2.47	3	9	6
0023	3F	08_6	125	19	2	1900	480	-1420	0.11	0.25	3	0	-3
0023	3F	08_6	126	30	6	3000	1800	-1200	0.20	0.60	5	3	-2
0023	3F	08_6	134	16	5	1600	1250	-350	0.31	0.78	2	2	0
0023	3F	08_6	135	11	3	1100	1190	90	0.27	1.08	1	2	1
0023	3F	08_6	136	17	4	1700	1020	-680	0.24	0.60	3	1	-2
0023	3F	08_6	145	8	2	800	610	-190	0.25	0.76	1	1	0
0023	3F	08_6	146	11	5	1100	1440	340	0.45	1.31	1	2	1
0023	3F	08_6	156	3	0	300	0	-300	0.00	0.00	0	0	0
0023	3F	08_6	234	2	0	200	0	-200	0.00	0.00	0	0	0
0023	3F	08_6	245	1	0	100	0	-100	0.00	0.00	0	0	0
0023	3F	08_6	246	1	1	100	360	260	1.00	3.60	0	0	0
0023	3F	08_7	123	15	2	1500	640	-860	0.13	0.43	2	1	-1
0023	3F	08_7	124	20	3	2000	1380	-620	0.15	0.69	3	2	-1
0023	3F	08_7	125	23	5	2300	2020	-280	0.22	0.88	4	3	-1
0023	3F	08_7	126	32	4	3200	2640	-560	0.13	0.83	5	4	-1
0023	3F	08_7	134	9	2	900	430	-470	0.22	0.48	1	0	-1
0023	3F	08_7	135	13	1	1300	210	-1090	0.08	0.16	2	0	-2
0023	3F	08_7	136	30	2	3000	990	-2010	0.07	0.33	5	1	-4
0023	3F	08_7	145	11	2	1100	750	-350	0.18	0.68	1	1	0
0023	3F	08_7	146	6	1	600	290	-310	0.17	0.48	1	0	-1
0023	3F	08_7	156	4	1	400	510	110	0.25	1.28	0	0	0
0023	3F	08_7	236	1	0	100	0	-100	0.00	0.00	0	0	0
0023	3F	08_8	123	11	5	1100	1000	-100	0.45	0.91	1	1	0
0023	3F	08_8	124	10	2	1000	570	-430	0.20	0.57	1	1	0
0023	3F	08_8	125	10	4	1000	1120	120	0.40	1.12	1	1	0
0023	3F	08_8	126	10	4	1000	1870	870	0.40	1.87	1	3	2
0023	3F	08_8	134	17	5	1700	1570	-130	0.29	0.92	3	2	-1
0023	3F	08_8	135	7	2	700	750	50	0.29	1.07	1	1	0
0023	3F	08_8	136	11	2	1100	760	-340	0.18	0.69	1	1	0
0023	3F	08_8	145	6	3	600	880	280	0.50	1.47	1	1	0
0023	3F	08_8	146	4	1	400	530	130	0.25	1.33	0	0	0
0023	3F	08_8	156	1	0	100	0	-100	0.00	0.00	0	0	0
0023	3F	08_8	234	1	0	100	0	-100	0.00	0.00	0	0	0
0023	3F	08_8	235	1	0	100	0	-100	0.00	0.00	0	0	0
0023	3F	08_9	123	36	16	3600	4150	550	0.44	1.15	6	7	1
0023	3F	08_9	124	53	7	5300	2120	-3180	0.13	0.40	9	3	-6
0023	3F	08_9	125	29	6	2900	4210	1310	0.21	1.45	5	7	2
0023	3F	08_9	126	20	4	2000	1510	-490	0.20	0.76	3	2	-1
0023	3F	08_9	134	20	7	2000	1910	-90	0.35	0.96	3	3	0
0023	3F	08_9	135	15	2	1500	950	-550	0.13	0.63	2	1	-1
0023	3F	08_9	136	7	2	700	1640	940	0.29	2.34	1	2	1
0023	3F	08_9	145	4	1	400	260	-140	0.25	0.65	0	0	0
0023	3F	08_9	146	6	1	600	150	-450	0.17	0.25	1	0	-1
0023	3F	08_9	156	3	1	300	250	-50	0.33	0.83	0	0	0
0023	3F	09_1	123	78	13	7800	3760	-4040	0.17	0.48	13	6	-7
0023	3F	09_1	124	58	13	5800	4720	-1080	0.22	0.81	10	8	-2
0023	3F	09_1	125	15	3	1500	940	-560	0.20	0.63	2	1	-1
0023	3F	09_1	126	15	4	1500	2220	720	0.27	1.48	2	3	1
0023	3F	09_1	134	6	1	600	250	-350	0.17	0.42	1	0	-1
0023	3F	09_1	135	5	0	500	0	-500	0.00	0.00	0	0	0
0023	3F	09_1	136	2	1	200	670	470	0.50	3.35	0	1	1
0023	3F	09_1	145	1	0	100	0	-100	0.00	0.00	0	0	0
0023	3F	09_10	123	30	12	3000	2980	-20	0.40	0.99	5	5	0
0023	3F	09_10	124	91	18	9100	5490	-3610	0.20	0.60	16	9	-7
0023	3F	09_10	125	28	6	2800	2200	-600	0.21	0.79	4	3	-1
0023	3F	09_10	126	13	3	1300	1930	630	0.23	1.48	2	3	1
0023	3F	09_10	134	27	7	2700	2100	-600	0.26	0.78	4	3	-1
0023	3F	09_10	135	24	3	2400	970	-1430	0.13	0.40	4	1	-3
0023	3F	09_10	136	8	1	800	1650	850	0.13	2.06	1	2	1
0023	3F	09_10	145	6	0	600	0	-600	0.00	0.00	1	0	-1
0023	3F	09_10	146	1	0	100	0	-100	0.00	0.00	0	0	0
0023	3F	09_10	235	2	0	200	0	-200	0.00	0.00	0	0	0
0023	3F	09_11	123	18	5	1800	1070	-730	0.28	0.59	3	1	-2
0023	3F	09_11	124	138	32	13800	10470	-3330	0.23	0.76	24	18	-6
0023	3F	09_11	125	29	8	2900	5180	2280	0.28	1.79	5	9	4
0023	3F	09_11	126	9	0	900	0	-900	0.00	0.00	1	0	-1
0023	3F	09_11	134	24	6	2400	2030	-370	0.25	0.85	4	3	-1
0023	3F	09_11	135	25	4	2500	1920	-580	0.16	0.77	4	3	-1
0023	3F	09_11	136	5	0	500	0	-500	0.00	0.00	0	0	0
0023	3F	09_11	146	1	1	100	500	400	1.00	5.00	0	0	0
0023	3F	09_12	123	30	10	3000	2470	-530	0.33	0.82	5	4	-1
0023	3F	09_12	124	175	38	17500	17290	-210	0.22	0.99	30	30	0
0023	3F	09_12	125	29	3	2900	1440	-1460	0.10	0.50	5	2	-3
0023	3F	09_12	126	4	0	400	0	-400	0.00	0.00	0	0	0
0023	3F	09_12	134	18	0	1800	0	-1800	0.00	0.00	3	0	-3
0023	3F	09_12	135	9	2	900	1030	130	0.22	1.14	1	1	0
0023	3F	09_12	136	1	0	100	0	-100	0.00	0.00	0	0	0
0023	3F	09_12	145	1	0	100	0	-100	0.00	0.00	0	0	0
0023	3F	09_2	123	32	8	3200	2800	-400	0.25	0.88	5	4	-1
0023	3F	09_2	124	21	4	2100	1560	-540	0.19	0.74	3	2	-1
0023	3F	09_2	125	15	5	1500	3300	1800	0.33	2.20	2	5	3
0023	3F	09_2	126	21	3	2100	2050	-50	0.14	0.98	3	3	0
0023	3F	09_2	134	12	3	1200	1380	180	0.25	1.15	2	2	0
0023	3F	09_2	135	10	1	1000	410	-590	0.10	0.41	1	0	-1
0023	3F	09_2	136	4	1	400	2240	1840	0.25	5.60	0	3	3
0023	3F	09_2	145	2	1	200	530	330	0.50	2.65	0	0	0
0023	3F	09_2	146	2	0	200	0	-200	0.00	0.00	0	0	0
0023	3F	09_2	156	3	0	300	0	-300	0.00	0.00	0	0	0
0023	3F	09_2	234	2	0	200	0	-200	0.00	0.00	0	0	0
0023	3F	09_3	123	12	5	1200	1370	170	0.42	1.14	2	2	0
0023	3F	09_3	124	19	6	1900	3440	1540	0.32	1.81	3	6	3
0023	3F	09_3	125	26	8	2600	2730	130	0.31	1.05	4	4	0
0023	3F	09_3	126	44	6	4400	4930	530	0.14	1.12	7	8	1
0023	3F	09_3	134	4	1	400	220	-180	0.25	0.55	0	0	0
0023	3F	09_3	135	13	1	1300	1340	40	0.08	1.03	2	2	0
0023	3F	09_3	136	22	3	2200	3080	880	0.14	1.40	3	5	2
0023	3F	09_3	145	5	0	500	0	-500	0.00	0.00	0	0	0
0023	3F	09_3	146	14	2	1400	3430	2030	0.14	2.45	2	6	4
0023	3F	09_3	156	5	0	500	0	-500	0.00	0.00	0	0	0
0023	3F	09_3	234	2	0	200	0	-200	0.00	0.00	0	0	0
0023	3F	09_3	235	2	0	200	0	-200	0.00	0.00	0	0	0
0023	3F	09_3	236	1	0	100	0	-100	0.00	0.00	0	0	0
0023	3F	09_3	246	2	1	200	380	180	0.50	1.90	0	0	0
0023	3F	09_4	123	8	5	800	1900	1100	0.63	2.38	1	3	2
0023	3F	09_4	124	15	3	1500	620	-880	0.20	0.41	2	1	-1
0023	3F	09_4	125	19	3	1900	1240	-660	0.16	0.65	3	2	-1
0023	3F	09_4	126	41	2	4100	510	-3590	0.05	0.12	7	0	-7
0023	3F	09_4	134	11	3	1100	850	-250	0.27	0.77	1	1	0
0023	3F	09_4	135	14	4	1400	2160	760	0.29	1.54	2	3	1
0023	3F	09_4	136	19	1	1900	580	-1320	0.05	0.31	3	1	-2
0023	3F	09_4	145	6	0	600	0	-600	0.00	0.00	1	0	-1
0023	3F	09_4	146	8	0	800	0	-800	0.00	0.00	1	0	-1
0023	3F	09_4	156	7	1	700	300	-400	0.14	0.43	1	0	-1
0023	3F	09_4	236	2	0	200	0	-200	0.00	0.00	0	0	0
0023	3F	09_4	246	1	1	100	1420	1320	1.00	14.20	0	2	2
0023	3F	09_5	123	76	25	7600	6200	-1400	0.33	0.82	13	10	-3
0023	3F	09_5	124	53	19	5300	7540	2240	0.36	1.42	9	13	4
0023	3F	09_5	125	20	7	2000	2360	360	0.35	1.18	3	4	1
0023	3F	09_5	126	8	2	800	2180	1380	0.25	2.73	1	3	2
0023	3F	09_5	134	16	4	1600	1620	20	0.25	1.01	2	2	0
0023	3F	09_5	135	8	2	800	830	30	0.25	1.04	1	1	0
0023	3F	09_5	136	3	0	300	0	-300	0.00	0.00	0	0	0
0023	3F	09_5	145	1	0	100	0	-100	0.00	0.00	0	0	0
0023	3F	09_5	146	6	1	600	460	-140	0.17	0.77	1	0	-1
0023	3F	09_5	156	1	0	100	0	-100	0.00	0.00	0	0	0
0023	3F	09_5	234	1	1	100	440	340	1.00	4.40	0	0	0
0023	3F	09_6	123	6	1	600	240	-360	0.17	0.40	1	0	-1
0023	3F	09_6	124	29	7	2900	1620	-1280	0.24	0.56	5	2	-3
0023	3F	09_6	125	15	4	1500	1450	-50	0.27	0.97	2	2	0
0023	3F	09_6	126	20	2	2000	780	-1220	0.10	0.39	3	1	-2
0023	3F	09_6	134	14	2	1400	380	-1020	0.14	0.27	2	0	-2
0023	3F	09_6	135	11	2	1100	840	-260	0.18	0.76	1	1	0
0023	3F	09_6	136	18	4	1800	2480	680	0.22	1.38	3	4	1
0023	3F	09_6	145	7	1	700	310	-390	0.14	0.44	1	0	-1
0023	3F	09_6	146	7	3	700	1740	1040	0.43	2.49	1	3	2
0023	3F	09_6	156	6	0	600	0	-600	0.00	0.00	1	0	-1
0023	3F	09_6	234	2	1	200	330	130	0.50	1.65	0	0	0
0023	3F	09_7	123	19	7	1900	1830	-70	0.37	0.96	3	3	0
0023	3F	09_7	124	34	10	3400	3390	-10	0.29	1.00	6	6	0
0023	3F	09_7	125	15	3	1500	730	-770	0.20	0.49	2	1	-1
0023	3F	09_7	126	25	5	2500	3360	860	0.20	1.34	4	5	1
0023	3F	09_7	134	16	2	1600	670	-930	0.13	0.42	2	1	-1
0023	3F	09_7	135	18	1	1800	140	-1660	0.06	0.08	3	0	-3
0023	3F	09_7	136	19	4	1900	2520	620	0.21	1.33	3	4	1
0023	3F	09_7	145	6	0	600	0	-600	0.00	0.00	1	0	-1
0023	3F	09_7	146	4	0	400	0	-400	0.00	0.00	0	0	0
0023	3F	09_7	156	2	1	200	450	250	0.50	2.25	0	0	0
0023	3F	09_7	234	2	0	200	0	-200	0.00	0.00	0	0	0
0023	3F	09_7	236	4	0	400	0	-400	0.00	0.00	0	0	0
0023	3F	09_7	246	1	0	100	0	-100	0.00	0.00	0	0	0
0023	3F	09_8	123	25	9	2500	2520	20	0.36	1.01	4	4	0
0023	3F	09_8	124	31	6	3100	1660	-1440	0.19	0.54	5	2	-3
0023	3F	09_8	125	24	8	2400	3280	880	0.33	1.37	4	5	1
0023	3F	09_8	126	15	1	1500	200	-1300	0.07	0.13	2	0	-2
0023	3F	09_8	134	18	7	1800	1640	-160	0.39	0.91	3	2	-1
0023	3F	09_8	135	15	4	1500	1370	-130	0.27	0.91	2	2	0
0023	3F	09_8	136	14	1	1400	200	-1200	0.07	0.14	2	0	-2
0023	3F	09_8	145	1	0	100	0	-100	0.00	0.00	0	0	0
0023	3F	09_8	146	2	0	200	0	-200	0.00	0.00	0	0	0
0023	3F	09_8	156	1	0	100	0	-100	0.00	0.00	0	0	0
0023	3F	09_8	234	1	0	100	0	-100	0.00	0.00	0	0	0
0023	3F	09_8	236	2	0	200	0	-200	0.00	0.00	0	0	0
0023	3F	09_9	123	24	6	2400	2560	160	0.25	1.07	4	4	0
0023	3F	09_9	124	39	6	3900	2270	-1630	0.15	0.58	6	4	-2
0023	3F	09_9	125	34	4	3400	1340	-2060	0.12	0.39	6	2	-4
0023	3F	09_9	126	28	4	2800	1330	-1470	0.14	0.48	4	2	-2
0023	3F	09_9	134	24	8	2400	3100	700	0.33	1.29	4	5	1
0023	3F	09_9	135	14	4	1400	1200	-200	0.29	0.86	2	2	0
0023	3F	09_9	136	19	2	1900	560	-1340	0.11	0.29	3	0	-3
0023	3F	09_9	145	6	1	600	1140	540	0.17	1.90	1	2	1
0023	3F	09_9	146	8	1	800	600	-200	0.13	0.75	1	1	0
0023	3F	09_9	156	3	0	300	0	-300	0.00	0.00	0	0	0
0023	3F	10_1	123	108	22	10800	7740	-3060	0.20	0.72	19	13	-6
0023	3F	10_1	124	34	5	3400	1600	-1800	0.15	0.47	6	2	-4
0023	3F	10_1	125	13	1	1300	480	-820	0.08	0.37	2	0	-2
0023	3F	10_1	126	18	2	1800	590	-1210	0.11	0.33	3	1	-2
0023	3F	10_1	134	12	0	1200	0	-1200	0.00	0.00	2	0	-2
0023	3F	10_1	135	6	1	600	430	-170	0.17	0.72	1	0	-1
0023	3F	10_1	136	1	0	100	0	-100	0.00	0.00	0	0	0
0023	3F	10_1	145	1	0	100	0	-100	0.00	0.00	0	0	0
0023	3F	10_10	123	24	5	2400	1180	-1220	0.21	0.49	4	2	-2
0023	3F	10_10	124	57	13	5700	3620	-2080	0.23	0.64	10	6	-4
0023	3F	10_10	125	26	3	2600	1370	-1230	0.12	0.53	4	2	-2
0023	3F	10_10	126	27	4	2700	2900	200	0.15	1.07	4	5	1
0023	3F	10_10	134	16	6	1600	1950	350	0.38	1.22	2	3	1
0023	3F	10_10	135	10	2	1000	670	-330	0.20	0.67	1	1	0
0023	3F	10_10	136	13	0	1300	0	-1300	0.00	0.00	2	0	-2
0023	3F	10_10	145	7	1	700	410	-290	0.14	0.59	1	0	-1
0023	3F	10_10	146	11	0	1100	0	-1100	0.00	0.00	1	0	-1
0023	3F	10_10	156	6	2	600	1350	750	0.33	2.25	1	2	1
0023	3F	10_10	246	1	0	100	0	-100	0.00	0.00	0	0	0
0023	3F	10_11	123	16	4	1600	910	-690	0.25	0.57	2	1	-1
0023	3F	10_11	124	103	24	10300	8800	-1500	0.23	0.85	18	15	-3
0023	3F	10_11	125	29	3	2900	2120	-780	0.10	0.73	5	3	-2
0023	3F	10_11	126	3	1	300	550	250	0.33	1.83	0	0	0
0023	3F	10_11	134	31	3	3100	880	-2220	0.10	0.28	5	1	-4
0023	3F	10_11	135	23	2	2300	730	-1570	0.09	0.32	4	1	-3
0023	3F	10_11	136	4	2	400	1270	870	0.50	3.18	0	2	2
0023	3F	10_11	145	10	1	1000	480	-520	0.10	0.48	1	0	-1
0023	3F	10_11	156	1	0	100	0	-100	0.00	0.00	0	0	0
0023	3F	10_12	123	17	8	1700	2630	930	0.47	1.55	3	4	1
0023	3F	10_12	124	136	28	13600	12120	-1480	0.21	0.89	24	21	-3
0023	3F	10_12	125	24	4	2400	1460	-940	0.17	0.61	4	2	-2
0023	3F	10_12	126	2	0	200	0	-200	0.00	0.00	0	0	0
0023	3F	10_12	134	26	4	2600	1350	-1250	0.15	0.52	4	2	-2
0023	3F	10_12	135	23	3	2300	1610	-690	0.13	0.70	4	2	-2
0023	3F	10_12	136	1	0	100	0	-100	0.00	0.00	0	0	0
0023	3F	10_12	145	6	0	600	0	-600	0.00	0.00	1	0	-1
0023	3F	10_2	123	137	29	13700	7420	-6280	0.21	0.54	24	13	-11
0023	3F	10_2	124	41	7	4100	1570	-2530	0.17	0.38	7	2	-5
0023	3F	10_2	125	15	5	1500	1860	360	0.33	1.24	2	3	1
0023	3F	10_2	126	1	0	100	0	-100	0.00	0.00	0	0	0
0023	3F	10_2	134	10	1	1000	200	-800	0.10	0.20	1	0	-1
0023	3F	10_2	135	9	0	900	0	-900	0.00	0.00	1	0	-1
0023	3F	10_2	145	1	0	100	0	-100	0.00	0.00	0	0	0
0023	3F	10_2	146	1	1	100	650	550	1.00	6.50	0	1	1
0023	3F	10_3	123	14	6	1400	1250	-150	0.43	0.89	2	2	0
0023	3F	10_3	124	11	1	1100	200	-900	0.09	0.18	1	0	-1
0023	3F	10_3	125	6	0	600	0	-600	0.00	0.00	1	0	-1
0023	3F	10_3	134	90	16	9000	4110	-4890	0.18	0.46	15	7	-8
0023	3F	10_3	135	24	3	2400	930	-1470	0.13	0.39	4	1	-3
0023	3F	10_3	136	6	0	600	0	-600	0.00	0.00	1	0	-1
0023	3F	10_3	146	3	0	300	0	-300	0.00	0.00	0	0	0
0023	3F	10_3	234	1	0	100	0	-100	0.00	0.00	0	0	0
0023	3F	10_3	235	3	0	300	0	-300	0.00	0.00	0	0	0
0023	3F	10_3	245	2	0	200	0	-200	0.00	0.00	0	0	0
0023	3F	10_3	246	2	0	200	0	-200	0.00	0.00	0	0	0
0023	3F	10_4	123	120	38	12000	6740	-5260	0.32	0.56	21	11	-10
0023	3F	10_4	124	14	2	1400	1750	350	0.14	1.25	2	3	1
0023	3F	10_4	125	19	2	1900	950	-950	0.11	0.50	3	1	-2
0023	3F	10_4	126	8	0	800	0	-800	0.00	0.00	1	0	-1
0023	3F	10_4	134	6	0	600	0	-600	0.00	0.00	1	0	-1
0023	3F	10_4	135	9	0	900	0	-900	0.00	0.00	1	0	-1
0023	3F	10_4	136	1	0	100	0	-100	0.00	0.00	0	0	0
0023	3F	10_4	145	5	0	500	0	-500	0.00	0.00	0	0	0
0023	3F	10_4	146	2	0	200	0	-200	0.00	0.00	0	0	0
0023	3F	10_4	156	1	0	100	0	-100	0.00	0.00	0	0	0
0023	3F	10_4	235	8	0	800	0	-800	0.00	0.00	1	0	-1
0023	3F	10_4	245	2	0	200	0	-200	0.00	0.00	0	0	0
0023	3F	10_4	246	1	0	100	0	-100	0.00	0.00	0	0	0
0023	3F	10_5	123	10	2	1000	610	-390	0.20	0.61	1	1	0
0023	3F	10_5	124	2	0	200	0	-200	0.00	0.00	0	0	0
0023	3F	10_5	125	13	5	1300	1650	350	0.38	1.27	2	2	0
0023	3F	10_5	126	8	0	800	0	-800	0.00	0.00	1	0	-1
0023	3F	10_5	134	3	1	300	190	-110	0.33	0.63	0	0	0
0023	3F	10_5	135	28	7	2800	3040	240	0.25	1.09	4	5	1
0023	3F	10_5	136	3	0	300	0	-300	0.00	0.00	0	0	0
0023	3F	10_5	145	10	3	1000	2110	1110	0.30	2.11	1	3	2
0023	3F	10_5	146	2	1	200	1710	1510	0.50	8.55	0	3	3
0023	3F	10_5	234	5	0	500	0	-500	0.00	0.00	0	0	0
0023	3F	10_5	235	7	2	700	670	-30	0.29	0.96	1	1	0
0023	3F	10_5	236	4	1	400	250	-150	0.25	0.63	0	0	0
0023	3F	10_5	245	21	4	2100	2270	170	0.19	1.08	3	4	1
0023	3F	10_5	246	8	0	800	0	-800	0.00	0.00	1	0	-1
0023	3F	10_5	256	1	0	100	0	-100	0.00	0.00	0	0	0
0023	3F	10_6	123	11	2	1100	590	-510	0.18	0.54	1	1	0
0023	3F	10_6	124	1	0	100	0	-100	0.00	0.00	0	0	0
0023	3F	10_6	125	15	2	1500	1740	240	0.13	1.16	2	3	1
0023	3F	10_6	126	2	0	200	0	-200	0.00	0.00	0	0	0
0023	3F	10_6	134	6	1	600	150	-450	0.17	0.25	1	0	-1
0023	3F	10_6	135	7	0	700	0	-700	0.00	0.00	1	0	-1
0023	3F	10_6	136	8	1	800	1670	870	0.13	2.09	1	2	1
0023	3F	10_6	145	13	1	1300	600	-700	0.08	0.46	2	1	-1
0023	3F	10_6	156	1	0	100	0	-100	0.00	0.00	0	0	0
0023	3F	10_6	234	6	0	600	0	-600	0.00	0.00	1	0	-1
0023	3F	10_6	235	15	1	1500	3380	1880	0.07	2.25	2	5	3
0023	3F	10_6	236	29	1	2900	2020	-880	0.03	0.70	5	3	-2
0023	3F	10_6	245	13	1	1300	350	-950	0.08	0.27	2	0	-2
0023	3F	10_6	246	1	0	100	0	-100	0.00	0.00	0	0	0
0023	3F	10_6	256	2	1	200	420	220	0.50	2.10	0	0	0
0023	3F	10_7	123	70	10	7000	4550	-2450	0.14	0.65	12	8	-4
0023	3F	10_7	134	5	2	500	790	290	0.40	1.58	0	1	1
0023	3F	10_7	234	12	1	1200	510	-690	0.08	0.43	2	0	-2
0023	3F	10_8	123	2	1	200	240	40	0.50	1.20	0	0	0
0023	3F	10_8	124	22	5	2200	1680	-520	0.23	0.76	3	2	-1
0023	3F	10_8	125	11	1	1100	620	-480	0.09	0.56	1	1	0
0023	3F	10_8	126	21	3	2100	3280	1180	0.14	1.56	3	5	2
0023	3F	10_8	134	11	2	1100	1000	-100	0.18	0.91	1	1	0
0023	3F	10_8	135	9	1	900	360	-540	0.11	0.40	1	0	-1
0023	3F	10_8	136	13	0	1300	0	-1300	0.00	0.00	2	0	-2
0023	3F	10_8	145	9	0	900	0	-900	0.00	0.00	1	0	-1
0023	3F	10_8	146	2	0	200	0	-200	0.00	0.00	0	0	0
0023	3F	10_8	234	2	1	200	260	60	0.50	1.30	0	0	0
0023	3F	10_8	235	5	1	500	190	-310	0.20	0.38	0	0	0
0023	3F	10_8	236	1	0	100	0	-100	0.00	0.00	0	0	0
0023	3F	10_8	245	5	0	500	0	-500	0.00	0.00	0	0	0
0023	3F	10_8	246	7	2	700	550	-150	0.29	0.79	1	0	-1
0023	3F	10_8	256	1	0	100	0	-100	0.00	0.00	0	0	0
0023	3F	10_9	123	9	4	900	1290	390	0.44	1.43	1	2	1
0023	3F	10_9	124	32	5	3200	1880	-1320	0.16	0.59	5	3	-2
0023	3F	10_9	125	19	6	1900	2020	120	0.32	1.06	3	3	0
0023	3F	10_9	126	11	0	1100	0	-1100	0.00	0.00	1	0	-1
0023	3F	10_9	134	17	2	1700	990	-710	0.12	0.58	3	1	-2
0023	3F	10_9	135	11	1	1100	460	-640	0.09	0.42	1	0	-1
0023	3F	10_9	136	5	1	500	220	-280	0.20	0.44	0	0	0
0023	3F	10_9	145	19	2	1900	1670	-230	0.11	0.88	3	2	-1
0023	3F	10_9	146	1	0	100	0	-100	0.00	0.00	0	0	0
0023	3F	10_9	235	5	0	500	0	-500	0.00	0.00	0	0	0
0023	3F	10_9	236	2	0	200	0	-200	0.00	0.00	0	0	0
0023	3F	10_9	245	2	0	200	0	-200	0.00	0.00	0	0	0
0023	3F	10_9	246	2	1	200	1510	1310	0.50	7.55	0	2	2
0023	3F	10_9	256	3	0	300	0	-300	0.00	0.00	0	0	0
0023	3F	11_1	123	38	9	3800	3010	-790	0.24	0.79	6	5	-1
0023	3F	11_1	124	44	7	4400	2270	-2130	0.16	0.52	7	4	-3
0023	3F	11_1	125	33	5	3300	2440	-860	0.15	0.74	5	4	-1
0023	3F	11_1	126	4	1	400	470	70	0.25	1.18	0	0	0
0023	3F	11_1	134	6	0	600	0	-600	0.00	0.00	1	0	-1
0023	3F	11_1	135	5	2	500	930	430	0.40	1.86	0	1	1
0023	3F	11_1	136	2	0	200	0	-200	0.00	0.00	0	0	0
0023	3F	11_1	145	2	0	200	0	-200	0.00	0.00	0	0	0
0023	3F	11_1	146	1	0	100	0	-100	0.00	0.00	0	0	0
0023	3F	11_1	156	2	0	200	0	-200	0.00	0.00	0	0	0
0023	3F	11_1	256	1	0	100	0	-100	0.00	0.00	0	0	0
0023	3F	11_10	123	12	2	1200	420	-780	0.17	0.35	2	0	-2
0023	3F	11_10	124	33	6	3300	1940	-1360	0.18	0.59	5	3	-2
0023	3F	11_10	125	40	6	4000	2130	-1870	0.15	0.53	7	3	-4
0023	3F	11_10	126	17	1	1700	330	-1370	0.06	0.19	3	0	-3
0023	3F	11_10	134	24	6	2400	1880	-520	0.25	0.78	4	3	-1
0023	3F	11_10	135	28	1	2800	320	-2480	0.04	0.11	4	0	-4
0023	3F	11_10	136	12	1	1200	410	-790	0.08	0.34	2	0	-2
0023	3F	11_10	145	12	5	1200	1870	670	0.42	1.56	2	3	1
0023	3F	11_10	146	4	0	400	0	-400	0.00	0.00	0	0	0
0023	3F	11_10	235	1	0	100	0	-100	0.00	0.00	0	0	0
0023	3F	11_10	236	1	0	100	0	-100	0.00	0.00	0	0	0
0023	3F	11_10	246	1	0	100	0	-100	0.00	0.00	0	0	0
0023	3F	11_11	123	11	2	1100	550	-550	0.18	0.50	1	0	-1
0023	3F	11_11	124	70	14	7000	6750	-250	0.20	0.96	12	11	-1
0023	3F	11_11	125	64	7	6400	5960	-440	0.11	0.93	11	10	-1
0023	3F	11_11	126	10	0	1000	0	-1000	0.00	0.00	1	0	-1
0023	3F	11_11	134	24	7	2400	2470	70	0.29	1.03	4	4	0
0023	3F	11_11	135	33	2	3300	1080	-2220	0.06	0.33	5	1	-4
0023	3F	11_11	136	3	0	300	0	-300	0.00	0.00	0	0	0
0023	3F	11_11	145	7	1	700	590	-110	0.14	0.84	1	1	0
0023	3F	11_11	146	2	0	200	0	-200	0.00	0.00	0	0	0
0023	3F	11_12	123	4	1	400	280	-120	0.25	0.70	0	0	0
0023	3F	11_12	124	91	17	9100	6300	-2800	0.19	0.69	16	11	-5
0023	3F	11_12	125	72	6	7200	5690	-1510	0.08	0.79	12	10	-2
0023	3F	11_12	126	1	0	100	0	-100	0.00	0.00	0	0	0
0023	3F	11_12	134	23	5	2300	2280	-20	0.22	0.99	4	4	0
0023	3F	11_12	135	31	3	3100	1510	-1590	0.10	0.49	5	2	-3
0023	3F	11_12	145	7	1	700	1090	390	0.14	1.56	1	1	0
0023	3F	11_2	123	10	4	1000	1120	120	0.40	1.12	1	1	0
0023	3F	11_2	124	18	2	1800	820	-980	0.11	0.46	3	1	-2
0023	3F	11_2	125	16	2	1600	1210	-390	0.13	0.76	2	2	0
0023	3F	11_2	126	21	5	2100	4320	2220	0.24	2.06	3	7	4
0023	3F	11_2	134	11	1	1100	340	-760	0.09	0.31	1	0	-1
0023	3F	11_2	135	9	1	900	360	-540	0.11	0.40	1	0	-1
0023	3F	11_2	136	16	2	1600	1680	80	0.13	1.05	2	2	0
0023	3F	11_2	145	8	0	800	0	-800	0.00	0.00	1	0	-1
0023	3F	11_2	146	3	0	300	0	-300	0.00	0.00	0	0	0
0023	3F	11_2	156	1	0	100	0	-100	0.00	0.00	0	0	0
0023	3F	11_2	234	1	0	100	0	-100	0.00	0.00	0	0	0
0023	3F	11_2	235	2	0	200	0	-200	0.00	0.00	0	0	0
0023	3F	11_2	236	1	0	100	0	-100	0.00	0.00	0	0	0
0023	3F	11_3	123	10	4	1000	1300	300	0.40	1.30	1	2	1
0023	3F	11_3	124	20	4	2000	1720	-280	0.20	0.86	3	3	0
0023	3F	11_3	125	11	2	1100	1410	310	0.18	1.28	1	2	1
0023	3F	11_3	126	29	4	2900	1720	-1180	0.14	0.59	5	3	-2
0023	3F	11_3	134	10	3	1000	840	-160	0.30	0.84	1	1	0
0023	3F	11_3	135	9	0	900	0	-900	0.00	0.00	1	0	-1
0023	3F	11_3	136	16	1	1600	190	-1410	0.06	0.12	2	0	-2
0023	3F	11_3	145	4	0	400	0	-400	0.00	0.00	0	0	0
0023	3F	11_3	146	11	3	1100	1790	690	0.27	1.63	1	3	2
0023	3F	11_3	156	2	0	200	0	-200	0.00	0.00	0	0	0
0023	3F	11_3	235	1	0	100	0	-100	0.00	0.00	0	0	0
0023	3F	11_3	236	1	0	100	0	-100	0.00	0.00	0	0	0
0023	3F	11_3	246	1	0	100	0	-100	0.00	0.00	0	0	0
0023	3F	11_4	123	9	2	900	380	-520	0.22	0.42	1	0	-1
0023	3F	11_4	124	17	2	1700	490	-1210	0.12	0.29	3	0	-3
0023	3F	11_4	125	11	2	1100	960	-140	0.18	0.87	1	1	0
0023	3F	11_4	126	28	3	2800	2730	-70	0.11	0.98	4	4	0
0023	3F	11_4	134	10	2	1000	690	-310	0.20	0.69	1	1	0
0023	3F	11_4	135	10	2	1000	670	-330	0.20	0.67	1	1	0
0023	3F	11_4	136	22	2	2200	1130	-1070	0.09	0.51	3	2	-1
0023	3F	11_4	145	6	2	600	770	170	0.33	1.28	1	1	0
0023	3F	11_4	146	4	1	400	730	330	0.25	1.83	0	1	1
0023	3F	11_4	156	3	0	300	0	-300	0.00	0.00	0	0	0
0023	3F	11_4	234	2	1	200	200	0	0.50	1.00	0	0	0
0023	3F	11_4	235	1	0	100	0	-100	0.00	0.00	0	0	0
0023	3F	11_4	246	1	0	100	0	-100	0.00	0.00	0	0	0
0023	3F	11_5	123	95	32	9500	7730	-1770	0.34	0.81	16	13	-3
0023	3F	11_5	124	59	23	5900	5510	-390	0.39	0.93	10	9	-1
0023	3F	11_5	125	16	4	1600	1080	-520	0.25	0.68	2	1	-1
0023	3F	11_5	126	11	1	1100	470	-630	0.09	0.43	1	0	-1
0023	3F	11_5	134	1	0	100	0	-100	0.00	0.00	0	0	0
0023	3F	11_5	136	1	0	100	0	-100	0.00	0.00	0	0	0
0023	3F	11_5	146	1	1	100	380	280	1.00	3.80	0	0	0
0023	3F	11_6	123	6	2	600	470	-130	0.33	0.78	1	0	-1
0023	3F	11_6	124	15	3	1500	1730	230	0.20	1.15	2	3	1
0023	3F	11_6	125	5	1	500	450	-50	0.20	0.90	0	0	0
0023	3F	11_6	126	8	1	800	950	150	0.13	1.19	1	1	0
0023	3F	11_6	134	114	39	11400	8280	-3120	0.34	0.73	20	14	-6
0023	3F	11_6	135	12	1	1200	300	-900	0.08	0.25	2	0	-2
0023	3F	11_6	136	4	1	400	320	-80	0.25	0.80	0	0	0
0023	3F	11_6	145	3	0	300	0	-300	0.00	0.00	0	0	0
0023	3F	11_6	146	6	2	600	1010	410	0.33	1.68	1	1	0
0023	3F	11_6	234	1	0	100	0	-100	0.00	0.00	0	0	0
0023	3F	11_7	123	16	7	1600	1600	0	0.44	1.00	2	2	0
0023	3F	11_7	124	24	10	2400	3510	1110	0.42	1.46	4	6	2
0023	3F	11_7	125	24	3	2400	980	-1420	0.13	0.41	4	1	-3
0023	3F	11_7	126	23	6	2300	3570	1270	0.26	1.55	4	6	2
0023	3F	11_7	134	13	2	1300	560	-740	0.15	0.43	2	0	-2
0023	3F	11_7	135	9	6	900	2060	1160	0.67	2.29	1	3	2
0023	3F	11_7	136	14	2	1400	780	-620	0.14	0.56	2	1	-1
0023	3F	11_7	145	4	2	400	430	30	0.50	1.08	0	0	0
0023	3F	11_7	146	6	1	600	300	-300	0.17	0.50	1	0	-1
0023	3F	11_7	156	1	1	100	330	230	1.00	3.30	0	0	0
0023	3F	11_7	236	2	0	200	0	-200	0.00	0.00	0	0	0
0023	3F	11_7	246	1	0	100	0	-100	0.00	0.00	0	0	0
0023	3F	11_7	256	1	1	100	260	160	1.00	2.60	0	0	0
0023	3F	11_8	123	11	2	1100	530	-570	0.18	0.48	1	0	-1
0023	3F	11_8	124	12	4	1200	2680	1480	0.33	2.23	2	4	2
0023	3F	11_8	125	17	3	1700	1050	-650	0.18	0.62	3	1	-2
0023	3F	11_8	126	25	0	2500	0	-2500	0.00	0.00	4	0	-4
0023	3F	11_8	134	9	2	900	540	-360	0.22	0.60	1	0	-1
0023	3F	11_8	135	12	3	1200	960	-240	0.25	0.80	2	1	-1
0023	3F	11_8	136	14	0	1400	0	-1400	0.00	0.00	2	0	-2
0023	3F	11_8	145	10	1	1000	330	-670	0.10	0.33	1	0	-1
0023	3F	11_8	146	3	0	300	0	-300	0.00	0.00	0	0	0
0023	3F	11_8	156	3	0	300	0	-300	0.00	0.00	0	0	0
0023	3F	11_8	235	3	1	300	250	-50	0.33	0.83	0	0	0
0023	3F	11_8	245	1	0	100	0	-100	0.00	0.00	0	0	0
0023	3F	11_8	256	1	0	100	0	-100	0.00	0.00	0	0	0
0023	3F	11_9	123	15	4	1500	1490	-10	0.27	0.99	2	2	0
0023	3F	11_9	124	31	6	3100	2260	-840	0.19	0.73	5	4	-1
0023	3F	11_9	125	20	0	2000	0	-2000	0.00	0.00	3	0	-3
0023	3F	11_9	126	26	5	2600	5910	3310	0.19	2.27	4	10	6
0023	3F	11_9	134	12	4	1200	1840	640	0.33	1.53	2	3	1
0023	3F	11_9	135	15	1	1500	250	-1250	0.07	0.17	2	0	-2
0023	3F	11_9	136	15	2	1500	580	-920	0.13	0.39	2	1	-1
0023	3F	11_9	145	6	2	600	1330	730	0.33	2.22	1	2	1
0023	3F	11_9	146	6	1	600	300	-300	0.17	0.50	1	0	-1
0023	3F	11_9	235	1	0	100	0	-100	0.00	0.00	0	0	0
0023	3F	11_9	236	2	0	200	0	-200	0.00	0.00	0	0	0
0023	3F	11_9	246	1	0	100	0	-100	0.00	0.00	0	0	0
0023	3F	11_9	256	1	0	100	0	-100	0.00	0.00	0	0	0
0023	3F	12_1	123	25	3	2500	850	-1650	0.12	0.34	4	1	-3
0023	3F	12_1	124	26	5	2600	1500	-1100	0.19	0.58	4	2	-2
0023	3F	12_1	125	16	2	1600	630	-970	0.13	0.39	2	1	-1
0023	3F	12_1	126	11	2	1100	1090	-10	0.18	0.99	1	1	0
0023	3F	12_1	134	11	4	1100	1550	450	0.36	1.41	1	2	1
0023	3F	12_1	135	5	0	500	0	-500	0.00	0.00	0	0	0
0023	3F	12_1	136	3	1	300	780	480	0.33	2.60	0	1	1
0023	3F	12_1	145	4	0	400	0	-400	0.00	0.00	0	0	0
0023	3F	12_1	146	5	0	500	0	-500	0.00	0.00	0	0	0
0023	3F	12_1	234	2	0	200	0	-200	0.00	0.00	0	0	0
0023	3F	12_10	123	10	4	1000	1030	30	0.40	1.03	1	1	0
0023	3F	12_10	124	55	10	5500	3060	-2440	0.18	0.56	9	5	-4
0023	3F	12_10	125	70	20	7000	14330	7330	0.29	2.05	12	25	13
0023	3F	12_10	126	12	3	1200	1300	100	0.25	1.08	2	2	0
0023	3F	12_10	134	19	1	1900	260	-1640	0.05	0.14	3	0	-3
0023	3F	12_10	135	40	7	4000	3930	-70	0.18	0.98	7	6	-1
0023	3F	12_10	136	9	0	900	0	-900	0.00	0.00	1	0	-1
0023	3F	12_10	145	5	0	500	0	-500	0.00	0.00	0	0	0
0023	3F	12_10	245	1	0	100	0	-100	0.00	0.00	0	0	0
0023	3F	12_11	123	7	1	700	290	-410	0.14	0.41	1	0	-1
0023	3F	12_11	124	33	7	3300	3330	30	0.21	1.01	5	5	0
0023	3F	12_11	125	84	13	8400	7980	-420	0.15	0.95	14	14	0
0023	3F	12_11	126	11	3	1100	2720	1620	0.27	2.47	1	4	3
0023	3F	12_11	134	32	8	3200	4380	1180	0.25	1.37	5	7	2
0023	3F	12_11	135	61	8	6100	3950	-2150	0.13	0.65	10	6	-4
0023	3F	12_11	136	4	1	400	990	590	0.25	2.48	0	1	1
0023	3F	12_11	145	5	0	500	0	-500	0.00	0.00	0	0	0
0023	3F	12_12	123	7	2	700	830	130	0.29	1.19	1	1	0
0023	3F	12_12	124	37	6	3700	2570	-1130	0.16	0.69	6	4	-2
0023	3F	12_12	125	82	5	8200	2160	-6040	0.06	0.26	14	3	-11
0023	3F	12_12	126	7	1	700	540	-160	0.14	0.77	1	0	-1
0023	3F	12_12	134	13	6	1300	2700	1400	0.46	2.08	2	4	2
0023	3F	12_12	135	68	6	6800	7090	290	0.09	1.04	12	12	0
0023	3F	12_12	136	3	0	300	0	-300	0.00	0.00	0	0	0
0023	3F	12_12	145	8	0	800	0	-800	0.00	0.00	1	0	-1
0023	3F	12_12	246	1	0	100	0	-100	0.00	0.00	0	0	0
0023	3F	12_2	123	21	9	2100	2530	430	0.43	1.20	3	4	1
0023	3F	12_2	124	25	3	2500	1000	-1500	0.12	0.40	4	1	-3
0023	3F	12_2	125	21	2	2100	1440	-660	0.10	0.69	3	2	-1
0023	3F	12_2	126	10	1	1000	730	-270	0.10	0.73	1	1	0
0023	3F	12_2	134	12	2	1200	1040	-160	0.17	0.87	2	1	-1
0023	3F	12_2	135	16	3	1600	990	-610	0.19	0.62	2	1	-1
0023	3F	12_2	136	7	1	700	390	-310	0.14	0.56	1	0	-1
0023	3F	12_2	145	8	1	800	410	-390	0.13	0.51	1	0	-1
0023	3F	12_2	146	1	0	100	0	-100	0.00	0.00	0	0	0
0023	3F	12_2	156	1	0	100	0	-100	0.00	0.00	0	0	0
0023	3F	12_2	234	1	1	100	230	130	1.00	2.30	0	0	0
0023	3F	12_2	235	3	0	300	0	-300	0.00	0.00	0	0	0
0023	3F	12_3	123	17	4	1700	820	-880	0.24	0.48	3	1	-2
0023	3F	12_3	124	28	6	2800	1900	-900	0.21	0.68	4	3	-1
0023	3F	12_3	125	22	4	2200	2270	70	0.18	1.03	3	4	1
0023	3F	12_3	126	14	2	1400	1260	-140	0.14	0.90	2	2	0
0023	3F	12_3	134	10	3	1000	1060	60	0.30	1.06	1	1	0
0023	3F	12_3	135	13	4	1300	920	-380	0.31	0.71	2	1	-1
0023	3F	12_3	136	8	1	800	280	-520	0.13	0.35	1	0	-1
0023	3F	12_3	145	6	0	600	0	-600	0.00	0.00	1	0	-1
0023	3F	12_3	146	5	0	500	0	-500	0.00	0.00	0	0	0
0023	3F	12_3	156	3	1	300	1720	1420	0.33	5.73	0	3	3
0023	3F	12_3	234	1	0	100	0	-100	0.00	0.00	0	0	0
0023	3F	12_3	235	1	0	100	0	-100	0.00	0.00	0	0	0
0023	3F	12_3	236	1	1	100	420	320	1.00	4.20	0	0	0
0023	3F	12_3	246	1	1	100	150	50	1.00	1.50	0	0	0
0023	3F	12_4	123	15	7	1500	1740	240	0.47	1.16	2	3	1
0023	3F	12_4	124	31	10	3100	2880	-220	0.32	0.93	5	5	0
0023	3F	12_4	125	21	2	2100	550	-1550	0.10	0.26	3	0	-3
0023	3F	12_4	126	15	3	1500	1110	-390	0.20	0.74	2	1	-1
0023	3F	12_4	134	12	2	1200	670	-530	0.17	0.56	2	1	-1
0023	3F	12_4	135	14	8	1400	3470	2070	0.57	2.48	2	6	4
0023	3F	12_4	136	4	0	400	0	-400	0.00	0.00	0	0	0
0023	3F	12_4	145	10	1	1000	250	-750	0.10	0.25	1	0	-1
0023	3F	12_4	146	6	0	600	0	-600	0.00	0.00	1	0	-1
0023	3F	12_4	156	1	0	100	0	-100	0.00	0.00	0	0	0
0023	3F	12_4	235	1	0	100	0	-100	0.00	0.00	0	0	0
0023	3F	12_4	236	2	0	200	0	-200	0.00	0.00	0	0	0
0023	3F	12_4	256	2	1	200	300	100	0.50	1.50	0	0	0
0023	3F	12_5	123	28	4	2800	1320	-1480	0.14	0.47	4	2	-2
0023	3F	12_5	124	16	4	1600	1640	40	0.25	1.03	2	2	0
0023	3F	12_5	125	9	1	900	310	-590	0.11	0.34	1	0	-1
0023	3F	12_5	126	96	21	9600	7460	-2140	0.22	0.78	16	13	-3
0023	3F	12_5	135	1	0	100	0	-100	0.00	0.00	0	0	0
0023	3F	12_5	136	24	7	2400	2170	-230	0.29	0.90	4	3	-1
0023	3F	12_5	145	1	1	100	630	530	1.00	6.30	0	1	1
0023	3F	12_5	146	6	1	600	430	-170	0.17	0.72	1	0	-1
0023	3F	12_6	123	22	13	2200	4140	1940	0.59	1.88	3	7	4
0023	3F	12_6	124	35	9	3500	2770	-730	0.26	0.79	6	4	-2
0023	3F	12_6	125	18	0	1800	0	-1800	0.00	0.00	3	0	-3
0023	3F	12_6	126	14	2	1400	560	-840	0.14	0.40	2	0	-2
0023	3F	12_6	134	10	2	1000	390	-610	0.20	0.39	1	0	-1
0023	3F	12_6	135	10	3	1000	800	-200	0.30	0.80	1	1	0
0023	3F	12_6	136	17	4	1700	1080	-620	0.24	0.64	3	1	-2
0023	3F	12_6	146	1	1	100	440	340	1.00	4.40	0	0	0
0023	3F	12_6	156	3	1	300	230	-70	0.33	0.77	0	0	0
0023	3F	12_6	234	1	0	100	0	-100	0.00	0.00	0	0	0
0023	3F	12_6	235	1	0	100	0	-100	0.00	0.00	0	0	0
0023	3F	12_6	245	2	0	200	0	-200	0.00	0.00	0	0	0
0023	3F	12_6	246	1	0	100	0	-100	0.00	0.00	0	0	0
0023	3F	12_7	123	31	10	3100	2780	-320	0.32	0.90	5	4	-1
0023	3F	12_7	124	35	8	3500	2040	-1460	0.23	0.58	6	3	-3
0023	3F	12_7	125	27	5	2700	1830	-870	0.19	0.68	4	3	-1
0023	3F	12_7	126	17	2	1700	290	-1410	0.12	0.17	3	0	-3
0023	3F	12_7	134	10	4	1000	1820	820	0.40	1.82	1	3	2
0023	3F	12_7	135	16	2	1600	670	-930	0.13	0.42	2	1	-1
0023	3F	12_7	136	14	4	1400	1060	-340	0.29	0.76	2	1	-1
0023	3F	12_7	145	7	3	700	980	280	0.43	1.40	1	1	0
0023	3F	12_7	146	3	1	300	260	-40	0.33	0.87	0	0	0
0023	3F	12_7	156	1	0	100	0	-100	0.00	0.00	0	0	0
0023	3F	12_7	234	1	1	100	230	130	1.00	2.30	0	0	0
0023	3F	12_7	246	1	0	100	0	-100	0.00	0.00	0	0	0
0023	3F	12_8	123	17	4	1700	810	-890	0.24	0.48	3	1	-2
0023	3F	12_8	124	36	8	3600	2180	-1420	0.22	0.61	6	3	-3
0023	3F	12_8	125	25	3	2500	1800	-700	0.12	0.72	4	3	-1
0023	3F	12_8	126	21	3	2100	860	-1240	0.14	0.41	3	1	-2
0023	3F	12_8	134	18	3	1800	1070	-730	0.17	0.59	3	1	-2
0023	3F	12_8	135	9	0	900	0	-900	0.00	0.00	1	0	-1
0023	3F	12_8	136	17	1	1700	320	-1380	0.06	0.19	3	0	-3
0023	3F	12_8	145	6	1	600	270	-330	0.17	0.45	1	0	-1
0023	3F	12_8	146	5	0	500	0	-500	0.00	0.00	0	0	0
0023	3F	12_8	156	3	1	300	720	420	0.33	2.40	0	1	1
0023	3F	12_9	123	37	11	3700	2810	-890	0.30	0.76	6	4	-2
0023	3F	12_9	124	59	12	5900	3030	-2870	0.20	0.51	10	5	-5
0023	3F	12_9	125	30	7	3000	2450	-550	0.23	0.82	5	4	-1
0023	3F	12_9	126	31	6	3100	2330	-770	0.19	0.75	5	4	-1
0023	3F	12_9	134	7	2	700	710	10	0.29	1.01	1	1	0
0023	3F	12_9	135	16	4	1600	1360	-240	0.25	0.85	2	2	0
0023	3F	12_9	136	18	5	1800	1890	90	0.28	1.05	3	3	0
0023	3F	12_9	145	3	2	300	750	450	0.67	2.50	0	1	1
0023	3F	12_9	146	5	0	500	0	-500	0.00	0.00	0	0	0
0023	3F	13_1	123	12	3	1200	700	-500	0.25	0.58	2	1	-1
0023	3F	13_1	124	17	3	1700	1100	-600	0.18	0.65	3	1	-2
0023	3F	13_1	125	12	2	1200	700	-500	0.17	0.58	2	1	-1
0023	3F	13_1	126	10	2	1000	650	-350	0.20	0.65	1	1	0
0023	3F	13_1	134	10	5	1000	2380	1380	0.50	2.38	1	4	3
0023	3F	13_1	135	9	3	900	610	-290	0.33	0.68	1	1	0
0023	3F	13_1	136	5	1	500	210	-290	0.20	0.42	0	0	0
0023	3F	13_1	145	2	0	200	0	-200	0.00	0.00	0	0	0
0023	3F	13_1	146	2	0	200	0	-200	0.00	0.00	0	0	0
0023	3F	13_1	156	1	0	100	0	-100	0.00	0.00	0	0	0
0023	3F	13_10	123	30	7	3000	3150	150	0.23	1.05	5	5	0
0023	3F	13_10	124	70	16	7000	5090	-1910	0.23	0.73	12	9	-3
0023	3F	13_10	125	24	6	2400	2090	-310	0.25	0.87	4	3	-1
0023	3F	13_10	126	36	4	3600	3830	230	0.11	1.06	6	6	0
0023	3F	13_10	134	21	8	2100	4010	1910	0.38	1.91	3	7	4
0023	3F	13_10	135	8	3	800	1480	680	0.38	1.85	1	2	1
0023	3F	13_10	136	12	1	1200	300	-900	0.08	0.25	2	0	-2
0023	3F	13_10	145	3	0	300	0	-300	0.00	0.00	0	0	0
0023	3F	13_10	146	2	0	200	0	-200	0.00	0.00	0	0	0
0023	3F	13_10	156	2	1	200	430	230	0.50	2.15	0	0	0
0023	3F	13_10	235	1	0	100	0	-100	0.00	0.00	0	0	0
0023	3F	13_11	123	48	13	4800	4130	-670	0.27	0.86	8	7	-1
0023	3F	13_11	124	81	13	8100	5810	-2290	0.16	0.72	14	10	-4
0023	3F	13_11	125	25	4	2500	1590	-910	0.16	0.64	4	2	-2
0023	3F	13_11	126	42	4	4200	4390	190	0.10	1.05	7	7	0
0023	3F	13_11	134	20	6	2000	2160	160	0.30	1.08	3	3	0
0023	3F	13_11	135	8	3	800	1570	770	0.38	1.96	1	2	1
0023	3F	13_11	136	4	1	400	1030	630	0.25	2.58	0	1	1
0023	3F	13_11	145	1	0	100	0	-100	0.00	0.00	0	0	0
0023	3F	13_11	146	5	0	500	0	-500	0.00	0.00	0	0	0
0023	3F	13_11	156	1	0	100	0	-100	0.00	0.00	0	0	0
0023	3F	13_11	235	1	0	100	0	-100	0.00	0.00	0	0	0
0023	3F	13_12	123	29	9	2900	2600	-300	0.31	0.90	5	4	-1
0023	3F	13_12	124	111	17	11100	7400	-3700	0.15	0.67	19	13	-6
0023	3F	13_12	125	16	2	1600	660	-940	0.13	0.41	2	1	-1
0023	3F	13_12	126	40	2	4000	2360	-1640	0.05	0.59	7	4	-3
0023	3F	13_12	134	15	1	1500	360	-1140	0.07	0.24	2	0	-2
0023	3F	13_12	135	7	0	700	0	-700	0.00	0.00	1	0	-1
0023	3F	13_12	136	13	2	1300	1630	330	0.15	1.25	2	2	0
0023	3F	13_12	156	1	0	100	0	-100	0.00	0.00	0	0	0
0023	3F	13_12	236	1	0	100	0	-100	0.00	0.00	0	0	0
0023	3F	13_2	123	21	7	2100	2540	440	0.33	1.21	3	4	1
0023	3F	13_2	124	17	4	1700	1250	-450	0.24	0.74	3	2	-1
0023	3F	13_2	125	15	5	1500	2070	570	0.33	1.38	2	3	1
0023	3F	13_2	126	9	2	900	1140	240	0.22	1.27	1	2	1
0023	3F	13_2	134	10	7	1000	1960	960	0.70	1.96	1	3	2
0023	3F	13_2	135	8	3	800	1160	360	0.38	1.45	1	2	1
0023	3F	13_2	136	10	3	1000	1180	180	0.30	1.18	1	2	1
0023	3F	13_2	145	4	1	400	950	550	0.25	2.38	0	1	1
0023	3F	13_2	146	5	1	500	210	-290	0.20	0.42	0	0	0
0023	3F	13_2	156	1	0	100	0	-100	0.00	0.00	0	0	0
0023	3F	13_2	235	1	0	100	0	-100	0.00	0.00	0	0	0
0023	3F	13_3	123	13	3	1300	1060	-240	0.23	0.82	2	1	-1
0023	3F	13_3	124	21	5	2100	1530	-570	0.24	0.73	3	2	-1
0023	3F	13_3	125	13	3	1300	1820	520	0.23	1.40	2	3	1
0023	3F	13_3	126	19	4	1900	1680	-220	0.21	0.88	3	2	-1
0023	3F	13_3	134	10	6	1000	1900	900	0.60	1.90	1	3	2
0023	3F	13_3	135	4	0	400	0	-400	0.00	0.00	0	0	0
0023	3F	13_3	136	11	0	1100	0	-1100	0.00	0.00	1	0	-1
0023	3F	13_3	145	6	1	600	350	-250	0.17	0.58	1	0	-1
0023	3F	13_3	146	5	1	500	910	410	0.20	1.82	0	1	1
0023	3F	13_3	156	1	0	100	0	-100	0.00	0.00	0	0	0
0023	3F	13_3	234	1	0	100	0	-100	0.00	0.00	0	0	0
0023	3F	13_3	235	2	2	200	420	220	1.00	2.10	0	0	0
0023	3F	13_3	236	1	1	100	410	310	1.00	4.10	0	0	0
0023	3F	13_3	245	1	0	100	0	-100	0.00	0.00	0	0	0
0023	3F	13_4	123	8	0	800	0	-800	0.00	0.00	1	0	-1
0023	3F	13_4	124	24	6	2400	2070	-330	0.25	0.86	4	3	-1
0023	3F	13_4	125	15	3	1500	950	-550	0.20	0.63	2	1	-1
0023	3F	13_4	126	24	2	2400	1600	-800	0.08	0.67	4	2	-2
0023	3F	13_4	134	17	2	1700	910	-790	0.12	0.54	3	1	-2
0023	3F	13_4	135	8	1	800	280	-520	0.13	0.35	1	0	-1
0023	3F	13_4	136	11	1	1100	140	-960	0.09	0.13	1	0	-1
0023	3F	13_4	145	6	0	600	0	-600	0.00	0.00	1	0	-1
0023	3F	13_4	146	4	2	400	750	350	0.50	1.88	0	1	1
0023	3F	13_4	156	4	1	400	330	-70	0.25	0.83	0	0	0
0023	3F	13_4	235	2	1	200	290	90	0.50	1.45	0	0	0
0023	3F	13_4	246	1	0	100	0	-100	0.00	0.00	0	0	0
0023	3F	13_4	256	1	1	100	480	380	1.00	4.80	0	0	0
0023	3F	13_5	123	13	4	1300	1650	350	0.31	1.27	2	2	0
0023	3F	13_5	124	32	8	3200	2880	-320	0.25	0.90	5	5	0
0023	3F	13_5	125	17	3	1700	810	-890	0.18	0.48	3	1	-2
0023	3F	13_5	126	16	3	1600	1540	-60	0.19	0.96	2	2	0
0023	3F	13_5	134	13	3	1300	1310	10	0.23	1.01	2	2	0
0023	3F	13_5	135	14	3	1400	930	-470	0.21	0.66	2	1	-1
0023	3F	13_5	136	8	2	800	630	-170	0.25	0.79	1	1	0
0023	3F	13_5	145	7	0	700	0	-700	0.00	0.00	1	0	-1
0023	3F	13_5	146	6	0	600	0	-600	0.00	0.00	1	0	-1
0023	3F	13_5	156	2	1	200	390	190	0.50	1.95	0	0	0
0023	3F	13_5	236	2	0	200	0	-200	0.00	0.00	0	0	0
0023	3F	13_6	123	10	5	1000	1230	230	0.50	1.23	1	2	1
0023	3F	13_6	124	29	10	2900	2230	-670	0.34	0.77	5	3	-2
0023	3F	13_6	125	12	4	1200	960	-240	0.33	0.80	2	1	-1
0023	3F	13_6	126	16	6	1600	1850	250	0.38	1.16	2	3	1
0023	3F	13_6	134	10	3	1000	600	-400	0.30	0.60	1	1	0
0023	3F	13_6	135	11	1	1100	240	-860	0.09	0.22	1	0	-1
0023	3F	13_6	136	18	3	1800	740	-1060	0.17	0.41	3	1	-2
0023	3F	13_6	145	2	0	200	0	-200	0.00	0.00	0	0	0
0023	3F	13_6	146	5	0	500	0	-500	0.00	0.00	0	0	0
0023	3F	13_6	156	2	0	200	0	-200	0.00	0.00	0	0	0
0023	3F	13_6	236	1	0	100	0	-100	0.00	0.00	0	0	0
0023	3F	13_6	256	1	0	100	0	-100	0.00	0.00	0	0	0
0023	3F	13_7	123	17	7	1700	2580	880	0.41	1.52	3	4	1
0023	3F	13_7	124	26	11	2600	3690	1090	0.42	1.42	4	6	2
0023	3F	13_7	125	30	5	3000	1310	-1690	0.17	0.44	5	2	-3
0023	3F	13_7	126	20	5	2000	1420	-580	0.25	0.71	3	2	-1
0023	3F	13_7	134	18	7	1800	2000	200	0.39	1.11	3	3	0
0023	3F	13_7	135	8	2	800	690	-110	0.25	0.86	1	1	0
0023	3F	13_7	136	12	2	1200	730	-470	0.17	0.61	2	1	-1
0023	3F	13_7	145	6	3	600	820	220	0.50	1.37	1	1	0
0023	3F	13_7	146	6	1	600	370	-230	0.17	0.62	1	0	-1
0023	3F	13_7	156	1	0	100	0	-100	0.00	0.00	0	0	0
0023	3F	13_7	235	1	0	100	0	-100	0.00	0.00	0	0	0
0023	3F	13_7	245	1	0	100	0	-100	0.00	0.00	0	0	0
0023	3F	13_7	256	1	0	100	0	-100	0.00	0.00	0	0	0
0023	3F	13_8	123	19	3	1900	610	-1290	0.16	0.32	3	1	-2
0023	3F	13_8	124	28	8	2800	1920	-880	0.29	0.69	4	3	-1
0023	3F	13_8	125	15	3	1500	760	-740	0.20	0.51	2	1	-1
0023	3F	13_8	126	19	3	1900	1950	50	0.16	1.03	3	3	0
0023	3F	13_8	134	14	4	1400	860	-540	0.29	0.61	2	1	-1
0023	3F	13_8	135	11	3	1100	2010	910	0.27	1.83	1	3	2
0023	3F	13_8	136	16	2	1600	730	-870	0.13	0.46	2	1	-1
0023	3F	13_8	145	4	0	400	0	-400	0.00	0.00	0	0	0
0023	3F	13_8	146	8	0	800	0	-800	0.00	0.00	1	0	-1
0023	3F	13_8	156	2	0	200	0	-200	0.00	0.00	0	0	0
0023	3F	13_8	234	1	0	100	0	-100	0.00	0.00	0	0	0
0023	3F	13_8	256	1	0	100	0	-100	0.00	0.00	0	0	0
0023	3F	13_9	123	30	7	3000	2220	-780	0.23	0.74	5	3	-2
0023	3F	13_9	124	36	7	3600	2480	-1120	0.19	0.69	6	4	-2
0023	3F	13_9	125	24	4	2400	1680	-720	0.17	0.70	4	2	-2
0023	3F	13_9	126	14	1	1400	320	-1080	0.07	0.23	2	0	-2
0023	3F	13_9	134	23	6	2300	1960	-340	0.26	0.85	4	3	-1
0023	3F	13_9	135	15	6	1500	1740	240	0.40	1.16	2	3	1
0023	3F	13_9	136	16	3	1600	1540	-60	0.19	0.96	2	2	0
0023	3F	13_9	145	1	0	100	0	-100	0.00	0.00	0	0	0
0023	3F	13_9	146	2	0	200	0	-200	0.00	0.00	0	0	0
0023	3F	13_9	156	1	0	100	0	-100	0.00	0.00	0	0	0
0023	3F	14_1	123	21	8	2100	3110	1010	0.38	1.48	3	5	2
0023	3F	14_1	124	53	14	5300	3920	-1380	0.26	0.74	9	6	-3
0023	3F	14_1	125	3	0	300	0	-300	0.00	0.00	0	0	0
0023	3F	14_1	126	2	1	200	390	190	0.50	1.95	0	0	0
0023	3F	14_1	134	10	3	1000	700	-300	0.30	0.70	1	1	0
0023	3F	14_1	135	3	0	300	0	-300	0.00	0.00	0	0	0
0023	3F	14_1	145	3	0	300	0	-300	0.00	0.00	0	0	0
0023	3F	14_1	146	5	1	500	390	-110	0.20	0.78	0	0	0
0023	3F	14_10	123	15	4	1500	910	-590	0.27	0.61	2	1	-1
0023	3F	14_10	124	48	11	4800	3310	-1490	0.23	0.69	8	5	-3
0023	3F	14_10	125	28	5	2800	1900	-900	0.18	0.68	4	3	-1
0023	3F	14_10	126	21	4	2100	2820	720	0.19	1.34	3	4	1
0023	3F	14_10	134	14	2	1400	1040	-360	0.14	0.74	2	1	-1
0023	3F	14_10	135	19	3	1900	940	-960	0.16	0.49	3	1	-2
0023	3F	14_10	136	9	0	900	0	-900	0.00	0.00	1	0	-1
0023	3F	14_10	145	6	1	600	720	120	0.17	1.20	1	1	0
0023	3F	14_10	146	3	1	300	270	-30	0.33	0.90	0	0	0
0023	3F	14_10	156	2	1	200	390	190	0.50	1.95	0	0	0
0023	3F	14_10	234	1	0	100	0	-100	0.00	0.00	0	0	0
0023	3F	14_10	235	1	0	100	0	-100	0.00	0.00	0	0	0
0023	3F	14_10	245	1	0	100	0	-100	0.00	0.00	0	0	0
0023	3F	14_11	123	30	8	3000	1810	-1190	0.27	0.60	5	3	-2
0023	3F	14_11	124	106	15	10600	5940	-4660	0.14	0.56	18	10	-8
0023	3F	14_11	125	25	3	2500	2880	380	0.12	1.15	4	5	1
0023	3F	14_11	126	16	2	1600	2450	850	0.13	1.53	2	4	2
0023	3F	14_11	134	21	5	2100	1830	-270	0.24	0.87	3	3	0
0023	3F	14_11	135	11	0	1100	0	-1100	0.00	0.00	1	0	-1
0023	3F	14_11	136	9	0	900	0	-900	0.00	0.00	1	0	-1
0023	3F	14_11	145	1	0	100	0	-100	0.00	0.00	0	0	0
0023	3F	14_11	146	2	0	200	0	-200	0.00	0.00	0	0	0
0023	3F	14_11	156	1	0	100	0	-100	0.00	0.00	0	0	0
0023	3F	14_12	123	33	6	3300	1750	-1550	0.18	0.53	5	3	-2
0023	3F	14_12	124	150	25	15000	11810	-3190	0.17	0.79	26	20	-6
0023	3F	14_12	125	11	0	1100	0	-1100	0.00	0.00	1	0	-1
0023	3F	14_12	126	25	0	2500	0	-2500	0.00	0.00	4	0	-4
0023	3F	14_12	134	11	1	1100	470	-630	0.09	0.43	1	0	-1
0023	3F	14_12	135	4	1	400	340	-60	0.25	0.85	0	0	0
0023	3F	14_12	136	5	0	500	0	-500	0.00	0.00	0	0	0
0023	3F	14_2	123	21	6	2100	1360	-740	0.29	0.65	3	2	-1
0023	3F	14_2	124	28	9	2800	3400	600	0.32	1.21	4	6	2
0023	3F	14_2	125	20	3	2000	1720	-280	0.15	0.86	3	3	0
0023	3F	14_2	126	30	5	3000	3320	320	0.17	1.11	5	5	0
0023	3F	14_2	134	17	3	1700	1570	-130	0.18	0.92	3	2	-1
0023	3F	14_2	135	6	1	600	360	-240	0.17	0.60	1	0	-1
0023	3F	14_2	136	14	4	1400	3020	1620	0.29	2.16	2	5	3
0023	3F	14_2	145	2	0	200	0	-200	0.00	0.00	0	0	0
0023	3F	14_2	146	11	0	1100	0	-1100	0.00	0.00	1	0	-1
0023	3F	14_2	156	7	1	700	380	-320	0.14	0.54	1	0	-1
0023	3F	14_2	235	2	0	200	0	-200	0.00	0.00	0	0	0
0023	3F	14_2	256	1	0	100	0	-100	0.00	0.00	0	0	0
0023	3F	14_3	123	39	9	3900	2780	-1120	0.23	0.71	6	4	-2
0023	3F	14_3	124	30	6	3000	1450	-1550	0.20	0.48	5	2	-3
0023	3F	14_3	125	27	6	2700	2500	-200	0.22	0.93	4	4	0
0023	3F	14_3	126	7	1	700	310	-390	0.14	0.44	1	0	-1
0023	3F	14_3	134	8	2	800	610	-190	0.25	0.76	1	1	0
0023	3F	14_3	135	8	2	800	790	-10	0.25	0.99	1	1	0
0023	3F	14_3	136	6	0	600	0	-600	0.00	0.00	1	0	-1
0023	3F	14_3	146	2	1	200	400	200	0.50	2.00	0	0	0
0023	3F	14_3	156	2	0	200	0	-200	0.00	0.00	0	0	0
0023	3F	14_4	123	13	1	1300	190	-1110	0.08	0.15	2	0	-2
0023	3F	14_4	124	21	3	2100	610	-1490	0.14	0.29	3	1	-2
0023	3F	14_4	125	20	4	2000	1420	-580	0.20	0.71	3	2	-1
0023	3F	14_4	126	28	5	2800	1890	-910	0.18	0.68	4	3	-1
0023	3F	14_4	134	10	3	1000	800	-200	0.30	0.80	1	1	0
0023	3F	14_4	135	14	3	1400	1170	-230	0.21	0.84	2	2	0
0023	3F	14_4	136	20	7	2000	2470	470	0.35	1.24	3	4	1
0023	3F	14_4	145	6	0	600	0	-600	0.00	0.00	1	0	-1
0023	3F	14_4	146	13	0	1300	0	-1300	0.00	0.00	2	0	-2
0023	3F	14_4	156	6	3	600	1610	1010	0.50	2.68	1	2	1
0023	3F	14_4	234	1	0	100	0	-100	0.00	0.00	0	0	0
0023	3F	14_4	235	1	1	100	500	400	1.00	5.00	0	0	0
0023	3F	14_4	256	1	0	100	0	-100	0.00	0.00	0	0	0
0023	3F	14_5	123	51	13	5100	5130	30	0.25	1.01	9	9	0
0023	3F	14_5	124	31	7	3100	1850	-1250	0.23	0.60	5	3	-2
0023	3F	14_5	125	20	9	2000	2810	810	0.45	1.41	3	4	1
0023	3F	14_5	126	13	0	1300	0	-1300	0.00	0.00	2	0	-2
0023	3F	14_5	134	6	0	600	0	-600	0.00	0.00	1	0	-1
0023	3F	14_5	135	7	3	700	810	110	0.43	1.16	1	1	0
0023	3F	14_5	136	3	0	300	0	-300	0.00	0.00	0	0	0
0023	3F	14_5	145	4	1	400	520	120	0.25	1.30	0	0	0
0023	3F	14_5	146	1	0	100	0	-100	0.00	0.00	0	0	0
0023	3F	14_5	156	3	0	300	0	-300	0.00	0.00	0	0	0
0023	3F	14_6	123	5	1	500	190	-310	0.20	0.38	0	0	0
0023	3F	14_6	124	13	2	1300	840	-460	0.15	0.65	2	1	-1
0023	3F	14_6	125	14	2	1400	1660	260	0.14	1.19	2	2	0
0023	3F	14_6	126	15	1	1500	250	-1250	0.07	0.17	2	0	-2
0023	3F	14_6	134	4	1	400	360	-40	0.25	0.90	0	0	0
0023	3F	14_6	135	14	2	1400	560	-840	0.14	0.40	2	0	-2
0023	3F	14_6	136	10	1	1000	640	-360	0.10	0.64	1	1	0
0023	3F	14_6	145	9	1	900	400	-500	0.11	0.44	1	0	-1
0023	3F	14_6	146	6	1	600	420	-180	0.17	0.70	1	0	-1
0023	3F	14_6	156	13	0	1300	0	-1300	0.00	0.00	2	0	-2
0023	3F	14_6	234	1	1	100	340	240	1.00	3.40	0	0	0
0023	3F	14_6	235	1	0	100	0	-100	0.00	0.00	0	0	0
0023	3F	14_6	236	1	1	100	350	250	1.00	3.50	0	0	0
0023	3F	14_6	245	1	0	100	0	-100	0.00	0.00	0	0	0
0023	3F	14_6	246	1	0	100	0	-100	0.00	0.00	0	0	0
0023	3F	14_6	256	1	1	100	910	810	1.00	9.10	0	1	1
0023	3F	14_7	123	5	1	500	210	-290	0.20	0.42	0	0	0
0023	3F	14_7	124	7	1	700	450	-250	0.14	0.64	1	0	-1
0023	3F	14_7	125	14	1	1400	230	-1170	0.07	0.16	2	0	-2
0023	3F	14_7	126	28	5	2800	2530	-270	0.18	0.90	4	4	0
0023	3F	14_7	134	5	0	500	0	-500	0.00	0.00	0	0	0
0023	3F	14_7	135	8	2	800	860	60	0.25	1.08	1	1	0
0023	3F	14_7	136	18	1	1800	210	-1590	0.06	0.12	3	0	-3
0023	3F	14_7	145	8	0	800	0	-800	0.00	0.00	1	0	-1
0023	3F	14_7	146	4	0	400	0	-400	0.00	0.00	0	0	0
0023	3F	14_7	156	6	1	600	470	-130	0.17	0.78	1	0	-1
0023	3F	14_7	234	2	1	200	250	50	0.50	1.25	0	0	0
0023	3F	14_7	236	2	0	200	0	-200	0.00	0.00	0	0	0
0023	3F	14_7	246	1	0	100	0	-100	0.00	0.00	0	0	0
0023	3F	14_8	123	12	3	1200	980	-220	0.25	0.82	2	1	-1
0023	3F	14_8	124	7	1	700	450	-250	0.14	0.64	1	0	-1
0023	3F	14_8	125	10	0	1000	0	-1000	0.00	0.00	1	0	-1
0023	3F	14_8	126	18	3	1800	3540	1740	0.17	1.97	3	6	3
0023	3F	14_8	134	5	2	500	1300	800	0.40	2.60	0	2	2
0023	3F	14_8	135	8	0	800	0	-800	0.00	0.00	1	0	-1
0023	3F	14_8	136	14	1	1400	300	-1100	0.07	0.21	2	0	-2
0023	3F	14_8	145	8	2	800	990	190	0.25	1.24	1	1	0
0023	3F	14_8	146	8	0	800	0	-800	0.00	0.00	1	0	-1
0023	3F	14_8	156	4	0	400	0	-400	0.00	0.00	0	0	0
0023	3F	14_8	234	2	0	200	0	-200	0.00	0.00	0	0	0
0023	3F	14_8	235	1	0	100	0	-100	0.00	0.00	0	0	0
0023	3F	14_8	236	2	0	200	0	-200	0.00	0.00	0	0	0
0023	3F	14_8	245	2	0	200	0	-200	0.00	0.00	0	0	0
0023	3F	14_8	256	1	0	100	0	-100	0.00	0.00	0	0	0
0023	3F	14_9	123	12	4	1200	1020	-180	0.33	0.85	2	1	-1
0023	3F	14_9	124	25	7	2500	2070	-430	0.28	0.83	4	3	-1
0023	3F	14_9	125	17	4	1700	1890	190	0.24	1.11	3	3	0
0023	3F	14_9	126	27	3	2700	1340	-1360	0.11	0.50	4	2	-2
0023	3F	14_9	134	4	1	400	660	260	0.25	1.65	0	1	1
0023	3F	14_9	135	11	0	1100	0	-1100	0.00	0.00	1	0	-1
0023	3F	14_9	136	9	1	900	620	-280	0.11	0.69	1	1	0
0023	3F	14_9	145	5	0	500	0	-500	0.00	0.00	0	0	0
0023	3F	14_9	146	5	0	500	0	-500	0.00	0.00	0	0	0
0023	3F	14_9	236	1	0	100	0	-100	0.00	0.00	0	0	0
0023	3F	14_9	245	1	0	100	0	-100	0.00	0.00	0	0	0
0023	3F	14_9	246	1	0	100	0	-100	0.00	0.00	0	0	0
0023	3F	15_1	123	41	9	4100	3040	-1060	0.22	0.74	7	5	-2
0023	3F	15_1	124	55	13	5500	5310	-190	0.24	0.97	9	9	0
0023	3F	15_1	125	32	6	3200	2950	-250	0.19	0.92	5	5	0
0023	3F	15_1	126	21	2	2100	720	-1380	0.10	0.34	3	1	-2
0023	3F	15_1	134	12	1	1200	290	-910	0.08	0.24	2	0	-2
0023	3F	15_1	135	12	1	1200	280	-920	0.08	0.23	2	0	-2
0023	3F	15_1	136	7	1	700	240	-460	0.14	0.34	1	0	-1
0023	3F	15_1	145	2	0	200	0	-200	0.00	0.00	0	0	0
0023	3F	15_1	146	1	0	100	0	-100	0.00	0.00	0	0	0
0023	3F	15_1	156	1	1	100	150	50	1.00	1.50	0	0	0
0023	3F	15_10	123	32	8	3200	2590	-610	0.25	0.81	5	4	-1
0023	3F	15_10	124	82	16	8200	5510	-2690	0.20	0.67	14	9	-5
0023	3F	15_10	125	41	8	4100	4710	610	0.20	1.15	7	8	1
0023	3F	15_10	126	17	7	1700	3190	1490	0.41	1.88	3	5	2
0023	3F	15_10	134	25	3	2500	1560	-940	0.12	0.62	4	2	-2
0023	3F	15_10	135	23	2	2300	470	-1830	0.09	0.20	4	0	-4
0023	3F	15_10	136	17	3	1700	1130	-570	0.18	0.66	3	2	-1
0023	3F	15_10	145	2	0	200	0	-200	0.00	0.00	0	0	0
0023	3F	15_10	146	4	1	400	220	-180	0.25	0.55	0	0	0
0023	3F	15_10	156	1	0	100	0	-100	0.00	0.00	0	0	0
0023	3F	15_10	234	1	0	100	0	-100	0.00	0.00	0	0	0
0023	3F	15_11	123	40	16	4000	4530	530	0.40	1.13	7	8	1
0023	3F	15_11	124	118	21	11800	8870	-2930	0.18	0.75	20	15	-5
0023	3F	15_11	125	40	8	4000	3930	-70	0.20	0.98	7	6	-1
0023	3F	15_11	126	13	0	1300	0	-1300	0.00	0.00	2	0	-2
0023	3F	15_11	134	27	4	2700	1590	-1110	0.15	0.59	4	2	-2
0023	3F	15_11	135	13	0	1300	0	-1300	0.00	0.00	2	0	-2
0023	3F	15_11	136	5	1	500	890	390	0.20	1.78	0	1	1
0023	3F	15_11	146	2	0	200	0	-200	0.00	0.00	0	0	0
0023	3F	15_11	156	1	0	100	0	-100	0.00	0.00	0	0	0
0023	3F	15_12	123	20	2	2000	580	-1420	0.10	0.29	3	1	-2
0023	3F	15_12	124	152	30	15200	11350	-3850	0.20	0.75	26	20	-6
0023	3F	15_12	125	32	3	3200	1370	-1830	0.09	0.43	5	2	-3
0023	3F	15_12	126	9	0	900	0	-900	0.00	0.00	1	0	-1
0023	3F	15_12	134	21	6	2100	1760	-340	0.29	0.84	3	3	0
0023	3F	15_12	135	13	5	1300	2820	1520	0.38	2.17	2	4	2
0023	3F	15_12	136	4	0	400	0	-400	0.00	0.00	0	0	0
0023	3F	15_12	156	1	0	100	0	-100	0.00	0.00	0	0	0
0023	3F	15_2	123	27	6	2700	1940	-760	0.22	0.72	4	3	-1
0023	3F	15_2	124	23	4	2300	1660	-640	0.17	0.72	4	2	-2
0023	3F	15_2	125	21	4	2100	1770	-330	0.19	0.84	3	3	0
0023	3F	15_2	126	20	4	2000	2410	410	0.20	1.21	3	4	1
0023	3F	15_2	134	16	1	1600	470	-1130	0.06	0.29	2	0	-2
0023	3F	15_2	135	7	1	700	220	-480	0.14	0.31	1	0	-1
0023	3F	15_2	136	10	3	1000	1920	920	0.30	1.92	1	3	2
0023	3F	15_2	145	2	1	200	280	80	0.50	1.40	0	0	0
0023	3F	15_2	146	4	0	400	0	-400	0.00	0.00	0	0	0
0023	3F	15_2	156	4	0	400	0	-400	0.00	0.00	0	0	0
0023	3F	15_2	235	1	0	100	0	-100	0.00	0.00	0	0	0
0023	3F	15_3	123	4	0	400	0	-400	0.00	0.00	0	0	0
0023	3F	15_3	124	14	2	1400	760	-640	0.14	0.54	2	1	-1
0023	3F	15_3	125	25	7	2500	5080	2580	0.28	2.03	4	8	4
0023	3F	15_3	126	27	3	2700	1740	-960	0.11	0.64	4	3	-1
0023	3F	15_3	134	10	2	1000	440	-560	0.20	0.44	1	0	-1
0023	3F	15_3	135	15	1	1500	420	-1080	0.07	0.28	2	0	-2
0023	3F	15_3	136	26	2	2600	1130	-1470	0.08	0.43	4	2	-2
0023	3F	15_3	145	8	1	800	1000	200	0.13	1.25	1	1	0
0023	3F	15_3	146	14	0	1400	0	-1400	0.00	0.00	2	0	-2
0023	3F	15_3	156	10	0	1000	0	-1000	0.00	0.00	1	0	-1
0023	3F	15_3	236	2	0	200	0	-200	0.00	0.00	0	0	0
0023	3F	15_4	123	1	0	100	0	-100	0.00	0.00	0	0	0
0023	3F	15_4	124	4	0	400	0	-400	0.00	0.00	0	0	0
0023	3F	15_4	125	12	1	1200	540	-660	0.08	0.45	2	0	-2
0023	3F	15_4	126	20	3	2000	1190	-810	0.15	0.60	3	2	-1
0023	3F	15_4	134	10	4	1000	1150	150	0.40	1.15	1	2	1
0023	3F	15_4	135	16	1	1600	270	-1330	0.06	0.17	2	0	-2
0023	3F	15_4	136	36	8	3600	4290	690	0.22	1.19	6	7	1
0023	3F	15_4	145	6	0	600	0	-600	0.00	0.00	1	0	-1
0023	3F	15_4	146	19	2	1900	4090	2190	0.11	2.15	3	7	4
0023	3F	15_4	156	14	1	1400	1280	-120	0.07	0.91	2	2	0
0023	3F	15_4	236	3	0	300	0	-300	0.00	0.00	0	0	0
0023	3F	15_4	256	2	0	200	0	-200	0.00	0.00	0	0	0
0023	3F	15_5	123	13	3	1300	740	-560	0.23	0.57	2	1	-1
0023	3F	15_5	124	66	13	6600	3150	-3450	0.20	0.48	11	5	-6
0023	3F	15_5	125	3	0	300	0	-300	0.00	0.00	0	0	0
0023	3F	15_5	126	1	0	100	0	-100	0.00	0.00	0	0	0
0023	3F	15_5	134	85	36	8500	8030	-470	0.42	0.94	15	14	-1
0023	3F	15_5	135	3	1	300	240	-60	0.33	0.80	0	0	0
0023	3F	15_5	136	4	0	400	0	-400	0.00	0.00	0	0	0
0023	3F	15_5	145	1	0	100	0	-100	0.00	0.00	0	0	0
0023	3F	15_5	146	2	0	200	0	-200	0.00	0.00	0	0	0
0023	3F	15_6	123	9	1	900	180	-720	0.11	0.20	1	0	-1
0023	3F	15_6	124	28	2	2800	640	-2160	0.07	0.23	4	1	-3
0023	3F	15_6	125	30	9	3000	2480	-520	0.30	0.83	5	4	-1
0023	3F	15_6	126	38	3	3800	1140	-2660	0.08	0.30	6	2	-4
0023	3F	15_6	134	3	0	300	0	-300	0.00	0.00	0	0	0
0023	3F	15_6	135	18	4	1800	1180	-620	0.22	0.66	3	2	-1
0023	3F	15_6	136	6	1	600	390	-210	0.17	0.65	1	0	-1
0023	3F	15_6	145	4	3	400	1580	1180	0.75	3.95	0	2	2
0023	3F	15_6	156	3	1	300	390	90	0.33	1.30	0	0	0
0023	3F	15_6	235	2	1	200	260	60	0.50	1.30	0	0	0
0023	3F	15_6	236	1	0	100	0	-100	0.00	0.00	0	0	0
0023	3F	15_6	245	1	0	100	0	-100	0.00	0.00	0	0	0
0023	3F	15_6	246	1	0	100	0	-100	0.00	0.00	0	0	0
0023	3F	15_6	256	1	0	100	0	-100	0.00	0.00	0	0	0
0023	3F	15_7	123	16	5	1600	1370	-230	0.31	0.86	2	2	0
0023	3F	15_7	124	24	3	2400	910	-1490	0.13	0.38	4	1	-3
0023	3F	15_7	125	33	6	3300	2400	-900	0.18	0.73	5	4	-1
0023	3F	15_7	126	29	3	2900	1030	-1870	0.10	0.36	5	1	-4
0023	3F	15_7	134	5	0	500	0	-500	0.00	0.00	0	0	0
0023	3F	15_7	135	12	5	1200	1420	220	0.42	1.18	2	2	0
0023	3F	15_7	136	16	3	1600	1800	200	0.19	1.13	2	3	1
0023	3F	15_7	145	5	0	500	0	-500	0.00	0.00	0	0	0
0023	3F	15_7	146	7	2	700	840	140	0.29	1.20	1	1	0
0023	3F	15_7	156	5	2	500	980	480	0.40	1.96	0	1	1
0023	3F	15_7	234	1	0	100	0	-100	0.00	0.00	0	0	0
0023	3F	15_7	235	2	0	200	0	-200	0.00	0.00	0	0	0
0023	3F	15_7	236	1	0	100	0	-100	0.00	0.00	0	0	0
0023	3F	15_7	245	1	1	100	420	320	1.00	4.20	0	0	0
0023	3F	15_8	123	21	3	2100	1050	-1050	0.14	0.50	3	1	-2
0023	3F	15_8	124	206	78	20600	14760	-5840	0.38	0.72	36	26	-10
0023	3F	15_8	125	3	0	300	0	-300	0.00	0.00	0	0	0
0023	3F	15_8	126	2	0	200	0	-200	0.00	0.00	0	0	0
0023	3F	15_8	136	1	0	100	0	-100	0.00	0.00	0	0	0
0023	3F	15_9	123	32	9	3200	2790	-410	0.28	0.87	5	4	-1
0023	3F	15_9	124	54	12	5400	4310	-1090	0.22	0.80	9	7	-2
0023	3F	15_9	125	32	6	3200	3020	-180	0.19	0.94	5	5	0
0023	3F	15_9	126	24	5	2400	2340	-60	0.21	0.98	4	4	0
0023	3F	15_9	134	14	5	1400	1920	520	0.36	1.37	2	3	1
0023	3F	15_9	135	20	2	2000	680	-1320	0.10	0.34	3	1	-2
0023	3F	15_9	136	9	1	900	450	-450	0.11	0.50	1	0	-1
0023	3F	15_9	145	4	1	400	630	230	0.25	1.58	0	1	1
0023	3F	15_9	146	2	1	200	1090	890	0.50	5.45	0	1	1
0023	3F	15_9	156	2	0	200	0	-200	0.00	0.00	0	0	0
0023	3F	15_9	236	1	0	100	0	-100	0.00	0.00	0	0	0
0023	3F	16_1	123	67	14	6700	4370	-2330	0.21	0.65	11	7	-4
0023	3F	16_1	124	64	10	6400	2780	-3620	0.16	0.43	11	4	-7
0023	3F	16_1	125	22	5	2200	1700	-500	0.23	0.77	3	3	0
0023	3F	16_1	126	10	2	1000	940	-60	0.20	0.94	1	1	0
0023	3F	16_1	134	15	2	1500	1550	50	0.13	1.03	2	2	0
0023	3F	16_1	136	3	0	300	0	-300	0.00	0.00	0	0	0
0023	3F	16_1	145	1	0	100	0	-100	0.00	0.00	0	0	0
0023	3F	16_1	146	1	1	100	350	250	1.00	3.50	0	0	0
0023	3F	16_10	123	20	4	2000	970	-1030	0.20	0.49	3	1	-2
0023	3F	16_10	124	97	31	9700	11880	2180	0.32	1.22	17	21	4
0023	3F	16_10	125	39	7	3900	2390	-1510	0.18	0.61	6	4	-2
0023	3F	16_10	126	35	6	3500	2930	-570	0.17	0.84	6	5	-1
0023	3F	16_10	134	16	6	1600	4640	3040	0.38	2.90	2	8	6
0023	3F	16_10	135	21	5	2100	2330	230	0.24	1.11	3	4	1
0023	3F	16_10	136	3	0	300	0	-300	0.00	0.00	0	0	0
0023	3F	16_10	145	3	0	300	0	-300	0.00	0.00	0	0	0
0023	3F	16_10	156	2	2	200	710	510	1.00	3.55	0	1	1
0023	3F	16_10	234	1	0	100	0	-100	0.00	0.00	0	0	0
0023	3F	16_11	123	31	8	3100	1950	-1150	0.26	0.63	5	3	-2
0023	3F	16_11	124	131	31	13100	12290	-810	0.24	0.94	23	21	-2
0023	3F	16_11	125	28	9	2800	4040	1240	0.32	1.44	4	7	3
0023	3F	16_11	126	7	1	700	1270	570	0.14	1.81	1	2	1
0023	3F	16_11	134	34	4	3400	1220	-2180	0.12	0.36	6	2	-4
0023	3F	16_11	135	21	5	2100	1990	-110	0.24	0.95	3	3	0
0023	3F	16_11	136	1	0	100	0	-100	0.00	0.00	0	0	0
0023	3F	16_11	146	1	0	100	0	-100	0.00	0.00	0	0	0
0023	3F	16_12	123	24	9	2400	2450	50	0.38	1.02	4	4	0
0023	3F	16_12	124	175	28	17500	11610	-5890	0.16	0.66	30	20	-10
0023	3F	16_12	125	21	1	2100	540	-1560	0.05	0.26	3	0	-3
0023	3F	16_12	126	4	0	400	0	-400	0.00	0.00	0	0	0
0023	3F	16_12	134	25	2	2500	560	-1940	0.08	0.22	4	0	-4
0023	3F	16_12	135	13	3	1300	1300	0	0.23	1.00	2	2	0
0023	3F	16_12	136	3	1	300	800	500	0.33	2.67	0	1	1
0023	3F	16_12	145	1	0	100	0	-100	0.00	0.00	0	0	0
0023	3F	16_2	123	36	9	3600	3250	-350	0.25	0.90	6	5	-1
0023	3F	16_2	124	17	7	1700	2480	780	0.41	1.46	3	4	1
0023	3F	16_2	125	27	3	2700	1100	-1600	0.11	0.41	4	1	-3
0023	3F	16_2	126	17	5	1700	2940	1240	0.29	1.73	3	5	2
0023	3F	16_2	134	13	1	1300	740	-560	0.08	0.57	2	1	-1
0023	3F	16_2	135	3	2	300	860	560	0.67	2.87	0	1	1
0023	3F	16_2	136	12	2	1200	770	-430	0.17	0.64	2	1	-1
0023	3F	16_2	145	5	2	500	800	300	0.40	1.60	0	1	1
0023	3F	16_2	146	6	3	600	1030	430	0.50	1.72	1	1	0
0023	3F	16_2	156	3	0	300	0	-300	0.00	0.00	0	0	0
0023	3F	16_2	236	1	1	100	840	740	1.00	8.40	0	1	1
0023	3F	16_3	123	11	1	1100	510	-590	0.09	0.46	1	0	-1
0023	3F	16_3	124	14	5	1400	1570	170	0.36	1.12	2	2	0
0023	3F	16_3	125	19	3	1900	1270	-630	0.16	0.67	3	2	-1
0023	3F	16_3	126	26	3	2600	1360	-1240	0.12	0.52	4	2	-2
0023	3F	16_3	134	7	0	700	0	-700	0.00	0.00	1	0	-1
0023	3F	16_3	135	15	2	1500	640	-860	0.13	0.43	2	1	-1
0023	3F	16_3	136	14	3	1400	1410	10	0.21	1.01	2	2	0
0023	3F	16_3	145	8	1	800	320	-480	0.13	0.40	1	0	-1
0023	3F	16_3	146	11	1	1100	300	-800	0.09	0.27	1	0	-1
0023	3F	16_3	156	4	1	400	590	190	0.25	1.48	0	1	1
0023	3F	16_3	236	2	1	200	580	380	0.50	2.90	0	1	1
0023	3F	16_3	246	1	0	100	0	-100	0.00	0.00	0	0	0
0023	3F	16_4	123	16	1	1600	180	-1420	0.06	0.11	2	0	-2
0023	3F	16_4	124	13	3	1300	1490	190	0.23	1.15	2	2	0
0023	3F	16_4	125	26	7	2600	3630	1030	0.27	1.40	4	6	2
0023	3F	16_4	126	24	7	2400	2900	500	0.29	1.21	4	5	1
0023	3F	16_4	134	10	2	1000	490	-510	0.20	0.49	1	0	-1
0023	3F	16_4	135	14	1	1400	260	-1140	0.07	0.19	2	0	-2
0023	3F	16_4	136	22	3	2200	2400	200	0.14	1.09	3	4	1
0023	3F	16_4	145	13	3	1300	1740	440	0.23	1.34	2	3	1
0023	3F	16_4	146	6	2	600	1200	600	0.33	2.00	1	2	1
0023	3F	16_4	156	5	0	500	0	-500	0.00	0.00	0	0	0
0023	3F	16_4	235	1	0	100	0	-100	0.00	0.00	0	0	0
0023	3F	16_4	236	2	0	200	0	-200	0.00	0.00	0	0	0
0023	3F	16_4	245	1	0	100	0	-100	0.00	0.00	0	0	0
0023	3F	16_4	246	1	0	100	0	-100	0.00	0.00	0	0	0
0023	3F	16_4	256	2	0	200	0	-200	0.00	0.00	0	0	0
0023	3F	16_5	123	13	2	1300	510	-790	0.15	0.39	2	0	-2
0023	3F	16_5	124	16	4	1600	1020	-580	0.25	0.64	2	1	-1
0023	3F	16_5	125	29	7	2900	1620	-1280	0.24	0.56	5	2	-3
0023	3F	16_5	126	27	5	2700	1440	-1260	0.19	0.53	4	2	-2
0023	3F	16_5	134	15	3	1500	930	-570	0.20	0.62	2	1	-1
0023	3F	16_5	135	19	3	1900	770	-1130	0.16	0.41	3	1	-2
0023	3F	16_5	136	20	3	2000	1080	-920	0.15	0.54	3	1	-2
0023	3F	16_5	145	6	0	600	0	-600	0.00	0.00	1	0	-1
0023	3F	16_5	146	2	1	200	390	190	0.50	1.95	0	0	0
0023	3F	16_5	156	4	1	400	700	300	0.25	1.75	0	1	1
0023	3F	16_5	234	1	0	100	0	-100	0.00	0.00	0	0	0
0023	3F	16_5	235	1	0	100	0	-100	0.00	0.00	0	0	0
0023	3F	16_5	246	1	0	100	0	-100	0.00	0.00	0	0	0
0023	3F	16_5	256	3	0	300	0	-300	0.00	0.00	0	0	0
0023	3F	16_6	123	147	71	14700	11900	-2800	0.48	0.81	26	21	-5
0023	3F	16_6	124	44	6	4400	2310	-2090	0.14	0.53	7	4	-3
0023	3F	16_6	125	4	1	400	370	-30	0.25	0.93	0	0	0
0023	3F	16_6	126	9	1	900	320	-580	0.11	0.36	1	0	-1
0023	3F	16_6	134	15	4	1500	1180	-320	0.27	0.79	2	2	0
0023	3F	16_6	135	3	1	300	250	-50	0.33	0.83	0	0	0
0023	3F	16_6	136	2	0	200	0	-200	0.00	0.00	0	0	0
0023	3F	16_6	156	1	1	100	210	110	1.00	2.10	0	0	0
0023	3F	16_7	123	5	1	500	250	-250	0.20	0.50	0	0	0
0023	3F	16_7	124	31	8	3100	2190	-910	0.26	0.71	5	3	-2
0023	3F	16_7	125	14	1	1400	210	-1190	0.07	0.15	2	0	-2
0023	3F	16_7	126	30	5	3000	2040	-960	0.17	0.68	5	3	-2
0023	3F	16_7	134	6	2	600	430	-170	0.33	0.72	1	0	-1
0023	3F	16_7	135	10	2	1000	1420	420	0.20	1.42	1	2	1
0023	3F	16_7	136	9	1	900	670	-230	0.11	0.74	1	1	0
0023	3F	16_7	145	4	0	400	0	-400	0.00	0.00	0	0	0
0023	3F	16_7	146	7	1	700	690	-10	0.14	0.99	1	1	0
0023	3F	16_7	156	7	0	700	0	-700	0.00	0.00	1	0	-1
0023	3F	16_7	236	2	1	200	350	150	0.50	1.75	0	0	0
0023	3F	16_7	245	2	1	200	260	60	0.50	1.30	0	0	0
0023	3F	16_7	256	4	2	400	850	450	0.50	2.13	0	1	1
0023	3F	16_8	123	5	1	500	280	-220	0.20	0.56	0	0	0
0023	3F	16_8	124	33	6	3300	1680	-1620	0.18	0.51	5	2	-3
0023	3F	16_8	125	27	6	2700	2180	-520	0.22	0.81	4	3	-1
0023	3F	16_8	126	39	7	3900	2220	-1680	0.18	0.57	6	3	-3
0023	3F	16_8	134	14	2	1400	510	-890	0.14	0.36	2	0	-2
0023	3F	16_8	135	8	4	800	1710	910	0.50	2.14	1	3	2
0023	3F	16_8	136	11	1	1100	660	-440	0.09	0.60	1	1	0
0023	3F	16_8	145	4	0	400	0	-400	0.00	0.00	0	0	0
0023	3F	16_8	146	5	1	500	540	40	0.20	1.08	0	0	0
0023	3F	16_8	156	3	0	300	0	-300	0.00	0.00	0	0	0
0023	3F	16_8	234	1	0	100	0	-100	0.00	0.00	0	0	0
0023	3F	16_8	235	2	1	200	200	0	0.50	1.00	0	0	0
0023	3F	16_8	236	1	0	100	0	-100	0.00	0.00	0	0	0
0023	3F	16_8	256	2	0	200	0	-200	0.00	0.00	0	0	0
0023	3F	16_9	123	6	0	600	0	-600	0.00	0.00	1	0	-1
0023	3F	16_9	124	58	18	5800	4990	-810	0.31	0.86	10	8	-2
0023	3F	16_9	125	9	1	900	300	-600	0.11	0.33	1	0	-1
0023	3F	16_9	126	1	1	100	450	350	1.00	4.50	0	0	0
0023	3F	16_9	134	20	5	2000	1350	-650	0.25	0.68	3	2	-1
0023	3F	16_9	135	2	0	200	0	-200	0.00	0.00	0	0	0
0023	3F	16_9	136	1	0	100	0	-100	0.00	0.00	0	0	0
0023	3F	16_9	145	18	6	1800	1970	170	0.33	1.09	3	3	0
0023	3F	16_9	146	3	0	300	0	-300	0.00	0.00	0	0	0
0023	3F	17_1	123	37	8	3700	2050	-1650	0.22	0.55	6	3	-3
0023	3F	17_1	124	58	10	5800	4010	-1790	0.17	0.69	10	7	-3
0023	3F	17_1	125	29	3	2900	1170	-1730	0.10	0.40	5	2	-3
0023	3F	17_1	126	18	3	1800	3360	1560	0.17	1.87	3	5	2
0023	3F	17_1	134	25	3	2500	1380	-1120	0.12	0.55	4	2	-2
0023	3F	17_1	135	3	0	300	0	-300	0.00	0.00	0	0	0
0023	3F	17_1	136	2	2	200	1370	1170	1.00	6.85	0	2	2
0023	3F	17_1	146	2	0	200	0	-200	0.00	0.00	0	0	0
0023	3F	17_10	123	46	12	4600	4040	-560	0.26	0.88	8	7	-1
0023	3F	17_10	124	69	14	6900	5890	-1010	0.20	0.85	12	10	-2
0023	3F	17_10	125	32	6	3200	3180	-20	0.19	0.99	5	5	0
0023	3F	17_10	126	6	1	600	260	-340	0.17	0.43	1	0	-1
0023	3F	17_10	134	28	3	2800	1310	-1490	0.11	0.47	4	2	-2
0023	3F	17_10	135	10	2	1000	950	-50	0.20	0.95	1	1	0
0023	3F	17_10	136	2	0	200	0	-200	0.00	0.00	0	0	0
0023	3F	17_10	145	4	0	400	0	-400	0.00	0.00	0	0	0
0023	3F	17_10	146	2	0	200	0	-200	0.00	0.00	0	0	0
0023	3F	17_11	123	84	21	8400	9310	910	0.25	1.11	14	16	2
0023	3F	17_11	124	44	11	4400	4010	-390	0.25	0.91	7	7	0
0023	3F	17_11	125	27	5	2700	2090	-610	0.19	0.77	4	3	-1
0023	3F	17_11	126	3	1	300	360	60	0.33	1.20	0	0	0
0023	3F	17_11	134	20	5	2000	1700	-300	0.25	0.85	3	3	0
0023	3F	17_11	135	7	2	700	860	160	0.29	1.23	1	1	0
0023	3F	17_11	145	4	2	400	920	520	0.50	2.30	0	1	1
0023	3F	17_12	123	56	12	5600	4970	-630	0.21	0.89	9	8	-1
0023	3F	17_12	124	136	22	13600	8260	-5340	0.16	0.61	24	14	-10
0023	3F	17_12	125	31	2	3100	1550	-1550	0.06	0.50	5	2	-3
0023	3F	17_12	134	19	4	1900	1500	-400	0.21	0.79	3	2	-1
0023	3F	17_12	135	1	0	100	0	-100	0.00	0.00	0	0	0
0023	3F	17_12	256	1	0	100	0	-100	0.00	0.00	0	0	0
0023	3F	17_2	123	29	7	2900	3140	240	0.24	1.08	5	5	0
0023	3F	17_2	124	36	3	3600	930	-2670	0.08	0.26	6	1	-5
0023	3F	17_2	125	20	4	2000	1750	-250	0.20	0.88	3	3	0
0023	3F	17_2	126	19	1	1900	1600	-300	0.05	0.84	3	2	-1
0023	3F	17_2	134	11	0	1100	0	-1100	0.00	0.00	1	0	-1
0023	3F	17_2	135	5	1	500	590	90	0.20	1.18	0	1	1
0023	3F	17_2	136	2	0	200	0	-200	0.00	0.00	0	0	0
0023	3F	17_2	146	4	1	400	280	-120	0.25	0.70	0	0	0
0023	3F	17_2	156	1	0	100	0	-100	0.00	0.00	0	0	0
0023	3F	17_2	234	1	0	100	0	-100	0.00	0.00	0	0	0
0023	3F	17_2	235	2	0	200	0	-200	0.00	0.00	0	0	0
0023	3F	17_3	123	3	1	300	220	-80	0.33	0.73	0	0	0
0023	3F	17_3	124	23	6	2300	1700	-600	0.26	0.74	4	3	-1
0023	3F	17_3	125	23	5	2300	3270	970	0.22	1.42	4	5	1
0023	3F	17_3	126	26	2	2600	4440	1840	0.08	1.71	4	7	3
0023	3F	17_3	134	13	2	1300	1020	-280	0.15	0.78	2	1	-1
0023	3F	17_3	135	17	2	1700	970	-730	0.12	0.57	3	1	-2
0023	3F	17_3	136	8	1	800	320	-480	0.13	0.40	1	0	-1
0023	3F	17_3	145	6	1	600	390	-210	0.17	0.65	1	0	-1
0023	3F	17_3	146	9	0	900	0	-900	0.00	0.00	1	0	-1
0023	3F	17_3	156	6	1	600	420	-180	0.17	0.70	1	0	-1
0023	3F	17_3	234	1	0	100	0	-100	0.00	0.00	0	0	0
0023	3F	17_3	235	3	1	300	270	-30	0.33	0.90	0	0	0
0023	3F	17_3	236	5	1	500	690	190	0.20	1.38	0	1	1
0023	3F	17_3	245	1	0	100	0	-100	0.00	0.00	0	0	0
0023	3F	17_3	246	2	0	200	0	-200	0.00	0.00	0	0	0
0023	3F	17_3	256	1	0	100	0	-100	0.00	0.00	0	0	0
0023	3F	17_4	123	18	8	1800	1670	-130	0.44	0.93	3	2	-1
0023	3F	17_4	124	57	11	5700	3300	-2400	0.19	0.58	10	5	-5
0023	3F	17_4	125	24	4	2400	1180	-1220	0.17	0.49	4	2	-2
0023	3F	17_4	126	9	0	900	0	-900	0.00	0.00	1	0	-1
0023	3F	17_4	134	37	9	3700	2380	-1320	0.24	0.64	6	4	-2
0023	3F	17_4	135	8	0	800	0	-800	0.00	0.00	1	0	-1
0023	3F	17_4	136	6	0	600	0	-600	0.00	0.00	1	0	-1
0023	3F	17_4	145	3	1	300	490	190	0.33	1.63	0	0	0
0023	3F	17_4	146	6	1	600	560	-40	0.17	0.93	1	0	-1
0023	3F	17_4	156	1	0	100	0	-100	0.00	0.00	0	0	0
0023	3F	17_4	234	2	0	200	0	-200	0.00	0.00	0	0	0
0023	3F	17_4	235	3	1	300	230	-70	0.33	0.77	0	0	0
0023	3F	17_4	236	1	0	100	0	-100	0.00	0.00	0	0	0
0023	3F	17_4	245	1	0	100	0	-100	0.00	0.00	0	0	0
0023	3F	17_4	246	1	0	100	0	-100	0.00	0.00	0	0	0
0023	3F	17_5	123	20	10	2000	1960	-40	0.50	0.98	3	3	0
0023	3F	17_5	124	41	6	4100	1730	-2370	0.15	0.42	7	3	-4
0023	3F	17_5	125	19	4	1900	1170	-730	0.21	0.62	3	2	-1
0023	3F	17_5	126	18	3	1800	7140	5340	0.17	3.97	3	12	9
0023	3F	17_5	134	27	3	2700	710	-1990	0.11	0.26	4	1	-3
0023	3F	17_5	135	15	3	1500	1070	-430	0.20	0.71	2	1	-1
0023	3F	17_5	136	7	0	700	0	-700	0.00	0.00	1	0	-1
0023	3F	17_5	145	2	1	200	420	220	0.50	2.10	0	0	0
0023	3F	17_5	146	1	1	100	330	230	1.00	3.30	0	0	0
0023	3F	17_5	235	1	0	100	0	-100	0.00	0.00	0	0	0
0023	3F	17_5	245	1	0	100	0	-100	0.00	0.00	0	0	0
0023	3F	17_5	256	1	0	100	0	-100	0.00	0.00	0	0	0
0023	3F	17_6	123	16	8	1600	1660	60	0.50	1.04	2	2	0
0023	3F	17_6	124	32	9	3200	2610	-590	0.28	0.82	5	4	-1
0023	3F	17_6	125	38	8	3800	3430	-370	0.21	0.90	6	6	0
0023	3F	17_6	126	17	0	1700	0	-1700	0.00	0.00	3	0	-3
0023	3F	17_6	134	15	4	1500	1130	-370	0.27	0.75	2	2	0
0023	3F	17_6	135	6	0	600	0	-600	0.00	0.00	1	0	-1
0023	3F	17_6	136	10	1	1000	310	-690	0.10	0.31	1	0	-1
0023	3F	17_6	145	5	2	500	1120	620	0.40	2.24	0	1	1
0023	3F	17_6	146	5	1	500	390	-110	0.20	0.78	0	0	0
0023	3F	17_6	156	3	0	300	0	-300	0.00	0.00	0	0	0
0023	3F	17_6	234	1	0	100	0	-100	0.00	0.00	0	0	0
0023	3F	17_6	235	3	0	300	0	-300	0.00	0.00	0	0	0
0023	3F	17_6	236	1	0	100	0	-100	0.00	0.00	0	0	0
0023	3F	17_6	245	2	0	200	0	-200	0.00	0.00	0	0	0
0023	3F	17_6	246	1	0	100	0	-100	0.00	0.00	0	0	0
0023	3F	17_7	123	15	7	1500	1420	-80	0.47	0.95	2	2	0
0023	3F	17_7	124	31	8	3100	1870	-1230	0.26	0.60	5	3	-2
0023	3F	17_7	125	27	6	2700	1570	-1130	0.22	0.58	4	2	-2
0023	3F	17_7	126	27	3	2700	1850	-850	0.11	0.69	4	3	-1
0023	3F	17_7	134	15	4	1500	970	-530	0.27	0.65	2	1	-1
0023	3F	17_7	135	25	3	2500	840	-1660	0.12	0.34	4	1	-3
0023	3F	17_7	136	10	1	1000	440	-560	0.10	0.44	1	0	-1
0023	3F	17_7	145	8	2	800	940	140	0.25	1.18	1	1	0
0023	3F	17_7	146	3	2	300	650	350	0.67	2.17	0	1	1
0023	3F	17_7	234	1	0	100	0	-100	0.00	0.00	0	0	0
0023	3F	17_7	235	1	0	100	0	-100	0.00	0.00	0	0	0
0023	3F	17_7	236	2	0	200	0	-200	0.00	0.00	0	0	0
0023	3F	17_7	245	1	1	100	330	230	1.00	3.30	0	0	0
0023	3F	17_7	246	3	1	300	410	110	0.33	1.37	0	0	0
0023	3F	17_8	123	9	4	900	960	60	0.44	1.07	1	1	0
0023	3F	17_8	124	34	5	3400	1130	-2270	0.15	0.33	6	2	-4
0023	3F	17_8	125	31	5	3100	2660	-440	0.16	0.86	5	4	-1
0023	3F	17_8	126	26	2	2600	1230	-1370	0.08	0.47	4	2	-2
0023	3F	17_8	134	21	7	2100	2220	120	0.33	1.06	3	3	0
0023	3F	17_8	135	23	9	2300	3850	1550	0.39	1.67	4	6	2
0023	3F	17_8	136	6	3	600	1290	690	0.50	2.15	1	2	1
0023	3F	17_8	145	13	2	1300	600	-700	0.15	0.46	2	1	-1
0023	3F	17_8	146	7	1	700	400	-300	0.14	0.57	1	0	-1
0023	3F	17_8	236	1	0	100	0	-100	0.00	0.00	0	0	0
0023	3F	17_8	246	1	0	100	0	-100	0.00	0.00	0	0	0
0023	3F	17_9	123	43	19	4300	5200	900	0.44	1.21	7	9	2
0023	3F	17_9	124	62	14	6200	4530	-1670	0.23	0.73	10	8	-2
0023	3F	17_9	125	14	5	1400	2110	710	0.36	1.51	2	3	1
0023	3F	17_9	126	8	1	800	240	-560	0.13	0.30	1	0	-1
0023	3F	17_9	134	50	11	5000	3600	-1400	0.22	0.72	8	6	-2
0023	3F	17_9	135	11	3	1100	1880	780	0.27	1.71	1	3	2
0023	3F	17_9	136	3	1	300	380	80	0.33	1.27	0	0	0
0023	3F	17_9	145	1	0	100	0	-100	0.00	0.00	0	0	0
0023	3F	17_9	146	1	0	100	0	-100	0.00	0.00	0	0	0
0023	3F	18_1	123	36	9	3600	3360	-240	0.25	0.93	6	5	-1
0023	3F	18_1	124	101	26	10100	8660	-1440	0.26	0.86	17	15	-2
0023	3F	18_1	125	85	12	8500	8010	-490	0.14	0.94	15	14	-1
0023	3F	18_1	126	7	0	700	0	-700	0.00	0.00	1	0	-1
0023	3F	18_1	134	15	3	1500	820	-680	0.20	0.55	2	1	-1
0023	3F	18_1	135	13	3	1300	1360	60	0.23	1.05	2	2	0
0023	3F	18_1	136	2	0	200	0	-200	0.00	0.00	0	0	0
0023	3F	18_1	145	3	0	300	0	-300	0.00	0.00	0	0	0
0023	3F	18_10	123	15	3	1500	570	-930	0.20	0.38	2	1	-1
0023	3F	18_10	124	71	15	7100	4580	-2520	0.21	0.65	12	8	-4
0023	3F	18_10	125	27	8	2700	2740	40	0.30	1.01	4	4	0
0023	3F	18_10	126	14	2	1400	410	-990	0.14	0.29	2	0	-2
0023	3F	18_10	134	13	6	1300	1850	550	0.46	1.42	2	3	1
0023	3F	18_10	135	12	3	1200	1200	0	0.25	1.00	2	2	0
0023	3F	18_10	136	15	2	1500	830	-670	0.13	0.55	2	1	-1
0023	3F	18_10	145	5	0	500	0	-500	0.00	0.00	0	0	0
0023	3F	18_10	146	2	1	200	270	70	0.50	1.35	0	0	0
0023	3F	18_11	123	23	4	2300	900	-1400	0.17	0.39	4	1	-3
0023	3F	18_11	124	79	16	7900	6020	-1880	0.20	0.76	13	10	-3
0023	3F	18_11	125	27	4	2700	890	-1810	0.15	0.33	4	1	-3
0023	3F	18_11	126	15	2	1500	910	-590	0.13	0.61	2	1	-1
0023	3F	18_11	134	22	8	2200	1720	-480	0.36	0.78	3	3	0
0023	3F	18_11	135	37	6	3700	1380	-2320	0.16	0.37	6	2	-4
0023	3F	18_11	136	17	3	1700	950	-750	0.18	0.56	3	1	-2
0023	3F	18_11	145	8	1	800	340	-460	0.13	0.43	1	0	-1
0023	3F	18_11	146	10	2	1000	700	-300	0.20	0.70	1	1	0
0023	3F	18_11	156	1	1	100	750	650	1.00	7.50	0	1	1
0023	3F	18_12	123	24	10	2400	2440	40	0.42	1.02	4	4	0
0023	3F	18_12	124	188	41	18800	15890	-2910	0.22	0.85	33	28	-5
0023	3F	18_12	125	13	2	1300	1210	-90	0.15	0.93	2	2	0
0023	3F	18_12	126	28	2	2800	4340	1540	0.07	1.55	4	7	3
0023	3F	18_12	134	16	6	1600	2290	690	0.38	1.43	2	4	2
0023	3F	18_12	135	7	1	700	220	-480	0.14	0.31	1	0	-1
0023	3F	18_12	136	1	1	100	550	450	1.00	5.50	0	0	0
0023	3F	18_12	145	2	0	200	0	-200	0.00	0.00	0	0	0
0023	3F	18_12	146	1	0	100	0	-100	0.00	0.00	0	0	0
0023	3F	18_2	123	23	5	2300	1980	-320	0.22	0.86	4	3	-1
0023	3F	18_2	124	130	26	13000	9480	-3520	0.20	0.73	23	16	-7
0023	3F	18_2	125	20	5	2000	2260	260	0.25	1.13	3	4	1
0023	3F	18_2	126	5	0	500	0	-500	0.00	0.00	0	0	0
0023	3F	18_2	134	46	4	4600	1330	-3270	0.09	0.29	8	2	-6
0023	3F	18_2	135	7	2	700	1210	510	0.29	1.73	1	2	1
0023	3F	18_2	136	1	0	100	0	-100	0.00	0.00	0	0	0
0023	3F	18_2	145	3	0	300	0	-300	0.00	0.00	0	0	0
0023	3F	18_2	146	2	0	200	0	-200	0.00	0.00	0	0	0
0023	3F	18_3	123	36	10	3600	6060	2460	0.28	1.68	6	10	4
0023	3F	18_3	124	54	11	5400	4970	-430	0.20	0.92	9	8	-1
0023	3F	18_3	125	33	10	3300	6950	3650	0.30	2.11	5	12	7
0023	3F	18_3	126	9	3	900	2290	1390	0.33	2.54	1	4	3
0023	3F	18_3	134	50	12	5000	4200	-800	0.24	0.84	8	7	-1
0023	3F	18_3	135	39	6	3900	1750	-2150	0.15	0.45	6	3	-3
0023	3F	18_3	136	10	2	1000	590	-410	0.20	0.59	1	1	0
0023	3F	18_3	145	10	3	1000	1110	110	0.30	1.11	1	1	0
0023	3F	18_3	146	2	0	200	0	-200	0.00	0.00	0	0	0
0023	3F	18_4	123	101	18	10100	4920	-5180	0.18	0.49	17	8	-9
0023	3F	18_4	124	78	26	7800	6890	-910	0.33	0.88	13	12	-1
0023	3F	18_4	125	80	18	8000	6620	-1380	0.23	0.83	14	11	-3
0023	3F	18_4	126	17	2	1700	570	-1130	0.12	0.34	3	1	-2
0023	3F	18_4	134	2	0	200	0	-200	0.00	0.00	0	0	0
0023	3F	18_4	136	1	0	100	0	-100	0.00	0.00	0	0	0
0023	3F	18_4	145	1	0	100	0	-100	0.00	0.00	0	0	0
0023	3F	18_5	123	30	1	3000	1470	-1530	0.03	0.49	5	2	-3
0023	3F	18_5	124	22	5	2200	2490	290	0.23	1.13	3	4	1
0023	3F	18_5	125	18	4	1800	710	-1090	0.22	0.39	3	1	-2
0023	3F	18_5	126	25	3	2500	1060	-1440	0.12	0.42	4	1	-3
0023	3F	18_5	134	13	6	1300	2540	1240	0.46	1.95	2	4	2
0023	3F	18_5	135	25	6	2500	2400	-100	0.24	0.96	4	4	0
0023	3F	18_5	136	13	2	1300	550	-750	0.15	0.42	2	0	-2
0023	3F	18_5	145	6	1	600	180	-420	0.17	0.30	1	0	-1
0023	3F	18_5	235	3	0	300	0	-300	0.00	0.00	0	0	0
0023	3F	18_5	236	6	0	600	0	-600	0.00	0.00	1	0	-1
0023	3F	18_5	245	6	1	600	520	-80	0.17	0.87	1	0	-1
0023	3F	18_5	246	5	2	500	2130	1630	0.40	4.26	0	3	3
0023	3F	18_6	123	16	2	1600	870	-730	0.13	0.54	2	1	-1
0023	3F	18_6	124	22	3	2200	660	-1540	0.14	0.30	3	1	-2
0023	3F	18_6	125	18	2	1800	700	-1100	0.11	0.39	3	1	-2
0023	3F	18_6	126	22	2	2200	1050	-1150	0.09	0.48	3	1	-2
0023	3F	18_6	134	11	1	1100	460	-640	0.09	0.42	1	0	-1
0023	3F	18_6	135	19	3	1900	1030	-870	0.16	0.54	3	1	-2
0023	3F	18_6	136	26	3	2600	1460	-1140	0.12	0.56	4	2	-2
0023	3F	18_6	145	5	1	500	2970	2470	0.20	5.94	0	5	5
0023	3F	18_6	146	7	1	700	460	-240	0.14	0.66	1	0	-1
0023	3F	18_6	234	2	0	200	0	-200	0.00	0.00	0	0	0
0023	3F	18_6	235	4	2	400	580	180	0.50	1.45	0	1	1
0023	3F	18_6	236	3	0	300	0	-300	0.00	0.00	0	0	0
0023	3F	18_6	246	2	0	200	0	-200	0.00	0.00	0	0	0
0023	3F	18_7	123	38	1	3800	250	-3550	0.03	0.07	6	0	-6
0023	3F	18_7	124	18	5	1800	2070	270	0.28	1.15	3	3	0
0023	3F	18_7	125	45	4	4500	2080	-2420	0.09	0.46	7	3	-4
0023	3F	18_7	126	33	8	3300	3900	600	0.24	1.18	5	6	1
0023	3F	18_7	134	16	3	1600	1360	-240	0.19	0.85	2	2	0
0023	3F	18_7	135	18	2	1800	870	-930	0.11	0.48	3	1	-2
0023	3F	18_7	136	16	2	1600	1050	-550	0.13	0.66	2	1	-1
0023	3F	18_7	145	4	0	400	0	-400	0.00	0.00	0	0	0
0023	3F	18_7	146	1	0	100	0	-100	0.00	0.00	0	0	0
0023	3F	18_7	156	1	0	100	0	-100	0.00	0.00	0	0	0
0023	3F	18_7	234	2	0	200	0	-200	0.00	0.00	0	0	0
0023	3F	18_7	235	2	0	200	0	-200	0.00	0.00	0	0	0
0023	3F	18_7	236	2	1	200	700	500	0.50	3.50	0	1	1
0023	3F	18_8	123	6	0	600	0	-600	0.00	0.00	1	0	-1
0023	3F	18_8	124	24	10	2400	3200	800	0.42	1.33	4	5	1
0023	3F	18_8	125	28	5	2800	2480	-320	0.18	0.89	4	4	0
0023	3F	18_8	126	22	1	2200	240	-1960	0.05	0.11	3	0	-3
0023	3F	18_8	134	11	6	1100	1780	680	0.55	1.62	1	3	2
0023	3F	18_8	135	30	7	3000	2880	-120	0.23	0.96	5	5	0
0023	3F	18_8	136	17	4	1700	1630	-70	0.24	0.96	3	2	-1
0023	3F	18_8	145	7	2	700	540	-160	0.29	0.77	1	0	-1
0023	3F	18_8	146	4	2	400	500	100	0.50	1.25	0	0	0
0023	3F	18_8	235	1	1	100	550	450	1.00	5.50	0	0	0
0023	3F	18_8	236	1	0	100	0	-100	0.00	0.00	0	0	0
0023	3F	18_9	123	8	4	800	1460	660	0.50	1.83	1	2	1
0023	3F	18_9	124	21	6	2100	1810	-290	0.29	0.86	3	3	0
0023	3F	18_9	125	32	5	3200	2150	-1050	0.16	0.67	5	3	-2
0023	3F	18_9	126	27	5	2700	1490	-1210	0.19	0.55	4	2	-2
0023	3F	18_9	134	19	3	1900	1360	-540	0.16	0.72	3	2	-1
0023	3F	18_9	135	33	3	3300	840	-2460	0.09	0.25	5	1	-4
0023	3F	18_9	136	22	1	2200	600	-1600	0.05	0.27	3	1	-2
0023	3F	18_9	145	6	0	600	0	-600	0.00	0.00	1	0	-1
0023	3F	18_9	146	7	2	700	570	-130	0.29	0.81	1	1	0
0023	3F	18_9	236	2	1	200	540	340	0.50	2.70	0	0	0
0023	3F	18_9	245	3	0	300	0	-300	0.00	0.00	0	0	0
0023	3F	18_9	246	1	0	100	0	-100	0.00	0.00	0	0	0
0023	3F	19_1	123	22	5	2200	1860	-340	0.23	0.85	3	3	0
0023	3F	19_1	124	36	7	3600	2220	-1380	0.19	0.62	6	3	-3
0023	3F	19_1	125	29	5	2900	2190	-710	0.17	0.76	5	3	-2
0023	3F	19_1	126	15	1	1500	400	-1100	0.07	0.27	2	0	-2
0023	3F	19_1	134	9	3	900	1360	460	0.33	1.51	1	2	1
0023	3F	19_1	135	6	0	600	0	-600	0.00	0.00	1	0	-1
0023	3F	19_1	136	3	0	300	0	-300	0.00	0.00	0	0	0
0023	3F	19_1	145	3	0	300	0	-300	0.00	0.00	0	0	0
0023	3F	19_1	156	1	0	100	0	-100	0.00	0.00	0	0	0
0023	3F	19_10	123	30	5	3000	2330	-670	0.17	0.78	5	4	-1
0023	3F	19_10	124	95	24	9500	7880	-1620	0.25	0.83	16	13	-3
0023	3F	19_10	125	29	3	2900	1270	-1630	0.10	0.44	5	2	-3
0023	3F	19_10	126	9	0	900	0	-900	0.00	0.00	1	0	-1
0023	3F	19_10	134	31	6	3100	2090	-1010	0.19	0.67	5	3	-2
0023	3F	19_10	135	12	2	1200	540	-660	0.17	0.45	2	0	-2
0023	3F	19_10	136	5	0	500	0	-500	0.00	0.00	0	0	0
0023	3F	19_10	145	1	0	100	0	-100	0.00	0.00	0	0	0
0023	3F	19_10	146	1	0	100	0	-100	0.00	0.00	0	0	0
0023	3F	19_11	123	31	9	3100	3020	-80	0.29	0.97	5	5	0
0023	3F	19_11	124	119	25	11900	8430	-3470	0.21	0.71	21	14	-7
0023	3F	19_11	125	23	3	2300	1730	-570	0.13	0.75	4	3	-1
0023	3F	19_11	126	8	0	800	0	-800	0.00	0.00	1	0	-1
0023	3F	19_11	134	26	4	2600	1440	-1160	0.15	0.55	4	2	-2
0023	3F	19_11	135	19	3	1900	1830	-70	0.16	0.96	3	3	0
0023	3F	19_11	136	3	0	300	0	-300	0.00	0.00	0	0	0
0023	3F	19_11	145	2	0	200	0	-200	0.00	0.00	0	0	0
0023	3F	19_12	123	35	11	3500	4200	700	0.31	1.20	6	7	1
0023	3F	19_12	124	152	20	15200	8010	-7190	0.13	0.53	26	14	-12
0023	3F	19_12	125	14	4	1400	3290	1890	0.29	2.35	2	5	3
0023	3F	19_12	126	6	0	600	0	-600	0.00	0.00	1	0	-1
0023	3F	19_12	134	9	1	900	420	-480	0.11	0.47	1	0	-1
0023	3F	19_12	135	7	1	700	230	-470	0.14	0.33	1	0	-1
0023	3F	19_12	136	2	0	200	0	-200	0.00	0.00	0	0	0
0023	3F	19_12	146	2	0	200	0	-200	0.00	0.00	0	0	0
0023	3F	19_2	123	9	4	900	1170	270	0.44	1.30	1	2	1
0023	3F	19_2	124	23	6	2300	2200	-100	0.26	0.96	4	3	-1
0023	3F	19_2	125	14	1	1400	330	-1070	0.07	0.24	2	0	-2
0023	3F	19_2	126	11	2	1100	880	-220	0.18	0.80	1	1	0
0023	3F	19_2	134	16	1	1600	210	-1390	0.06	0.13	2	0	-2
0023	3F	19_2	135	7	2	700	830	130	0.29	1.19	1	1	0
0023	3F	19_2	136	5	1	500	1170	670	0.20	2.34	0	2	2
0023	3F	19_2	145	4	0	400	0	-400	0.00	0.00	0	0	0
0023	3F	19_2	146	3	0	300	0	-300	0.00	0.00	0	0	0
0023	3F	19_2	235	2	0	200	0	-200	0.00	0.00	0	0	0
0023	3F	19_3	123	12	0	1200	0	-1200	0.00	0.00	2	0	-2
0023	3F	19_3	124	8	1	800	320	-480	0.13	0.40	1	0	-1
0023	3F	19_3	125	16	2	1600	390	-1210	0.13	0.24	2	0	-2
0023	3F	19_3	126	20	2	2000	1650	-350	0.10	0.83	3	2	-1
0023	3F	19_3	134	6	2	600	510	-90	0.33	0.85	1	0	-1
0023	3F	19_3	135	8	2	800	650	-150	0.25	0.81	1	1	0
0023	3F	19_3	136	20	3	2000	970	-1030	0.15	0.49	3	1	-2
0023	3F	19_3	145	2	0	200	0	-200	0.00	0.00	0	0	0
0023	3F	19_3	146	5	1	500	580	80	0.20	1.16	0	1	1
0023	3F	19_3	156	2	0	200	0	-200	0.00	0.00	0	0	0
0023	3F	19_3	235	2	0	200	0	-200	0.00	0.00	0	0	0
0023	3F	19_3	236	2	0	200	0	-200	0.00	0.00	0	0	0
0023	3F	19_3	246	3	1	300	670	370	0.33	2.23	0	1	1
0023	3F	19_4	123	8	2	800	350	-450	0.25	0.44	1	0	-1
0023	3F	19_4	124	9	2	900	440	-460	0.22	0.49	1	0	-1
0023	3F	19_4	125	13	3	1300	1670	370	0.23	1.28	2	2	0
0023	3F	19_4	126	30	5	3000	3360	360	0.17	1.12	5	5	0
0023	3F	19_4	134	8	2	800	600	-200	0.25	0.75	1	1	0
0023	3F	19_4	135	9	0	900	0	-900	0.00	0.00	1	0	-1
0023	3F	19_4	136	25	4	2500	1360	-1140	0.16	0.54	4	2	-2
0023	3F	19_4	146	3	2	300	840	540	0.67	2.80	0	1	1
0023	3F	19_4	156	1	0	100	0	-100	0.00	0.00	0	0	0
0023	3F	19_4	234	1	0	100	0	-100	0.00	0.00	0	0	0
0023	3F	19_4	235	2	0	200	0	-200	0.00	0.00	0	0	0
0023	3F	19_4	236	2	0	200	0	-200	0.00	0.00	0	0	0
0023	3F	19_4	246	2	1	200	750	550	0.50	3.75	0	1	1
0023	3F	19_5	123	5	2	500	1090	590	0.40	2.18	0	1	1
0023	3F	19_5	124	56	24	5600	5430	-170	0.43	0.97	9	9	0
0023	3F	19_5	125	4	0	400	0	-400	0.00	0.00	0	0	0
0023	3F	19_5	126	1	1	100	380	280	1.00	3.80	0	0	0
0023	3F	19_5	134	15	7	1500	2010	510	0.47	1.34	2	3	1
0023	3F	19_5	135	2	0	200	0	-200	0.00	0.00	0	0	0
0023	3F	19_5	136	3	1	300	270	-30	0.33	0.90	0	0	0
0023	3F	19_5	145	7	1	700	380	-320	0.14	0.54	1	0	-1
0023	3F	19_6	123	4	2	400	390	-10	0.50	0.98	0	0	0
0023	3F	19_6	124	22	4	2200	1760	-440	0.18	0.80	3	3	0
0023	3F	19_6	125	9	1	900	280	-620	0.11	0.31	1	0	-1
0023	3F	19_6	126	23	6	2300	2890	590	0.26	1.26	4	5	1
0023	3F	19_6	134	11	3	1100	660	-440	0.27	0.60	1	1	0
0023	3F	19_6	135	10	5	1000	1380	380	0.50	1.38	1	2	1
0023	3F	19_6	136	16	2	1600	680	-920	0.13	0.43	2	1	-1
0023	3F	19_6	145	2	1	200	720	520	0.50	3.60	0	1	1
0023	3F	19_6	146	3	0	300	0	-300	0.00	0.00	0	0	0
0023	3F	19_6	156	1	0	100	0	-100	0.00	0.00	0	0	0
0023	3F	19_6	234	1	0	100	0	-100	0.00	0.00	0	0	0
0023	3F	19_6	235	1	0	100	0	-100	0.00	0.00	0	0	0
0023	3F	19_6	236	5	0	500	0	-500	0.00	0.00	0	0	0
0023	3F	19_6	245	1	0	100	0	-100	0.00	0.00	0	0	0
0023	3F	19_6	246	2	0	200	0	-200	0.00	0.00	0	0	0
0023	3F	19_7	123	9	1	900	270	-630	0.11	0.30	1	0	-1
0023	3F	19_7	124	45	16	4500	3540	-960	0.36	0.79	7	6	-1
0023	3F	19_7	125	9	2	900	1670	770	0.22	1.86	1	2	1
0023	3F	19_7	126	1	0	100	0	-100	0.00	0.00	0	0	0
0023	3F	19_7	134	46	22	4600	4990	390	0.48	1.08	8	8	0
0023	3F	19_7	135	22	6	2200	2580	380	0.27	1.17	3	4	1
0023	3F	19_7	136	23	9	2300	3520	1220	0.39	1.53	4	6	2
0023	3F	19_7	145	18	6	1800	1610	-190	0.33	0.89	3	2	-1
0023	3F	19_7	146	4	1	400	690	290	0.25	1.73	0	1	1
0023	3F	19_7	156	1	0	100	0	-100	0.00	0.00	0	0	0
0023	3F	19_8	123	12	1	1200	220	-980	0.08	0.18	2	0	-2
0023	3F	19_8	124	50	10	5000	2800	-2200	0.20	0.56	8	4	-4
0023	3F	19_8	125	6	3	600	750	150	0.50	1.25	1	1	0
0023	3F	19_8	126	12	1	1200	1400	200	0.08	1.17	2	2	0
0023	3F	19_8	134	23	10	2300	2580	280	0.43	1.12	4	4	0
0023	3F	19_8	135	21	5	2100	1140	-960	0.24	0.54	3	2	-1
0023	3F	19_8	136	33	7	3300	2400	-900	0.21	0.73	5	4	-1
0023	3F	19_8	145	5	1	500	320	-180	0.20	0.64	0	0	0
0023	3F	19_8	146	5	0	500	0	-500	0.00	0.00	0	0	0
0023	3F	19_9	123	29	4	2900	1020	-1880	0.14	0.35	5	1	-4
0023	3F	19_9	124	70	17	7000	4630	-2370	0.24	0.66	12	8	-4
0023	3F	19_9	125	13	1	1300	190	-1110	0.08	0.15	2	0	-2
0023	3F	19_9	126	10	2	1000	760	-240	0.20	0.76	1	1	0
0023	3F	19_9	134	20	3	2000	1110	-890	0.15	0.56	3	1	-2
0023	3F	19_9	135	20	4	2000	950	-1050	0.20	0.48	3	1	-2
0023	3F	19_9	136	10	1	1000	320	-680	0.10	0.32	1	0	-1
0023	3F	19_9	145	4	1	400	220	-180	0.25	0.55	0	0	0
0023	3F	19_9	146	2	0	200	0	-200	0.00	0.00	0	0	0
0023	3F	20_1	123	56	12	5600	3780	-1820	0.21	0.68	9	6	-3
0023	3F	20_1	124	42	8	4200	3040	-1160	0.19	0.72	7	5	-2
0023	3F	20_1	125	16	3	1600	1390	-210	0.19	0.87	2	2	0
0023	3F	20_1	126	16	6	1600	3880	2280	0.38	2.43	2	6	4
0023	3F	20_1	134	9	1	900	1250	350	0.11	1.39	1	2	1
0023	3F	20_1	135	7	1	700	1000	300	0.14	1.43	1	1	0
0023	3F	20_1	136	8	1	800	810	10	0.13	1.01	1	1	0
0023	3F	20_1	146	5	1	500	2010	1510	0.20	4.02	0	3	3
0023	3F	20_1	156	2	1	200	120	-80	0.50	0.60	0	0	0
0023	3F	20_10	123	19	4	1900	1200	-700	0.21	0.63	3	2	-1
0023	3F	20_10	124	77	16	7700	5740	-1960	0.21	0.75	13	10	-3
0023	3F	20_10	125	40	6	4000	2000	-2000	0.15	0.50	7	3	-4
0023	3F	20_10	126	20	0	2000	0	-2000	0.00	0.00	3	0	-3
0023	3F	20_10	134	31	5	3100	1600	-1500	0.16	0.52	5	2	-3
0023	3F	20_10	135	20	7	2000	2660	660	0.35	1.33	3	4	1
0023	3F	20_10	136	11	1	1100	570	-530	0.09	0.52	1	1	0
0023	3F	20_10	145	3	1	300	320	20	0.33	1.07	0	0	0
0023	3F	20_10	146	2	0	200	0	-200	0.00	0.00	0	0	0
0023	3F	20_11	123	33	11	3300	3180	-120	0.33	0.96	5	5	0
0023	3F	20_11	124	95	16	9500	5650	-3850	0.17	0.59	16	10	-6
0023	3F	20_11	125	33	4	3300	1750	-1550	0.12	0.53	5	3	-2
0023	3F	20_11	126	19	2	1900	740	-1160	0.11	0.39	3	1	-2
0023	3F	20_11	134	27	5	2700	1680	-1020	0.19	0.62	4	2	-2
0023	3F	20_11	135	20	8	2000	3090	1090	0.40	1.55	3	5	2
0023	3F	20_11	136	9	0	900	0	-900	0.00	0.00	1	0	-1
0023	3F	20_11	145	2	1	200	350	150	0.50	1.75	0	0	0
0023	3F	20_11	146	1	0	100	0	-100	0.00	0.00	0	0	0
0023	3F	20_12	123	46	14	4600	5540	940	0.30	1.20	8	9	1
0023	3F	20_12	124	126	15	12600	5550	-7050	0.12	0.44	22	9	-13
0023	3F	20_12	125	22	4	2200	1810	-390	0.18	0.82	3	3	0
0023	3F	20_12	126	10	0	1000	0	-1000	0.00	0.00	1	0	-1
0023	3F	20_12	134	15	5	1500	1640	140	0.33	1.09	2	2	0
0023	3F	20_12	135	10	1	1000	530	-470	0.10	0.53	1	0	-1
0023	3F	20_12	136	5	1	500	500	0	0.20	1.00	0	0	0
0023	3F	20_12	145	1	0	100	0	-100	0.00	0.00	0	0	0
0023	3F	20_12	146	1	0	100	0	-100	0.00	0.00	0	0	0
0023	3F	20_12	156	1	0	100	0	-100	0.00	0.00	0	0	0
0023	3F	20_2	123	15	1	1500	420	-1080	0.07	0.28	2	0	-2
0023	3F	20_2	124	26	9	2600	3920	1320	0.35	1.51	4	6	2
0023	3F	20_2	125	20	4	2000	1410	-590	0.20	0.71	3	2	-1
0023	3F	20_2	126	17	0	1700	0	-1700	0.00	0.00	3	0	-3
0023	3F	20_2	134	13	3	1300	870	-430	0.23	0.67	2	1	-1
0023	3F	20_2	135	7	1	700	870	170	0.14	1.24	1	1	0
0023	3F	20_2	136	5	1	500	350	-150	0.20	0.70	0	0	0
0023	3F	20_2	145	6	0	600	0	-600	0.00	0.00	1	0	-1
0023	3F	20_2	146	1	1	100	350	250	1.00	3.50	0	0	0
0023	3F	20_2	156	3	1	300	440	140	0.33	1.47	0	0	0
0023	3F	20_2	235	1	0	100	0	-100	0.00	0.00	0	0	0
0023	3F	20_2	236	2	1	200	850	650	0.50	4.25	0	1	1
0023	3F	20_2	246	1	0	100	0	-100	0.00	0.00	0	0	0
0023	3F	20_3	123	6	1	600	390	-210	0.17	0.65	1	0	-1
0023	3F	20_3	124	19	5	1900	1430	-470	0.26	0.75	3	2	-1
0023	3F	20_3	125	17	2	1700	470	-1230	0.12	0.28	3	0	-3
0023	3F	20_3	126	27	4	2700	2380	-320	0.15	0.88	4	4	0
0023	3F	20_3	134	8	2	800	720	-80	0.25	0.90	1	1	0
0023	3F	20_3	135	11	1	1100	360	-740	0.09	0.33	1	0	-1
0023	3F	20_3	136	7	2	700	700	0	0.29	1.00	1	1	0
0023	3F	20_3	145	6	2	600	1130	530	0.33	1.88	1	2	1
0023	3F	20_3	146	4	1	400	510	110	0.25	1.28	0	0	0
0023	3F	20_3	156	3	1	300	370	70	0.33	1.23	0	0	0
0023	3F	20_3	234	2	1	200	610	410	0.50	3.05	0	1	1
0023	3F	20_3	246	1	0	100	0	-100	0.00	0.00	0	0	0
0023	3F	20_4	123	4	0	400	0	-400	0.00	0.00	0	0	0
0023	3F	20_4	124	18	2	1800	460	-1340	0.11	0.26	3	0	-3
0023	3F	20_4	125	16	1	1600	170	-1430	0.06	0.11	2	0	-2
0023	3F	20_4	126	19	3	1900	2920	1020	0.16	1.54	3	5	2
0023	3F	20_4	134	11	3	1100	770	-330	0.27	0.70	1	1	0
0023	3F	20_4	135	13	0	1300	0	-1300	0.00	0.00	2	0	-2
0023	3F	20_4	136	19	0	1900	0	-1900	0.00	0.00	3	0	-3
0023	3F	20_4	145	4	0	400	0	-400	0.00	0.00	0	0	0
0023	3F	20_4	146	10	0	1000	0	-1000	0.00	0.00	1	0	-1
0023	3F	20_4	156	4	0	400	0	-400	0.00	0.00	0	0	0
0023	3F	20_4	234	1	0	100	0	-100	0.00	0.00	0	0	0
0023	3F	20_4	236	1	0	100	0	-100	0.00	0.00	0	0	0
0023	3F	20_4	245	4	2	400	570	170	0.50	1.43	0	1	1
0023	3F	20_5	123	9	2	900	500	-400	0.22	0.56	1	0	-1
0023	3F	20_5	124	201	73	20100	13550	-6550	0.36	0.67	35	23	-12
0023	3F	20_5	125	14	2	1400	930	-470	0.14	0.66	2	1	-1
0023	3F	20_5	126	4	1	400	630	230	0.25	1.58	0	1	1
0023	3F	20_5	135	1	0	100	0	-100	0.00	0.00	0	0	0
0023	3F	20_5	145	1	0	100	0	-100	0.00	0.00	0	0	0
0023	3F	20_6	123	5	3	500	830	330	0.60	1.66	0	1	1
0023	3F	20_6	124	26	10	2600	3130	530	0.38	1.20	4	5	1
0023	3F	20_6	125	37	9	3700	2650	-1050	0.24	0.72	6	4	-2
0023	3F	20_6	126	14	5	1400	1750	350	0.36	1.25	2	3	1
0023	3F	20_6	134	25	5	2500	1730	-770	0.20	0.69	4	3	-1
0023	3F	20_6	135	42	8	4200	2320	-1880	0.19	0.55	7	4	-3
0023	3F	20_6	136	10	2	1000	530	-470	0.20	0.53	1	0	-1
0023	3F	20_6	145	19	4	1900	1590	-310	0.21	0.84	3	2	-1
0023	3F	20_6	146	9	1	900	310	-590	0.11	0.34	1	0	-1
0023	3F	20_6	156	5	0	500	0	-500	0.00	0.00	0	0	0
0023	3F	20_7	123	5	1	500	410	-90	0.20	0.82	0	0	0
0023	3F	20_7	124	38	10	3800	2700	-1100	0.26	0.71	6	4	-2
0023	3F	20_7	125	40	6	4000	1580	-2420	0.15	0.40	7	2	-5
0023	3F	20_7	126	23	6	2300	2040	-260	0.26	0.89	4	3	-1
0023	3F	20_7	134	24	9	2400	2600	200	0.38	1.08	4	4	0
0023	3F	20_7	135	33	10	3300	5180	1880	0.30	1.57	5	9	4
0023	3F	20_7	136	7	1	700	310	-390	0.14	0.44	1	0	-1
0023	3F	20_7	145	26	5	2600	2380	-220	0.19	0.92	4	4	0
0023	3F	20_7	146	18	3	1800	1190	-610	0.17	0.66	3	2	-1
0023	3F	20_7	156	2	0	200	0	-200	0.00	0.00	0	0	0
0023	3F	20_8	123	96	36	9600	6970	-2630	0.38	0.73	16	12	-4
0023	3F	20_8	124	53	11	5300	5980	680	0.21	1.13	9	10	1
0023	3F	20_8	125	10	2	1000	900	-100	0.20	0.90	1	1	0
0023	3F	20_8	126	5	1	500	2580	2080	0.20	5.16	0	4	4
0023	3F	20_8	134	28	6	2800	2490	-310	0.21	0.89	4	4	0
0023	3F	20_8	135	7	3	700	1730	1030	0.43	2.47	1	3	2
0023	3F	20_8	136	1	0	100	0	-100	0.00	0.00	0	0	0
0023	3F	20_8	146	1	0	100	0	-100	0.00	0.00	0	0	0
0023	3F	20_9	123	19	5	1900	2200	300	0.26	1.16	3	3	0
0023	3F	20_9	124	47	6	4700	2090	-2610	0.13	0.44	8	3	-5
0023	3F	20_9	125	24	6	2400	4110	1710	0.25	1.71	4	7	3
0023	3F	20_9	126	15	1	1500	850	-650	0.07	0.57	2	1	-1
0023	3F	20_9	134	30	6	3000	1610	-1390	0.20	0.54	5	2	-3
0023	3F	20_9	135	32	10	3200	3130	-70	0.31	0.98	5	5	0
0023	3F	20_9	136	15	4	1500	1110	-390	0.27	0.74	2	1	-1
0023	3F	20_9	145	10	0	1000	0	-1000	0.00	0.00	1	0	-1
0023	3F	20_9	146	6	1	600	370	-230	0.17	0.62	1	0	-1
0023	3F	20_9	156	1	0	100	0	-100	0.00	0.00	0	0	0
0023	3F	21_1	123	35	10	3500	3270	-230	0.29	0.93	6	5	-1
0023	3F	21_1	124	70	16	7000	6020	-980	0.23	0.86	12	10	-2
0023	3F	21_1	125	27	5	2700	2190	-510	0.19	0.81	4	3	-1
0023	3F	21_1	126	13	2	1300	780	-520	0.15	0.60	2	1	-1
0023	3F	21_1	134	36	8	3600	2480	-1120	0.22	0.69	6	4	-2
0023	3F	21_1	135	11	2	1100	460	-640	0.18	0.42	1	0	-1
0023	3F	21_1	136	5	1	500	190	-310	0.20	0.38	0	0	0
0023	3F	21_1	145	1	0	100	0	-100	0.00	0.00	0	0	0
0023	3F	21_1	156	2	1	200	800	600	0.50	4.00	0	1	1
0023	3F	21_10	123	22	8	2200	2860	660	0.36	1.30	3	5	2
0023	3F	21_10	124	89	18	8900	6440	-2460	0.20	0.72	15	11	-4
0023	3F	21_10	125	20	4	2000	2120	120	0.20	1.06	3	3	0
0023	3F	21_10	126	24	4	2400	1690	-710	0.17	0.70	4	2	-2
0023	3F	21_10	134	27	4	2700	1050	-1650	0.15	0.39	4	1	-3
0023	3F	21_10	135	26	9	2600	3290	690	0.35	1.27	4	5	1
0023	3F	21_10	136	9	2	900	1420	520	0.22	1.58	1	2	1
0023	3F	21_10	145	2	1	200	340	140	0.50	1.70	0	0	0
0023	3F	21_10	146	6	1	600	510	-90	0.17	0.85	1	0	-1
0023	3F	21_11	123	23	5	2300	1200	-1100	0.22	0.52	4	2	-2
0023	3F	21_11	124	126	20	12600	6290	-6310	0.16	0.50	22	11	-11
0023	3F	21_11	125	29	6	2900	3280	380	0.21	1.13	5	5	0
0023	3F	21_11	126	13	1	1300	2010	710	0.08	1.55	2	3	1
0023	3F	21_11	134	30	2	3000	580	-2420	0.07	0.19	5	1	-4
0023	3F	21_11	135	12	2	1200	1150	-50	0.17	0.96	2	2	0
0023	3F	21_11	136	11	2	1100	2740	1640	0.18	2.49	1	4	3
0023	3F	21_11	145	2	1	200	500	300	0.50	2.50	0	0	0
0023	3F	21_11	146	2	0	200	0	-200	0.00	0.00	0	0	0
0023	3F	21_11	234	1	0	100	0	-100	0.00	0.00	0	0	0
0023	3F	21_12	123	18	6	1800	1560	-240	0.33	0.87	3	2	-1
0023	3F	21_12	124	192	31	19200	13140	-6060	0.16	0.68	33	23	-10
0023	3F	21_12	125	11	2	1100	940	-160	0.18	0.85	1	1	0
0023	3F	21_12	126	5	2	500	2070	1570	0.40	4.14	0	3	3
0023	3F	21_12	134	19	3	1900	1300	-600	0.16	0.68	3	2	-1
0023	3F	21_12	135	7	1	700	450	-250	0.14	0.64	1	0	-1
0023	3F	21_12	136	6	2	600	1830	1230	0.33	3.05	1	3	2
0023	3F	21_12	145	1	0	100	0	-100	0.00	0.00	0	0	0
0023	3F	21_2	123	1	0	100	0	-100	0.00	0.00	0	0	0
0023	3F	21_2	124	59	16	5900	3740	-2160	0.27	0.63	10	6	-4
0023	3F	21_2	125	6	0	600	0	-600	0.00	0.00	1	0	-1
0023	3F	21_2	126	3	0	300	0	-300	0.00	0.00	0	0	0
0023	3F	21_2	134	21	7	2100	2010	-90	0.33	0.96	3	3	0
0023	3F	21_2	136	3	0	300	0	-300	0.00	0.00	0	0	0
0023	3F	21_2	145	6	1	600	230	-370	0.17	0.38	1	0	-1
0023	3F	21_2	146	11	2	1100	820	-280	0.18	0.75	1	1	0
0023	3F	21_3	124	3	1	300	430	130	0.33	1.43	0	0	0
0023	3F	21_3	125	17	3	1700	1390	-310	0.18	0.82	3	2	-1
0023	3F	21_3	134	18	1	1800	350	-1450	0.06	0.19	3	0	-3
0023	3F	21_3	135	173	47	17300	10900	-6400	0.27	0.63	30	19	-11
0023	3F	21_3	136	2	0	200	0	-200	0.00	0.00	0	0	0
0023	3F	21_4	123	19	6	1900	1950	50	0.32	1.03	3	3	0
0023	3F	21_4	124	103	29	10300	8650	-1650	0.28	0.84	18	15	-3
0023	3F	21_4	125	20	1	2000	260	-1740	0.05	0.13	3	0	-3
0023	3F	21_4	134	65	18	6500	4190	-2310	0.28	0.64	11	7	-4
0023	3F	21_4	135	35	11	3500	4660	1160	0.31	1.33	6	8	2
0023	3F	21_4	136	2	0	200	0	-200	0.00	0.00	0	0	0
0023	3F	21_4	145	4	0	400	0	-400	0.00	0.00	0	0	0
0023	3F	21_4	156	1	0	100	0	-100	0.00	0.00	0	0	0
0023	3F	21_5	123	41	11	4100	4170	70	0.27	1.02	7	7	0
0023	3F	21_5	124	66	7	6600	2650	-3950	0.11	0.40	11	4	-7
0023	3F	21_5	125	79	26	7900	5740	-2160	0.33	0.73	13	10	-3
0023	3F	21_5	126	34	7	3400	1940	-1460	0.21	0.57	6	3	-3
0023	3F	21_5	134	1	0	100	0	-100	0.00	0.00	0	0	0
0023	3F	21_5	135	2	0	200	0	-200	0.00	0.00	0	0	0
0023	3F	21_5	136	1	0	100	0	-100	0.00	0.00	0	0	0
0023	3F	21_5	235	1	0	100	0	-100	0.00	0.00	0	0	0
0023	3F	21_6	123	12	5	1200	1500	300	0.42	1.25	2	2	0
0023	3F	21_6	124	46	4	4600	1250	-3350	0.09	0.27	8	2	-6
0023	3F	21_6	125	22	3	2200	2360	160	0.14	1.07	3	4	1
0023	3F	21_6	126	26	3	2600	2970	370	0.12	1.14	4	5	1
0023	3F	21_6	134	13	0	1300	0	-1300	0.00	0.00	2	0	-2
0023	3F	21_6	135	5	4	500	1560	1060	0.80	3.12	0	2	2
0023	3F	21_6	136	12	0	1200	0	-1200	0.00	0.00	2	0	-2
0023	3F	21_6	145	2	0	200	0	-200	0.00	0.00	0	0	0
0023	3F	21_6	146	2	0	200	0	-200	0.00	0.00	0	0	0
0023	3F	21_6	234	1	0	100	0	-100	0.00	0.00	0	0	0
0023	3F	21_6	236	1	0	100	0	-100	0.00	0.00	0	0	0
0023	3F	21_6	246	5	0	500	0	-500	0.00	0.00	0	0	0
0023	3F	21_7	123	40	13	4000	4450	450	0.33	1.11	7	7	0
0023	3F	21_7	124	56	11	5600	3600	-2000	0.20	0.64	9	6	-3
0023	3F	21_7	125	31	4	3100	1430	-1670	0.13	0.46	5	2	-3
0023	3F	21_7	126	11	1	1100	380	-720	0.09	0.35	1	0	-1
0023	3F	21_7	134	23	2	2300	510	-1790	0.09	0.22	4	0	-4
0023	3F	21_7	135	19	3	1900	1490	-410	0.16	0.78	3	2	-1
0023	3F	21_7	136	3	0	300	0	-300	0.00	0.00	0	0	0
0023	3F	21_7	145	9	2	900	1100	200	0.22	1.22	1	1	0
0023	3F	21_7	146	2	0	200	0	-200	0.00	0.00	0	0	0
0023	3F	21_7	234	1	0	100	0	-100	0.00	0.00	0	0	0
0023	3F	21_8	123	12	4	1200	940	-260	0.33	0.78	2	1	-1
0023	3F	21_8	124	37	12	3700	4280	580	0.32	1.16	6	7	1
0023	3F	21_8	125	32	7	3200	3770	570	0.22	1.18	5	6	1
0023	3F	21_8	126	19	3	1900	850	-1050	0.16	0.45	3	1	-2
0023	3F	21_8	134	27	6	2700	1670	-1030	0.22	0.62	4	2	-2
0023	3F	21_8	135	24	3	2400	880	-1520	0.13	0.37	4	1	-3
0023	3F	21_8	136	16	3	1600	1080	-520	0.19	0.68	2	1	-1
0023	3F	21_8	145	12	1	1200	350	-850	0.08	0.29	2	0	-2
0023	3F	21_8	146	5	0	500	0	-500	0.00	0.00	0	0	0
0023	3F	21_8	156	1	0	100	0	-100	0.00	0.00	0	0	0
0023	3F	21_9	123	14	5	1400	1150	-250	0.36	0.82	2	2	0
0023	3F	21_9	124	31	7	3100	2030	-1070	0.23	0.65	5	3	-2
0023	3F	21_9	125	31	7	3100	2470	-630	0.23	0.80	5	4	-1
0023	3F	21_9	126	29	4	2900	1880	-1020	0.14	0.65	5	3	-2
0023	3F	21_9	134	11	4	1100	1260	160	0.36	1.15	1	2	1
0023	3F	21_9	135	17	2	1700	730	-970	0.12	0.43	3	1	-2
0023	3F	21_9	136	8	2	800	820	20	0.25	1.03	1	1	0
0023	3F	21_9	145	8	2	800	810	10	0.25	1.01	1	1	0
0023	3F	21_9	146	3	0	300	0	-300	0.00	0.00	0	0	0
0023	3F	21_9	156	1	0	100	0	-100	0.00	0.00	0	0	0
0023	3F	21_9	234	1	0	100	0	-100	0.00	0.00	0	0	0
0023	3F	22_1	123	29	6	2900	1240	-1660	0.21	0.43	5	2	-3
0023	3F	22_1	124	37	6	3700	1790	-1910	0.16	0.48	6	3	-3
0023	3F	22_1	125	17	3	1700	1540	-160	0.18	0.91	3	2	-1
0023	3F	22_1	126	5	0	500	0	-500	0.00	0.00	0	0	0
0023	3F	22_1	134	10	3	1000	1340	340	0.30	1.34	1	2	1
0023	3F	22_1	135	9	1	900	340	-560	0.11	0.38	1	0	-1
0023	3F	22_1	136	2	0	200	0	-200	0.00	0.00	0	0	0
0023	3F	22_1	145	1	1	100	200	100	1.00	2.00	0	0	0
0023	3F	22_10	123	28	12	2800	3590	790	0.43	1.28	4	6	2
0023	3F	22_10	124	60	16	6000	5930	-70	0.27	0.99	10	10	0
0023	3F	22_10	125	32	7	3200	3440	240	0.22	1.08	5	6	1
0023	3F	22_10	126	14	1	1400	230	-1170	0.07	0.16	2	0	-2
0023	3F	22_10	134	21	2	2100	1080	-1020	0.10	0.51	3	1	-2
0023	3F	22_10	135	24	4	2400	1480	-920	0.17	0.62	4	2	-2
0023	3F	22_10	136	5	0	500	0	-500	0.00	0.00	0	0	0
0023	3F	22_10	145	6	0	600	0	-600	0.00	0.00	1	0	-1
0023	3F	22_10	146	4	0	400	0	-400	0.00	0.00	0	0	0
0023	3F	22_10	156	1	0	100	0	-100	0.00	0.00	0	0	0
0023	3F	22_11	123	30	10	3000	3310	310	0.33	1.10	5	5	0
0023	3F	22_11	124	79	14	7900	4650	-3250	0.18	0.59	13	8	-5
0023	3F	22_11	125	31	5	3100	3210	110	0.16	1.04	5	5	0
0023	3F	22_11	126	10	0	1000	0	-1000	0.00	0.00	1	0	-1
0023	3F	22_11	134	23	0	2300	0	-2300	0.00	0.00	4	0	-4
0023	3F	22_11	135	25	8	2500	4270	1770	0.32	1.71	4	7	3
0023	3F	22_11	136	2	0	200	0	-200	0.00	0.00	0	0	0
0023	3F	22_11	145	5	0	500	0	-500	0.00	0.00	0	0	0
0023	3F	22_11	146	2	0	200	0	-200	0.00	0.00	0	0	0
0023	3F	22_12	123	2	1	200	180	-20	0.50	0.90	0	0	0
0023	3F	22_12	124	73	15	7300	6920	-380	0.21	0.95	12	12	0
0023	3F	22_12	125	96	10	9600	7050	-2550	0.10	0.73	16	12	-4
0023	3F	22_12	126	4	0	400	0	-400	0.00	0.00	0	0	0
0023	3F	22_12	134	25	4	2500	2090	-410	0.16	0.84	4	3	-1
0023	3F	22_12	135	21	4	2100	2570	470	0.19	1.22	3	4	1
0023	3F	22_12	136	2	1	200	530	330	0.50	2.65	0	0	0
0023	3F	22_12	145	5	0	500	0	-500	0.00	0.00	0	0	0
0023	3F	22_2	123	15	4	1500	970	-530	0.27	0.65	2	1	-1
0023	3F	22_2	124	22	6	2200	1370	-830	0.27	0.62	3	2	-1
0023	3F	22_2	125	8	2	800	660	-140	0.25	0.83	1	1	0
0023	3F	22_2	126	17	3	1700	3810	2110	0.18	2.24	3	6	3
0023	3F	22_2	134	14	4	1400	1200	-200	0.29	0.86	2	2	0
0023	3F	22_2	135	8	0	800	0	-800	0.00	0.00	1	0	-1
0023	3F	22_2	136	13	0	1300	0	-1300	0.00	0.00	2	0	-2
0023	3F	22_2	145	4	0	400	0	-400	0.00	0.00	0	0	0
0023	3F	22_2	146	1	1	100	510	410	1.00	5.10	0	0	0
0023	3F	22_2	156	2	0	200	0	-200	0.00	0.00	0	0	0
0023	3F	22_2	234	1	1	100	390	290	1.00	3.90	0	0	0
0023	3F	22_3	123	14	4	1400	850	-550	0.29	0.61	2	1	-1
0023	3F	22_3	124	24	7	2400	2580	180	0.29	1.08	4	4	0
0023	3F	22_3	125	13	6	1300	2520	1220	0.46	1.94	2	4	2
0023	3F	22_3	126	16	2	1600	540	-1060	0.13	0.34	2	0	-2
0023	3F	22_3	134	9	2	900	510	-390	0.22	0.57	1	0	-1
0023	3F	22_3	135	18	0	1800	0	-1800	0.00	0.00	3	0	-3
0023	3F	22_3	136	9	0	900	0	-900	0.00	0.00	1	0	-1
0023	3F	22_3	145	7	0	700	0	-700	0.00	0.00	1	0	-1
0023	3F	22_3	146	2	1	200	1890	1690	0.50	9.45	0	3	3
0023	3F	22_3	235	1	0	100	0	-100	0.00	0.00	0	0	0
0023	3F	22_3	245	1	0	100	0	-100	0.00	0.00	0	0	0
0023	3F	22_3	246	2	0	200	0	-200	0.00	0.00	0	0	0
0023	3F	22_4	123	13	4	1300	990	-310	0.31	0.76	2	1	-1
0023	3F	22_4	124	28	9	2800	2910	110	0.32	1.04	4	5	1
0023	3F	22_4	125	14	3	1400	750	-650	0.21	0.54	2	1	-1
0023	3F	22_4	126	16	3	1600	1390	-210	0.19	0.87	2	2	0
0023	3F	22_4	134	10	3	1000	1030	30	0.30	1.03	1	1	0
0023	3F	22_4	135	14	4	1400	1130	-270	0.29	0.81	2	2	0
0023	3F	22_4	136	14	0	1400	0	-1400	0.00	0.00	2	0	-2
0023	3F	22_4	145	7	0	700	0	-700	0.00	0.00	1	0	-1
0023	3F	22_4	146	6	1	600	930	330	0.17	1.55	1	1	0
0023	3F	22_4	156	2	0	200	0	-200	0.00	0.00	0	0	0
0023	3F	22_4	234	1	0	100	0	-100	0.00	0.00	0	0	0
0023	3F	22_4	245	1	0	100	0	-100	0.00	0.00	0	0	0
0023	3F	22_5	123	18	4	1800	930	-870	0.22	0.52	3	1	-2
0023	3F	22_5	124	24	7	2400	1990	-410	0.29	0.83	4	3	-1
0023	3F	22_5	125	10	0	1000	0	-1000	0.00	0.00	1	0	-1
0023	3F	22_5	126	13	3	1300	3050	1750	0.23	2.35	2	5	3
0023	3F	22_5	134	12	1	1200	110	-1090	0.08	0.09	2	0	-2
0023	3F	22_5	135	16	2	1600	880	-720	0.13	0.55	2	1	-1
0023	3F	22_5	136	15	3	1500	1220	-280	0.20	0.81	2	2	0
0023	3F	22_5	145	4	0	400	0	-400	0.00	0.00	0	0	0
0023	3F	22_5	146	6	1	600	180	-420	0.17	0.30	1	0	-1
0023	3F	22_5	156	2	1	200	1150	950	0.50	5.75	0	2	2
0023	3F	22_5	234	1	1	100	170	70	1.00	1.70	0	0	0
0023	3F	22_5	236	4	1	400	230	-170	0.25	0.58	0	0	0
0023	3F	22_5	245	1	1	100	380	280	1.00	3.80	0	0	0
0023	3F	22_6	123	13	4	1300	830	-470	0.31	0.64	2	1	-1
0023	3F	22_6	124	28	9	2800	2570	-230	0.32	0.92	4	4	0
0023	3F	22_6	125	13	6	1300	1870	570	0.46	1.44	2	3	1
0023	3F	22_6	126	17	3	1700	1110	-590	0.18	0.65	3	1	-2
0023	3F	22_6	134	13	2	1300	470	-830	0.15	0.36	2	0	-2
0023	3F	22_6	135	11	3	1100	1220	120	0.27	1.11	1	2	1
0023	3F	22_6	136	9	2	900	550	-350	0.22	0.61	1	0	-1
0023	3F	22_6	145	9	1	900	300	-600	0.11	0.33	1	0	-1
0023	3F	22_6	146	4	0	400	0	-400	0.00	0.00	0	0	0
0023	3F	22_6	156	4	1	400	420	20	0.25	1.05	0	0	0
0023	3F	22_6	234	1	0	100	0	-100	0.00	0.00	0	0	0
0023	3F	22_6	236	1	0	100	0	-100	0.00	0.00	0	0	0
0023	3F	22_6	245	2	2	200	480	280	1.00	2.40	0	0	0
0023	3F	22_7	123	18	6	1800	1700	-100	0.33	0.94	3	3	0
0023	3F	22_7	124	30	9	3000	2460	-540	0.30	0.82	5	4	-1
0023	3F	22_7	125	25	7	2500	2730	230	0.28	1.09	4	4	0
0023	3F	22_7	126	12	3	1200	1580	380	0.25	1.32	2	2	0
0023	3F	22_7	134	17	5	1700	1630	-70	0.29	0.96	3	2	-1
0023	3F	22_7	135	10	2	1000	740	-260	0.20	0.74	1	1	0
0023	3F	22_7	136	6	0	600	0	-600	0.00	0.00	1	0	-1
0023	3F	22_7	145	3	0	300	0	-300	0.00	0.00	0	0	0
0023	3F	22_7	146	3	0	300	0	-300	0.00	0.00	0	0	0
0023	3F	22_7	156	3	0	300	0	-300	0.00	0.00	0	0	0
0023	3F	22_7	246	1	0	100	0	-100	0.00	0.00	0	0	0
0023	3F	22_7	256	1	0	100	0	-100	0.00	0.00	0	0	0
0023	3F	22_8	123	11	5	1100	1440	340	0.45	1.31	1	2	1
0023	3F	22_8	124	65	12	6500	3270	-3230	0.18	0.50	11	5	-6
0023	3F	22_8	125	3	1	300	220	-80	0.33	0.73	0	0	0
0023	3F	22_8	134	16	7	1600	1630	30	0.44	1.02	2	2	0
0023	3F	22_8	135	3	1	300	290	-10	0.33	0.97	0	0	0
0023	3F	22_8	136	2	0	200	0	-200	0.00	0.00	0	0	0
0023	3F	22_8	145	4	2	400	750	350	0.50	1.88	0	1	1
0023	3F	22_9	123	24	10	2400	3090	690	0.42	1.29	4	5	1
0023	3F	22_9	124	29	5	2900	1910	-990	0.17	0.66	5	3	-2
0023	3F	22_9	125	27	7	2700	2740	40	0.26	1.01	4	4	0
0023	3F	22_9	126	23	4	2300	4180	1880	0.17	1.82	4	7	3
0023	3F	22_9	134	16	2	1600	620	-980	0.13	0.39	2	1	-1
0023	3F	22_9	135	8	2	800	790	-10	0.25	0.99	1	1	0
0023	3F	22_9	136	12	1	1200	360	-840	0.08	0.30	2	0	-2
0023	3F	22_9	145	6	2	600	650	50	0.33	1.08	1	1	0
0023	3F	22_9	146	2	0	200	0	-200	0.00	0.00	0	0	0
0023	3F	22_9	234	2	2	200	590	390	1.00	2.95	0	1	1
0023	3F	23_1	123	48	19	4800	6420	1620	0.40	1.34	8	11	3
0023	3F	23_1	124	49	10	4900	2830	-2070	0.20	0.58	8	5	-3
0023	3F	23_1	125	11	1	1100	340	-760	0.09	0.31	1	0	-1
0023	3F	23_1	126	3	1	300	340	40	0.33	1.13	0	0	0
0023	3F	23_1	134	7	0	700	0	-700	0.00	0.00	1	0	-1
0023	3F	23_1	135	6	4	600	1430	830	0.67	2.38	1	2	1
0023	3F	23_1	136	4	0	400	0	-400	0.00	0.00	0	0	0
0023	3F	23_1	146	1	1	100	380	280	1.00	3.80	0	0	0
0023	3F	23_10	123	18	4	1800	1020	-780	0.22	0.57	3	1	-2
0023	3F	23_10	124	118	16	11800	5660	-6140	0.14	0.48	20	10	-10
0023	3F	23_10	125	33	3	3300	1570	-1730	0.09	0.48	5	2	-3
0023	3F	23_10	126	2	0	200	0	-200	0.00	0.00	0	0	0
0023	3F	23_10	134	45	11	4500	5100	600	0.24	1.13	7	9	2
0023	3F	23_10	135	3	1	300	810	510	0.33	2.70	0	1	1
0023	3F	23_10	136	1	0	100	0	-100	0.00	0.00	0	0	0
0023	3F	23_10	145	15	0	1500	0	-1500	0.00	0.00	2	0	-2
0023	3F	23_10	146	3	1	300	3430	3130	0.33	11.43	0	6	6
0023	3F	23_10	235	1	1	100	360	260	1.00	3.60	0	0	0
0023	3F	23_10	245	4	0	400	0	-400	0.00	0.00	0	0	0
0023	3F	23_10	246	1	0	100	0	-100	0.00	0.00	0	0	0
0023	3F	23_11	123	111	25	11100	8070	-3030	0.23	0.73	19	14	-5
0023	3F	23_11	124	29	4	2900	2740	-160	0.14	0.94	5	4	-1
0023	3F	23_11	125	6	1	600	500	-100	0.17	0.83	1	0	-1
0023	3F	23_11	134	16	1	1600	410	-1190	0.06	0.26	2	0	-2
0023	3F	23_11	135	9	0	900	0	-900	0.00	0.00	1	0	-1
0023	3F	23_11	146	1	0	100	0	-100	0.00	0.00	0	0	0
0023	3F	23_12	123	132	27	13200	10320	-2880	0.20	0.78	23	18	-5
0023	3F	23_12	124	75	11	7500	4060	-3440	0.15	0.54	13	7	-6
0023	3F	23_12	125	2	0	200	0	-200	0.00	0.00	0	0	0
0023	3F	23_12	134	19	3	1900	1830	-70	0.16	0.96	3	3	0
0023	3F	23_2	123	119	42	11900	9970	-1930	0.35	0.84	21	17	-4
0023	3F	23_2	124	73	11	7300	2730	-4570	0.15	0.37	12	4	-8
0023	3F	23_2	125	20	5	2000	1420	-580	0.25	0.71	3	2	-1
0023	3F	23_2	126	5	2	500	960	460	0.40	1.92	0	1	1
0023	3F	23_2	134	1	0	100	0	-100	0.00	0.00	0	0	0
0023	3F	23_3	123	14	3	1400	600	-800	0.21	0.43	2	1	-1
0023	3F	23_3	124	6	0	600	0	-600	0.00	0.00	1	0	-1
0023	3F	23_3	125	1	0	100	0	-100	0.00	0.00	0	0	0
0023	3F	23_3	134	53	19	5300	5180	-120	0.36	0.98	9	9	0
0023	3F	23_3	135	13	2	1300	570	-730	0.15	0.44	2	1	-1
0023	3F	23_3	136	5	2	500	700	200	0.40	1.40	0	1	1
0023	3F	23_3	145	1	0	100	0	-100	0.00	0.00	0	0	0
0023	3F	23_3	234	1	0	100	0	-100	0.00	0.00	0	0	0
0023	3F	23_4	123	4	0	400	0	-400	0.00	0.00	0	0	0
0023	3F	23_4	124	27	9	2700	3140	440	0.33	1.16	4	5	1
0023	3F	23_4	125	23	2	2300	1340	-960	0.09	0.58	4	2	-2
0023	3F	23_4	126	10	2	1000	1080	80	0.20	1.08	1	1	0
0023	3F	23_4	134	26	3	2600	610	-1990	0.12	0.23	4	1	-3
0023	3F	23_4	135	21	4	2100	840	-1260	0.19	0.40	3	1	-2
0023	3F	23_4	136	14	4	1400	1060	-340	0.29	0.76	2	1	-1
0023	3F	23_4	145	24	10	2400	3140	740	0.42	1.31	4	5	1
0023	3F	23_4	146	9	0	900	0	-900	0.00	0.00	1	0	-1
0023	3F	23_4	156	1	0	100	0	-100	0.00	0.00	0	0	0
0023	3F	23_5	123	12	5	1200	1240	40	0.42	1.03	2	2	0
0023	3F	23_5	124	31	6	3100	2400	-700	0.19	0.77	5	4	-1
0023	3F	23_5	125	27	7	2700	2800	100	0.26	1.04	4	4	0
0023	3F	23_5	126	20	1	2000	520	-1480	0.05	0.26	3	0	-3
0023	3F	23_5	134	14	1	1400	370	-1030	0.07	0.26	2	0	-2
0023	3F	23_5	135	14	0	1400	0	-1400	0.00	0.00	2	0	-2
0023	3F	23_5	136	7	1	700	550	-150	0.14	0.79	1	0	-1
0023	3F	23_5	145	12	1	1200	370	-830	0.08	0.31	2	0	-2
0023	3F	23_5	146	8	0	800	0	-800	0.00	0.00	1	0	-1
0023	3F	23_5	156	2	0	200	0	-200	0.00	0.00	0	0	0
0023	3F	23_5	234	2	0	200	0	-200	0.00	0.00	0	0	0
0023	3F	23_5	235	1	0	100	0	-100	0.00	0.00	0	0	0
0023	3F	23_5	245	3	0	300	0	-300	0.00	0.00	0	0	0
0023	3F	23_5	246	3	1	300	380	80	0.33	1.27	0	0	0
0023	3F	23_6	123	2	0	200	0	-200	0.00	0.00	0	0	0
0023	3F	23_6	124	24	7	2400	2860	460	0.29	1.19	4	5	1
0023	3F	23_6	125	16	2	1600	510	-1090	0.13	0.32	2	0	-2
0023	3F	23_6	126	20	3	2000	1410	-590	0.15	0.71	3	2	-1
0023	3F	23_6	134	10	5	1000	1440	440	0.50	1.44	1	2	1
0023	3F	23_6	135	16	1	1600	360	-1240	0.06	0.23	2	0	-2
0023	3F	23_6	136	12	3	1200	3310	2110	0.25	2.76	2	5	3
0023	3F	23_6	145	16	6	1600	1830	230	0.38	1.14	2	3	1
0023	3F	23_6	146	4	1	400	2360	1960	0.25	5.90	0	4	4
0023	3F	23_6	234	2	1	200	230	30	0.50	1.15	0	0	0
0023	3F	23_6	235	1	0	100	0	-100	0.00	0.00	0	0	0
0023	3F	23_6	236	1	0	100	0	-100	0.00	0.00	0	0	0
0023	3F	23_6	245	2	2	200	1140	940	1.00	5.70	0	2	2
0023	3F	23_6	246	1	0	100	0	-100	0.00	0.00	0	0	0
0023	3F	23_6	256	1	1	100	310	210	1.00	3.10	0	0	0
0023	3F	23_7	123	15	5	1500	1400	-100	0.33	0.93	2	2	0
0023	3F	23_7	124	28	9	2800	3020	220	0.32	1.08	4	5	1
0023	3F	23_7	125	20	8	2000	3450	1450	0.40	1.73	3	6	3
0023	3F	23_7	126	6	0	600	0	-600	0.00	0.00	1	0	-1
0023	3F	23_7	134	16	3	1600	860	-740	0.19	0.54	2	1	-1
0023	3F	23_7	135	13	2	1300	960	-340	0.15	0.74	2	1	-1
0023	3F	23_7	136	4	1	400	860	460	0.25	2.15	0	1	1
0023	3F	23_7	145	5	1	500	200	-300	0.20	0.40	0	0	0
0023	3F	23_7	146	4	0	400	0	-400	0.00	0.00	0	0	0
0023	3F	23_7	234	1	0	100	0	-100	0.00	0.00	0	0	0
0023	3F	23_7	245	1	0	100	0	-100	0.00	0.00	0	0	0
0023	3F	23_7	246	1	1	100	430	330	1.00	4.30	0	0	0
0023	3F	23_8	123	13	4	1300	1220	-80	0.31	0.94	2	2	0
0023	3F	23_8	124	10	1	1000	340	-660	0.10	0.34	1	0	-1
0023	3F	23_8	125	9	1	900	470	-430	0.11	0.52	1	0	-1
0023	3F	23_8	126	2	0	200	0	-200	0.00	0.00	0	0	0
0023	3F	23_8	134	7	0	700	0	-700	0.00	0.00	1	0	-1
0023	3F	23_8	135	5	0	500	0	-500	0.00	0.00	0	0	0
0023	3F	23_8	136	4	2	400	1800	1400	0.50	4.50	0	3	3
0023	3F	23_8	145	10	3	1000	920	-80	0.30	0.92	1	1	0
0023	3F	23_8	146	4	0	400	0	-400	0.00	0.00	0	0	0
0023	3F	23_8	156	3	0	300	0	-300	0.00	0.00	0	0	0
0023	3F	23_8	235	2	0	200	0	-200	0.00	0.00	0	0	0
0023	3F	23_8	246	1	0	100	0	-100	0.00	0.00	0	0	0
0023	3F	23_9	123	26	9	2600	2670	70	0.35	1.03	4	4	0
0023	3F	23_9	124	40	7	4000	2490	-1510	0.18	0.62	7	4	-3
0023	3F	23_9	125	22	4	2200	1740	-460	0.18	0.79	3	3	0
0023	3F	23_9	126	13	0	1300	0	-1300	0.00	0.00	2	0	-2
0023	3F	23_9	134	11	1	1100	230	-870	0.09	0.21	1	0	-1
0023	3F	23_9	135	19	3	1900	1430	-470	0.16	0.75	3	2	-1
0023	3F	23_9	136	7	1	700	360	-340	0.14	0.51	1	0	-1
0023	3F	23_9	145	11	1	1100	940	-160	0.09	0.85	1	1	0
0023	3F	23_9	146	5	0	500	0	-500	0.00	0.00	0	0	0
0023	3F	23_9	156	3	0	300	0	-300	0.00	0.00	0	0	0
0023	3F	23_9	234	2	0	200	0	-200	0.00	0.00	0	0	0
0023	3F	23_9	235	1	0	100	0	-100	0.00	0.00	0	0	0
0023	3F	23_9	246	1	0	100	0	-100	0.00	0.00	0	0	0
0023	3F	23_9	256	1	0	100	0	-100	0.00	0.00	0	0	0
0023	3F	24_1	123	42	9	4200	2180	-2020	0.21	0.52	7	3	-4
0023	3F	24_1	124	25	10	2500	2740	240	0.40	1.10	4	4	0
0023	3F	24_1	125	16	3	1600	900	-700	0.19	0.56	2	1	-1
0023	3F	24_1	126	6	2	600	470	-130	0.33	0.78	1	0	-1
0023	3F	24_1	134	9	2	900	520	-380	0.22	0.58	1	0	-1
0023	3F	24_1	135	3	1	300	540	240	0.33	1.80	0	0	0
0023	3F	24_1	136	2	0	200	0	-200	0.00	0.00	0	0	0
0023	3F	24_1	145	5	0	500	0	-500	0.00	0.00	0	0	0
0023	3F	24_1	156	1	0	100	0	-100	0.00	0.00	0	0	0
0023	3F	24_1	235	1	0	100	0	-100	0.00	0.00	0	0	0
0023	3F	24_10	123	50	16	5000	4570	-430	0.32	0.91	8	8	0
0023	3F	24_10	124	87	15	8700	4920	-3780	0.17	0.57	15	8	-7
0023	3F	24_10	125	35	3	3500	820	-2680	0.09	0.23	6	1	-5
0023	3F	24_10	126	28	3	2800	3420	620	0.11	1.22	4	6	2
0023	3F	24_10	134	20	4	2000	1940	-60	0.20	0.97	3	3	0
0023	3F	24_10	135	12	2	1200	830	-370	0.17	0.69	2	1	-1
0023	3F	24_10	136	7	0	700	0	-700	0.00	0.00	1	0	-1
0023	3F	24_10	145	1	0	100	0	-100	0.00	0.00	0	0	0
0023	3F	24_10	146	1	0	100	0	-100	0.00	0.00	0	0	0
0023	3F	24_11	123	58	16	5800	4350	-1450	0.28	0.75	10	7	-3
0023	3F	24_11	124	109	15	10900	5430	-5470	0.14	0.50	19	9	-10
0023	3F	24_11	125	34	5	3400	2120	-1280	0.15	0.62	6	3	-3
0023	3F	24_11	126	16	0	1600	0	-1600	0.00	0.00	2	0	-2
0023	3F	24_11	134	14	3	1400	1040	-360	0.21	0.74	2	1	-1
0023	3F	24_11	135	11	1	1100	310	-790	0.09	0.28	1	0	-1
0023	3F	24_11	136	4	0	400	0	-400	0.00	0.00	0	0	0
0023	3F	24_11	145	1	0	100	0	-100	0.00	0.00	0	0	0
0023	3F	24_11	146	1	0	100	0	-100	0.00	0.00	0	0	0
0023	3F	24_12	123	22	4	2200	1050	-1150	0.18	0.48	3	1	-2
0023	3F	24_12	124	133	19	13300	8010	-5290	0.14	0.60	23	14	-9
0023	3F	24_12	125	15	1	1500	560	-940	0.07	0.37	2	0	-2
0023	3F	24_12	126	40	3	4000	3900	-100	0.08	0.98	7	6	-1
0023	3F	24_12	134	18	8	1800	3260	1460	0.44	1.81	3	5	2
0023	3F	24_12	135	7	1	700	440	-260	0.14	0.63	1	0	-1
0023	3F	24_12	136	5	1	500	250	-250	0.20	0.50	0	0	0
0023	3F	24_12	145	3	0	300	0	-300	0.00	0.00	0	0	0
0023	3F	24_12	146	1	0	100	0	-100	0.00	0.00	0	0	0
0023	3F	24_2	123	49	16	4900	3920	-980	0.33	0.80	8	6	-2
0023	3F	24_2	124	26	11	2600	3530	930	0.42	1.36	4	6	2
0023	3F	24_2	125	13	4	1300	1240	-60	0.31	0.95	2	2	0
0023	3F	24_2	126	20	3	2000	1420	-580	0.15	0.71	3	2	-1
0023	3F	24_2	134	16	4	1600	1000	-600	0.25	0.63	2	1	-1
0023	3F	24_2	135	8	4	800	2470	1670	0.50	3.09	1	4	3
0023	3F	24_2	136	13	1	1300	270	-1030	0.08	0.21	2	0	-2
0023	3F	24_2	145	2	0	200	0	-200	0.00	0.00	0	0	0
0023	3F	24_2	146	3	0	300	0	-300	0.00	0.00	0	0	0
0023	3F	24_2	234	1	0	100	0	-100	0.00	0.00	0	0	0
0023	3F	24_2	235	1	0	100	0	-100	0.00	0.00	0	0	0
0023	3F	24_3	123	20	6	2000	2340	340	0.30	1.17	3	4	1
0023	3F	24_3	124	23	6	2300	1840	-460	0.26	0.80	4	3	-1
0023	3F	24_3	125	23	3	2300	1400	-900	0.13	0.61	4	2	-2
0023	3F	24_3	126	21	4	2100	1610	-490	0.19	0.77	3	2	-1
0023	3F	24_3	134	14	4	1400	950	-450	0.29	0.68	2	1	-1
0023	3F	24_3	135	6	2	600	370	-230	0.33	0.62	1	0	-1
0023	3F	24_3	136	23	3	2300	1540	-760	0.13	0.67	4	2	-2
0023	3F	24_3	145	5	0	500	0	-500	0.00	0.00	0	0	0
0023	3F	24_3	146	2	0	200	0	-200	0.00	0.00	0	0	0
0023	3F	24_3	236	1	0	100	0	-100	0.00	0.00	0	0	0
0023	3F	24_4	123	18	5	1800	1220	-580	0.28	0.68	3	2	-1
0023	3F	24_4	124	26	5	2600	1330	-1270	0.19	0.51	4	2	-2
0023	3F	24_4	125	19	3	1900	3420	1520	0.16	1.80	3	6	3
0023	3F	24_4	126	25	12	2500	5030	2530	0.48	2.01	4	8	4
0023	3F	24_4	134	19	4	1900	1280	-620	0.21	0.67	3	2	-1
0023	3F	24_4	135	9	2	900	630	-270	0.22	0.70	1	1	0
0023	3F	24_4	136	18	1	1800	1330	-470	0.06	0.74	3	2	-1
0023	3F	24_4	145	2	0	200	0	-200	0.00	0.00	0	0	0
0023	3F	24_4	146	6	0	600	0	-600	0.00	0.00	1	0	-1
0023	3F	24_4	156	1	0	100	0	-100	0.00	0.00	0	0	0
0023	3F	24_4	235	1	1	100	320	220	1.00	3.20	0	0	0
0023	3F	24_5	123	31	15	3100	2780	-320	0.48	0.90	5	4	-1
0023	3F	24_5	124	50	17	5000	4480	-520	0.34	0.90	8	7	-1
0023	3F	24_5	125	17	6	1700	1850	150	0.35	1.09	3	3	0
0023	3F	24_5	126	9	0	900	0	-900	0.00	0.00	1	0	-1
0023	3F	24_5	134	26	9	2600	2410	-190	0.35	0.93	4	4	0
0023	3F	24_5	135	20	3	2000	970	-1030	0.15	0.49	3	1	-2
0023	3F	24_5	136	4	0	400	0	-400	0.00	0.00	0	0	0
0023	3F	24_5	145	10	2	1000	460	-540	0.20	0.46	1	0	-1
0023	3F	24_5	146	1	0	100	0	-100	0.00	0.00	0	0	0
0023	3F	24_5	156	1	0	100	0	-100	0.00	0.00	0	0	0
0023	3F	24_6	123	25	9	2500	2710	210	0.36	1.08	4	4	0
0023	3F	24_6	124	39	15	3900	4450	550	0.38	1.14	6	7	1
0023	3F	24_6	125	16	1	1600	550	-1050	0.06	0.34	2	0	-2
0023	3F	24_6	126	28	5	2800	1380	-1420	0.18	0.49	4	2	-2
0023	3F	24_6	134	13	3	1300	1020	-280	0.23	0.78	2	1	-1
0023	3F	24_6	135	9	3	900	1350	450	0.33	1.50	1	2	1
0023	3F	24_6	136	16	2	1600	490	-1110	0.13	0.31	2	0	-2
0023	3F	24_6	145	3	0	300	0	-300	0.00	0.00	0	0	0
0023	3F	24_6	146	2	0	200	0	-200	0.00	0.00	0	0	0
0023	3F	24_6	235	1	0	100	0	-100	0.00	0.00	0	0	0
0023	3F	24_7	123	8	2	800	410	-390	0.25	0.51	1	0	-1
0023	3F	24_7	124	20	5	2000	1270	-730	0.25	0.64	3	2	-1
0023	3F	24_7	125	17	5	1700	2210	510	0.29	1.30	3	3	0
0023	3F	24_7	126	18	3	1800	970	-830	0.17	0.54	3	1	-2
0023	3F	24_7	134	12	3	1200	670	-530	0.25	0.56	2	1	-1
0023	3F	24_7	135	11	4	1100	1510	410	0.36	1.37	1	2	1
0023	3F	24_7	136	17	5	1700	1230	-470	0.29	0.72	3	2	-1
0023	3F	24_7	145	3	0	300	0	-300	0.00	0.00	0	0	0
0023	3F	24_7	146	3	0	300	0	-300	0.00	0.00	0	0	0
0023	3F	24_8	123	28	8	2800	2050	-750	0.29	0.73	4	3	-1
0023	3F	24_8	124	22	10	2200	3970	1770	0.45	1.80	3	7	4
0023	3F	24_8	125	19	6	1900	2660	760	0.32	1.40	3	4	1
0023	3F	24_8	126	19	3	1900	760	-1140	0.16	0.40	3	1	-2
0023	3F	24_8	134	19	8	1900	2630	730	0.42	1.38	3	4	1
0023	3F	24_8	135	12	4	1200	1000	-200	0.33	0.83	2	1	-1
0023	3F	24_8	136	13	0	1300	0	-1300	0.00	0.00	2	0	-2
0023	3F	24_8	145	6	2	600	550	-50	0.33	0.92	1	0	-1
0023	3F	24_8	146	1	0	100	0	-100	0.00	0.00	0	0	0
0023	3F	24_8	156	2	1	200	280	80	0.50	1.40	0	0	0
0023	3F	24_9	123	41	13	4100	3700	-400	0.32	0.90	7	6	-1
0023	3F	24_9	124	69	13	6900	3860	-3040	0.19	0.56	12	6	-6
0023	3F	24_9	125	19	4	1900	1630	-270	0.21	0.86	3	2	-1
0023	3F	24_9	126	19	1	1900	310	-1590	0.05	0.16	3	0	-3
0023	3F	24_9	134	21	4	2100	950	-1150	0.19	0.45	3	1	-2
0023	3F	24_9	135	9	0	900	0	-900	0.00	0.00	1	0	-1
0023	3F	24_9	136	13	5	1300	1530	230	0.38	1.18	2	2	0
0023	3F	24_9	145	3	1	300	220	-80	0.33	0.73	0	0	0
0023	3F	24_9	146	2	0	200	0	-200	0.00	0.00	0	0	0
0023	3F	24_9	156	1	0	100	0	-100	0.00	0.00	0	0	0
0023	3F	24_9	236	1	0	100	0	-100	0.00	0.00	0	0	0
0023	3T	01_1	123	1	0	100	0	-100	0.00	0.00	0	0	0
0023	3T	01_1	124	11	0	1100	0	-1100	0.00	0.00	1	0	-1
0023	3T	01_1	125	3	0	300	0	-300	0.00	0.00	0	0	0
0023	3T	01_1	126	2	0	200	0	-200	0.00	0.00	0	0	0
0023	3T	01_1	145	5	1	500	1590	1090	0.20	3.18	0	2	2
0023	3T	01_1	146	5	1	500	2060	1560	0.20	4.12	0	3	3
0023	3T	01_10	123	42	3	4200	1910	-2290	0.07	0.45	7	3	-4
0023	3T	01_10	124	70	5	7000	4520	-2480	0.07	0.65	12	8	-4
0023	3T	01_10	125	48	5	4800	5630	830	0.10	1.17	8	9	1
0023	3T	01_10	126	24	4	2400	7250	4850	0.17	3.02	4	12	8
0023	3T	01_10	134	26	2	2600	1810	-790	0.08	0.70	4	3	-1
0023	3T	01_10	135	15	1	1500	550	-950	0.07	0.37	2	0	-2
0023	3T	01_10	136	11	0	1100	0	-1100	0.00	0.00	1	0	-1
0023	3T	01_10	145	1	0	100	0	-100	0.00	0.00	0	0	0
0023	3T	01_10	146	5	0	500	0	-500	0.00	0.00	0	0	0
0023	3T	01_10	235	1	0	100	0	-100	0.00	0.00	0	0	0
0023	3T	01_11	123	47	6	4700	4960	260	0.13	1.06	8	8	0
0023	3T	01_11	124	120	7	12000	5260	-6740	0.06	0.44	21	9	-12
0023	3T	01_11	125	28	3	2800	4340	1540	0.11	1.55	4	7	3
0023	3T	01_11	126	25	1	2500	1560	-940	0.04	0.62	4	2	-2
0023	3T	01_11	134	17	0	1700	0	-1700	0.00	0.00	3	0	-3
0023	3T	01_11	135	19	1	1900	1310	-590	0.05	0.69	3	2	-1
0023	3T	01_11	136	4	0	400	0	-400	0.00	0.00	0	0	0
0023	3T	01_11	145	2	0	200	0	-200	0.00	0.00	0	0	0
0023	3T	01_12	123	54	9	5400	6330	930	0.17	1.17	9	11	2
0023	3T	01_12	124	146	8	14600	7520	-7080	0.05	0.52	25	13	-12
0023	3T	01_12	125	18	2	1800	5180	3380	0.11	2.88	3	9	6
0023	3T	01_12	126	24	2	2400	7520	5120	0.08	3.13	4	13	9
0023	3T	01_12	134	17	2	1700	2300	600	0.12	1.35	3	4	1
0023	3T	01_12	135	2	0	200	0	-200	0.00	0.00	0	0	0
0023	3T	01_12	136	3	0	300	0	-300	0.00	0.00	0	0	0
0023	3T	01_12	142	1	0	100	0	-100	0.00	0.00	0	0	0
0023	3T	01_12	146	1	0	100	0	-100	0.00	0.00	0	0	0
0023	3T	01_2	123	13	1	1300	790	-510	0.08	0.61	2	1	-1
0023	3T	01_2	124	16	1	1600	820	-780	0.06	0.51	2	1	-1
0023	3T	01_2	125	13	1	1300	1330	30	0.08	1.02	2	2	0
0023	3T	01_2	126	17	1	1700	1110	-590	0.06	0.65	3	1	-2
0023	3T	01_2	134	9	0	900	0	-900	0.00	0.00	1	0	-1
0023	3T	01_2	135	13	3	1300	3930	2630	0.23	3.02	2	6	4
0023	3T	01_2	136	8	1	800	2080	1280	0.13	2.60	1	3	2
0023	3T	01_2	142	1	0	100	0	-100	0.00	0.00	0	0	0
0023	3T	01_2	145	3	0	300	0	-300	0.00	0.00	0	0	0
0023	3T	01_2	146	5	0	500	0	-500	0.00	0.00	0	0	0
0023	3T	01_2	156	5	0	500	0	-500	0.00	0.00	0	0	0
0023	3T	01_2	234	1	0	100	0	-100	0.00	0.00	0	0	0
0023	3T	01_2	235	1	0	100	0	-100	0.00	0.00	0	0	0
0023	3T	01_2	236	1	0	100	0	-100	0.00	0.00	0	0	0
0023	3T	01_2	246	1	0	100	0	-100	0.00	0.00	0	0	0
0023	3T	01_2	256	1	0	100	0	-100	0.00	0.00	0	0	0
0023	3T	01_3	123	19	2	1900	1830	-70	0.11	0.96	3	3	0
0023	3T	01_3	124	20	0	2000	0	-2000	0.00	0.00	3	0	-3
0023	3T	01_3	125	13	1	1300	1270	-30	0.08	0.98	2	2	0
0023	3T	01_3	126	22	0	2200	0	-2200	0.00	0.00	3	0	-3
0023	3T	01_3	134	12	2	1200	2090	890	0.17	1.74	2	3	1
0023	3T	01_3	135	16	1	1600	960	-640	0.06	0.60	2	1	-1
0023	3T	01_3	136	19	2	1900	2290	390	0.11	1.21	3	4	1
0023	3T	01_3	145	3	1	300	2280	1980	0.33	7.60	0	4	4
0023	3T	01_3	146	3	0	300	0	-300	0.00	0.00	0	0	0
0023	3T	01_3	154	1	0	100	0	-100	0.00	0.00	0	0	0
0023	3T	01_3	156	2	0	200	0	-200	0.00	0.00	0	0	0
0023	3T	01_3	234	2	0	200	0	-200	0.00	0.00	0	0	0
0023	3T	01_3	235	2	0	200	0	-200	0.00	0.00	0	0	0
0023	3T	01_3	236	2	1	200	720	520	0.50	3.60	0	1	1
0023	3T	01_3	246	1	0	100	0	-100	0.00	0.00	0	0	0
0023	3T	01_3	256	1	0	100	0	-100	0.00	0.00	0	0	0
0023	3T	01_4	123	8	0	800	0	-800	0.00	0.00	1	0	-1
0023	3T	01_4	124	34	0	3400	0	-3400	0.00	0.00	6	0	-6
0023	3T	01_4	125	15	1	1500	820	-680	0.07	0.55	2	1	-1
0023	3T	01_4	126	21	0	2100	0	-2100	0.00	0.00	3	0	-3
0023	3T	01_4	134	14	0	1400	0	-1400	0.00	0.00	2	0	-2
0023	3T	01_4	135	15	0	1500	0	-1500	0.00	0.00	2	0	-2
0023	3T	01_4	136	22	0	2200	0	-2200	0.00	0.00	3	0	-3
0023	3T	01_4	143	1	0	100	0	-100	0.00	0.00	0	0	0
0023	3T	01_4	145	5	1	500	1430	930	0.20	2.86	0	2	2
0023	3T	01_4	146	7	1	700	760	60	0.14	1.09	1	1	0
0023	3T	01_4	156	3	0	300	0	-300	0.00	0.00	0	0	0
0023	3T	01_4	215	1	0	100	0	-100	0.00	0.00	0	0	0
0023	3T	01_4	234	2	0	200	0	-200	0.00	0.00	0	0	0
0023	3T	01_4	235	1	0	100	0	-100	0.00	0.00	0	0	0
0023	3T	01_4	236	1	0	100	0	-100	0.00	0.00	0	0	0
0023	3T	01_4	245	1	0	100	0	-100	0.00	0.00	0	0	0
0023	3T	01_4	246	2	0	200	0	-200	0.00	0.00	0	0	0
0023	3T	01_5	123	18	2	1800	1340	-460	0.11	0.74	3	2	-1
0023	3T	01_5	124	30	3	3000	2110	-890	0.10	0.70	5	3	-2
0023	3T	01_5	125	21	0	2100	0	-2100	0.00	0.00	3	0	-3
0023	3T	01_5	126	33	0	3300	0	-3300	0.00	0.00	5	0	-5
0023	3T	01_5	134	16	1	1600	740	-860	0.06	0.46	2	1	-1
0023	3T	01_5	135	19	0	1900	0	-1900	0.00	0.00	3	0	-3
0023	3T	01_5	136	26	1	2600	640	-1960	0.04	0.25	4	1	-3
0023	3T	01_5	145	3	0	300	0	-300	0.00	0.00	0	0	0
0023	3T	01_5	146	4	0	400	0	-400	0.00	0.00	0	0	0
0023	3T	01_5	156	3	0	300	0	-300	0.00	0.00	0	0	0
0023	3T	01_5	234	1	0	100	0	-100	0.00	0.00	0	0	0
0023	3T	01_5	235	1	0	100	0	-100	0.00	0.00	0	0	0
0023	3T	01_5	236	3	0	300	0	-300	0.00	0.00	0	0	0
0023	3T	01_5	245	2	0	200	0	-200	0.00	0.00	0	0	0
0023	3T	01_5	246	1	0	100	0	-100	0.00	0.00	0	0	0
0023	3T	01_5	256	1	0	100	0	-100	0.00	0.00	0	0	0
0023	3T	01_6	123	36	2	3600	730	-2870	0.06	0.20	6	1	-5
0023	3T	01_6	124	39	3	3900	1610	-2290	0.08	0.41	6	2	-4
0023	3T	01_6	125	9	1	900	820	-80	0.11	0.91	1	1	0
0023	3T	01_6	126	2	0	200	0	-200	0.00	0.00	0	0	0
0023	3T	01_6	132	2	1	200	420	220	0.50	2.10	0	0	0
0023	3T	01_6	134	5	0	500	0	-500	0.00	0.00	0	0	0
0023	3T	01_6	135	3	0	300	0	-300	0.00	0.00	0	0	0
0023	3T	01_6	136	3	0	300	0	-300	0.00	0.00	0	0	0
0023	3T	01_6	143	2	0	200	0	-200	0.00	0.00	0	0	0
0023	3T	01_7	123	29	7	2900	4950	2050	0.24	1.71	5	8	3
0023	3T	01_7	124	32	6	3200	3560	360	0.19	1.11	5	6	1
0023	3T	01_7	125	21	1	2100	350	-1750	0.05	0.17	3	0	-3
0023	3T	01_7	126	44	6	4400	5140	740	0.14	1.17	7	9	2
0023	3T	01_7	134	8	1	800	500	-300	0.13	0.63	1	0	-1
0023	3T	01_7	135	4	1	400	510	110	0.25	1.28	0	0	0
0023	3T	01_7	136	13	1	1300	700	-600	0.08	0.54	2	1	-1
0023	3T	01_7	145	4	0	400	0	-400	0.00	0.00	0	0	0
0023	3T	01_7	146	5	0	500	0	-500	0.00	0.00	0	0	0
0023	3T	01_7	154	1	0	100	0	-100	0.00	0.00	0	0	0
0023	3T	01_7	156	1	0	100	0	-100	0.00	0.00	0	0	0
0023	3T	01_7	164	1	0	100	0	-100	0.00	0.00	0	0	0
0023	3T	01_7	236	1	0	100	0	-100	0.00	0.00	0	0	0
0023	3T	01_7	246	1	0	100	0	-100	0.00	0.00	0	0	0
0023	3T	01_8	123	3	0	300	0	-300	0.00	0.00	0	0	0
0023	3T	01_8	124	4	1	400	440	40	0.25	1.10	0	0	0
0023	3T	01_8	125	72	12	7200	11220	4020	0.17	1.56	12	19	7
0023	3T	01_8	126	5	0	500	0	-500	0.00	0.00	0	0	0
0023	3T	01_8	134	1	0	100	0	-100	0.00	0.00	0	0	0
0023	3T	01_8	135	24	2	2400	1100	-1300	0.08	0.46	4	1	-3
0023	3T	01_8	143	2	0	200	0	-200	0.00	0.00	0	0	0
0023	3T	01_8	145	7	0	700	0	-700	0.00	0.00	1	0	-1
0023	3T	01_8	146	1	0	100	0	-100	0.00	0.00	0	0	0
0023	3T	01_8	152	2	0	200	0	-200	0.00	0.00	0	0	0
0023	3T	01_8	153	1	0	100	0	-100	0.00	0.00	0	0	0
0023	3T	01_8	156	1	0	100	0	-100	0.00	0.00	0	0	0
0023	3T	01_9	123	52	8	5200	7370	2170	0.15	1.42	9	13	4
0023	3T	01_9	124	68	6	6800	4220	-2580	0.09	0.62	12	7	-5
0023	3T	01_9	125	29	1	2900	430	-2470	0.03	0.15	5	0	-5
0023	3T	01_9	126	29	3	2900	3180	280	0.10	1.10	5	5	0
0023	3T	01_9	134	15	2	1500	3510	2010	0.13	2.34	2	6	4
0023	3T	01_9	135	12	1	1200	1190	-10	0.08	0.99	2	2	0
0023	3T	01_9	136	10	0	1000	0	-1000	0.00	0.00	1	0	-1
0023	3T	01_9	143	1	0	100	0	-100	0.00	0.00	0	0	0
0023	3T	01_9	145	1	0	100	0	-100	0.00	0.00	0	0	0
0023	3T	01_9	146	1	0	100	0	-100	0.00	0.00	0	0	0
0023	3T	01_9	152	1	0	100	0	-100	0.00	0.00	0	0	0
0023	3T	01_9	156	2	0	200	0	-200	0.00	0.00	0	0	0
0023	3T	02_1	123	34	3	3400	3120	-280	0.09	0.92	6	5	-1
0023	3T	02_1	124	16	0	1600	0	-1600	0.00	0.00	2	0	-2
0023	3T	02_1	125	7	1	700	1530	830	0.14	2.19	1	2	1
0023	3T	02_1	126	12	1	1200	1170	-30	0.08	0.98	2	2	0
0023	3T	02_1	132	2	0	200	0	-200	0.00	0.00	0	0	0
0023	3T	02_1	134	6	0	600	0	-600	0.00	0.00	1	0	-1
0023	3T	02_1	135	4	0	400	0	-400	0.00	0.00	0	0	0
0023	3T	02_1	136	8	1	800	1410	610	0.13	1.76	1	2	1
0023	3T	02_1	143	1	0	100	0	-100	0.00	0.00	0	0	0
0023	3T	02_1	145	2	0	200	0	-200	0.00	0.00	0	0	0
0023	3T	02_1	146	3	0	300	0	-300	0.00	0.00	0	0	0
0023	3T	02_1	154	1	0	100	0	-100	0.00	0.00	0	0	0
0023	3T	02_1	156	1	0	100	0	-100	0.00	0.00	0	0	0
0023	3T	02_1	162	1	0	100	0	-100	0.00	0.00	0	0	0
0023	3T	02_1	234	1	0	100	0	-100	0.00	0.00	0	0	0
0023	3T	02_1	235	1	0	100	0	-100	0.00	0.00	0	0	0
0023	3T	02_1	236	1	0	100	0	-100	0.00	0.00	0	0	0
0023	3T	02_10	123	41	3	4100	3070	-1030	0.07	0.75	7	5	-2
0023	3T	02_10	124	57	2	5700	1540	-4160	0.04	0.27	10	2	-8
0023	3T	02_10	125	25	0	2500	0	-2500	0.00	0.00	4	0	-4
0023	3T	02_10	126	36	0	3600	0	-3600	0.00	0.00	6	0	-6
0023	3T	02_10	134	19	0	1900	0	-1900	0.00	0.00	3	0	-3
0023	3T	02_10	135	21	0	2100	0	-2100	0.00	0.00	3	0	-3
0023	3T	02_10	136	18	0	1800	0	-1800	0.00	0.00	3	0	-3
0023	3T	02_10	145	2	0	200	0	-200	0.00	0.00	0	0	0
0023	3T	02_10	146	4	1	400	1710	1310	0.25	4.28	0	3	3
0023	3T	02_10	156	2	1	200	1880	1680	0.50	9.40	0	3	3
0023	3T	02_10	215	1	0	100	0	-100	0.00	0.00	0	0	0
0023	3T	02_10	256	1	0	100	0	-100	0.00	0.00	0	0	0
0023	3T	02_11	123	38	4	3800	2760	-1040	0.11	0.73	6	4	-2
0023	3T	02_11	124	67	6	6700	6520	-180	0.09	0.97	11	11	0
0023	3T	02_11	125	27	1	2700	850	-1850	0.04	0.31	4	1	-3
0023	3T	02_11	126	40	0	4000	0	-4000	0.00	0.00	7	0	-7
0023	3T	02_11	134	16	1	1600	910	-690	0.06	0.57	2	1	-1
0023	3T	02_11	135	24	3	2400	7710	5310	0.13	3.21	4	13	9
0023	3T	02_11	136	15	1	1500	2190	690	0.07	1.46	2	3	1
0023	3T	02_11	145	2	0	200	0	-200	0.00	0.00	0	0	0
0023	3T	02_11	146	10	0	1000	0	-1000	0.00	0.00	1	0	-1
0023	3T	02_12	123	64	5	6400	4550	-1850	0.08	0.71	11	8	-3
0023	3T	02_12	124	97	7	9700	7740	-1960	0.07	0.80	17	13	-4
0023	3T	02_12	125	15	1	1500	650	-850	0.07	0.43	2	1	-1
0023	3T	02_12	126	27	0	2700	0	-2700	0.00	0.00	4	0	-4
0023	3T	02_12	132	1	0	100	0	-100	0.00	0.00	0	0	0
0023	3T	02_12	134	19	2	1900	1640	-260	0.11	0.86	3	2	-1
0023	3T	02_12	135	8	1	800	1120	320	0.13	1.40	1	1	0
0023	3T	02_12	136	6	0	600	0	-600	0.00	0.00	1	0	-1
0023	3T	02_12	145	4	0	400	0	-400	0.00	0.00	0	0	0
0023	3T	02_12	216	1	0	100	0	-100	0.00	0.00	0	0	0
0023	3T	02_12	246	1	0	100	0	-100	0.00	0.00	0	0	0
0023	3T	02_2	123	2	0	200	0	-200	0.00	0.00	0	0	0
0023	3T	02_2	124	21	2	2100	4130	2030	0.10	1.97	3	7	4
0023	3T	02_2	125	4	0	400	0	-400	0.00	0.00	0	0	0
0023	3T	02_2	126	4	2	400	1740	1340	0.50	4.35	0	3	3
0023	3T	02_2	134	4	0	400	0	-400	0.00	0.00	0	0	0
0023	3T	02_2	135	1	0	100	0	-100	0.00	0.00	0	0	0
0023	3T	02_2	143	1	0	100	0	-100	0.00	0.00	0	0	0
0023	3T	02_2	145	5	0	500	0	-500	0.00	0.00	0	0	0
0023	3T	02_2	146	6	0	600	0	-600	0.00	0.00	1	0	-1
0023	3T	02_2	234	1	0	100	0	-100	0.00	0.00	0	0	0
0023	3T	02_2	246	1	0	100	0	-100	0.00	0.00	0	0	0
0023	3T	02_3	123	22	2	2200	3850	1650	0.09	1.75	3	6	3
0023	3T	02_3	124	16	0	1600	0	-1600	0.00	0.00	2	0	-2
0023	3T	02_3	125	29	2	2900	2140	-760	0.07	0.74	5	3	-2
0023	3T	02_3	126	25	1	2500	1210	-1290	0.04	0.48	4	2	-2
0023	3T	02_3	134	8	1	800	1300	500	0.13	1.63	1	2	1
0023	3T	02_3	135	13	3	1300	3590	2290	0.23	2.76	2	6	4
0023	3T	02_3	136	17	1	1700	1530	-170	0.06	0.90	3	2	-1
0023	3T	02_3	145	4	0	400	0	-400	0.00	0.00	0	0	0
0023	3T	02_3	146	7	0	700	0	-700	0.00	0.00	1	0	-1
0023	3T	02_3	156	1	0	100	0	-100	0.00	0.00	0	0	0
0023	3T	02_3	214	1	0	100	0	-100	0.00	0.00	0	0	0
0023	3T	02_3	234	1	1	100	2160	2060	1.00	21.60	0	3	3
0023	3T	02_3	235	1	0	100	0	-100	0.00	0.00	0	0	0
0023	3T	02_3	236	1	0	100	0	-100	0.00	0.00	0	0	0
0023	3T	02_3	246	3	0	300	0	-300	0.00	0.00	0	0	0
0023	3T	02_3	256	1	0	100	0	-100	0.00	0.00	0	0	0
0023	3T	02_4	123	22	0	2200	0	-2200	0.00	0.00	3	0	-3
0023	3T	02_4	124	33	3	3300	3830	530	0.09	1.16	5	6	1
0023	3T	02_4	125	18	2	1800	1850	50	0.11	1.03	3	3	0
0023	3T	02_4	126	26	1	2600	1800	-800	0.04	0.69	4	3	-1
0023	3T	02_4	134	14	2	1400	1220	-180	0.14	0.87	2	2	0
0023	3T	02_4	135	23	1	2300	510	-1790	0.04	0.22	4	0	-4
0023	3T	02_4	136	15	1	1500	1120	-380	0.07	0.75	2	1	-1
0023	3T	02_4	143	1	0	100	0	-100	0.00	0.00	0	0	0
0023	3T	02_4	145	6	0	600	0	-600	0.00	0.00	1	0	-1
0023	3T	02_4	146	5	0	500	0	-500	0.00	0.00	0	0	0
0023	3T	02_4	156	3	1	300	3280	2980	0.33	10.93	0	5	5
0023	3T	02_4	215	1	0	100	0	-100	0.00	0.00	0	0	0
0023	3T	02_4	216	3	0	300	0	-300	0.00	0.00	0	0	0
0023	3T	02_4	234	1	0	100	0	-100	0.00	0.00	0	0	0
0023	3T	02_4	236	1	0	100	0	-100	0.00	0.00	0	0	0
0023	3T	02_4	245	2	0	200	0	-200	0.00	0.00	0	0	0
0023	3T	02_4	246	1	0	100	0	-100	0.00	0.00	0	0	0
0023	3T	02_5	123	29	4	2900	3880	980	0.14	1.34	5	6	1
0023	3T	02_5	124	28	1	2800	590	-2210	0.04	0.21	4	1	-3
0023	3T	02_5	125	24	4	2400	4120	1720	0.17	1.72	4	7	3
0023	3T	02_5	126	28	2	2800	2180	-620	0.07	0.78	4	3	-1
0023	3T	02_5	134	9	0	900	0	-900	0.00	0.00	1	0	-1
0023	3T	02_5	135	15	0	1500	0	-1500	0.00	0.00	2	0	-2
0023	3T	02_5	136	9	0	900	0	-900	0.00	0.00	1	0	-1
0023	3T	02_5	145	3	0	300	0	-300	0.00	0.00	0	0	0
0023	3T	02_5	146	5	0	500	0	-500	0.00	0.00	0	0	0
0023	3T	02_5	154	1	0	100	0	-100	0.00	0.00	0	0	0
0023	3T	02_5	156	2	1	200	2750	2550	0.50	13.75	0	4	4
0023	3T	02_5	164	1	0	100	0	-100	0.00	0.00	0	0	0
0023	3T	02_5	214	1	0	100	0	-100	0.00	0.00	0	0	0
0023	3T	02_5	216	1	0	100	0	-100	0.00	0.00	0	0	0
0023	3T	02_5	235	1	0	100	0	-100	0.00	0.00	0	0	0
0023	3T	02_5	256	1	0	100	0	-100	0.00	0.00	0	0	0
0023	3T	02_6	123	20	4	2000	4980	2980	0.20	2.49	3	8	5
0023	3T	02_6	124	26	3	2600	3370	770	0.12	1.30	4	5	1
0023	3T	02_6	125	20	2	2000	4310	2310	0.10	2.16	3	7	4
0023	3T	02_6	126	24	2	2400	3120	720	0.08	1.30	4	5	1
0023	3T	02_6	134	9	0	900	0	-900	0.00	0.00	1	0	-1
0023	3T	02_6	135	13	1	1300	760	-540	0.08	0.58	2	1	-1
0023	3T	02_6	136	16	2	1600	2980	1380	0.13	1.86	2	5	3
0023	3T	02_6	145	1	0	100	0	-100	0.00	0.00	0	0	0
0023	3T	02_6	146	4	1	400	1500	1100	0.25	3.75	0	2	2
0023	3T	02_6	154	1	0	100	0	-100	0.00	0.00	0	0	0
0023	3T	02_6	156	3	0	300	0	-300	0.00	0.00	0	0	0
0023	3T	02_6	214	1	0	100	0	-100	0.00	0.00	0	0	0
0023	3T	02_6	216	1	0	100	0	-100	0.00	0.00	0	0	0
0023	3T	02_6	235	1	0	100	0	-100	0.00	0.00	0	0	0
0023	3T	02_6	256	2	1	200	1450	1250	0.50	7.25	0	2	2
0023	3T	02_7	123	56	8	5600	8810	3210	0.14	1.57	9	15	6
0023	3T	02_7	124	40	2	4000	1310	-2690	0.05	0.33	7	2	-5
0023	3T	02_7	125	12	0	1200	0	-1200	0.00	0.00	2	0	-2
0023	3T	02_7	126	12	0	1200	0	-1200	0.00	0.00	2	0	-2
0023	3T	02_7	132	2	0	200	0	-200	0.00	0.00	0	0	0
0023	3T	02_7	134	3	0	300	0	-300	0.00	0.00	0	0	0
0023	3T	02_7	135	5	1	500	1470	970	0.20	2.94	0	2	2
0023	3T	02_7	136	6	0	600	0	-600	0.00	0.00	1	0	-1
0023	3T	02_7	143	2	0	200	0	-200	0.00	0.00	0	0	0
0023	3T	02_7	145	2	0	200	0	-200	0.00	0.00	0	0	0
0023	3T	02_7	146	1	0	100	0	-100	0.00	0.00	0	0	0
0023	3T	02_8	123	27	1	2700	680	-2020	0.04	0.25	4	1	-3
0023	3T	02_8	124	24	0	2400	0	-2400	0.00	0.00	4	0	-4
0023	3T	02_8	125	24	1	2400	1260	-1140	0.04	0.53	4	2	-2
0023	3T	02_8	126	24	0	2400	0	-2400	0.00	0.00	4	0	-4
0023	3T	02_8	134	16	0	1600	0	-1600	0.00	0.00	2	0	-2
0023	3T	02_8	135	6	0	600	0	-600	0.00	0.00	1	0	-1
0023	3T	02_8	136	22	4	2200	9140	6940	0.18	4.15	3	16	13
0023	3T	02_8	145	3	0	300	0	-300	0.00	0.00	0	0	0
0023	3T	02_8	146	9	1	900	1830	930	0.11	2.03	1	3	2
0023	3T	02_8	156	1	0	100	0	-100	0.00	0.00	0	0	0
0023	3T	02_8	213	1	0	100	0	-100	0.00	0.00	0	0	0
0023	3T	02_8	235	1	0	100	0	-100	0.00	0.00	0	0	0
0023	3T	02_8	236	1	0	100	0	-100	0.00	0.00	0	0	0
0023	3T	02_8	245	1	0	100	0	-100	0.00	0.00	0	0	0
0023	3T	02_9	123	42	6	4200	4790	590	0.14	1.14	7	8	1
0023	3T	02_9	124	31	2	3100	1560	-1540	0.06	0.50	5	2	-3
0023	3T	02_9	125	39	3	3900	5110	1210	0.08	1.31	6	9	3
0023	3T	02_9	126	30	4	3000	5670	2670	0.13	1.89	5	10	5
0023	3T	02_9	134	17	2	1700	1490	-210	0.12	0.88	3	2	-1
0023	3T	02_9	135	23	2	2300	2130	-170	0.09	0.93	4	3	-1
0023	3T	02_9	136	19	0	1900	0	-1900	0.00	0.00	3	0	-3
0023	3T	02_9	145	3	1	300	1720	1420	0.33	5.73	0	3	3
0023	3T	02_9	146	5	0	500	0	-500	0.00	0.00	0	0	0
0023	3T	02_9	156	2	0	200	0	-200	0.00	0.00	0	0	0
0023	3T	02_9	163	1	0	100	0	-100	0.00	0.00	0	0	0
0023	3T	02_9	164	2	1	200	2610	2410	0.50	13.05	0	4	4
0023	3T	03_1	123	21	1	2100	710	-1390	0.05	0.34	3	1	-2
0023	3T	03_1	124	13	1	1300	980	-320	0.08	0.75	2	1	-1
0023	3T	03_1	125	5	0	500	0	-500	0.00	0.00	0	0	0
0023	3T	03_1	126	9	0	900	0	-900	0.00	0.00	1	0	-1
0023	3T	03_1	132	1	0	100	0	-100	0.00	0.00	0	0	0
0023	3T	03_1	134	5	0	500	0	-500	0.00	0.00	0	0	0
0023	3T	03_1	135	2	0	200	0	-200	0.00	0.00	0	0	0
0023	3T	03_1	136	5	1	500	1010	510	0.20	2.02	0	1	1
0023	3T	03_1	143	1	0	100	0	-100	0.00	0.00	0	0	0
0023	3T	03_1	145	2	0	200	0	-200	0.00	0.00	0	0	0
0023	3T	03_1	152	2	0	200	0	-200	0.00	0.00	0	0	0
0023	3T	03_10	123	22	1	2200	900	-1300	0.05	0.41	3	1	-2
0023	3T	03_10	124	44	5	4400	4510	110	0.11	1.03	7	7	0
0023	3T	03_10	125	21	1	2100	420	-1680	0.05	0.20	3	0	-3
0023	3T	03_10	126	21	2	2100	2420	320	0.10	1.15	3	4	1
0023	3T	03_10	134	17	0	1700	0	-1700	0.00	0.00	3	0	-3
0023	3T	03_10	135	10	2	1000	3820	2820	0.20	3.82	1	6	5
0023	3T	03_10	136	3	0	300	0	-300	0.00	0.00	0	0	0
0023	3T	03_10	146	6	0	600	0	-600	0.00	0.00	1	0	-1
0023	3T	03_10	156	2	0	200	0	-200	0.00	0.00	0	0	0
0023	3T	03_11	123	28	9	2800	8510	5710	0.32	3.04	4	15	11
0023	3T	03_11	124	51	2	5100	1570	-3530	0.04	0.31	9	2	-7
0023	3T	03_11	125	21	0	2100	0	-2100	0.00	0.00	3	0	-3
0023	3T	03_11	126	19	1	1900	5130	3230	0.05	2.70	3	9	6
0023	3T	03_11	134	13	2	1300	2050	750	0.15	1.58	2	3	1
0023	3T	03_11	135	16	2	1600	2110	510	0.13	1.32	2	3	1
0023	3T	03_11	136	15	1	1500	1680	180	0.07	1.12	2	2	0
0023	3T	03_12	123	33	5	3300	4460	1160	0.15	1.35	5	7	2
0023	3T	03_12	124	86	5	8600	5450	-3150	0.06	0.63	15	9	-6
0023	3T	03_12	125	15	0	1500	0	-1500	0.00	0.00	2	0	-2
0023	3T	03_12	126	13	1	1300	2760	1460	0.08	2.12	2	4	2
0023	3T	03_12	134	13	1	1300	670	-630	0.08	0.52	2	1	-1
0023	3T	03_12	135	3	0	300	0	-300	0.00	0.00	0	0	0
0023	3T	03_12	136	3	0	300	0	-300	0.00	0.00	0	0	0
0023	3T	03_12	146	1	1	100	2590	2490	1.00	25.90	0	4	4
0023	3T	03_12	156	1	0	100	0	-100	0.00	0.00	0	0	0
0023	3T	03_12	246	1	0	100	0	-100	0.00	0.00	0	0	0
0023	3T	03_2	123	14	2	1400	1950	550	0.14	1.39	2	3	1
0023	3T	03_2	124	15	1	1500	1990	490	0.07	1.33	2	3	1
0023	3T	03_2	125	19	0	1900	0	-1900	0.00	0.00	3	0	-3
0023	3T	03_2	126	9	1	900	3290	2390	0.11	3.66	1	5	4
0023	3T	03_2	132	1	0	100	0	-100	0.00	0.00	0	0	0
0023	3T	03_2	134	8	3	800	2790	1990	0.38	3.49	1	4	3
0023	3T	03_2	135	8	0	800	0	-800	0.00	0.00	1	0	-1
0023	3T	03_2	136	11	1	1100	5200	4100	0.09	4.73	1	9	8
0023	3T	03_2	143	1	0	100	0	-100	0.00	0.00	0	0	0
0023	3T	03_2	145	1	0	100	0	-100	0.00	0.00	0	0	0
0023	3T	03_2	146	6	0	600	0	-600	0.00	0.00	1	0	-1
0023	3T	03_2	156	2	0	200	0	-200	0.00	0.00	0	0	0
0023	3T	03_2	245	1	0	100	0	-100	0.00	0.00	0	0	0
0023	3T	03_2	246	1	0	100	0	-100	0.00	0.00	0	0	0
0023	3T	03_3	123	12	1	1200	550	-650	0.08	0.46	2	0	-2
0023	3T	03_3	124	6	0	600	0	-600	0.00	0.00	1	0	-1
0023	3T	03_3	125	16	3	1600	3880	2280	0.19	2.43	2	6	4
0023	3T	03_3	126	15	1	1500	820	-680	0.07	0.55	2	1	-1
0023	3T	03_3	134	16	0	1600	0	-1600	0.00	0.00	2	0	-2
0023	3T	03_3	135	9	2	900	2340	1440	0.22	2.60	1	4	3
0023	3T	03_3	136	6	0	600	0	-600	0.00	0.00	1	0	-1
0023	3T	03_3	145	3	0	300	0	-300	0.00	0.00	0	0	0
0023	3T	03_3	146	5	0	500	0	-500	0.00	0.00	0	0	0
0023	3T	03_3	154	1	0	100	0	-100	0.00	0.00	0	0	0
0023	3T	03_3	156	3	0	300	0	-300	0.00	0.00	0	0	0
0023	3T	03_3	235	2	0	200	0	-200	0.00	0.00	0	0	0
0023	3T	03_3	246	3	0	300	0	-300	0.00	0.00	0	0	0
0023	3T	03_3	256	1	0	100	0	-100	0.00	0.00	0	0	0
0023	3T	03_4	123	11	0	1100	0	-1100	0.00	0.00	1	0	-1
0023	3T	03_4	124	12	0	1200	0	-1200	0.00	0.00	2	0	-2
0023	3T	03_4	125	14	1	1400	1120	-280	0.07	0.80	2	1	-1
0023	3T	03_4	126	13	0	1300	0	-1300	0.00	0.00	2	0	-2
0023	3T	03_4	134	7	0	700	0	-700	0.00	0.00	1	0	-1
0023	3T	03_4	135	9	1	900	1580	680	0.11	1.76	1	2	1
0023	3T	03_4	136	10	0	1000	0	-1000	0.00	0.00	1	0	-1
0023	3T	03_4	145	6	1	600	710	110	0.17	1.18	1	1	0
0023	3T	03_4	146	7	0	700	0	-700	0.00	0.00	1	0	-1
0023	3T	03_4	156	5	0	500	0	-500	0.00	0.00	0	0	0
0023	3T	03_4	213	1	0	100	0	-100	0.00	0.00	0	0	0
0023	3T	03_4	236	1	0	100	0	-100	0.00	0.00	0	0	0
0023	3T	03_4	245	1	0	100	0	-100	0.00	0.00	0	0	0
0023	3T	03_4	246	2	0	200	0	-200	0.00	0.00	0	0	0
0023	3T	03_5	123	10	0	1000	0	-1000	0.00	0.00	1	0	-1
0023	3T	03_5	124	11	1	1100	860	-240	0.09	0.78	1	1	0
0023	3T	03_5	125	10	0	1000	0	-1000	0.00	0.00	1	0	-1
0023	3T	03_5	126	16	0	1600	0	-1600	0.00	0.00	2	0	-2
0023	3T	03_5	134	12	0	1200	0	-1200	0.00	0.00	2	0	-2
0023	3T	03_5	135	13	2	1300	1500	200	0.15	1.15	2	2	0
0023	3T	03_5	136	13	1	1300	1130	-170	0.08	0.87	2	2	0
0023	3T	03_5	143	1	1	100	2920	2820	1.00	29.20	0	5	5
0023	3T	03_5	145	6	0	600	0	-600	0.00	0.00	1	0	-1
0023	3T	03_5	146	3	0	300	0	-300	0.00	0.00	0	0	0
0023	3T	03_5	156	1	0	100	0	-100	0.00	0.00	0	0	0
0023	3T	03_5	164	1	0	100	0	-100	0.00	0.00	0	0	0
0023	3T	03_5	236	1	0	100	0	-100	0.00	0.00	0	0	0
0023	3T	03_5	245	2	0	200	0	-200	0.00	0.00	0	0	0
0023	3T	03_5	246	1	0	100	0	-100	0.00	0.00	0	0	0
0023	3T	03_5	256	1	0	100	0	-100	0.00	0.00	0	0	0
0023	3T	03_6	123	8	2	800	2430	1630	0.25	3.04	1	4	3
0023	3T	03_6	124	18	0	1800	0	-1800	0.00	0.00	3	0	-3
0023	3T	03_6	125	7	2	700	1460	760	0.29	2.09	1	2	1
0023	3T	03_6	126	16	1	1600	2750	1150	0.06	1.72	2	4	2
0023	3T	03_6	134	9	2	900	2350	1450	0.22	2.61	1	4	3
0023	3T	03_6	135	11	0	1100	0	-1100	0.00	0.00	1	0	-1
0023	3T	03_6	136	14	2	1400	4360	2960	0.14	3.11	2	7	5
0023	3T	03_6	145	7	0	700	0	-700	0.00	0.00	1	0	-1
0023	3T	03_6	146	5	0	500	0	-500	0.00	0.00	0	0	0
0023	3T	03_6	154	1	0	100	0	-100	0.00	0.00	0	0	0
0023	3T	03_6	156	5	0	500	0	-500	0.00	0.00	0	0	0
0023	3T	03_6	163	1	0	100	0	-100	0.00	0.00	0	0	0
0052	2T	14	12	575	109	57500	36180	-21320	0.19	0.63	101	64	-37
0052	2T	14	13	372	61	37200	22430	-14770	0.16	0.60	65	39	-26
0052	2T	14	14	307	48	30700	20470	-10230	0.16	0.67	54	36	-18
0052	2T	14	15	195	15	19500	14010	-5490	0.08	0.72	34	24	-10
0052	2T	14	16	119	13	11900	10260	-1640	0.11	0.86	21	18	-3
0052	2T	14	21	96	16	9600	12050	2450	0.17	1.26	16	21	5
0052	2T	14	23	88	9	8800	10190	1390	0.10	1.16	15	18	3
0052	2T	14	24	61	4	6100	3830	-2270	0.07	0.63	10	6	-4
0052	2T	14	25	47	6	4700	9580	4880	0.13	2.04	8	16	8
0052	2T	14	26	30	5	3000	4480	1480	0.17	1.49	5	7	2
0052	2T	15	12	713	170	71300	57950	-13350	0.24	0.81	126	102	-24
0052	2T	15	13	444	74	44400	26750	-17650	0.17	0.60	78	47	-31
0052	2T	15	14	404	70	40400	34920	-5480	0.17	0.86	71	61	-10
0052	2T	15	15	217	19	21700	10790	-10910	0.09	0.50	38	19	-19
0052	2T	15	16	140	11	14000	10940	-3060	0.08	0.78	24	19	-5
0052	2T	15	21	90	6	9000	6570	-2430	0.07	0.73	15	11	-4
0052	2T	15	23	82	2	8200	2220	-5980	0.02	0.27	14	3	-11
0052	2T	15	24	64	6	6400	8990	2590	0.09	1.40	11	15	4
0052	2T	15	25	35	1	3500	720	-2780	0.03	0.21	6	1	-5
0052	2T	15	26	36	4	3600	4650	1050	0.11	1.29	6	8	2
0052	2T	16	12	710	183	71000	59430	-11570	0.26	0.84	125	105	-20
0052	2T	16	13	506	87	50600	34870	-15730	0.17	0.69	89	61	-28
0052	2T	16	14	423	82	42300	35610	-6690	0.19	0.84	74	63	-11
0052	2T	16	15	199	20	19900	14040	-5860	0.10	0.71	35	24	-11
0052	2T	16	16	134	8	13400	8840	-4560	0.06	0.66	23	15	-8
0052	2T	16	21	105	8	10500	3760	-6740	0.08	0.36	18	6	-12
0052	2T	16	23	80	4	8000	8480	480	0.05	1.06	14	15	1
0052	2T	16	24	71	2	7100	4950	-2150	0.03	0.70	12	8	-4
0052	2T	16	25	47	6	4700	7250	2550	0.13	1.54	8	12	4
0052	2T	16	26	39	3	3900	7230	3330	0.08	1.85	6	12	6
0052	2T	17	12	757	180	75700	57510	-18190	0.24	0.76	133	101	-32
0052	2T	17	13	526	112	52600	38510	-14090	0.21	0.73	93	68	-25
0052	2T	17	14	385	54	38500	24260	-14240	0.14	0.63	68	42	-26
0052	2T	17	15	194	12	19400	8710	-10690	0.06	0.45	34	15	-19
0052	2T	17	16	107	10	10700	14160	3460	0.09	1.32	18	25	7
0052	2T	17	21	88	9	8800	6400	-2400	0.10	0.73	15	11	-4
0052	2T	17	23	71	6	7100	5140	-1960	0.08	0.72	12	9	-3
0052	2T	17	24	51	2	5100	1670	-3430	0.04	0.33	9	2	-7
0052	2T	17	25	42	2	4200	940	-3260	0.05	0.22	7	1	-6
0052	2T	17	26	30	3	3000	2130	-870	0.10	0.71	5	3	-2
0052	2T	18	12	832	276	83200	76350	-6850	0.33	0.92	147	135	-12
0052	2T	18	13	511	104	51100	39270	-11830	0.20	0.77	90	69	-21
0052	2T	18	14	448	86	44800	41330	-3470	0.19	0.92	79	73	-6
0052	2T	18	15	265	43	26500	25310	-1190	0.16	0.96	46	44	-2
0052	2T	18	16	122	9	12200	5910	-6290	0.07	0.48	21	10	-11
0052	2T	18	21	89	11	8900	6190	-2710	0.12	0.70	15	10	-5
0052	2T	18	23	75	6	7500	5710	-1790	0.08	0.76	13	10	-3
0052	2T	18	24	48	2	4800	1230	-3570	0.04	0.26	8	2	-6
0052	2T	18	25	41	3	4100	1190	-2910	0.07	0.29	7	2	-5
0052	2T	18	26	24	3	2400	3480	1080	0.13	1.45	4	6	2
0052	2T	19	12	689	173	68900	58650	-10250	0.25	0.85	121	103	-18
0052	2T	19	13	479	101	47900	37250	-10650	0.21	0.78	84	65	-19
0052	2T	19	14	396	89	39600	36280	-3320	0.22	0.92	70	64	-6
0052	2T	19	15	173	17	17300	14730	-2570	0.10	0.85	30	26	-4
0052	2T	19	16	98	7	9800	4600	-5200	0.07	0.47	17	8	-9
0052	2T	19	21	68	13	6800	19140	12340	0.19	2.81	12	33	21
0052	2T	19	23	62	4	6200	3070	-3130	0.06	0.50	10	5	-5
0052	2T	19	24	59	5	5900	2450	-3450	0.08	0.42	10	4	-6
0052	2T	19	25	28	2	2800	3480	680	0.07	1.24	4	6	2
0052	2T	19	26	39	3	3900	2340	-1560	0.08	0.60	6	4	-2
0052	2T	20	12	697	169	69700	52130	-17570	0.24	0.75	123	92	-31
0052	2T	20	13	471	109	47100	43540	-3560	0.23	0.92	83	77	-6
0052	2T	20	14	381	60	38100	29570	-8530	0.16	0.78	67	52	-15
0052	2T	20	15	229	38	22900	22030	-870	0.17	0.96	40	38	-2
0052	2T	20	16	140	16	14000	9930	-4070	0.11	0.71	24	17	-7
0052	2T	20	21	87	11	8700	5740	-2960	0.13	0.66	15	10	-5
0052	2T	20	23	60	3	6000	2080	-3920	0.05	0.35	10	3	-7
0052	2T	20	24	39	4	3900	9050	5150	0.10	2.32	6	16	10
0052	2T	20	25	40	0	4000	0	-4000	0.00	0.00	7	0	-7
0052	2T	20	26	23	3	2300	11900	9600	0.13	5.17	4	21	17
0023	3T	03_6	213	1	0	100	0	-100	0.00	0.00	0	0	0
0052	2T	21	12	825	213	82500	65970	-16530	0.26	0.80	146	116	-30
0052	2T	21	13	604	163	60400	54550	-5850	0.27	0.90	106	96	-10
0052	2T	21	14	404	76	40400	30580	-9820	0.19	0.76	71	54	-17
0052	2T	21	15	258	30	25800	19580	-6220	0.12	0.76	45	34	-11
0052	2T	21	16	98	4	9800	2950	-6850	0.04	0.30	17	5	-12
0052	2T	21	21	64	6	6400	5510	-890	0.09	0.86	11	9	-2
0052	2T	21	23	39	4	3900	4040	140	0.10	1.04	6	7	1
0052	2T	21	24	33	2	3300	950	-2350	0.06	0.29	5	1	-4
0052	2T	21	25	21	0	2100	0	-2100	0.00	0.00	3	0	-3
0052	2T	21	26	13	0	1300	0	-1300	0.00	0.00	2	0	-2
0052	2T	22	12	507	128	50700	43790	-6910	0.25	0.86	89	77	-12
0052	2T	22	13	388	77	38800	30360	-8440	0.20	0.78	68	53	-15
0052	2T	22	14	275	34	27500	14900	-12600	0.12	0.54	48	26	-22
0052	2T	22	15	166	20	16600	19560	2960	0.12	1.18	29	34	5
0052	2T	22	16	99	2	9900	1670	-8230	0.02	0.17	17	2	-15
0052	2T	22	21	114	15	11400	8180	-3220	0.13	0.72	20	14	-6
0052	2T	22	23	91	8	9100	7390	-1710	0.09	0.81	16	13	-3
0052	2T	22	24	56	3	5600	2260	-3340	0.05	0.40	9	4	-5
0052	2T	22	25	55	6	5500	4630	-870	0.11	0.84	9	8	-1
0052	2T	22	26	22	0	2200	0	-2200	0.00	0.00	3	0	-3
0052	2T	23	12	651	145	65100	40490	-24610	0.22	0.62	115	71	-44
0052	2T	23	13	463	103	46300	40030	-6270	0.22	0.86	81	70	-11
0052	2T	23	14	315	41	31500	29480	-2020	0.13	0.94	55	52	-3
0052	2T	23	15	179	23	17900	14730	-3170	0.13	0.82	31	26	-5
0052	2T	23	16	104	14	10400	13020	2620	0.13	1.25	18	23	5
0052	2T	23	21	73	9	7300	5130	-2170	0.12	0.70	12	9	-3
0052	2T	23	23	84	9	8400	8390	-10	0.11	1.00	14	14	0
0052	2T	23	24	64	4	6400	4130	-2270	0.06	0.65	11	7	-4
0052	2T	23	25	31	2	3100	2590	-510	0.06	0.84	5	4	-1
0052	2T	23	26	27	1	2700	1360	-1340	0.04	0.50	4	2	-2
0052	2T	24	12	856	250	85600	66330	-19270	0.29	0.77	151	117	-34
0052	2T	24	13	533	127	53300	41610	-11690	0.24	0.78	94	73	-21
0052	2T	24	14	389	70	38900	28020	-10880	0.18	0.72	68	49	-19
0052	2T	24	15	170	22	17000	20320	3320	0.13	1.20	30	35	5
0052	2T	24	16	138	20	13800	15900	2100	0.14	1.15	24	28	4
0052	2T	24	21	51	5	5100	2770	-2330	0.10	0.54	9	4	-5
0052	2T	24	23	68	6	6800	9360	2560	0.09	1.38	12	16	4
0052	2T	24	24	32	2	3200	1110	-2090	0.06	0.35	5	1	-4
0052	2T	24	25	21	1	2100	420	-1680	0.05	0.20	3	0	-3
0052	2T	24	26	21	4	2100	4770	2670	0.19	2.27	3	8	5
0052	3F	01	123	230	52	23000	18950	-4050	0.23	0.82	40	33	-7
0052	3F	01	124	202	26	20200	12130	-8070	0.13	0.60	35	21	-14
0052	3F	01	125	171	30	17100	15970	-1130	0.18	0.93	30	28	-2
0052	3F	01	126	163	16	16300	14030	-2270	0.10	0.86	28	24	-4
0052	3F	01	134	110	13	11000	9870	-1130	0.12	0.90	19	17	-2
0052	3F	01	135	127	15	12700	11100	-1600	0.12	0.87	22	19	-3
0052	3F	01	136	90	6	9000	3500	-5500	0.07	0.39	15	6	-9
0052	3F	01	145	76	6	7600	6860	-740	0.08	0.90	13	12	-1
0052	3F	01	146	67	4	6700	6670	-30	0.06	1.00	11	11	0
0052	3F	01	156	54	4	5400	2840	-2560	0.07	0.53	9	5	-4
0052	3F	01	234	30	2	3000	820	-2180	0.07	0.27	5	1	-4
0052	3F	01	235	18	0	1800	0	-1800	0.00	0.00	3	0	-3
0052	3F	01	236	19	1	1900	430	-1470	0.05	0.23	3	0	-3
0052	3F	01	245	16	3	1600	4240	2640	0.19	2.65	2	7	5
0052	3F	01	246	11	0	1100	0	-1100	0.00	0.00	1	0	-1
0052	3F	01	256	8	0	800	0	-800	0.00	0.00	1	0	-1
0052	3F	02	123	237	45	23700	17270	-6430	0.19	0.73	41	30	-11
0052	3F	02	124	212	28	21200	12170	-9030	0.13	0.57	37	21	-16
0052	3F	02	125	137	16	13700	17060	3360	0.12	1.25	24	30	6
0052	3F	02	126	158	19	15800	18500	2700	0.12	1.17	27	32	5
0052	3F	02	134	144	15	14400	11100	-3300	0.10	0.77	25	19	-6
0052	3F	02	135	111	13	11100	7660	-3440	0.12	0.69	19	13	-6
0052	3F	02	136	92	7	9200	3870	-5330	0.08	0.42	16	6	-10
0052	3F	02	145	92	6	9200	3240	-5960	0.07	0.35	16	5	-11
0052	3F	02	146	72	5	7200	5200	-2000	0.07	0.72	12	9	-3
0052	3F	02	156	44	1	4400	890	-3510	0.02	0.20	7	1	-6
0052	3F	02	234	28	3	2800	1390	-1410	0.11	0.50	4	2	-2
0052	3F	02	235	27	2	2700	1570	-1130	0.07	0.58	4	2	-2
0052	3F	02	236	24	2	2400	1460	-940	0.08	0.61	4	2	-2
0052	3F	02	245	23	3	2300	3100	800	0.13	1.35	4	5	1
0052	3F	02	246	14	0	1400	0	-1400	0.00	0.00	2	0	-2
0052	3F	02	256	5	1	500	1290	790	0.20	2.58	0	2	2
0052	3F	03	123	170	30	17000	13570	-3430	0.18	0.80	30	24	-6
0052	3F	03	124	160	32	16000	18510	2510	0.20	1.16	28	32	4
0052	3F	03	125	113	8	11300	3840	-7460	0.07	0.34	20	6	-14
0052	3F	03	126	105	18	10500	15550	5050	0.17	1.48	18	27	9
0052	3F	03	134	102	8	10200	7150	-3050	0.08	0.70	18	12	-6
0052	3F	03	135	89	9	8900	5260	-3640	0.10	0.59	15	9	-6
0052	3F	03	136	52	4	5200	3340	-1860	0.08	0.64	9	5	-4
0052	3F	03	145	75	8	7500	5550	-1950	0.11	0.74	13	9	-4
0052	3F	03	146	43	3	4300	2830	-1470	0.07	0.66	7	5	-2
0052	3F	03	156	35	2	3500	1130	-2370	0.06	0.32	6	2	-4
0052	3F	03	234	20	0	2000	0	-2000	0.00	0.00	3	0	-3
0052	3F	03	235	25	2	2500	1240	-1260	0.08	0.50	4	2	-2
0052	3F	03	236	12	1	1200	3440	2240	0.08	2.87	2	6	4
0052	3F	03	245	25	1	2500	560	-1940	0.04	0.22	4	0	-4
0052	3F	03	246	12	1	1200	750	-450	0.08	0.63	2	1	-1
0052	3F	03	256	6	0	600	0	-600	0.00	0.00	1	0	-1
0052	3F	04	123	212	45	21200	20120	-1080	0.21	0.95	37	35	-2
0052	3F	04	124	186	23	18600	11370	-7230	0.12	0.61	32	20	-12
0052	3F	04	125	134	18	13400	14840	1440	0.13	1.11	23	26	3
0052	3F	04	126	115	13	11500	6450	-5050	0.11	0.56	20	11	-9
0052	3F	04	134	127	17	12700	13010	310	0.13	1.02	22	23	1
0052	3F	04	135	86	12	8600	8280	-320	0.14	0.96	15	14	-1
0052	3F	04	136	71	3	7100	2790	-4310	0.04	0.39	12	4	-8
0052	3F	04	145	74	10	7400	10090	2690	0.14	1.36	13	17	4
0052	3F	04	146	67	2	6700	920	-5780	0.03	0.14	11	1	-10
0052	3F	04	156	49	5	4900	3770	-1130	0.10	0.77	8	6	-2
0052	3F	04	234	28	3	2800	3750	950	0.11	1.34	4	6	2
0052	3F	04	235	20	1	2000	180	-1820	0.05	0.09	3	0	-3
0052	3F	04	236	13	3	1300	1180	-120	0.23	0.91	2	2	0
0052	3F	04	245	19	1	1900	600	-1300	0.05	0.32	3	1	-2
0052	3F	04	246	18	2	1800	4210	2410	0.11	2.34	3	7	4
0052	3F	04	256	14	0	1400	0	-1400	0.00	0.00	2	0	-2
0052	3F	05	123	255	53	25500	26030	530	0.21	1.02	45	46	1
0052	3F	05	124	208	41	20800	17610	-3190	0.20	0.85	36	31	-5
0052	3F	05	125	157	13	15700	21610	5910	0.08	1.38	27	38	11
0052	3F	05	126	160	14	16000	15440	-560	0.09	0.97	28	27	-1
0052	3F	05	134	165	22	16500	13830	-2670	0.13	0.84	29	24	-5
0052	3F	05	135	111	10	11100	5350	-5750	0.09	0.48	19	9	-10
0052	3F	05	136	86	13	8600	10620	2020	0.15	1.23	15	18	3
0052	3F	05	145	95	12	9500	9040	-460	0.13	0.95	16	16	0
0052	3F	05	146	68	6	6800	5700	-1100	0.09	0.84	12	10	-2
0052	3F	05	156	51	6	5100	7900	2800	0.12	1.55	9	13	4
0052	3F	05	234	30	2	3000	530	-2470	0.07	0.18	5	0	-5
0052	3F	05	235	24	1	2400	320	-2080	0.04	0.13	4	0	-4
0052	3F	05	236	27	0	2700	0	-2700	0.00	0.00	4	0	-4
0052	3F	05	245	22	3	2200	1270	-930	0.14	0.58	3	2	-1
0052	3F	05	246	16	1	1600	970	-630	0.06	0.61	2	1	-1
0052	3F	05	256	21	0	2100	0	-2100	0.00	0.00	3	0	-3
0052	3F	06	123	234	42	23400	17180	-6220	0.18	0.73	41	30	-11
0052	3F	06	124	210	44	21000	22440	1440	0.21	1.07	37	39	2
0052	3F	06	125	177	22	17700	13820	-3880	0.12	0.78	31	24	-7
0052	3F	06	126	175	20	17500	14430	-3070	0.11	0.82	30	25	-5
0052	3F	06	134	140	27	14000	14880	880	0.19	1.06	24	26	2
0052	3F	06	135	113	11	11300	4230	-7070	0.10	0.37	20	7	-13
0052	3F	06	136	93	13	9300	9210	-90	0.14	0.99	16	16	0
0052	3F	06	145	106	8	10600	3740	-6860	0.08	0.35	18	6	-12
0052	3F	06	146	91	5	9100	6370	-2730	0.05	0.70	16	11	-5
0052	3F	06	156	69	5	6900	6750	-150	0.07	0.98	12	11	-1
0052	3F	06	234	21	2	2100	800	-1300	0.10	0.38	3	1	-2
0052	3F	06	235	23	1	2300	1760	-540	0.04	0.77	4	3	-1
0052	3F	06	236	18	3	1800	1310	-490	0.17	0.73	3	2	-1
0052	3F	06	245	17	4	1700	1820	120	0.24	1.07	3	3	0
0052	3F	06	246	21	1	2100	160	-1940	0.05	0.08	3	0	-3
0052	3F	06	256	18	3	1800	6520	4720	0.17	3.62	3	11	8
0052	3F	07	123	227	40	22700	17390	-5310	0.18	0.77	40	30	-10
0052	3F	07	124	214	33	21400	15110	-6290	0.15	0.71	37	26	-11
0052	3F	07	125	180	20	18000	13650	-4350	0.11	0.76	31	24	-7
0052	3F	07	126	172	17	17200	14240	-2960	0.10	0.83	30	25	-5
0052	3F	07	134	147	29	14700	10330	-4370	0.20	0.70	26	18	-8
0052	3F	07	135	143	24	14300	12610	-1690	0.17	0.88	25	22	-3
0052	3F	07	136	87	5	8700	2020	-6680	0.06	0.23	15	3	-12
0052	3F	07	145	138	17	13800	17760	3960	0.12	1.29	24	31	7
0052	3F	07	146	84	5	8400	2720	-5680	0.06	0.32	14	4	-10
0052	3F	07	156	62	6	6200	3950	-2250	0.10	0.64	10	6	-4
0052	3F	07	234	16	0	1600	0	-1600	0.00	0.00	2	0	-2
0052	3F	07	235	23	3	2300	790	-1510	0.13	0.34	4	1	-3
0052	3F	07	236	17	0	1700	0	-1700	0.00	0.00	3	0	-3
0052	3F	07	245	14	0	1400	0	-1400	0.00	0.00	2	0	-2
0052	3F	07	246	20	1	2000	600	-1400	0.05	0.30	3	1	-2
0052	3F	07	256	21	2	2100	2200	100	0.10	1.05	3	3	0
0052	3F	08	123	270	52	27000	18730	-8270	0.19	0.69	47	33	-14
0052	3F	08	124	201	41	20100	16210	-3890	0.20	0.81	35	28	-7
0052	3F	08	125	166	21	16600	14790	-1810	0.13	0.89	29	26	-3
0052	3F	08	126	156	18	15600	12080	-3520	0.12	0.77	27	21	-6
0052	3F	08	134	168	27	16800	14540	-2260	0.16	0.87	29	25	-4
0052	3F	08	135	104	9	10400	6330	-4070	0.09	0.61	18	11	-7
0052	3F	08	136	122	6	12200	2460	-9740	0.05	0.20	21	4	-17
0052	3F	08	145	83	13	8300	9530	1230	0.16	1.15	14	16	2
0052	3F	08	146	101	7	10100	8490	-1610	0.07	0.84	17	15	-2
0052	3F	08	156	64	4	6400	3110	-3290	0.06	0.49	11	5	-6
0052	3F	08	234	22	5	2200	2620	420	0.23	1.19	3	4	1
0052	3F	08	235	21	2	2100	1930	-170	0.10	0.92	3	3	0
0052	3F	08	236	12	0	1200	0	-1200	0.00	0.00	2	0	-2
0052	3F	08	245	17	2	1700	2370	670	0.12	1.39	3	4	1
0052	3F	08	246	20	2	2000	2100	100	0.10	1.05	3	3	0
0052	3F	08	256	13	0	1300	0	-1300	0.00	0.00	2	0	-2
0052	3F	09	123	308	84	30800	26720	-4080	0.27	0.87	54	47	-7
0052	3F	09	124	289	51	28900	20380	-8520	0.18	0.71	51	36	-15
0052	3F	09	125	166	26	16600	13750	-2850	0.16	0.83	29	24	-5
0052	3F	09	126	158	17	15800	12540	-3260	0.11	0.79	27	22	-5
0052	3F	09	134	176	26	17600	13910	-3690	0.15	0.79	31	24	-7
0052	3F	09	135	139	27	13900	16470	2570	0.19	1.18	24	29	5
0052	3F	09	136	87	8	8700	11100	2400	0.09	1.28	15	19	4
0052	3F	09	145	106	5	10600	3160	-7440	0.05	0.30	18	5	-13
0052	3F	09	146	75	4	7500	3570	-3930	0.05	0.48	13	6	-7
0052	3F	09	156	41	0	4100	0	-4100	0.00	0.00	7	0	-7
0052	3F	09	234	35	4	3500	1970	-1530	0.11	0.56	6	3	-3
0052	3F	09	235	26	2	2600	470	-2130	0.08	0.18	4	0	-4
0052	3F	09	236	26	3	2600	1660	-940	0.12	0.64	4	2	-2
0052	3F	09	245	20	0	2000	0	-2000	0.00	0.00	3	0	-3
0052	3F	09	246	17	1	1700	670	-1030	0.06	0.39	3	1	-2
0052	3F	09	256	11	2	1100	1360	260	0.18	1.24	1	2	1
0052	3F	10	123	283	63	28300	22140	-6160	0.22	0.78	50	39	-11
0052	3F	10	124	201	43	20100	15140	-4960	0.21	0.75	35	26	-9
0052	3F	10	125	162	12	16200	10050	-6150	0.07	0.62	28	17	-11
0052	3F	10	126	131	12	13100	14600	1500	0.09	1.11	23	25	2
0052	3F	10	134	184	33	18400	14030	-4370	0.18	0.76	32	24	-8
0052	3F	10	135	140	17	14000	9750	-4250	0.12	0.70	24	17	-7
0052	3F	10	136	93	3	9300	2460	-6840	0.03	0.26	16	4	-12
0052	3F	10	145	94	12	9400	6480	-2920	0.13	0.69	16	11	-5
0052	3F	10	146	75	5	7500	2950	-4550	0.07	0.39	13	5	-8
0052	3F	10	156	33	3	3300	3030	-270	0.09	0.92	5	5	0
0052	3F	10	234	29	2	2900	1060	-1840	0.07	0.37	5	1	-4
0052	3F	10	235	23	4	2300	1850	-450	0.17	0.80	4	3	-1
0052	3F	10	236	13	1	1300	1530	230	0.08	1.18	2	2	0
0052	3F	10	245	20	1	2000	320	-1680	0.05	0.16	3	0	-3
0052	3F	10	246	12	0	1200	0	-1200	0.00	0.00	2	0	-2
0052	3F	10	256	16	0	1600	0	-1600	0.00	0.00	2	0	-2
0052	3F	11	123	267	55	26700	23960	-2740	0.21	0.90	47	42	-5
0052	3F	11	124	223	39	22300	19500	-2800	0.17	0.87	39	34	-5
0052	3F	11	125	120	15	12000	9650	-2350	0.13	0.80	21	17	-4
0052	3F	11	126	117	14	11700	9720	-1980	0.12	0.83	20	17	-3
0052	3F	11	134	143	20	14300	12010	-2290	0.14	0.84	25	21	-4
0052	3F	11	135	92	8	9200	10460	1260	0.09	1.14	16	18	2
0052	3F	11	136	74	7	7400	7850	450	0.09	1.06	13	13	0
0052	3F	11	145	67	10	6700	6650	-50	0.15	0.99	11	11	0
0052	3F	11	146	68	4	6800	2270	-4530	0.06	0.33	12	4	-8
0052	3F	11	156	42	1	4200	420	-3780	0.02	0.10	7	0	-7
0052	3F	11	234	37	0	3700	0	-3700	0.00	0.00	6	0	-6
0052	3F	11	235	25	5	2500	6090	3590	0.20	2.44	4	10	6
0052	3F	11	236	15	1	1500	210	-1290	0.07	0.14	2	0	-2
0052	3F	11	245	21	2	2100	2290	190	0.10	1.09	3	4	1
0052	3F	11	246	11	2	1100	1230	130	0.18	1.12	1	2	1
0052	3F	11	256	14	1	1400	930	-470	0.07	0.66	2	1	-1
0052	3F	12	123	255	64	25500	27480	1980	0.25	1.08	45	48	3
0052	3F	12	124	240	34	24000	13790	-10210	0.14	0.57	42	24	-18
0052	3F	12	125	175	22	17500	13050	-4450	0.13	0.75	30	23	-7
0052	3F	12	126	128	18	12800	6000	-6800	0.14	0.47	22	10	-12
0052	3F	12	134	128	10	12800	5020	-7780	0.08	0.39	22	8	-14
0052	3F	12	135	98	7	9800	3460	-6340	0.07	0.35	17	6	-11
0052	3F	12	136	74	11	7400	8890	1490	0.15	1.20	13	15	2
0052	3F	12	145	84	10	8400	8440	40	0.12	1.00	14	14	0
0052	3F	12	146	58	4	5800	3590	-2210	0.07	0.62	10	6	-4
0052	3F	12	156	54	2	5400	850	-4550	0.04	0.16	9	1	-8
0052	3F	12	234	31	4	3100	2660	-440	0.13	0.86	5	4	-1
0052	3F	12	235	24	0	2400	0	-2400	0.00	0.00	4	0	-4
0052	3F	12	236	8	0	800	0	-800	0.00	0.00	1	0	-1
0052	3F	12	245	24	1	2400	1600	-800	0.04	0.67	4	2	-2
0052	3F	12	246	14	1	1400	700	-700	0.07	0.50	2	1	-1
0052	3F	12	256	7	1	700	350	-350	0.14	0.50	1	0	-1
0052	3F	13	123	227	45	22700	17020	-5680	0.20	0.75	40	30	-10
0052	3F	13	124	238	44	23800	18130	-5670	0.18	0.76	42	32	-10
0052	3F	13	125	138	23	13800	15760	1960	0.17	1.14	24	27	3
0052	3F	13	126	122	22	12200	16440	4240	0.18	1.35	21	29	8
0052	3F	13	134	167	23	16700	11110	-5590	0.14	0.67	29	19	-10
0052	3F	13	135	103	10	10300	4250	-6050	0.10	0.41	18	7	-11
0052	3F	13	136	75	7	7500	4050	-3450	0.09	0.54	13	7	-6
0052	3F	13	145	91	8	9100	8400	-700	0.09	0.92	16	14	-2
0052	3F	13	146	67	6	6700	3990	-2710	0.09	0.60	11	7	-4
0052	3F	13	156	41	6	4100	4940	840	0.15	1.20	7	8	1
0052	3F	13	234	35	5	3500	2000	-1500	0.14	0.57	6	3	-3
0052	3F	13	235	12	2	1200	1170	-30	0.17	0.98	2	2	0
0052	3F	13	236	13	1	1300	490	-810	0.08	0.38	2	0	-2
0052	3F	13	245	16	1	1600	550	-1050	0.06	0.34	2	0	-2
0052	3F	13	246	12	0	1200	0	-1200	0.00	0.00	2	0	-2
0052	3F	13	256	7	0	700	0	-700	0.00	0.00	1	0	-1
0052	3F	14	123	223	39	22300	16640	-5660	0.17	0.75	39	29	-10
0052	3F	14	124	215	30	21500	14480	-7020	0.14	0.67	38	25	-13
0052	3F	14	125	134	8	13400	3160	-10240	0.06	0.24	23	5	-18
0052	3F	14	126	146	9	14600	5340	-9260	0.06	0.37	25	9	-16
0052	3F	14	134	153	18	15300	9060	-6240	0.12	0.59	27	16	-11
0052	3F	14	135	94	5	9400	2890	-6510	0.05	0.31	16	5	-11
0052	3F	14	136	75	8	7500	10190	2690	0.11	1.36	13	18	5
0052	3F	14	145	82	6	8200	6610	-1590	0.07	0.81	14	11	-3
0052	3F	14	146	59	4	5900	2960	-2940	0.07	0.50	10	5	-5
0052	3F	14	156	53	3	5300	5710	410	0.06	1.08	9	10	1
0052	3F	14	234	36	7	3600	6820	3220	0.19	1.89	6	12	6
0052	3F	14	235	21	1	2100	1580	-520	0.05	0.75	3	2	-1
0052	3F	14	236	18	0	1800	0	-1800	0.00	0.00	3	0	-3
0052	3F	14	245	16	0	1600	0	-1600	0.00	0.00	2	0	-2
0052	3F	14	246	18	3	1800	3350	1550	0.17	1.86	3	5	2
0052	3F	14	256	10	0	1000	0	-1000	0.00	0.00	1	0	-1
0052	3F	15	123	264	54	26400	21970	-4430	0.20	0.83	46	38	-8
0052	3F	15	124	267	52	26700	16220	-10480	0.19	0.61	47	28	-19
0052	3F	15	125	162	15	16200	8300	-7900	0.09	0.51	28	14	-14
0052	3F	15	126	149	17	14900	10760	-4140	0.11	0.72	26	19	-7
0052	3F	15	134	175	27	17500	14230	-3270	0.15	0.81	30	25	-5
0052	3F	15	135	103	10	10300	5000	-5300	0.10	0.49	18	8	-10
0052	3F	15	136	89	8	8900	3550	-5350	0.09	0.40	15	6	-9
0052	3F	15	145	106	10	10600	6580	-4020	0.09	0.62	18	11	-7
0052	3F	15	146	74	9	7400	8120	720	0.12	1.10	13	14	1
0052	3F	15	156	55	4	5500	5020	-480	0.07	0.91	9	8	-1
0052	3F	15	234	28	1	2800	570	-2230	0.04	0.20	4	1	-3
0052	3F	15	235	20	2	2000	960	-1040	0.10	0.48	3	1	-2
0052	3F	15	236	19	1	1900	470	-1430	0.05	0.25	3	0	-3
0052	3F	15	245	18	0	1800	0	-1800	0.00	0.00	3	0	-3
0052	3F	15	246	25	3	2500	11930	9430	0.12	4.77	4	21	17
0052	3F	15	256	7	0	700	0	-700	0.00	0.00	1	0	-1
0052	3F	16	123	275	71	27500	20110	-7390	0.26	0.73	48	35	-13
0052	3F	16	124	272	53	27200	20500	-6700	0.19	0.75	48	36	-12
0052	3F	16	125	168	18	16800	10980	-5820	0.11	0.65	29	19	-10
0052	3F	16	126	162	20	16200	13690	-2510	0.12	0.85	28	24	-4
0052	3F	16	134	197	26	19700	13390	-6310	0.13	0.68	34	23	-11
0052	3F	16	135	121	16	12100	12160	60	0.13	1.00	21	21	0
0052	3F	16	136	83	4	8300	4380	-3920	0.05	0.53	14	7	-7
0052	3F	16	145	116	15	11600	11210	-390	0.13	0.97	20	19	-1
0052	3F	16	146	73	3	7300	3590	-3710	0.04	0.49	12	6	-6
0052	3F	16	156	39	3	3900	3690	-210	0.08	0.95	6	6	0
0052	3F	16	234	32	0	3200	0	-3200	0.00	0.00	5	0	-5
0052	3F	16	235	20	3	2000	2690	690	0.15	1.35	3	4	1
0052	3F	16	236	23	3	2300	8610	6310	0.13	3.74	4	15	11
0052	3F	16	245	18	2	1800	890	-910	0.11	0.49	3	1	-2
0052	3F	16	246	22	1	2200	400	-1800	0.05	0.18	3	0	-3
0052	3F	16	256	13	2	1300	6320	5020	0.15	4.86	2	11	9
0052	3F	17	123	299	70	29900	22180	-7720	0.23	0.74	52	39	-13
0052	3F	17	124	268	47	26800	27090	290	0.18	1.01	47	47	0
0052	3F	17	125	187	23	18700	11660	-7040	0.12	0.62	33	20	-13
0052	3F	17	126	146	19	14600	20660	6060	0.13	1.42	25	36	11
0052	3F	17	134	192	29	19200	13630	-5570	0.15	0.71	33	24	-9
0052	3F	17	135	137	16	13700	9400	-4300	0.12	0.69	24	16	-8
0052	3F	17	136	81	11	8100	9770	1670	0.14	1.21	14	17	3
0052	3F	17	145	102	4	10200	1920	-8280	0.04	0.19	18	3	-15
0052	3F	17	146	56	2	5600	2930	-2670	0.04	0.52	9	5	-4
0052	3F	17	156	48	4	4800	2700	-2100	0.08	0.56	8	4	-4
0052	3F	17	234	24	2	2400	2040	-360	0.08	0.85	4	3	-1
0052	3F	17	235	21	0	2100	0	-2100	0.00	0.00	3	0	-3
0052	3F	17	236	18	1	1800	1540	-260	0.06	0.86	3	2	-1
0052	3F	17	245	11	0	1100	0	-1100	0.00	0.00	1	0	-1
0052	3F	17	246	8	0	800	0	-800	0.00	0.00	1	0	-1
0052	3F	17	256	11	0	1100	0	-1100	0.00	0.00	1	0	-1
0052	3F	18	123	296	70	29600	27240	-2360	0.24	0.92	52	48	-4
0052	3F	18	124	280	62	28000	26690	-1310	0.22	0.95	49	47	-2
0052	3F	18	125	213	33	21300	13950	-7350	0.15	0.65	37	24	-13
0052	3F	18	126	174	23	17400	20390	2990	0.13	1.17	30	36	6
0052	3F	18	134	184	40	18400	22630	4230	0.22	1.23	32	40	8
0052	3F	18	135	148	14	14800	8020	-6780	0.09	0.54	26	14	-12
0052	3F	18	136	90	8	9000	4990	-4010	0.09	0.55	15	8	-7
0052	3F	18	145	131	15	13100	12840	-260	0.11	0.98	23	22	-1
0052	3F	18	146	88	4	8800	3940	-4860	0.05	0.45	15	6	-9
0052	3F	18	156	54	3	5400	5140	-260	0.06	0.95	9	9	0
0052	3F	18	234	31	3	3100	7830	4730	0.10	2.53	5	13	8
0052	3F	18	235	23	1	2300	420	-1880	0.04	0.18	4	0	-4
0052	3F	18	236	22	3	2200	5710	3510	0.14	2.60	3	10	7
0052	3F	18	245	16	1	1600	440	-1160	0.06	0.28	2	0	-2
0052	3F	18	246	5	0	500	0	-500	0.00	0.00	0	0	0
0052	3F	18	256	8	1	800	300	-500	0.13	0.38	1	0	-1
0052	3F	19	123	218	45	21800	18070	-3730	0.21	0.83	38	31	-7
0052	3F	19	124	287	69	28700	24190	-4510	0.24	0.84	50	42	-8
0052	3F	19	125	157	15	15700	9920	-5780	0.10	0.63	27	17	-10
0052	3F	19	126	130	18	13000	14410	1410	0.14	1.11	23	25	2
0052	3F	19	134	191	39	19100	15150	-3950	0.20	0.79	33	26	-7
0052	3F	19	135	107	14	10700	11790	1090	0.13	1.10	18	20	2
0052	3F	19	136	93	12	9300	9100	-200	0.13	0.98	16	16	0
0052	3F	19	145	88	9	8800	5060	-3740	0.10	0.58	15	8	-7
0052	3F	19	146	73	8	7300	7020	-280	0.11	0.96	12	12	0
0052	3F	19	156	25	1	2500	2090	-410	0.04	0.84	4	3	-1
0052	3F	19	234	29	4	2900	3160	260	0.14	1.09	5	5	0
0052	3F	19	235	16	1	1600	440	-1160	0.06	0.28	2	0	-2
0052	3F	19	236	19	1	1900	920	-980	0.05	0.48	3	1	-2
0052	3F	19	245	15	1	1500	1020	-480	0.07	0.68	2	1	-1
0052	3F	19	246	15	5	1500	3590	2090	0.33	2.39	2	6	4
0052	3F	19	256	6	0	600	0	-600	0.00	0.00	1	0	-1
0052	3F	20	123	291	55	29100	18570	-10530	0.19	0.64	51	32	-19
0052	3F	20	124	244	44	24400	13550	-10850	0.18	0.56	43	23	-20
0052	3F	20	125	158	19	15800	13910	-1890	0.12	0.88	27	24	-3
0052	3F	20	126	138	13	13800	13240	-560	0.09	0.96	24	23	-1
0052	3F	20	134	165	23	16500	12610	-3890	0.14	0.76	29	22	-7
0052	3F	20	135	126	22	12600	14820	2220	0.17	1.18	22	26	4
0052	3F	20	136	122	13	12200	9450	-2750	0.11	0.77	21	16	-5
0052	3F	20	145	101	15	10100	14500	4400	0.15	1.44	17	25	8
0052	3F	20	146	72	3	7200	3410	-3790	0.04	0.47	12	6	-6
0052	3F	20	156	49	3	4900	2760	-2140	0.06	0.56	8	4	-4
0052	3F	20	234	20	1	2000	1240	-760	0.05	0.62	3	2	-1
0052	3F	20	235	14	0	1400	0	-1400	0.00	0.00	2	0	-2
0052	3F	20	236	14	0	1400	0	-1400	0.00	0.00	2	0	-2
0052	3F	20	245	12	2	1200	890	-310	0.17	0.74	2	1	-1
0052	3F	20	246	14	0	1400	0	-1400	0.00	0.00	2	0	-2
0052	3F	20	256	9	0	900	0	-900	0.00	0.00	1	0	-1
0052	3F	21	123	264	79	26400	29770	3370	0.30	1.13	46	52	6
0052	3F	21	124	302	63	30200	23570	-6630	0.21	0.78	53	41	-12
0052	3F	21	125	219	25	21900	11950	-9950	0.11	0.55	38	21	-17
0052	3F	21	126	141	20	14100	16380	2280	0.14	1.16	24	28	4
0052	3F	21	134	225	39	22500	20950	-1550	0.17	0.93	39	37	-2
0052	3F	21	135	193	30	19300	10160	-9140	0.16	0.53	34	17	-17
0052	3F	21	136	93	9	9300	5850	-3450	0.10	0.63	16	10	-6
0052	3F	21	145	120	16	12000	13990	1990	0.13	1.17	21	24	3
0052	3F	21	146	64	4	6400	2240	-4160	0.06	0.35	11	3	-8
0052	3F	21	156	40	0	4000	0	-4000	0.00	0.00	7	0	-7
0052	3F	21	234	12	1	1200	840	-360	0.08	0.70	2	1	-1
0052	3F	21	235	13	2	1300	1600	300	0.15	1.23	2	2	0
0052	3F	21	236	8	1	800	300	-500	0.13	0.38	1	0	-1
0052	3F	21	245	3	0	300	0	-300	0.00	0.00	0	0	0
0052	3F	21	246	11	1	1100	710	-390	0.09	0.65	1	1	0
0052	3F	21	256	6	1	600	1010	410	0.17	1.68	1	1	0
0052	3F	22	123	182	46	18200	16770	-1430	0.25	0.92	32	29	-3
0052	3F	22	124	224	35	22400	14760	-7640	0.16	0.66	39	26	-13
0052	3F	22	125	147	16	14700	11340	-3360	0.11	0.77	26	20	-6
0052	3F	22	126	101	4	10100	2600	-7500	0.04	0.26	17	4	-13
0052	3F	22	134	177	41	17700	22640	4940	0.23	1.28	31	40	9
0052	3F	22	135	96	8	9600	5790	-3810	0.08	0.60	16	10	-6
0052	3F	22	136	67	4	6700	3480	-3220	0.06	0.52	11	6	-5
0052	3F	22	145	85	9	8500	6390	-2110	0.11	0.75	15	11	-4
0052	3F	22	146	47	0	4700	0	-4700	0.00	0.00	8	0	-8
0052	3F	22	156	39	1	3900	2210	-1690	0.03	0.57	6	3	-3
0052	3F	22	234	33	6	3300	8830	5530	0.18	2.68	5	15	10
0052	3F	22	235	39	4	3900	2610	-1290	0.10	0.67	6	4	-2
0052	3F	22	236	14	0	1400	0	-1400	0.00	0.00	2	0	-2
0052	3F	22	245	20	1	2000	1280	-720	0.05	0.64	3	2	-1
0052	3F	22	246	9	2	900	1420	520	0.22	1.58	1	2	1
0052	3F	22	256	11	0	1100	0	-1100	0.00	0.00	1	0	-1
0052	3F	23	123	317	94	31700	31100	-600	0.30	0.98	56	55	-1
0052	3F	23	124	212	39	21200	16690	-4510	0.18	0.79	37	29	-8
0052	3F	23	125	140	12	14000	5710	-8290	0.09	0.41	24	10	-14
0052	3F	23	126	113	7	11300	5630	-5670	0.06	0.50	20	9	-11
0052	3F	23	134	139	20	13900	10840	-3060	0.14	0.78	24	19	-5
0052	3F	23	135	141	11	14100	7290	-6810	0.08	0.52	24	12	-12
0052	3F	23	136	75	5	7500	3000	-4500	0.07	0.40	13	5	-8
0052	3F	23	145	86	7	8600	3730	-4870	0.08	0.43	15	6	-9
0052	3F	23	146	57	4	5700	980	-4720	0.07	0.17	10	1	-9
0052	3F	23	156	47	4	4700	3210	-1490	0.09	0.68	8	5	-3
0052	3F	23	234	26	4	2600	1210	-1390	0.15	0.47	4	2	-2
0052	3F	23	235	21	3	2100	2220	120	0.14	1.06	3	3	0
0052	3F	23	236	21	1	2100	1170	-930	0.05	0.56	3	2	-1
0052	3F	23	245	15	1	1500	540	-960	0.07	0.36	2	0	-2
0052	3F	23	246	14	2	1400	8780	7380	0.14	6.27	2	15	13
0052	3F	23	256	3	0	300	0	-300	0.00	0.00	0	0	0
0052	3F	24	123	344	96	34400	33330	-1070	0.28	0.97	60	58	-2
0052	3F	24	124	256	48	25600	18940	-6660	0.19	0.74	45	33	-12
0052	3F	24	125	185	24	18500	14510	-3990	0.13	0.78	32	25	-7
0052	3F	24	126	150	20	15000	8640	-6360	0.13	0.58	26	15	-11
0052	3F	24	134	190	29	19000	11340	-7660	0.15	0.60	33	20	-13
0052	3F	24	135	123	20	12300	16440	4140	0.16	1.34	21	29	8
0052	3F	24	136	90	15	9000	9940	940	0.17	1.10	15	17	2
0052	3F	24	145	102	6	10200	5970	-4230	0.06	0.59	18	10	-8
0052	3F	24	146	88	8	8800	5840	-2960	0.09	0.66	15	10	-5
0052	3F	24	156	48	1	4800	2200	-2600	0.02	0.46	8	3	-5
0052	3F	24	234	22	0	2200	0	-2200	0.00	0.00	3	0	-3
0052	3F	24	235	19	2	1900	1750	-150	0.11	0.92	3	3	0
0052	3F	24	236	17	3	1700	2460	760	0.18	1.45	3	4	1
0052	3F	24	245	8	0	800	0	-800	0.00	0.00	1	0	-1
0052	3F	24	246	7	0	700	0	-700	0.00	0.00	1	0	-1
0052	3F	24	256	9	0	900	0	-900	0.00	0.00	1	0	-1
0052	3T	01	123	119	12	11900	9770	-2130	0.10	0.82	21	17	-4
0052	3T	01	124	115	7	11500	4490	-7010	0.06	0.39	20	7	-13
0052	3T	01	125	116	13	11600	16020	4420	0.11	1.38	20	28	8
0052	3T	01	126	111	4	11100	8650	-2450	0.04	0.78	19	15	-4
0052	3T	01	132	74	8	7400	9180	1780	0.11	1.24	13	16	3
0052	3T	01	134	71	2	7100	2270	-4830	0.03	0.32	12	4	-8
0052	3T	01	135	89	5	8900	10410	1510	0.06	1.17	15	18	3
0052	3T	01	136	72	2	7200	1740	-5460	0.03	0.24	12	3	-9
0052	3T	01	142	64	2	6400	5890	-510	0.03	0.92	11	10	-1
0052	3T	01	143	39	0	3900	0	-3900	0.00	0.00	6	0	-6
0052	3T	01	145	44	2	4400	5520	1120	0.05	1.25	7	9	2
0052	3T	01	146	50	2	5000	5810	810	0.04	1.16	8	10	2
0052	3T	01	152	27	0	2700	0	-2700	0.00	0.00	4	0	-4
0052	3T	01	153	38	1	3800	2380	-1420	0.03	0.63	6	4	-2
0052	3T	01	154	32	0	3200	0	-3200	0.00	0.00	5	0	-5
0052	3T	01	156	38	1	3800	2050	-1750	0.03	0.54	6	3	-3
0052	3T	01	162	25	1	2500	9820	7320	0.04	3.93	4	17	13
0052	3T	01	163	18	0	1800	0	-1800	0.00	0.00	3	0	-3
0052	3T	01	164	17	0	1700	0	-1700	0.00	0.00	3	0	-3
0052	3T	01	165	16	0	1600	0	-1600	0.00	0.00	2	0	-2
0052	3T	01	213	27	3	2700	12900	10200	0.11	4.78	4	22	18
0052	3T	01	214	16	0	1600	0	-1600	0.00	0.00	2	0	-2
0052	3T	01	215	22	1	2200	5580	3380	0.05	2.54	3	9	6
0052	3T	01	216	23	0	2300	0	-2300	0.00	0.00	4	0	-4
0052	3T	01	231	10	0	1000	0	-1000	0.00	0.00	1	0	-1
0052	3T	01	234	18	0	1800	0	-1800	0.00	0.00	3	0	-3
0052	3T	01	235	16	0	1600	0	-1600	0.00	0.00	2	0	-2
0052	3T	01	236	18	0	1800	0	-1800	0.00	0.00	3	0	-3
0052	3T	01	241	7	0	700	0	-700	0.00	0.00	1	0	-1
0052	3T	01	243	12	1	1200	3490	2290	0.08	2.91	2	6	4
0052	3T	01	245	11	1	1100	8880	7780	0.09	8.07	1	15	14
0052	3T	01	246	10	0	1000	0	-1000	0.00	0.00	1	0	-1
0052	3T	01	251	6	0	600	0	-600	0.00	0.00	1	0	-1
0052	3T	01	253	2	0	200	0	-200	0.00	0.00	0	0	0
0052	3T	01	254	5	1	500	2700	2200	0.20	5.40	0	4	4
0052	3T	01	256	7	0	700	0	-700	0.00	0.00	1	0	-1
0052	3T	01	261	4	0	400	0	-400	0.00	0.00	0	0	0
0052	3T	01	263	1	0	100	0	-100	0.00	0.00	0	0	0
0052	3T	01	264	1	0	100	0	-100	0.00	0.00	0	0	0
0052	3T	01	265	1	0	100	0	-100	0.00	0.00	0	0	0
0052	3T	02	123	137	17	13700	15050	1350	0.12	1.10	24	26	2
0052	3T	02	124	125	14	12500	15660	3160	0.11	1.25	22	27	5
0052	3T	02	125	80	6	8000	14610	6610	0.08	1.83	14	25	11
0052	3T	02	126	103	6	10300	13800	3500	0.06	1.34	18	24	6
0052	3T	02	132	70	1	7000	800	-6200	0.01	0.11	12	1	-11
0052	3T	02	134	91	4	9100	5480	-3620	0.04	0.60	16	9	-7
0052	3T	02	135	66	3	6600	4120	-2480	0.05	0.62	11	7	-4
0052	3T	02	136	68	3	6800	5050	-1750	0.04	0.74	12	8	-4
0052	3T	02	142	47	1	4700	1770	-2930	0.02	0.38	8	3	-5
0052	3T	02	143	53	1	5300	7460	2160	0.02	1.41	9	13	4
0052	3T	02	145	57	2	5700	1970	-3730	0.04	0.35	10	3	-7
0052	3T	02	146	50	2	5000	2390	-2610	0.04	0.48	8	4	-4
0052	3T	02	152	33	1	3300	5470	2170	0.03	1.66	5	9	4
0052	3T	02	153	45	0	4500	0	-4500	0.00	0.00	7	0	-7
0052	3T	02	154	35	0	3500	0	-3500	0.00	0.00	6	0	-6
0052	3T	02	156	25	0	2500	0	-2500	0.00	0.00	4	0	-4
0052	3T	02	162	23	2	2300	14420	12120	0.09	6.27	4	25	21
0052	3T	02	163	24	0	2400	0	-2400	0.00	0.00	4	0	-4
0052	3T	02	164	22	1	2200	6920	4720	0.05	3.15	3	12	9
0052	3T	02	165	19	0	1900	0	-1900	0.00	0.00	3	0	-3
0052	3T	02	213	27	0	2700	0	-2700	0.00	0.00	4	0	-4
0052	3T	02	214	31	1	3100	1220	-1880	0.03	0.39	5	2	-3
0052	3T	02	215	19	0	1900	0	-1900	0.00	0.00	3	0	-3
0052	3T	02	216	32	0	3200	0	-3200	0.00	0.00	5	0	-5
0052	3T	02	231	3	0	300	0	-300	0.00	0.00	0	0	0
0052	3T	02	234	17	0	1700	0	-1700	0.00	0.00	3	0	-3
0052	3T	02	235	16	0	1600	0	-1600	0.00	0.00	2	0	-2
0052	3T	02	236	15	1	1500	2110	610	0.07	1.41	2	3	1
0052	3T	02	241	9	0	900	0	-900	0.00	0.00	1	0	-1
0052	3T	02	243	11	0	1100	0	-1100	0.00	0.00	1	0	-1
0052	3T	02	245	10	1	1000	9450	8450	0.10	9.45	1	16	15
0052	3T	02	246	4	0	400	0	-400	0.00	0.00	0	0	0
0052	3T	02	251	5	0	500	0	-500	0.00	0.00	0	0	0
0052	3T	02	253	11	0	1100	0	-1100	0.00	0.00	1	0	-1
0052	3T	02	254	13	1	1300	2060	760	0.08	1.58	2	3	1
0052	3T	02	256	2	0	200	0	-200	0.00	0.00	0	0	0
0052	3T	02	263	9	0	900	0	-900	0.00	0.00	1	0	-1
0052	3T	02	264	10	0	1000	0	-1000	0.00	0.00	1	0	-1
0052	3T	02	265	3	0	300	0	-300	0.00	0.00	0	0	0
0052	3T	03	123	87	6	8700	6930	-1770	0.07	0.80	15	12	-3
0052	3T	03	124	95	6	9500	5800	-3700	0.06	0.61	16	10	-6
0052	3T	03	125	70	1	7000	390	-6610	0.01	0.06	12	0	-12
0052	3T	03	126	68	4	6800	8140	1340	0.06	1.20	12	14	2
0052	3T	03	132	52	2	5200	5510	310	0.04	1.06	9	9	0
0052	3T	03	134	61	1	6100	9020	2920	0.02	1.48	10	15	5
0052	3T	03	135	53	2	5300	2420	-2880	0.04	0.46	9	4	-5
0052	3T	03	136	37	0	3700	0	-3700	0.00	0.00	6	0	-6
0052	3T	03	142	42	4	4200	15600	11400	0.10	3.71	7	27	20
0052	3T	03	143	41	1	4100	720	-3380	0.02	0.18	7	1	-6
0052	3T	03	145	47	0	4700	0	-4700	0.00	0.00	8	0	-8
0052	3T	03	146	29	0	2900	0	-2900	0.00	0.00	5	0	-5
0052	3T	03	152	25	0	2500	0	-2500	0.00	0.00	4	0	-4
0052	3T	03	153	36	1	3600	770	-2830	0.03	0.21	6	1	-5
0052	3T	03	154	28	1	2800	1740	-1060	0.04	0.62	4	3	-1
0052	3T	03	156	20	1	2000	2210	210	0.05	1.11	3	3	0
0052	3T	03	162	24	0	2400	0	-2400	0.00	0.00	4	0	-4
0052	3T	03	163	15	1	1500	8300	6800	0.07	5.53	2	14	12
0052	3T	03	164	14	0	1400	0	-1400	0.00	0.00	2	0	-2
0052	3T	03	165	15	1	1500	3620	2120	0.07	2.41	2	6	4
0052	3T	03	213	20	0	2000	0	-2000	0.00	0.00	3	0	-3
0052	3T	03	214	19	2	1900	3430	1530	0.11	1.81	3	6	3
0052	3T	03	215	13	0	1300	0	-1300	0.00	0.00	2	0	-2
0052	3T	03	216	10	0	1000	0	-1000	0.00	0.00	1	0	-1
0052	3T	03	231	11	0	1100	0	-1100	0.00	0.00	1	0	-1
0052	3T	03	234	11	0	1100	0	-1100	0.00	0.00	1	0	-1
0052	3T	03	235	14	0	1400	0	-1400	0.00	0.00	2	0	-2
0052	3T	03	236	7	0	700	0	-700	0.00	0.00	1	0	-1
0052	3T	03	241	4	0	400	0	-400	0.00	0.00	0	0	0
0052	3T	03	243	9	0	900	0	-900	0.00	0.00	1	0	-1
0052	3T	03	245	15	0	1500	0	-1500	0.00	0.00	2	0	-2
0052	3T	03	246	7	0	700	0	-700	0.00	0.00	1	0	-1
0052	3T	03	251	5	0	500	0	-500	0.00	0.00	0	0	0
0052	3T	03	253	11	0	1100	0	-1100	0.00	0.00	1	0	-1
0052	3T	03	254	10	0	1000	0	-1000	0.00	0.00	1	0	-1
0052	3T	03	256	1	0	100	0	-100	0.00	0.00	0	0	0
0052	3T	03	261	3	0	300	0	-300	0.00	0.00	0	0	0
0052	3T	03	263	5	0	500	0	-500	0.00	0.00	0	0	0
0052	3T	03	264	5	0	500	0	-500	0.00	0.00	0	0	0
0052	3T	03	265	5	0	500	0	-500	0.00	0.00	0	0	0
0052	3T	04	123	113	14	11300	17000	5700	0.12	1.50	20	30	10
0052	3T	04	124	105	6	10500	5750	-4750	0.06	0.55	18	10	-8
0052	3T	04	125	77	5	7700	9690	1990	0.06	1.26	13	17	4
0052	3T	04	126	73	6	7300	6820	-480	0.08	0.93	12	12	0
0052	3T	04	132	60	4	6000	6250	250	0.07	1.04	10	11	1
0052	3T	04	134	74	5	7400	11860	4460	0.07	1.60	13	20	7
0052	3T	04	135	62	3	6200	7420	1220	0.05	1.20	10	13	3
0052	3T	04	136	50	1	5000	3670	-1330	0.02	0.73	8	6	-2
0052	3T	04	142	54	1	5400	1550	-3850	0.02	0.29	9	2	-7
0052	3T	04	143	53	1	5300	870	-4430	0.02	0.16	9	1	-8
0052	3T	04	145	40	2	4000	3730	-270	0.05	0.93	7	6	-1
0052	3T	04	146	41	0	4100	0	-4100	0.00	0.00	7	0	-7
0052	3T	04	152	32	1	3200	1050	-2150	0.03	0.33	5	1	-4
0052	3T	04	153	24	1	2400	850	-1550	0.04	0.35	4	1	-3
0052	3T	04	154	34	1	3400	5820	2420	0.03	1.71	6	10	4
0052	3T	04	156	28	1	2800	3840	1040	0.04	1.37	4	6	2
0052	3T	04	162	27	1	2700	3670	970	0.04	1.36	4	6	2
0052	3T	04	163	21	0	2100	0	-2100	0.00	0.00	3	0	-3
0052	3T	04	164	26	0	2600	0	-2600	0.00	0.00	4	0	-4
0052	3T	04	165	21	1	2100	3550	1450	0.05	1.69	3	6	3
0052	3T	04	213	23	3	2300	4660	2360	0.13	2.03	4	8	4
0052	3T	04	214	18	0	1800	0	-1800	0.00	0.00	3	0	-3
0052	3T	04	215	19	1	1900	3140	1240	0.05	1.65	3	5	2
0052	3T	04	216	13	0	1300	0	-1300	0.00	0.00	2	0	-2
0052	3T	04	231	16	0	1600	0	-1600	0.00	0.00	2	0	-2
0052	3T	04	234	23	0	2300	0	-2300	0.00	0.00	4	0	-4
0052	3T	04	235	18	1	1800	400	-1400	0.06	0.22	3	0	-3
0052	3T	04	236	7	0	700	0	-700	0.00	0.00	1	0	-1
0052	3T	04	241	9	0	900	0	-900	0.00	0.00	1	0	-1
0052	3T	04	243	5	0	500	0	-500	0.00	0.00	0	0	0
0052	3T	04	245	13	0	1300	0	-1300	0.00	0.00	2	0	-2
0052	3T	04	246	9	0	900	0	-900	0.00	0.00	1	0	-1
0052	3T	04	251	6	0	600	0	-600	0.00	0.00	1	0	-1
0052	3T	04	253	2	0	200	0	-200	0.00	0.00	0	0	0
0052	3T	04	254	6	0	600	0	-600	0.00	0.00	1	0	-1
0052	3T	04	256	9	0	900	0	-900	0.00	0.00	1	0	-1
0052	3T	04	261	2	0	200	0	-200	0.00	0.00	0	0	0
0011	2F	2_4	26	22	4	2200	2310	110	0.18	1.05	3	4	1
0011	2F	2_5	12	384	149	38400	37150	-1250	0.39	0.97	67	65	-2
0011	2F	2_5	13	189	50	18900	16970	-1930	0.26	0.90	33	30	-3
0011	2F	2_5	14	117	21	11700	7060	-4640	0.18	0.60	20	12	-8
0011	2F	2_5	15	49	7	4900	3300	-1600	0.14	0.67	8	5	-3
0011	2F	2_5	16	47	12	4700	4160	-540	0.26	0.89	8	7	-1
0011	2F	2_5	23	18	4	1800	2100	300	0.22	1.17	3	3	0
0011	2F	2_5	24	18	5	1800	2180	380	0.28	1.21	3	3	0
0011	2F	2_5	25	9	1	900	200	-700	0.11	0.22	1	0	-1
0011	2F	2_5	26	7	2	700	660	-40	0.29	0.94	1	1	0
0011	2F	2_6	12	330	81	33000	23740	-9260	0.25	0.72	58	42	-16
0011	2F	2_6	13	198	60	19800	20030	230	0.30	1.01	35	35	0
0011	2F	2_6	14	100	16	10000	6230	-3770	0.16	0.62	17	11	-6
0011	2F	2_6	15	57	14	5700	5410	-290	0.25	0.95	10	9	-1
0011	2F	2_6	16	59	12	5900	7680	1780	0.20	1.30	10	13	3
0011	2F	2_6	23	27	4	2700	2450	-250	0.15	0.91	4	4	0
0011	2F	2_6	24	16	3	1600	11810	10210	0.19	7.38	2	20	18
0011	2F	2_6	25	14	4	1400	1560	160	0.29	1.11	2	2	0
0011	2F	2_6	26	14	5	1400	1680	280	0.36	1.20	2	2	0
0011	2F	2_7	12	326	102	32600	29740	-2860	0.31	0.91	57	52	-5
0011	2F	2_7	13	184	50	18400	15330	-3070	0.27	0.83	32	27	-5
0011	2F	2_7	14	121	33	12100	9790	-2310	0.27	0.81	21	17	-4
0011	2F	2_7	15	47	7	4700	3030	-1670	0.15	0.64	8	5	-3
0011	2F	2_7	16	64	9	6400	3830	-2570	0.14	0.60	11	6	-5
0011	2F	2_7	23	24	2	2400	470	-1930	0.08	0.20	4	0	-4
0011	2F	2_7	24	12	1	1200	890	-310	0.08	0.74	2	1	-1
0011	2F	2_7	25	15	2	1500	510	-990	0.13	0.34	2	0	-2
0011	2F	2_7	26	18	1	1800	290	-1510	0.06	0.16	3	0	-3
0011	2F	2_8	12	333	95	33300	30780	-2520	0.29	0.92	58	54	-4
0011	2F	2_8	13	191	47	19100	18460	-640	0.25	0.97	33	32	-1
0011	2F	2_8	14	132	34	13200	11360	-1840	0.26	0.86	23	20	-3
0011	2F	2_8	15	54	12	5400	3640	-1760	0.22	0.67	9	6	-3
0011	2F	2_8	16	50	10	5000	7120	2120	0.20	1.42	8	12	4
0011	2F	2_8	23	24	6	2400	3580	1180	0.25	1.49	4	6	2
0011	2F	2_8	24	10	2	1000	600	-400	0.20	0.60	1	1	0
0011	2F	2_8	25	16	5	1600	2000	400	0.31	1.25	2	3	1
0011	2F	2_8	26	12	2	1200	2290	1090	0.17	1.91	2	4	2
0011	2F	2_9	12	378	119	37800	33830	-3970	0.31	0.89	66	59	-7
0011	2F	2_9	13	195	51	19500	18660	-840	0.26	0.96	34	33	-1
0011	2F	2_9	14	141	36	14100	11220	-2880	0.26	0.80	24	19	-5
0011	2F	2_9	15	60	10	6000	3910	-2090	0.17	0.65	10	6	-4
0011	2F	2_9	16	38	13	3800	5360	1560	0.34	1.41	6	9	3
0011	2F	2_9	23	24	1	2400	420	-1980	0.04	0.18	4	0	-4
0011	2F	2_9	24	13	1	1300	240	-1060	0.08	0.18	2	0	-2
0011	2F	2_9	25	11	0	1100	0	-1100	0.00	0.00	1	0	-1
0011	2F	2_9	26	5	0	500	0	-500	0.00	0.00	0	0	0
0011	2F	3_1	12	372	105	37200	32000	-5200	0.28	0.86	65	56	-9
0052	3T	04	263	6	0	600	0	-600	0.00	0.00	1	0	-1
0052	3T	04	264	9	0	900	0	-900	0.00	0.00	1	0	-1
0052	3T	04	265	5	0	500	0	-500	0.00	0.00	0	0	0
0052	3T	05	123	145	8	14500	6550	-7950	0.06	0.45	25	11	-14
0052	3T	05	124	124	12	12400	12240	-160	0.10	0.99	21	21	0
0052	3T	05	125	88	4	8800	20220	11420	0.05	2.30	15	35	20
0052	3T	05	126	105	4	10500	13280	2780	0.04	1.26	18	23	5
0052	3T	05	132	84	4	8400	4240	-4160	0.05	0.50	14	7	-7
0052	3T	05	134	87	3	8700	4110	-4590	0.03	0.47	15	7	-8
0052	3T	05	135	71	2	7100	1290	-5810	0.03	0.18	12	2	-10
0052	3T	05	136	63	3	6300	3850	-2450	0.05	0.61	11	6	-5
0052	3T	05	142	62	1	6200	800	-5400	0.02	0.13	10	1	-9
0052	3T	05	143	78	7	7800	12750	4950	0.09	1.63	13	22	9
0052	3T	05	145	69	2	6900	1720	-5180	0.03	0.25	12	3	-9
0052	3T	05	146	55	1	5500	1900	-3600	0.02	0.35	9	3	-6
0052	3T	05	152	42	1	4200	1330	-2870	0.02	0.32	7	2	-5
0052	3T	05	153	40	0	4000	0	-4000	0.00	0.00	7	0	-7
0052	3T	05	154	26	2	2600	5010	2410	0.08	1.93	4	8	4
0052	3T	05	156	40	3	4000	14130	10130	0.08	3.53	7	25	18
0052	3T	05	162	30	0	3000	0	-3000	0.00	0.00	5	0	-5
0052	3T	05	163	23	1	2300	4240	1940	0.04	1.84	4	7	3
0052	3T	05	164	13	1	1300	2540	1240	0.08	1.95	2	4	2
0052	3T	05	165	11	1	1100	3870	2770	0.09	3.52	1	6	5
0052	3T	05	213	16	2	1600	4560	2960	0.13	2.85	2	8	6
0052	3T	05	214	18	2	1800	3630	1830	0.11	2.02	3	6	3
0052	3T	05	215	25	0	2500	0	-2500	0.00	0.00	4	0	-4
0052	3T	05	216	24	0	2400	0	-2400	0.00	0.00	4	0	-4
0052	3T	05	231	10	0	1000	0	-1000	0.00	0.00	1	0	-1
0052	3T	05	234	19	0	1900	0	-1900	0.00	0.00	3	0	-3
0052	3T	05	235	11	0	1100	0	-1100	0.00	0.00	1	0	-1
0052	3T	05	236	24	0	2400	0	-2400	0.00	0.00	4	0	-4
0052	3T	05	241	4	0	400	0	-400	0.00	0.00	0	0	0
0052	3T	05	243	11	1	1100	1920	820	0.09	1.75	1	3	2
0052	3T	05	245	10	0	1000	0	-1000	0.00	0.00	1	0	-1
0052	3T	05	246	14	0	1400	0	-1400	0.00	0.00	2	0	-2
0052	3T	05	251	2	0	200	0	-200	0.00	0.00	0	0	0
0052	3T	05	253	13	0	1300	0	-1300	0.00	0.00	2	0	-2
0052	3T	05	254	12	0	1200	0	-1200	0.00	0.00	2	0	-2
0052	3T	05	256	17	0	1700	0	-1700	0.00	0.00	3	0	-3
0052	3T	05	261	1	0	100	0	-100	0.00	0.00	0	0	0
0052	3T	05	263	3	0	300	0	-300	0.00	0.00	0	0	0
0052	3T	05	264	2	0	200	0	-200	0.00	0.00	0	0	0
0052	3T	05	265	4	0	400	0	-400	0.00	0.00	0	0	0
0052	3T	06	123	130	12	13000	11840	-1160	0.09	0.91	23	20	-3
0052	3T	06	124	120	11	12000	14830	2830	0.09	1.24	21	26	5
0052	3T	06	125	131	5	13100	4900	-8200	0.04	0.37	23	8	-15
0052	3T	06	126	124	7	12400	11450	-950	0.06	0.92	21	20	-1
0052	3T	06	132	80	4	8000	3470	-4530	0.05	0.43	14	6	-8
0052	3T	06	134	96	10	9600	8810	-790	0.10	0.92	16	15	-1
0052	3T	06	135	83	5	8300	4090	-4210	0.06	0.49	14	7	-7
0052	3T	06	136	67	4	6700	6200	-500	0.06	0.93	11	10	-1
0052	3T	06	142	62	3	6200	4060	-2140	0.05	0.65	10	7	-3
0052	3T	06	143	44	4	4400	13540	9140	0.09	3.08	7	23	16
0052	3T	06	145	69	2	6900	1570	-5330	0.03	0.23	12	2	-10
0052	3T	06	146	60	2	6000	7060	1060	0.03	1.18	10	12	2
0052	3T	06	152	29	0	2900	0	-2900	0.00	0.00	5	0	-5
0052	3T	06	153	30	0	3000	0	-3000	0.00	0.00	5	0	-5
0052	3T	06	154	37	0	3700	0	-3700	0.00	0.00	6	0	-6
0052	3T	06	156	44	0	4400	0	-4400	0.00	0.00	7	0	-7
0052	3T	06	162	32	0	3200	0	-3200	0.00	0.00	5	0	-5
0052	3T	06	163	26	1	2600	3590	990	0.04	1.38	4	6	2
0052	3T	06	164	31	0	3100	0	-3100	0.00	0.00	5	0	-5
0052	3T	06	165	25	1	2500	3450	950	0.04	1.38	4	6	2
0052	3T	06	213	18	0	1800	0	-1800	0.00	0.00	3	0	-3
0052	3T	06	214	20	1	2000	2430	430	0.05	1.22	3	4	1
0052	3T	06	215	15	1	1500	2400	900	0.07	1.60	2	4	2
0052	3T	06	216	15	0	1500	0	-1500	0.00	0.00	2	0	-2
0052	3T	06	231	6	0	600	0	-600	0.00	0.00	1	0	-1
0052	3T	06	234	15	0	1500	0	-1500	0.00	0.00	2	0	-2
0052	3T	06	235	15	0	1500	0	-1500	0.00	0.00	2	0	-2
0052	3T	06	236	14	2	1400	3820	2420	0.14	2.73	2	6	4
0052	3T	06	241	8	1	800	2970	2170	0.13	3.71	1	5	4
0052	3T	06	243	6	0	600	0	-600	0.00	0.00	1	0	-1
0052	3T	06	245	9	0	900	0	-900	0.00	0.00	1	0	-1
0052	3T	06	246	14	0	1400	0	-1400	0.00	0.00	2	0	-2
0052	3T	06	251	2	0	200	0	-200	0.00	0.00	0	0	0
0052	3T	06	253	8	0	800	0	-800	0.00	0.00	1	0	-1
0052	3T	06	254	8	0	800	0	-800	0.00	0.00	1	0	-1
0052	3T	06	256	11	2	1100	14400	13300	0.18	13.09	1	25	24
0052	3T	06	261	4	0	400	0	-400	0.00	0.00	0	0	0
0052	3T	06	263	4	0	400	0	-400	0.00	0.00	0	0	0
0052	3T	06	264	7	0	700	0	-700	0.00	0.00	1	0	-1
0052	3T	06	265	7	0	700	0	-700	0.00	0.00	1	0	-1
0052	3T	07	123	108	3	10800	5020	-5780	0.03	0.46	19	8	-11
0052	3T	07	124	131	13	13100	12620	-480	0.10	0.96	23	22	-1
0052	3T	07	125	120	8	12000	12210	210	0.07	1.02	21	21	0
0052	3T	07	126	115	6	11500	15270	3770	0.05	1.33	20	27	7
0052	3T	07	132	96	12	9600	16230	6630	0.13	1.69	16	28	12
0052	3T	07	134	96	10	9600	9710	110	0.10	1.01	16	17	1
0052	3T	07	135	96	7	9600	12470	2870	0.07	1.30	16	22	6
0052	3T	07	136	64	2	6400	2550	-3850	0.03	0.40	11	4	-7
0052	3T	07	142	63	2	6300	1830	-4470	0.03	0.29	11	3	-8
0052	3T	07	143	51	1	5100	470	-4630	0.02	0.09	9	0	-9
0052	3T	07	145	85	8	8500	12380	3880	0.09	1.46	15	21	6
0052	3T	07	146	59	0	5900	0	-5900	0.00	0.00	10	0	-10
0052	3T	07	152	41	0	4100	0	-4100	0.00	0.00	7	0	-7
0052	3T	07	153	47	0	4700	0	-4700	0.00	0.00	8	0	-8
0052	3T	07	154	53	1	5300	5820	520	0.02	1.10	9	10	1
0052	3T	07	156	41	2	4100	3330	-770	0.05	0.81	7	5	-2
0052	3T	07	162	41	0	4100	0	-4100	0.00	0.00	7	0	-7
0052	3T	07	163	23	0	2300	0	-2300	0.00	0.00	4	0	-4
0052	3T	07	164	25	0	2500	0	-2500	0.00	0.00	4	0	-4
0052	3T	07	165	21	0	2100	0	-2100	0.00	0.00	3	0	-3
0052	3T	07	213	19	0	1900	0	-1900	0.00	0.00	3	0	-3
0052	3T	07	214	12	0	1200	0	-1200	0.00	0.00	2	0	-2
0052	3T	07	215	14	1	1400	1700	300	0.07	1.21	2	3	1
0052	3T	07	216	15	2	1500	2860	1360	0.13	1.91	2	5	3
0052	3T	07	231	4	0	400	0	-400	0.00	0.00	0	0	0
0052	3T	07	234	10	0	1000	0	-1000	0.00	0.00	1	0	-1
0052	3T	07	235	15	1	1500	700	-800	0.07	0.47	2	1	-1
0052	3T	07	236	15	0	1500	0	-1500	0.00	0.00	2	0	-2
0052	3T	07	241	8	0	800	0	-800	0.00	0.00	1	0	-1
0052	3T	07	243	6	0	600	0	-600	0.00	0.00	1	0	-1
0052	3T	07	245	8	0	800	0	-800	0.00	0.00	1	0	-1
0052	3T	07	246	13	0	1300	0	-1300	0.00	0.00	2	0	-2
0052	3T	07	251	5	0	500	0	-500	0.00	0.00	0	0	0
0052	3T	07	253	8	0	800	0	-800	0.00	0.00	1	0	-1
0052	3T	07	254	6	0	600	0	-600	0.00	0.00	1	0	-1
0052	3T	07	256	12	0	1200	0	-1200	0.00	0.00	2	0	-2
0052	3T	07	261	1	0	100	0	-100	0.00	0.00	0	0	0
0052	3T	07	263	2	0	200	0	-200	0.00	0.00	0	0	0
0052	3T	07	264	7	0	700	0	-700	0.00	0.00	1	0	-1
0052	3T	07	265	9	0	900	0	-900	0.00	0.00	1	0	-1
0052	3T	08	123	171	22	17100	17900	800	0.13	1.05	30	31	1
0052	3T	08	124	128	13	12800	13960	1160	0.10	1.09	22	24	2
0052	3T	08	125	106	5	10600	5830	-4770	0.05	0.55	18	10	-8
0052	3T	08	126	107	5	10700	8410	-2290	0.05	0.79	18	14	-4
0052	3T	08	132	83	6	8300	5260	-3040	0.07	0.63	14	9	-5
0052	3T	08	134	96	2	9600	3730	-5870	0.02	0.39	16	6	-10
0052	3T	08	135	68	3	6800	3530	-3270	0.04	0.52	12	6	-6
0052	3T	08	136	89	1	8900	730	-8170	0.01	0.08	15	1	-14
0052	3T	08	142	56	4	5600	4200	-1400	0.07	0.75	9	7	-2
0052	3T	08	143	72	4	7200	5980	-1220	0.06	0.83	12	10	-2
0052	3T	08	145	48	3	4800	3910	-890	0.06	0.81	8	6	-2
0052	3T	08	146	76	4	7600	10270	2670	0.05	1.35	13	18	5
0052	3T	08	152	46	2	4600	2780	-1820	0.04	0.60	8	4	-4
0052	3T	08	153	36	2	3600	4730	1130	0.06	1.31	6	8	2
0052	3T	08	154	35	2	3500	5900	2400	0.06	1.69	6	10	4
0052	3T	08	156	41	2	4100	3510	-590	0.05	0.86	7	6	-1
0052	3T	08	162	31	0	3100	0	-3100	0.00	0.00	5	0	-5
0052	3T	08	163	33	1	3300	1020	-2280	0.03	0.31	5	1	-4
0052	3T	08	164	25	0	2500	0	-2500	0.00	0.00	4	0	-4
0052	3T	08	165	23	0	2300	0	-2300	0.00	0.00	4	0	-4
0052	3T	08	213	8	0	800	0	-800	0.00	0.00	1	0	-1
0052	3T	08	214	15	0	1500	0	-1500	0.00	0.00	2	0	-2
0052	3T	08	215	6	0	600	0	-600	0.00	0.00	1	0	-1
0052	3T	08	216	12	0	1200	0	-1200	0.00	0.00	2	0	-2
0052	3T	08	231	8	0	800	0	-800	0.00	0.00	1	0	-1
0052	3T	08	234	17	1	1700	4360	2660	0.06	2.56	3	7	4
0052	3T	08	235	17	0	1700	0	-1700	0.00	0.00	3	0	-3
0052	3T	08	236	8	0	800	0	-800	0.00	0.00	1	0	-1
0052	3T	08	241	2	0	200	0	-200	0.00	0.00	0	0	0
0052	3T	08	243	5	0	500	0	-500	0.00	0.00	0	0	0
0052	3T	08	245	7	0	700	0	-700	0.00	0.00	1	0	-1
0052	3T	08	246	13	0	1300	0	-1300	0.00	0.00	2	0	-2
0052	3T	08	251	8	0	800	0	-800	0.00	0.00	1	0	-1
0052	3T	08	253	4	0	400	0	-400	0.00	0.00	0	0	0
0052	3T	08	254	10	0	1000	0	-1000	0.00	0.00	1	0	-1
0052	3T	08	256	9	0	900	0	-900	0.00	0.00	1	0	-1
0052	3T	08	261	6	0	600	0	-600	0.00	0.00	1	0	-1
0052	3T	08	263	4	0	400	0	-400	0.00	0.00	0	0	0
0052	3T	08	264	7	0	700	0	-700	0.00	0.00	1	0	-1
0052	3T	08	265	4	0	400	0	-400	0.00	0.00	0	0	0
0052	3T	09	123	179	26	17900	15020	-2880	0.15	0.84	31	26	-5
0052	3T	09	124	187	18	18700	15180	-3520	0.10	0.81	33	26	-7
0052	3T	09	125	106	8	10600	11180	580	0.08	1.05	18	19	1
0052	3T	09	126	119	6	11900	6840	-5060	0.05	0.57	21	12	-9
0052	3T	09	132	103	12	10300	14690	4390	0.12	1.43	18	26	8
0052	3T	09	134	106	5	10600	4680	-5920	0.05	0.44	18	8	-10
0052	3T	09	135	96	11	9600	12520	2920	0.11	1.30	16	22	6
0052	3T	09	136	64	2	6400	1790	-4610	0.03	0.28	11	3	-8
0052	3T	09	142	80	5	8000	5950	-2050	0.06	0.74	14	10	-4
0052	3T	09	143	70	3	7000	8020	1020	0.04	1.15	12	14	2
0052	3T	09	145	53	2	5300	2410	-2890	0.04	0.45	9	4	-5
0052	3T	09	146	49	0	4900	0	-4900	0.00	0.00	8	0	-8
0052	3T	09	152	37	1	3700	1200	-2500	0.03	0.32	6	2	-4
0052	3T	09	153	43	1	4300	3110	-1190	0.02	0.72	7	5	-2
0052	3T	09	154	53	1	5300	1700	-3600	0.02	0.32	9	3	-6
0052	3T	09	156	25	0	2500	0	-2500	0.00	0.00	4	0	-4
0052	3T	09	162	21	1	2100	2020	-80	0.05	0.96	3	3	0
0052	3T	09	163	23	2	2300	13600	11300	0.09	5.91	4	24	20
0052	3T	09	164	26	0	2600	0	-2600	0.00	0.00	4	0	-4
0052	3T	09	165	16	0	1600	0	-1600	0.00	0.00	2	0	-2
0052	3T	09	213	20	1	2000	570	-1430	0.05	0.29	3	1	-2
0052	3T	09	214	18	0	1800	0	-1800	0.00	0.00	3	0	-3
0052	3T	09	215	19	1	1900	1730	-170	0.05	0.91	3	3	0
0052	3T	09	216	16	2	1600	5670	4070	0.13	3.54	2	10	8
0052	3T	09	231	6	0	600	0	-600	0.00	0.00	1	0	-1
0052	3T	09	234	22	1	2200	1750	-450	0.05	0.80	3	3	0
0052	3T	09	235	18	1	1800	1120	-680	0.06	0.62	3	1	-2
0052	3T	09	236	18	0	1800	0	-1800	0.00	0.00	3	0	-3
0052	3T	09	241	4	0	400	0	-400	0.00	0.00	0	0	0
0052	3T	09	243	13	0	1300	0	-1300	0.00	0.00	2	0	-2
0052	3T	09	245	15	0	1500	0	-1500	0.00	0.00	2	0	-2
0052	3T	09	246	8	0	800	0	-800	0.00	0.00	1	0	-1
0052	3T	09	251	4	0	400	0	-400	0.00	0.00	0	0	0
0052	3T	09	253	8	0	800	0	-800	0.00	0.00	1	0	-1
0052	3T	09	254	5	0	500	0	-500	0.00	0.00	0	0	0
0052	3T	09	256	7	0	700	0	-700	0.00	0.00	1	0	-1
0052	3T	09	261	2	0	200	0	-200	0.00	0.00	0	0	0
0052	3T	09	263	8	0	800	0	-800	0.00	0.00	1	0	-1
0052	3T	09	264	9	0	900	0	-900	0.00	0.00	1	0	-1
0052	3T	09	265	4	1	400	3060	2660	0.25	7.65	0	5	5
0052	3T	10	123	156	16	15600	11090	-4510	0.10	0.71	27	19	-8
0052	3T	10	124	137	10	13700	7050	-6650	0.07	0.51	24	12	-12
0052	3T	10	125	109	5	10900	6650	-4250	0.05	0.61	19	11	-8
0052	3T	10	126	93	3	9300	10680	1380	0.03	1.15	16	18	2
0052	3T	10	132	101	4	10100	4020	-6080	0.04	0.40	17	7	-10
0052	3T	10	134	114	9	11400	7340	-4060	0.08	0.64	20	12	-8
0052	3T	10	135	103	4	10300	4540	-5760	0.04	0.44	18	8	-10
0052	3T	10	136	71	1	7100	5560	-1540	0.01	0.78	12	9	-3
0052	3T	10	142	41	4	4100	6780	2680	0.10	1.65	7	12	5
0052	3T	10	143	70	2	7000	2470	-4530	0.03	0.35	12	4	-8
0052	3T	10	145	60	3	6000	4160	-1840	0.05	0.69	10	7	-3
0052	3T	10	146	58	2	5800	2640	-3160	0.03	0.46	10	4	-6
0052	3T	10	152	34	0	3400	0	-3400	0.00	0.00	6	0	-6
0052	3T	10	153	37	2	3700	4540	840	0.05	1.23	6	8	2
0052	3T	10	154	34	3	3400	4490	1090	0.09	1.32	6	7	1
0052	3T	10	156	15	1	1500	1950	450	0.07	1.30	2	3	1
0052	3T	10	162	13	0	1300	0	-1300	0.00	0.00	2	0	-2
0052	3T	10	163	22	0	2200	0	-2200	0.00	0.00	3	0	-3
0052	3T	10	164	17	0	1700	0	-1700	0.00	0.00	3	0	-3
0052	3T	10	165	18	0	1800	0	-1800	0.00	0.00	3	0	-3
0052	3T	10	213	19	0	1900	0	-1900	0.00	0.00	3	0	-3
0052	3T	10	214	19	1	1900	1000	-900	0.05	0.53	3	1	-2
0052	3T	10	215	15	0	1500	0	-1500	0.00	0.00	2	0	-2
0052	3T	10	216	19	1	1900	1510	-390	0.05	0.79	3	2	-1
0052	3T	10	231	7	0	700	0	-700	0.00	0.00	1	0	-1
0052	3T	10	234	13	0	1300	0	-1300	0.00	0.00	2	0	-2
0052	3T	10	235	15	0	1500	0	-1500	0.00	0.00	2	0	-2
0052	3T	10	236	9	0	900	0	-900	0.00	0.00	1	0	-1
0052	3T	10	241	4	0	400	0	-400	0.00	0.00	0	0	0
0052	3T	10	243	16	0	1600	0	-1600	0.00	0.00	2	0	-2
0052	3T	10	245	19	0	1900	0	-1900	0.00	0.00	3	0	-3
0052	3T	10	246	6	0	600	0	-600	0.00	0.00	1	0	-1
0052	3T	10	251	4	0	400	0	-400	0.00	0.00	0	0	0
0052	3T	10	253	8	0	800	0	-800	0.00	0.00	1	0	-1
0052	3T	10	254	1	0	100	0	-100	0.00	0.00	0	0	0
0052	3T	10	256	6	0	600	0	-600	0.00	0.00	1	0	-1
0052	3T	10	261	6	0	600	0	-600	0.00	0.00	1	0	-1
0052	3T	10	263	4	0	400	0	-400	0.00	0.00	0	0	0
0052	3T	10	264	6	0	600	0	-600	0.00	0.00	1	0	-1
0052	3T	10	265	10	0	1000	0	-1000	0.00	0.00	1	0	-1
0052	3T	11	123	182	20	18200	15910	-2290	0.11	0.87	32	28	-4
0052	3T	11	124	128	12	12800	17060	4260	0.09	1.33	22	30	8
0052	3T	11	125	70	2	7000	1980	-5020	0.03	0.28	12	3	-9
0052	3T	11	126	80	4	8000	7950	-50	0.05	0.99	14	14	0
0052	3T	11	132	50	3	5000	5880	880	0.06	1.18	8	10	2
0052	3T	11	134	52	4	5200	10090	4890	0.08	1.94	9	17	8
0052	3T	11	135	40	1	4000	910	-3090	0.03	0.23	7	1	-6
0052	3T	11	136	65	2	6500	2410	-4090	0.03	0.37	11	4	-7
0052	3T	11	142	71	3	7100	2460	-4640	0.04	0.35	12	4	-8
0052	3T	11	143	91	2	9100	6410	-2690	0.02	0.70	16	11	-5
0052	3T	11	145	39	2	3900	2870	-1030	0.05	0.74	6	5	-1
0052	3T	11	146	50	1	5000	1050	-3950	0.02	0.21	8	1	-7
0052	3T	11	152	27	3	2700	9550	6850	0.11	3.54	4	16	12
0052	3T	11	153	52	1	5200	19850	14650	0.02	3.82	9	35	26
0052	3T	11	154	28	1	2800	4620	1820	0.04	1.65	4	8	4
0052	3T	11	156	31	0	3100	0	-3100	0.00	0.00	5	0	-5
0052	3T	11	162	11	0	1100	0	-1100	0.00	0.00	1	0	-1
0052	3T	11	163	9	0	900	0	-900	0.00	0.00	1	0	-1
0052	3T	11	164	18	0	1800	0	-1800	0.00	0.00	3	0	-3
0052	3T	11	165	11	0	1100	0	-1100	0.00	0.00	1	0	-1
0052	3T	11	213	28	2	2800	6770	3970	0.07	2.42	4	11	7
0052	3T	11	214	20	1	2000	2310	310	0.05	1.16	3	4	1
0052	3T	11	215	19	0	1900	0	-1900	0.00	0.00	3	0	-3
0052	3T	11	216	23	1	2300	1750	-550	0.04	0.76	4	3	-1
0052	3T	11	231	7	0	700	0	-700	0.00	0.00	1	0	-1
0052	3T	11	234	19	0	1900	0	-1900	0.00	0.00	3	0	-3
0052	3T	11	235	14	0	1400	0	-1400	0.00	0.00	2	0	-2
0052	3T	11	236	10	0	1000	0	-1000	0.00	0.00	1	0	-1
0052	3T	11	241	4	0	400	0	-400	0.00	0.00	0	0	0
0052	3T	11	243	18	0	1800	0	-1800	0.00	0.00	3	0	-3
0052	3T	11	245	9	0	900	0	-900	0.00	0.00	1	0	-1
0052	3T	11	246	5	0	500	0	-500	0.00	0.00	0	0	0
0052	3T	11	251	4	0	400	0	-400	0.00	0.00	0	0	0
0052	3T	11	253	11	0	1100	0	-1100	0.00	0.00	1	0	-1
0052	3T	11	254	12	0	1200	0	-1200	0.00	0.00	2	0	-2
0052	3T	11	256	10	1	1000	2590	1590	0.10	2.59	1	4	3
0052	3T	11	261	3	0	300	0	-300	0.00	0.00	0	0	0
0052	3T	11	263	5	0	500	0	-500	0.00	0.00	0	0	0
0052	3T	11	264	6	0	600	0	-600	0.00	0.00	1	0	-1
0052	3T	11	265	4	0	400	0	-400	0.00	0.00	0	0	0
0052	3T	12	123	126	12	12600	7950	-4650	0.10	0.63	22	14	-8
0052	3T	12	124	151	4	15100	3920	-11180	0.03	0.26	26	6	-20
0052	3T	12	125	118	3	11800	3320	-8480	0.03	0.28	20	5	-15
0052	3T	12	126	76	1	7600	1210	-6390	0.01	0.16	13	2	-11
0052	3T	12	132	95	8	9500	15710	6210	0.08	1.65	16	27	11
0052	3T	12	134	80	4	8000	4880	-3120	0.05	0.61	14	8	-6
0052	3T	12	135	62	0	6200	0	-6200	0.00	0.00	10	0	-10
0052	3T	12	136	56	4	5600	7380	1780	0.07	1.32	9	13	4
0052	3T	12	142	64	4	6400	4090	-2310	0.06	0.64	11	7	-4
0052	3T	12	143	48	0	4800	0	-4800	0.00	0.00	8	0	-8
0052	3T	12	145	53	3	5300	5320	20	0.06	1.00	9	9	0
0052	3T	12	146	43	1	4300	700	-3600	0.02	0.16	7	1	-6
0052	3T	12	152	37	0	3700	0	-3700	0.00	0.00	6	0	-6
0052	3T	12	153	36	2	3600	3480	-120	0.06	0.97	6	6	0
0052	3T	12	154	31	3	3100	9420	6320	0.10	3.04	5	16	11
0052	3T	12	156	31	1	3100	1030	-2070	0.03	0.33	5	1	-4
0052	3T	12	162	38	3	3800	2000	-1800	0.08	0.53	6	3	-3
0052	3T	12	163	18	1	1800	570	-1230	0.06	0.32	3	1	-2
0052	3T	12	164	15	0	1500	0	-1500	0.00	0.00	2	0	-2
0052	3T	12	165	23	1	2300	1310	-990	0.04	0.57	4	2	-2
0052	3T	12	213	24	3	2400	3280	880	0.13	1.37	4	5	1
0052	3T	12	214	22	0	2200	0	-2200	0.00	0.00	3	0	-3
0052	3T	12	215	17	0	1700	0	-1700	0.00	0.00	3	0	-3
0052	3T	12	216	9	0	900	0	-900	0.00	0.00	1	0	-1
0052	3T	12	231	10	0	1000	0	-1000	0.00	0.00	1	0	-1
0052	3T	12	234	21	0	2100	0	-2100	0.00	0.00	3	0	-3
0052	3T	12	235	14	0	1400	0	-1400	0.00	0.00	2	0	-2
0052	3T	12	236	5	0	500	0	-500	0.00	0.00	0	0	0
0052	3T	12	241	3	0	300	0	-300	0.00	0.00	0	0	0
0052	3T	12	243	10	1	1000	2880	1880	0.10	2.88	1	5	4
0052	3T	12	245	15	0	1500	0	-1500	0.00	0.00	2	0	-2
0052	3T	12	246	9	0	900	0	-900	0.00	0.00	1	0	-1
0052	3T	12	251	3	0	300	0	-300	0.00	0.00	0	0	0
0052	3T	12	253	10	0	1000	0	-1000	0.00	0.00	1	0	-1
0052	3T	12	254	9	1	900	2820	1920	0.11	3.13	1	4	3
0052	3T	12	256	1	0	100	0	-100	0.00	0.00	0	0	0
0052	3T	12	261	5	0	500	0	-500	0.00	0.00	0	0	0
0052	3T	12	263	3	0	300	0	-300	0.00	0.00	0	0	0
0052	3T	12	264	5	0	500	0	-500	0.00	0.00	0	0	0
0052	3T	12	265	6	0	600	0	-600	0.00	0.00	1	0	-1
0052	3T	13	123	133	17	13300	15900	2600	0.13	1.20	23	28	5
0052	3T	13	124	133	11	13300	12220	-1080	0.08	0.92	23	21	-2
0052	3T	13	125	91	5	9100	4900	-4200	0.05	0.54	16	8	-8
0052	3T	13	126	81	7	8100	21430	13330	0.09	2.65	14	37	23
0052	3T	13	132	75	5	7500	3680	-3820	0.07	0.49	13	6	-7
0052	3T	13	134	105	7	10500	9270	-1230	0.07	0.88	18	16	-2
0052	3T	13	135	65	3	6500	3280	-3220	0.05	0.50	11	5	-6
0052	3T	13	136	55	2	5500	1760	-3740	0.04	0.32	9	3	-6
0052	3T	13	142	66	5	6600	4180	-2420	0.08	0.63	11	7	-4
0052	3T	13	143	62	1	6200	3270	-2930	0.02	0.53	10	5	-5
0052	3T	13	145	43	1	4300	350	-3950	0.02	0.08	7	0	-7
0052	3T	13	146	36	3	3600	4780	1180	0.08	1.33	6	8	2
0052	3T	13	152	27	0	2700	0	-2700	0.00	0.00	4	0	-4
0052	3T	13	153	38	1	3800	1920	-1880	0.03	0.51	6	3	-3
0052	3T	13	154	48	0	4800	0	-4800	0.00	0.00	8	0	-8
0052	3T	13	156	20	1	2000	1020	-980	0.05	0.51	3	1	-2
0052	3T	13	162	29	1	2900	580	-2320	0.03	0.20	5	1	-4
0052	3T	13	163	20	1	2000	1020	-980	0.05	0.51	3	1	-2
0052	3T	13	164	31	1	3100	2180	-920	0.03	0.70	5	3	-2
0052	3T	13	165	21	1	2100	2090	-10	0.05	1.00	3	3	0
0052	3T	13	213	17	1	1700	1210	-490	0.06	0.71	3	2	-1
0052	3T	13	214	28	2	2800	4400	1600	0.07	1.57	4	7	3
0052	3T	13	215	19	1	1900	650	-1250	0.05	0.34	3	1	-2
0052	3T	13	216	8	0	800	0	-800	0.00	0.00	1	0	-1
0052	3T	13	231	2	0	200	0	-200	0.00	0.00	0	0	0
0052	3T	13	234	26	1	2600	2990	390	0.04	1.15	4	5	1
0052	3T	13	235	7	0	700	0	-700	0.00	0.00	1	0	-1
0052	3T	13	236	11	1	1100	2300	1200	0.09	2.09	1	4	3
0052	3T	13	241	11	0	1100	0	-1100	0.00	0.00	1	0	-1
0052	3T	13	243	9	1	900	1890	990	0.11	2.10	1	3	2
0052	3T	13	245	6	0	600	0	-600	0.00	0.00	1	0	-1
0052	3T	13	246	7	0	700	0	-700	0.00	0.00	1	0	-1
0052	3T	13	251	1	0	100	0	-100	0.00	0.00	0	0	0
0052	3T	13	253	5	0	500	0	-500	0.00	0.00	0	0	0
0052	3T	13	254	10	0	1000	0	-1000	0.00	0.00	1	0	-1
0052	3T	13	256	5	0	500	0	-500	0.00	0.00	0	0	0
0052	3T	13	261	4	1	400	800	400	0.25	2.00	0	1	1
0052	3T	13	263	2	0	200	0	-200	0.00	0.00	0	0	0
0052	3T	13	264	5	0	500	0	-500	0.00	0.00	0	0	0
0052	3T	13	265	2	0	200	0	-200	0.00	0.00	0	0	0
0052	3T	14	123	118	12	11800	11010	-790	0.10	0.93	20	19	-1
0052	3T	14	124	134	5	13400	3200	-10200	0.04	0.24	23	5	-18
0052	3T	14	125	84	2	8400	1170	-7230	0.02	0.14	14	2	-12
0052	3T	14	126	92	4	9200	6200	-3000	0.04	0.67	16	10	-6
0052	3T	14	132	73	1	7300	860	-6440	0.01	0.12	12	1	-11
0052	3T	14	134	90	6	9000	6840	-2160	0.07	0.76	15	12	-3
0052	3T	14	135	54	0	5400	0	-5400	0.00	0.00	9	0	-9
0052	3T	14	136	57	4	5700	7480	1780	0.07	1.31	10	13	3
0052	3T	14	142	54	4	5400	2650	-2750	0.07	0.49	9	4	-5
0052	3T	14	143	63	3	6300	2460	-3840	0.05	0.39	11	4	-7
0052	3T	14	145	47	2	4700	4960	260	0.04	1.06	8	8	0
0052	3T	14	146	42	1	4200	850	-3350	0.02	0.20	7	1	-6
0052	3T	14	152	29	0	2900	0	-2900	0.00	0.00	5	0	-5
0052	3T	14	153	40	0	4000	0	-4000	0.00	0.00	7	0	-7
0052	3T	14	154	35	2	3500	20220	16720	0.06	5.78	6	35	29
0052	3T	14	156	46	1	4600	5570	970	0.02	1.21	8	9	1
0052	3T	14	162	29	0	2900	0	-2900	0.00	0.00	5	0	-5
0052	3T	14	163	18	0	1800	0	-1800	0.00	0.00	3	0	-3
0052	3T	14	164	17	0	1700	0	-1700	0.00	0.00	3	0	-3
0052	3T	14	165	7	1	700	7980	7280	0.14	11.40	1	14	13
0052	3T	14	213	22	2	2200	6160	3960	0.09	2.80	3	10	7
0052	3T	14	214	20	0	2000	0	-2000	0.00	0.00	3	0	-3
0052	3T	14	215	14	0	1400	0	-1400	0.00	0.00	2	0	-2
0052	3T	14	216	25	2	2500	4660	2160	0.08	1.86	4	8	4
0052	3T	14	231	10	0	1000	0	-1000	0.00	0.00	1	0	-1
0052	3T	14	234	23	0	2300	0	-2300	0.00	0.00	4	0	-4
0052	3T	14	235	12	0	1200	0	-1200	0.00	0.00	2	0	-2
0052	3T	14	236	12	0	1200	0	-1200	0.00	0.00	2	0	-2
0052	3T	14	241	7	0	700	0	-700	0.00	0.00	1	0	-1
0052	3T	14	243	13	0	1300	0	-1300	0.00	0.00	2	0	-2
0052	3T	14	245	6	0	600	0	-600	0.00	0.00	1	0	-1
0052	3T	14	246	10	1	1000	3050	2050	0.10	3.05	1	5	4
0052	3T	14	251	7	0	700	0	-700	0.00	0.00	1	0	-1
0052	3T	14	253	9	0	900	0	-900	0.00	0.00	1	0	-1
0052	3T	14	254	10	0	1000	0	-1000	0.00	0.00	1	0	-1
0052	3T	14	256	7	0	700	0	-700	0.00	0.00	1	0	-1
0052	3T	14	263	6	0	600	0	-600	0.00	0.00	1	0	-1
0052	3T	14	264	8	2	800	6900	6100	0.25	8.63	1	12	11
0052	3T	14	265	3	0	300	0	-300	0.00	0.00	0	0	0
0052	3T	15	123	168	14	16800	11610	-5190	0.08	0.69	29	20	-9
0052	3T	15	124	158	16	15800	10080	-5720	0.10	0.64	27	17	-10
0052	3T	15	125	109	3	10900	12320	1420	0.03	1.13	19	21	2
0052	3T	15	126	109	7	10900	9730	-1170	0.06	0.89	19	17	-2
0052	3T	15	132	65	5	6500	4560	-1940	0.08	0.70	11	8	-3
0052	3T	15	134	103	7	10300	6980	-3320	0.07	0.68	18	12	-6
0052	3T	15	135	73	1	7300	620	-6680	0.01	0.08	12	1	-11
0052	3T	15	136	68	3	6800	4170	-2630	0.04	0.61	12	7	-5
0052	3T	15	142	87	6	8700	7350	-1350	0.07	0.84	15	13	-2
0052	3T	15	143	72	5	7200	10350	3150	0.07	1.44	12	18	6
0052	3T	15	145	64	2	6400	2110	-4290	0.03	0.33	11	3	-8
0052	3T	15	146	46	3	4600	8860	4260	0.07	1.93	8	15	7
0052	3T	15	152	40	1	4000	1510	-2490	0.03	0.38	7	2	-5
0052	3T	15	153	30	1	3000	930	-2070	0.03	0.31	5	1	-4
0052	3T	15	154	42	1	4200	1190	-3010	0.02	0.28	7	2	-5
0052	3T	15	156	31	1	3100	3870	770	0.03	1.25	5	6	1
0052	3T	15	162	18	1	1800	1280	-520	0.06	0.71	3	2	-1
0052	3T	15	163	21	0	2100	0	-2100	0.00	0.00	3	0	-3
0052	3T	15	164	28	0	2800	0	-2800	0.00	0.00	4	0	-4
0052	3T	15	165	24	0	2400	0	-2400	0.00	0.00	4	0	-4
0052	3T	15	213	22	0	2200	0	-2200	0.00	0.00	3	0	-3
0052	3T	15	214	15	2	1500	1660	160	0.13	1.11	2	2	0
0052	3T	15	215	12	0	1200	0	-1200	0.00	0.00	2	0	-2
0052	3T	15	216	20	1	2000	1740	-260	0.05	0.87	3	3	0
0052	3T	15	231	9	0	900	0	-900	0.00	0.00	1	0	-1
0052	3T	15	234	16	0	1600	0	-1600	0.00	0.00	2	0	-2
0052	3T	15	235	14	0	1400	0	-1400	0.00	0.00	2	0	-2
0052	3T	15	236	14	0	1400	0	-1400	0.00	0.00	2	0	-2
0052	3T	15	241	7	0	700	0	-700	0.00	0.00	1	0	-1
0052	3T	15	243	12	0	1200	0	-1200	0.00	0.00	2	0	-2
0052	3T	15	245	9	0	900	0	-900	0.00	0.00	1	0	-1
0052	3T	15	246	16	2	1600	20080	18480	0.13	12.55	2	35	33
0052	3T	15	251	1	0	100	0	-100	0.00	0.00	0	0	0
0052	3T	15	253	6	0	600	0	-600	0.00	0.00	1	0	-1
0052	3T	15	254	9	0	900	0	-900	0.00	0.00	1	0	-1
0052	3T	15	256	5	0	500	0	-500	0.00	0.00	0	0	0
0052	3T	15	261	2	0	200	0	-200	0.00	0.00	0	0	0
0052	3T	15	263	5	0	500	0	-500	0.00	0.00	0	0	0
0052	3T	15	264	9	0	900	0	-900	0.00	0.00	1	0	-1
0052	3T	15	265	2	0	200	0	-200	0.00	0.00	0	0	0
0052	3T	16	123	149	22	14900	11300	-3600	0.15	0.76	26	20	-6
0052	3T	16	124	154	20	15400	16820	1420	0.13	1.09	27	29	2
0052	3T	16	125	116	5	11600	5170	-6430	0.04	0.45	20	9	-11
0052	3T	16	126	112	5	11200	6590	-4610	0.04	0.59	19	11	-8
0052	3T	16	132	103	8	10300	7040	-3260	0.08	0.68	18	12	-6
0052	3T	16	134	104	1	10400	570	-9830	0.01	0.05	18	1	-17
0052	3T	16	135	91	4	9100	2790	-6310	0.04	0.31	16	4	-12
0052	3T	16	136	66	2	6600	2030	-4570	0.03	0.31	11	3	-8
0052	3T	16	142	93	5	9300	2930	-6370	0.05	0.32	16	5	-11
0052	3T	16	143	93	5	9300	4250	-5050	0.05	0.46	16	7	-9
0052	3T	16	145	73	5	7300	7240	-60	0.07	0.99	12	12	0
0052	3T	16	146	51	2	5100	5360	260	0.04	1.05	9	9	0
0052	3T	16	152	34	0	3400	0	-3400	0.00	0.00	6	0	-6
0052	3T	16	153	30	2	3000	7890	4890	0.07	2.63	5	13	8
0052	3T	16	154	43	0	4300	0	-4300	0.00	0.00	7	0	-7
0052	3T	16	156	23	1	2300	2900	600	0.04	1.26	4	5	1
0052	3T	16	162	22	1	2200	1630	-570	0.05	0.74	3	2	-1
0052	3T	16	163	17	1	1700	4870	3170	0.06	2.86	3	8	5
0052	3T	16	164	22	0	2200	0	-2200	0.00	0.00	3	0	-3
0052	3T	16	165	16	1	1600	6120	4520	0.06	3.83	2	10	8
0052	3T	16	213	14	0	1400	0	-1400	0.00	0.00	2	0	-2
0052	3T	16	214	18	2	1800	4930	3130	0.11	2.74	3	8	5
0052	3T	16	215	13	0	1300	0	-1300	0.00	0.00	2	0	-2
0052	3T	16	216	25	0	2500	0	-2500	0.00	0.00	4	0	-4
0052	3T	16	231	9	0	900	0	-900	0.00	0.00	1	0	-1
0052	3T	16	234	16	0	1600	0	-1600	0.00	0.00	2	0	-2
0052	3T	16	235	12	0	1200	0	-1200	0.00	0.00	2	0	-2
0052	3T	16	236	18	0	1800	0	-1800	0.00	0.00	3	0	-3
0052	3T	16	241	7	0	700	0	-700	0.00	0.00	1	0	-1
0052	3T	16	243	16	0	1600	0	-1600	0.00	0.00	2	0	-2
0052	3T	16	245	12	0	1200	0	-1200	0.00	0.00	2	0	-2
0052	3T	16	246	14	0	1400	0	-1400	0.00	0.00	2	0	-2
0052	3T	16	251	5	0	500	0	-500	0.00	0.00	0	0	0
0052	3T	16	253	8	1	800	1570	770	0.13	1.96	1	2	1
0052	3T	16	254	6	0	600	0	-600	0.00	0.00	1	0	-1
0052	3T	16	256	10	0	1000	0	-1000	0.00	0.00	1	0	-1
0052	3T	16	261	3	1	300	3050	2750	0.33	10.17	0	5	5
0052	3T	16	263	5	0	500	0	-500	0.00	0.00	0	0	0
0052	3T	16	264	8	1	800	1460	660	0.13	1.83	1	2	1
0052	3T	16	265	3	0	300	0	-300	0.00	0.00	0	0	0
0052	3T	17	123	166	16	16600	12790	-3810	0.10	0.77	29	22	-7
0052	3T	17	124	172	10	17200	12880	-4320	0.06	0.75	30	22	-8
0052	3T	17	125	119	3	11900	4560	-7340	0.03	0.38	21	8	-13
0052	3T	17	126	113	10	11300	27710	16410	0.09	2.45	20	49	29
0052	3T	17	132	106	10	10600	7030	-3570	0.09	0.66	18	12	-6
0052	3T	17	134	108	8	10800	5870	-4930	0.07	0.54	19	10	-9
0052	3T	17	135	100	5	10000	5020	-4980	0.05	0.50	17	8	-9
0052	3T	17	136	61	4	6100	6620	520	0.07	1.09	10	11	1
0052	3T	17	142	67	5	6700	11420	4720	0.07	1.70	11	20	9
0052	3T	17	143	84	3	8400	3030	-5370	0.04	0.36	14	5	-9
0052	3T	17	145	74	1	7400	2960	-4440	0.01	0.40	13	5	-8
0052	3T	17	146	38	1	3800	3800	0	0.03	1.00	6	6	0
0052	3T	17	152	42	3	4200	3620	-580	0.07	0.86	7	6	-1
0052	3T	17	153	37	0	3700	0	-3700	0.00	0.00	6	0	-6
0052	3T	17	154	28	0	2800	0	-2800	0.00	0.00	4	0	-4
0052	3T	17	156	29	1	2900	870	-2030	0.03	0.30	5	1	-4
0052	3T	17	162	18	2	1800	13940	12140	0.11	7.74	3	24	21
0052	3T	17	163	20	0	2000	0	-2000	0.00	0.00	3	0	-3
0052	3T	17	164	18	0	1800	0	-1800	0.00	0.00	3	0	-3
0052	3T	17	165	19	2	1900	5390	3490	0.11	2.84	3	9	6
0052	3T	17	213	17	0	1700	0	-1700	0.00	0.00	3	0	-3
0052	3T	17	214	26	4	2600	17930	15330	0.15	6.90	4	31	27
0052	3T	17	215	22	0	2200	0	-2200	0.00	0.00	3	0	-3
0052	3T	17	216	9	0	900	0	-900	0.00	0.00	1	0	-1
0052	3T	17	231	10	0	1000	0	-1000	0.00	0.00	1	0	-1
0052	3T	17	234	16	0	1600	0	-1600	0.00	0.00	2	0	-2
0052	3T	17	235	15	0	1500	0	-1500	0.00	0.00	2	0	-2
0052	3T	17	236	12	1	1200	6070	4870	0.08	5.06	2	10	8
0052	3T	17	241	3	0	300	0	-300	0.00	0.00	0	0	0
0052	3T	17	243	8	0	800	0	-800	0.00	0.00	1	0	-1
0052	3T	17	245	9	0	900	0	-900	0.00	0.00	1	0	-1
0052	3T	17	246	5	0	500	0	-500	0.00	0.00	0	0	0
0052	3T	17	251	4	0	400	0	-400	0.00	0.00	0	0	0
0052	3T	17	253	6	0	600	0	-600	0.00	0.00	1	0	-1
0052	3T	17	254	2	0	200	0	-200	0.00	0.00	0	0	0
0052	3T	17	256	7	0	700	0	-700	0.00	0.00	1	0	-1
0052	3T	17	261	6	1	600	2750	2150	0.17	4.58	1	4	3
0052	3T	17	263	6	0	600	0	-600	0.00	0.00	1	0	-1
0052	3T	17	264	3	0	300	0	-300	0.00	0.00	0	0	0
0052	3T	17	265	4	0	400	0	-400	0.00	0.00	0	0	0
0052	3T	18	123	175	27	17500	20960	3460	0.15	1.20	30	37	7
0052	3T	18	124	184	17	18400	12600	-5800	0.09	0.68	32	22	-10
0052	3T	18	125	137	15	13700	10720	-2980	0.11	0.78	24	18	-6
0052	3T	18	126	126	10	12600	19370	6770	0.08	1.54	22	34	12
0052	3T	18	132	96	3	9600	3010	-6590	0.03	0.31	16	5	-11
0052	3T	18	134	102	9	10200	12200	2000	0.09	1.20	18	21	3
0052	3T	18	135	104	4	10400	2800	-7600	0.04	0.27	18	4	-14
0052	3T	18	136	67	3	6700	3890	-2810	0.04	0.58	11	6	-5
0052	3T	18	142	74	6	7400	8680	1280	0.08	1.17	13	15	2
0052	3T	18	143	82	8	8200	11440	3240	0.10	1.40	14	20	6
0052	3T	18	145	89	7	8900	10690	1790	0.08	1.20	15	18	3
0052	3T	18	146	68	3	6800	5550	-1250	0.04	0.82	12	9	-3
0052	3T	18	152	53	2	5300	4000	-1300	0.04	0.75	9	7	-2
0052	3T	18	153	44	3	4400	4680	280	0.07	1.06	7	8	1
0052	3T	18	154	42	3	4200	6020	1820	0.07	1.43	7	10	3
0052	3T	18	156	39	2	3900	3200	-700	0.05	0.82	6	5	-1
0052	3T	18	162	26	1	2600	900	-1700	0.04	0.35	4	1	-3
0052	3T	18	163	23	1	2300	1480	-820	0.04	0.64	4	2	-2
0052	3T	18	164	20	0	2000	0	-2000	0.00	0.00	3	0	-3
0052	3T	18	165	15	0	1500	0	-1500	0.00	0.00	2	0	-2
0052	3T	18	213	17	0	1700	0	-1700	0.00	0.00	3	0	-3
0052	3T	18	214	20	1	2000	1520	-480	0.05	0.76	3	2	-1
0052	3T	18	215	20	1	2000	5010	3010	0.05	2.51	3	8	5
0052	3T	18	216	18	1	1800	4820	3020	0.06	2.68	3	8	5
0052	3T	18	231	8	1	800	9350	8550	0.13	11.69	1	16	15
0052	3T	18	234	19	2	1900	18960	17060	0.11	9.98	3	33	30
0052	3T	18	235	16	1	1600	730	-870	0.06	0.46	2	1	-1
0052	3T	18	236	15	0	1500	0	-1500	0.00	0.00	2	0	-2
0052	3T	18	241	2	0	200	0	-200	0.00	0.00	0	0	0
0052	3T	18	243	12	0	1200	0	-1200	0.00	0.00	2	0	-2
0052	3T	18	245	9	1	900	1170	270	0.11	1.30	1	2	1
0052	3T	18	246	4	0	400	0	-400	0.00	0.00	0	0	0
0052	3T	18	251	3	0	300	0	-300	0.00	0.00	0	0	0
0052	3T	18	253	7	0	700	0	-700	0.00	0.00	1	0	-1
0052	3T	18	254	7	0	700	0	-700	0.00	0.00	1	0	-1
0052	3T	18	256	6	1	600	840	240	0.17	1.40	1	1	0
0052	3T	18	261	4	0	400	0	-400	0.00	0.00	0	0	0
0052	3T	18	263	7	0	700	0	-700	0.00	0.00	1	0	-1
0052	3T	18	264	1	0	100	0	-100	0.00	0.00	0	0	0
0052	3T	18	265	2	0	200	0	-200	0.00	0.00	0	0	0
0052	3T	19	123	122	15	12200	12050	-150	0.12	0.99	21	21	0
0052	3T	19	124	177	18	17700	15880	-1820	0.10	0.90	31	28	-3
0052	3T	19	125	108	3	10800	4710	-6090	0.03	0.44	19	8	-11
0052	3T	19	126	96	6	9600	16300	6700	0.06	1.70	16	28	12
0052	3T	19	132	82	6	8200	8260	60	0.07	1.01	14	14	0
0052	3T	19	134	125	14	12500	11990	-510	0.11	0.96	22	21	-1
0052	3T	19	135	76	7	7600	5060	-2540	0.09	0.67	13	8	-5
0052	3T	19	136	78	2	7800	3560	-4240	0.03	0.46	13	6	-7
0052	3T	19	142	84	7	8400	7940	-460	0.08	0.95	14	14	0
0052	3T	19	143	66	6	6600	5220	-1380	0.09	0.79	11	9	-2
0052	3T	19	145	56	3	5600	4050	-1550	0.05	0.72	9	7	-2
0052	3T	19	146	48	1	4800	1080	-3720	0.02	0.23	8	1	-7
0052	3T	19	152	34	3	3400	7550	4150	0.09	2.22	6	13	7
0052	3T	19	153	31	0	3100	0	-3100	0.00	0.00	5	0	-5
0052	3T	19	154	32	1	3200	3400	200	0.03	1.06	5	6	1
0052	3T	19	156	19	0	1900	0	-1900	0.00	0.00	3	0	-3
0052	3T	19	162	16	1	1600	2040	440	0.06	1.28	2	3	1
0052	3T	19	163	15	0	1500	0	-1500	0.00	0.00	2	0	-2
0052	3T	19	164	25	0	2500	0	-2500	0.00	0.00	4	0	-4
0052	3T	19	165	6	0	600	0	-600	0.00	0.00	1	0	-1
0052	3T	19	213	11	1	1100	1730	630	0.09	1.57	1	3	2
0052	3T	19	214	22	2	2200	2170	-30	0.09	0.99	3	3	0
0052	3T	19	215	11	0	1100	0	-1100	0.00	0.00	1	0	-1
0052	3T	19	216	13	1	1300	1450	150	0.08	1.12	2	2	0
0052	3T	19	231	3	0	300	0	-300	0.00	0.00	0	0	0
0052	3T	19	234	14	0	1400	0	-1400	0.00	0.00	2	0	-2
0052	3T	19	235	12	1	1200	1110	-90	0.08	0.93	2	1	-1
0052	3T	19	236	16	0	1600	0	-1600	0.00	0.00	2	0	-2
0052	3T	19	241	4	0	400	0	-400	0.00	0.00	0	0	0
0052	3T	19	243	15	0	1500	0	-1500	0.00	0.00	2	0	-2
0052	3T	19	245	12	0	1200	0	-1200	0.00	0.00	2	0	-2
0052	3T	19	246	7	1	700	1280	580	0.14	1.83	1	2	1
0052	3T	19	251	4	1	400	9570	9170	0.25	23.93	0	16	16
0052	3T	19	253	4	0	400	0	-400	0.00	0.00	0	0	0
0052	3T	19	254	3	0	300	0	-300	0.00	0.00	0	0	0
0052	3T	19	261	5	0	500	0	-500	0.00	0.00	0	0	0
0052	3T	19	263	3	0	300	0	-300	0.00	0.00	0	0	0
0052	3T	19	264	8	1	800	2260	1460	0.13	2.83	1	4	3
0052	3T	19	265	6	0	600	0	-600	0.00	0.00	1	0	-1
0052	3T	20	123	173	20	17300	14430	-2870	0.12	0.83	30	25	-5
0052	3T	20	124	145	13	14500	8970	-5530	0.09	0.62	25	15	-10
0052	3T	20	125	106	8	10600	16930	6330	0.08	1.60	18	29	11
0052	3T	20	126	93	3	9300	4670	-4630	0.03	0.50	16	8	-8
0052	3T	20	132	95	5	9500	4530	-4970	0.05	0.48	16	8	-8
0052	3T	20	134	91	3	9100	3140	-5960	0.03	0.35	16	5	-11
0052	3T	20	135	83	9	8300	12030	3730	0.11	1.45	14	21	7
0052	3T	20	136	82	3	8200	9140	940	0.04	1.11	14	16	2
0052	3T	20	142	75	4	7500	4550	-2950	0.05	0.61	13	8	-5
0052	3T	20	143	74	2	7400	2590	-4810	0.03	0.35	13	4	-9
0052	3T	20	145	66	4	6600	7580	980	0.06	1.15	11	13	2
0052	3T	20	146	60	1	6000	5880	-120	0.02	0.98	10	10	0
0052	3T	20	152	30	1	3000	900	-2100	0.03	0.30	5	1	-4
0052	3T	20	153	43	4	4300	7120	2820	0.09	1.66	7	12	5
0052	3T	20	154	35	1	3500	3590	90	0.03	1.03	6	6	0
0052	3T	20	156	37	2	3700	4400	700	0.05	1.19	6	7	1
0052	3T	20	162	30	1	3000	1490	-1510	0.03	0.50	5	2	-3
0052	3T	20	163	40	1	4000	1430	-2570	0.03	0.36	7	2	-5
0052	3T	20	164	12	1	1200	4710	3510	0.08	3.93	2	8	6
0052	3T	20	165	12	0	1200	0	-1200	0.00	0.00	2	0	-2
0052	3T	20	213	17	0	1700	0	-1700	0.00	0.00	3	0	-3
0052	3T	20	214	21	2	2100	2440	340	0.10	1.16	3	4	1
0052	3T	20	215	17	0	1700	0	-1700	0.00	0.00	3	0	-3
0052	3T	20	216	14	2	1400	3710	2310	0.14	2.65	2	6	4
0052	3T	20	231	6	0	600	0	-600	0.00	0.00	1	0	-1
0052	3T	20	234	12	0	1200	0	-1200	0.00	0.00	2	0	-2
0052	3T	20	235	11	0	1100	0	-1100	0.00	0.00	1	0	-1
0052	3T	20	236	11	0	1100	0	-1100	0.00	0.00	1	0	-1
0052	3T	20	241	3	0	300	0	-300	0.00	0.00	0	0	0
0052	3T	20	243	8	0	800	0	-800	0.00	0.00	1	0	-1
0052	3T	20	245	4	1	400	3280	2880	0.25	8.20	0	5	5
0052	3T	20	246	11	0	1100	0	-1100	0.00	0.00	1	0	-1
0052	3T	20	251	5	0	500	0	-500	0.00	0.00	0	0	0
0052	3T	20	253	3	0	300	0	-300	0.00	0.00	0	0	0
0052	3T	20	254	8	0	800	0	-800	0.00	0.00	1	0	-1
0052	3T	20	256	4	0	400	0	-400	0.00	0.00	0	0	0
0052	3T	20	261	1	0	100	0	-100	0.00	0.00	0	0	0
0052	3T	20	263	3	0	300	0	-300	0.00	0.00	0	0	0
0052	3T	20	264	3	0	300	0	-300	0.00	0.00	0	0	0
0052	3T	20	265	5	0	500	0	-500	0.00	0.00	0	0	0
0052	3T	21	123	155	25	15500	18680	3180	0.16	1.21	27	33	6
0052	3T	21	124	209	15	20900	14180	-6720	0.07	0.68	36	25	-11
0052	3T	21	125	146	7	14600	12570	-2030	0.05	0.86	25	22	-3
0052	3T	21	126	109	5	10900	5750	-5150	0.05	0.53	19	10	-9
0052	3T	21	132	100	16	10000	22680	12680	0.16	2.27	17	40	23
0052	3T	21	134	150	10	15000	16640	1640	0.07	1.11	26	29	3
0052	3T	21	135	145	11	14500	8700	-5800	0.08	0.60	25	15	-10
0052	3T	21	136	70	6	7000	6310	-690	0.09	0.90	12	11	-1
0052	3T	21	142	75	4	7500	3260	-4240	0.05	0.43	13	5	-8
0052	3T	21	143	75	2	7500	1930	-5570	0.03	0.26	13	3	-10
0052	3T	21	145	81	5	8100	7560	-540	0.06	0.93	14	13	-1
0052	3T	21	146	50	1	5000	1190	-3810	0.02	0.24	8	2	-6
0052	3T	21	152	58	4	5800	4010	-1790	0.07	0.69	10	7	-3
0052	3T	21	153	48	1	4800	1030	-3770	0.02	0.21	8	1	-7
0052	3T	21	154	39	0	3900	0	-3900	0.00	0.00	6	0	-6
0052	3T	21	156	26	0	2600	0	-2600	0.00	0.00	4	0	-4
0052	3T	21	162	13	0	1300	0	-1300	0.00	0.00	2	0	-2
0052	3T	21	163	23	0	2300	0	-2300	0.00	0.00	4	0	-4
0052	3T	21	164	14	0	1400	0	-1400	0.00	0.00	2	0	-2
0052	3T	21	165	14	0	1400	0	-1400	0.00	0.00	2	0	-2
0052	3T	21	213	8	0	800	0	-800	0.00	0.00	1	0	-1
0052	3T	21	214	14	2	1400	2230	830	0.14	1.59	2	3	1
0052	3T	21	215	13	0	1300	0	-1300	0.00	0.00	2	0	-2
0052	3T	21	216	17	1	1700	770	-930	0.06	0.45	3	1	-2
0052	3T	21	231	1	0	100	0	-100	0.00	0.00	0	0	0
0052	3T	21	234	9	0	900	0	-900	0.00	0.00	1	0	-1
0052	3T	21	235	9	0	900	0	-900	0.00	0.00	1	0	-1
0052	3T	21	236	8	0	800	0	-800	0.00	0.00	1	0	-1
0052	3T	21	241	4	0	400	0	-400	0.00	0.00	0	0	0
0052	3T	21	243	3	0	300	0	-300	0.00	0.00	0	0	0
0052	3T	21	245	3	0	300	0	-300	0.00	0.00	0	0	0
0052	3T	21	246	10	0	1000	0	-1000	0.00	0.00	1	0	-1
0052	3T	21	251	2	0	200	0	-200	0.00	0.00	0	0	0
0052	3T	21	253	4	0	400	0	-400	0.00	0.00	0	0	0
0052	3T	21	256	5	0	500	0	-500	0.00	0.00	0	0	0
0052	3T	21	261	2	0	200	0	-200	0.00	0.00	0	0	0
0052	3T	21	264	1	0	100	0	-100	0.00	0.00	0	0	0
0052	3T	21	265	1	0	100	0	-100	0.00	0.00	0	0	0
0052	3T	22	123	98	9	9800	6190	-3610	0.09	0.63	17	10	-7
0052	3T	22	124	145	10	14500	10240	-4260	0.07	0.71	25	18	-7
0052	3T	22	125	88	6	8800	8840	40	0.07	1.00	15	15	0
0052	3T	22	126	66	1	6600	2890	-3710	0.02	0.44	11	5	-6
0052	3T	22	132	53	2	5300	1620	-3680	0.04	0.31	9	2	-7
0052	3T	22	134	130	14	13000	15790	2790	0.11	1.21	23	27	4
0052	3T	22	135	70	0	7000	0	-7000	0.00	0.00	12	0	-12
0052	3T	22	136	47	1	4700	720	-3980	0.02	0.15	8	1	-7
0052	3T	22	142	51	0	5100	0	-5100	0.00	0.00	9	0	-9
0052	3T	22	143	47	3	4700	5370	670	0.06	1.14	8	9	1
0052	3T	22	145	44	3	4400	4830	430	0.07	1.10	7	8	1
0052	3T	22	146	26	0	2600	0	-2600	0.00	0.00	4	0	-4
0052	3T	22	152	29	1	2900	3270	370	0.03	1.13	5	5	0
0052	3T	22	153	26	0	2600	0	-2600	0.00	0.00	4	0	-4
0052	3T	22	154	41	0	4100	0	-4100	0.00	0.00	7	0	-7
0052	3T	22	156	20	0	2000	0	-2000	0.00	0.00	3	0	-3
0052	3T	22	162	16	1	1600	3360	1760	0.06	2.10	2	5	3
0052	3T	22	163	20	0	2000	0	-2000	0.00	0.00	3	0	-3
0052	3T	22	164	21	0	2100	0	-2100	0.00	0.00	3	0	-3
0052	3T	22	165	19	0	1900	0	-1900	0.00	0.00	3	0	-3
0052	3T	22	213	27	3	2700	3740	1040	0.11	1.39	4	6	2
0052	3T	22	214	22	1	2200	1110	-1090	0.05	0.50	3	1	-2
0052	3T	22	215	23	1	2300	1660	-640	0.04	0.72	4	2	-2
0052	3T	22	216	18	0	1800	0	-1800	0.00	0.00	3	0	-3
0052	3T	22	231	4	0	400	0	-400	0.00	0.00	0	0	0
0052	3T	22	234	19	2	1900	3230	1330	0.11	1.70	3	5	2
0052	3T	22	235	27	0	2700	0	-2700	0.00	0.00	4	0	-4
0052	3T	22	236	10	0	1000	0	-1000	0.00	0.00	1	0	-1
0052	3T	22	241	6	0	600	0	-600	0.00	0.00	1	0	-1
0052	3T	22	243	14	0	1400	0	-1400	0.00	0.00	2	0	-2
0052	3T	22	245	12	0	1200	0	-1200	0.00	0.00	2	0	-2
0052	3T	22	246	5	0	500	0	-500	0.00	0.00	0	0	0
0052	3T	22	251	7	0	700	0	-700	0.00	0.00	1	0	-1
0052	3T	22	253	12	2	1200	3260	2060	0.17	2.72	2	5	3
0052	3T	22	254	8	0	800	0	-800	0.00	0.00	1	0	-1
0052	3T	22	256	5	0	500	0	-500	0.00	0.00	0	0	0
0052	3T	22	261	1	0	100	0	-100	0.00	0.00	0	0	0
0052	3T	22	263	4	0	400	0	-400	0.00	0.00	0	0	0
0052	3T	22	264	4	0	400	0	-400	0.00	0.00	0	0	0
0052	3T	22	265	6	0	600	0	-600	0.00	0.00	1	0	-1
0052	3T	23	123	186	21	18600	13380	-5220	0.11	0.72	32	23	-9
0052	3T	23	124	118	9	11800	6630	-5170	0.08	0.56	20	11	-9
0052	3T	23	125	98	4	9800	3060	-6740	0.04	0.31	17	5	-12
0052	3T	23	126	84	0	8400	0	-8400	0.00	0.00	14	0	-14
0052	3T	23	132	108	15	10800	14240	3440	0.14	1.32	19	25	6
0052	3T	23	134	83	2	8300	4570	-3730	0.02	0.55	14	8	-6
0052	3T	23	135	93	5	9300	11020	1720	0.05	1.18	16	19	3
0052	3T	23	136	55	3	5500	5120	-380	0.05	0.93	9	9	0
0052	3T	23	142	75	6	7500	8360	860	0.08	1.11	13	14	1
0052	3T	23	143	56	2	5600	9270	3670	0.04	1.66	9	16	7
0052	3T	23	145	63	1	6300	800	-5500	0.02	0.13	11	1	-10
0052	3T	23	146	34	2	3400	2220	-1180	0.06	0.65	6	3	-3
0052	3T	23	152	25	1	2500	1190	-1310	0.04	0.48	4	2	-2
0052	3T	23	153	48	1	4800	4850	50	0.02	1.01	8	8	0
0052	3T	23	154	23	1	2300	1670	-630	0.04	0.73	4	2	-2
0052	3T	23	156	28	2	2800	3130	330	0.07	1.12	4	5	1
0052	3T	23	162	17	0	1700	0	-1700	0.00	0.00	3	0	-3
0052	3T	23	163	20	1	2000	1500	-500	0.05	0.75	3	2	-1
0052	3T	23	164	23	0	2300	0	-2300	0.00	0.00	4	0	-4
0052	3T	23	165	19	0	1900	0	-1900	0.00	0.00	3	0	-3
0052	3T	23	213	18	1	1800	2460	660	0.06	1.37	3	4	1
0052	3T	23	214	13	1	1300	1420	120	0.08	1.09	2	2	0
0052	3T	23	215	15	1	1500	3000	1500	0.07	2.00	2	5	3
0052	3T	23	216	9	0	900	0	-900	0.00	0.00	1	0	-1
0052	3T	23	231	5	0	500	0	-500	0.00	0.00	0	0	0
0052	3T	23	234	18	3	1800	2380	580	0.17	1.32	3	4	1
0052	3T	23	235	18	1	1800	2820	1020	0.06	1.57	3	4	1
0052	3T	23	236	14	0	1400	0	-1400	0.00	0.00	2	0	-2
0052	3T	23	241	6	0	600	0	-600	0.00	0.00	1	0	-1
0052	3T	23	243	8	0	800	0	-800	0.00	0.00	1	0	-1
0052	3T	23	245	8	1	800	1350	550	0.13	1.69	1	2	1
0052	3T	23	246	9	0	900	0	-900	0.00	0.00	1	0	-1
0052	3T	23	251	2	0	200	0	-200	0.00	0.00	0	0	0
0052	3T	23	253	3	0	300	0	-300	0.00	0.00	0	0	0
0052	3T	23	254	7	0	700	0	-700	0.00	0.00	1	0	-1
0052	3T	23	261	3	0	300	0	-300	0.00	0.00	0	0	0
0052	3T	23	263	7	0	700	0	-700	0.00	0.00	1	0	-1
0052	3T	23	264	5	0	500	0	-500	0.00	0.00	0	0	0
0052	3T	23	265	3	0	300	0	-300	0.00	0.00	0	0	0
0052	3T	24	123	213	35	21300	22670	1370	0.16	1.06	37	40	3
0052	3T	24	124	175	16	17500	11160	-6340	0.09	0.64	30	19	-11
0052	3T	24	125	132	9	13200	11330	-1870	0.07	0.86	23	20	-3
0052	3T	24	126	115	4	11500	3770	-7730	0.03	0.33	20	6	-14
0052	3T	24	132	117	5	11700	4510	-7190	0.04	0.39	20	7	-13
0052	3T	24	134	112	10	11200	11260	60	0.09	1.01	19	19	0
0052	3T	24	135	95	9	9500	11610	2110	0.09	1.22	16	20	4
0052	3T	24	136	65	4	6500	7130	630	0.06	1.10	11	12	1
0052	3T	24	142	68	6	6800	6780	-20	0.09	1.00	12	12	0
0052	3T	24	143	78	1	7800	660	-7140	0.01	0.08	13	1	-12
0052	3T	24	145	67	2	6700	4000	-2700	0.03	0.60	11	7	-4
0052	3T	24	146	65	2	6500	3530	-2970	0.03	0.54	11	6	-5
0052	3T	24	152	43	2	4300	2560	-1740	0.05	0.60	7	4	-3
0052	3T	24	153	28	0	2800	0	-2800	0.00	0.00	4	0	-4
0052	3T	24	154	35	0	3500	0	-3500	0.00	0.00	6	0	-6
0052	3T	24	156	25	1	2500	4070	1570	0.04	1.63	4	7	3
0052	3T	24	162	23	3	2300	3010	710	0.13	1.31	4	5	1
0052	3T	24	163	25	1	2500	11170	8670	0.04	4.47	4	19	15
0052	3T	24	164	23	0	2300	0	-2300	0.00	0.00	4	0	-4
0052	3T	24	165	23	0	2300	0	-2300	0.00	0.00	4	0	-4
0052	3T	24	213	8	0	800	0	-800	0.00	0.00	1	0	-1
0052	3T	24	214	10	0	1000	0	-1000	0.00	0.00	1	0	-1
0052	3T	24	215	7	1	700	2820	2120	0.14	4.03	1	4	3
0052	3T	24	216	10	0	1000	0	-1000	0.00	0.00	1	0	-1
0052	3T	24	231	6	0	600	0	-600	0.00	0.00	1	0	-1
0052	3T	24	234	13	0	1300	0	-1300	0.00	0.00	2	0	-2
0052	3T	24	235	15	1	1500	640	-860	0.07	0.43	2	1	-1
0052	3T	24	236	13	1	1300	4380	3080	0.08	3.37	2	7	5
0052	3T	24	241	3	0	300	0	-300	0.00	0.00	0	0	0
0052	3T	24	243	9	0	900	0	-900	0.00	0.00	1	0	-1
0052	3T	24	245	7	0	700	0	-700	0.00	0.00	1	0	-1
0052	3T	24	246	4	0	400	0	-400	0.00	0.00	0	0	0
0052	3T	24	251	3	0	300	0	-300	0.00	0.00	0	0	0
0052	3T	24	253	4	0	400	0	-400	0.00	0.00	0	0	0
0052	3T	24	254	1	0	100	0	-100	0.00	0.00	0	0	0
0052	3T	24	256	5	0	500	0	-500	0.00	0.00	0	0	0
0052	3T	24	261	2	1	200	3590	3390	0.50	17.95	0	6	6
0052	3T	24	263	4	1	400	3480	3080	0.25	8.70	0	6	6
0052	3T	24	264	3	0	300	0	-300	0.00	0.00	0	0	0
0052	3T	24	265	4	0	400	0	-400	0.00	0.00	0	0	0
0011	2F	3_1	13	235	46	23500	15940	-7560	0.20	0.68	41	28	-13
0011	2F	3_1	14	189	27	18900	12200	-6700	0.14	0.65	33	21	-12
0011	2F	3_1	15	61	6	6100	2940	-3160	0.10	0.48	10	5	-5
0011	2F	3_1	16	20	2	2000	600	-1400	0.10	0.30	3	1	-2
0011	2F	3_1	23	19	2	1900	1080	-820	0.11	0.57	3	1	-2
0011	2F	3_1	24	11	0	1100	0	-1100	0.00	0.00	1	0	-1
0011	2F	3_1	25	7	0	700	0	-700	0.00	0.00	1	0	-1
0011	2F	3_1	26	5	0	500	0	-500	0.00	0.00	0	0	0
0011	2F	3_10	12	404	133	40400	35130	-5270	0.33	0.87	71	62	-9
0011	2F	3_10	13	252	78	25200	26270	1070	0.31	1.04	44	46	2
0011	2F	3_10	14	132	31	13200	12420	-780	0.23	0.94	23	21	-2
0011	2F	3_10	15	65	12	6500	4870	-1630	0.18	0.75	11	8	-3
0011	2F	3_10	16	39	4	3900	3260	-640	0.10	0.84	6	5	-1
0011	2F	3_10	23	15	0	1500	0	-1500	0.00	0.00	2	0	-2
0011	2F	3_10	24	3	0	300	0	-300	0.00	0.00	0	0	0
0011	2F	3_10	25	6	1	600	670	70	0.17	1.12	1	1	0
0011	2F	3_10	26	6	0	600	0	-600	0.00	0.00	1	0	-1
0011	2F	3_11	12	489	146	48900	38000	-10900	0.30	0.78	86	67	-19
0011	2F	3_11	13	275	68	27500	23220	-4280	0.25	0.84	48	41	-7
0011	2F	3_11	14	129	33	12900	12270	-630	0.26	0.95	22	21	-1
0011	2F	3_11	15	62	8	6200	4300	-1900	0.13	0.69	10	7	-3
0011	2F	3_11	16	26	4	2600	2710	110	0.15	1.04	4	4	0
0011	2F	3_11	23	5	0	500	0	-500	0.00	0.00	0	0	0
0011	2F	3_11	24	3	0	300	0	-300	0.00	0.00	0	0	0
0011	2F	3_11	25	2	0	200	0	-200	0.00	0.00	0	0	0
0011	2F	3_11	26	1	0	100	0	-100	0.00	0.00	0	0	0
0011	2F	3_12	12	534	166	53400	46690	-6710	0.31	0.87	94	82	-12
0011	2F	3_12	13	277	77	27700	24760	-2940	0.28	0.89	49	43	-6
0011	2F	3_12	14	163	30	16300	13700	-2600	0.18	0.84	28	24	-4
0011	2F	3_12	15	61	6	6100	4810	-1290	0.10	0.79	10	8	-2
0011	2F	3_12	16	18	3	1800	1610	-190	0.17	0.89	3	2	-1
0011	2F	3_12	23	3	0	300	0	-300	0.00	0.00	0	0	0
0011	2F	3_12	25	1	1	100	2970	2870	1.00	29.70	0	5	5
0011	2F	3_12	26	1	0	100	0	-100	0.00	0.00	0	0	0
0011	2F	3_2	12	331	87	33100	28500	-4600	0.26	0.86	58	50	-8
0011	2F	3_2	13	191	30	19100	14480	-4620	0.16	0.76	33	25	-8
0011	2F	3_2	14	149	19	14900	10570	-4330	0.13	0.71	26	18	-8
0011	2F	3_2	15	74	6	7400	3610	-3790	0.08	0.49	13	6	-7
0011	2F	3_2	16	20	1	2000	1070	-930	0.05	0.54	3	1	-2
0011	2F	3_2	23	33	1	3300	2220	-1080	0.03	0.67	5	3	-2
0011	2F	3_2	24	25	2	2500	2450	-50	0.08	0.98	4	4	0
0011	2F	3_2	25	9	1	900	1750	850	0.11	1.94	1	3	2
0011	2F	3_2	26	8	0	800	0	-800	0.00	0.00	1	0	-1
0011	2F	3_3	12	325	74	32500	30620	-1880	0.23	0.94	57	54	-3
0011	2F	3_3	13	221	54	22100	20140	-1960	0.24	0.91	39	35	-4
0011	2F	3_3	14	134	14	13400	8830	-4570	0.10	0.66	23	15	-8
0011	2F	3_3	15	63	8	6300	3460	-2840	0.13	0.55	11	6	-5
0011	2F	3_3	16	31	4	3100	2730	-370	0.13	0.88	5	4	-1
0011	2F	3_3	23	39	3	3900	1460	-2440	0.08	0.37	6	2	-4
0011	2F	3_3	24	18	1	1800	600	-1200	0.06	0.33	3	1	-2
0011	2F	3_3	25	8	0	800	0	-800	0.00	0.00	1	0	-1
0011	2F	3_3	26	8	1	800	420	-380	0.13	0.53	1	0	-1
0011	2F	3_4	12	339	86	33900	27050	-6850	0.25	0.80	60	47	-13
0011	2F	3_4	13	217	51	21700	23110	1410	0.24	1.06	38	40	2
0011	2F	3_4	14	99	16	9900	11830	1930	0.16	1.19	17	20	3
0011	2F	3_4	15	68	9	6800	10190	3390	0.13	1.50	12	18	6
0011	2F	3_4	16	32	2	3200	420	-2780	0.06	0.13	5	0	-5
0011	2F	3_4	23	32	2	3200	1340	-1860	0.06	0.42	5	2	-3
0011	2F	3_4	24	7	2	700	970	270	0.29	1.39	1	1	0
0011	2F	3_4	25	12	1	1200	470	-730	0.08	0.39	2	0	-2
0011	2F	3_4	26	11	1	1100	450	-650	0.09	0.41	1	0	-1
0011	2F	3_5	12	380	116	38000	35680	-2320	0.31	0.94	67	63	-4
0011	2F	3_5	13	216	50	21600	27870	6270	0.23	1.29	38	49	11
0011	2F	3_5	14	130	25	13000	10300	-2700	0.19	0.79	23	18	-5
0011	2F	3_5	15	44	6	4400	11700	7300	0.14	2.66	7	20	13
0011	2F	3_5	16	39	1	3900	230	-3670	0.03	0.06	6	0	-6
0011	2F	3_5	23	20	5	2000	2500	500	0.25	1.25	3	4	1
0011	2F	3_5	24	21	1	2100	260	-1840	0.05	0.12	3	0	-3
0011	2F	3_5	25	9	2	900	580	-320	0.22	0.64	1	1	0
0011	2F	3_5	26	9	0	900	0	-900	0.00	0.00	1	0	-1
0011	2F	3_6	12	327	95	32700	32750	50	0.29	1.00	57	57	0
0011	2F	3_6	13	191	40	19100	12010	-7090	0.21	0.63	33	21	-12
0011	2F	3_6	14	104	18	10400	8640	-1760	0.17	0.83	18	15	-3
0011	2F	3_6	15	61	11	6100	5880	-220	0.18	0.96	10	10	0
0011	2F	3_6	16	32	6	3200	9360	6160	0.19	2.93	5	16	11
0011	2F	3_6	23	40	3	4000	1430	-2570	0.08	0.36	7	2	-5
0011	2F	3_6	24	28	2	2800	1620	-1180	0.07	0.58	4	2	-2
0011	2F	3_6	25	22	3	2200	2400	200	0.14	1.09	3	4	1
0011	2F	3_6	26	18	2	1800	880	-920	0.11	0.49	3	1	-2
0011	2F	3_7	12	317	84	31700	27800	-3900	0.26	0.88	56	49	-7
0011	2F	3_7	13	198	44	19800	14640	-5160	0.22	0.74	35	25	-10
0011	2F	3_7	14	131	33	13100	13620	520	0.25	1.04	23	24	1
0011	2F	3_7	15	53	12	5300	3910	-1390	0.23	0.74	9	6	-3
0011	2F	3_7	16	38	3	3800	2430	-1370	0.08	0.64	6	4	-2
0011	2F	3_7	23	31	3	3100	1210	-1890	0.10	0.39	5	2	-3
0011	2F	3_7	24	15	1	1500	430	-1070	0.07	0.29	2	0	-2
0011	2F	3_7	25	13	1	1300	520	-780	0.08	0.40	2	0	-2
0011	2F	3_7	26	15	2	1500	4060	2560	0.13	2.71	2	7	5
0011	2F	3_8	12	313	104	31300	32960	1660	0.33	1.05	55	58	3
0011	2F	3_8	13	214	61	21400	19200	-2200	0.29	0.90	37	33	-4
0011	2F	3_8	14	118	24	11800	7490	-4310	0.20	0.63	20	13	-7
0011	2F	3_8	15	68	10	6800	4870	-1930	0.15	0.72	12	8	-4
0011	2F	3_8	16	36	7	3600	14820	11220	0.19	4.12	6	26	20
0011	2F	3_8	23	33	3	3300	1860	-1440	0.09	0.56	5	3	-2
0011	2F	3_8	24	18	3	1800	1190	-610	0.17	0.66	3	2	-1
0011	2F	3_8	25	13	4	1300	1580	280	0.31	1.22	2	2	0
0011	2F	3_8	26	10	1	1000	1480	480	0.10	1.48	1	2	1
0011	2F	3_9	12	372	120	37200	32600	-4600	0.32	0.88	65	57	-8
0011	2F	3_9	13	218	55	21800	19620	-2180	0.25	0.90	38	34	-4
0011	2F	3_9	14	121	23	12100	7320	-4780	0.19	0.60	21	12	-9
0011	2F	3_9	15	61	9	6100	3650	-2450	0.15	0.60	10	6	-4
0011	2F	3_9	16	23	1	2300	570	-1730	0.04	0.25	4	1	-3
0011	2F	3_9	23	18	1	1800	540	-1260	0.06	0.30	3	0	-3
0011	2F	3_9	24	11	2	1100	1510	410	0.18	1.37	1	2	1
0011	2F	3_9	25	7	0	700	0	-700	0.00	0.00	1	0	-1
0011	2F	3_9	26	9	0	900	0	-900	0.00	0.00	1	0	-1
0011	2F	4_1	12	301	103	30100	26270	-3830	0.34	0.87	53	46	-7
0011	2F	4_1	13	171	44	17100	13470	-3630	0.26	0.79	30	23	-7
0011	2F	4_1	14	130	32	13000	10550	-2450	0.25	0.81	23	18	-5
0011	2F	4_1	15	35	6	3500	2760	-740	0.17	0.79	6	4	-2
0011	2F	4_1	16	23	6	2300	4420	2120	0.26	1.92	4	7	3
0011	2F	4_1	23	14	0	1400	0	-1400	0.00	0.00	2	0	-2
0011	2F	4_1	24	7	0	700	0	-700	0.00	0.00	1	0	-1
0011	2F	4_1	25	5	0	500	0	-500	0.00	0.00	0	0	0
0011	2F	4_1	26	7	2	700	2090	1390	0.29	2.99	1	3	2
0011	2F	4_10	12	389	102	38900	26680	-12220	0.26	0.69	68	47	-21
0011	2F	4_10	13	212	60	21200	23240	2040	0.28	1.10	37	41	4
0011	2F	4_10	14	138	18	13800	8850	-4950	0.13	0.64	24	15	-9
0011	2F	4_10	15	36	7	3600	4530	930	0.19	1.26	6	8	2
0011	2F	4_10	16	7	0	700	0	-700	0.00	0.00	1	0	-1
0011	2F	4_10	23	5	0	500	0	-500	0.00	0.00	0	0	0
0011	2F	4_10	24	9	0	900	0	-900	0.00	0.00	1	0	-1
0011	2F	4_10	25	3	0	300	0	-300	0.00	0.00	0	0	0
0011	2F	4_11	12	417	142	41700	41660	-40	0.34	1.00	73	73	0
0011	2F	4_11	13	227	60	22700	20500	-2200	0.26	0.90	40	36	-4
0011	2F	4_11	14	153	29	15300	12070	-3230	0.19	0.79	27	21	-6
0011	2F	4_11	15	38	4	3800	3200	-600	0.11	0.84	6	5	-1
0011	2F	4_11	16	7	1	700	1230	530	0.14	1.76	1	2	1
0011	2F	4_11	23	2	0	200	0	-200	0.00	0.00	0	0	0
0011	2F	4_11	24	3	1	300	690	390	0.33	2.30	0	1	1
0011	2F	4_11	26	1	0	100	0	-100	0.00	0.00	0	0	0
0011	2F	4_12	12	430	131	43000	34010	-8990	0.30	0.79	76	60	-16
0011	2F	4_12	13	255	70	25500	23180	-2320	0.27	0.91	45	41	-4
0011	2F	4_12	14	126	18	12600	9180	-3420	0.14	0.73	22	16	-6
0011	2F	4_12	15	31	2	3100	1540	-1560	0.06	0.50	5	2	-3
0011	2F	4_12	16	5	0	500	0	-500	0.00	0.00	0	0	0
0011	2F	4_12	23	2	0	200	0	-200	0.00	0.00	0	0	0
0011	2F	4_12	24	1	0	100	0	-100	0.00	0.00	0	0	0
0011	2F	4_12	25	1	0	100	0	-100	0.00	0.00	0	0	0
0011	2F	4_12	26	2	0	200	0	-200	0.00	0.00	0	0	0
0011	2F	4_2	12	302	87	30200	25590	-4610	0.29	0.85	53	45	-8
0011	2F	4_2	13	154	39	15400	14730	-670	0.25	0.96	27	26	-1
0011	2F	4_2	14	88	21	8800	4730	-4070	0.24	0.54	15	8	-7
0011	2F	4_2	15	33	7	3300	3580	280	0.21	1.08	5	6	1
0011	2F	4_2	16	19	1	1900	800	-1100	0.05	0.42	3	1	-2
0011	2F	4_2	23	35	8	3500	3710	210	0.23	1.06	6	6	0
0011	2F	4_2	24	9	1	900	250	-650	0.11	0.28	1	0	-1
0011	2F	4_2	25	10	0	1000	0	-1000	0.00	0.00	1	0	-1
0011	2F	4_2	26	9	0	900	0	-900	0.00	0.00	1	0	-1
0011	2F	4_3	12	256	77	25600	27410	1810	0.30	1.07	45	48	3
0011	2F	4_3	13	193	56	19300	15960	-3340	0.29	0.83	34	28	-6
0011	2F	4_3	14	73	15	7300	5020	-2280	0.21	0.69	12	8	-4
0011	2F	4_3	15	40	7	4000	3790	-210	0.18	0.95	7	6	-1
0011	2F	4_3	16	21	4	2100	6690	4590	0.19	3.19	3	11	8
0011	2F	4_3	23	26	5	2600	1520	-1080	0.19	0.58	4	2	-2
0011	2F	4_3	24	25	4	2500	12060	9560	0.16	4.82	4	21	17
0011	2F	4_3	25	17	2	1700	880	-820	0.12	0.52	3	1	-2
0011	2F	4_3	26	12	4	1200	1430	230	0.33	1.19	2	2	0
0011	2F	4_4	12	277	81	27700	23870	-3830	0.29	0.86	49	42	-7
0011	2F	4_4	13	174	46	17400	16400	-1000	0.26	0.94	30	29	-1
0011	2F	4_4	14	107	23	10700	9160	-1540	0.21	0.86	18	16	-2
0011	2F	4_4	15	47	6	4700	1810	-2890	0.13	0.39	8	3	-5
0011	2F	4_4	16	22	3	2200	2440	240	0.14	1.11	3	4	1
0011	2F	4_4	23	26	1	2600	390	-2210	0.04	0.15	4	0	-4
0011	2F	4_4	24	16	3	1600	1060	-540	0.19	0.66	2	1	-1
0011	2F	4_4	25	11	1	1100	350	-750	0.09	0.32	1	0	-1
0011	2F	4_4	26	9	0	900	0	-900	0.00	0.00	1	0	-1
0011	2F	4_5	12	336	97	33600	23190	-10410	0.29	0.69	59	41	-18
0011	2F	4_5	13	159	42	15900	11960	-3940	0.26	0.75	28	21	-7
0011	2F	4_5	14	106	17	10600	6340	-4260	0.16	0.60	18	11	-7
0011	2F	4_5	15	46	5	4600	6810	2210	0.11	1.48	8	12	4
0011	2F	4_5	16	25	4	2500	5310	2810	0.16	2.12	4	9	5
0011	2F	4_5	23	29	3	2900	1340	-1560	0.10	0.46	5	2	-3
0011	2F	4_5	24	20	4	2000	4000	2000	0.20	2.00	3	7	4
0011	2F	4_5	25	10	2	1000	860	-140	0.20	0.86	1	1	0
0011	2F	4_5	26	2	1	200	210	10	0.50	1.05	0	0	0
0011	2F	4_6	12	260	86	26000	23490	-2510	0.33	0.90	46	41	-5
0011	2F	4_6	13	162	45	16200	12730	-3470	0.28	0.79	28	22	-6
0011	2F	4_6	14	84	19	8400	7670	-730	0.23	0.91	14	13	-1
0011	2F	4_6	15	46	8	4600	2750	-1850	0.17	0.60	8	4	-4
0011	2F	4_6	16	22	2	2200	930	-1270	0.09	0.42	3	1	-2
0011	2F	4_6	23	36	8	3600	5580	1980	0.22	1.55	6	9	3
0011	2F	4_6	24	10	3	1000	790	-210	0.30	0.79	1	1	0
0011	2F	4_6	25	18	2	1800	680	-1120	0.11	0.38	3	1	-2
0011	2F	4_6	26	10	1	1000	170	-830	0.10	0.17	1	0	-1
0011	2F	4_7	12	246	67	24600	20210	-4390	0.27	0.82	43	35	-8
0011	2F	4_7	13	173	43	17300	13110	-4190	0.25	0.76	30	23	-7
0011	2F	4_7	14	121	29	12100	9310	-2790	0.24	0.77	21	16	-5
0011	2F	4_7	15	48	9	4800	4590	-210	0.19	0.96	8	8	0
0011	2F	4_7	16	28	6	2800	5210	2410	0.21	1.86	4	9	5
0011	2F	4_7	23	24	3	2400	970	-1430	0.13	0.40	4	1	-3
0011	2F	4_7	24	9	2	900	770	-130	0.22	0.86	1	1	0
0011	2F	4_7	25	14	3	1400	5130	3730	0.21	3.66	2	9	7
0011	2F	4_7	26	11	2	1100	960	-140	0.18	0.87	1	1	0
0011	2F	4_8	12	293	94	29300	24850	-4450	0.32	0.85	51	43	-8
0011	2F	4_8	13	152	36	15200	11150	-4050	0.24	0.73	26	19	-7
0011	2F	4_8	14	109	34	10900	9210	-1690	0.31	0.84	19	16	-3
0011	2F	4_8	15	65	9	6500	3160	-3340	0.14	0.49	11	5	-6
0011	2F	4_8	16	31	3	3100	680	-2420	0.10	0.22	5	1	-4
0011	2F	4_8	23	29	7	2900	3580	680	0.24	1.23	5	6	1
0011	2F	4_8	24	12	3	1200	770	-430	0.25	0.64	2	1	-1
0011	2F	4_8	25	8	1	800	1590	790	0.13	1.99	1	2	1
0011	2F	4_8	26	6	0	600	0	-600	0.00	0.00	1	0	-1
0011	2F	4_9	12	330	122	33000	30090	-2910	0.37	0.91	58	53	-5
0011	2F	4_9	13	209	63	20900	19190	-1710	0.30	0.92	36	33	-3
0011	2F	4_9	14	126	35	12600	11200	-1400	0.28	0.89	22	19	-3
0011	2F	4_9	15	38	8	3800	3790	-10	0.21	1.00	6	6	0
0011	2F	4_9	16	17	2	1700	1370	-330	0.12	0.81	3	2	-1
0011	2F	4_9	23	13	1	1300	850	-450	0.08	0.65	2	1	-1
0011	2F	4_9	24	9	2	900	1230	330	0.22	1.37	1	2	1
0011	2F	4_9	25	9	0	900	0	-900	0.00	0.00	1	0	-1
0011	2F	4_9	26	3	0	300	0	-300	0.00	0.00	0	0	0
0011	2F	5_1	12	224	67	22400	17650	-4750	0.30	0.79	39	31	-8
0011	2F	5_1	13	143	35	14300	13240	-1060	0.24	0.93	25	23	-2
0011	2F	5_1	14	99	20	9900	7790	-2110	0.20	0.79	17	13	-4
0011	2F	5_1	15	42	9	4200	5160	960	0.21	1.23	7	9	2
0011	2F	5_1	16	13	1	1300	860	-440	0.08	0.66	2	1	-1
0011	2F	5_1	23	16	0	1600	0	-1600	0.00	0.00	2	0	-2
0011	2F	5_1	24	7	0	700	0	-700	0.00	0.00	1	0	-1
0011	2F	5_1	25	2	0	200	0	-200	0.00	0.00	0	0	0
0011	2F	5_1	26	4	0	400	0	-400	0.00	0.00	0	0	0
0011	2F	5_10	12	356	135	35600	27680	-7920	0.38	0.78	63	48	-15
0011	2F	5_10	13	162	35	16200	11910	-4290	0.22	0.74	28	21	-7
0011	2F	5_10	14	65	16	6500	6970	470	0.25	1.07	11	12	1
0011	2F	5_10	15	20	2	2000	1400	-600	0.10	0.70	3	2	-1
0011	2F	5_10	16	9	1	900	5230	4330	0.11	5.81	1	9	8
0011	2F	5_10	23	9	1	900	600	-300	0.11	0.67	1	1	0
0011	2F	5_10	24	2	0	200	0	-200	0.00	0.00	0	0	0
0011	2F	5_10	25	1	0	100	0	-100	0.00	0.00	0	0	0
0011	2F	5_10	26	1	0	100	0	-100	0.00	0.00	0	0	0
0011	2F	5_11	12	379	145	37900	28360	-9540	0.38	0.75	67	50	-17
0011	2F	5_11	13	183	51	18300	15660	-2640	0.28	0.86	32	27	-5
0011	2F	5_11	14	67	9	6700	3910	-2790	0.13	0.58	11	6	-5
0011	2F	5_11	15	24	0	2400	0	-2400	0.00	0.00	4	0	-4
0011	2F	5_11	16	2	0	200	0	-200	0.00	0.00	0	0	0
0011	2F	5_11	23	6	0	600	0	-600	0.00	0.00	1	0	-1
0011	2F	5_11	25	1	0	100	0	-100	0.00	0.00	0	0	0
0011	2F	5_12	12	334	140	33400	29680	-3720	0.42	0.89	59	52	-7
0011	2F	5_12	13	186	53	18600	16300	-2300	0.28	0.88	32	28	-4
0011	2F	5_12	14	86	23	8600	9830	1230	0.27	1.14	15	17	2
0011	2F	5_12	15	33	4	3300	2220	-1080	0.12	0.67	5	3	-2
0011	2F	5_12	16	4	1	400	500	100	0.25	1.25	0	0	0
0011	2F	5_12	23	7	1	700	730	30	0.14	1.04	1	1	0
0011	2F	5_12	24	1	0	100	0	-100	0.00	0.00	0	0	0
0011	2F	5_12	25	3	0	300	0	-300	0.00	0.00	0	0	0
0011	2F	5_12	26	1	0	100	0	-100	0.00	0.00	0	0	0
0011	2F	5_2	12	212	58	21200	16490	-4710	0.27	0.78	37	29	-8
0011	2F	5_2	13	118	21	11800	7160	-4640	0.18	0.61	20	12	-8
0011	2F	5_2	14	90	21	9000	8880	-120	0.23	0.99	15	15	0
0011	2F	5_2	15	39	7	3900	5300	1400	0.18	1.36	6	9	3
0011	2F	5_2	16	20	2	2000	1190	-810	0.10	0.60	3	2	-1
0011	2F	5_2	23	17	1	1700	370	-1330	0.06	0.22	3	0	-3
0011	2F	5_2	24	8	2	800	2080	1280	0.25	2.60	1	3	2
0011	2F	5_2	25	9	0	900	0	-900	0.00	0.00	1	0	-1
0011	2F	5_2	26	2	0	200	0	-200	0.00	0.00	0	0	0
0011	2F	5_3	12	210	63	21000	24360	3360	0.30	1.16	37	43	6
0011	2F	5_3	13	148	35	14800	10730	-4070	0.24	0.73	26	18	-8
0011	2F	5_3	14	77	9	7700	3580	-4120	0.12	0.46	13	6	-7
0011	2F	5_3	15	38	4	3800	2880	-920	0.11	0.76	6	5	-1
0011	2F	5_3	16	18	2	1800	3990	2190	0.11	2.22	3	7	4
0011	2F	5_3	23	11	2	1100	670	-430	0.18	0.61	1	1	0
0011	2F	5_3	24	14	1	1400	260	-1140	0.07	0.19	2	0	-2
0011	2F	5_3	25	12	1	1200	3270	2070	0.08	2.73	2	5	3
0011	2F	5_3	26	6	1	600	1820	1220	0.17	3.03	1	3	2
0011	2F	5_4	12	214	60	21400	18250	-3150	0.28	0.85	37	32	-5
0011	2F	5_4	13	132	33	13200	14010	810	0.25	1.06	23	24	1
0011	2F	5_4	14	92	14	9200	5770	-3430	0.15	0.63	16	10	-6
0011	2F	5_4	15	36	4	3600	2340	-1260	0.11	0.65	6	4	-2
0011	2F	5_4	16	15	3	1500	2930	1430	0.20	1.95	2	5	3
0011	2F	5_4	23	10	1	1000	380	-620	0.10	0.38	1	0	-1
0011	2F	5_4	24	7	0	700	0	-700	0.00	0.00	1	0	-1
0011	2F	5_4	25	6	0	600	0	-600	0.00	0.00	1	0	-1
0011	2F	5_4	26	1	0	100	0	-100	0.00	0.00	0	0	0
0011	2F	5_5	12	243	84	24300	23530	-770	0.35	0.97	43	41	-2
0011	2F	5_5	13	146	32	14600	9420	-5180	0.22	0.65	25	16	-9
0011	2F	5_5	14	89	18	8900	5580	-3320	0.20	0.63	15	9	-6
0011	2F	5_5	15	29	11	2900	4540	1640	0.38	1.57	5	8	3
0011	2F	5_5	16	22	3	2200	2620	420	0.14	1.19	3	4	1
0011	2F	5_5	23	6	0	600	0	-600	0.00	0.00	1	0	-1
0011	2F	5_5	24	8	1	800	400	-400	0.13	0.50	1	0	-1
0011	2F	5_5	25	7	0	700	0	-700	0.00	0.00	1	0	-1
0011	2F	5_5	26	1	0	100	0	-100	0.00	0.00	0	0	0
0011	2F	5_6	12	214	63	21400	22460	1060	0.29	1.05	37	39	2
0011	2F	5_6	13	129	36	12900	11200	-1700	0.28	0.87	22	19	-3
0011	2F	5_6	14	98	18	9800	5620	-4180	0.18	0.57	17	9	-8
0011	2F	5_6	15	33	5	3300	2560	-740	0.15	0.78	5	4	-1
0011	2F	5_6	16	21	5	2100	1860	-240	0.24	0.89	3	3	0
0011	2F	5_6	23	18	5	1800	3750	1950	0.28	2.08	3	6	3
0011	2F	5_6	24	8	0	800	0	-800	0.00	0.00	1	0	-1
0011	2F	5_6	25	8	0	800	0	-800	0.00	0.00	1	0	-1
0011	2F	5_6	26	7	0	700	0	-700	0.00	0.00	1	0	-1
0011	2F	5_7	12	220	60	22000	23120	1120	0.27	1.05	38	40	2
0011	2F	5_7	13	151	47	15100	14380	-720	0.31	0.95	26	25	-1
0011	2F	5_7	14	107	26	10700	7590	-3110	0.24	0.71	18	13	-5
0011	2F	5_7	15	32	6	3200	2210	-990	0.19	0.69	5	3	-2
0011	2F	5_7	16	18	6	1800	4020	2220	0.33	2.23	3	7	4
0011	2F	5_7	23	10	0	1000	0	-1000	0.00	0.00	1	0	-1
0011	2F	5_7	24	5	0	500	0	-500	0.00	0.00	0	0	0
0011	2F	5_7	25	3	0	300	0	-300	0.00	0.00	0	0	0
0011	2F	5_7	26	3	0	300	0	-300	0.00	0.00	0	0	0
0011	2F	5_8	12	215	64	21500	19860	-1640	0.30	0.92	38	35	-3
0011	2F	5_8	13	142	41	14200	12510	-1690	0.29	0.88	25	22	-3
0011	2F	5_8	14	113	36	11300	8690	-2610	0.32	0.77	20	15	-5
0011	2F	5_8	15	31	4	3100	3120	20	0.13	1.01	5	5	0
0011	2F	5_8	16	26	6	2600	1790	-810	0.23	0.69	4	3	-1
0011	2F	5_8	23	12	0	1200	0	-1200	0.00	0.00	2	0	-2
0011	2F	5_8	24	4	0	400	0	-400	0.00	0.00	0	0	0
0011	2F	5_8	25	3	1	300	1840	1540	0.33	6.13	0	3	3
0011	2F	5_9	12	265	89	26500	21020	-5480	0.34	0.79	46	37	-9
0011	2F	5_9	13	158	37	15800	11160	-4640	0.23	0.71	27	19	-8
0011	2F	5_9	14	115	34	11500	12230	730	0.30	1.06	20	21	1
0011	2F	5_9	15	33	1	3300	440	-2860	0.03	0.13	5	0	-5
0011	2F	5_9	16	20	2	2000	2050	50	0.10	1.03	3	3	0
0011	2F	5_9	23	8	1	800	570	-230	0.13	0.71	1	1	0
0011	2F	5_9	24	5	0	500	0	-500	0.00	0.00	0	0	0
0011	2F	5_9	25	2	0	200	0	-200	0.00	0.00	0	0	0
0011	2F	6_1	12	20	6	2000	1330	-670	0.30	0.67	3	2	-1
0011	2F	6_1	13	12	4	1200	1170	-30	0.33	0.98	2	2	0
0011	2F	6_1	14	7	1	700	220	-480	0.14	0.31	1	0	-1
0011	2F	6_1	15	4	0	400	0	-400	0.00	0.00	0	0	0
0011	2F	6_1	16	1	0	100	0	-100	0.00	0.00	0	0	0
0011	2F	6_1	23	1	0	100	0	-100	0.00	0.00	0	0	0
0011	2F	6_1	25	1	0	100	0	-100	0.00	0.00	0	0	0
0011	2F	6_10	12	29	12	2900	2520	-380	0.41	0.87	5	4	-1
0011	2F	6_10	13	6	1	600	340	-260	0.17	0.57	1	0	-1
0011	2F	6_10	14	4	1	400	1040	640	0.25	2.60	0	1	1
0011	2F	6_10	15	2	0	200	0	-200	0.00	0.00	0	0	0
0011	2F	6_10	16	1	0	100	0	-100	0.00	0.00	0	0	0
0011	2F	6_11	12	29	13	2900	2170	-730	0.45	0.75	5	3	-2
0011	2F	6_11	13	16	3	1600	1000	-600	0.19	0.63	2	1	-1
0011	2F	6_11	14	4	0	400	0	-400	0.00	0.00	0	0	0
0011	2F	6_11	15	2	0	200	0	-200	0.00	0.00	0	0	0
0011	2F	6_11	24	1	0	100	0	-100	0.00	0.00	0	0	0
0011	2F	6_12	12	34	12	3400	2630	-770	0.35	0.77	6	4	-2
0011	2F	6_12	13	10	4	1000	880	-120	0.40	0.88	1	1	0
0011	2F	6_12	14	7	2	700	940	240	0.29	1.34	1	1	0
0011	2F	6_12	15	2	0	200	0	-200	0.00	0.00	0	0	0
0011	2F	6_2	12	10	5	1000	1120	120	0.50	1.12	1	1	0
0011	2F	6_2	13	7	0	700	0	-700	0.00	0.00	1	0	-1
0011	2F	6_2	14	13	2	1300	1330	30	0.15	1.02	2	2	0
0011	2F	6_2	15	3	0	300	0	-300	0.00	0.00	0	0	0
0011	2F	6_2	16	2	1	200	610	410	0.50	3.05	0	1	1
0011	2F	6_2	23	2	1	200	750	550	0.50	3.75	0	1	1
0011	2F	6_2	24	1	0	100	0	-100	0.00	0.00	0	0	0
0011	2F	6_2	26	1	0	100	0	-100	0.00	0.00	0	0	0
0011	2F	6_3	12	14	2	1400	520	-880	0.14	0.37	2	0	-2
0011	2F	6_3	13	11	2	1100	1170	70	0.18	1.06	1	2	1
0011	2F	6_3	14	12	1	1200	1340	140	0.08	1.12	2	2	0
0011	2F	6_3	15	2	0	200	0	-200	0.00	0.00	0	0	0
0011	2F	6_3	16	2	1	200	480	280	0.50	2.40	0	0	0
0011	2F	6_3	25	1	0	100	0	-100	0.00	0.00	0	0	0
0011	2F	6_3	26	1	0	100	0	-100	0.00	0.00	0	0	0
0011	2F	6_4	12	22	6	2200	1620	-580	0.27	0.74	3	2	-1
0011	2F	6_4	13	10	1	1000	270	-730	0.10	0.27	1	0	-1
0011	2F	6_4	14	6	1	600	330	-270	0.17	0.55	1	0	-1
0011	2F	6_4	15	2	0	200	0	-200	0.00	0.00	0	0	0
0011	2F	6_4	16	3	0	300	0	-300	0.00	0.00	0	0	0
0011	2F	6_4	24	1	0	100	0	-100	0.00	0.00	0	0	0
0011	2F	6_5	12	23	6	2300	1370	-930	0.26	0.60	4	2	-2
0011	2F	6_5	13	16	7	1600	1650	50	0.44	1.03	2	2	0
0011	2F	6_5	14	6	2	600	350	-250	0.33	0.58	1	0	-1
0011	2F	6_5	15	2	1	200	470	270	0.50	2.35	0	0	0
0011	2F	6_5	16	3	1	300	1560	1260	0.33	5.20	0	2	2
0011	2F	6_6	12	14	3	1400	1050	-350	0.21	0.75	2	1	-1
0011	2F	6_6	13	12	4	1200	1290	90	0.33	1.08	2	2	0
0011	2F	6_6	14	9	0	900	0	-900	0.00	0.00	1	0	-1
0011	2F	6_6	15	3	0	300	0	-300	0.00	0.00	0	0	0
0011	2F	6_6	16	4	1	400	270	-130	0.25	0.68	0	0	0
0011	2F	6_6	24	1	0	100	0	-100	0.00	0.00	0	0	0
0011	2F	6_7	12	15	5	1500	2280	780	0.33	1.52	2	4	2
0011	2F	6_7	13	12	4	1200	860	-340	0.33	0.72	2	1	-1
0011	2F	6_7	14	6	2	600	840	240	0.33	1.40	1	1	0
0011	2F	6_7	15	4	1	400	160	-240	0.25	0.40	0	0	0
0011	2F	6_7	16	3	0	300	0	-300	0.00	0.00	0	0	0
0011	2F	6_7	24	1	0	100	0	-100	0.00	0.00	0	0	0
0011	2F	6_8	12	12	2	1200	450	-750	0.17	0.38	2	0	-2
0011	2F	6_8	13	11	6	1100	1390	290	0.55	1.26	1	2	1
0011	2F	6_8	14	9	2	900	420	-480	0.22	0.47	1	0	-1
0011	2F	6_8	15	6	0	600	0	-600	0.00	0.00	1	0	-1
0011	2F	6_8	16	3	1	300	480	180	0.33	1.60	0	0	0
0011	2F	6_9	12	24	8	2400	1620	-780	0.33	0.68	4	2	-2
0011	2F	6_9	13	12	2	1200	490	-710	0.17	0.41	2	0	-2
0011	2F	6_9	14	7	0	700	0	-700	0.00	0.00	1	0	-1
0011	2F	6_9	15	2	0	200	0	-200	0.00	0.00	0	0	0
0011	2F	6_9	16	1	0	100	0	-100	0.00	0.00	0	0	0
0011	2F	6_9	23	1	0	100	0	-100	0.00	0.00	0	0	0
0011	2F	6_9	24	2	0	200	0	-200	0.00	0.00	0	0	0
0011	2F	7_1	12	367	113	36700	31400	-5300	0.31	0.86	64	55	-9
0011	2F	7_1	13	249	59	24900	20880	-4020	0.24	0.84	44	36	-8
0011	2F	7_1	14	143	38	14300	13370	-930	0.27	0.93	25	23	-2
0011	2F	7_1	15	40	3	4000	1140	-2860	0.08	0.29	7	2	-5
0011	2F	7_1	16	22	3	2200	3120	920	0.14	1.42	3	5	2
0011	2F	7_1	23	32	6	3200	5620	2420	0.19	1.76	5	9	4
0011	2F	7_1	24	9	0	900	0	-900	0.00	0.00	1	0	-1
0011	2F	7_1	25	10	1	1000	320	-680	0.10	0.32	1	0	-1
0011	2F	7_1	26	2	0	200	0	-200	0.00	0.00	0	0	0
0011	2F	7_10	12	504	182	50400	44940	-5460	0.36	0.89	89	79	-10
0011	2F	7_10	13	214	44	21400	15650	-5750	0.21	0.73	37	27	-10
0011	2F	7_10	14	154	22	15400	10200	-5200	0.14	0.66	27	18	-9
0011	2F	7_10	15	50	6	5000	2610	-2390	0.12	0.52	8	4	-4
0011	2F	7_10	16	15	1	1500	1050	-450	0.07	0.70	2	1	-1
0011	2F	7_10	23	15	0	1500	0	-1500	0.00	0.00	2	0	-2
0011	2F	7_10	24	7	0	700	0	-700	0.00	0.00	1	0	-1
0011	2F	7_10	25	3	0	300	0	-300	0.00	0.00	0	0	0
0011	2F	7_10	26	3	0	300	0	-300	0.00	0.00	0	0	0
0011	2F	7_11	12	508	180	50800	40450	-10350	0.35	0.80	89	71	-18
0011	2F	7_11	13	273	63	27300	23820	-3480	0.23	0.87	48	42	-6
0011	2F	7_11	14	129	22	12900	12170	-730	0.17	0.94	22	21	-1
0011	2F	7_11	15	44	1	4400	1350	-3050	0.02	0.31	7	2	-5
0011	2F	7_11	16	17	0	1700	0	-1700	0.00	0.00	3	0	-3
0011	2F	7_11	23	9	0	900	0	-900	0.00	0.00	1	0	-1
0011	2F	7_11	24	4	0	400	0	-400	0.00	0.00	0	0	0
0011	2F	7_11	25	1	1	100	1840	1740	1.00	18.40	0	3	3
0011	2F	7_11	26	2	0	200	0	-200	0.00	0.00	0	0	0
0011	2F	7_12	12	495	160	49500	37370	-12130	0.32	0.75	87	66	-21
0011	2F	7_12	13	245	41	24500	16170	-8330	0.17	0.66	43	28	-15
0011	2F	7_12	14	179	31	17900	13760	-4140	0.17	0.77	31	24	-7
0011	2F	7_12	15	52	5	5200	3610	-1590	0.10	0.69	9	6	-3
0011	2F	7_12	16	12	1	1200	1020	-180	0.08	0.85	2	1	-1
0011	2F	7_12	23	9	0	900	0	-900	0.00	0.00	1	0	-1
0011	2F	7_12	24	3	0	300	0	-300	0.00	0.00	0	0	0
0011	2F	7_12	25	4	0	400	0	-400	0.00	0.00	0	0	0
0011	2F	7_2	12	338	106	33800	31130	-2670	0.31	0.92	59	55	-4
0011	2F	7_2	13	226	45	22600	20610	-1990	0.20	0.91	40	36	-4
0011	2F	7_2	14	129	24	12900	8690	-4210	0.19	0.67	22	15	-7
0011	2F	7_2	15	39	1	3900	320	-3580	0.03	0.08	6	0	-6
0011	2F	7_2	16	19	1	1900	450	-1450	0.05	0.24	3	0	-3
0011	2F	7_2	23	34	2	3400	1440	-1960	0.06	0.42	6	2	-4
0011	2F	7_2	24	20	1	2000	280	-1720	0.05	0.14	3	0	-3
0011	2F	7_2	25	12	1	1200	580	-620	0.08	0.48	2	1	-1
0011	2F	7_2	26	5	0	500	0	-500	0.00	0.00	0	0	0
0011	2F	7_3	12	358	107	35800	33640	-2160	0.30	0.94	63	59	-4
0011	2F	7_3	13	222	69	22200	24660	2460	0.31	1.11	39	43	4
0011	2F	7_3	14	131	29	13100	13450	350	0.22	1.03	23	23	0
0011	2F	7_3	15	67	11	6700	5110	-1590	0.16	0.76	11	9	-2
0011	2F	7_3	16	29	3	2900	1230	-1670	0.10	0.42	5	2	-3
0011	2F	7_3	23	33	3	3300	2730	-570	0.09	0.83	5	4	-1
0011	2F	7_3	24	16	3	1600	1860	260	0.19	1.16	2	3	1
0011	2F	7_3	25	13	1	1300	1240	-60	0.08	0.95	2	2	0
0011	2F	7_3	26	4	0	400	0	-400	0.00	0.00	0	0	0
0011	2F	7_4	12	374	127	37400	33710	-3690	0.34	0.90	66	59	-7
0011	2F	7_4	13	252	60	25200	21120	-4080	0.24	0.84	44	37	-7
0011	2F	7_4	14	146	34	14600	16030	1430	0.23	1.10	25	28	3
0011	2F	7_4	15	65	9	6500	4290	-2210	0.14	0.66	11	7	-4
0011	2F	7_4	16	29	8	2900	6880	3980	0.28	2.37	5	12	7
0011	2F	7_4	23	24	4	2400	3520	1120	0.17	1.47	4	6	2
0011	2F	7_4	24	15	2	1500	2480	980	0.13	1.65	2	4	2
0011	2F	7_4	25	10	0	1000	0	-1000	0.00	0.00	1	0	-1
0011	2F	7_4	26	4	1	400	440	40	0.25	1.10	0	0	0
0011	2F	7_5	12	384	130	38400	34420	-3980	0.34	0.90	67	60	-7
0011	2F	7_5	13	248	53	24800	16660	-8140	0.21	0.67	43	29	-14
0011	2F	7_5	14	142	30	14200	10980	-3220	0.21	0.77	25	19	-6
0011	2F	7_5	15	50	7	5000	2860	-2140	0.14	0.57	8	5	-3
0011	2F	7_5	16	35	2	3500	1120	-2380	0.06	0.32	6	1	-5
0011	2F	7_5	23	15	1	1500	1390	-110	0.07	0.93	2	2	0
0011	2F	7_5	24	13	3	1300	2630	1330	0.23	2.02	2	4	2
0011	2F	7_5	25	8	1	800	1010	210	0.13	1.26	1	1	0
0011	2F	7_5	26	2	1	200	900	700	0.50	4.50	0	1	1
0011	2F	7_6	12	374	117	37400	32670	-4730	0.31	0.87	66	57	-9
0011	2F	7_6	13	255	62	25500	18630	-6870	0.24	0.73	45	32	-13
0011	2F	7_6	14	138	28	13800	6900	-6900	0.20	0.50	24	12	-12
0011	2F	7_6	15	63	11	6300	10780	4480	0.17	1.71	11	19	8
0011	2F	7_6	16	24	2	2400	1230	-1170	0.08	0.51	4	2	-2
0011	2F	7_6	23	22	3	2200	2520	320	0.14	1.15	3	4	1
0011	2F	7_6	24	14	0	1400	0	-1400	0.00	0.00	2	0	-2
0011	2F	7_6	25	9	3	900	1420	520	0.33	1.58	1	2	1
0011	2F	7_6	26	8	0	800	0	-800	0.00	0.00	1	0	-1
0011	2F	7_7	12	367	126	36700	34950	-1750	0.34	0.95	64	61	-3
0011	2F	7_7	13	238	57	23800	17910	-5890	0.24	0.75	42	31	-11
0011	2F	7_7	14	160	35	16000	11070	-4930	0.22	0.69	28	19	-9
0011	2F	7_7	15	59	9	5900	3340	-2560	0.15	0.57	10	5	-5
0011	2F	7_7	16	45	10	4500	3100	-1400	0.22	0.69	7	5	-2
0011	2F	7_7	23	12	1	1200	330	-870	0.08	0.28	2	0	-2
0011	2F	7_7	24	8	0	800	0	-800	0.00	0.00	1	0	-1
0011	2F	7_7	25	4	0	400	0	-400	0.00	0.00	0	0	0
0011	2F	7_7	26	6	1	600	740	140	0.17	1.23	1	1	0
0011	2F	7_8	12	380	111	38000	31240	-6760	0.29	0.82	67	55	-12
0011	2F	7_8	13	232	59	23200	19240	-3960	0.25	0.83	41	34	-7
0011	2F	7_8	14	160	36	16000	14800	-1200	0.23	0.93	28	26	-2
0011	2F	7_8	15	61	9	6100	6190	90	0.15	1.01	10	10	0
0011	2F	7_8	16	43	4	4300	1970	-2330	0.09	0.46	7	3	-4
0011	2F	7_8	23	14	1	1400	210	-1190	0.07	0.15	2	0	-2
0011	2F	7_8	24	8	1	800	370	-430	0.13	0.46	1	0	-1
0011	2F	7_8	25	9	2	900	1260	360	0.22	1.40	1	2	1
0011	2F	7_8	26	6	0	600	0	-600	0.00	0.00	1	0	-1
0011	2F	7_9	12	427	136	42700	39240	-3460	0.32	0.92	75	69	-6
0011	2F	7_9	13	264	69	26400	22210	-4190	0.26	0.84	46	39	-7
0011	2F	7_9	14	161	33	16100	12980	-3120	0.20	0.81	28	22	-6
0011	2F	7_9	15	60	9	6000	5730	-270	0.15	0.96	10	10	0
0011	2F	7_9	16	32	6	3200	3020	-180	0.19	0.94	5	5	0
0011	2F	7_9	23	3	1	300	910	610	0.33	3.03	0	1	1
0011	2F	7_9	24	7	1	700	1270	570	0.14	1.81	1	2	1
0011	2F	7_9	25	3	0	300	0	-300	0.00	0.00	0	0	0
0011	2F	7_9	26	2	1	200	1350	1150	0.50	6.75	0	2	2
0011	2T	1_1	12	320	58	32000	20640	-11360	0.18	0.65	56	36	-20
0011	2T	1_1	13	247	46	24700	21360	-3340	0.19	0.86	43	37	-6
0011	2T	1_1	14	183	28	18300	12360	-5940	0.15	0.68	32	21	-11
0011	2T	1_1	15	66	3	6600	2360	-4240	0.05	0.36	11	4	-7
0011	2T	1_1	16	15	0	1500	0	-1500	0.00	0.00	2	0	-2
0011	2T	1_1	21	25	1	2500	2000	-500	0.04	0.80	4	3	-1
0011	2T	1_1	23	15	0	1500	0	-1500	0.00	0.00	2	0	-2
0011	2T	1_1	24	11	2	1100	9230	8130	0.18	8.39	1	16	15
0011	2T	1_1	25	9	0	900	0	-900	0.00	0.00	1	0	-1
0011	2T	1_1	26	2	0	200	0	-200	0.00	0.00	0	0	0
0011	2T	1_10	12	470	107	47000	38150	-8850	0.23	0.81	83	67	-16
0011	2T	1_10	13	287	47	28700	17870	-10830	0.16	0.62	50	31	-19
0011	2T	1_10	14	137	20	13700	9870	-3830	0.15	0.72	24	17	-7
0011	2T	1_10	15	30	2	3000	1280	-1720	0.07	0.43	5	2	-3
0011	2T	1_10	16	20	1	2000	590	-1410	0.05	0.30	3	1	-2
0011	2T	1_10	21	15	4	1500	4240	2740	0.27	2.83	2	7	5
0011	2T	1_10	23	2	0	200	0	-200	0.00	0.00	0	0	0
0011	2T	1_10	24	1	0	100	0	-100	0.00	0.00	0	0	0
0011	2T	1_10	25	1	0	100	0	-100	0.00	0.00	0	0	0
0011	2T	1_10	26	3	0	300	0	-300	0.00	0.00	0	0	0
0011	2T	1_11	12	515	117	51500	41510	-9990	0.23	0.81	91	73	-18
0011	2T	1_11	13	271	48	27100	20280	-6820	0.18	0.75	47	35	-12
0011	2T	1_11	14	167	32	16700	14520	-2180	0.19	0.87	29	25	-4
0011	2T	1_11	15	39	7	3900	4940	1040	0.18	1.27	6	8	2
0011	2T	1_11	16	7	1	700	1770	1070	0.14	2.53	1	3	2
0011	2T	1_11	21	6	1	600	620	20	0.17	1.03	1	1	0
0011	2T	1_11	23	1	0	100	0	-100	0.00	0.00	0	0	0
0011	2T	1_11	24	1	0	100	0	-100	0.00	0.00	0	0	0
0011	2T	1_11	25	2	0	200	0	-200	0.00	0.00	0	0	0
0011	2T	1_12	12	612	156	61200	51430	-9770	0.25	0.84	108	91	-17
0011	2T	1_12	13	239	48	23900	19990	-3910	0.20	0.84	42	35	-7
0011	2T	1_12	14	149	30	14900	12090	-2810	0.20	0.81	26	21	-5
0011	2T	1_12	15	39	1	3900	750	-3150	0.03	0.19	6	1	-5
0011	2T	1_12	16	3	0	300	0	-300	0.00	0.00	0	0	0
0011	2T	1_12	21	1	0	100	0	-100	0.00	0.00	0	0	0
0011	2T	1_12	23	2	0	200	0	-200	0.00	0.00	0	0	0
0011	2T	1_12	25	1	0	100	0	-100	0.00	0.00	0	0	0
0011	2T	1_2	12	317	51	31700	22090	-9610	0.16	0.70	56	39	-17
0011	2T	1_2	13	239	31	23900	18910	-4990	0.13	0.79	42	33	-9
0011	2T	1_2	14	172	12	17200	6300	-10900	0.07	0.37	30	11	-19
0011	2T	1_2	15	65	5	6500	11550	5050	0.08	1.78	11	20	9
0011	2T	1_2	16	24	1	2400	520	-1880	0.04	0.22	4	0	-4
0011	2T	1_2	21	42	4	4200	5390	1190	0.10	1.28	7	9	2
0011	2T	1_2	23	17	1	1700	880	-820	0.06	0.52	3	1	-2
0011	2T	1_2	24	14	0	1400	0	-1400	0.00	0.00	2	0	-2
0011	2T	1_2	25	7	0	700	0	-700	0.00	0.00	1	0	-1
0011	2T	1_2	26	1	0	100	0	-100	0.00	0.00	0	0	0
0011	2T	1_3	12	291	32	29100	23030	-6070	0.11	0.79	51	40	-11
0011	2T	1_3	13	247	30	24700	14560	-10140	0.12	0.59	43	25	-18
0011	2T	1_3	14	151	19	15100	15210	110	0.13	1.01	26	26	0
0011	2T	1_3	15	78	5	7800	6480	-1320	0.06	0.83	13	11	-2
0011	2T	1_3	16	19	0	1900	0	-1900	0.00	0.00	3	0	-3
0011	2T	1_3	21	32	4	3200	4200	1000	0.13	1.31	5	7	2
0011	2T	1_3	23	23	0	2300	0	-2300	0.00	0.00	4	0	-4
0011	2T	1_3	24	13	0	1300	0	-1300	0.00	0.00	2	0	-2
0011	2T	1_3	25	6	1	600	1590	990	0.17	2.65	1	2	1
0011	2T	1_3	26	4	0	400	0	-400	0.00	0.00	0	0	0
0011	2T	1_4	12	373	63	37300	26030	-11270	0.17	0.70	66	46	-20
0011	2T	1_4	13	258	28	25800	18160	-7640	0.11	0.70	45	32	-13
0011	2T	1_4	14	140	19	14000	10570	-3430	0.14	0.76	24	18	-6
0011	2T	1_4	15	57	4	5700	1840	-3860	0.07	0.32	10	3	-7
0011	2T	1_4	16	27	2	2700	5150	2450	0.07	1.91	4	9	5
0011	2T	1_4	21	30	2	3000	2630	-370	0.07	0.88	5	4	-1
0011	2T	1_4	23	26	1	2600	680	-1920	0.04	0.26	4	1	-3
0011	2T	1_4	24	12	1	1200	310	-890	0.08	0.26	2	0	-2
0011	2T	1_4	25	4	0	400	0	-400	0.00	0.00	0	0	0
0011	2T	1_4	26	2	0	200	0	-200	0.00	0.00	0	0	0
0011	2T	1_5	12	331	75	33100	28410	-4690	0.23	0.86	58	50	-8
0011	2T	1_5	13	247	48	24700	29020	4320	0.19	1.17	43	51	8
0011	2T	1_5	14	158	22	15800	12540	-3260	0.14	0.79	27	22	-5
0011	2T	1_5	15	36	2	3600	1610	-1990	0.06	0.45	6	2	-4
0011	2T	1_5	16	14	1	1400	480	-920	0.07	0.34	2	0	-2
0011	2T	1_5	21	38	7	3800	3580	-220	0.18	0.94	6	6	0
0011	2T	1_5	23	30	5	3000	2000	-1000	0.17	0.67	5	3	-2
0011	2T	1_5	24	19	1	1900	350	-1550	0.05	0.18	3	0	-3
0011	2T	1_5	25	5	0	500	0	-500	0.00	0.00	0	0	0
0011	2T	1_5	26	5	0	500	0	-500	0.00	0.00	0	0	0
0011	2T	1_6	12	292	59	29200	31240	2040	0.20	1.07	51	55	4
0011	2T	1_6	13	198	27	19800	12950	-6850	0.14	0.65	35	22	-13
0011	2T	1_6	14	130	9	13000	5050	-7950	0.07	0.39	23	8	-15
0011	2T	1_6	15	45	5	4500	2040	-2460	0.11	0.45	7	3	-4
0011	2T	1_6	16	39	3	3900	3060	-840	0.08	0.78	6	5	-1
0011	2T	1_6	21	54	6	5400	7540	2140	0.11	1.40	9	13	4
0011	2T	1_6	23	27	3	2700	2150	-550	0.11	0.80	4	3	-1
0011	2T	1_6	24	12	4	1200	3160	1960	0.33	2.63	2	5	3
0011	2T	1_6	25	12	1	1200	830	-370	0.08	0.69	2	1	-1
0011	2T	1_6	26	10	0	1000	0	-1000	0.00	0.00	1	0	-1
0011	2T	1_7	12	300	46	30000	20310	-9690	0.15	0.68	53	35	-18
0011	2T	1_7	13	220	32	22000	12750	-9250	0.15	0.58	38	22	-16
0011	2T	1_7	14	134	24	13400	11300	-2100	0.18	0.84	23	20	-3
0011	2T	1_7	15	47	5	4700	4440	-260	0.11	0.94	8	7	-1
0011	2T	1_7	16	28	1	2800	2140	-660	0.04	0.76	4	3	-1
0011	2T	1_7	21	43	5	4300	3170	-1130	0.12	0.74	7	5	-2
0011	2T	1_7	23	30	3	3000	2450	-550	0.10	0.82	5	4	-1
0011	2T	1_7	24	25	5	2500	7410	4910	0.20	2.96	4	13	9
0011	2T	1_7	25	15	0	1500	0	-1500	0.00	0.00	2	0	-2
0011	2T	1_7	26	5	0	500	0	-500	0.00	0.00	0	0	0
0011	2T	1_8	12	306	60	30600	27890	-2710	0.20	0.91	54	49	-5
0011	2T	1_8	13	206	40	20600	16500	-4100	0.19	0.80	36	29	-7
0011	2T	1_8	14	144	17	14400	6690	-7710	0.12	0.46	25	11	-14
0011	2T	1_8	15	47	6	4700	8380	3680	0.13	1.78	8	14	6
0011	2T	1_8	16	18	0	1800	0	-1800	0.00	0.00	3	0	-3
0011	2T	1_8	21	55	9	5500	4330	-1170	0.16	0.79	9	7	-2
0011	2T	1_8	23	17	2	1700	960	-740	0.12	0.56	3	1	-2
0011	2T	1_8	24	15	2	1500	1150	-350	0.13	0.77	2	2	0
0011	2T	1_8	25	10	0	1000	0	-1000	0.00	0.00	1	0	-1
0011	2T	1_8	26	7	1	700	1040	340	0.14	1.49	1	1	0
0011	2T	1_9	12	326	83	32600	31260	-1340	0.25	0.96	57	55	-2
0011	2T	1_9	13	267	49	26700	22400	-4300	0.18	0.84	47	39	-8
0011	2T	1_9	14	138	24	13800	9320	-4480	0.17	0.68	24	16	-8
0011	2T	1_9	15	54	8	5400	10530	5130	0.15	1.95	9	18	9
0011	2T	1_9	16	24	1	2400	680	-1720	0.04	0.28	4	1	-3
0011	2T	1_9	21	34	7	3400	2630	-770	0.21	0.77	6	4	-2
0011	2T	1_9	23	17	1	1700	400	-1300	0.06	0.24	3	0	-3
0011	2T	1_9	24	12	2	1200	2140	940	0.17	1.78	2	3	1
0011	2T	1_9	25	4	0	400	0	-400	0.00	0.00	0	0	0
0011	2T	1_9	26	1	0	100	0	-100	0.00	0.00	0	0	0
0011	2T	2_1	12	338	101	33800	31800	-2000	0.30	0.94	59	56	-3
0011	2T	2_1	13	205	41	20500	15210	-5290	0.20	0.74	36	26	-10
0011	2T	2_1	14	148	37	14800	15480	680	0.25	1.05	26	27	1
0011	2T	2_1	15	53	7	5300	3310	-1990	0.13	0.62	9	5	-4
0011	2T	2_1	16	35	2	3500	1100	-2400	0.06	0.31	6	1	-5
0011	2T	2_1	21	27	0	2700	0	-2700	0.00	0.00	4	0	-4
0011	2T	2_1	23	13	0	1300	0	-1300	0.00	0.00	2	0	-2
0011	2T	2_1	24	10	0	1000	0	-1000	0.00	0.00	1	0	-1
0011	2T	2_1	25	10	1	1000	1310	310	0.10	1.31	1	2	1
0011	2T	2_1	26	6	0	600	0	-600	0.00	0.00	1	0	-1
0011	2T	2_10	12	437	92	43700	33950	-9750	0.21	0.78	77	60	-17
0011	2T	2_10	13	247	46	24700	17360	-7340	0.19	0.70	43	30	-13
0011	2T	2_10	14	123	13	12300	5860	-6440	0.11	0.48	21	10	-11
0011	2T	2_10	15	43	5	4300	2760	-1540	0.12	0.64	7	4	-3
0011	2T	2_10	16	46	4	4600	2990	-1610	0.09	0.65	8	5	-3
0011	2T	2_10	21	24	4	2400	1940	-460	0.17	0.81	4	3	-1
0011	2T	2_10	23	6	0	600	0	-600	0.00	0.00	1	0	-1
0011	2T	2_10	24	5	0	500	0	-500	0.00	0.00	0	0	0
0011	2T	2_10	25	4	0	400	0	-400	0.00	0.00	0	0	0
0011	2T	2_10	26	4	0	400	0	-400	0.00	0.00	0	0	0
0011	2T	2_11	12	495	111	49500	38680	-10820	0.22	0.78	87	68	-19
0011	2T	2_11	13	244	47	24400	14980	-9420	0.19	0.61	43	26	-17
0011	2T	2_11	14	172	31	17200	12530	-4670	0.18	0.73	30	22	-8
0011	2T	2_11	15	48	7	4800	4390	-410	0.15	0.91	8	7	-1
0011	2T	2_11	16	20	0	2000	0	-2000	0.00	0.00	3	0	-3
0011	2T	2_11	21	7	2	700	1260	560	0.29	1.80	1	2	1
0011	2T	2_11	23	3	1	300	670	370	0.33	2.23	0	1	1
0011	2T	2_11	24	2	0	200	0	-200	0.00	0.00	0	0	0
0011	2T	2_11	26	1	0	100	0	-100	0.00	0.00	0	0	0
0011	2T	2_12	12	548	146	54800	47660	-7140	0.27	0.87	96	84	-12
0011	2T	2_12	13	270	60	27000	20730	-6270	0.22	0.77	47	36	-11
0011	2T	2_12	14	182	33	18200	11970	-6230	0.18	0.66	32	21	-11
0011	2T	2_12	15	42	5	4200	2480	-1720	0.12	0.59	7	4	-3
0011	2T	2_12	16	6	0	600	0	-600	0.00	0.00	1	0	-1
0011	2T	2_12	21	2	0	200	0	-200	0.00	0.00	0	0	0
0011	2T	2_12	23	4	0	400	0	-400	0.00	0.00	0	0	0
0011	2T	2_12	24	1	0	100	0	-100	0.00	0.00	0	0	0
0011	2T	2_2	12	264	63	26400	25570	-830	0.24	0.97	46	45	-1
0011	2T	2_2	13	158	18	15800	14740	-1060	0.11	0.93	27	26	-1
0011	2T	2_2	14	138	19	13800	9280	-4520	0.14	0.67	24	16	-8
0011	2T	2_2	15	59	4	5900	2720	-3180	0.07	0.46	10	4	-6
0011	2T	2_2	16	42	5	4200	3820	-380	0.12	0.91	7	6	-1
0011	2T	2_2	21	35	7	3500	4040	540	0.20	1.15	6	7	1
0011	2T	2_2	23	34	2	3400	1310	-2090	0.06	0.39	6	2	-4
0011	2T	2_2	24	14	2	1400	10710	9310	0.14	7.65	2	18	16
0011	2T	2_2	25	5	1	500	590	90	0.20	1.18	0	1	1
0011	2T	2_2	26	11	0	1100	0	-1100	0.00	0.00	1	0	-1
0011	2T	2_3	12	262	43	26200	18980	-7220	0.16	0.72	46	33	-13
0011	2T	2_3	13	200	40	20000	15950	-4050	0.20	0.80	35	28	-7
0011	2T	2_3	14	103	11	10300	7520	-2780	0.11	0.73	18	13	-5
0011	2T	2_3	15	61	7	6100	4210	-1890	0.11	0.69	10	7	-3
0011	2T	2_3	16	55	5	5500	3840	-1660	0.09	0.70	9	6	-3
0011	2T	2_3	21	36	4	3600	5710	2110	0.11	1.59	6	10	4
0011	2T	2_3	23	26	4	2600	2820	220	0.15	1.08	4	4	0
0011	2T	2_3	24	20	1	2000	1470	-530	0.05	0.74	3	2	-1
0011	2T	2_3	25	10	1	1000	1630	630	0.10	1.63	1	2	1
0011	2T	2_3	26	18	2	1800	1960	160	0.11	1.09	3	3	0
0011	2T	2_4	12	304	68	30400	21440	-8960	0.22	0.71	53	37	-16
0011	2T	2_4	13	196	36	19600	19910	310	0.18	1.02	34	35	1
0011	2T	2_4	14	113	14	11300	6890	-4410	0.12	0.61	20	12	-8
0011	2T	2_4	15	63	8	6300	13750	7450	0.13	2.18	11	24	13
0011	2T	2_4	16	48	4	4800	5810	1010	0.08	1.21	8	10	2
0011	2T	2_4	21	49	5	4900	5260	360	0.10	1.07	8	9	1
0011	2T	2_4	23	25	2	2500	4110	1610	0.08	1.64	4	7	3
0011	2T	2_4	24	24	4	2400	1180	-1220	0.17	0.49	4	2	-2
0011	2T	2_4	25	14	1	1400	1220	-180	0.07	0.87	2	2	0
0011	2T	2_4	26	22	2	2200	3080	880	0.09	1.40	3	5	2
0011	2T	2_5	12	341	104	34100	34730	630	0.30	1.02	60	61	1
0011	2T	2_5	13	189	39	18900	17450	-1450	0.21	0.92	33	30	-3
0011	2T	2_5	14	117	14	11700	7140	-4560	0.12	0.61	20	12	-8
0011	2T	2_5	15	49	5	4900	3420	-1480	0.10	0.70	8	6	-2
0011	2T	2_5	16	47	9	4700	4710	10	0.19	1.00	8	8	0
0011	2T	2_5	21	43	13	4300	8380	4080	0.30	1.95	7	14	7
0011	2T	2_5	23	18	3	1800	3630	1830	0.17	2.02	3	6	3
0011	2T	2_5	24	18	4	1800	2560	760	0.22	1.42	3	4	1
0011	2T	2_5	25	9	0	900	0	-900	0.00	0.00	1	0	-1
0011	2T	2_5	26	7	0	700	0	-700	0.00	0.00	1	0	-1
0011	2T	2_6	12	278	41	27800	18660	-9140	0.15	0.67	49	33	-16
0011	2T	2_6	13	198	46	19800	22090	2290	0.23	1.12	35	39	4
0011	2T	2_6	14	100	14	10000	8670	-1330	0.14	0.87	17	15	-2
0011	2T	2_6	15	57	8	5700	4610	-1090	0.14	0.81	10	8	-2
0011	2T	2_6	16	59	10	5900	10130	4230	0.17	1.72	10	17	7
0011	2T	2_6	21	52	8	5200	4300	-900	0.15	0.83	9	7	-2
0011	2T	2_6	23	27	4	2700	4960	2260	0.15	1.84	4	8	4
0011	2T	2_6	24	16	1	1600	440	-1160	0.06	0.28	2	0	-2
0011	2T	2_6	25	14	2	1400	1910	510	0.14	1.36	2	3	1
0011	2T	2_6	26	14	3	1400	2220	820	0.21	1.59	2	3	1
0011	2T	2_7	12	290	59	29000	25270	-3730	0.20	0.87	51	44	-7
0011	2T	2_7	13	184	28	18400	10590	-7810	0.15	0.58	32	18	-14
0011	2T	2_7	14	121	26	12100	9730	-2370	0.21	0.80	21	17	-4
0011	2T	2_7	15	47	6	4700	3970	-730	0.13	0.84	8	7	-1
0011	2T	2_7	16	64	2	6400	1610	-4790	0.03	0.25	11	2	-9
0011	2T	2_7	21	36	8	3600	3860	260	0.22	1.07	6	6	0
0011	2T	2_7	23	24	0	2400	0	-2400	0.00	0.00	4	0	-4
0011	2T	2_7	24	12	0	1200	0	-1200	0.00	0.00	2	0	-2
0011	2T	2_7	25	15	1	1500	370	-1130	0.07	0.25	2	0	-2
0011	2T	2_7	26	18	1	1800	560	-1240	0.06	0.31	3	0	-3
0011	2T	2_8	12	284	59	28400	28230	-170	0.21	0.99	50	49	-1
0011	2T	2_8	13	191	37	19100	20710	1610	0.19	1.08	33	36	3
0011	2T	2_8	14	132	25	13200	11450	-1750	0.19	0.87	23	20	-3
0011	2T	2_8	15	54	8	5400	4090	-1310	0.15	0.76	9	7	-2
0011	2T	2_8	16	50	8	5000	7870	2870	0.16	1.57	8	13	5
0011	2T	2_8	21	49	12	4900	6040	1140	0.24	1.23	8	10	2
0011	2T	2_8	23	24	4	2400	4740	2340	0.17	1.98	4	8	4
0011	2T	2_8	24	10	1	1000	410	-590	0.10	0.41	1	0	-1
0011	2T	2_8	25	16	5	1600	4630	3030	0.31	2.89	2	8	6
0011	2T	2_8	26	12	1	1200	1550	350	0.08	1.29	2	2	0
0011	2T	2_9	12	340	74	34000	28130	-5870	0.22	0.83	60	49	-11
0011	2T	2_9	13	195	40	19500	17010	-2490	0.21	0.87	34	30	-4
0011	2T	2_9	14	141	25	14100	8890	-5210	0.18	0.63	24	15	-9
0011	2T	2_9	15	60	7	6000	4630	-1370	0.12	0.77	10	8	-2
0011	2T	2_9	16	38	8	3800	4830	1030	0.21	1.27	6	8	2
0011	2T	2_9	21	38	7	3800	3860	60	0.18	1.02	6	6	0
0011	2T	2_9	23	24	1	2400	540	-1860	0.04	0.23	4	0	-4
0011	2T	2_9	24	13	1	1300	250	-1050	0.08	0.19	2	0	-2
0011	2T	2_9	25	11	0	1100	0	-1100	0.00	0.00	1	0	-1
0011	2T	2_9	26	5	0	500	0	-500	0.00	0.00	0	0	0
0011	2T	3_1	12	341	81	34100	31420	-2680	0.24	0.92	60	55	-5
0011	2T	3_1	13	235	40	23500	16750	-6750	0.17	0.71	41	29	-12
0011	2T	3_1	14	189	25	18900	10720	-8180	0.13	0.57	33	18	-15
0011	2T	3_1	15	61	6	6100	3380	-2720	0.10	0.55	10	5	-5
0011	2T	3_1	16	20	2	2000	970	-1030	0.10	0.49	3	1	-2
0011	2T	3_1	21	31	1	3100	360	-2740	0.03	0.12	5	0	-5
0011	2T	3_1	23	19	1	1900	550	-1350	0.05	0.29	3	0	-3
0011	2T	3_1	24	11	0	1100	0	-1100	0.00	0.00	1	0	-1
0011	2T	3_1	25	7	0	700	0	-700	0.00	0.00	1	0	-1
0011	2T	3_1	26	5	0	500	0	-500	0.00	0.00	0	0	0
0011	2T	3_10	12	362	89	36200	32390	-3810	0.25	0.89	64	57	-7
0011	2T	3_10	13	252	63	25200	29270	4070	0.25	1.16	44	51	7
0011	2T	3_10	14	132	24	13200	12700	-500	0.18	0.96	23	22	-1
0011	2T	3_10	15	65	10	6500	5030	-1470	0.15	0.77	11	8	-3
0011	2T	3_10	16	39	4	3900	3240	-660	0.10	0.83	6	5	-1
0011	2T	3_10	21	42	8	4200	3540	-660	0.19	0.84	7	6	-1
0011	2T	3_10	23	15	0	1500	0	-1500	0.00	0.00	2	0	-2
0011	2T	3_10	24	3	0	300	0	-300	0.00	0.00	0	0	0
0011	2T	3_10	25	6	1	600	840	240	0.17	1.40	1	1	0
0011	2T	3_10	26	6	0	600	0	-600	0.00	0.00	1	0	-1
0011	2T	3_11	12	482	122	48200	41050	-7150	0.25	0.85	85	72	-13
0011	2T	3_11	13	275	53	27500	20780	-6720	0.19	0.76	48	36	-12
0011	2T	3_11	14	129	28	12900	13320	420	0.22	1.03	22	23	1
0011	2T	3_11	15	62	6	6200	4090	-2110	0.10	0.66	10	7	-3
0011	2T	3_11	16	26	4	2600	3320	720	0.15	1.28	4	5	1
0011	2T	3_11	21	7	1	700	470	-230	0.14	0.67	1	0	-1
0011	2T	3_11	23	5	0	500	0	-500	0.00	0.00	0	0	0
0011	2T	3_11	24	3	0	300	0	-300	0.00	0.00	0	0	0
0011	2T	3_11	25	2	0	200	0	-200	0.00	0.00	0	0	0
0011	2T	3_11	26	1	0	100	0	-100	0.00	0.00	0	0	0
0011	2T	3_12	12	527	140	52700	45360	-7340	0.27	0.86	93	80	-13
0011	2T	3_12	13	277	63	27700	22110	-5590	0.23	0.80	49	39	-10
0011	2T	3_12	14	163	24	16300	12190	-4110	0.15	0.75	28	21	-7
0011	2T	3_12	15	61	4	6100	3380	-2720	0.07	0.55	10	5	-5
0011	2T	3_12	16	18	3	1800	2560	760	0.17	1.42	3	4	1
0011	2T	3_12	21	7	0	700	0	-700	0.00	0.00	1	0	-1
0011	2T	3_12	23	3	0	300	0	-300	0.00	0.00	0	0	0
0011	2T	3_12	25	1	0	100	0	-100	0.00	0.00	0	0	0
0011	2T	3_12	26	1	0	100	0	-100	0.00	0.00	0	0	0
0011	2T	3_2	12	294	52	29400	24020	-5380	0.18	0.82	52	42	-10
0011	2T	3_2	13	191	22	19100	15480	-3620	0.12	0.81	33	27	-6
0011	2T	3_2	14	149	8	14900	5160	-9740	0.05	0.35	26	9	-17
0011	2T	3_2	15	74	5	7400	4560	-2840	0.07	0.62	13	8	-5
0011	2T	3_2	16	20	1	2000	1570	-430	0.05	0.79	3	2	-1
0011	2T	3_2	21	37	5	3700	4810	1110	0.14	1.30	6	8	2
0011	2T	3_2	23	33	0	3300	0	-3300	0.00	0.00	5	0	-5
0011	2T	3_2	24	25	1	2500	1520	-980	0.04	0.61	4	2	-2
0011	2T	3_2	25	9	1	900	3360	2460	0.11	3.73	1	5	4
0011	2T	3_2	26	8	0	800	0	-800	0.00	0.00	1	0	-1
0011	2T	3_3	12	289	43	28900	23330	-5570	0.15	0.81	51	41	-10
0011	2T	3_3	13	221	40	22100	21890	-210	0.18	0.99	39	38	-1
0011	2T	3_3	14	134	11	13400	9100	-4300	0.08	0.68	23	16	-7
0011	2T	3_3	15	63	4	6300	2260	-4040	0.06	0.36	11	4	-7
0011	2T	3_3	16	31	1	3100	860	-2240	0.03	0.28	5	1	-4
0011	2T	3_3	21	36	5	3600	5850	2250	0.14	1.63	6	10	4
0011	2T	3_3	23	39	2	3900	1890	-2010	0.05	0.48	6	3	-3
0011	2T	3_3	24	18	1	1800	1110	-690	0.06	0.62	3	1	-2
0011	2T	3_3	25	8	0	800	0	-800	0.00	0.00	1	0	-1
0011	2T	3_3	26	8	0	800	0	-800	0.00	0.00	1	0	-1
0011	2T	3_4	12	293	54	29300	21830	-7470	0.18	0.75	51	38	-13
0011	2T	3_4	13	217	36	21700	24470	2770	0.17	1.13	38	43	5
0011	2T	3_4	14	99	14	9900	13370	3470	0.14	1.35	17	23	6
0011	2T	3_4	15	68	7	6800	6150	-650	0.10	0.90	12	10	-2
0011	2T	3_4	16	32	1	3200	750	-2450	0.03	0.23	5	1	-4
0011	2T	3_4	21	46	4	4600	2730	-1870	0.09	0.59	8	4	-4
0011	2T	3_4	23	32	1	3200	1040	-2160	0.03	0.33	5	1	-4
0011	2T	3_4	24	7	1	700	690	-10	0.14	0.99	1	1	0
0011	2T	3_4	25	12	1	1200	1190	-10	0.08	0.99	2	2	0
0011	2T	3_4	26	11	1	1100	770	-330	0.09	0.70	1	1	0
0011	2T	3_5	12	333	80	33300	29650	-3650	0.24	0.89	58	52	-6
0011	2T	3_5	13	216	37	21600	29460	7860	0.17	1.36	38	52	14
0011	2T	3_5	14	130	19	13000	9660	-3340	0.15	0.74	23	17	-6
0011	2T	3_5	15	44	5	4400	15340	10940	0.11	3.49	7	27	20
0011	2T	3_5	16	39	0	3900	0	-3900	0.00	0.00	6	0	-6
0011	2T	3_5	21	47	8	4700	6370	1670	0.17	1.36	8	11	3
0011	2T	3_5	23	20	5	2000	3390	1390	0.25	1.70	3	6	3
0011	2T	3_5	24	21	1	2100	370	-1730	0.05	0.18	3	0	-3
0011	2T	3_5	25	9	1	900	270	-630	0.11	0.30	1	0	-1
0011	2T	3_5	26	9	0	900	0	-900	0.00	0.00	1	0	-1
0011	2T	3_6	12	261	51	26100	26930	830	0.20	1.03	46	47	1
0011	2T	3_6	13	191	33	19100	14710	-4390	0.17	0.77	33	26	-7
0011	2T	3_6	14	104	15	10400	10350	-50	0.14	1.00	18	18	0
0011	2T	3_6	15	61	10	6100	6110	10	0.16	1.00	10	10	0
0011	2T	3_6	16	32	4	3200	11470	8270	0.13	3.58	5	20	15
0011	2T	3_6	21	66	14	6600	11060	4460	0.21	1.68	11	19	8
0011	2T	3_6	23	40	3	4000	1820	-2180	0.08	0.46	7	3	-4
0011	2T	3_6	24	28	2	2800	2860	60	0.07	1.02	4	5	1
0011	2T	3_6	25	22	2	2200	1580	-620	0.09	0.72	3	2	-1
0011	2T	3_6	26	18	2	1800	1570	-230	0.11	0.87	3	2	-1
0011	2T	3_7	12	279	52	27900	23380	-4520	0.19	0.84	49	41	-8
0011	2T	3_7	13	198	32	19800	17180	-2620	0.16	0.87	35	30	-5
0011	2T	3_7	14	131	26	13100	12970	-130	0.20	0.99	23	22	-1
0011	2T	3_7	15	53	7	5300	4400	-900	0.13	0.83	9	7	-2
0011	2T	3_7	16	38	1	3800	3110	-690	0.03	0.82	6	5	-1
0011	2T	3_7	21	38	0	3800	0	-3800	0.00	0.00	6	0	-6
0011	2T	3_7	23	31	2	3100	1970	-1130	0.06	0.64	5	3	-2
0011	2T	3_7	24	15	0	1500	0	-1500	0.00	0.00	2	0	-2
0011	2T	3_7	25	13	1	1300	560	-740	0.08	0.43	2	0	-2
0011	2T	3_7	26	15	2	1500	9060	7560	0.13	6.04	2	16	14
0011	2T	3_8	12	267	61	26700	28870	2170	0.23	1.08	47	51	4
0011	2T	3_8	13	214	49	21400	22510	1110	0.23	1.05	37	39	2
0011	2T	3_8	14	118	16	11800	7820	-3980	0.14	0.66	20	13	-7
0011	2T	3_8	15	68	9	6800	6060	-740	0.13	0.89	12	10	-2
0011	2T	3_8	16	36	6	3600	11130	7530	0.17	3.09	6	19	13
0011	2T	3_8	21	46	12	4600	4730	130	0.26	1.03	8	8	0
0011	2T	3_8	23	33	3	3300	2200	-1100	0.09	0.67	5	3	-2
0011	2T	3_8	24	18	3	1800	3180	1380	0.17	1.77	3	5	2
0011	2T	3_8	25	13	2	1300	1430	130	0.15	1.10	2	2	0
0011	2T	3_8	26	10	1	1000	1660	660	0.10	1.66	1	2	1
0011	2T	3_9	12	324	78	32400	30240	-2160	0.24	0.93	57	53	-4
0011	2T	3_9	13	218	44	21800	21360	-440	0.20	0.98	38	37	-1
0011	2T	3_9	14	121	17	12100	9550	-2550	0.14	0.79	21	16	-5
0011	2T	3_9	15	61	8	6100	4700	-1400	0.13	0.77	10	8	-2
0011	2T	3_9	16	23	1	2300	910	-1390	0.04	0.40	4	1	-3
0011	2T	3_9	21	48	5	4800	4200	-600	0.10	0.88	8	7	-1
0011	2T	3_9	23	18	1	1800	620	-1180	0.06	0.34	3	1	-2
0011	2T	3_9	24	11	2	1100	1760	660	0.18	1.60	1	3	2
0011	2T	3_9	25	7	0	700	0	-700	0.00	0.00	1	0	-1
0011	2T	3_9	26	9	0	900	0	-900	0.00	0.00	1	0	-1
0011	2T	4_1	12	277	83	27700	24210	-3490	0.30	0.87	49	42	-7
0011	2T	4_1	13	171	36	17100	12330	-4770	0.21	0.72	30	21	-9
0011	2T	4_1	14	130	24	13000	11130	-1870	0.18	0.86	23	19	-4
0011	2T	4_1	15	35	5	3500	2890	-610	0.14	0.83	6	5	-1
0011	2T	4_1	16	23	4	2300	3400	1100	0.17	1.48	4	6	2
0011	2T	4_1	21	24	1	2400	590	-1810	0.04	0.25	4	1	-3
0011	2T	4_1	23	14	0	1400	0	-1400	0.00	0.00	2	0	-2
0011	2T	4_1	24	7	0	700	0	-700	0.00	0.00	1	0	-1
0011	2T	4_1	25	5	0	500	0	-500	0.00	0.00	0	0	0
0011	2T	4_1	26	7	2	700	3140	2440	0.29	4.49	1	5	4
0011	2T	4_10	12	374	67	37400	22470	-14930	0.18	0.60	66	39	-27
0011	2T	4_10	13	212	42	21200	21520	320	0.20	1.02	37	38	1
0011	2T	4_10	14	138	10	13800	6560	-7240	0.07	0.48	24	11	-13
0011	2T	4_10	15	36	6	3600	6160	2560	0.17	1.71	6	10	4
0011	2T	4_10	16	7	0	700	0	-700	0.00	0.00	1	0	-1
0011	2T	4_10	21	15	1	1500	970	-530	0.07	0.65	2	1	-1
0011	2T	4_10	23	5	0	500	0	-500	0.00	0.00	0	0	0
0011	2T	4_10	24	9	0	900	0	-900	0.00	0.00	1	0	-1
0011	2T	4_10	25	3	0	300	0	-300	0.00	0.00	0	0	0
0011	2T	4_11	12	403	115	40300	37650	-2650	0.29	0.93	71	66	-5
0011	2T	4_11	13	227	51	22700	21030	-1670	0.22	0.93	40	37	-3
0011	2T	4_11	14	153	26	15300	13320	-1980	0.17	0.87	27	23	-4
0011	2T	4_11	15	38	4	3800	3910	110	0.11	1.03	6	6	0
0011	2T	4_11	16	7	1	700	2020	1320	0.14	2.89	1	3	2
0011	2T	4_11	21	14	1	1400	2770	1370	0.07	1.98	2	4	2
0011	2T	4_11	23	2	0	200	0	-200	0.00	0.00	0	0	0
0011	2T	4_11	24	3	0	300	0	-300	0.00	0.00	0	0	0
0011	2T	4_11	26	1	0	100	0	-100	0.00	0.00	0	0	0
0011	2T	4_12	12	418	105	41800	31100	-10700	0.25	0.74	73	55	-18
0011	2T	4_12	13	255	60	25500	23550	-1950	0.24	0.92	45	41	-4
0011	2T	4_12	14	126	13	12600	5820	-6780	0.10	0.46	22	10	-12
0011	2T	4_12	15	31	2	3100	1650	-1450	0.06	0.53	5	2	-3
0011	2T	4_12	16	5	0	500	0	-500	0.00	0.00	0	0	0
0011	2T	4_12	21	12	0	1200	0	-1200	0.00	0.00	2	0	-2
0011	2T	4_12	23	2	0	200	0	-200	0.00	0.00	0	0	0
0011	2T	4_12	24	1	0	100	0	-100	0.00	0.00	0	0	0
0011	2T	4_12	25	1	0	100	0	-100	0.00	0.00	0	0	0
0011	2T	4_12	26	2	0	200	0	-200	0.00	0.00	0	0	0
0011	2T	4_2	12	273	60	27300	22880	-4420	0.22	0.84	48	40	-8
0011	2T	4_2	13	154	28	15400	15160	-240	0.18	0.98	27	26	-1
0011	2T	4_2	14	88	13	8800	3800	-5000	0.15	0.43	15	6	-9
0011	2T	4_2	15	33	7	3300	4640	1340	0.21	1.41	5	8	3
0011	2T	4_2	16	19	0	1900	0	-1900	0.00	0.00	3	0	-3
0011	2T	4_2	21	29	1	2900	600	-2300	0.03	0.21	5	1	-4
0011	2T	4_2	23	35	1	3500	540	-2960	0.03	0.15	6	0	-6
0011	2T	4_2	24	9	1	900	610	-290	0.11	0.68	1	1	0
0011	2T	4_2	25	10	0	1000	0	-1000	0.00	0.00	1	0	-1
0011	2T	4_2	26	9	0	900	0	-900	0.00	0.00	1	0	-1
0011	2T	4_3	12	210	54	21000	26600	5600	0.26	1.27	37	47	10
0011	2T	4_3	13	193	48	19300	21080	1780	0.25	1.09	34	37	3
0011	2T	4_3	14	73	13	7300	6620	-680	0.18	0.91	12	11	-1
0011	2T	4_3	15	40	6	4000	5160	1160	0.15	1.29	7	9	2
0011	2T	4_3	16	21	4	2100	6620	4520	0.19	3.15	3	11	8
0011	2T	4_3	21	46	8	4600	6180	1580	0.17	1.34	8	10	2
0011	2T	4_3	23	26	2	2600	1210	-1390	0.08	0.47	4	2	-2
0011	2T	4_3	24	25	3	2500	12050	9550	0.12	4.82	4	21	17
0011	2T	4_3	25	17	1	1700	820	-880	0.06	0.48	3	1	-2
0011	2T	4_3	26	12	2	1200	1190	-10	0.17	0.99	2	2	0
0011	2T	4_4	12	242	53	24200	18390	-5810	0.22	0.76	42	32	-10
0011	2T	4_4	13	174	37	17400	18770	1370	0.21	1.08	30	33	3
0011	2T	4_4	14	107	17	10700	8320	-2380	0.16	0.78	18	14	-4
0011	2T	4_4	15	47	5	4700	2100	-2600	0.11	0.45	8	3	-5
0011	2T	4_4	16	22	3	2200	3000	800	0.14	1.36	3	5	2
0011	2T	4_4	21	35	7	3500	5430	1930	0.20	1.55	6	9	3
0011	2T	4_4	23	26	0	2600	0	-2600	0.00	0.00	4	0	-4
0011	2T	4_4	24	16	2	1600	1070	-530	0.13	0.67	2	1	-1
0011	2T	4_4	25	11	1	1100	810	-290	0.09	0.74	1	1	0
0011	2T	4_4	26	9	0	900	0	-900	0.00	0.00	1	0	-1
0011	2T	4_5	12	305	64	30500	22160	-8340	0.21	0.73	53	39	-14
0011	2T	4_5	13	159	32	15900	10680	-5220	0.20	0.67	28	18	-10
0011	2T	4_5	14	106	11	10600	5050	-5550	0.10	0.48	18	8	-10
0011	2T	4_5	15	46	5	4600	10650	6050	0.11	2.32	8	18	10
0011	2T	4_5	16	25	3	2500	4820	2320	0.12	1.93	4	8	4
0011	2T	4_5	21	31	4	3100	1440	-1660	0.13	0.46	5	2	-3
0011	2T	4_5	23	29	3	2900	2020	-880	0.10	0.70	5	3	-2
0011	2T	4_5	24	20	1	2000	430	-1570	0.05	0.22	3	0	-3
0011	2T	4_5	25	10	2	1000	970	-30	0.20	0.97	1	1	0
0011	2T	4_5	26	2	1	200	240	40	0.50	1.20	0	0	0
0011	2T	4_6	12	224	52	22400	19760	-2640	0.23	0.88	39	34	-5
0011	2T	4_6	13	162	37	16200	17480	1280	0.23	1.08	28	30	2
0011	2T	4_6	14	84	14	8400	9160	760	0.17	1.09	14	16	2
0011	2T	4_6	15	46	4	4600	1240	-3360	0.09	0.27	8	2	-6
0011	2T	4_6	16	22	2	2200	1750	-450	0.09	0.80	3	3	0
0011	2T	4_6	21	36	6	3600	3020	-580	0.17	0.84	6	5	-1
0011	2T	4_6	23	36	5	3600	5310	1710	0.14	1.48	6	9	3
0011	2T	4_6	24	10	1	1000	360	-640	0.10	0.36	1	0	-1
0011	2T	4_6	25	18	0	1800	0	-1800	0.00	0.00	3	0	-3
0011	2T	4_6	26	10	1	1000	330	-670	0.10	0.33	1	0	-1
0011	2T	4_7	12	219	40	21900	18370	-3530	0.18	0.84	38	32	-6
0011	2T	4_7	13	173	32	17300	13500	-3800	0.18	0.78	30	23	-7
0011	2T	4_7	14	121	25	12100	11460	-640	0.21	0.95	21	20	-1
0011	2T	4_7	15	48	8	4800	4590	-210	0.17	0.96	8	8	0
0011	2T	4_7	16	28	2	2800	1170	-1630	0.07	0.42	4	2	-2
0011	2T	4_7	21	27	2	2700	810	-1890	0.07	0.30	4	1	-3
0011	2T	4_7	23	24	2	2400	1200	-1200	0.08	0.50	4	2	-2
0011	2T	4_7	24	9	2	900	1040	140	0.22	1.16	1	1	0
0011	2T	4_7	25	14	1	1400	530	-870	0.07	0.38	2	0	-2
0011	2T	4_7	26	11	2	1100	1580	480	0.18	1.44	1	2	1
0011	2T	4_8	12	268	62	26800	20680	-6120	0.23	0.77	47	36	-11
0011	2T	4_8	13	152	30	15200	12680	-2520	0.20	0.83	26	22	-4
0011	2T	4_8	14	109	21	10900	8420	-2480	0.19	0.77	19	14	-5
0011	2T	4_8	15	65	7	6500	3970	-2530	0.11	0.61	11	7	-4
0011	2T	4_8	16	31	2	3100	700	-2400	0.06	0.23	5	1	-4
0011	2T	4_8	21	25	6	2500	2320	-180	0.24	0.93	4	4	0
0011	2T	4_8	23	29	3	2900	5640	2740	0.10	1.94	5	9	4
0011	2T	4_8	24	12	3	1200	920	-280	0.25	0.77	2	1	-1
0011	2T	4_8	25	8	1	800	2190	1390	0.13	2.74	1	3	2
0011	2T	4_8	26	6	0	600	0	-600	0.00	0.00	1	0	-1
0011	2T	4_9	12	303	86	30300	27120	-3180	0.28	0.90	53	48	-5
0011	2T	4_9	13	209	51	20900	22120	1220	0.24	1.06	36	39	3
0011	2T	4_9	14	126	24	12600	9300	-3300	0.19	0.74	22	16	-6
0011	2T	4_9	15	38	6	3800	3830	30	0.16	1.01	6	6	0
0011	2T	4_9	16	17	1	1700	870	-830	0.06	0.51	3	1	-2
0011	2T	4_9	21	27	6	2700	3530	830	0.22	1.31	4	6	2
0011	2T	4_9	23	13	0	1300	0	-1300	0.00	0.00	2	0	-2
0011	2T	4_9	24	9	1	900	2040	1140	0.11	2.27	1	3	2
0011	2T	4_9	25	9	0	900	0	-900	0.00	0.00	1	0	-1
0011	2T	4_9	26	3	0	300	0	-300	0.00	0.00	0	0	0
0011	2T	5_1	12	211	53	21100	13760	-7340	0.25	0.65	37	24	-13
0011	2T	5_1	13	143	33	14300	14180	-120	0.23	0.99	25	25	0
0011	2T	5_1	14	99	15	9900	7770	-2130	0.15	0.78	17	13	-4
0011	2T	5_1	15	42	5	4200	3380	-820	0.12	0.80	7	5	-2
0011	2T	5_1	16	13	1	1300	920	-380	0.08	0.71	2	1	-1
0011	2T	5_1	21	13	1	1300	400	-900	0.08	0.31	2	0	-2
0011	2T	5_1	23	16	0	1600	0	-1600	0.00	0.00	2	0	-2
0011	2T	5_1	24	7	0	700	0	-700	0.00	0.00	1	0	-1
0011	2T	5_1	25	2	0	200	0	-200	0.00	0.00	0	0	0
0011	2T	5_1	26	4	0	400	0	-400	0.00	0.00	0	0	0
0011	2T	5_10	12	338	101	33800	24630	-9170	0.30	0.73	59	43	-16
0011	2T	5_10	13	162	32	16200	12360	-3840	0.20	0.76	28	21	-7
0011	2T	5_10	14	65	15	6500	7620	1120	0.23	1.17	11	13	2
0011	2T	5_10	15	20	2	2000	1600	-400	0.10	0.80	3	2	-1
0011	2T	5_10	16	9	1	900	4640	3740	0.11	5.16	1	8	7
0011	2T	5_10	21	18	2	1800	1020	-780	0.11	0.57	3	1	-2
0011	2T	5_10	23	9	1	900	920	20	0.11	1.02	1	1	0
0011	2T	5_10	24	2	0	200	0	-200	0.00	0.00	0	0	0
0011	2T	5_10	25	1	0	100	0	-100	0.00	0.00	0	0	0
0011	2T	5_10	26	1	0	100	0	-100	0.00	0.00	0	0	0
0011	2T	5_11	12	373	123	37300	29070	-8230	0.33	0.78	66	51	-15
0011	2T	5_11	13	183	43	18300	14730	-3570	0.23	0.80	32	26	-6
0011	2T	5_11	14	67	8	6700	3900	-2800	0.12	0.58	11	6	-5
0011	2T	5_11	15	24	0	2400	0	-2400	0.00	0.00	4	0	-4
0011	2T	5_11	16	2	0	200	0	-200	0.00	0.00	0	0	0
0011	2T	5_11	21	6	1	600	430	-170	0.17	0.72	1	0	-1
0011	2T	5_11	23	6	0	600	0	-600	0.00	0.00	1	0	-1
0011	2T	5_11	25	1	0	100	0	-100	0.00	0.00	0	0	0
0011	2T	5_12	12	329	111	32900	28060	-4840	0.34	0.85	58	49	-9
0011	2T	5_12	13	186	49	18600	16940	-1660	0.26	0.91	32	29	-3
0011	2T	5_12	14	86	17	8600	8210	-390	0.20	0.95	15	14	-1
0011	2T	5_12	15	33	2	3300	950	-2350	0.06	0.29	5	1	-4
0011	2T	5_12	16	4	1	400	670	270	0.25	1.68	0	1	1
0011	2T	5_12	21	5	0	500	0	-500	0.00	0.00	0	0	0
0011	2T	5_12	23	7	0	700	0	-700	0.00	0.00	1	0	-1
0011	2T	5_12	24	1	0	100	0	-100	0.00	0.00	0	0	0
0011	2T	5_12	25	3	0	300	0	-300	0.00	0.00	0	0	0
0011	2T	5_12	26	1	0	100	0	-100	0.00	0.00	0	0	0
0011	2T	5_2	12	194	32	19400	10470	-8930	0.16	0.54	34	18	-16
0011	2T	5_2	13	118	18	11800	9280	-2520	0.15	0.79	20	16	-4
0011	2T	5_2	14	90	13	9000	5970	-3030	0.14	0.66	15	10	-5
0011	2T	5_2	15	39	4	3900	4670	770	0.10	1.20	6	8	2
0011	2T	5_2	16	20	2	2000	1700	-300	0.10	0.85	3	3	0
0011	2T	5_2	21	18	2	1800	7380	5580	0.11	4.10	3	13	10
0011	2T	5_2	23	17	1	1700	520	-1180	0.06	0.31	3	0	-3
0011	2T	5_2	24	8	2	800	3160	2360	0.25	3.95	1	5	4
0011	2T	5_2	25	9	0	900	0	-900	0.00	0.00	1	0	-1
0011	2T	5_2	26	2	0	200	0	-200	0.00	0.00	0	0	0
0011	2T	5_3	12	197	46	19700	22250	2550	0.23	1.13	34	39	5
0011	2T	5_3	13	148	28	14800	10580	-4220	0.19	0.71	26	18	-8
0011	2T	5_3	14	77	7	7700	4910	-2790	0.09	0.64	13	8	-5
0011	2T	5_3	15	38	4	3800	4070	270	0.11	1.07	6	7	1
0011	2T	5_3	16	18	2	1800	4910	3110	0.11	2.73	3	8	5
0011	2T	5_3	21	13	3	1300	2140	840	0.23	1.65	2	3	1
0011	2T	5_3	23	11	2	1100	820	-280	0.18	0.75	1	1	0
0011	2T	5_3	24	14	1	1400	330	-1070	0.07	0.24	2	0	-2
0011	2T	5_3	25	12	1	1200	3120	1920	0.08	2.60	2	5	3
0011	2T	5_3	26	6	1	600	3030	2430	0.17	5.05	1	5	4
0011	2T	5_4	12	192	36	19200	11290	-7910	0.19	0.59	33	19	-14
0011	2T	5_4	13	132	21	13200	9410	-3790	0.16	0.71	23	16	-7
0011	2T	5_4	14	92	13	9200	7560	-1640	0.14	0.82	16	13	-3
0011	2T	5_4	15	36	2	3600	3420	-180	0.06	0.95	6	6	0
0011	2T	5_4	16	15	3	1500	3500	2000	0.20	2.33	2	6	4
0011	2T	5_4	21	22	2	2200	920	-1280	0.09	0.42	3	1	-2
0011	2T	5_4	23	10	0	1000	0	-1000	0.00	0.00	1	0	-1
0011	2T	5_4	24	7	0	700	0	-700	0.00	0.00	1	0	-1
0011	2T	5_4	25	6	0	600	0	-600	0.00	0.00	1	0	-1
0011	2T	5_4	26	1	0	100	0	-100	0.00	0.00	0	0	0
0011	2T	5_5	12	232	57	23200	21350	-1850	0.25	0.92	41	37	-4
0011	2T	5_5	13	146	28	14600	11800	-2800	0.19	0.81	25	20	-5
0011	2T	5_5	14	89	14	8900	6900	-2000	0.16	0.78	15	12	-3
0011	2T	5_5	15	29	10	2900	5350	2450	0.34	1.84	5	9	4
0011	2T	5_5	16	22	3	2200	3520	1320	0.14	1.60	3	6	3
0011	2T	5_5	21	11	2	1100	970	-130	0.18	0.88	1	1	0
0011	2T	5_5	23	6	0	600	0	-600	0.00	0.00	1	0	-1
0011	2T	5_5	24	8	0	800	0	-800	0.00	0.00	1	0	-1
0011	2T	5_5	25	7	0	700	0	-700	0.00	0.00	1	0	-1
0011	2T	5_5	26	1	0	100	0	-100	0.00	0.00	0	0	0
0011	2T	5_6	12	194	42	19400	19870	470	0.22	1.02	34	35	1
0011	2T	5_6	13	129	23	12900	10170	-2730	0.18	0.79	22	18	-4
0011	2T	5_6	14	98	12	9800	4760	-5040	0.12	0.49	17	8	-9
0011	2T	5_6	15	33	4	3300	2310	-990	0.12	0.70	5	4	-1
0011	2T	5_6	16	21	5	2100	2920	820	0.24	1.39	3	5	2
0011	2T	5_6	21	20	1	2000	930	-1070	0.05	0.47	3	1	-2
0011	2T	5_6	23	18	5	1800	6450	4650	0.28	3.58	3	11	8
0011	2T	5_6	24	8	0	800	0	-800	0.00	0.00	1	0	-1
0011	2T	5_6	25	8	0	800	0	-800	0.00	0.00	1	0	-1
0011	2T	5_6	26	7	0	700	0	-700	0.00	0.00	1	0	-1
0011	2T	5_7	12	209	44	20900	20780	-120	0.21	0.99	36	36	0
0011	2T	5_7	13	151	34	15100	14850	-250	0.23	0.98	26	26	0
0011	2T	5_7	14	107	20	10700	9250	-1450	0.19	0.86	18	16	-2
0011	2T	5_7	15	32	5	3200	3050	-150	0.16	0.95	5	5	0
0011	2T	5_7	16	18	3	1800	880	-920	0.17	0.49	3	1	-2
0011	2T	5_7	21	11	0	1100	0	-1100	0.00	0.00	1	0	-1
0011	2T	5_7	23	10	0	1000	0	-1000	0.00	0.00	1	0	-1
0011	2T	5_7	24	5	0	500	0	-500	0.00	0.00	0	0	0
0011	2T	5_7	25	3	0	300	0	-300	0.00	0.00	0	0	0
0011	2T	5_7	26	3	0	300	0	-300	0.00	0.00	0	0	0
0011	2T	5_8	12	204	46	20400	18820	-1580	0.23	0.92	36	33	-3
0011	2T	5_8	13	142	28	14200	12110	-2090	0.20	0.85	25	21	-4
0011	2T	5_8	14	113	24	11300	8460	-2840	0.21	0.75	20	14	-6
0011	2T	5_8	15	31	4	3100	4060	960	0.13	1.31	5	7	2
0011	2T	5_8	16	26	5	2600	2070	-530	0.19	0.80	4	3	-1
0011	2T	5_8	21	11	1	1100	260	-840	0.09	0.24	1	0	-1
0011	2T	5_8	23	12	0	1200	0	-1200	0.00	0.00	2	0	-2
0011	2T	5_8	24	4	0	400	0	-400	0.00	0.00	0	0	0
0011	2T	5_8	25	3	1	300	3060	2760	0.33	10.20	0	5	5
0011	2T	5_9	12	252	71	25200	20800	-4400	0.28	0.83	44	36	-8
0011	2T	5_9	13	158	31	15800	11770	-4030	0.20	0.74	27	20	-7
0011	2T	5_9	14	115	27	11500	10880	-620	0.23	0.95	20	19	-1
0011	2T	5_9	15	33	1	3300	560	-2740	0.03	0.17	5	0	-5
0011	2T	5_9	16	20	1	2000	620	-1380	0.05	0.31	3	1	-2
0011	2T	5_9	21	13	1	1300	720	-580	0.08	0.55	2	1	-1
0011	2T	5_9	23	8	0	800	0	-800	0.00	0.00	1	0	-1
0011	2T	5_9	24	5	0	500	0	-500	0.00	0.00	0	0	0
0011	2T	5_9	25	2	0	200	0	-200	0.00	0.00	0	0	0
0011	2T	6_1	12	19	6	1900	1630	-270	0.32	0.86	3	2	-1
0011	2T	6_1	13	12	3	1200	850	-350	0.25	0.71	2	1	-1
0011	2T	6_1	14	7	1	700	470	-230	0.14	0.67	1	0	-1
0011	2T	6_1	15	4	0	400	0	-400	0.00	0.00	0	0	0
0011	2T	6_1	16	1	0	100	0	-100	0.00	0.00	0	0	0
0011	2T	6_1	21	1	0	100	0	-100	0.00	0.00	0	0	0
0011	2T	6_1	23	1	0	100	0	-100	0.00	0.00	0	0	0
0011	2T	6_1	25	1	0	100	0	-100	0.00	0.00	0	0	0
0011	2T	6_10	12	28	11	2800	2820	20	0.39	1.01	4	4	0
0011	2T	6_10	13	6	1	600	300	-300	0.17	0.50	1	0	-1
0011	2T	6_10	14	4	0	400	0	-400	0.00	0.00	0	0	0
0011	2T	6_10	15	2	0	200	0	-200	0.00	0.00	0	0	0
0011	2T	6_10	16	1	0	100	0	-100	0.00	0.00	0	0	0
0011	2T	6_10	21	1	0	100	0	-100	0.00	0.00	0	0	0
0011	2T	6_11	12	29	10	2900	2190	-710	0.34	0.76	5	3	-2
0011	2T	6_11	13	16	3	1600	950	-650	0.19	0.59	2	1	-1
0011	2T	6_11	14	4	0	400	0	-400	0.00	0.00	0	0	0
0011	2T	6_11	15	2	0	200	0	-200	0.00	0.00	0	0	0
0011	2T	6_11	24	1	0	100	0	-100	0.00	0.00	0	0	0
0011	2T	6_12	12	33	8	3300	2140	-1160	0.24	0.65	5	3	-2
0011	2T	6_12	13	10	1	1000	430	-570	0.10	0.43	1	0	-1
0011	2T	6_12	14	7	2	700	1330	630	0.29	1.90	1	2	1
0011	2T	6_12	15	2	0	200	0	-200	0.00	0.00	0	0	0
0011	2T	6_12	21	1	1	100	830	730	1.00	8.30	0	1	1
0011	2T	6_2	12	7	3	700	850	150	0.43	1.21	1	1	0
0011	2T	6_2	13	7	0	700	0	-700	0.00	0.00	1	0	-1
0011	2T	6_2	14	13	1	1300	1000	-300	0.08	0.77	2	1	-1
0011	2T	6_2	15	3	0	300	0	-300	0.00	0.00	0	0	0
0011	2T	6_2	16	2	1	200	930	730	0.50	4.65	0	1	1
0011	2T	6_2	21	3	0	300	0	-300	0.00	0.00	0	0	0
0011	2T	6_2	23	2	0	200	0	-200	0.00	0.00	0	0	0
0011	2T	6_2	24	1	0	100	0	-100	0.00	0.00	0	0	0
0011	2T	6_2	26	1	0	100	0	-100	0.00	0.00	0	0	0
0011	2T	6_3	12	12	1	1200	160	-1040	0.08	0.13	2	0	-2
0011	2T	6_3	13	11	0	1100	0	-1100	0.00	0.00	1	0	-1
0011	2T	6_3	14	12	1	1200	1080	-120	0.08	0.90	2	1	-1
0011	2T	6_3	15	2	0	200	0	-200	0.00	0.00	0	0	0
0011	2T	6_3	16	2	0	200	0	-200	0.00	0.00	0	0	0
0011	2T	6_3	21	2	0	200	0	-200	0.00	0.00	0	0	0
0011	2T	6_3	25	1	0	100	0	-100	0.00	0.00	0	0	0
0011	2T	6_3	26	1	0	100	0	-100	0.00	0.00	0	0	0
0011	2T	6_4	12	22	5	2200	1870	-330	0.23	0.85	3	3	0
0011	2T	6_4	13	10	0	1000	0	-1000	0.00	0.00	1	0	-1
0011	2T	6_4	14	6	1	600	680	80	0.17	1.13	1	1	0
0011	2T	6_4	15	2	0	200	0	-200	0.00	0.00	0	0	0
0011	2T	6_4	16	3	0	300	0	-300	0.00	0.00	0	0	0
0011	2T	6_4	24	1	0	100	0	-100	0.00	0.00	0	0	0
0011	2T	6_5	12	23	5	2300	1370	-930	0.22	0.60	4	2	-2
0011	2T	6_5	13	16	2	1600	590	-1010	0.13	0.37	2	1	-1
0011	2T	6_5	14	6	2	600	590	-10	0.33	0.98	1	1	0
0011	2T	6_5	15	2	0	200	0	-200	0.00	0.00	0	0	0
0011	2T	6_5	16	3	1	300	3110	2810	0.33	10.37	0	5	5
0011	2T	6_6	12	14	3	1400	1250	-150	0.21	0.89	2	2	0
0011	2T	6_6	13	12	2	1200	580	-620	0.17	0.48	2	1	-1
0011	2T	6_6	14	9	0	900	0	-900	0.00	0.00	1	0	-1
0011	2T	6_6	15	3	0	300	0	-300	0.00	0.00	0	0	0
0011	2T	6_6	16	4	0	400	0	-400	0.00	0.00	0	0	0
0011	2T	6_6	24	1	0	100	0	-100	0.00	0.00	0	0	0
0011	2T	6_7	12	14	2	1400	1790	390	0.14	1.28	2	3	1
0011	2T	6_7	13	12	3	1200	730	-470	0.25	0.61	2	1	-1
0011	2T	6_7	14	6	2	600	1240	640	0.33	2.07	1	2	1
0011	2T	6_7	15	4	0	400	0	-400	0.00	0.00	0	0	0
0011	2T	6_7	16	3	0	300	0	-300	0.00	0.00	0	0	0
0011	2T	6_7	21	1	1	100	390	290	1.00	3.90	0	0	0
0011	2T	6_7	24	1	0	100	0	-100	0.00	0.00	0	0	0
0011	2T	6_8	12	12	1	1200	310	-890	0.08	0.26	2	0	-2
0011	2T	6_8	13	11	6	1100	1560	460	0.55	1.42	1	2	1
0011	2T	6_8	14	9	2	900	740	-160	0.22	0.82	1	1	0
0011	2T	6_8	15	6	0	600	0	-600	0.00	0.00	1	0	-1
0011	2T	6_8	16	3	0	300	0	-300	0.00	0.00	0	0	0
0011	2T	6_9	12	22	6	2200	1590	-610	0.27	0.72	3	2	-1
0011	2T	6_9	13	12	1	1200	290	-910	0.08	0.24	2	0	-2
0011	2T	6_9	14	7	0	700	0	-700	0.00	0.00	1	0	-1
0011	2T	6_9	15	2	0	200	0	-200	0.00	0.00	0	0	0
0011	2T	6_9	16	1	0	100	0	-100	0.00	0.00	0	0	0
0011	2T	6_9	21	2	0	200	0	-200	0.00	0.00	0	0	0
0011	2T	6_9	23	1	0	100	0	-100	0.00	0.00	0	0	0
0011	2T	6_9	24	2	0	200	0	-200	0.00	0.00	0	0	0
0011	2T	7_1	12	346	93	34600	29400	-5200	0.27	0.85	61	52	-9
0011	2T	7_1	13	249	52	24900	22760	-2140	0.21	0.91	44	40	-4
0011	2T	7_1	14	143	30	14300	12330	-1970	0.21	0.86	25	21	-4
0011	2T	7_1	15	40	2	4000	700	-3300	0.05	0.18	7	1	-6
0011	2T	7_1	16	22	3	2200	5930	3730	0.14	2.70	3	10	7
0011	2T	7_1	21	21	3	2100	4610	2510	0.14	2.20	3	8	5
0011	2T	7_1	23	32	5	3200	9870	6670	0.16	3.08	5	17	12
0011	2T	7_1	24	9	0	900	0	-900	0.00	0.00	1	0	-1
0011	2T	7_1	25	10	1	1000	520	-480	0.10	0.52	1	0	-1
0011	2T	7_1	26	2	0	200	0	-200	0.00	0.00	0	0	0
0011	2T	7_10	12	478	141	47800	43910	-3890	0.29	0.92	84	77	-7
0011	2T	7_10	13	214	35	21400	14300	-7100	0.16	0.67	37	25	-12
0011	2T	7_10	14	154	16	15400	9170	-6230	0.10	0.60	27	16	-11
0011	2T	7_10	15	50	6	5000	3580	-1420	0.12	0.72	8	6	-2
0011	2T	7_10	16	15	1	1500	1150	-350	0.07	0.77	2	2	0
0011	2T	7_10	21	26	5	2600	3220	620	0.19	1.24	4	5	1
0011	2T	7_10	23	15	0	1500	0	-1500	0.00	0.00	2	0	-2
0011	2T	7_10	24	7	0	700	0	-700	0.00	0.00	1	0	-1
0011	2T	7_10	25	3	0	300	0	-300	0.00	0.00	0	0	0
0011	2T	7_10	26	3	0	300	0	-300	0.00	0.00	0	0	0
0011	2T	7_11	12	491	147	49100	41880	-7220	0.30	0.85	86	74	-12
0011	2T	7_11	13	273	54	27300	24360	-2940	0.20	0.89	48	43	-5
0011	2T	7_11	14	129	21	12900	12440	-460	0.16	0.96	22	22	0
0011	2T	7_11	15	44	1	4400	700	-3700	0.02	0.16	7	1	-6
0011	2T	7_11	16	17	0	1700	0	-1700	0.00	0.00	3	0	-3
0011	2T	7_11	21	17	2	1700	1120	-580	0.12	0.66	3	1	-2
0011	2T	7_11	23	9	0	900	0	-900	0.00	0.00	1	0	-1
0011	2T	7_11	24	4	0	400	0	-400	0.00	0.00	0	0	0
0011	2T	7_11	25	1	0	100	0	-100	0.00	0.00	0	0	0
0011	2T	7_11	26	2	0	200	0	-200	0.00	0.00	0	0	0
0011	2T	7_12	12	476	130	47600	37620	-9980	0.27	0.79	84	66	-18
0011	2T	7_12	13	245	40	24500	17780	-6720	0.16	0.73	43	31	-12
0011	2T	7_12	14	179	25	17900	12640	-5260	0.14	0.71	31	22	-9
0011	2T	7_12	15	52	1	5200	910	-4290	0.02	0.18	9	1	-8
0011	2T	7_12	16	12	1	1200	990	-210	0.08	0.83	2	1	-1
0011	2T	7_12	21	19	1	1900	680	-1220	0.05	0.36	3	1	-2
0011	2T	7_12	23	9	0	900	0	-900	0.00	0.00	1	0	-1
0011	2T	7_12	24	3	0	300	0	-300	0.00	0.00	0	0	0
0011	2T	7_12	25	4	0	400	0	-400	0.00	0.00	0	0	0
0011	2T	7_2	12	295	67	29500	24640	-4860	0.23	0.84	52	43	-9
0011	2T	7_2	13	226	34	22600	22340	-260	0.15	0.99	40	39	-1
0011	2T	7_2	14	129	18	12900	8050	-4850	0.14	0.62	22	14	-8
0011	2T	7_2	15	39	1	3900	390	-3510	0.03	0.10	6	0	-6
0011	2T	7_2	16	19	0	1900	0	-1900	0.00	0.00	3	0	-3
0011	2T	7_2	21	43	3	4300	3210	-1090	0.07	0.75	7	5	-2
0011	2T	7_2	23	34	0	3400	0	-3400	0.00	0.00	6	0	-6
0011	2T	7_2	24	20	1	2000	550	-1450	0.05	0.28	3	0	-3
0011	2T	7_2	25	12	0	1200	0	-1200	0.00	0.00	2	0	-2
0011	2T	7_2	26	5	0	500	0	-500	0.00	0.00	0	0	0
0011	2T	7_3	12	314	75	31400	32640	1240	0.24	1.04	55	57	2
0011	2T	7_3	13	222	53	22200	23530	1330	0.24	1.06	39	41	2
0011	2T	7_3	14	131	22	13100	11500	-1600	0.17	0.88	23	20	-3
0011	2T	7_3	15	67	10	6700	6700	0	0.15	1.00	11	11	0
0011	2T	7_3	16	29	2	2900	890	-2010	0.07	0.31	5	1	-4
0011	2T	7_3	21	44	5	4400	7260	2860	0.11	1.65	7	12	5
0011	2T	7_3	23	33	3	3300	3320	20	0.09	1.01	5	5	0
0011	2T	7_3	24	16	1	1600	1080	-520	0.06	0.68	2	1	-1
0011	2T	7_3	25	13	1	1300	2640	1340	0.08	2.03	2	4	2
0011	2T	7_3	26	4	0	400	0	-400	0.00	0.00	0	0	0
0011	2T	7_4	12	334	92	33400	29220	-4180	0.28	0.87	59	51	-8
0011	2T	7_4	13	252	48	25200	21080	-4120	0.19	0.84	44	37	-7
0011	2T	7_4	14	146	23	14600	14330	-270	0.16	0.98	25	25	0
0011	2T	7_4	15	65	6	6500	4590	-1910	0.09	0.71	11	8	-3
0011	2T	7_4	16	29	7	2900	9970	7070	0.24	3.44	5	17	12
0011	2T	7_4	21	40	2	4000	1160	-2840	0.05	0.29	7	2	-5
0011	2T	7_4	23	24	2	2400	2960	560	0.08	1.23	4	5	1
0011	2T	7_4	24	15	2	1500	2940	1440	0.13	1.96	2	5	3
0011	2T	7_4	25	10	0	1000	0	-1000	0.00	0.00	1	0	-1
0011	2T	7_4	26	4	1	400	890	490	0.25	2.23	0	1	1
0011	2T	7_5	12	350	97	35000	29250	-5750	0.28	0.84	61	51	-10
0011	2T	7_5	13	248	43	24800	17170	-7630	0.17	0.69	43	30	-13
0011	2T	7_5	14	142	22	14200	11400	-2800	0.15	0.80	25	20	-5
0011	2T	7_5	15	50	3	5000	1640	-3360	0.06	0.33	8	2	-6
0011	2T	7_5	16	35	2	3500	1740	-1760	0.06	0.50	6	3	-3
0011	2T	7_5	21	34	7	3400	5040	1640	0.21	1.48	6	8	2
0011	2T	7_5	23	15	1	1500	3030	1530	0.07	2.02	2	5	3
0011	2T	7_5	24	13	1	1300	1560	260	0.08	1.20	2	2	0
0011	2T	7_5	25	8	1	800	1210	410	0.13	1.51	1	2	1
0011	2T	7_5	26	2	1	200	1120	920	0.50	5.60	0	1	1
0011	2T	7_6	12	341	82	34100	26630	-7470	0.24	0.78	60	47	-13
0011	2T	7_6	13	255	49	25500	18390	-7110	0.19	0.72	45	32	-13
0011	2T	7_6	14	138	22	13800	7630	-6170	0.16	0.55	24	13	-11
0011	2T	7_6	15	63	7	6300	10940	4640	0.11	1.74	11	19	8
0011	2T	7_6	16	24	2	2400	1600	-800	0.08	0.67	4	2	-2
0011	2T	7_6	21	33	7	3300	4520	1220	0.21	1.37	5	8	3
0011	2T	7_6	23	22	2	2200	3230	1030	0.09	1.47	3	5	2
0011	2T	7_6	24	14	0	1400	0	-1400	0.00	0.00	2	0	-2
0011	2T	7_6	25	9	3	900	2380	1480	0.33	2.64	1	4	3
0011	2T	7_6	26	8	0	800	0	-800	0.00	0.00	1	0	-1
0011	2T	7_7	12	346	94	34600	31020	-3580	0.27	0.90	61	54	-7
0011	2T	7_7	13	238	42	23800	15930	-7870	0.18	0.67	42	28	-14
0011	2T	7_7	14	160	28	16000	12300	-3700	0.18	0.77	28	21	-7
0011	2T	7_7	15	59	6	5900	3310	-2590	0.10	0.56	10	5	-5
0011	2T	7_7	16	45	7	4500	3540	-960	0.16	0.79	7	6	-1
0011	2T	7_7	21	21	5	2100	3110	1010	0.24	1.48	3	5	2
0011	2T	7_7	23	12	1	1200	500	-700	0.08	0.42	2	0	-2
0011	2T	7_7	24	8	0	800	0	-800	0.00	0.00	1	0	-1
0011	2T	7_7	25	4	0	400	0	-400	0.00	0.00	0	0	0
0011	2T	7_7	26	6	1	600	1670	1070	0.17	2.78	1	2	1
0011	2T	7_8	12	363	81	36300	27790	-8510	0.22	0.77	64	49	-15
0011	2T	7_8	13	232	49	23200	19420	-3780	0.21	0.84	41	34	-7
0011	2T	7_8	14	160	30	16000	15140	-860	0.19	0.95	28	26	-2
0011	2T	7_8	15	61	8	6100	6340	240	0.13	1.04	10	11	1
0011	2T	7_8	16	43	3	4300	2060	-2240	0.07	0.48	7	3	-4
0011	2T	7_8	21	17	2	1700	4850	3150	0.12	2.85	3	8	5
0011	2T	7_8	23	14	0	1400	0	-1400	0.00	0.00	2	0	-2
0011	2T	7_8	24	8	1	800	520	-280	0.13	0.65	1	0	-1
0011	2T	7_8	25	9	1	900	1020	120	0.11	1.13	1	1	0
0011	2T	7_8	26	6	0	600	0	-600	0.00	0.00	1	0	-1
0011	2T	7_9	12	412	112	41200	39640	-1560	0.27	0.96	72	70	-2
0011	2T	7_9	13	264	55	26400	21530	-4870	0.21	0.82	46	38	-8
0011	2T	7_9	14	161	28	16100	15230	-870	0.17	0.95	28	26	-2
0011	2T	7_9	15	60	7	6000	4830	-1170	0.12	0.81	10	8	-2
0011	2T	7_9	16	32	5	3200	4090	890	0.16	1.28	5	7	2
0011	2T	7_9	21	15	1	1500	690	-810	0.07	0.46	2	1	-1
0011	2T	7_9	23	3	1	300	1550	1250	0.33	5.17	0	2	2
0011	2T	7_9	24	7	1	700	1730	1030	0.14	2.47	1	3	2
0011	2T	7_9	25	3	0	300	0	-300	0.00	0.00	0	0	0
0011	2T	7_9	26	2	0	200	0	-200	0.00	0.00	0	0	0
0011	3F	1_1	123	171	33	17100	14430	-2670	0.19	0.84	30	25	-5
0011	3F	1_1	124	153	24	15300	13590	-1710	0.16	0.89	27	24	-3
0011	3F	1_1	125	85	4	8500	3340	-5160	0.05	0.39	15	5	-10
0011	3F	1_1	126	36	2	3600	1080	-2520	0.06	0.30	6	1	-5
0011	3F	1_1	134	114	17	11400	7730	-3670	0.15	0.68	20	13	-7
0011	3F	1_1	135	52	7	5200	4930	-270	0.13	0.95	9	8	-1
0011	3F	1_1	136	35	1	3500	1900	-1600	0.03	0.54	6	3	-3
0011	3F	1_1	145	52	3	5200	5200	0	0.06	1.00	9	9	0
0011	3F	1_1	146	19	0	1900	0	-1900	0.00	0.00	3	0	-3
0011	3F	1_1	156	8	0	800	0	-800	0.00	0.00	1	0	-1
0011	3F	1_1	234	5	1	500	380	-120	0.20	0.76	0	0	0
0011	3F	1_1	235	5	0	500	0	-500	0.00	0.00	0	0	0
0011	3F	1_1	236	1	0	100	0	-100	0.00	0.00	0	0	0
0011	3F	1_1	245	9	0	900	0	-900	0.00	0.00	1	0	-1
0011	3F	1_1	246	3	0	300	0	-300	0.00	0.00	0	0	0
0011	3F	1_1	256	2	0	200	0	-200	0.00	0.00	0	0	0
0011	3F	1_10	123	187	44	18700	21640	2940	0.24	1.16	33	38	5
0011	3F	1_10	124	157	29	15700	13810	-1890	0.18	0.88	27	24	-3
0011	3F	1_10	125	85	14	8500	7390	-1110	0.16	0.87	15	13	-2
0011	3F	1_10	126	75	12	7500	9730	2230	0.16	1.30	13	17	4
0011	3F	1_10	134	99	20	9900	12250	2350	0.20	1.24	17	21	4
0011	3F	1_10	135	67	8	6700	4010	-2690	0.12	0.60	11	7	-4
0011	3F	1_10	136	50	6	5000	4080	-920	0.12	0.82	8	7	-1
0011	3F	1_10	145	27	2	2700	1710	-990	0.07	0.63	4	3	-1
0011	3F	1_10	146	23	2	2300	1440	-860	0.09	0.63	4	2	-2
0011	3F	1_10	156	7	0	700	0	-700	0.00	0.00	1	0	-1
0011	3F	1_10	246	1	0	100	0	-100	0.00	0.00	0	0	0
0011	3F	1_11	123	189	38	18900	15480	-3420	0.20	0.82	33	27	-6
0011	3F	1_11	124	187	42	18700	17010	-1690	0.22	0.91	33	30	-3
0011	3F	1_11	125	94	11	9400	7100	-2300	0.12	0.76	16	12	-4
0011	3F	1_11	126	73	6	7300	5810	-1490	0.08	0.80	12	10	-2
0011	3F	1_11	134	125	24	12500	13550	1050	0.19	1.08	22	23	1
0011	3F	1_11	135	56	5	5600	3600	-2000	0.09	0.64	9	6	-3
0011	3F	1_11	136	36	1	3600	1890	-1710	0.03	0.53	6	3	-3
0011	3F	1_11	145	37	2	3700	840	-2860	0.05	0.23	6	1	-5
0011	3F	1_11	146	33	4	3300	4640	1340	0.12	1.41	5	8	3
0011	3F	1_11	156	6	0	600	0	-600	0.00	0.00	1	0	-1
0011	3F	1_11	234	1	0	100	0	-100	0.00	0.00	0	0	0
0011	3F	1_11	235	1	0	100	0	-100	0.00	0.00	0	0	0
0011	3F	1_11	256	1	0	100	0	-100	0.00	0.00	0	0	0
0011	3F	1_12	123	232	43	23200	17800	-5400	0.19	0.77	41	31	-10
0011	3F	1_12	124	213	34	21300	15100	-6200	0.16	0.71	37	26	-11
0011	3F	1_12	125	99	6	9900	5090	-4810	0.06	0.51	17	9	-8
0011	3F	1_12	126	98	9	9800	12970	3170	0.09	1.32	17	22	5
0011	3F	1_12	134	94	17	9400	11010	1610	0.18	1.17	16	19	3
0011	3F	1_12	135	48	6	4800	6530	1730	0.13	1.36	8	11	3
0011	3F	1_12	136	39	2	3900	3250	-650	0.05	0.83	6	5	-1
0011	3F	1_12	145	48	5	4800	3850	-950	0.10	0.80	8	6	-2
0011	3F	1_12	146	23	1	2300	1750	-550	0.04	0.76	4	3	-1
0011	3F	1_12	156	4	0	400	0	-400	0.00	0.00	0	0	0
0011	3F	1_12	234	1	0	100	0	-100	0.00	0.00	0	0	0
0011	3F	1_2	123	166	27	16600	11690	-4910	0.16	0.70	29	20	-9
0011	3F	1_2	124	150	19	15000	11890	-3110	0.13	0.79	26	21	-5
0011	3F	1_2	125	78	2	7800	1450	-6350	0.03	0.19	13	2	-11
0011	3F	1_2	126	36	3	3600	4240	640	0.08	1.18	6	7	1
0011	3F	1_2	134	124	15	12400	10890	-1510	0.12	0.88	21	19	-2
0011	3F	1_2	135	45	3	4500	2190	-2310	0.07	0.49	7	3	-4
0011	3F	1_2	136	32	4	3200	5070	1870	0.13	1.58	5	8	3
0011	3F	1_2	145	51	4	5100	2670	-2430	0.08	0.52	9	4	-5
0011	3F	1_2	146	15	0	1500	0	-1500	0.00	0.00	2	0	-2
0011	3F	1_2	156	12	0	1200	0	-1200	0.00	0.00	2	0	-2
0011	3F	1_2	234	8	0	800	0	-800	0.00	0.00	1	0	-1
0011	3F	1_2	235	6	1	600	1660	1060	0.17	2.77	1	2	1
0011	3F	1_2	236	2	0	200	0	-200	0.00	0.00	0	0	0
0011	3F	1_2	245	5	0	500	0	-500	0.00	0.00	0	0	0
0011	3F	1_2	256	1	0	100	0	-100	0.00	0.00	0	0	0
0011	3F	1_3	123	165	26	16500	16060	-440	0.16	0.97	29	28	-1
0011	3F	1_3	124	127	11	12700	9880	-2820	0.09	0.78	22	17	-5
0011	3F	1_3	125	70	9	7000	10000	3000	0.13	1.43	12	17	5
0011	3F	1_3	126	40	7	4000	3900	-100	0.18	0.98	7	6	-1
0011	3F	1_3	134	109	15	10900	6740	-4160	0.14	0.62	19	11	-8
0011	3F	1_3	135	63	2	6300	1720	-4580	0.03	0.27	11	3	-8
0011	3F	1_3	136	29	4	2900	2630	-270	0.14	0.91	5	4	-1
0011	3F	1_3	145	39	4	3900	2320	-1580	0.10	0.59	6	4	-2
0011	3F	1_3	146	24	2	2400	1420	-980	0.08	0.59	4	2	-2
0011	3F	1_3	156	14	0	1400	0	-1400	0.00	0.00	2	0	-2
0011	3F	1_3	234	6	2	600	3620	3020	0.33	6.03	1	6	5
0011	3F	1_3	235	9	2	900	1240	340	0.22	1.38	1	2	1
0011	3F	1_3	236	3	0	300	0	-300	0.00	0.00	0	0	0
0011	3F	1_3	245	3	0	300	0	-300	0.00	0.00	0	0	0
0011	3F	1_3	246	4	0	400	0	-400	0.00	0.00	0	0	0
0011	3F	1_3	256	3	0	300	0	-300	0.00	0.00	0	0	0
0011	3F	1_4	123	220	40	22000	19270	-2730	0.18	0.88	38	34	-4
0011	3F	1_4	124	125	16	12500	9300	-3200	0.13	0.74	22	16	-6
0011	3F	1_4	125	68	9	6800	4700	-2100	0.13	0.69	12	8	-4
0011	3F	1_4	126	69	3	6900	4160	-2740	0.04	0.60	12	7	-5
0011	3F	1_4	134	94	14	9400	12920	3520	0.15	1.37	16	22	6
0011	3F	1_4	135	55	4	5500	5870	370	0.07	1.07	9	10	1
0011	3F	1_4	136	37	2	3700	6600	2900	0.05	1.78	6	11	5
0011	3F	1_4	145	38	2	3800	3750	-50	0.05	0.99	6	6	0
0011	3F	1_4	146	30	3	3000	6290	3290	0.10	2.10	5	11	6
0011	3F	1_4	156	8	2	800	2500	1700	0.25	3.13	1	4	3
0011	3F	1_4	234	6	1	600	290	-310	0.17	0.48	1	0	-1
0011	3F	1_4	235	7	0	700	0	-700	0.00	0.00	1	0	-1
0011	3F	1_4	236	8	0	800	0	-800	0.00	0.00	1	0	-1
0011	3F	1_4	245	3	0	300	0	-300	0.00	0.00	0	0	0
0011	3F	1_4	246	3	0	300	0	-300	0.00	0.00	0	0	0
0011	3F	1_5	123	195	49	19500	20120	620	0.25	1.03	34	35	1
0011	3F	1_5	124	151	28	15100	13380	-1720	0.19	0.89	26	23	-3
0011	3F	1_5	125	58	4	5800	3000	-2800	0.07	0.52	10	5	-5
0011	3F	1_5	126	41	4	4100	5750	1650	0.10	1.40	7	10	3
0011	3F	1_5	134	119	13	11900	7370	-4530	0.11	0.62	21	13	-8
0011	3F	1_5	135	39	1	3900	170	-3730	0.03	0.04	6	0	-6
0011	3F	1_5	136	34	1	3400	310	-3090	0.03	0.09	6	0	-6
0011	3F	1_5	145	42	6	4200	4450	250	0.14	1.06	7	7	0
0011	3F	1_5	146	13	0	1300	0	-1300	0.00	0.00	2	0	-2
0011	3F	1_5	156	4	1	400	750	350	0.25	1.88	0	1	1
0011	3F	1_5	234	11	1	1100	1240	140	0.09	1.13	1	2	1
0011	3F	1_5	235	9	2	900	1280	380	0.22	1.42	1	2	1
0011	3F	1_5	236	2	1	200	640	440	0.50	3.20	0	1	1
0011	3F	1_5	245	1	0	100	0	-100	0.00	0.00	0	0	0
0011	3F	1_5	246	6	0	600	0	-600	0.00	0.00	1	0	-1
0011	3F	1_5	256	3	0	300	0	-300	0.00	0.00	0	0	0
0011	3F	1_6	123	158	32	15800	17840	2040	0.20	1.13	27	31	4
0011	3F	1_6	124	109	15	10900	7450	-3450	0.14	0.68	19	13	-6
0011	3F	1_6	125	58	9	5800	6380	580	0.16	1.10	10	11	1
0011	3F	1_6	126	57	4	5700	3980	-1720	0.07	0.70	10	7	-3
0011	3F	1_6	134	92	11	9200	7290	-1910	0.12	0.79	16	12	-4
0011	3F	1_6	135	42	4	4200	8100	3900	0.10	1.93	7	14	7
0011	3F	1_6	136	36	1	3600	220	-3380	0.03	0.06	6	0	-6
0011	3F	1_6	145	28	1	2800	190	-2610	0.04	0.07	4	0	-4
0011	3F	1_6	146	23	1	2300	1080	-1220	0.04	0.47	4	1	-3
0011	3F	1_6	156	11	1	1100	390	-710	0.09	0.35	1	0	-1
0011	3F	1_6	234	8	1	800	770	-30	0.13	0.96	1	1	0
0011	3F	1_6	235	10	0	1000	0	-1000	0.00	0.00	1	0	-1
0011	3F	1_6	236	7	1	700	290	-410	0.14	0.41	1	0	-1
0011	3F	1_6	245	2	0	200	0	-200	0.00	0.00	0	0	0
0011	3F	1_6	246	3	0	300	0	-300	0.00	0.00	0	0	0
0011	3F	1_6	256	4	1	400	450	50	0.25	1.13	0	0	0
0011	3F	1_7	123	142	28	14200	12900	-1300	0.20	0.91	25	22	-3
0011	3F	1_7	124	111	27	11100	12210	1110	0.24	1.10	19	21	2
0011	3F	1_7	125	75	11	7500	6490	-1010	0.15	0.87	13	11	-2
0011	3F	1_7	126	64	8	6400	7330	930	0.13	1.15	11	12	1
0011	3F	1_7	134	95	14	9500	5120	-4380	0.15	0.54	16	9	-7
0011	3F	1_7	135	54	5	5400	2170	-3230	0.09	0.40	9	3	-6
0011	3F	1_7	136	42	7	4200	3170	-1030	0.17	0.75	7	5	-2
0011	3F	1_7	145	33	2	3300	1630	-1670	0.06	0.49	5	2	-3
0011	3F	1_7	146	23	2	2300	1670	-630	0.09	0.73	4	2	-2
0011	3F	1_7	156	9	2	900	800	-100	0.22	0.89	1	1	0
0011	3F	1_7	234	8	1	800	580	-220	0.13	0.73	1	1	0
0011	3F	1_7	235	9	0	900	0	-900	0.00	0.00	1	0	-1
0011	3F	1_7	236	4	0	400	0	-400	0.00	0.00	0	0	0
0011	3F	1_7	245	7	0	700	0	-700	0.00	0.00	1	0	-1
0011	3F	1_7	246	4	0	400	0	-400	0.00	0.00	0	0	0
0011	3F	1_7	256	1	0	100	0	-100	0.00	0.00	0	0	0
0011	3F	1_8	123	153	24	15300	12420	-2880	0.16	0.81	27	21	-6
0011	3F	1_8	124	121	26	12100	10580	-1520	0.21	0.87	21	18	-3
0011	3F	1_8	125	73	17	7300	7750	450	0.23	1.06	12	13	1
0011	3F	1_8	126	58	5	5800	4090	-1710	0.09	0.71	10	7	-3
0011	3F	1_8	134	93	17	9300	8840	-460	0.18	0.95	16	15	-1
0011	3F	1_8	135	48	7	4800	2190	-2610	0.15	0.46	8	3	-5
0011	3F	1_8	136	32	3	3200	1180	-2020	0.09	0.37	5	2	-3
0011	3F	1_8	145	25	3	2500	3770	1270	0.12	1.51	4	6	2
0011	3F	1_8	146	17	1	1700	340	-1360	0.06	0.20	3	0	-3
0011	3F	1_8	156	8	0	800	0	-800	0.00	0.00	1	0	-1
0011	3F	1_8	234	9	0	900	0	-900	0.00	0.00	1	0	-1
0011	3F	1_8	235	10	2	1000	1010	10	0.20	1.01	1	1	0
0011	3F	1_8	236	4	0	400	0	-400	0.00	0.00	0	0	0
0011	3F	1_8	245	4	1	400	890	490	0.25	2.23	0	1	1
0011	3F	1_8	246	2	0	200	0	-200	0.00	0.00	0	0	0
0011	3F	1_8	256	4	1	400	490	90	0.25	1.23	0	0	0
0011	3F	1_9	123	176	33	17600	13080	-4520	0.19	0.74	31	23	-8
0011	3F	1_9	124	128	22	12800	6600	-6200	0.17	0.52	22	11	-11
0011	3F	1_9	125	62	10	6200	6110	-90	0.16	0.99	10	10	0
0011	3F	1_9	126	53	7	5300	5910	610	0.13	1.12	9	10	1
0011	3F	1_9	134	96	19	9600	6900	-2700	0.20	0.72	16	12	-4
0011	3F	1_9	135	66	11	6600	10280	3680	0.17	1.56	11	18	7
0011	3F	1_9	136	43	2	4300	6430	2130	0.05	1.50	7	11	4
0011	3F	1_9	145	36	2	3600	6630	3030	0.06	1.84	6	11	5
0011	3F	1_9	146	19	2	1900	2790	890	0.11	1.47	3	4	1
0011	3F	1_9	156	9	0	900	0	-900	0.00	0.00	1	0	-1
0011	3F	1_9	234	8	1	800	270	-530	0.13	0.34	1	0	-1
0011	3F	1_9	235	2	0	200	0	-200	0.00	0.00	0	0	0
0011	3F	1_9	236	4	1	400	2370	1970	0.25	5.93	0	4	4
0011	3F	1_9	245	4	0	400	0	-400	0.00	0.00	0	0	0
0011	3F	1_9	246	2	0	200	0	-200	0.00	0.00	0	0	0
0011	3F	2_1	123	189	38	18900	13290	-5610	0.20	0.70	33	23	-10
0011	3F	2_1	124	107	24	10700	9600	-1100	0.22	0.90	18	16	-2
0011	3F	2_1	125	78	16	7800	8970	1170	0.21	1.15	13	15	2
0011	3F	2_1	126	39	4	3900	1860	-2040	0.10	0.48	6	3	-3
0011	3F	2_1	134	84	15	8400	6420	-1980	0.18	0.76	14	11	-3
0011	3F	2_1	135	46	5	4600	2890	-1710	0.11	0.63	8	5	-3
0011	3F	2_1	136	30	1	3000	900	-2100	0.03	0.30	5	1	-4
0011	3F	2_1	145	35	2	3500	830	-2670	0.06	0.24	6	1	-5
0011	3F	2_1	146	24	5	2400	4060	1660	0.21	1.69	4	7	3
0011	3F	2_1	156	5	0	500	0	-500	0.00	0.00	0	0	0
0011	3F	2_1	234	4	0	400	0	-400	0.00	0.00	0	0	0
0011	3F	2_1	235	5	0	500	0	-500	0.00	0.00	0	0	0
0011	3F	2_1	236	2	0	200	0	-200	0.00	0.00	0	0	0
0011	3F	2_1	245	5	0	500	0	-500	0.00	0.00	0	0	0
0011	3F	2_1	246	4	0	400	0	-400	0.00	0.00	0	0	0
0011	3F	2_10	123	174	30	17400	13590	-3810	0.17	0.78	30	24	-6
0011	3F	2_10	124	152	25	15200	13310	-1890	0.16	0.88	26	23	-3
0011	3F	2_10	125	84	14	8400	7490	-910	0.17	0.89	14	13	-1
0011	3F	2_10	126	97	15	9700	6250	-3450	0.15	0.64	17	11	-6
0011	3F	2_10	134	92	13	9200	6770	-2430	0.14	0.74	16	11	-5
0011	3F	2_10	135	47	11	4700	4310	-390	0.23	0.92	8	7	-1
0011	3F	2_10	136	58	6	5800	4760	-1040	0.10	0.82	10	8	-2
0011	3F	2_10	145	20	2	2000	1930	-70	0.10	0.97	3	3	0
0011	3F	2_10	146	35	4	3500	4920	1420	0.11	1.41	6	8	2
0011	3F	2_10	156	14	2	1400	3250	1850	0.14	2.32	2	5	3
0011	3F	2_10	234	1	0	100	0	-100	0.00	0.00	0	0	0
0011	3F	2_10	235	1	0	100	0	-100	0.00	0.00	0	0	0
0011	3F	2_10	236	2	0	200	0	-200	0.00	0.00	0	0	0
0011	3F	2_10	245	2	0	200	0	-200	0.00	0.00	0	0	0
0011	3F	2_10	246	1	0	100	0	-100	0.00	0.00	0	0	0
0011	3F	2_10	256	1	0	100	0	-100	0.00	0.00	0	0	0
0011	3F	2_11	123	190	35	19000	13340	-5660	0.18	0.70	33	23	-10
0011	3F	2_11	124	179	30	17900	11760	-6140	0.17	0.66	31	20	-11
0011	3F	2_11	125	101	13	10100	6650	-3450	0.13	0.66	17	11	-6
0011	3F	2_11	126	72	3	7200	2980	-4220	0.04	0.41	12	5	-7
0011	3F	2_11	134	114	14	11400	8080	-3320	0.12	0.71	20	14	-6
0011	3F	2_11	135	50	5	5000	1800	-3200	0.10	0.36	8	3	-5
0011	3F	2_11	136	43	3	4300	1460	-2840	0.07	0.34	7	2	-5
0011	3F	2_11	145	37	4	3700	4940	1240	0.11	1.34	6	8	2
0011	3F	2_11	146	27	1	2700	550	-2150	0.04	0.20	4	0	-4
0011	3F	2_11	156	17	0	1700	0	-1700	0.00	0.00	3	0	-3
0011	3F	2_11	234	1	0	100	0	-100	0.00	0.00	0	0	0
0011	3F	2_11	235	1	0	100	0	-100	0.00	0.00	0	0	0
0011	3F	2_11	236	1	0	100	0	-100	0.00	0.00	0	0	0
0011	3F	2_11	246	1	0	100	0	-100	0.00	0.00	0	0	0
0011	3F	2_12	123	216	40	21600	16080	-5520	0.19	0.74	38	28	-10
0011	3F	2_12	124	192	35	19200	17590	-1610	0.18	0.92	33	31	-2
0011	3F	2_12	125	115	15	11500	12000	500	0.13	1.04	20	21	1
0011	3F	2_12	126	79	4	7900	2550	-5350	0.05	0.32	13	4	-9
0011	3F	2_12	134	107	15	10700	9860	-840	0.14	0.92	18	17	-1
0011	3F	2_12	135	53	10	5300	8520	3220	0.19	1.61	9	15	6
0011	3F	2_12	136	43	1	4300	410	-3890	0.02	0.10	7	0	-7
0011	3F	2_12	145	48	5	4800	5200	400	0.10	1.08	8	9	1
0011	3F	2_12	146	25	4	2500	3750	1250	0.16	1.50	4	6	2
0011	3F	2_12	156	12	2	1200	1310	110	0.17	1.09	2	2	0
0011	3F	2_12	234	1	0	100	0	-100	0.00	0.00	0	0	0
0011	3F	2_12	245	1	0	100	0	-100	0.00	0.00	0	0	0
0011	3F	2_2	123	123	24	12300	9850	-2450	0.20	0.80	21	17	-4
0011	3F	2_2	124	114	20	11400	7350	-4050	0.18	0.64	20	13	-7
0011	3F	2_2	125	50	10	5000	5980	980	0.20	1.20	8	10	2
0011	3F	2_2	126	52	4	5200	3170	-2030	0.08	0.61	9	5	-4
0011	3F	2_2	134	76	9	7600	4340	-3260	0.12	0.57	13	7	-6
0011	3F	2_2	135	36	7	3600	2880	-720	0.19	0.80	6	5	-1
0011	3F	2_2	136	38	0	3800	0	-3800	0.00	0.00	6	0	-6
0011	3F	2_2	145	29	5	2900	2340	-560	0.17	0.81	5	4	-1
0011	3F	2_2	146	24	3	2400	1900	-500	0.13	0.79	4	3	-1
0011	3F	2_2	156	13	0	1300	0	-1300	0.00	0.00	2	0	-2
0011	3F	2_2	234	10	3	1000	4620	3620	0.30	4.62	1	8	7
0011	3F	2_2	235	5	0	500	0	-500	0.00	0.00	0	0	0
0011	3F	2_2	236	12	1	1200	550	-650	0.08	0.46	2	0	-2
0011	3F	2_2	245	3	2	300	11370	11070	0.67	37.90	0	20	20
0011	3F	2_2	246	4	0	400	0	-400	0.00	0.00	0	0	0
0011	3F	2_2	256	2	0	200	0	-200	0.00	0.00	0	0	0
0011	3F	2_3	123	152	28	15200	11430	-3770	0.18	0.75	26	20	-6
0011	3F	2_3	124	77	15	7700	6110	-1590	0.19	0.79	13	10	-3
0011	3F	2_3	125	58	11	5800	5000	-800	0.19	0.86	10	8	-2
0011	3F	2_3	126	50	5	5000	3690	-1310	0.10	0.74	8	6	-2
0011	3F	2_3	134	47	6	4700	3030	-1670	0.13	0.64	8	5	-3
0011	3F	2_3	135	53	11	5300	5100	-200	0.21	0.96	9	9	0
0011	3F	2_3	136	48	3	4800	1190	-3610	0.06	0.25	8	2	-6
0011	3F	2_3	145	35	0	3500	0	-3500	0.00	0.00	6	0	-6
0011	3F	2_3	146	23	1	2300	350	-1950	0.04	0.15	4	0	-4
0011	3F	2_3	156	20	0	2000	0	-2000	0.00	0.00	3	0	-3
0011	3F	2_3	234	10	1	1000	560	-440	0.10	0.56	1	0	-1
0011	3F	2_3	235	4	0	400	0	-400	0.00	0.00	0	0	0
0011	3F	2_3	236	9	1	900	640	-260	0.11	0.71	1	1	0
0011	3F	2_3	245	5	0	500	0	-500	0.00	0.00	0	0	0
0011	3F	2_3	246	9	0	900	0	-900	0.00	0.00	1	0	-1
0011	3F	2_3	256	4	0	400	0	-400	0.00	0.00	0	0	0
0011	3F	2_4	123	137	33	13700	13160	-540	0.24	0.96	24	23	-1
0011	3F	2_4	124	112	15	11200	6780	-4420	0.13	0.61	19	12	-7
0011	3F	2_4	125	63	9	6300	5430	-870	0.14	0.86	11	9	-2
0011	3F	2_4	126	77	10	7700	8250	550	0.13	1.07	13	14	1
0011	3F	2_4	134	61	7	6100	2520	-3580	0.11	0.41	10	4	-6
0011	3F	2_4	135	52	8	5200	3000	-2200	0.15	0.58	9	5	-4
0011	3F	2_4	136	52	5	5200	4770	-430	0.10	0.92	9	8	-1
0011	3F	2_4	145	42	5	4200	3030	-1170	0.12	0.72	7	5	-2
0011	3F	2_4	146	20	3	2000	1190	-810	0.15	0.60	3	2	-1
0011	3F	2_4	156	18	2	1800	1240	-560	0.11	0.69	3	2	-1
0011	3F	2_4	234	9	1	900	280	-620	0.11	0.31	1	0	-1
0011	3F	2_4	235	8	1	800	410	-390	0.13	0.51	1	0	-1
0011	3F	2_4	236	12	3	1200	1700	500	0.25	1.42	2	3	1
0011	3F	2_4	245	6	0	600	0	-600	0.00	0.00	1	0	-1
0011	3F	2_4	246	8	1	800	560	-240	0.13	0.70	1	0	-1
0011	3F	2_4	256	5	0	500	0	-500	0.00	0.00	0	0	0
0011	3F	2_5	123	151	27	15100	10260	-4840	0.18	0.68	26	18	-8
0011	3F	2_5	124	130	23	13000	7560	-5440	0.18	0.58	23	13	-10
0011	3F	2_5	125	76	14	7600	9890	2290	0.18	1.30	13	17	4
0011	3F	2_5	126	80	11	8000	8250	250	0.14	1.03	14	14	0
0011	3F	2_5	134	78	10	7800	5000	-2800	0.13	0.64	13	8	-5
0011	3F	2_5	135	35	2	3500	2040	-1460	0.06	0.58	6	3	-3
0011	3F	2_5	136	36	4	3600	1670	-1930	0.11	0.46	6	2	-4
0011	3F	2_5	145	22	5	2200	2360	160	0.23	1.07	3	4	1
0011	3F	2_5	146	15	0	1500	0	-1500	0.00	0.00	2	0	-2
0011	3F	2_5	156	17	0	1700	0	-1700	0.00	0.00	3	0	-3
0011	3F	2_5	234	7	3	700	2300	1600	0.43	3.29	1	4	3
0011	3F	2_5	235	4	1	400	520	120	0.25	1.30	0	0	0
0011	3F	2_5	236	5	0	500	0	-500	0.00	0.00	0	0	0
0011	3F	2_5	245	7	0	700	0	-700	0.00	0.00	1	0	-1
0011	3F	2_5	246	3	1	300	330	30	0.33	1.10	0	0	0
0011	3F	2_5	256	4	1	400	640	240	0.25	1.60	0	1	1
0011	3F	2_6	123	133	29	13300	11020	-2280	0.22	0.83	23	19	-4
0011	3F	2_6	124	104	11	10400	5400	-5000	0.11	0.52	18	9	-9
0011	3F	2_6	125	77	8	7700	3100	-4600	0.10	0.40	13	5	-8
0011	3F	2_6	126	81	14	8100	6930	-1170	0.17	0.86	14	12	-2
0011	3F	2_6	134	71	12	7100	4550	-2550	0.17	0.64	12	8	-4
0011	3F	2_6	135	43	2	4300	2070	-2230	0.05	0.48	7	3	-4
0011	3F	2_6	136	43	11	4300	4000	-300	0.26	0.93	7	7	0
0011	3F	2_6	145	21	2	2100	1410	-690	0.10	0.67	3	2	-1
0011	3F	2_6	146	20	0	2000	0	-2000	0.00	0.00	3	0	-3
0011	3F	2_6	156	12	1	1200	600	-600	0.08	0.50	2	1	-1
0011	3F	2_6	234	8	3	800	1350	550	0.38	1.69	1	2	1
0011	3F	2_6	235	6	1	600	310	-290	0.17	0.52	1	0	-1
0011	3F	2_6	236	14	1	1400	1790	390	0.07	1.28	2	3	1
0011	3F	2_6	245	1	1	100	1200	1100	1.00	12.00	0	2	2
0011	3F	2_6	246	5	0	500	0	-500	0.00	0.00	0	0	0
0011	3F	2_6	256	6	1	600	440	-160	0.17	0.73	1	0	-1
0011	3F	2_7	123	125	27	12500	10170	-2330	0.22	0.81	22	18	-4
0011	3F	2_7	124	105	23	10500	8590	-1910	0.22	0.82	18	15	-3
0011	3F	2_7	125	69	13	6900	7180	280	0.19	1.04	12	12	0
0011	3F	2_7	126	61	12	6100	7540	1440	0.20	1.24	10	13	3
0011	3F	2_7	134	77	11	7700	6290	-1410	0.14	0.82	13	11	-2
0011	3F	2_7	135	42	5	4200	2200	-2000	0.12	0.52	7	3	-4
0011	3F	2_7	136	49	3	4900	1650	-3250	0.06	0.34	8	2	-6
0011	3F	2_7	145	24	6	2400	3260	860	0.25	1.36	4	5	1
0011	3F	2_7	146	30	4	3000	2040	-960	0.13	0.68	5	3	-2
0011	3F	2_7	156	13	1	1300	290	-1010	0.08	0.22	2	0	-2
0011	3F	2_7	234	5	1	500	1070	570	0.20	2.14	0	1	1
0011	3F	2_7	235	7	2	700	1440	740	0.29	2.06	1	2	1
0011	3F	2_7	236	14	2	1400	750	-650	0.14	0.54	2	1	-1
0011	3F	2_7	245	5	0	500	0	-500	0.00	0.00	0	0	0
0011	3F	2_7	246	6	1	600	1110	510	0.17	1.85	1	1	0
0011	3F	2_7	256	8	1	800	1070	270	0.13	1.34	1	1	0
0011	3F	2_8	123	131	21	13100	8170	-4930	0.16	0.62	23	14	-9
0011	3F	2_8	124	121	30	12100	10130	-1970	0.25	0.84	21	17	-4
0011	3F	2_8	125	67	9	6700	4970	-1730	0.13	0.74	11	8	-3
0011	3F	2_8	126	62	9	6200	3830	-2370	0.15	0.62	10	6	-4
0011	3F	2_8	134	71	10	7100	7500	400	0.14	1.06	12	13	1
0011	3F	2_8	135	41	4	4100	1530	-2570	0.10	0.37	7	2	-5
0011	3F	2_8	136	49	9	4900	4920	20	0.18	1.00	8	8	0
0011	3F	2_8	145	24	4	2400	1310	-1090	0.17	0.55	4	2	-2
0011	3F	2_8	146	21	1	2100	810	-1290	0.05	0.39	3	1	-2
0011	3F	2_8	156	13	3	1300	1670	370	0.23	1.28	2	2	0
0011	3F	2_8	234	7	0	700	0	-700	0.00	0.00	1	0	-1
0011	3F	2_8	235	5	0	500	0	-500	0.00	0.00	0	0	0
0011	3F	2_8	236	8	1	800	960	160	0.13	1.20	1	1	0
0011	3F	2_8	245	3	0	300	0	-300	0.00	0.00	0	0	0
0011	3F	2_8	246	2	1	200	480	280	0.50	2.40	0	0	0
0011	3F	2_8	256	4	0	400	0	-400	0.00	0.00	0	0	0
0011	3F	2_9	123	159	33	15900	14160	-1740	0.21	0.89	28	25	-3
0011	3F	2_9	124	129	23	12900	10140	-2760	0.18	0.79	22	17	-5
0011	3F	2_9	125	60	10	6000	4410	-1590	0.17	0.74	10	7	-3
0011	3F	2_9	126	67	9	6700	4460	-2240	0.13	0.67	11	7	-4
0011	3F	2_9	134	72	11	7200	4070	-3130	0.15	0.57	12	7	-5
0011	3F	2_9	135	45	5	4500	5470	970	0.11	1.22	7	9	2
0011	3F	2_9	136	42	7	4200	3040	-1160	0.17	0.72	7	5	-2
0011	3F	2_9	145	45	6	4500	7970	3470	0.13	1.77	7	14	7
0011	3F	2_9	146	31	2	3100	960	-2140	0.06	0.31	5	1	-4
0011	3F	2_9	156	12	1	1200	1580	380	0.08	1.32	2	2	0
0011	3F	2_9	234	7	1	700	380	-320	0.14	0.54	1	0	-1
0011	3F	2_9	235	6	1	600	900	300	0.17	1.50	1	1	0
0011	3F	2_9	236	5	2	500	880	380	0.40	1.76	0	1	1
0011	3F	2_9	245	4	1	400	500	100	0.25	1.25	0	0	0
0011	3F	2_9	246	4	0	400	0	-400	0.00	0.00	0	0	0
0011	3F	2_9	256	3	1	300	500	200	0.33	1.67	0	0	0
0011	3F	3_1	123	172	38	17200	16270	-930	0.22	0.95	30	28	-2
0011	3F	3_1	124	137	21	13700	11510	-2190	0.15	0.84	24	20	-4
0011	3F	3_1	125	92	6	9200	9020	-180	0.07	0.98	16	15	-1
0011	3F	3_1	126	46	4	4600	1920	-2680	0.09	0.42	8	3	-5
0011	3F	3_1	134	118	14	11800	7910	-3890	0.12	0.67	20	14	-6
0011	3F	3_1	135	64	7	6400	4920	-1480	0.11	0.77	11	8	-3
0011	3F	3_1	136	28	3	2800	2380	-420	0.11	0.85	4	4	0
0011	3F	3_1	145	53	3	5300	1870	-3430	0.06	0.35	9	3	-6
0011	3F	3_1	146	27	1	2700	510	-2190	0.04	0.19	4	0	-4
0011	3F	3_1	156	6	0	600	0	-600	0.00	0.00	1	0	-1
0011	3F	3_1	234	5	0	500	0	-500	0.00	0.00	0	0	0
0011	3F	3_1	235	10	0	1000	0	-1000	0.00	0.00	1	0	-1
0011	3F	3_1	236	2	0	200	0	-200	0.00	0.00	0	0	0
0011	3F	3_1	245	4	0	400	0	-400	0.00	0.00	0	0	0
0011	3F	3_1	246	2	0	200	0	-200	0.00	0.00	0	0	0
0011	3F	3_1	256	1	0	100	0	-100	0.00	0.00	0	0	0
0011	3F	3_10	123	169	33	16900	11680	-5220	0.20	0.69	29	20	-9
0011	3F	3_10	124	109	15	10900	7590	-3310	0.14	0.70	19	13	-6
0011	3F	3_10	125	82	8	8200	7450	-750	0.10	0.91	14	13	-1
0011	3F	3_10	126	71	9	7100	6540	-560	0.13	0.92	12	11	-1
0011	3F	3_10	134	112	17	11200	11420	220	0.15	1.02	19	20	1
0011	3F	3_10	135	66	8	6600	6050	-550	0.12	0.92	11	10	-1
0011	3F	3_10	136	45	0	4500	0	-4500	0.00	0.00	7	0	-7
0011	3F	3_10	145	43	2	4300	640	-3660	0.05	0.15	7	1	-6
0011	3F	3_10	146	23	3	2300	2680	380	0.13	1.17	4	4	0
0011	3F	3_10	156	17	2	1700	1430	-270	0.12	0.84	3	2	-1
0011	3F	3_10	234	8	1	800	540	-260	0.13	0.68	1	0	-1
0011	3F	3_10	235	1	0	100	0	-100	0.00	0.00	0	0	0
0011	3F	3_10	236	4	0	400	0	-400	0.00	0.00	0	0	0
0011	3F	3_10	245	3	0	300	0	-300	0.00	0.00	0	0	0
0011	3F	3_10	246	1	0	100	0	-100	0.00	0.00	0	0	0
0011	3F	3_10	256	3	0	300	0	-300	0.00	0.00	0	0	0
0011	3F	3_11	123	219	54	21900	20900	-1000	0.25	0.95	38	36	-2
0011	3F	3_11	124	161	26	16100	12200	-3900	0.16	0.76	28	21	-7
0011	3F	3_11	125	96	11	9600	7480	-2120	0.11	0.78	16	13	-3
0011	3F	3_11	126	75	8	7500	10850	3350	0.11	1.45	13	19	6
0011	3F	3_11	134	77	8	7700	4790	-2910	0.10	0.62	13	8	-5
0011	3F	3_11	135	68	6	6800	4700	-2100	0.09	0.69	12	8	-4
0011	3F	3_11	136	34	5	3400	3130	-270	0.15	0.92	6	5	-1
0011	3F	3_11	145	38	3	3800	1270	-2530	0.08	0.33	6	2	-4
0011	3F	3_11	146	30	5	3000	4940	1940	0.17	1.65	5	8	3
0011	3F	3_11	156	14	1	1400	670	-730	0.07	0.48	2	1	-1
0011	3F	3_11	234	1	0	100	0	-100	0.00	0.00	0	0	0
0011	3F	3_11	235	2	0	200	0	-200	0.00	0.00	0	0	0
0011	3F	3_11	236	1	0	100	0	-100	0.00	0.00	0	0	0
0011	3F	3_11	245	2	0	200	0	-200	0.00	0.00	0	0	0
0011	3F	3_12	123	237	66	23700	25140	1440	0.28	1.06	41	44	3
0011	3F	3_12	124	183	31	18300	15530	-2770	0.17	0.85	32	27	-5
0011	3F	3_12	125	116	10	11600	6500	-5100	0.09	0.56	20	11	-9
0011	3F	3_12	126	58	3	5800	3750	-2050	0.05	0.65	10	6	-4
0011	3F	3_12	134	115	24	11500	12940	1440	0.21	1.13	20	22	2
0011	3F	3_12	135	59	5	5900	3510	-2390	0.08	0.59	10	6	-4
0011	3F	3_12	136	43	6	4300	6480	2180	0.14	1.51	7	11	4
0011	3F	3_12	145	35	3	3500	1480	-2020	0.09	0.42	6	2	-4
0011	3F	3_12	146	33	3	3300	2230	-1070	0.09	0.68	5	3	-2
0011	3F	3_12	156	14	1	1400	2100	700	0.07	1.50	2	3	1
0011	3F	3_12	234	2	0	200	0	-200	0.00	0.00	0	0	0
0011	3F	3_12	236	1	0	100	0	-100	0.00	0.00	0	0	0
0011	3F	3_2	123	160	20	16000	8250	-7750	0.13	0.52	28	14	-14
0011	3F	3_2	124	122	23	12200	11010	-1190	0.19	0.90	21	19	-2
0011	3F	3_2	125	72	3	7200	1600	-5600	0.04	0.22	12	2	-10
0011	3F	3_2	126	53	3	5300	6310	1010	0.06	1.19	9	11	2
0011	3F	3_2	134	75	9	7500	5690	-1810	0.12	0.76	13	10	-3
0011	3F	3_2	135	55	5	5500	5560	60	0.09	1.01	9	9	0
0011	3F	3_2	136	34	1	3400	1100	-2300	0.03	0.32	6	1	-5
0011	3F	3_2	145	44	5	4400	6410	2010	0.11	1.46	7	11	4
0011	3F	3_2	146	17	1	1700	610	-1090	0.06	0.36	3	1	-2
0011	3F	3_2	156	16	2	1600	2040	440	0.13	1.28	2	3	1
0011	3F	3_2	234	12	1	1200	1740	540	0.08	1.45	2	3	1
0011	3F	3_2	235	13	0	1300	0	-1300	0.00	0.00	2	0	-2
0011	3F	3_2	236	4	0	400	0	-400	0.00	0.00	0	0	0
0011	3F	3_2	245	10	0	1000	0	-1000	0.00	0.00	1	0	-1
0011	3F	3_2	246	6	0	600	0	-600	0.00	0.00	1	0	-1
0011	3F	3_3	123	154	25	15400	11110	-4290	0.16	0.72	27	19	-8
0011	3F	3_3	124	128	16	12800	10540	-2260	0.13	0.82	22	18	-4
0011	3F	3_3	125	54	10	5400	9590	4190	0.19	1.78	9	16	7
0011	3F	3_3	126	43	1	4300	250	-4050	0.02	0.06	7	0	-7
0011	3F	3_3	134	91	14	9100	7750	-1350	0.15	0.85	16	13	-3
0011	3F	3_3	135	71	5	7100	3220	-3880	0.07	0.45	12	5	-7
0011	3F	3_3	136	39	2	3900	1560	-2340	0.05	0.40	6	2	-4
0011	3F	3_3	145	40	2	4000	2690	-1310	0.05	0.67	7	4	-3
0011	3F	3_3	146	22	0	2200	0	-2200	0.00	0.00	3	0	-3
0011	3F	3_3	156	17	1	1700	2490	790	0.06	1.46	3	4	1
0011	3F	3_3	234	15	0	1500	0	-1500	0.00	0.00	2	0	-2
0011	3F	3_3	235	11	1	1100	440	-660	0.09	0.40	1	0	-1
0011	3F	3_3	236	7	0	700	0	-700	0.00	0.00	1	0	-1
0011	3F	3_3	245	7	1	700	1130	430	0.14	1.61	1	2	1
0011	3F	3_3	246	4	0	400	0	-400	0.00	0.00	0	0	0
0011	3F	3_3	256	2	0	200	0	-200	0.00	0.00	0	0	0
0011	3F	3_4	123	137	20	13700	10730	-2970	0.15	0.78	24	18	-6
0011	3F	3_4	124	101	15	10100	8400	-1700	0.15	0.83	17	14	-3
0011	3F	3_4	125	82	12	8200	10790	2590	0.15	1.32	14	19	5
0011	3F	3_4	126	71	10	7100	8980	1880	0.14	1.26	12	15	3
0011	3F	3_4	134	95	16	9500	10610	1110	0.17	1.12	16	18	2
0011	3F	3_4	135	50	8	5000	2740	-2260	0.16	0.55	8	4	-4
0011	3F	3_4	136	28	4	2800	3950	1150	0.14	1.41	4	6	2
0011	3F	3_4	145	26	4	2600	1640	-960	0.15	0.63	4	2	-2
0011	3F	3_4	146	25	1	2500	1500	-1000	0.04	0.60	4	2	-2
0011	3F	3_4	156	18	0	1800	0	-1800	0.00	0.00	3	0	-3
0011	3F	3_4	234	13	2	1300	1030	-270	0.15	0.79	2	1	-1
0011	3F	3_4	235	14	0	1400	0	-1400	0.00	0.00	2	0	-2
0011	3F	3_4	236	8	0	800	0	-800	0.00	0.00	1	0	-1
0011	3F	3_4	245	5	0	500	0	-500	0.00	0.00	0	0	0
0011	3F	3_4	246	3	0	300	0	-300	0.00	0.00	0	0	0
0011	3F	3_4	256	3	0	300	0	-300	0.00	0.00	0	0	0
0011	3F	3_5	123	148	31	14800	11780	-3020	0.21	0.80	26	20	-6
0011	3F	3_5	124	119	30	11900	20230	8330	0.25	1.70	21	35	14
0011	3F	3_5	125	86	11	8600	4720	-3880	0.13	0.55	15	8	-7
0011	3F	3_5	126	56	7	5600	7620	2020	0.13	1.36	9	13	4
0011	3F	3_5	134	94	13	9400	6490	-2910	0.14	0.69	16	11	-5
0011	3F	3_5	135	42	6	4200	6790	2590	0.14	1.62	7	12	5
0011	3F	3_5	136	47	5	4700	2530	-2170	0.11	0.54	8	4	-4
0011	3F	3_5	145	36	5	3600	3540	-60	0.14	0.98	6	6	0
0011	3F	3_5	146	18	0	1800	0	-1800	0.00	0.00	3	0	-3
0011	3F	3_5	156	13	3	1300	2730	1430	0.23	2.10	2	4	2
0011	3F	3_5	234	11	0	1100	0	-1100	0.00	0.00	1	0	-1
0011	3F	3_5	235	2	2	200	1220	1020	1.00	6.10	0	2	2
0011	3F	3_5	236	1	0	100	0	-100	0.00	0.00	0	0	0
0011	3F	3_5	245	5	1	500	380	-120	0.20	0.76	0	0	0
0011	3F	3_5	246	6	0	600	0	-600	0.00	0.00	1	0	-1
0011	3F	3_5	256	4	0	400	0	-400	0.00	0.00	0	0	0
0011	3F	3_6	123	135	37	13500	14490	990	0.27	1.07	23	25	2
0011	3F	3_6	124	112	15	11200	6140	-5060	0.13	0.55	19	10	-9
0011	3F	3_6	125	64	12	6400	4980	-1420	0.19	0.78	11	8	-3
0011	3F	3_6	126	63	6	6300	2230	-4070	0.10	0.35	11	3	-8
0011	3F	3_6	134	73	11	7300	5390	-1910	0.15	0.74	12	9	-3
0011	3F	3_6	135	43	4	4300	3590	-710	0.09	0.83	7	6	-1
0011	3F	3_6	136	36	5	3600	3320	-280	0.14	0.92	6	5	-1
0011	3F	3_6	145	29	4	2900	3240	340	0.14	1.12	5	5	0
0011	3F	3_6	146	28	0	2800	0	-2800	0.00	0.00	4	0	-4
0011	3F	3_6	156	11	1	1100	3300	2200	0.09	3.00	1	5	4
0011	3F	3_6	234	14	3	1400	1100	-300	0.21	0.79	2	1	-1
0011	3F	3_6	235	14	3	1400	1190	-210	0.21	0.85	2	2	0
0011	3F	3_6	236	17	1	1700	260	-1440	0.06	0.15	3	0	-3
0011	3F	3_6	245	4	0	400	0	-400	0.00	0.00	0	0	0
0011	3F	3_6	246	7	0	700	0	-700	0.00	0.00	1	0	-1
0011	3F	3_6	256	6	1	600	400	-200	0.17	0.67	1	0	-1
0011	3F	3_7	123	122	30	12200	11170	-1030	0.25	0.92	21	19	-2
0011	3F	3_7	124	116	16	11600	6610	-4990	0.14	0.57	20	11	-9
0011	3F	3_7	125	62	3	6200	1570	-4630	0.05	0.25	10	2	-8
0011	3F	3_7	126	58	7	5800	3140	-2660	0.12	0.54	10	5	-5
0011	3F	3_7	134	84	10	8400	8720	320	0.12	1.04	14	15	1
0011	3F	3_7	135	52	6	5200	2430	-2770	0.12	0.47	9	4	-5
0011	3F	3_7	136	39	1	3900	400	-3500	0.03	0.10	6	0	-6
0011	3F	3_7	145	38	8	3800	5900	2100	0.21	1.55	6	10	4
0011	3F	3_7	146	23	1	2300	950	-1350	0.04	0.41	4	1	-3
0011	3F	3_7	156	11	1	1100	8970	7870	0.09	8.15	1	15	14
0011	3F	3_7	234	8	2	800	790	-10	0.25	0.99	1	1	0
0011	3F	3_7	235	11	0	1100	0	-1100	0.00	0.00	1	0	-1
0011	3F	3_7	236	10	1	1000	140	-860	0.10	0.14	1	0	-1
0011	3F	3_7	245	7	0	700	0	-700	0.00	0.00	1	0	-1
0011	3F	3_7	246	4	1	400	750	350	0.25	1.88	0	1	1
0011	3F	3_7	256	6	0	600	0	-600	0.00	0.00	1	0	-1
0011	3F	3_8	123	153	36	15300	14790	-510	0.24	0.97	27	26	-1
0011	3F	3_8	124	97	17	9700	7540	-2160	0.18	0.78	17	13	-4
0011	3F	3_8	125	80	18	8000	7130	-870	0.23	0.89	14	12	-2
0011	3F	3_8	126	35	2	3500	4510	1010	0.06	1.29	6	7	1
0011	3F	3_8	134	89	13	8900	5600	-3300	0.15	0.63	15	9	-6
0011	3F	3_8	135	67	6	6700	2050	-4650	0.09	0.31	11	3	-8
0011	3F	3_8	136	39	4	3900	3250	-650	0.10	0.83	6	5	-1
0011	3F	3_8	145	30	3	3000	1380	-1620	0.10	0.46	5	2	-3
0011	3F	3_8	146	25	4	2500	3330	830	0.16	1.33	4	5	1
0011	3F	3_8	156	9	0	900	0	-900	0.00	0.00	1	0	-1
0011	3F	3_8	234	15	0	1500	0	-1500	0.00	0.00	2	0	-2
0011	3F	3_8	235	9	1	900	2720	1820	0.11	3.02	1	4	3
0011	3F	3_8	236	6	0	600	0	-600	0.00	0.00	1	0	-1
0011	3F	3_8	245	4	0	400	0	-400	0.00	0.00	0	0	0
0011	3F	3_8	246	5	0	500	0	-500	0.00	0.00	0	0	0
0011	3F	3_8	256	4	0	400	0	-400	0.00	0.00	0	0	0
0011	3F	3_9	123	162	36	16200	16310	110	0.22	1.01	28	28	0
0011	3F	3_9	124	124	20	12400	6990	-5410	0.16	0.56	21	12	-9
0011	3F	3_9	125	82	15	8200	7410	-790	0.18	0.90	14	13	-1
0011	3F	3_9	126	61	6	6100	4970	-1130	0.10	0.81	10	8	-2
0011	3F	3_9	134	84	10	8400	3710	-4690	0.12	0.44	14	6	-8
0011	3F	3_9	135	42	5	4200	2840	-1360	0.12	0.68	7	5	-2
0011	3F	3_9	136	27	7	2700	2860	160	0.26	1.06	4	5	1
0011	3F	3_9	145	32	4	3200	2790	-410	0.13	0.87	5	4	-1
0011	3F	3_9	146	16	1	1600	260	-1340	0.06	0.16	2	0	-2
0011	3F	3_9	156	13	0	1300	0	-1300	0.00	0.00	2	0	-2
0011	3F	3_9	234	7	0	700	0	-700	0.00	0.00	1	0	-1
0011	3F	3_9	235	5	0	500	0	-500	0.00	0.00	0	0	0
0011	3F	3_9	236	4	0	400	0	-400	0.00	0.00	0	0	0
0011	3F	3_9	245	3	0	300	0	-300	0.00	0.00	0	0	0
0011	3F	3_9	246	1	0	100	0	-100	0.00	0.00	0	0	0
0011	3F	3_9	256	3	0	300	0	-300	0.00	0.00	0	0	0
0011	3F	4_1	123	144	34	14400	13080	-1320	0.24	0.91	25	23	-2
0011	3F	4_1	124	99	20	9900	8050	-1850	0.20	0.81	17	14	-3
0011	3F	4_1	125	51	5	5100	2620	-2480	0.10	0.51	9	4	-5
0011	3F	4_1	126	38	1	3800	590	-3210	0.03	0.16	6	1	-5
0011	3F	4_1	134	88	17	8800	6680	-2120	0.19	0.76	15	11	-4
0011	3F	4_1	135	32	0	3200	0	-3200	0.00	0.00	5	0	-5
0011	3F	4_1	136	27	3	2700	4610	1910	0.11	1.71	4	8	4
0011	3F	4_1	145	18	3	1800	2960	1160	0.17	1.64	3	5	2
0011	3F	4_1	146	13	0	1300	0	-1300	0.00	0.00	2	0	-2
0011	3F	4_1	156	6	0	600	0	-600	0.00	0.00	1	0	-1
0011	3F	4_1	234	5	1	500	380	-120	0.20	0.76	0	0	0
0011	3F	4_1	235	4	0	400	0	-400	0.00	0.00	0	0	0
0011	3F	4_1	236	4	2	400	2890	2490	0.50	7.23	0	5	5
0011	3F	4_1	245	2	0	200	0	-200	0.00	0.00	0	0	0
0011	3F	4_1	256	1	0	100	0	-100	0.00	0.00	0	0	0
0011	3F	4_10	123	206	40	20600	18190	-2410	0.19	0.88	36	32	-4
0011	3F	4_10	124	130	11	13000	6840	-6160	0.08	0.53	23	12	-11
0011	3F	4_10	125	63	5	6300	4500	-1800	0.08	0.71	11	7	-4
0011	3F	4_10	126	53	4	5300	2160	-3140	0.08	0.41	9	3	-6
0011	3F	4_10	134	102	18	10200	8250	-1950	0.18	0.81	18	14	-4
0011	3F	4_10	135	32	6	3200	3650	450	0.19	1.14	5	6	1
0011	3F	4_10	136	25	1	2500	320	-2180	0.04	0.13	4	0	-4
0011	3F	4_10	145	30	3	3000	3760	760	0.10	1.25	5	6	1
0011	3F	4_10	146	23	2	2300	7260	4960	0.09	3.16	4	12	8
0011	3F	4_10	156	4	0	400	0	-400	0.00	0.00	0	0	0
0011	3F	4_10	234	3	0	300	0	-300	0.00	0.00	0	0	0
0011	3F	4_10	236	1	0	100	0	-100	0.00	0.00	0	0	0
0011	3F	4_10	245	3	0	300	0	-300	0.00	0.00	0	0	0
0011	3F	4_10	256	1	0	100	0	-100	0.00	0.00	0	0	0
0011	3F	4_11	123	211	47	21100	21190	90	0.22	1.00	37	37	0
0011	3F	4_11	124	149	16	14900	7980	-6920	0.11	0.54	26	14	-12
0011	3F	4_11	125	97	10	9700	4640	-5060	0.10	0.48	17	8	-9
0011	3F	4_11	126	37	3	3700	1500	-2200	0.08	0.41	6	2	-4
0011	3F	4_11	134	110	9	11000	4890	-6110	0.08	0.44	19	8	-11
0011	3F	4_11	135	49	3	4900	1490	-3410	0.06	0.30	8	2	-6
0011	3F	4_11	136	33	2	3300	4960	1660	0.06	1.50	5	8	3
0011	3F	4_11	145	31	2	3100	1820	-1280	0.06	0.59	5	3	-2
0011	3F	4_11	146	18	0	1800	0	-1800	0.00	0.00	3	0	-3
0011	3F	4_11	156	5	0	500	0	-500	0.00	0.00	0	0	0
0011	3F	4_11	234	2	0	200	0	-200	0.00	0.00	0	0	0
0011	3F	4_11	236	2	0	200	0	-200	0.00	0.00	0	0	0
0011	3F	4_11	245	1	0	100	0	-100	0.00	0.00	0	0	0
0011	3F	4_11	246	1	0	100	0	-100	0.00	0.00	0	0	0
0011	3F	4_12	123	235	58	23500	21280	-2220	0.25	0.91	41	37	-4
0011	3F	4_12	124	129	23	12900	10300	-2600	0.18	0.80	22	18	-4
0011	3F	4_12	125	73	3	7300	4080	-3220	0.04	0.56	12	7	-5
0011	3F	4_12	126	41	0	4100	0	-4100	0.00	0.00	7	0	-7
0011	3F	4_12	134	96	14	9600	8310	-1290	0.15	0.87	16	14	-2
0011	3F	4_12	135	53	4	5300	2490	-2810	0.08	0.47	9	4	-5
0011	3F	4_12	136	28	2	2800	1740	-1060	0.07	0.62	4	3	-1
0011	3F	4_12	145	22	5	2200	2140	-60	0.23	0.97	3	3	0
0011	3F	4_12	146	13	0	1300	0	-1300	0.00	0.00	2	0	-2
0011	3F	4_12	156	5	0	500	0	-500	0.00	0.00	0	0	0
0011	3F	4_12	234	1	0	100	0	-100	0.00	0.00	0	0	0
0011	3F	4_12	245	1	0	100	0	-100	0.00	0.00	0	0	0
0011	3F	4_12	256	2	0	200	0	-200	0.00	0.00	0	0	0
0011	3F	4_2	123	134	25	13400	9780	-3620	0.19	0.73	23	17	-6
0011	3F	4_2	124	106	23	10600	7390	-3210	0.22	0.70	18	13	-5
0011	3F	4_2	125	61	8	6100	4610	-1490	0.13	0.76	10	8	-2
0011	3F	4_2	126	36	3	3600	1690	-1910	0.08	0.47	6	2	-4
0011	3F	4_2	134	47	9	4700	3880	-820	0.19	0.83	8	6	-2
0011	3F	4_2	135	34	5	3400	3270	-130	0.15	0.96	6	5	-1
0011	3F	4_2	136	28	2	2800	690	-2110	0.07	0.25	4	1	-3
0011	3F	4_2	145	26	3	2600	1190	-1410	0.12	0.46	4	2	-2
0011	3F	4_2	146	12	0	1200	0	-1200	0.00	0.00	2	0	-2
0011	3F	4_2	156	6	2	600	1070	470	0.33	1.78	1	1	0
0011	3F	4_2	234	15	1	1500	550	-950	0.07	0.37	2	0	-2
0011	3F	4_2	235	7	2	700	790	90	0.29	1.13	1	1	0
0011	3F	4_2	236	8	1	800	680	-120	0.13	0.85	1	1	0
0011	3F	4_2	245	3	0	300	0	-300	0.00	0.00	0	0	0
0011	3F	4_2	246	2	0	200	0	-200	0.00	0.00	0	0	0
0011	3F	4_2	256	2	0	200	0	-200	0.00	0.00	0	0	0
0011	3F	4_3	123	122	24	12200	8460	-3740	0.20	0.69	21	14	-7
0011	3F	4_3	124	76	9	7600	2870	-4730	0.12	0.38	13	5	-8
0011	3F	4_3	125	59	10	5900	8560	2660	0.17	1.45	10	15	5
0011	3F	4_3	126	35	3	3500	4130	630	0.09	1.18	6	7	1
0011	3F	4_3	134	55	5	5500	2020	-3480	0.09	0.37	9	3	-6
0011	3F	4_3	135	44	10	4400	5620	1220	0.23	1.28	7	9	2
0011	3F	4_3	136	29	4	2900	2700	-200	0.14	0.93	5	4	-1
0011	3F	4_3	145	20	1	2000	860	-1140	0.05	0.43	3	1	-2
0011	3F	4_3	146	15	3	1500	2390	890	0.20	1.59	2	4	2
0011	3F	4_3	156	2	0	200	0	-200	0.00	0.00	0	0	0
0011	3F	4_3	234	11	1	1100	340	-760	0.09	0.31	1	0	-1
0011	3F	4_3	235	9	1	900	610	-290	0.11	0.68	1	1	0
0011	3F	4_3	236	9	3	900	1830	930	0.33	2.03	1	3	2
0011	3F	4_3	245	12	0	1200	0	-1200	0.00	0.00	2	0	-2
0011	3F	4_3	246	8	2	800	590	-210	0.25	0.74	1	1	0
0011	3F	4_3	256	6	0	600	0	-600	0.00	0.00	1	0	-1
0011	3F	4_4	123	127	33	12700	12350	-350	0.26	0.97	22	21	-1
0011	3F	4_4	124	89	19	8900	9470	570	0.21	1.06	15	16	1
0011	3F	4_4	125	64	7	6400	6220	-180	0.11	0.97	11	11	0
0011	3F	4_4	126	39	6	3900	5530	1630	0.15	1.42	6	9	3
0011	3F	4_4	134	71	8	7100	3180	-3920	0.11	0.45	12	5	-7
0011	3F	4_4	135	48	8	4800	2980	-1820	0.17	0.62	8	5	-3
0011	3F	4_4	136	34	3	3400	1860	-1540	0.09	0.55	6	3	-3
0011	3F	4_4	145	23	3	2300	2140	-160	0.13	0.93	4	3	-1
0011	3F	4_4	146	17	0	1700	0	-1700	0.00	0.00	3	0	-3
0011	3F	4_4	156	11	0	1100	0	-1100	0.00	0.00	1	0	-1
0011	3F	4_4	234	15	2	1500	390	-1110	0.13	0.26	2	0	-2
0011	3F	4_4	235	6	1	600	1060	460	0.17	1.77	1	1	0
0011	3F	4_4	236	5	0	500	0	-500	0.00	0.00	0	0	0
0011	3F	4_4	246	9	1	900	1440	540	0.11	1.60	1	2	1
0011	3F	4_4	256	2	0	200	0	-200	0.00	0.00	0	0	0
0011	3F	4_5	123	146	31	14600	11200	-3400	0.21	0.77	25	19	-6
0011	3F	4_5	124	102	28	10200	9380	-820	0.27	0.92	18	16	-2
0011	3F	4_5	125	64	14	6400	3950	-2450	0.22	0.62	11	6	-5
0011	3F	4_5	126	52	6	5200	2660	-2540	0.12	0.51	9	4	-5
0011	3F	4_5	134	65	12	6500	4800	-1700	0.18	0.74	11	8	-3
0011	3F	4_5	135	35	2	3500	1030	-2470	0.06	0.29	6	1	-5
0011	3F	4_5	136	27	3	2700	850	-1850	0.11	0.31	4	1	-3
0011	3F	4_5	145	22	0	2200	0	-2200	0.00	0.00	3	0	-3
0011	3F	4_5	146	16	1	1600	350	-1250	0.06	0.22	2	0	-2
0011	3F	4_5	156	11	1	1100	1320	220	0.09	1.20	1	2	1
0011	3F	4_5	234	9	0	900	0	-900	0.00	0.00	1	0	-1
0011	3F	4_5	235	12	1	1200	400	-800	0.08	0.33	2	0	-2
0011	3F	4_5	236	4	0	400	0	-400	0.00	0.00	0	0	0
0011	3F	4_5	245	6	1	600	320	-280	0.17	0.53	1	0	-1
0011	3F	4_5	246	1	0	100	0	-100	0.00	0.00	0	0	0
0011	3F	4_5	256	5	0	500	0	-500	0.00	0.00	0	0	0
0011	3F	4_6	123	126	29	12600	12460	-140	0.23	0.99	22	22	0
0011	3F	4_6	124	95	20	9500	9440	-60	0.21	0.99	16	16	0
0011	3F	4_6	125	48	9	4800	4340	-460	0.19	0.90	8	7	-1
0011	3F	4_6	126	48	13	4800	8010	3210	0.27	1.67	8	14	6
0011	3F	4_6	134	44	8	4400	6020	1620	0.18	1.37	7	10	3
0011	3F	4_6	135	45	6	4500	5480	980	0.13	1.22	7	9	2
0011	3F	4_6	136	25	4	2500	5160	2660	0.16	2.06	4	9	5
0011	3F	4_6	145	19	5	1900	3350	1450	0.26	1.76	3	5	2
0011	3F	4_6	146	10	0	1000	0	-1000	0.00	0.00	1	0	-1
0011	3F	4_6	156	4	0	400	0	-400	0.00	0.00	0	0	0
0011	3F	4_6	234	7	1	700	340	-360	0.14	0.49	1	0	-1
0011	3F	4_6	235	15	3	1500	860	-640	0.20	0.57	2	1	-1
0011	3F	4_6	236	5	1	500	1070	570	0.20	2.14	0	1	1
0011	3F	4_6	245	4	1	400	370	-30	0.25	0.93	0	0	0
0011	3F	4_6	246	4	0	400	0	-400	0.00	0.00	0	0	0
0011	3F	4_6	256	1	0	100	0	-100	0.00	0.00	0	0	0
0011	3F	4_7	123	114	21	11400	6860	-4540	0.18	0.60	20	12	-8
0011	3F	4_7	124	88	13	8800	4260	-4540	0.15	0.48	15	7	-8
0011	3F	4_7	125	50	9	5000	2780	-2220	0.18	0.56	8	4	-4
0011	3F	4_7	126	34	3	3400	910	-2490	0.09	0.27	6	1	-5
0011	3F	4_7	134	82	17	8200	5930	-2270	0.21	0.72	14	10	-4
0011	3F	4_7	135	42	3	4200	1360	-2840	0.07	0.32	7	2	-5
0011	3F	4_7	136	21	0	2100	0	-2100	0.00	0.00	3	0	-3
0011	3F	4_7	145	33	3	3300	2730	-570	0.09	0.83	5	4	-1
0011	3F	4_7	146	15	2	1500	710	-790	0.13	0.47	2	1	-1
0011	3F	4_7	156	14	2	1400	770	-630	0.14	0.55	2	1	-1
0011	3F	4_7	234	4	0	400	0	-400	0.00	0.00	0	0	0
0011	3F	4_7	235	9	0	900	0	-900	0.00	0.00	1	0	-1
0011	3F	4_7	236	6	1	600	2080	1480	0.17	3.47	1	3	2
0011	3F	4_7	245	4	0	400	0	-400	0.00	0.00	0	0	0
0011	3F	4_7	246	3	0	300	0	-300	0.00	0.00	0	0	0
0011	3F	4_7	256	4	1	400	760	360	0.25	1.90	0	1	1
0011	3F	4_8	123	134	29	13400	10890	-2510	0.22	0.81	23	19	-4
0011	3F	4_8	124	96	12	9600	6090	-3510	0.13	0.63	16	10	-6
0011	3F	4_8	125	62	8	6200	4860	-1340	0.13	0.78	10	8	-2
0011	3F	4_8	126	49	4	4900	1230	-3670	0.08	0.25	8	2	-6
0011	3F	4_8	134	50	11	5000	4090	-910	0.22	0.82	8	7	-1
0011	3F	4_8	135	45	6	4500	2800	-1700	0.13	0.62	7	4	-3
0011	3F	4_8	136	30	3	3000	2600	-400	0.10	0.87	5	4	-1
0011	3F	4_8	145	28	3	2800	1150	-1650	0.11	0.41	4	2	-2
0011	3F	4_8	146	21	4	2100	4560	2460	0.19	2.17	3	8	5
0011	3F	4_8	156	9	0	900	0	-900	0.00	0.00	1	0	-1
0011	3F	4_8	234	12	2	1200	450	-750	0.17	0.38	2	0	-2
0011	3F	4_8	235	1	0	100	0	-100	0.00	0.00	0	0	0
0011	3F	4_8	236	5	1	500	2220	1720	0.20	4.44	0	3	3
0011	3F	4_8	245	3	0	300	0	-300	0.00	0.00	0	0	0
0011	3F	4_8	246	1	0	100	0	-100	0.00	0.00	0	0	0
0011	3F	4_8	256	3	0	300	0	-300	0.00	0.00	0	0	0
0011	3F	4_9	123	149	47	14900	15920	1020	0.32	1.07	26	28	2
0011	3F	4_9	124	111	25	11100	7370	-3730	0.23	0.66	19	13	-6
0011	3F	4_9	125	73	14	7300	10550	3250	0.19	1.45	12	18	6
0011	3F	4_9	126	41	5	4100	2900	-1200	0.12	0.71	7	5	-2
0011	3F	4_9	134	59	12	5900	10820	4920	0.20	1.83	10	19	9
0011	3F	4_9	135	52	5	5200	1580	-3620	0.10	0.30	9	2	-7
0011	3F	4_9	136	35	8	3500	11470	7970	0.23	3.28	6	20	14
0011	3F	4_9	145	30	3	3000	1510	-1490	0.10	0.50	5	2	-3
0011	3F	4_9	146	12	2	1200	2270	1070	0.17	1.89	2	4	2
0011	3F	4_9	156	2	0	200	0	-200	0.00	0.00	0	0	0
0011	3F	4_9	234	4	0	400	0	-400	0.00	0.00	0	0	0
0011	3F	4_9	235	6	3	600	1800	1200	0.50	3.00	1	3	2
0011	3F	4_9	236	1	0	100	0	-100	0.00	0.00	0	0	0
0011	3F	4_9	245	3	0	300	0	-300	0.00	0.00	0	0	0
0011	3F	4_9	246	1	0	100	0	-100	0.00	0.00	0	0	0
0011	3F	4_9	256	2	0	200	0	-200	0.00	0.00	0	0	0
0011	3F	5_1	123	105	18	10500	7170	-3330	0.17	0.68	18	12	-6
0011	3F	5_1	124	86	18	8600	7020	-1580	0.21	0.82	15	12	-3
0011	3F	5_1	125	51	6	5100	4630	-470	0.12	0.91	9	8	-1
0011	3F	5_1	126	17	2	1700	890	-810	0.12	0.52	3	1	-2
0011	3F	5_1	134	64	7	6400	5070	-1330	0.11	0.79	11	8	-3
0011	3F	5_1	135	42	2	4200	3730	-470	0.05	0.89	7	6	-1
0011	3F	5_1	136	15	1	1500	990	-510	0.07	0.66	2	1	-1
0011	3F	5_1	145	23	3	2300	1600	-700	0.13	0.70	4	2	-2
0011	3F	5_1	146	11	1	1100	1960	860	0.09	1.78	1	3	2
0011	3F	5_1	156	5	0	500	0	-500	0.00	0.00	0	0	0
0011	3F	5_1	234	6	1	600	380	-220	0.17	0.63	1	0	-1
0011	3F	5_1	235	4	0	400	0	-400	0.00	0.00	0	0	0
0011	3F	5_1	236	1	0	100	0	-100	0.00	0.00	0	0	0
0011	3F	5_1	245	2	0	200	0	-200	0.00	0.00	0	0	0
0011	3F	5_1	246	2	0	200	0	-200	0.00	0.00	0	0	0
0011	3F	5_1	256	2	0	200	0	-200	0.00	0.00	0	0	0
0011	3F	5_10	123	150	46	15000	13140	-1860	0.31	0.88	26	23	-3
0011	3F	5_10	124	109	26	10900	11200	300	0.24	1.03	19	19	0
0011	3F	5_10	125	51	3	5100	1840	-3260	0.06	0.36	9	3	-6
0011	3F	5_10	126	55	4	5500	3380	-2120	0.07	0.61	9	5	-4
0011	3F	5_10	134	54	13	5400	7820	2420	0.24	1.45	9	13	4
0011	3F	5_10	135	37	4	3700	4140	440	0.11	1.12	6	7	1
0011	3F	5_10	136	23	1	2300	1580	-720	0.04	0.69	4	2	-2
0011	3F	5_10	145	22	1	2200	620	-1580	0.05	0.28	3	1	-2
0011	3F	5_10	146	11	0	1100	0	-1100	0.00	0.00	1	0	-1
0011	3F	5_10	156	7	0	700	0	-700	0.00	0.00	1	0	-1
0011	3F	5_10	234	5	1	500	830	330	0.20	1.66	0	1	1
0011	3F	5_10	245	1	0	100	0	-100	0.00	0.00	0	0	0
0011	3F	5_10	256	1	1	100	2040	1940	1.00	20.40	0	3	3
0011	3F	5_11	123	147	51	14700	13080	-1620	0.35	0.89	26	23	-3
0011	3F	5_11	124	134	22	13400	8640	-4760	0.16	0.64	23	15	-8
0011	3F	5_11	125	70	6	7000	4670	-2330	0.09	0.67	12	8	-4
0011	3F	5_11	126	40	6	4000	10210	6210	0.15	2.55	7	18	11
0011	3F	5_11	134	73	12	7300	6730	-570	0.16	0.92	12	11	-1
0011	3F	5_11	135	38	5	3800	5520	1720	0.13	1.45	6	9	3
0011	3F	5_11	136	17	0	1700	0	-1700	0.00	0.00	3	0	-3
0011	3F	5_11	145	19	0	1900	0	-1900	0.00	0.00	3	0	-3
0011	3F	5_11	146	9	0	900	0	-900	0.00	0.00	1	0	-1
0011	3F	5_11	156	3	0	300	0	-300	0.00	0.00	0	0	0
0011	3F	5_11	234	2	0	200	0	-200	0.00	0.00	0	0	0
0011	3F	5_11	236	2	0	200	0	-200	0.00	0.00	0	0	0
0011	3F	5_11	245	1	0	100	0	-100	0.00	0.00	0	0	0
0011	3F	5_12	123	143	38	14300	10760	-3540	0.27	0.75	25	19	-6
0011	3F	5_12	124	129	26	12900	11420	-1480	0.20	0.89	22	20	-2
0011	3F	5_12	125	50	5	5000	4950	-50	0.10	0.99	8	8	0
0011	3F	5_12	126	32	3	3200	1500	-1700	0.09	0.47	5	2	-3
0011	3F	5_12	134	78	11	7800	7230	-570	0.14	0.93	13	12	-1
0011	3F	5_12	135	38	3	3800	1580	-2220	0.08	0.42	6	2	-4
0011	3F	5_12	136	20	1	2000	1330	-670	0.05	0.67	3	2	-1
0011	3F	5_12	145	24	2	2400	2000	-400	0.08	0.83	4	3	-1
0011	3F	5_12	146	14	1	1400	1250	-150	0.07	0.89	2	2	0
0011	3F	5_12	156	2	1	200	460	260	0.50	2.30	0	0	0
0011	3F	5_12	234	2	1	200	2400	2200	0.50	12.00	0	4	4
0011	3F	5_12	235	1	0	100	0	-100	0.00	0.00	0	0	0
0011	3F	5_12	246	2	0	200	0	-200	0.00	0.00	0	0	0
0011	3F	5_2	123	91	16	9100	6740	-2360	0.18	0.74	16	11	-5
0011	3F	5_2	124	75	12	7500	6910	-590	0.16	0.92	13	12	-1
0011	3F	5_2	125	52	5	5200	1040	-4160	0.10	0.20	9	1	-8
0011	3F	5_2	126	27	3	2700	1480	-1220	0.11	0.55	4	2	-2
0011	3F	5_2	134	56	5	5600	2230	-3370	0.09	0.40	9	3	-6
0011	3F	5_2	135	21	3	2100	950	-1150	0.14	0.45	3	1	-2
0011	3F	5_2	136	19	2	1900	2950	1050	0.11	1.55	3	5	2
0011	3F	5_2	145	20	4	2000	11820	9820	0.20	5.91	3	20	17
0011	3F	5_2	146	11	0	1100	0	-1100	0.00	0.00	1	0	-1
0011	3F	5_2	156	10	1	1000	280	-720	0.10	0.28	1	0	-1
0011	3F	5_2	234	6	2	600	910	310	0.33	1.52	1	1	0
0011	3F	5_2	235	5	1	500	390	-110	0.20	0.78	0	0	0
0011	3F	5_2	236	4	0	400	0	-400	0.00	0.00	0	0	0
0011	3F	5_2	245	1	0	100	0	-100	0.00	0.00	0	0	0
0011	3F	5_2	246	1	0	100	0	-100	0.00	0.00	0	0	0
0011	3F	5_2	256	2	0	200	0	-200	0.00	0.00	0	0	0
0011	3F	5_3	123	103	23	10300	14170	3870	0.22	1.38	18	25	7
0011	3F	5_3	124	84	14	8400	7900	-500	0.17	0.94	14	13	-1
0011	3F	5_3	125	38	4	3800	2710	-1090	0.11	0.71	6	4	-2
0011	3F	5_3	126	30	6	3000	4990	1990	0.20	1.66	5	8	3
0011	3F	5_3	134	58	12	5800	7690	1890	0.21	1.33	10	13	3
0011	3F	5_3	135	33	3	3300	1160	-2140	0.09	0.35	5	2	-3
0011	3F	5_3	136	25	2	2500	630	-1870	0.08	0.25	4	1	-3
0011	3F	5_3	145	17	0	1700	0	-1700	0.00	0.00	3	0	-3
0011	3F	5_3	146	12	2	1200	2480	1280	0.17	2.07	2	4	2
0011	3F	5_3	156	5	1	500	470	-30	0.20	0.94	0	0	0
0011	3F	5_3	234	4	0	400	0	-400	0.00	0.00	0	0	0
0011	3F	5_3	235	5	1	500	760	260	0.20	1.52	0	1	1
0011	3F	5_3	236	5	0	500	0	-500	0.00	0.00	0	0	0
0011	3F	5_3	245	9	0	900	0	-900	0.00	0.00	1	0	-1
0011	3F	5_3	246	2	0	200	0	-200	0.00	0.00	0	0	0
0011	3F	5_3	256	2	0	200	0	-200	0.00	0.00	0	0	0
0011	3F	5_4	123	94	22	9400	8830	-570	0.23	0.94	16	15	-1
0011	3F	5_4	124	69	11	6900	5410	-1490	0.16	0.78	12	9	-3
0011	3F	5_4	125	45	5	4500	7040	2540	0.11	1.56	7	12	5
0011	3F	5_4	126	36	2	3600	1430	-2170	0.06	0.40	6	2	-4
0011	3F	5_4	134	58	8	5800	2980	-2820	0.14	0.51	10	5	-5
0011	3F	5_4	135	35	6	3500	3310	-190	0.17	0.95	6	5	-1
0011	3F	5_4	136	21	1	2100	140	-1960	0.05	0.07	3	0	-3
0011	3F	5_4	145	30	3	3000	2440	-560	0.10	0.81	5	4	-1
0011	3F	5_4	146	14	0	1400	0	-1400	0.00	0.00	2	0	-2
0011	3F	5_4	156	3	0	300	0	-300	0.00	0.00	0	0	0
0011	3F	5_4	234	3	0	300	0	-300	0.00	0.00	0	0	0
0011	3F	5_4	235	4	0	400	0	-400	0.00	0.00	0	0	0
0011	3F	5_4	236	1	0	100	0	-100	0.00	0.00	0	0	0
0011	3F	5_4	245	3	0	300	0	-300	0.00	0.00	0	0	0
0011	3F	5_4	246	2	0	200	0	-200	0.00	0.00	0	0	0
0011	3F	5_5	123	117	28	11700	13910	2210	0.24	1.19	20	24	4
0011	3F	5_5	124	71	17	7100	5540	-1560	0.24	0.78	12	9	-3
0011	3F	5_5	125	48	7	4800	5120	320	0.15	1.07	8	9	1
0011	3F	5_5	126	29	3	2900	7910	5010	0.10	2.73	5	14	9
0011	3F	5_5	134	74	7	7400	3100	-4300	0.09	0.42	13	5	-8
0011	3F	5_5	135	23	1	2300	320	-1980	0.04	0.14	4	0	-4
0011	3F	5_5	136	26	4	2600	2190	-410	0.15	0.84	4	3	-1
0011	3F	5_5	145	13	1	1300	290	-1010	0.08	0.22	2	0	-2
0011	3F	5_5	146	9	1	900	770	-130	0.11	0.86	1	1	0
0011	3F	5_5	156	15	1	1500	540	-960	0.07	0.36	2	0	-2
0011	3F	5_5	234	4	0	400	0	-400	0.00	0.00	0	0	0
0011	3F	5_5	235	4	1	400	240	-160	0.25	0.60	0	0	0
0011	3F	5_5	236	1	0	100	0	-100	0.00	0.00	0	0	0
0011	3F	5_5	245	2	0	200	0	-200	0.00	0.00	0	0	0
0011	3F	5_5	246	1	0	100	0	-100	0.00	0.00	0	0	0
0011	3F	5_5	256	2	0	200	0	-200	0.00	0.00	0	0	0
0011	3F	5_6	123	91	24	9100	9120	20	0.26	1.00	16	16	0
0011	3F	5_6	124	86	17	8600	6560	-2040	0.20	0.76	15	11	-4
0011	3F	5_6	125	47	4	4700	3280	-1420	0.09	0.70	8	5	-3
0011	3F	5_6	126	25	3	2500	3810	1310	0.12	1.52	4	6	2
0011	3F	5_6	134	49	6	4900	1850	-3050	0.12	0.38	8	3	-5
0011	3F	5_6	135	40	4	4000	3130	-870	0.10	0.78	7	5	-2
0011	3F	5_6	136	24	4	2400	1950	-450	0.17	0.81	4	3	-1
0011	3F	5_6	145	23	2	2300	1710	-590	0.09	0.74	4	3	-1
0011	3F	5_6	146	16	2	1600	690	-910	0.13	0.43	2	1	-1
0011	3F	5_6	156	5	2	500	1050	550	0.40	2.10	0	1	1
0011	3F	5_6	234	8	0	800	0	-800	0.00	0.00	1	0	-1
0011	3F	5_6	235	4	0	400	0	-400	0.00	0.00	0	0	0
0011	3F	5_6	236	4	2	400	3470	3070	0.50	8.68	0	6	6
0011	3F	5_6	245	3	0	300	0	-300	0.00	0.00	0	0	0
0011	3F	5_6	246	3	0	300	0	-300	0.00	0.00	0	0	0
0011	3F	5_6	256	3	0	300	0	-300	0.00	0.00	0	0	0
0011	3F	5_7	123	104	12	10400	6190	-4210	0.12	0.60	18	10	-8
0011	3F	5_7	124	97	17	9700	6920	-2780	0.18	0.71	17	12	-5
0011	3F	5_7	125	43	3	4300	1090	-3210	0.07	0.25	7	1	-6
0011	3F	5_7	126	23	2	2300	750	-1550	0.09	0.33	4	1	-3
0011	3F	5_7	134	61	9	6100	2190	-3910	0.15	0.36	10	3	-7
0011	3F	5_7	135	39	6	3900	2500	-1400	0.15	0.64	6	4	-2
0011	3F	5_7	136	21	1	2100	850	-1250	0.05	0.40	3	1	-2
0011	3F	5_7	145	23	0	2300	0	-2300	0.00	0.00	4	0	-4
0011	3F	5_7	146	14	2	1400	630	-770	0.14	0.45	2	1	-1
0011	3F	5_7	156	7	1	700	400	-300	0.14	0.57	1	0	-1
0011	3F	5_7	234	3	0	300	0	-300	0.00	0.00	0	0	0
0011	3F	5_7	235	4	1	400	1380	980	0.25	3.45	0	2	2
0011	3F	5_7	236	1	0	100	0	-100	0.00	0.00	0	0	0
0011	3F	5_7	245	3	0	300	0	-300	0.00	0.00	0	0	0
0011	3F	5_7	246	1	0	100	0	-100	0.00	0.00	0	0	0
0011	3F	5_8	123	103	20	10300	6530	-3770	0.19	0.63	18	11	-7
0011	3F	5_8	124	96	24	9600	8080	-1520	0.25	0.84	16	14	-2
0011	3F	5_8	125	51	9	5100	4360	-740	0.18	0.85	9	7	-2
0011	3F	5_8	126	28	4	2800	4900	2100	0.14	1.75	4	8	4
0011	3F	5_8	134	44	5	4400	2340	-2060	0.11	0.53	7	4	-3
0011	3F	5_8	135	33	5	3300	2270	-1030	0.15	0.69	5	4	-1
0011	3F	5_8	136	23	5	2300	2830	530	0.22	1.23	4	5	1
0011	3F	5_8	145	27	2	2700	920	-1780	0.07	0.34	4	1	-3
0011	3F	5_8	146	15	2	1500	690	-810	0.13	0.46	2	1	-1
0011	3F	5_8	156	5	0	500	0	-500	0.00	0.00	0	0	0
0011	3F	5_8	234	2	1	200	290	90	0.50	1.45	0	0	0
0011	3F	5_8	235	4	0	400	0	-400	0.00	0.00	0	0	0
0011	3F	5_8	236	5	0	500	0	-500	0.00	0.00	0	0	0
0011	3F	5_8	245	1	0	100	0	-100	0.00	0.00	0	0	0
0011	3F	5_8	246	1	0	100	0	-100	0.00	0.00	0	0	0
0011	3F	5_9	123	111	24	11100	10110	-990	0.22	0.91	19	17	-2
0011	3F	5_9	124	108	16	10800	9050	-1750	0.15	0.84	19	16	-3
0011	3F	5_9	125	59	7	5900	6070	170	0.12	1.03	10	10	0
0011	3F	5_9	126	34	2	3400	700	-2700	0.06	0.21	6	1	-5
0011	3F	5_9	134	72	11	7200	6890	-310	0.15	0.96	12	12	0
0011	3F	5_9	135	35	2	3500	1570	-1930	0.06	0.45	6	2	-4
0011	3F	5_9	136	18	0	1800	0	-1800	0.00	0.00	3	0	-3
0011	3F	5_9	145	31	3	3100	1310	-1790	0.10	0.42	5	2	-3
0011	3F	5_9	146	16	3	1600	2020	420	0.19	1.26	2	3	1
0011	3F	5_9	156	6	1	600	1170	570	0.17	1.95	1	2	1
0011	3F	5_9	234	4	0	400	0	-400	0.00	0.00	0	0	0
0011	3F	5_9	235	1	0	100	0	-100	0.00	0.00	0	0	0
0011	3F	5_9	236	1	0	100	0	-100	0.00	0.00	0	0	0
0011	3F	5_9	245	1	0	100	0	-100	0.00	0.00	0	0	0
0011	3F	5_9	256	1	0	100	0	-100	0.00	0.00	0	0	0
0011	3F	6_1	123	8	3	800	1080	280	0.38	1.35	1	1	0
0011	3F	6_1	124	6	1	600	150	-450	0.17	0.25	1	0	-1
0011	3F	6_1	125	3	1	300	390	90	0.33	1.30	0	0	0
0011	3F	6_1	126	3	0	300	0	-300	0.00	0.00	0	0	0
0011	3F	6_1	134	5	2	500	660	160	0.40	1.32	0	1	1
0011	3F	6_1	135	1	0	100	0	-100	0.00	0.00	0	0	0
0011	3F	6_1	136	3	2	300	910	610	0.67	3.03	0	1	1
0011	3F	6_1	145	2	0	200	0	-200	0.00	0.00	0	0	0
0011	3F	6_1	146	1	0	100	0	-100	0.00	0.00	0	0	0
0011	3F	6_1	156	1	0	100	0	-100	0.00	0.00	0	0	0
0011	3F	6_1	236	1	0	100	0	-100	0.00	0.00	0	0	0
0011	3F	6_10	123	12	3	1200	850	-350	0.25	0.71	2	1	-1
0011	3F	6_10	124	6	1	600	210	-390	0.17	0.35	1	0	-1
0011	3F	6_10	125	6	1	600	780	180	0.17	1.30	1	1	0
0011	3F	6_10	126	3	0	300	0	-300	0.00	0.00	0	0	0
0011	3F	6_10	134	2	0	200	0	-200	0.00	0.00	0	0	0
0011	3F	6_10	135	2	0	200	0	-200	0.00	0.00	0	0	0
0011	3F	6_10	136	2	0	200	0	-200	0.00	0.00	0	0	0
0011	3F	6_10	145	3	0	300	0	-300	0.00	0.00	0	0	0
0011	3F	6_10	146	1	0	100	0	-100	0.00	0.00	0	0	0
0011	3F	6_10	156	1	0	100	0	-100	0.00	0.00	0	0	0
0011	3F	6_11	123	10	1	1000	260	-740	0.10	0.26	1	0	-1
0011	3F	6_11	124	11	2	1100	690	-410	0.18	0.63	1	1	0
0011	3F	6_11	125	5	3	500	1980	1480	0.60	3.96	0	3	3
0011	3F	6_11	126	3	0	300	0	-300	0.00	0.00	0	0	0
0011	3F	6_11	134	5	0	500	0	-500	0.00	0.00	0	0	0
0011	3F	6_11	135	2	0	200	0	-200	0.00	0.00	0	0	0
0011	3F	6_11	136	3	0	300	0	-300	0.00	0.00	0	0	0
0011	3F	6_11	145	1	0	100	0	-100	0.00	0.00	0	0	0
0011	3F	6_11	146	2	0	200	0	-200	0.00	0.00	0	0	0
0011	3F	6_11	156	1	0	100	0	-100	0.00	0.00	0	0	0
0011	3F	6_11	246	1	0	100	0	-100	0.00	0.00	0	0	0
0011	3F	6_12	123	12	1	1200	390	-810	0.08	0.33	2	0	-2
0011	3F	6_12	124	16	4	1600	1660	60	0.25	1.04	2	2	0
0011	3F	6_12	125	4	1	400	450	50	0.25	1.13	0	0	0
0011	3F	6_12	126	5	1	500	710	210	0.20	1.42	0	1	1
0011	3F	6_12	134	4	0	400	0	-400	0.00	0.00	0	0	0
0011	3F	6_12	135	2	0	200	0	-200	0.00	0.00	0	0	0
0011	3F	6_12	136	1	0	100	0	-100	0.00	0.00	0	0	0
0011	3F	6_12	145	4	0	400	0	-400	0.00	0.00	0	0	0
0011	3F	6_12	156	1	0	100	0	-100	0.00	0.00	0	0	0
0011	3F	6_2	123	5	2	500	750	250	0.40	1.50	0	1	1
0011	3F	6_2	124	9	1	900	1900	1000	0.11	2.11	1	3	2
0011	3F	6_2	125	1	0	100	0	-100	0.00	0.00	0	0	0
0011	3F	6_2	134	3	1	300	140	-160	0.33	0.47	0	0	0
0011	3F	6_2	135	2	0	200	0	-200	0.00	0.00	0	0	0
0011	3F	6_2	136	2	0	200	0	-200	0.00	0.00	0	0	0
0011	3F	6_2	145	4	0	400	0	-400	0.00	0.00	0	0	0
0011	3F	6_2	146	2	0	200	0	-200	0.00	0.00	0	0	0
0011	3F	6_2	236	1	1	100	240	140	1.00	2.40	0	0	0
0011	3F	6_3	123	8	0	800	0	-800	0.00	0.00	1	0	-1
0011	3F	6_3	124	6	1	600	320	-280	0.17	0.53	1	0	-1
0011	3F	6_3	125	5	1	500	1110	610	0.20	2.22	0	1	1
0011	3F	6_3	126	2	0	200	0	-200	0.00	0.00	0	0	0
0011	3F	6_3	134	4	0	400	0	-400	0.00	0.00	0	0	0
0011	3F	6_3	135	2	0	200	0	-200	0.00	0.00	0	0	0
0011	3F	6_3	145	2	0	200	0	-200	0.00	0.00	0	0	0
0011	3F	6_3	146	2	0	200	0	-200	0.00	0.00	0	0	0
0011	3F	6_3	256	1	0	100	0	-100	0.00	0.00	0	0	0
0011	3F	6_4	123	11	1	1100	520	-580	0.09	0.47	1	0	-1
0011	3F	6_4	124	6	0	600	0	-600	0.00	0.00	1	0	-1
0011	3F	6_4	125	4	1	400	560	160	0.25	1.40	0	0	0
0011	3F	6_4	126	2	1	200	490	290	0.50	2.45	0	0	0
0011	3F	6_4	134	2	0	200	0	-200	0.00	0.00	0	0	0
0011	3F	6_4	135	4	0	400	0	-400	0.00	0.00	0	0	0
0011	3F	6_4	136	2	1	200	780	580	0.50	3.90	0	1	1
0011	3F	6_4	145	3	0	300	0	-300	0.00	0.00	0	0	0
0011	3F	6_4	146	1	0	100	0	-100	0.00	0.00	0	0	0
0011	3F	6_5	123	7	1	700	820	120	0.14	1.17	1	1	0
0011	3F	6_5	124	10	2	1000	420	-580	0.20	0.42	1	0	-1
0011	3F	6_5	125	5	1	500	410	-90	0.20	0.82	0	0	0
0011	3F	6_5	134	5	1	500	280	-220	0.20	0.56	0	0	0
0011	3F	6_5	135	5	0	500	0	-500	0.00	0.00	0	0	0
0011	3F	6_5	136	1	0	100	0	-100	0.00	0.00	0	0	0
0011	3F	6_5	145	4	1	400	370	-30	0.25	0.93	0	0	0
0011	3F	6_5	146	1	0	100	0	-100	0.00	0.00	0	0	0
0011	3F	6_5	156	1	0	100	0	-100	0.00	0.00	0	0	0
0011	3F	6_6	123	6	0	600	0	-600	0.00	0.00	1	0	-1
0011	3F	6_6	124	4	1	400	320	-80	0.25	0.80	0	0	0
0011	3F	6_6	125	7	1	700	200	-500	0.14	0.29	1	0	-1
0011	3F	6_6	126	3	0	300	0	-300	0.00	0.00	0	0	0
0011	3F	6_6	134	5	2	500	720	220	0.40	1.44	0	1	1
0011	3F	6_6	135	2	0	200	0	-200	0.00	0.00	0	0	0
0011	3F	6_6	136	3	1	300	980	680	0.33	3.27	0	1	1
0011	3F	6_6	145	2	0	200	0	-200	0.00	0.00	0	0	0
0011	3F	6_6	146	4	0	400	0	-400	0.00	0.00	0	0	0
0011	3F	6_6	234	1	0	100	0	-100	0.00	0.00	0	0	0
0011	3F	6_7	123	7	2	700	520	-180	0.29	0.74	1	0	-1
0011	3F	6_7	124	4	2	400	470	70	0.50	1.18	0	0	0
0011	3F	6_7	125	1	0	100	0	-100	0.00	0.00	0	0	0
0011	3F	6_7	126	2	0	200	0	-200	0.00	0.00	0	0	0
0011	3F	6_7	134	3	1	300	430	130	0.33	1.43	0	0	0
0011	3F	6_7	135	2	0	200	0	-200	0.00	0.00	0	0	0
0011	3F	6_7	136	5	2	500	780	280	0.40	1.56	0	1	1
0011	3F	6_7	145	2	1	200	210	10	0.50	1.05	0	0	0
0011	3F	6_7	146	1	0	100	0	-100	0.00	0.00	0	0	0
0011	3F	6_7	156	1	1	100	250	150	1.00	2.50	0	0	0
0011	3F	6_7	234	1	0	100	0	-100	0.00	0.00	0	0	0
0011	3F	6_8	123	6	1	600	170	-430	0.17	0.28	1	0	-1
0011	3F	6_8	124	8	0	800	0	-800	0.00	0.00	1	0	-1
0011	3F	6_8	125	3	0	300	0	-300	0.00	0.00	0	0	0
0011	3F	6_8	134	5	0	500	0	-500	0.00	0.00	0	0	0
0011	3F	6_8	135	4	1	400	260	-140	0.25	0.65	0	0	0
0011	3F	6_8	136	4	1	400	1760	1360	0.25	4.40	0	3	3
0011	3F	6_8	145	1	0	100	0	-100	0.00	0.00	0	0	0
0011	3F	6_8	146	3	0	300	0	-300	0.00	0.00	0	0	0
0011	3F	6_9	123	9	2	900	600	-300	0.22	0.67	1	1	0
0011	3F	6_9	124	9	1	900	200	-700	0.11	0.22	1	0	-1
0011	3F	6_9	125	4	0	400	0	-400	0.00	0.00	0	0	0
0011	3F	6_9	126	5	0	500	0	-500	0.00	0.00	0	0	0
0011	3F	6_9	134	4	0	400	0	-400	0.00	0.00	0	0	0
0011	3F	6_9	135	2	0	200	0	-200	0.00	0.00	0	0	0
0011	3F	6_9	145	2	0	200	0	-200	0.00	0.00	0	0	0
0011	3F	6_9	146	2	0	200	0	-200	0.00	0.00	0	0	0
0011	3F	6_9	156	1	0	100	0	-100	0.00	0.00	0	0	0
0011	3F	6_9	234	1	0	100	0	-100	0.00	0.00	0	0	0
0011	3F	6_9	246	1	0	100	0	-100	0.00	0.00	0	0	0
0011	3F	7_1	123	193	50	19300	21570	2270	0.26	1.12	34	38	4
0011	3F	7_1	124	129	23	12900	12770	-130	0.18	0.99	22	22	0
0011	3F	7_1	125	70	7	7000	3140	-3860	0.10	0.45	12	5	-7
0011	3F	7_1	126	36	3	3600	1410	-2190	0.08	0.39	6	2	-4
0011	3F	7_1	134	107	19	10700	9230	-1470	0.18	0.86	18	16	-2
0011	3F	7_1	135	62	7	6200	4730	-1470	0.11	0.76	10	8	-2
0011	3F	7_1	136	30	1	3000	4330	1330	0.03	1.44	5	7	2
0011	3F	7_1	145	22	2	2200	880	-1320	0.09	0.40	3	1	-2
0011	3F	7_1	146	10	0	1000	0	-1000	0.00	0.00	1	0	-1
0011	3F	7_1	156	8	0	800	0	-800	0.00	0.00	1	0	-1
0011	3F	7_1	234	8	2	800	840	40	0.25	1.05	1	1	0
0011	3F	7_1	235	11	3	1100	3690	2590	0.27	3.35	1	6	5
0011	3F	7_1	236	6	0	600	0	-600	0.00	0.00	1	0	-1
0011	3F	7_1	245	7	0	700	0	-700	0.00	0.00	1	0	-1
0011	3F	7_1	256	1	0	100	0	-100	0.00	0.00	0	0	0
0011	3F	7_10	123	192	51	19200	18030	-1170	0.27	0.94	33	31	-2
0011	3F	7_10	124	175	35	17500	15750	-1750	0.20	0.90	30	27	-3
0011	3F	7_10	125	88	12	8800	10550	1750	0.14	1.20	15	18	3
0011	3F	7_10	126	60	3	6000	2790	-3210	0.05	0.47	10	4	-6
0011	3F	7_10	134	91	11	9100	6890	-2210	0.12	0.76	16	12	-4
0011	3F	7_10	135	50	8	5000	6940	1940	0.16	1.39	8	12	4
0011	3F	7_10	136	26	0	2600	0	-2600	0.00	0.00	4	0	-4
0011	3F	7_10	145	42	2	4200	1350	-2850	0.05	0.32	7	2	-5
0011	3F	7_10	146	27	1	2700	1420	-1280	0.04	0.53	4	2	-2
0011	3F	7_10	156	10	1	1000	2340	1340	0.10	2.34	1	4	3
0011	3F	7_10	234	11	0	1100	0	-1100	0.00	0.00	1	0	-1
0011	3F	7_10	235	2	0	200	0	-200	0.00	0.00	0	0	0
0011	3F	7_10	236	2	0	200	0	-200	0.00	0.00	0	0	0
0011	3F	7_10	245	2	2	200	1960	1760	1.00	9.80	0	3	3
0011	3F	7_10	246	1	0	100	0	-100	0.00	0.00	0	0	0
0011	3F	7_10	256	2	0	200	0	-200	0.00	0.00	0	0	0
0011	3F	7_11	123	205	54	20500	18860	-1640	0.26	0.92	36	33	-3
0011	3F	7_11	124	212	44	21200	18520	-2680	0.21	0.87	37	32	-5
0011	3F	7_11	125	91	13	9100	9490	390	0.14	1.04	16	16	0
0011	3F	7_11	126	58	6	5800	5700	-100	0.10	0.98	10	10	0
0011	3F	7_11	134	98	14	9800	9660	-140	0.14	0.99	17	17	0
0011	3F	7_11	135	62	8	6200	8860	2660	0.13	1.43	10	15	5
0011	3F	7_11	136	42	1	4200	750	-3450	0.02	0.18	7	1	-6
0011	3F	7_11	145	34	1	3400	1510	-1890	0.03	0.44	6	2	-4
0011	3F	7_11	146	19	0	1900	0	-1900	0.00	0.00	3	0	-3
0011	3F	7_11	156	9	0	900	0	-900	0.00	0.00	1	0	-1
0011	3F	7_11	234	2	0	200	0	-200	0.00	0.00	0	0	0
0011	3F	7_11	235	2	0	200	0	-200	0.00	0.00	0	0	0
0011	3F	7_11	236	2	0	200	0	-200	0.00	0.00	0	0	0
0011	3F	7_11	246	1	0	100	0	-100	0.00	0.00	0	0	0
0011	3F	7_11	256	1	0	100	0	-100	0.00	0.00	0	0	0
0011	3F	7_12	123	196	43	19600	18660	-940	0.22	0.95	34	33	-1
0011	3F	7_12	124	185	31	18500	12310	-6190	0.17	0.67	32	21	-11
0011	3F	7_12	125	89	8	8900	7760	-1140	0.09	0.87	15	13	-2
0011	3F	7_12	126	77	4	7700	5570	-2130	0.05	0.72	13	9	-4
0011	3F	7_12	134	105	26	10500	18740	8240	0.25	1.78	18	33	15
0011	3F	7_12	135	50	4	5000	3710	-1290	0.08	0.74	8	6	-2
0011	3F	7_12	136	41	2	4100	2470	-1630	0.05	0.60	7	4	-3
0011	3F	7_12	145	57	4	5700	5480	-220	0.07	0.96	10	9	-1
0011	3F	7_12	146	27	3	2700	4480	1780	0.11	1.66	4	7	3
0011	3F	7_12	156	9	0	900	0	-900	0.00	0.00	1	0	-1
0011	3F	7_12	234	4	0	400	0	-400	0.00	0.00	0	0	0
0011	3F	7_12	235	2	0	200	0	-200	0.00	0.00	0	0	0
0011	3F	7_12	236	1	0	100	0	-100	0.00	0.00	0	0	0
0011	3F	7_12	245	1	0	100	0	-100	0.00	0.00	0	0	0
0011	3F	7_12	256	1	0	100	0	-100	0.00	0.00	0	0	0
0011	3F	7_2	123	171	32	17100	12880	-4220	0.19	0.75	30	22	-8
0011	3F	7_2	124	124	20	12400	10290	-2110	0.16	0.83	21	18	-3
0011	3F	7_2	125	63	5	6300	2030	-4270	0.08	0.32	11	3	-8
0011	3F	7_2	126	34	6	3400	4580	1180	0.18	1.35	6	8	2
0011	3F	7_2	134	88	12	8800	6850	-1950	0.14	0.78	15	12	-3
0011	3F	7_2	135	49	4	4900	2570	-2330	0.08	0.52	8	4	-4
0011	3F	7_2	136	35	3	3500	6080	2580	0.09	1.74	6	10	4
0011	3F	7_2	145	27	4	2700	2060	-640	0.15	0.76	4	3	-1
0011	3F	7_2	146	18	2	1800	2330	530	0.11	1.29	3	4	1
0011	3F	7_2	156	7	0	700	0	-700	0.00	0.00	1	0	-1
0011	3F	7_2	234	11	1	1100	560	-540	0.09	0.51	1	0	-1
0011	3F	7_2	235	11	0	1100	0	-1100	0.00	0.00	1	0	-1
0011	3F	7_2	236	2	0	200	0	-200	0.00	0.00	0	0	0
0011	3F	7_2	245	6	1	600	440	-160	0.17	0.73	1	0	-1
0011	3F	7_2	246	5	0	500	0	-500	0.00	0.00	0	0	0
0011	3F	7_2	256	2	0	200	0	-200	0.00	0.00	0	0	0
0011	3F	7_3	123	183	32	18300	12820	-5480	0.17	0.70	32	22	-10
0011	3F	7_3	124	103	12	10300	7380	-2920	0.12	0.72	18	13	-5
0011	3F	7_3	125	80	12	8000	6660	-1340	0.15	0.83	14	11	-3
0011	3F	7_3	126	44	3	4400	1880	-2520	0.07	0.43	7	3	-4
0011	3F	7_3	134	77	15	7700	5820	-1880	0.19	0.76	13	10	-3
0011	3F	7_3	135	71	13	7100	15650	8550	0.18	2.20	12	27	15
0011	3F	7_3	136	39	1	3900	560	-3340	0.03	0.14	6	0	-6
0011	3F	7_3	145	38	3	3800	3540	-260	0.08	0.93	6	6	0
0011	3F	7_3	146	19	2	1900	1240	-660	0.11	0.65	3	2	-1
0011	3F	7_3	156	9	1	900	1880	980	0.11	2.09	1	3	2
0011	3F	7_3	234	17	0	1700	0	-1700	0.00	0.00	3	0	-3
0011	3F	7_3	235	5	0	500	0	-500	0.00	0.00	0	0	0
0011	3F	7_3	236	6	0	600	0	-600	0.00	0.00	1	0	-1
0011	3F	7_3	245	5	0	500	0	-500	0.00	0.00	0	0	0
0011	3F	7_3	246	2	0	200	0	-200	0.00	0.00	0	0	0
0011	3F	7_3	256	8	0	800	0	-800	0.00	0.00	1	0	-1
0011	3F	7_4	123	166	41	16600	15770	-830	0.25	0.95	29	27	-2
0011	3F	7_4	124	132	30	13200	12490	-710	0.23	0.95	23	22	-1
0011	3F	7_4	125	77	9	7700	5210	-2490	0.12	0.68	13	9	-4
0011	3F	7_4	126	55	8	5500	6080	580	0.15	1.11	9	10	1
0011	3F	7_4	134	99	14	9900	6850	-3050	0.14	0.69	17	12	-5
0011	3F	7_4	135	46	5	4600	4990	390	0.11	1.08	8	8	0
0011	3F	7_4	136	39	2	3900	2670	-1230	0.05	0.68	6	4	-2
0011	3F	7_4	145	35	2	3500	1710	-1790	0.06	0.49	6	3	-3
0011	3F	7_4	146	26	4	2600	5960	3360	0.15	2.29	4	10	6
0011	3F	7_4	156	18	4	1800	3050	1250	0.22	1.69	3	5	2
0011	3F	7_4	234	11	1	1100	520	-580	0.09	0.47	1	0	-1
0011	3F	7_4	235	7	0	700	0	-700	0.00	0.00	1	0	-1
0011	3F	7_4	236	6	0	600	0	-600	0.00	0.00	1	0	-1
0011	3F	7_4	245	3	0	300	0	-300	0.00	0.00	0	0	0
0011	3F	7_4	246	5	0	500	0	-500	0.00	0.00	0	0	0
0011	3F	7_5	123	184	46	18400	18320	-80	0.25	1.00	32	32	0
0011	3F	7_5	124	130	26	13000	10920	-2080	0.20	0.84	23	19	-4
0011	3F	7_5	125	66	15	6600	6640	40	0.23	1.01	11	11	0
0011	3F	7_5	126	57	9	5700	5970	270	0.16	1.05	10	10	0
0011	3F	7_5	134	88	20	8800	10890	2090	0.23	1.24	15	19	4
0011	3F	7_5	135	49	5	4900	2160	-2740	0.10	0.44	8	3	-5
0011	3F	7_5	136	43	5	4300	2960	-1340	0.12	0.69	7	5	-2
0011	3F	7_5	145	27	1	2700	840	-1860	0.04	0.31	4	1	-3
0011	3F	7_5	146	25	3	2500	3130	630	0.12	1.25	4	5	1
0011	3F	7_5	156	10	0	1000	0	-1000	0.00	0.00	1	0	-1
0011	3F	7_5	234	8	0	800	0	-800	0.00	0.00	1	0	-1
0011	3F	7_5	235	6	2	600	390	-210	0.33	0.65	1	0	-1
0011	3F	7_5	245	4	0	400	0	-400	0.00	0.00	0	0	0
0011	3F	7_5	246	4	0	400	0	-400	0.00	0.00	0	0	0
0011	3F	7_5	256	3	0	300	0	-300	0.00	0.00	0	0	0
0011	3F	7_6	123	181	42	18100	17820	-280	0.23	0.98	32	31	-1
0011	3F	7_6	124	122	30	12200	10490	-1710	0.25	0.86	21	18	-3
0011	3F	7_6	125	80	13	8000	4630	-3370	0.16	0.58	14	8	-6
0011	3F	7_6	126	54	7	5400	3450	-1950	0.13	0.64	9	6	-3
0011	3F	7_6	134	72	12	7200	4910	-2290	0.17	0.68	12	8	-4
0011	3F	7_6	135	46	5	4600	4660	60	0.11	1.01	8	8	0
0011	3F	7_6	136	44	4	4400	1510	-2890	0.09	0.34	7	2	-5
0011	3F	7_6	145	41	5	4100	6450	2350	0.12	1.57	7	11	4
0011	3F	7_6	146	13	2	1300	2810	1510	0.15	2.16	2	4	2
0011	3F	7_6	156	11	4	1100	3480	2380	0.36	3.16	1	6	5
0011	3F	7_6	234	6	1	600	350	-250	0.17	0.58	1	0	-1
0011	3F	7_6	235	8	0	800	0	-800	0.00	0.00	1	0	-1
0011	3F	7_6	236	6	1	600	3010	2410	0.17	5.02	1	5	4
0011	3F	7_6	245	6	0	600	0	-600	0.00	0.00	1	0	-1
0011	3F	7_6	246	5	0	500	0	-500	0.00	0.00	0	0	0
0011	3F	7_7	123	192	36	19200	12660	-6540	0.19	0.66	33	22	-11
0011	3F	7_7	124	111	19	11100	7200	-3900	0.17	0.65	19	12	-7
0011	3F	7_7	125	78	18	7800	11130	3330	0.23	1.43	13	19	6
0011	3F	7_7	126	56	10	5600	6550	950	0.18	1.17	9	11	2
0011	3F	7_7	134	95	14	9500	5660	-3840	0.15	0.60	16	10	-6
0011	3F	7_7	135	49	2	4900	1150	-3750	0.04	0.23	8	2	-6
0011	3F	7_7	136	37	8	3700	2420	-1280	0.22	0.65	6	4	-2
0011	3F	7_7	145	43	7	4300	4300	0	0.16	1.00	7	7	0
0011	3F	7_7	146	29	2	2900	1770	-1130	0.07	0.61	5	3	-2
0011	3F	7_7	156	16	1	1600	1840	240	0.06	1.15	2	3	1
0011	3F	7_7	235	2	0	200	0	-200	0.00	0.00	0	0	0
0011	3F	7_7	236	6	1	600	550	-50	0.17	0.92	1	0	-1
0011	3F	7_7	245	3	0	300	0	-300	0.00	0.00	0	0	0
0011	3F	7_7	246	2	0	200	0	-200	0.00	0.00	0	0	0
0011	3F	7_7	256	1	0	100	0	-100	0.00	0.00	0	0	0
0011	3F	7_8	123	169	29	16900	10830	-6070	0.17	0.64	29	19	-10
0011	3F	7_8	124	140	28	14000	10360	-3640	0.20	0.74	24	18	-6
0011	3F	7_8	125	69	9	6900	3590	-3310	0.13	0.52	12	6	-6
0011	3F	7_8	126	59	13	5900	13240	7340	0.22	2.24	10	23	13
0011	3F	7_8	134	104	19	10400	8920	-1480	0.18	0.86	18	15	-3
0011	3F	7_8	135	57	6	5700	6250	550	0.11	1.10	10	11	1
0011	3F	7_8	136	36	5	3600	2830	-770	0.14	0.79	6	5	-1
0011	3F	7_8	145	26	4	2600	2850	250	0.15	1.10	4	5	1
0011	3F	7_8	146	18	1	1800	1460	-340	0.06	0.81	3	2	-1
0011	3F	7_8	156	12	2	1200	3260	2060	0.17	2.72	2	5	3
0011	3F	7_8	234	6	0	600	0	-600	0.00	0.00	1	0	-1
0011	3F	7_8	235	6	1	600	630	30	0.17	1.05	1	1	0
0011	3F	7_8	236	1	0	100	0	-100	0.00	0.00	0	0	0
0011	3F	7_8	245	3	0	300	0	-300	0.00	0.00	0	0	0
0011	3F	7_8	246	1	0	100	0	-100	0.00	0.00	0	0	0
0011	3F	7_8	256	6	0	600	0	-600	0.00	0.00	1	0	-1
0011	3F	7_9	123	188	48	18800	22940	4140	0.26	1.22	33	40	7
0011	3F	7_9	124	181	29	18100	11960	-6140	0.16	0.66	32	21	-11
0011	3F	7_9	125	87	12	8700	7260	-1440	0.14	0.83	15	12	-3
0011	3F	7_9	126	50	5	5000	4060	-940	0.10	0.81	8	7	-1
0011	3F	7_9	134	100	18	10000	10610	610	0.18	1.06	17	18	1
0011	3F	7_9	135	51	8	5100	4300	-800	0.16	0.84	9	7	-2
0011	3F	7_9	136	34	5	3400	2830	-570	0.15	0.83	6	5	-1
0011	3F	7_9	145	44	6	4400	4190	-210	0.14	0.95	7	7	0
0011	3F	7_9	146	23	1	2300	2090	-210	0.04	0.91	4	3	-1
0011	3F	7_9	156	13	2	1300	1920	620	0.15	1.48	2	3	1
0011	3F	7_9	234	5	1	500	460	-40	0.20	0.92	0	0	0
0011	3F	7_9	235	2	1	200	450	250	0.50	2.25	0	0	0
0011	3F	7_9	245	1	0	100	0	-100	0.00	0.00	0	0	0
0011	3F	7_9	246	2	0	200	0	-200	0.00	0.00	0	0	0
0011	3F	7_9	256	1	0	100	0	-100	0.00	0.00	0	0	0
0011	3T	1_1	123	96	7	9600	5880	-3720	0.07	0.61	16	10	-6
0011	3T	1_1	124	88	2	8800	1870	-6930	0.02	0.21	15	3	-12
0011	3T	1_1	125	55	3	5500	3990	-1510	0.05	0.73	9	7	-2
0011	3T	1_1	126	27	0	2700	0	-2700	0.00	0.00	4	0	-4
0011	3T	1_1	132	69	4	6900	9900	3000	0.06	1.43	12	17	5
0011	3T	1_1	134	68	4	6800	4580	-2220	0.06	0.67	12	8	-4
0011	3T	1_1	135	42	3	4200	4590	390	0.07	1.09	7	8	1
0011	3T	1_1	136	33	0	3300	0	-3300	0.00	0.00	5	0	-5
0011	3T	1_1	142	58	2	5800	4130	-1670	0.03	0.71	10	7	-3
0011	3T	1_1	143	46	6	4600	6690	2090	0.13	1.45	8	11	3
0011	3T	1_1	145	32	2	3200	6180	2980	0.06	1.93	5	10	5
0011	3T	1_1	146	13	0	1300	0	-1300	0.00	0.00	2	0	-2
0011	3T	1_1	152	24	0	2400	0	-2400	0.00	0.00	4	0	-4
0011	3T	1_1	153	10	0	1000	0	-1000	0.00	0.00	1	0	-1
0011	3T	1_1	154	20	0	2000	0	-2000	0.00	0.00	3	0	-3
0011	3T	1_1	156	4	0	400	0	-400	0.00	0.00	0	0	0
0011	3T	1_1	162	3	0	300	0	-300	0.00	0.00	0	0	0
0011	3T	1_1	163	2	0	200	0	-200	0.00	0.00	0	0	0
0011	3T	1_1	164	6	0	600	0	-600	0.00	0.00	1	0	-1
0011	3T	1_1	165	4	0	400	0	-400	0.00	0.00	0	0	0
0011	3T	1_1	213	3	0	300	0	-300	0.00	0.00	0	0	0
0011	3T	1_1	214	6	1	600	5930	5330	0.17	9.88	1	10	9
0011	3T	1_1	215	6	0	600	0	-600	0.00	0.00	1	0	-1
0011	3T	1_1	216	5	0	500	0	-500	0.00	0.00	0	0	0
0011	3T	1_1	231	3	0	300	0	-300	0.00	0.00	0	0	0
0011	3T	1_1	234	4	0	400	0	-400	0.00	0.00	0	0	0
0011	3T	1_1	235	3	0	300	0	-300	0.00	0.00	0	0	0
0011	3T	1_1	236	1	0	100	0	-100	0.00	0.00	0	0	0
0011	3T	1_1	241	1	0	100	0	-100	0.00	0.00	0	0	0
0011	3T	1_1	243	1	0	100	0	-100	0.00	0.00	0	0	0
0011	3T	1_1	245	5	0	500	0	-500	0.00	0.00	0	0	0
0011	3T	1_1	246	3	0	300	0	-300	0.00	0.00	0	0	0
0011	3T	1_1	253	2	0	200	0	-200	0.00	0.00	0	0	0
0011	3T	1_1	254	4	0	400	0	-400	0.00	0.00	0	0	0
0011	3T	1_1	256	1	0	100	0	-100	0.00	0.00	0	0	0
0011	3T	1_1	261	1	0	100	0	-100	0.00	0.00	0	0	0
0011	3T	1_1	265	1	0	100	0	-100	0.00	0.00	0	0	0
0011	3T	1_10	123	116	8	11600	8310	-3290	0.07	0.72	20	14	-6
0011	3T	1_10	124	128	13	12800	13050	250	0.10	1.02	22	23	1
0011	3T	1_10	125	79	4	7900	8000	100	0.05	1.01	13	14	1
0011	3T	1_10	126	67	4	6700	6680	-20	0.06	1.00	11	11	0
0011	3T	1_10	132	68	8	6800	11990	5190	0.12	1.76	12	21	9
0011	3T	1_10	134	68	3	6800	4450	-2350	0.04	0.65	12	7	-5
0011	3T	1_10	135	59	3	5900	3960	-1940	0.05	0.67	10	7	-3
0011	3T	1_10	136	46	1	4600	1360	-3240	0.02	0.30	8	2	-6
0011	3T	1_10	142	27	2	2700	1540	-1160	0.07	0.57	4	2	-2
0011	3T	1_10	143	31	0	3100	0	-3100	0.00	0.00	5	0	-5
0011	3T	1_10	145	20	0	2000	0	-2000	0.00	0.00	3	0	-3
0011	3T	1_10	146	18	1	1800	1820	20	0.06	1.01	3	3	0
0011	3T	1_10	152	5	0	500	0	-500	0.00	0.00	0	0	0
0011	3T	1_10	153	8	0	800	0	-800	0.00	0.00	1	0	-1
0011	3T	1_10	154	7	0	700	0	-700	0.00	0.00	1	0	-1
0011	3T	1_10	156	3	0	300	0	-300	0.00	0.00	0	0	0
0011	3T	1_10	162	6	1	600	3910	3310	0.17	6.52	1	6	5
0011	3T	1_10	163	4	0	400	0	-400	0.00	0.00	0	0	0
0011	3T	1_10	164	5	0	500	0	-500	0.00	0.00	0	0	0
0011	3T	1_10	165	4	0	400	0	-400	0.00	0.00	0	0	0
0011	3T	1_10	213	3	0	300	0	-300	0.00	0.00	0	0	0
0011	3T	1_10	214	2	0	200	0	-200	0.00	0.00	0	0	0
0011	3T	1_10	215	1	0	100	0	-100	0.00	0.00	0	0	0
0011	3T	1_10	216	2	0	200	0	-200	0.00	0.00	0	0	0
0011	3T	1_10	264	1	0	100	0	-100	0.00	0.00	0	0	0
0011	3T	1_11	123	135	14	13500	13590	90	0.10	1.01	23	24	1
0011	3T	1_11	124	157	18	15700	20340	4640	0.11	1.30	27	36	9
0011	3T	1_11	125	83	7	8300	9500	1200	0.08	1.14	14	16	2
0011	3T	1_11	126	72	3	7200	5670	-1530	0.04	0.79	12	10	-2
0011	3T	1_11	132	53	2	5300	6900	1600	0.04	1.30	9	12	3
0011	3T	1_11	134	85	8	8500	10690	2190	0.09	1.26	15	18	3
0011	3T	1_11	135	51	1	5100	1570	-3530	0.02	0.31	9	2	-7
0011	3T	1_11	136	33	1	3300	2390	-910	0.03	0.72	5	4	-1
0011	3T	1_11	142	28	2	2800	1870	-930	0.07	0.67	4	3	-1
0011	3T	1_11	143	40	5	4000	9670	5670	0.13	2.42	7	17	10
0011	3T	1_11	145	26	1	2600	980	-1620	0.04	0.38	4	1	-3
0011	3T	1_11	146	31	2	3100	4020	920	0.06	1.30	5	7	2
0011	3T	1_11	152	10	2	1000	3650	2650	0.20	3.65	1	6	5
0011	3T	1_11	153	5	0	500	0	-500	0.00	0.00	0	0	0
0011	3T	1_11	154	11	0	1100	0	-1100	0.00	0.00	1	0	-1
0011	3T	1_11	156	6	0	600	0	-600	0.00	0.00	1	0	-1
0011	3T	1_11	162	1	0	100	0	-100	0.00	0.00	0	0	0
0011	3T	1_11	163	3	0	300	0	-300	0.00	0.00	0	0	0
0011	3T	1_11	164	2	1	200	4330	4130	0.50	21.65	0	7	7
0011	3T	1_11	213	1	0	100	0	-100	0.00	0.00	0	0	0
0011	3T	1_11	214	2	0	200	0	-200	0.00	0.00	0	0	0
0011	3T	1_11	215	1	0	100	0	-100	0.00	0.00	0	0	0
0011	3T	1_11	234	1	0	100	0	-100	0.00	0.00	0	0	0
0011	3T	1_11	253	1	0	100	0	-100	0.00	0.00	0	0	0
0011	3T	1_11	256	1	0	100	0	-100	0.00	0.00	0	0	0
0011	3T	1_12	123	175	21	17500	19360	1860	0.12	1.11	30	34	4
0011	3T	1_12	124	174	16	17400	14990	-2410	0.09	0.86	30	26	-4
0011	3T	1_12	125	89	5	8900	9140	240	0.06	1.03	15	16	1
0011	3T	1_12	126	96	6	9600	16830	7230	0.06	1.75	16	29	13
0011	3T	1_12	132	57	1	5700	1290	-4410	0.02	0.23	10	2	-8
0011	3T	1_12	134	68	6	6800	7160	360	0.09	1.05	12	12	0
0011	3T	1_12	135	37	1	3700	1800	-1900	0.03	0.49	6	3	-3
0011	3T	1_12	136	39	1	3900	4950	1050	0.03	1.27	6	8	2
0011	3T	1_12	142	39	6	3900	6700	2800	0.15	1.72	6	11	5
0011	3T	1_12	143	26	2	2600	2610	10	0.08	1.00	4	4	0
0011	3T	1_12	145	41	2	4100	2300	-1800	0.05	0.56	7	4	-3
0011	3T	1_12	146	22	1	2200	2890	690	0.05	1.31	3	5	2
0011	3T	1_12	152	9	0	900	0	-900	0.00	0.00	1	0	-1
0011	3T	1_12	153	11	0	1100	0	-1100	0.00	0.00	1	0	-1
0011	3T	1_12	154	7	0	700	0	-700	0.00	0.00	1	0	-1
0011	3T	1_12	156	4	0	400	0	-400	0.00	0.00	0	0	0
0011	3T	1_12	162	2	0	200	0	-200	0.00	0.00	0	0	0
0011	3T	1_12	164	1	0	100	0	-100	0.00	0.00	0	0	0
0011	3T	1_12	234	1	0	100	0	-100	0.00	0.00	0	0	0
0011	3T	1_12	251	1	0	100	0	-100	0.00	0.00	0	0	0
0011	3T	1_2	123	97	9	9700	11880	2180	0.09	1.22	17	21	4
0011	3T	1_2	124	90	8	9000	11710	2710	0.09	1.30	15	20	5
0011	3T	1_2	125	54	0	5400	0	-5400	0.00	0.00	9	0	-9
0011	3T	1_2	126	24	0	2400	0	-2400	0.00	0.00	4	0	-4
0011	3T	1_2	132	62	0	6200	0	-6200	0.00	0.00	10	0	-10
0011	3T	1_2	134	76	3	7600	19960	12360	0.04	2.63	13	35	22
0011	3T	1_2	135	28	0	2800	0	-2800	0.00	0.00	4	0	-4
0011	3T	1_2	136	23	0	2300	0	-2300	0.00	0.00	4	0	-4
0011	3T	1_2	142	47	1	4700	620	-4080	0.02	0.13	8	1	-7
0011	3T	1_2	143	48	3	4800	3400	-1400	0.06	0.71	8	6	-2
0011	3T	1_2	145	31	1	3100	990	-2110	0.03	0.32	5	1	-4
0011	3T	1_2	146	13	0	1300	0	-1300	0.00	0.00	2	0	-2
0011	3T	1_2	152	16	0	1600	0	-1600	0.00	0.00	2	0	-2
0011	3T	1_2	153	17	0	1700	0	-1700	0.00	0.00	3	0	-3
0011	3T	1_2	154	20	0	2000	0	-2000	0.00	0.00	3	0	-3
0011	3T	1_2	156	5	0	500	0	-500	0.00	0.00	0	0	0
0011	3T	1_2	162	5	0	500	0	-500	0.00	0.00	0	0	0
0011	3T	1_2	163	9	0	900	0	-900	0.00	0.00	1	0	-1
0011	3T	1_2	164	2	0	200	0	-200	0.00	0.00	0	0	0
0011	3T	1_2	165	7	0	700	0	-700	0.00	0.00	1	0	-1
0011	3T	1_2	213	6	0	600	0	-600	0.00	0.00	1	0	-1
0011	3T	1_2	214	8	0	800	0	-800	0.00	0.00	1	0	-1
0011	3T	1_2	215	7	0	700	0	-700	0.00	0.00	1	0	-1
0011	3T	1_2	216	7	1	700	10600	9900	0.14	15.14	1	18	17
0011	3T	1_2	231	1	0	100	0	-100	0.00	0.00	0	0	0
0011	3T	1_2	234	4	0	400	0	-400	0.00	0.00	0	0	0
0011	3T	1_2	235	4	0	400	0	-400	0.00	0.00	0	0	0
0011	3T	1_2	236	1	0	100	0	-100	0.00	0.00	0	0	0
0011	3T	1_2	241	5	0	500	0	-500	0.00	0.00	0	0	0
0011	3T	1_2	243	4	0	400	0	-400	0.00	0.00	0	0	0
0011	3T	1_2	245	3	0	300	0	-300	0.00	0.00	0	0	0
0011	3T	1_2	251	1	0	100	0	-100	0.00	0.00	0	0	0
0011	3T	1_2	253	2	0	200	0	-200	0.00	0.00	0	0	0
0011	3T	1_2	254	2	0	200	0	-200	0.00	0.00	0	0	0
0011	3T	1_2	256	1	0	100	0	-100	0.00	0.00	0	0	0
0011	3T	1_2	263	1	0	100	0	-100	0.00	0.00	0	0	0
0011	3T	1_3	123	90	5	9000	13950	4950	0.06	1.55	15	24	9
0011	3T	1_3	124	75	2	7500	2990	-4510	0.03	0.40	13	5	-8
0011	3T	1_3	125	42	1	4200	1030	-3170	0.02	0.25	7	1	-6
0011	3T	1_3	126	33	1	3300	2670	-630	0.03	0.81	5	4	-1
0011	3T	1_3	132	68	3	6800	4500	-2300	0.04	0.66	12	7	-5
0011	3T	1_3	134	67	5	6700	8720	2020	0.07	1.30	11	15	4
0011	3T	1_3	135	48	0	4800	0	-4800	0.00	0.00	8	0	-8
0011	3T	1_3	136	24	2	2400	4390	1990	0.08	1.83	4	7	3
0011	3T	1_3	142	35	1	3500	1940	-1560	0.03	0.55	6	3	-3
0011	3T	1_3	143	42	1	4200	1440	-2760	0.02	0.34	7	2	-5
0011	3T	1_3	145	20	0	2000	0	-2000	0.00	0.00	3	0	-3
0011	3T	1_3	146	18	1	1800	1270	-530	0.06	0.71	3	2	-1
0011	3T	1_3	152	21	1	2100	6430	4330	0.05	3.06	3	11	8
0011	3T	1_3	153	15	0	1500	0	-1500	0.00	0.00	2	0	-2
0011	3T	1_3	154	19	0	1900	0	-1900	0.00	0.00	3	0	-3
0011	3T	1_3	156	13	0	1300	0	-1300	0.00	0.00	2	0	-2
0011	3T	1_3	162	4	0	400	0	-400	0.00	0.00	0	0	0
0011	3T	1_3	163	5	0	500	0	-500	0.00	0.00	0	0	0
0011	3T	1_3	164	6	0	600	0	-600	0.00	0.00	1	0	-1
0011	3T	1_3	165	1	0	100	0	-100	0.00	0.00	0	0	0
0011	3T	1_3	213	3	1	300	1180	880	0.33	3.93	0	2	2
0011	3T	1_3	214	15	1	1500	3220	1720	0.07	2.15	2	5	3
0011	3T	1_3	215	6	0	600	0	-600	0.00	0.00	1	0	-1
0011	3T	1_3	216	2	0	200	0	-200	0.00	0.00	0	0	0
0011	3T	1_3	231	4	0	400	0	-400	0.00	0.00	0	0	0
0011	3T	1_3	234	4	0	400	0	-400	0.00	0.00	0	0	0
0011	3T	1_3	235	6	0	600	0	-600	0.00	0.00	1	0	-1
0011	3T	1_3	236	3	0	300	0	-300	0.00	0.00	0	0	0
0011	3T	1_3	241	2	0	200	0	-200	0.00	0.00	0	0	0
0011	3T	1_3	243	2	0	200	0	-200	0.00	0.00	0	0	0
0011	3T	1_3	245	2	0	200	0	-200	0.00	0.00	0	0	0
0011	3T	1_3	246	4	0	400	0	-400	0.00	0.00	0	0	0
0011	3T	1_3	251	1	0	100	0	-100	0.00	0.00	0	0	0
0011	3T	1_3	253	3	1	300	2680	2380	0.33	8.93	0	4	4
0011	3T	1_3	254	1	0	100	0	-100	0.00	0.00	0	0	0
0011	3T	1_3	256	1	0	100	0	-100	0.00	0.00	0	0	0
0011	3T	1_3	261	1	0	100	0	-100	0.00	0.00	0	0	0
0011	3T	1_3	265	2	0	200	0	-200	0.00	0.00	0	0	0
0011	3T	1_4	123	133	7	13300	7600	-5700	0.05	0.57	23	13	-10
0011	3T	1_4	124	84	7	8400	10460	2060	0.08	1.25	14	18	4
0011	3T	1_4	125	44	3	4400	6620	2220	0.07	1.50	7	11	4
0011	3T	1_4	126	52	1	5200	480	-4720	0.02	0.09	9	0	-9
0011	3T	1_4	132	75	2	7500	1190	-6310	0.03	0.16	13	2	-11
0011	3T	1_4	134	61	4	6100	27550	21450	0.07	4.52	10	48	38
0011	3T	1_4	135	45	0	4500	0	-4500	0.00	0.00	7	0	-7
0011	3T	1_4	136	34	0	3400	0	-3400	0.00	0.00	6	0	-6
0011	3T	1_4	142	35	1	3500	1490	-2010	0.03	0.43	6	2	-4
0011	3T	1_4	143	33	0	3300	0	-3300	0.00	0.00	5	0	-5
0011	3T	1_4	145	29	0	2900	0	-2900	0.00	0.00	5	0	-5
0011	3T	1_4	146	21	0	2100	0	-2100	0.00	0.00	3	0	-3
0011	3T	1_4	152	20	1	2000	810	-1190	0.05	0.41	3	1	-2
0011	3T	1_4	153	10	0	1000	0	-1000	0.00	0.00	1	0	-1
0011	3T	1_4	154	9	0	900	0	-900	0.00	0.00	1	0	-1
0011	3T	1_4	156	6	1	600	3670	3070	0.17	6.12	1	6	5
0011	3T	1_4	162	8	0	800	0	-800	0.00	0.00	1	0	-1
0011	3T	1_4	163	3	0	300	0	-300	0.00	0.00	0	0	0
0011	3T	1_4	164	9	1	900	1780	880	0.11	1.98	1	3	2
0011	3T	1_4	165	2	0	200	0	-200	0.00	0.00	0	0	0
0011	3T	1_4	213	10	0	1000	0	-1000	0.00	0.00	1	0	-1
0011	3T	1_4	214	6	0	600	0	-600	0.00	0.00	1	0	-1
0011	3T	1_4	215	4	0	400	0	-400	0.00	0.00	0	0	0
0011	3T	1_4	216	8	0	800	0	-800	0.00	0.00	1	0	-1
0011	3T	1_4	231	2	0	200	0	-200	0.00	0.00	0	0	0
0011	3T	1_4	234	3	0	300	0	-300	0.00	0.00	0	0	0
0011	3T	1_4	235	6	0	600	0	-600	0.00	0.00	1	0	-1
0011	3T	1_4	236	8	0	800	0	-800	0.00	0.00	1	0	-1
0011	3T	1_4	243	3	0	300	0	-300	0.00	0.00	0	0	0
0011	3T	1_4	245	2	0	200	0	-200	0.00	0.00	0	0	0
0011	3T	1_4	246	2	0	200	0	-200	0.00	0.00	0	0	0
0011	3T	1_4	253	1	0	100	0	-100	0.00	0.00	0	0	0
0011	3T	1_4	254	1	0	100	0	-100	0.00	0.00	0	0	0
0011	3T	1_4	261	1	0	100	0	-100	0.00	0.00	0	0	0
0011	3T	1_4	264	1	0	100	0	-100	0.00	0.00	0	0	0
0011	3T	1_5	123	112	10	11200	10980	-220	0.09	0.98	19	19	0
0011	3T	1_5	124	107	7	10700	6570	-4130	0.07	0.61	18	11	-7
0011	3T	1_5	125	40	1	4000	580	-3420	0.03	0.15	7	1	-6
0011	3T	1_5	126	30	1	3000	2490	-510	0.03	0.83	5	4	-1
0011	3T	1_5	132	70	7	7000	9890	2890	0.10	1.41	12	17	5
0011	3T	1_5	134	73	2	7300	2710	-4590	0.03	0.37	12	4	-8
0011	3T	1_5	135	29	0	2900	0	-2900	0.00	0.00	5	0	-5
0011	3T	1_5	136	29	0	2900	0	-2900	0.00	0.00	5	0	-5
0011	3T	1_5	142	35	3	3500	2070	-1430	0.09	0.59	6	3	-3
0011	3T	1_5	143	46	2	4600	5510	910	0.04	1.20	8	9	1
0011	3T	1_5	145	35	2	3500	3810	310	0.06	1.09	6	6	0
0011	3T	1_5	146	11	0	1100	0	-1100	0.00	0.00	1	0	-1
0011	3T	1_5	152	11	0	1100	0	-1100	0.00	0.00	1	0	-1
0011	3T	1_5	153	10	0	1000	0	-1000	0.00	0.00	1	0	-1
0011	3T	1_5	154	7	0	700	0	-700	0.00	0.00	1	0	-1
0011	3T	1_5	156	2	0	200	0	-200	0.00	0.00	0	0	0
0011	3T	1_5	162	2	0	200	0	-200	0.00	0.00	0	0	0
0011	3T	1_5	163	5	0	500	0	-500	0.00	0.00	0	0	0
0011	3T	1_5	164	2	0	200	0	-200	0.00	0.00	0	0	0
0011	3T	1_5	165	2	1	200	1750	1550	0.50	8.75	0	3	3
0011	3T	1_5	213	11	2	1100	4810	3710	0.18	4.37	1	8	7
0011	3T	1_5	214	7	0	700	0	-700	0.00	0.00	1	0	-1
0011	3T	1_5	215	6	1	600	2080	1480	0.17	3.47	1	3	2
0011	3T	1_5	216	7	0	700	0	-700	0.00	0.00	1	0	-1
0011	3T	1_5	231	2	1	200	1940	1740	0.50	9.70	0	3	3
0011	3T	1_5	234	9	0	900	0	-900	0.00	0.00	1	0	-1
0011	3T	1_5	235	9	1	900	650	-250	0.11	0.72	1	1	0
0011	3T	1_5	236	1	0	100	0	-100	0.00	0.00	0	0	0
0011	3T	1_5	241	2	0	200	0	-200	0.00	0.00	0	0	0
0011	3T	1_5	243	2	0	200	0	-200	0.00	0.00	0	0	0
0011	3T	1_5	245	1	0	100	0	-100	0.00	0.00	0	0	0
0011	3T	1_5	246	6	0	600	0	-600	0.00	0.00	1	0	-1
0011	3T	1_5	251	1	0	100	0	-100	0.00	0.00	0	0	0
0011	3T	1_5	256	2	0	200	0	-200	0.00	0.00	0	0	0
0011	3T	1_5	261	2	0	200	0	-200	0.00	0.00	0	0	0
0011	3T	1_5	263	1	0	100	0	-100	0.00	0.00	0	0	0
0011	3T	1_5	265	1	0	100	0	-100	0.00	0.00	0	0	0
0011	3T	1_6	123	94	7	9400	16570	7170	0.07	1.76	16	29	13
0011	3T	1_6	124	69	5	6900	7840	940	0.07	1.14	12	13	1
0011	3T	1_6	125	42	1	4200	4030	-170	0.02	0.96	7	7	0
0011	3T	1_6	126	41	1	4100	5230	1130	0.02	1.28	7	9	2
0011	3T	1_6	132	48	4	4800	8260	3460	0.08	1.72	8	14	6
0011	3T	1_6	134	60	0	6000	0	-6000	0.00	0.00	10	0	-10
0011	3T	1_6	135	26	2	2600	1590	-1010	0.08	0.61	4	2	-2
0011	3T	1_6	136	26	1	2600	570	-2030	0.04	0.22	4	1	-3
0011	3T	1_6	142	27	0	2700	0	-2700	0.00	0.00	4	0	-4
0011	3T	1_6	143	32	3	3200	3890	690	0.09	1.22	5	6	1
0011	3T	1_6	145	24	0	2400	0	-2400	0.00	0.00	4	0	-4
0011	3T	1_6	146	16	0	1600	0	-1600	0.00	0.00	2	0	-2
0011	3T	1_6	152	7	0	700	0	-700	0.00	0.00	1	0	-1
0011	3T	1_6	153	16	0	1600	0	-1600	0.00	0.00	2	0	-2
0011	3T	1_6	154	4	0	400	0	-400	0.00	0.00	0	0	0
0011	3T	1_6	156	9	0	900	0	-900	0.00	0.00	1	0	-1
0011	3T	1_6	162	6	0	600	0	-600	0.00	0.00	1	0	-1
0011	3T	1_6	163	10	0	1000	0	-1000	0.00	0.00	1	0	-1
0011	3T	1_6	164	7	0	700	0	-700	0.00	0.00	1	0	-1
0011	3T	1_6	165	2	0	200	0	-200	0.00	0.00	0	0	0
0011	3T	1_6	213	13	0	1300	0	-1300	0.00	0.00	2	0	-2
0011	3T	1_6	214	12	0	1200	0	-1200	0.00	0.00	2	0	-2
0011	3T	1_6	215	9	0	900	0	-900	0.00	0.00	1	0	-1
0011	3T	1_6	216	7	0	700	0	-700	0.00	0.00	1	0	-1
0011	3T	1_6	231	3	0	300	0	-300	0.00	0.00	0	0	0
0011	3T	1_6	234	5	0	500	0	-500	0.00	0.00	0	0	0
0011	3T	1_6	235	5	0	500	0	-500	0.00	0.00	0	0	0
0011	3T	1_6	236	6	0	600	0	-600	0.00	0.00	1	0	-1
0011	3T	1_6	241	1	0	100	0	-100	0.00	0.00	0	0	0
0011	3T	1_6	243	3	1	300	2180	1880	0.33	7.27	0	3	3
0011	3T	1_6	245	1	0	100	0	-100	0.00	0.00	0	0	0
0011	3T	1_6	246	3	0	300	0	-300	0.00	0.00	0	0	0
0011	3T	1_6	253	5	0	500	0	-500	0.00	0.00	0	0	0
0011	3T	1_6	254	1	0	100	0	-100	0.00	0.00	0	0	0
0011	3T	1_6	256	3	0	300	0	-300	0.00	0.00	0	0	0
0011	3T	1_6	261	3	0	300	0	-300	0.00	0.00	0	0	0
0011	3T	1_6	263	1	0	100	0	-100	0.00	0.00	0	0	0
0011	3T	1_6	265	1	0	100	0	-100	0.00	0.00	0	0	0
0011	3T	1_7	123	83	7	8300	8230	-70	0.08	0.99	14	14	0
0011	3T	1_7	124	65	3	6500	2010	-4490	0.05	0.31	11	3	-8
0011	3T	1_7	125	53	2	5300	3410	-1890	0.04	0.64	9	6	-3
0011	3T	1_7	126	50	1	5000	1940	-3060	0.02	0.39	8	3	-5
0011	3T	1_7	132	51	3	5100	6380	1280	0.06	1.25	9	11	2
0011	3T	1_7	134	55	3	5500	1870	-3630	0.05	0.34	9	3	-6
0011	3T	1_7	135	41	2	4100	2060	-2040	0.05	0.50	7	3	-4
0011	3T	1_7	136	34	2	3400	1870	-1530	0.06	0.55	6	3	-3
0011	3T	1_7	142	30	3	3000	3600	600	0.10	1.20	5	6	1
0011	3T	1_7	143	40	2	4000	2120	-1880	0.05	0.53	7	3	-4
0011	3T	1_7	145	24	1	2400	2330	-70	0.04	0.97	4	4	0
0011	3T	1_7	146	16	1	1600	2490	890	0.06	1.56	2	4	2
0011	3T	1_7	152	13	1	1300	1600	300	0.08	1.23	2	2	0
0011	3T	1_7	153	13	1	1300	2280	980	0.08	1.75	2	4	2
0011	3T	1_7	154	9	0	900	0	-900	0.00	0.00	1	0	-1
0011	3T	1_7	156	5	1	500	1140	640	0.20	2.28	0	2	2
0011	3T	1_7	162	5	1	500	9930	9430	0.20	19.86	0	17	17
0011	3T	1_7	163	8	0	800	0	-800	0.00	0.00	1	0	-1
0011	3T	1_7	164	7	0	700	0	-700	0.00	0.00	1	0	-1
0011	3T	1_7	165	4	0	400	0	-400	0.00	0.00	0	0	0
0011	3T	1_7	213	6	0	600	0	-600	0.00	0.00	1	0	-1
0011	3T	1_7	214	10	1	1000	1390	390	0.10	1.39	1	2	1
0011	3T	1_7	215	6	0	600	0	-600	0.00	0.00	1	0	-1
0011	3T	1_7	216	9	0	900	0	-900	0.00	0.00	1	0	-1
0011	3T	1_7	231	2	0	200	0	-200	0.00	0.00	0	0	0
0011	3T	1_7	234	5	0	500	0	-500	0.00	0.00	0	0	0
0011	3T	1_7	235	7	0	700	0	-700	0.00	0.00	1	0	-1
0011	3T	1_7	236	4	0	400	0	-400	0.00	0.00	0	0	0
0011	3T	1_7	241	6	0	600	0	-600	0.00	0.00	1	0	-1
0011	3T	1_7	243	3	1	300	2000	1700	0.33	6.67	0	3	3
0011	3T	1_7	245	4	0	400	0	-400	0.00	0.00	0	0	0
0011	3T	1_7	246	2	0	200	0	-200	0.00	0.00	0	0	0
0011	3T	1_7	251	3	0	300	0	-300	0.00	0.00	0	0	0
0011	3T	1_7	253	2	0	200	0	-200	0.00	0.00	0	0	0
0011	3T	1_7	254	3	0	300	0	-300	0.00	0.00	0	0	0
0011	3T	1_7	264	2	0	200	0	-200	0.00	0.00	0	0	0
0011	3T	1_7	265	1	0	100	0	-100	0.00	0.00	0	0	0
0011	3T	1_8	123	79	9	7900	11910	4010	0.11	1.51	13	21	8
0011	3T	1_8	124	75	6	7500	5410	-2090	0.08	0.72	13	9	-4
0011	3T	1_8	125	50	8	5000	9920	4920	0.16	1.98	8	17	9
0011	3T	1_8	126	47	0	4700	0	-4700	0.00	0.00	8	0	-8
0011	3T	1_8	132	53	1	5300	360	-4940	0.02	0.07	9	0	-9
0011	3T	1_8	134	50	6	5000	6060	1060	0.12	1.21	8	10	2
0011	3T	1_8	135	36	3	3600	2390	-1210	0.08	0.66	6	4	-2
0011	3T	1_8	136	26	1	2600	1060	-1540	0.04	0.41	4	1	-3
0011	3T	1_8	142	32	3	3200	2630	-570	0.09	0.82	5	4	-1
0011	3T	1_8	143	43	1	4300	1330	-2970	0.02	0.31	7	2	-5
0011	3T	1_8	145	22	0	2200	0	-2200	0.00	0.00	3	0	-3
0011	3T	1_8	146	16	0	1600	0	-1600	0.00	0.00	2	0	-2
0011	3T	1_8	152	12	0	1200	0	-1200	0.00	0.00	2	0	-2
0011	3T	1_8	153	12	0	1200	0	-1200	0.00	0.00	2	0	-2
0011	3T	1_8	154	3	0	300	0	-300	0.00	0.00	0	0	0
0011	3T	1_8	156	7	0	700	0	-700	0.00	0.00	1	0	-1
0011	3T	1_8	162	5	0	500	0	-500	0.00	0.00	0	0	0
0011	3T	1_8	163	6	0	600	0	-600	0.00	0.00	1	0	-1
0011	3T	1_8	164	1	0	100	0	-100	0.00	0.00	0	0	0
0011	3T	1_8	165	1	0	100	0	-100	0.00	0.00	0	0	0
0011	3T	1_8	213	20	0	2000	0	-2000	0.00	0.00	3	0	-3
0011	3T	1_8	214	10	2	1000	1380	380	0.20	1.38	1	2	1
0011	3T	1_8	215	9	1	900	1070	170	0.11	1.19	1	1	0
0011	3T	1_8	216	6	0	600	0	-600	0.00	0.00	1	0	-1
0011	3T	1_8	231	1	0	100	0	-100	0.00	0.00	0	0	0
0011	3T	1_8	234	5	0	500	0	-500	0.00	0.00	0	0	0
0011	3T	1_8	235	7	1	700	630	-70	0.14	0.90	1	1	0
0011	3T	1_8	236	3	0	300	0	-300	0.00	0.00	0	0	0
0011	3T	1_8	241	4	0	400	0	-400	0.00	0.00	0	0	0
0011	3T	1_8	243	4	0	400	0	-400	0.00	0.00	0	0	0
0011	3T	1_8	245	3	0	300	0	-300	0.00	0.00	0	0	0
0011	3T	1_8	246	2	0	200	0	-200	0.00	0.00	0	0	0
0011	3T	1_8	251	2	0	200	0	-200	0.00	0.00	0	0	0
0011	3T	1_8	253	3	0	300	0	-300	0.00	0.00	0	0	0
0011	3T	1_8	254	1	0	100	0	-100	0.00	0.00	0	0	0
0011	3T	1_8	256	1	0	100	0	-100	0.00	0.00	0	0	0
0011	3T	1_8	263	1	0	100	0	-100	0.00	0.00	0	0	0
0011	3T	1_8	265	3	0	300	0	-300	0.00	0.00	0	0	0
0011	3T	1_9	123	105	9	10500	8820	-1680	0.09	0.84	18	15	-3
0011	3T	1_9	124	73	8	7300	5380	-1920	0.11	0.74	12	9	-3
0011	3T	1_9	125	52	2	5200	1090	-4110	0.04	0.21	9	1	-8
0011	3T	1_9	126	44	2	4400	3530	-870	0.05	0.80	7	6	-1
0011	3T	1_9	132	60	7	6000	9140	3140	0.12	1.52	10	16	6
0011	3T	1_9	134	72	6	7200	4850	-2350	0.08	0.67	12	8	-4
0011	3T	1_9	135	50	2	5000	2300	-2700	0.04	0.46	8	4	-4
0011	3T	1_9	136	38	1	3800	10290	6490	0.03	2.71	6	18	12
0011	3T	1_9	142	42	1	4200	1000	-3200	0.02	0.24	7	1	-6
0011	3T	1_9	143	24	3	2400	3320	920	0.13	1.38	4	5	1
0011	3T	1_9	145	24	0	2400	0	-2400	0.00	0.00	4	0	-4
0011	3T	1_9	146	16	1	1600	3030	1430	0.06	1.89	2	5	3
0011	3T	1_9	152	6	0	600	0	-600	0.00	0.00	1	0	-1
0011	3T	1_9	153	16	0	1600	0	-1600	0.00	0.00	2	0	-2
0011	3T	1_9	154	12	2	1200	21990	20790	0.17	18.33	2	38	36
0011	3T	1_9	156	4	0	400	0	-400	0.00	0.00	0	0	0
0011	3T	1_9	162	5	0	500	0	-500	0.00	0.00	0	0	0
0011	3T	1_9	163	5	0	500	0	-500	0.00	0.00	0	0	0
0011	3T	1_9	164	3	0	300	0	-300	0.00	0.00	0	0	0
0011	3T	1_9	165	5	0	500	0	-500	0.00	0.00	0	0	0
0011	3T	1_9	213	10	1	1000	980	-20	0.10	0.98	1	1	0
0011	3T	1_9	214	11	0	1100	0	-1100	0.00	0.00	1	0	-1
0011	3T	1_9	215	3	0	300	0	-300	0.00	0.00	0	0	0
0011	3T	1_9	216	4	0	400	0	-400	0.00	0.00	0	0	0
0011	3T	1_9	231	1	0	100	0	-100	0.00	0.00	0	0	0
0011	3T	1_9	234	5	0	500	0	-500	0.00	0.00	0	0	0
0011	3T	1_9	235	2	0	200	0	-200	0.00	0.00	0	0	0
0011	3T	1_9	236	4	0	400	0	-400	0.00	0.00	0	0	0
0011	3T	1_9	241	2	0	200	0	-200	0.00	0.00	0	0	0
0011	3T	1_9	243	3	0	300	0	-300	0.00	0.00	0	0	0
0011	3T	1_9	245	2	0	200	0	-200	0.00	0.00	0	0	0
0011	3T	1_9	246	2	0	200	0	-200	0.00	0.00	0	0	0
0011	3T	1_9	251	1	0	100	0	-100	0.00	0.00	0	0	0
0011	3T	1_9	254	2	0	200	0	-200	0.00	0.00	0	0	0
0011	3T	2_1	123	107	11	10700	8040	-2660	0.10	0.75	18	14	-4
0011	3T	2_1	124	75	11	7500	11010	3510	0.15	1.47	13	19	6
0011	3T	2_1	125	57	8	5700	11640	5940	0.14	2.04	10	20	10
0011	3T	2_1	126	28	2	2800	1980	-820	0.07	0.71	4	3	-1
0011	3T	2_1	132	75	5	7500	5140	-2360	0.07	0.69	13	9	-4
0011	3T	2_1	134	45	5	4500	4110	-390	0.11	0.91	7	7	0
0011	3T	2_1	135	30	0	3000	0	-3000	0.00	0.00	5	0	-5
0011	3T	2_1	136	23	0	2300	0	-2300	0.00	0.00	4	0	-4
0011	3T	2_1	142	26	1	2600	850	-1750	0.04	0.33	4	1	-3
0011	3T	2_1	143	39	3	3900	3740	-160	0.08	0.96	6	6	0
0011	3T	2_1	145	29	0	2900	0	-2900	0.00	0.00	5	0	-5
0011	3T	2_1	146	21	3	2100	5680	3580	0.14	2.70	3	10	7
0011	3T	2_1	152	16	3	1600	2440	840	0.19	1.53	2	4	2
0011	3T	2_1	153	16	1	1600	1360	-240	0.06	0.85	2	2	0
0011	3T	2_1	154	6	1	600	1060	460	0.17	1.77	1	1	0
0011	3T	2_1	156	2	0	200	0	-200	0.00	0.00	0	0	0
0011	3T	2_1	162	7	0	700	0	-700	0.00	0.00	1	0	-1
0011	3T	2_1	163	7	0	700	0	-700	0.00	0.00	1	0	-1
0011	3T	2_1	164	3	0	300	0	-300	0.00	0.00	0	0	0
0011	3T	2_1	165	3	0	300	0	-300	0.00	0.00	0	0	0
0011	3T	2_1	213	7	0	700	0	-700	0.00	0.00	1	0	-1
0011	3T	2_1	214	4	0	400	0	-400	0.00	0.00	0	0	0
0011	3T	2_1	215	2	0	200	0	-200	0.00	0.00	0	0	0
0011	3T	2_1	216	4	0	400	0	-400	0.00	0.00	0	0	0
0011	3T	2_1	234	2	0	200	0	-200	0.00	0.00	0	0	0
0011	3T	2_1	235	4	0	400	0	-400	0.00	0.00	0	0	0
0011	3T	2_1	241	2	0	200	0	-200	0.00	0.00	0	0	0
0011	3T	2_1	243	2	0	200	0	-200	0.00	0.00	0	0	0
0011	3T	2_1	245	1	0	100	0	-100	0.00	0.00	0	0	0
0011	3T	2_1	246	3	0	300	0	-300	0.00	0.00	0	0	0
0011	3T	2_1	251	3	0	300	0	-300	0.00	0.00	0	0	0
0011	3T	2_1	253	1	0	100	0	-100	0.00	0.00	0	0	0
0011	3T	2_1	254	4	0	400	0	-400	0.00	0.00	0	0	0
0011	3T	2_1	263	2	0	200	0	-200	0.00	0.00	0	0	0
0011	3T	2_1	264	1	0	100	0	-100	0.00	0.00	0	0	0
0011	3T	2_10	123	121	10	12100	13210	1110	0.08	1.09	21	23	2
0011	3T	2_10	124	112	10	11200	17190	5990	0.09	1.53	19	30	11
0011	3T	2_10	125	73	6	7300	7650	350	0.08	1.05	12	13	1
0011	3T	2_10	126	80	9	8000	7690	-310	0.11	0.96	14	13	-1
0011	3T	2_10	132	47	2	4700	1950	-2750	0.04	0.41	8	3	-5
0011	3T	2_10	134	65	4	6500	6670	170	0.06	1.03	11	11	0
0011	3T	2_10	135	33	4	3300	3550	250	0.12	1.08	5	6	1
0011	3T	2_10	136	50	2	5000	2340	-2660	0.04	0.47	8	4	-4
0011	3T	2_10	142	30	2	3000	3400	400	0.07	1.13	5	6	1
0011	3T	2_10	143	27	1	2700	2350	-350	0.04	0.87	4	4	0
0011	3T	2_10	145	17	0	1700	0	-1700	0.00	0.00	3	0	-3
0011	3T	2_10	146	27	0	2700	0	-2700	0.00	0.00	4	0	-4
0011	3T	2_10	152	6	2	600	2850	2250	0.33	4.75	1	5	4
0011	3T	2_10	153	14	0	1400	0	-1400	0.00	0.00	2	0	-2
0011	3T	2_10	154	3	0	300	0	-300	0.00	0.00	0	0	0
0011	3T	2_10	156	10	0	1000	0	-1000	0.00	0.00	1	0	-1
0011	3T	2_10	162	12	0	1200	0	-1200	0.00	0.00	2	0	-2
0011	3T	2_10	163	8	0	800	0	-800	0.00	0.00	1	0	-1
0011	3T	2_10	164	8	0	800	0	-800	0.00	0.00	1	0	-1
0011	3T	2_10	165	4	0	400	0	-400	0.00	0.00	0	0	0
0011	3T	2_10	213	5	0	500	0	-500	0.00	0.00	0	0	0
0011	3T	2_10	214	8	3	800	3490	2690	0.38	4.36	1	6	5
0011	3T	2_10	215	4	0	400	0	-400	0.00	0.00	0	0	0
0011	3T	2_10	216	3	0	300	0	-300	0.00	0.00	0	0	0
0011	3T	2_10	231	1	0	100	0	-100	0.00	0.00	0	0	0
0011	3T	2_10	234	1	0	100	0	-100	0.00	0.00	0	0	0
0011	3T	2_10	236	1	0	100	0	-100	0.00	0.00	0	0	0
0011	3T	2_10	241	2	0	200	0	-200	0.00	0.00	0	0	0
0011	3T	2_10	245	1	0	100	0	-100	0.00	0.00	0	0	0
0011	3T	2_10	246	1	0	100	0	-100	0.00	0.00	0	0	0
0011	3T	2_10	251	1	0	100	0	-100	0.00	0.00	0	0	0
0011	3T	2_10	253	1	0	100	0	-100	0.00	0.00	0	0	0
0011	3T	2_10	254	1	0	100	0	-100	0.00	0.00	0	0	0
0011	3T	2_10	261	2	0	200	0	-200	0.00	0.00	0	0	0
0011	3T	2_10	263	1	0	100	0	-100	0.00	0.00	0	0	0
0011	3T	2_10	265	1	0	100	0	-100	0.00	0.00	0	0	0
0011	3T	2_11	123	132	13	13200	10240	-2960	0.10	0.78	23	18	-5
0011	3T	2_11	124	141	15	14100	15350	1250	0.11	1.09	24	27	3
0011	3T	2_11	125	94	6	9400	5200	-4200	0.06	0.55	16	9	-7
0011	3T	2_11	126	61	2	6100	6200	100	0.03	1.02	10	10	0
0011	3T	2_11	132	58	4	5800	3870	-1930	0.07	0.67	10	6	-4
0011	3T	2_11	134	69	3	6900	3200	-3700	0.04	0.46	12	5	-7
0011	3T	2_11	135	39	1	3900	690	-3210	0.03	0.18	6	1	-5
0011	3T	2_11	136	40	0	4000	0	-4000	0.00	0.00	7	0	-7
0011	3T	2_11	142	35	2	3500	1530	-1970	0.06	0.44	6	2	-4
0011	3T	2_11	143	45	2	4500	6560	2060	0.04	1.46	7	11	4
0011	3T	2_11	145	27	0	2700	0	-2700	0.00	0.00	4	0	-4
0011	3T	2_11	146	24	1	2400	1390	-1010	0.04	0.58	4	2	-2
0011	3T	2_11	152	7	0	700	0	-700	0.00	0.00	1	0	-1
0011	3T	2_11	153	11	0	1100	0	-1100	0.00	0.00	1	0	-1
0011	3T	2_11	154	10	1	1000	4300	3300	0.10	4.30	1	7	6
0011	3T	2_11	156	13	0	1300	0	-1300	0.00	0.00	2	0	-2
0011	3T	2_11	162	7	0	700	0	-700	0.00	0.00	1	0	-1
0011	3T	2_11	163	3	0	300	0	-300	0.00	0.00	0	0	0
0011	3T	2_11	164	3	0	300	0	-300	0.00	0.00	0	0	0
0011	3T	2_11	165	4	0	400	0	-400	0.00	0.00	0	0	0
0011	3T	2_11	214	2	0	200	0	-200	0.00	0.00	0	0	0
0011	3T	2_11	216	4	0	400	0	-400	0.00	0.00	0	0	0
0011	3T	2_11	234	1	0	100	0	-100	0.00	0.00	0	0	0
0011	3T	2_11	235	1	0	100	0	-100	0.00	0.00	0	0	0
0011	3T	2_11	241	1	0	100	0	-100	0.00	0.00	0	0	0
0011	3T	2_11	246	1	0	100	0	-100	0.00	0.00	0	0	0
0011	3T	2_11	263	1	0	100	0	-100	0.00	0.00	0	0	0
0011	3T	2_12	123	154	16	15400	14380	-1020	0.10	0.93	27	25	-2
0011	3T	2_12	124	150	10	15000	14110	-890	0.07	0.94	26	24	-2
0011	3T	2_12	125	106	11	10600	19490	8890	0.10	1.84	18	34	16
0011	3T	2_12	126	77	2	7700	2140	-5560	0.03	0.28	13	3	-10
0011	3T	2_12	132	62	5	6200	4710	-1490	0.08	0.76	10	8	-2
0011	3T	2_12	134	71	8	7100	8910	1810	0.11	1.25	12	15	3
0011	3T	2_12	135	47	2	4700	2460	-2240	0.04	0.52	8	4	-4
0011	3T	2_12	136	41	1	4100	700	-3400	0.02	0.17	7	1	-6
0011	3T	2_12	142	42	4	4200	5950	1750	0.10	1.42	7	10	3
0011	3T	2_12	143	36	1	3600	780	-2820	0.03	0.22	6	1	-5
0011	3T	2_12	145	42	1	4200	1380	-2820	0.02	0.33	7	2	-5
0011	3T	2_12	146	23	4	2300	6900	4600	0.17	3.00	4	12	8
0011	3T	2_12	152	9	1	900	2080	1180	0.11	2.31	1	3	2
0011	3T	2_12	153	6	1	600	3010	2410	0.17	5.02	1	5	4
0011	3T	2_12	154	6	0	600	0	-600	0.00	0.00	1	0	-1
0011	3T	2_12	156	12	1	1200	1500	300	0.08	1.25	2	2	0
0011	3T	2_12	162	1	0	100	0	-100	0.00	0.00	0	0	0
0011	3T	2_12	163	2	0	200	0	-200	0.00	0.00	0	0	0
0011	3T	2_12	164	2	0	200	0	-200	0.00	0.00	0	0	0
0011	3T	2_12	216	1	0	100	0	-100	0.00	0.00	0	0	0
0011	3T	2_12	234	1	0	100	0	-100	0.00	0.00	0	0	0
0011	3T	2_12	245	1	0	100	0	-100	0.00	0.00	0	0	0
0011	3T	2_2	123	81	9	8100	12450	4350	0.11	1.54	14	22	8
0011	3T	2_2	124	73	6	7300	6860	-440	0.08	0.94	12	12	0
0011	3T	2_2	125	31	4	3100	4880	1780	0.13	1.57	5	8	3
0011	3T	2_2	126	30	1	3000	1030	-1970	0.03	0.34	5	1	-4
0011	3T	2_2	132	32	0	3200	0	-3200	0.00	0.00	5	0	-5
0011	3T	2_2	134	42	2	4200	4350	150	0.05	1.04	7	7	0
0011	3T	2_2	135	21	1	2100	670	-1430	0.05	0.32	3	1	-2
0011	3T	2_2	136	30	0	3000	0	-3000	0.00	0.00	5	0	-5
0011	3T	2_2	142	33	2	3300	1500	-1800	0.06	0.45	5	2	-3
0011	3T	2_2	143	34	1	3400	1340	-2060	0.03	0.39	6	2	-4
0011	3T	2_2	145	22	0	2200	0	-2200	0.00	0.00	3	0	-3
0011	3T	2_2	146	17	0	1700	0	-1700	0.00	0.00	3	0	-3
0011	3T	2_2	152	12	1	1200	1250	50	0.08	1.04	2	2	0
0011	3T	2_2	153	15	2	1500	2270	770	0.13	1.51	2	4	2
0011	3T	2_2	154	7	1	700	1900	1200	0.14	2.71	1	3	2
0011	3T	2_2	156	8	0	800	0	-800	0.00	0.00	1	0	-1
0011	3T	2_2	162	10	0	1000	0	-1000	0.00	0.00	1	0	-1
0011	3T	2_2	163	8	0	800	0	-800	0.00	0.00	1	0	-1
0011	3T	2_2	164	7	1	700	2820	2120	0.14	4.03	1	4	3
0011	3T	2_2	165	5	0	500	0	-500	0.00	0.00	0	0	0
0011	3T	2_2	213	4	0	400	0	-400	0.00	0.00	0	0	0
0011	3T	2_2	214	7	0	700	0	-700	0.00	0.00	1	0	-1
0011	3T	2_2	215	5	0	500	0	-500	0.00	0.00	0	0	0
0011	3T	2_2	216	11	0	1100	0	-1100	0.00	0.00	1	0	-1
0011	3T	2_2	231	6	1	600	2050	1450	0.17	3.42	1	3	2
0011	3T	2_2	234	7	0	700	0	-700	0.00	0.00	1	0	-1
0011	3T	2_2	235	4	0	400	0	-400	0.00	0.00	0	0	0
0011	3T	2_2	236	8	0	800	0	-800	0.00	0.00	1	0	-1
0011	3T	2_2	241	1	0	100	0	-100	0.00	0.00	0	0	0
0011	3T	2_2	243	3	1	300	3280	2980	0.33	10.93	0	5	5
0011	3T	2_2	245	3	1	300	72950	72650	0.33	243.17	0	129	129
0011	3T	2_2	251	2	0	200	0	-200	0.00	0.00	0	0	0
0011	3T	2_2	253	1	0	100	0	-100	0.00	0.00	0	0	0
0011	3T	2_2	256	2	0	200	0	-200	0.00	0.00	0	0	0
0011	3T	2_2	261	1	0	100	0	-100	0.00	0.00	0	0	0
0011	3T	2_2	263	4	0	400	0	-400	0.00	0.00	0	0	0
0011	3T	2_2	264	4	0	400	0	-400	0.00	0.00	0	0	0
0011	3T	2_3	123	91	10	9100	11690	2590	0.11	1.28	16	20	4
0011	3T	2_3	124	50	2	5000	1450	-3550	0.04	0.29	8	2	-6
0011	3T	2_3	125	41	2	4100	3020	-1080	0.05	0.74	7	5	-2
0011	3T	2_3	126	30	1	3000	710	-2290	0.03	0.24	5	1	-4
0011	3T	2_3	132	47	2	4700	1950	-2750	0.04	0.41	8	3	-5
0011	3T	2_3	134	25	1	2500	2660	160	0.04	1.06	4	4	0
0011	3T	2_3	135	37	2	3700	2200	-1500	0.05	0.59	6	3	-3
0011	3T	2_3	136	35	2	3500	1780	-1720	0.06	0.51	6	3	-3
0011	3T	2_3	142	18	1	1800	1140	-660	0.06	0.63	3	2	-1
0011	3T	2_3	143	22	0	2200	0	-2200	0.00	0.00	3	0	-3
0011	3T	2_3	145	22	0	2200	0	-2200	0.00	0.00	3	0	-3
0011	3T	2_3	146	17	0	1700	0	-1700	0.00	0.00	3	0	-3
0011	3T	2_3	152	10	0	1000	0	-1000	0.00	0.00	1	0	-1
0011	3T	2_3	153	16	1	1600	1310	-290	0.06	0.82	2	2	0
0011	3T	2_3	154	13	0	1300	0	-1300	0.00	0.00	2	0	-2
0011	3T	2_3	156	12	0	1200	0	-1200	0.00	0.00	2	0	-2
0011	3T	2_3	162	11	0	1100	0	-1100	0.00	0.00	1	0	-1
0011	3T	2_3	163	13	0	1300	0	-1300	0.00	0.00	2	0	-2
0011	3T	2_3	164	6	0	600	0	-600	0.00	0.00	1	0	-1
0011	3T	2_3	165	8	0	800	0	-800	0.00	0.00	1	0	-1
0011	3T	2_3	213	9	0	900	0	-900	0.00	0.00	1	0	-1
0011	3T	2_3	214	7	0	700	0	-700	0.00	0.00	1	0	-1
0011	3T	2_3	215	6	0	600	0	-600	0.00	0.00	1	0	-1
0011	3T	2_3	216	7	0	700	0	-700	0.00	0.00	1	0	-1
0011	3T	2_3	231	5	0	500	0	-500	0.00	0.00	0	0	0
0011	3T	2_3	234	6	1	600	1830	1230	0.17	3.05	1	3	2
0011	3T	2_3	235	4	0	400	0	-400	0.00	0.00	0	0	0
0011	3T	2_3	236	4	0	400	0	-400	0.00	0.00	0	0	0
0011	3T	2_3	241	2	0	200	0	-200	0.00	0.00	0	0	0
0011	3T	2_3	243	4	0	400	0	-400	0.00	0.00	0	0	0
0011	3T	2_3	245	5	0	500	0	-500	0.00	0.00	0	0	0
0011	3T	2_3	246	5	0	500	0	-500	0.00	0.00	0	0	0
0011	3T	2_3	251	1	0	100	0	-100	0.00	0.00	0	0	0
0011	3T	2_3	256	4	0	400	0	-400	0.00	0.00	0	0	0
0011	3T	2_3	261	2	0	200	0	-200	0.00	0.00	0	0	0
0011	3T	2_3	263	5	0	500	0	-500	0.00	0.00	0	0	0
0011	3T	2_3	264	4	0	400	0	-400	0.00	0.00	0	0	0
0011	3T	2_4	123	75	5	7500	3020	-4480	0.07	0.40	13	5	-8
0011	3T	2_4	124	73	5	7300	7800	500	0.07	1.07	12	13	1
0011	3T	2_4	125	48	3	4800	5230	430	0.06	1.09	8	9	1
0011	3T	2_4	126	57	6	5700	7200	1500	0.11	1.26	10	12	2
0011	3T	2_4	132	45	6	4500	7710	3210	0.13	1.71	7	13	6
0011	3T	2_4	134	41	2	4100	2470	-1630	0.05	0.60	7	4	-3
0011	3T	2_4	135	28	0	2800	0	-2800	0.00	0.00	4	0	-4
0011	3T	2_4	136	41	1	4100	4470	370	0.02	1.09	7	7	0
0011	3T	2_4	142	25	0	2500	0	-2500	0.00	0.00	4	0	-4
0011	3T	2_4	143	20	0	2000	0	-2000	0.00	0.00	3	0	-3
0011	3T	2_4	145	31	3	3100	3400	300	0.10	1.10	5	6	1
0011	3T	2_4	146	11	1	1100	590	-510	0.09	0.54	1	1	0
0011	3T	2_4	152	7	0	700	0	-700	0.00	0.00	1	0	-1
0011	3T	2_4	153	24	1	2400	760	-1640	0.04	0.32	4	1	-3
0011	3T	2_4	154	11	0	1100	0	-1100	0.00	0.00	1	0	-1
0011	3T	2_4	156	16	0	1600	0	-1600	0.00	0.00	2	0	-2
0011	3T	2_4	162	8	0	800	0	-800	0.00	0.00	1	0	-1
0011	3T	2_4	163	11	1	1100	890	-210	0.09	0.81	1	1	0
0011	3T	2_4	164	9	0	900	0	-900	0.00	0.00	1	0	-1
0011	3T	2_4	165	2	0	200	0	-200	0.00	0.00	0	0	0
0011	3T	2_4	213	13	0	1300	0	-1300	0.00	0.00	2	0	-2
0011	3T	2_4	214	12	0	1200	0	-1200	0.00	0.00	2	0	-2
0011	3T	2_4	215	4	0	400	0	-400	0.00	0.00	0	0	0
0011	3T	2_4	216	11	0	1100	0	-1100	0.00	0.00	1	0	-1
0011	3T	2_4	231	4	0	400	0	-400	0.00	0.00	0	0	0
0011	3T	2_4	234	5	0	500	0	-500	0.00	0.00	0	0	0
0011	3T	2_4	235	6	0	600	0	-600	0.00	0.00	1	0	-1
0011	3T	2_4	236	6	0	600	0	-600	0.00	0.00	1	0	-1
0011	3T	2_4	241	2	0	200	0	-200	0.00	0.00	0	0	0
0011	3T	2_4	243	4	1	400	810	410	0.25	2.03	0	1	1
0011	3T	2_4	245	3	0	300	0	-300	0.00	0.00	0	0	0
0011	3T	2_4	246	3	0	300	0	-300	0.00	0.00	0	0	0
0011	3T	2_4	251	4	0	400	0	-400	0.00	0.00	0	0	0
0011	3T	2_4	253	2	0	200	0	-200	0.00	0.00	0	0	0
0011	3T	2_4	254	3	0	300	0	-300	0.00	0.00	0	0	0
0011	3T	2_4	256	4	0	400	0	-400	0.00	0.00	0	0	0
0011	3T	2_4	261	1	0	100	0	-100	0.00	0.00	0	0	0
0011	3T	2_4	263	6	0	600	0	-600	0.00	0.00	1	0	-1
0011	3T	2_4	264	5	0	500	0	-500	0.00	0.00	0	0	0
0011	3T	2_4	265	1	0	100	0	-100	0.00	0.00	0	0	0
0011	3T	2_5	123	92	10	9200	8080	-1120	0.11	0.88	16	14	-2
0011	3T	2_5	124	87	8	8700	6480	-2220	0.09	0.74	15	11	-4
0011	3T	2_5	125	57	7	5700	14650	8950	0.12	2.57	10	25	15
0011	3T	2_5	126	62	5	6200	7780	1580	0.08	1.25	10	13	3
0011	3T	2_5	132	47	4	4700	4450	-250	0.09	0.95	8	7	-1
0011	3T	2_5	134	43	4	4300	4120	-180	0.09	0.96	7	7	0
0011	3T	2_5	135	31	0	3100	0	-3100	0.00	0.00	5	0	-5
0011	3T	2_5	136	28	2	2800	2400	-400	0.07	0.86	4	4	0
0011	3T	2_5	142	33	1	3300	540	-2760	0.03	0.16	5	0	-5
0011	3T	2_5	143	35	0	3500	0	-3500	0.00	0.00	6	0	-6
0011	3T	2_5	145	13	1	1300	900	-400	0.08	0.69	2	1	-1
0011	3T	2_5	146	5	0	500	0	-500	0.00	0.00	0	0	0
0011	3T	2_5	152	12	0	1200	0	-1200	0.00	0.00	2	0	-2
0011	3T	2_5	153	4	0	400	0	-400	0.00	0.00	0	0	0
0011	3T	2_5	154	9	0	900	0	-900	0.00	0.00	1	0	-1
0011	3T	2_5	156	11	0	1100	0	-1100	0.00	0.00	1	0	-1
0011	3T	2_5	162	8	1	800	1910	1110	0.13	2.39	1	3	2
0011	3T	2_5	163	8	0	800	0	-800	0.00	0.00	1	0	-1
0011	3T	2_5	164	10	0	1000	0	-1000	0.00	0.00	1	0	-1
0011	3T	2_5	165	6	0	600	0	-600	0.00	0.00	1	0	-1
0011	3T	2_5	213	7	1	700	810	110	0.14	1.16	1	1	0
0011	3T	2_5	214	8	1	800	1080	280	0.13	1.35	1	1	0
0011	3T	2_5	215	6	0	600	0	-600	0.00	0.00	1	0	-1
0011	3T	2_5	216	9	0	900	0	-900	0.00	0.00	1	0	-1
0011	3T	2_5	231	5	0	500	0	-500	0.00	0.00	0	0	0
0011	3T	2_5	234	3	1	300	3420	3120	0.33	11.40	0	6	6
0011	3T	2_5	235	3	0	300	0	-300	0.00	0.00	0	0	0
0011	3T	2_5	236	5	0	500	0	-500	0.00	0.00	0	0	0
0011	3T	2_5	241	2	0	200	0	-200	0.00	0.00	0	0	0
0011	3T	2_5	243	4	0	400	0	-400	0.00	0.00	0	0	0
0011	3T	2_5	245	4	0	400	0	-400	0.00	0.00	0	0	0
0011	3T	2_5	246	2	1	200	890	690	0.50	4.45	0	1	1
0011	3T	2_5	251	1	0	100	0	-100	0.00	0.00	0	0	0
0011	3T	2_5	253	1	0	100	0	-100	0.00	0.00	0	0	0
0011	3T	2_5	254	3	0	300	0	-300	0.00	0.00	0	0	0
0011	3T	2_5	256	2	0	200	0	-200	0.00	0.00	0	0	0
0011	3T	2_5	261	1	0	100	0	-100	0.00	0.00	0	0	0
0011	3T	2_5	264	1	0	100	0	-100	0.00	0.00	0	0	0
0011	3T	2_5	265	2	0	200	0	-200	0.00	0.00	0	0	0
0011	3T	2_6	123	66	5	6600	2120	-4480	0.08	0.32	11	3	-8
0011	3T	2_6	124	68	3	6800	3440	-3360	0.04	0.51	12	6	-6
0011	3T	2_6	125	50	2	5000	3420	-1580	0.04	0.68	8	6	-2
0011	3T	2_6	126	53	7	5300	8600	3300	0.13	1.62	9	15	6
0011	3T	2_6	132	53	2	5300	2790	-2510	0.04	0.53	9	4	-5
0011	3T	2_6	134	49	2	4900	1220	-3680	0.04	0.25	8	2	-6
0011	3T	2_6	135	33	0	3300	0	-3300	0.00	0.00	5	0	-5
0011	3T	2_6	136	29	5	2900	6280	3380	0.17	2.17	5	11	6
0011	3T	2_6	142	26	0	2600	0	-2600	0.00	0.00	4	0	-4
0011	3T	2_6	143	22	1	2200	2810	610	0.05	1.28	3	4	1
0011	3T	2_6	145	16	0	1600	0	-1600	0.00	0.00	2	0	-2
0011	3T	2_6	146	12	0	1200	0	-1200	0.00	0.00	2	0	-2
0011	3T	2_6	152	14	0	1400	0	-1400	0.00	0.00	2	0	-2
0011	3T	2_6	153	10	0	1000	0	-1000	0.00	0.00	1	0	-1
0011	3T	2_6	154	5	0	500	0	-500	0.00	0.00	0	0	0
0011	3T	2_6	156	9	1	900	1480	580	0.11	1.64	1	2	1
0011	3T	2_6	162	12	1	1200	2340	1140	0.08	1.95	2	4	2
0011	3T	2_6	163	14	2	1400	1860	460	0.14	1.33	2	3	1
0011	3T	2_6	164	8	0	800	0	-800	0.00	0.00	1	0	-1
0011	3T	2_6	165	3	0	300	0	-300	0.00	0.00	0	0	0
0011	3T	2_6	213	10	2	1000	1580	580	0.20	1.58	1	2	1
0011	3T	2_6	214	8	0	800	0	-800	0.00	0.00	1	0	-1
0011	3T	2_6	215	11	0	1100	0	-1100	0.00	0.00	1	0	-1
0011	3T	2_6	216	15	1	1500	2670	1170	0.07	1.78	2	4	2
0011	3T	2_6	231	4	0	400	0	-400	0.00	0.00	0	0	0
0011	3T	2_6	234	4	1	400	3840	3440	0.25	9.60	0	6	6
0011	3T	2_6	235	4	0	400	0	-400	0.00	0.00	0	0	0
0011	3T	2_6	236	11	1	1100	5150	4050	0.09	4.68	1	9	8
0011	3T	2_6	241	2	0	200	0	-200	0.00	0.00	0	0	0
0011	3T	2_6	243	4	1	400	750	350	0.25	1.88	0	1	1
0011	3T	2_6	246	4	0	400	0	-400	0.00	0.00	0	0	0
0011	3T	2_6	251	2	0	200	0	-200	0.00	0.00	0	0	0
0011	3T	2_6	253	2	0	200	0	-200	0.00	0.00	0	0	0
0011	3T	2_6	254	1	1	100	5630	5530	1.00	56.30	0	9	9
0011	3T	2_6	256	6	0	600	0	-600	0.00	0.00	1	0	-1
0011	3T	2_6	261	1	0	100	0	-100	0.00	0.00	0	0	0
0011	3T	2_6	263	3	0	300	0	-300	0.00	0.00	0	0	0
0011	3T	2_6	264	1	0	100	0	-100	0.00	0.00	0	0	0
0011	3T	2_7	123	83	7	8300	7380	-920	0.08	0.89	14	13	-1
0011	3T	2_7	124	66	8	6600	10710	4110	0.12	1.62	11	18	7
0011	3T	2_7	125	50	2	5000	1230	-3770	0.04	0.25	8	2	-6
0011	3T	2_7	126	43	3	4300	4070	-230	0.07	0.95	7	7	0
0011	3T	2_7	132	33	1	3300	1150	-2150	0.03	0.35	5	2	-3
0011	3T	2_7	134	48	3	4800	4330	-470	0.06	0.90	8	7	-1
0011	3T	2_7	135	30	1	3000	1110	-1890	0.03	0.37	5	1	-4
0011	3T	2_7	136	33	2	3300	1590	-1710	0.06	0.48	5	2	-3
0011	3T	2_7	142	33	1	3300	580	-2720	0.03	0.18	5	1	-4
0011	3T	2_7	143	29	3	2900	5960	3060	0.10	2.06	5	10	5
0011	3T	2_7	145	16	1	1600	980	-620	0.06	0.61	2	1	-1
0011	3T	2_7	146	18	1	1800	740	-1060	0.06	0.41	3	1	-2
0011	3T	2_7	152	10	1	1000	6000	5000	0.10	6.00	1	10	9
0011	3T	2_7	153	12	2	1200	1810	610	0.17	1.51	2	3	1
0011	3T	2_7	154	8	0	800	0	-800	0.00	0.00	1	0	-1
0011	3T	2_7	156	6	0	600	0	-600	0.00	0.00	1	0	-1
0011	3T	2_7	162	10	0	1000	0	-1000	0.00	0.00	1	0	-1
0011	3T	2_7	163	16	0	1600	0	-1600	0.00	0.00	2	0	-2
0011	3T	2_7	164	12	0	1200	0	-1200	0.00	0.00	2	0	-2
0011	3T	2_7	165	7	0	700	0	-700	0.00	0.00	1	0	-1
0011	3T	2_7	213	8	2	800	2220	1420	0.25	2.78	1	3	2
0011	3T	2_7	214	5	0	500	0	-500	0.00	0.00	0	0	0
0011	3T	2_7	215	8	0	800	0	-800	0.00	0.00	1	0	-1
0011	3T	2_7	216	7	1	700	3320	2620	0.14	4.74	1	5	4
0011	3T	2_7	231	1	0	100	0	-100	0.00	0.00	0	0	0
0011	3T	2_7	234	3	0	300	0	-300	0.00	0.00	0	0	0
0011	3T	2_7	235	4	0	400	0	-400	0.00	0.00	0	0	0
0011	3T	2_7	236	9	0	900	0	-900	0.00	0.00	1	0	-1
0011	3T	2_7	241	1	0	100	0	-100	0.00	0.00	0	0	0
0011	3T	2_7	243	2	0	200	0	-200	0.00	0.00	0	0	0
0011	3T	2_7	245	3	0	300	0	-300	0.00	0.00	0	0	0
0011	3T	2_7	246	4	0	400	0	-400	0.00	0.00	0	0	0
0011	3T	2_7	251	1	0	100	0	-100	0.00	0.00	0	0	0
0011	3T	2_7	253	3	0	300	0	-300	0.00	0.00	0	0	0
0011	3T	2_7	254	2	0	200	0	-200	0.00	0.00	0	0	0
0011	3T	2_7	256	4	0	400	0	-400	0.00	0.00	0	0	0
0011	3T	2_7	261	1	0	100	0	-100	0.00	0.00	0	0	0
0011	3T	2_7	263	5	0	500	0	-500	0.00	0.00	0	0	0
0011	3T	2_7	264	2	1	200	2820	2620	0.50	14.10	0	4	4
0011	3T	2_7	265	4	0	400	0	-400	0.00	0.00	0	0	0
0011	3T	2_8	123	72	5	7200	4410	-2790	0.07	0.61	12	7	-5
0011	3T	2_8	124	74	5	7400	3530	-3870	0.07	0.48	13	6	-7
0011	3T	2_8	125	47	3	4700	3320	-1380	0.06	0.71	8	5	-3
0011	3T	2_8	126	42	2	4200	1870	-2330	0.05	0.45	7	3	-4
0011	3T	2_8	132	41	2	4100	2030	-2070	0.05	0.50	7	3	-4
0011	3T	2_8	134	44	3	4400	6990	2590	0.07	1.59	7	12	5
0011	3T	2_8	135	32	0	3200	0	-3200	0.00	0.00	5	0	-5
0011	3T	2_8	136	35	1	3500	830	-2670	0.03	0.24	6	1	-5
0011	3T	2_8	142	35	5	3500	5790	2290	0.14	1.65	6	10	4
0011	3T	2_8	143	27	1	2700	630	-2070	0.04	0.23	4	1	-3
0011	3T	2_8	145	17	2	1700	2090	390	0.12	1.23	3	3	0
0011	3T	2_8	146	14	0	1400	0	-1400	0.00	0.00	2	0	-2
0011	3T	2_8	152	11	0	1100	0	-1100	0.00	0.00	1	0	-1
0011	3T	2_8	153	9	2	900	1940	1040	0.22	2.16	1	3	2
0011	3T	2_8	154	7	0	700	0	-700	0.00	0.00	1	0	-1
0011	3T	2_8	156	10	0	1000	0	-1000	0.00	0.00	1	0	-1
0011	3T	2_8	162	9	1	900	2230	1330	0.11	2.48	1	3	2
0011	3T	2_8	163	14	1	1400	5100	3700	0.07	3.64	2	9	7
0011	3T	2_8	164	7	0	700	0	-700	0.00	0.00	1	0	-1
0011	3T	2_8	165	3	0	300	0	-300	0.00	0.00	0	0	0
0011	3T	2_8	213	13	2	1300	3480	2180	0.15	2.68	2	6	4
0011	3T	2_8	214	10	1	1000	1520	520	0.10	1.52	1	2	1
0011	3T	2_8	215	7	0	700	0	-700	0.00	0.00	1	0	-1
0011	3T	2_8	216	11	2	1100	2010	910	0.18	1.83	1	3	2
0011	3T	2_8	231	5	1	500	2320	1820	0.20	4.64	0	4	4
0011	3T	2_8	234	4	0	400	0	-400	0.00	0.00	0	0	0
0011	3T	2_8	235	2	0	200	0	-200	0.00	0.00	0	0	0
0011	3T	2_8	236	5	0	500	0	-500	0.00	0.00	0	0	0
0011	3T	2_8	241	2	1	200	1010	810	0.50	5.05	0	1	1
0011	3T	2_8	243	3	0	300	0	-300	0.00	0.00	0	0	0
0011	3T	2_8	245	1	0	100	0	-100	0.00	0.00	0	0	0
0011	3T	2_8	251	2	0	200	0	-200	0.00	0.00	0	0	0
0011	3T	2_8	253	3	0	300	0	-300	0.00	0.00	0	0	0
0011	3T	2_8	254	2	0	200	0	-200	0.00	0.00	0	0	0
0011	3T	2_8	256	2	0	200	0	-200	0.00	0.00	0	0	0
0011	3T	2_8	263	3	1	300	5270	4970	0.33	17.57	0	9	9
0011	3T	2_8	264	2	0	200	0	-200	0.00	0.00	0	0	0
0011	3T	2_8	265	2	0	200	0	-200	0.00	0.00	0	0	0
0011	3T	2_9	123	103	9	10300	7010	-3290	0.09	0.68	18	12	-6
0011	3T	2_9	124	89	7	8900	9590	690	0.08	1.08	15	16	1
0011	3T	2_9	125	43	2	4300	1580	-2720	0.05	0.37	7	2	-5
0011	3T	2_9	126	50	3	5000	1810	-3190	0.06	0.36	8	3	-5
0011	3T	2_9	132	44	1	4400	580	-3820	0.02	0.13	7	1	-6
0011	3T	2_9	134	47	3	4700	3060	-1640	0.06	0.65	8	5	-3
0011	3T	2_9	135	32	3	3200	8690	5490	0.09	2.72	5	15	10
0011	3T	2_9	136	36	0	3600	0	-3600	0.00	0.00	6	0	-6
0011	3T	2_9	142	30	1	3000	510	-2490	0.03	0.17	5	0	-5
0011	3T	2_9	143	25	1	2500	890	-1610	0.04	0.36	4	1	-3
0011	3T	2_9	145	31	1	3100	1500	-1600	0.03	0.48	5	2	-3
0011	3T	2_9	146	24	0	2400	0	-2400	0.00	0.00	4	0	-4
0011	3T	2_9	152	9	3	900	3690	2790	0.33	4.10	1	6	5
0011	3T	2_9	153	13	0	1300	0	-1300	0.00	0.00	2	0	-2
0011	3T	2_9	154	14	0	1400	0	-1400	0.00	0.00	2	0	-2
0011	3T	2_9	156	8	0	800	0	-800	0.00	0.00	1	0	-1
0011	3T	2_9	162	7	1	700	4630	3930	0.14	6.61	1	8	7
0011	3T	2_9	163	6	1	600	620	20	0.17	1.03	1	1	0
0011	3T	2_9	164	7	0	700	0	-700	0.00	0.00	1	0	-1
0011	3T	2_9	165	4	0	400	0	-400	0.00	0.00	0	0	0
0011	3T	2_9	213	9	0	900	0	-900	0.00	0.00	1	0	-1
0011	3T	2_9	214	8	0	800	0	-800	0.00	0.00	1	0	-1
0011	3T	2_9	215	8	0	800	0	-800	0.00	0.00	1	0	-1
0011	3T	2_9	216	8	0	800	0	-800	0.00	0.00	1	0	-1
0011	3T	2_9	231	3	0	300	0	-300	0.00	0.00	0	0	0
0011	3T	2_9	234	5	0	500	0	-500	0.00	0.00	0	0	0
0011	3T	2_9	235	3	0	300	0	-300	0.00	0.00	0	0	0
0011	3T	2_9	236	4	0	400	0	-400	0.00	0.00	0	0	0
0011	3T	2_9	241	2	0	200	0	-200	0.00	0.00	0	0	0
0011	3T	2_9	243	2	0	200	0	-200	0.00	0.00	0	0	0
0011	3T	2_9	245	1	0	100	0	-100	0.00	0.00	0	0	0
0011	3T	2_9	246	4	0	400	0	-400	0.00	0.00	0	0	0
0011	3T	2_9	253	3	0	300	0	-300	0.00	0.00	0	0	0
0011	3T	2_9	254	3	0	300	0	-300	0.00	0.00	0	0	0
0011	3T	2_9	256	3	0	300	0	-300	0.00	0.00	0	0	0
0011	3T	2_9	261	2	0	200	0	-200	0.00	0.00	0	0	0
0011	3T	2_9	263	1	0	100	0	-100	0.00	0.00	0	0	0
0011	3T	3_1	123	108	15	10800	18680	7880	0.14	1.73	19	33	14
0011	3T	3_1	124	83	6	8300	6820	-1480	0.07	0.82	14	12	-2
0011	3T	3_1	125	65	3	6500	7550	1050	0.05	1.16	11	13	2
0011	3T	3_1	126	37	2	3700	1580	-2120	0.05	0.43	6	2	-4
0011	3T	3_1	132	56	4	5600	5110	-490	0.07	0.91	9	9	0
0011	3T	3_1	134	71	4	7100	2360	-4740	0.06	0.33	12	4	-8
0011	3T	3_1	135	52	3	5200	5970	770	0.06	1.15	9	10	1
0011	3T	3_1	136	20	0	2000	0	-2000	0.00	0.00	3	0	-3
0011	3T	3_1	142	46	3	4600	4670	70	0.07	1.02	8	8	0
0011	3T	3_1	143	47	2	4700	2040	-2660	0.04	0.43	8	3	-5
0011	3T	3_1	145	33	2	3300	2400	-900	0.06	0.73	5	4	-1
0011	3T	3_1	146	24	0	2400	0	-2400	0.00	0.00	4	0	-4
0011	3T	3_1	152	18	0	1800	0	-1800	0.00	0.00	3	0	-3
0011	3T	3_1	153	12	1	1200	800	-400	0.08	0.67	2	1	-1
0011	3T	3_1	154	20	1	2000	1780	-220	0.05	0.89	3	3	0
0011	3T	3_1	156	5	0	500	0	-500	0.00	0.00	0	0	0
0011	3T	3_1	162	4	0	400	0	-400	0.00	0.00	0	0	0
0011	3T	3_1	163	8	0	800	0	-800	0.00	0.00	1	0	-1
0011	3T	3_1	164	3	0	300	0	-300	0.00	0.00	0	0	0
0011	3T	3_1	165	1	0	100	0	-100	0.00	0.00	0	0	0
0011	3T	3_1	213	7	0	700	0	-700	0.00	0.00	1	0	-1
0011	3T	3_1	214	5	1	500	1220	720	0.20	2.44	0	2	2
0011	3T	3_1	215	7	0	700	0	-700	0.00	0.00	1	0	-1
0011	3T	3_1	216	5	0	500	0	-500	0.00	0.00	0	0	0
0011	3T	3_1	231	1	0	100	0	-100	0.00	0.00	0	0	0
0011	3T	3_1	234	1	0	100	0	-100	0.00	0.00	0	0	0
0011	3T	3_1	235	8	0	800	0	-800	0.00	0.00	1	0	-1
0011	3T	3_1	236	2	0	200	0	-200	0.00	0.00	0	0	0
0011	3T	3_1	241	3	0	300	0	-300	0.00	0.00	0	0	0
0011	3T	3_1	243	4	0	400	0	-400	0.00	0.00	0	0	0
0011	3T	3_1	245	3	0	300	0	-300	0.00	0.00	0	0	0
0011	3T	3_1	246	1	0	100	0	-100	0.00	0.00	0	0	0
0011	3T	3_1	251	2	0	200	0	-200	0.00	0.00	0	0	0
0011	3T	3_1	253	2	0	200	0	-200	0.00	0.00	0	0	0
0011	3T	3_1	254	1	0	100	0	-100	0.00	0.00	0	0	0
0011	3T	3_1	264	1	0	100	0	-100	0.00	0.00	0	0	0
0011	3T	3_1	265	1	0	100	0	-100	0.00	0.00	0	0	0
0011	3T	3_10	123	102	7	10200	6060	-4140	0.07	0.59	18	10	-8
0011	3T	3_10	124	81	5	8100	8180	80	0.06	1.01	14	14	0
0011	3T	3_10	125	63	4	6300	10400	4100	0.06	1.65	11	18	7
0011	3T	3_10	126	54	5	5400	7450	2050	0.09	1.38	9	13	4
0011	3T	3_10	132	57	9	5700	9530	3830	0.16	1.67	10	16	6
0011	3T	3_10	134	73	5	7300	5960	-1340	0.07	0.82	12	10	-2
0011	3T	3_10	135	48	3	4800	6110	1310	0.06	1.27	8	10	2
0011	3T	3_10	136	33	0	3300	0	-3300	0.00	0.00	5	0	-5
0011	3T	3_10	142	18	0	1800	0	-1800	0.00	0.00	3	0	-3
0011	3T	3_10	143	39	2	3900	3750	-150	0.05	0.96	6	6	0
0011	3T	3_10	145	27	0	2700	0	-2700	0.00	0.00	4	0	-4
0011	3T	3_10	146	19	2	1900	3250	1350	0.11	1.71	3	5	2
0011	3T	3_10	152	8	1	800	3960	3160	0.13	4.95	1	7	6
0011	3T	3_10	153	18	0	1800	0	-1800	0.00	0.00	3	0	-3
0011	3T	3_10	154	16	0	1600	0	-1600	0.00	0.00	2	0	-2
0011	3T	3_10	156	9	2	900	3430	2530	0.22	3.81	1	6	5
0011	3T	3_10	162	5	0	500	0	-500	0.00	0.00	0	0	0
0011	3T	3_10	163	12	0	1200	0	-1200	0.00	0.00	2	0	-2
0011	3T	3_10	164	4	0	400	0	-400	0.00	0.00	0	0	0
0011	3T	3_10	165	8	0	800	0	-800	0.00	0.00	1	0	-1
0011	3T	3_10	213	7	0	700	0	-700	0.00	0.00	1	0	-1
0011	3T	3_10	214	10	1	1000	490	-510	0.10	0.49	1	0	-1
0011	3T	3_10	215	10	0	1000	0	-1000	0.00	0.00	1	0	-1
0011	3T	3_10	216	11	0	1100	0	-1100	0.00	0.00	1	0	-1
0011	3T	3_10	231	3	0	300	0	-300	0.00	0.00	0	0	0
0011	3T	3_10	234	6	0	600	0	-600	0.00	0.00	1	0	-1
0011	3T	3_10	235	1	0	100	0	-100	0.00	0.00	0	0	0
0011	3T	3_10	236	2	0	200	0	-200	0.00	0.00	0	0	0
0011	3T	3_10	243	2	0	200	0	-200	0.00	0.00	0	0	0
0011	3T	3_10	245	1	0	100	0	-100	0.00	0.00	0	0	0
0011	3T	3_10	251	1	0	100	0	-100	0.00	0.00	0	0	0
0011	3T	3_10	254	2	0	200	0	-200	0.00	0.00	0	0	0
0011	3T	3_10	256	1	0	100	0	-100	0.00	0.00	0	0	0
0011	3T	3_10	261	1	0	100	0	-100	0.00	0.00	0	0	0
0011	3T	3_10	263	2	0	200	0	-200	0.00	0.00	0	0	0
0011	3T	3_10	264	1	0	100	0	-100	0.00	0.00	0	0	0
0011	3T	3_10	265	2	0	200	0	-200	0.00	0.00	0	0	0
0011	3T	3_11	123	132	12	13200	12530	-670	0.09	0.95	23	22	-1
0011	3T	3_11	124	123	6	12300	6470	-5830	0.05	0.53	21	11	-10
0011	3T	3_11	125	88	8	8800	12590	3790	0.09	1.43	15	22	7
0011	3T	3_11	126	70	4	7000	13110	6110	0.06	1.87	12	23	11
0011	3T	3_11	132	84	7	8400	5990	-2410	0.08	0.71	14	10	-4
0011	3T	3_11	134	57	7	5700	9280	3580	0.12	1.63	10	16	6
0011	3T	3_11	135	57	1	5700	990	-4710	0.02	0.17	10	1	-9
0011	3T	3_11	136	28	1	2800	730	-2070	0.04	0.26	4	1	-3
0011	3T	3_11	142	34	0	3400	0	-3400	0.00	0.00	6	0	-6
0011	3T	3_11	143	20	0	2000	0	-2000	0.00	0.00	3	0	-3
0011	3T	3_11	145	23	1	2300	670	-1630	0.04	0.29	4	1	-3
0011	3T	3_11	146	25	4	2500	6040	3540	0.16	2.42	4	10	6
0011	3T	3_11	152	8	0	800	0	-800	0.00	0.00	1	0	-1
0011	3T	3_11	153	11	0	1100	0	-1100	0.00	0.00	1	0	-1
0011	3T	3_11	154	15	1	1500	1560	60	0.07	1.04	2	2	0
0011	3T	3_11	156	10	1	1000	1670	670	0.10	1.67	1	2	1
0011	3T	3_11	162	5	0	500	0	-500	0.00	0.00	0	0	0
0011	3T	3_11	163	6	1	600	1310	710	0.17	2.18	1	2	1
0011	3T	3_11	164	5	1	500	6730	6230	0.20	13.46	0	11	11
0011	3T	3_11	165	4	0	400	0	-400	0.00	0.00	0	0	0
0011	3T	3_11	213	1	0	100	0	-100	0.00	0.00	0	0	0
0011	3T	3_11	214	4	0	400	0	-400	0.00	0.00	0	0	0
0011	3T	3_11	231	2	0	200	0	-200	0.00	0.00	0	0	0
0011	3T	3_11	234	1	0	100	0	-100	0.00	0.00	0	0	0
0011	3T	3_11	235	1	0	100	0	-100	0.00	0.00	0	0	0
0011	3T	3_11	245	2	0	200	0	-200	0.00	0.00	0	0	0
0011	3T	3_11	253	1	0	100	0	-100	0.00	0.00	0	0	0
0011	3T	3_11	263	1	0	100	0	-100	0.00	0.00	0	0	0
0011	3T	3_12	123	162	26	16200	19600	3400	0.16	1.21	28	34	6
0011	3T	3_12	124	147	14	14700	17810	3110	0.10	1.21	26	31	5
0011	3T	3_12	125	100	7	10000	8360	-1640	0.07	0.84	17	14	-3
0011	3T	3_12	126	54	0	5400	0	-5400	0.00	0.00	9	0	-9
0011	3T	3_12	132	74	7	7400	5890	-1510	0.09	0.80	13	10	-3
0011	3T	3_12	134	79	9	7900	8180	280	0.11	1.04	13	14	1
0011	3T	3_12	135	42	1	4200	920	-3280	0.02	0.22	7	1	-6
0011	3T	3_12	136	36	3	3600	6140	2540	0.08	1.71	6	10	4
0011	3T	3_12	142	34	1	3400	1740	-1660	0.03	0.51	6	3	-3
0011	3T	3_12	143	36	1	3600	4600	1000	0.03	1.28	6	8	2
0011	3T	3_12	145	24	0	2400	0	-2400	0.00	0.00	4	0	-4
0011	3T	3_12	146	31	2	3100	3300	200	0.06	1.06	5	5	0
0011	3T	3_12	152	14	0	1400	0	-1400	0.00	0.00	2	0	-2
0011	3T	3_12	153	17	0	1700	0	-1700	0.00	0.00	3	0	-3
0011	3T	3_12	154	11	0	1100	0	-1100	0.00	0.00	1	0	-1
0011	3T	3_12	156	13	0	1300	0	-1300	0.00	0.00	2	0	-2
0011	3T	3_12	162	3	0	300	0	-300	0.00	0.00	0	0	0
0011	3T	3_12	163	7	1	700	1120	420	0.14	1.60	1	1	0
0011	3T	3_12	164	2	0	200	0	-200	0.00	0.00	0	0	0
0011	3T	3_12	165	1	0	100	0	-100	0.00	0.00	0	0	0
0011	3T	3_12	213	1	0	100	0	-100	0.00	0.00	0	0	0
0011	3T	3_12	214	2	0	200	0	-200	0.00	0.00	0	0	0
0011	3T	3_12	215	2	0	200	0	-200	0.00	0.00	0	0	0
0011	3T	3_12	216	1	0	100	0	-100	0.00	0.00	0	0	0
0011	3T	3_12	234	2	0	200	0	-200	0.00	0.00	0	0	0
0011	3T	3_12	263	1	0	100	0	-100	0.00	0.00	0	0	0
0011	3T	3_2	123	91	5	9100	5800	-3300	0.05	0.64	16	10	-6
0011	3T	3_2	124	72	7	7200	8430	1230	0.10	1.17	12	14	2
0011	3T	3_2	125	50	0	5000	0	-5000	0.00	0.00	8	0	-8
0011	3T	3_2	126	43	0	4300	0	-4300	0.00	0.00	7	0	-7
0011	3T	3_2	132	51	3	5100	3950	-1150	0.06	0.77	9	6	-3
0011	3T	3_2	134	40	3	4000	3020	-980	0.08	0.76	7	5	-2
0011	3T	3_2	135	34	1	3400	1390	-2010	0.03	0.41	6	2	-4
0011	3T	3_2	136	31	1	3100	1850	-1250	0.03	0.60	5	3	-2
0011	3T	3_2	142	38	1	3800	2100	-1700	0.03	0.55	6	3	-3
0011	3T	3_2	143	35	0	3500	0	-3500	0.00	0.00	6	0	-6
0011	3T	3_2	145	33	1	3300	16110	12810	0.03	4.88	5	28	23
0011	3T	3_2	146	13	0	1300	0	-1300	0.00	0.00	2	0	-2
0011	3T	3_2	152	17	0	1700	0	-1700	0.00	0.00	3	0	-3
0011	3T	3_2	153	21	1	2100	3110	1010	0.05	1.48	3	5	2
0011	3T	3_2	154	11	0	1100	0	-1100	0.00	0.00	1	0	-1
0011	3T	3_2	156	11	0	1100	0	-1100	0.00	0.00	1	0	-1
0011	3T	3_2	162	5	0	500	0	-500	0.00	0.00	0	0	0
0011	3T	3_2	163	3	0	300	0	-300	0.00	0.00	0	0	0
0011	3T	3_2	164	4	0	400	0	-400	0.00	0.00	0	0	0
0011	3T	3_2	165	5	0	500	0	-500	0.00	0.00	0	0	0
0011	3T	3_2	213	12	1	1200	2200	1000	0.08	1.83	2	3	1
0011	3T	3_2	214	8	0	800	0	-800	0.00	0.00	1	0	-1
0011	3T	3_2	215	5	1	500	1500	1000	0.20	3.00	0	2	2
0011	3T	3_2	216	4	0	400	0	-400	0.00	0.00	0	0	0
0011	3T	3_2	231	6	0	600	0	-600	0.00	0.00	1	0	-1
0011	3T	3_2	234	6	0	600	0	-600	0.00	0.00	1	0	-1
0011	3T	3_2	235	10	0	1000	0	-1000	0.00	0.00	1	0	-1
0011	3T	3_2	236	3	0	300	0	-300	0.00	0.00	0	0	0
0011	3T	3_2	241	4	0	400	0	-400	0.00	0.00	0	0	0
0011	3T	3_2	243	6	0	600	0	-600	0.00	0.00	1	0	-1
0011	3T	3_2	245	6	0	600	0	-600	0.00	0.00	1	0	-1
0011	3T	3_2	246	3	0	300	0	-300	0.00	0.00	0	0	0
0011	3T	3_2	253	3	0	300	0	-300	0.00	0.00	0	0	0
0011	3T	3_2	254	4	0	400	0	-400	0.00	0.00	0	0	0
0011	3T	3_2	261	1	0	100	0	-100	0.00	0.00	0	0	0
0011	3T	3_2	263	1	0	100	0	-100	0.00	0.00	0	0	0
0011	3T	3_2	264	3	0	300	0	-300	0.00	0.00	0	0	0
0011	3T	3_3	123	93	6	9300	7410	-1890	0.06	0.80	16	13	-3
0011	3T	3_3	124	84	5	8400	11320	2920	0.06	1.35	14	20	6
0011	3T	3_3	125	41	3	4100	4810	710	0.07	1.17	7	8	1
0011	3T	3_3	126	31	0	3100	0	-3100	0.00	0.00	5	0	-5
0011	3T	3_3	132	44	5	4400	9340	4940	0.11	2.12	7	16	9
0011	3T	3_3	134	63	4	6300	7540	1240	0.06	1.20	11	13	2
0011	3T	3_3	135	56	1	5600	1500	-4100	0.02	0.27	9	2	-7
0011	3T	3_3	136	31	0	3100	0	-3100	0.00	0.00	5	0	-5
0011	3T	3_3	142	35	2	3500	3270	-230	0.06	0.93	6	5	-1
0011	3T	3_3	143	28	4	2800	6090	3290	0.14	2.18	4	10	6
0011	3T	3_3	145	26	0	2600	0	-2600	0.00	0.00	4	0	-4
0011	3T	3_3	146	17	0	1700	0	-1700	0.00	0.00	3	0	-3
0011	3T	3_3	152	8	0	800	0	-800	0.00	0.00	1	0	-1
0011	3T	3_3	153	15	0	1500	0	-1500	0.00	0.00	2	0	-2
0011	3T	3_3	154	14	0	1400	0	-1400	0.00	0.00	2	0	-2
0011	3T	3_3	156	11	1	1100	5450	4350	0.09	4.95	1	9	8
0011	3T	3_3	162	5	0	500	0	-500	0.00	0.00	0	0	0
0011	3T	3_3	163	8	0	800	0	-800	0.00	0.00	1	0	-1
0011	3T	3_3	164	5	0	500	0	-500	0.00	0.00	0	0	0
0011	3T	3_3	165	6	0	600	0	-600	0.00	0.00	1	0	-1
0011	3T	3_3	213	13	0	1300	0	-1300	0.00	0.00	2	0	-2
0011	3T	3_3	214	8	1	800	5300	4500	0.13	6.63	1	9	8
0011	3T	3_3	215	4	0	400	0	-400	0.00	0.00	0	0	0
0011	3T	3_3	216	6	0	600	0	-600	0.00	0.00	1	0	-1
0011	3T	3_3	231	4	0	400	0	-400	0.00	0.00	0	0	0
0011	3T	3_3	234	9	0	900	0	-900	0.00	0.00	1	0	-1
0011	3T	3_3	235	9	1	900	1870	970	0.11	2.08	1	3	2
0011	3T	3_3	236	7	0	700	0	-700	0.00	0.00	1	0	-1
0011	3T	3_3	241	1	0	100	0	-100	0.00	0.00	0	0	0
0011	3T	3_3	243	6	0	600	0	-600	0.00	0.00	1	0	-1
0011	3T	3_3	245	3	0	300	0	-300	0.00	0.00	0	0	0
0011	3T	3_3	246	3	0	300	0	-300	0.00	0.00	0	0	0
0011	3T	3_3	251	1	0	100	0	-100	0.00	0.00	0	0	0
0011	3T	3_3	253	2	0	200	0	-200	0.00	0.00	0	0	0
0011	3T	3_3	254	4	0	400	0	-400	0.00	0.00	0	0	0
0011	3T	3_3	256	1	0	100	0	-100	0.00	0.00	0	0	0
0011	3T	3_3	261	1	0	100	0	-100	0.00	0.00	0	0	0
0011	3T	3_3	264	1	0	100	0	-100	0.00	0.00	0	0	0
0011	3T	3_3	265	1	0	100	0	-100	0.00	0.00	0	0	0
0011	3T	3_4	123	76	5	7600	9910	2310	0.07	1.30	13	17	4
0011	3T	3_4	124	72	4	7200	1660	-5540	0.06	0.23	12	2	-10
0011	3T	3_4	125	55	3	5500	4150	-1350	0.05	0.75	9	7	-2
0011	3T	3_4	126	53	1	5300	4000	-1300	0.02	0.75	9	7	-2
0011	3T	3_4	132	51	2	5100	1800	-3300	0.04	0.35	9	3	-6
0011	3T	3_4	134	63	5	6300	7590	1290	0.08	1.20	11	13	2
0011	3T	3_4	135	37	2	3700	2190	-1510	0.05	0.59	6	3	-3
0011	3T	3_4	136	23	3	2300	7460	5160	0.13	3.24	4	13	9
0011	3T	3_4	142	19	0	1900	0	-1900	0.00	0.00	3	0	-3
0011	3T	3_4	143	32	2	3200	20820	17620	0.06	6.51	5	36	31
0011	3T	3_4	145	14	2	1400	1780	380	0.14	1.27	2	3	1
0011	3T	3_4	146	18	1	1800	3550	1750	0.06	1.97	3	6	3
0011	3T	3_4	152	12	0	1200	0	-1200	0.00	0.00	2	0	-2
0011	3T	3_4	153	13	1	1300	1740	440	0.08	1.34	2	3	1
0011	3T	3_4	154	12	1	1200	3360	2160	0.08	2.80	2	5	3
0011	3T	3_4	156	15	0	1500	0	-1500	0.00	0.00	2	0	-2
0011	3T	3_4	162	10	0	1000	0	-1000	0.00	0.00	1	0	-1
0011	3T	3_4	163	5	0	500	0	-500	0.00	0.00	0	0	0
0011	3T	3_4	164	7	0	700	0	-700	0.00	0.00	1	0	-1
0011	3T	3_4	165	3	0	300	0	-300	0.00	0.00	0	0	0
0011	3T	3_4	213	8	0	800	0	-800	0.00	0.00	1	0	-1
0011	3T	3_4	214	10	0	1000	0	-1000	0.00	0.00	1	0	-1
0011	3T	3_4	215	14	1	1400	770	-630	0.07	0.55	2	1	-1
0011	3T	3_4	216	7	0	700	0	-700	0.00	0.00	1	0	-1
0011	3T	3_4	231	2	0	200	0	-200	0.00	0.00	0	0	0
0011	3T	3_4	234	11	0	1100	0	-1100	0.00	0.00	1	0	-1
0011	3T	3_4	235	8	0	800	0	-800	0.00	0.00	1	0	-1
0011	3T	3_4	236	5	0	500	0	-500	0.00	0.00	0	0	0
0011	3T	3_4	243	2	1	200	1820	1620	0.50	9.10	0	3	3
0011	3T	3_4	245	2	0	200	0	-200	0.00	0.00	0	0	0
0011	3T	3_4	246	1	0	100	0	-100	0.00	0.00	0	0	0
0011	3T	3_4	251	1	0	100	0	-100	0.00	0.00	0	0	0
0011	3T	3_4	253	6	0	600	0	-600	0.00	0.00	1	0	-1
0011	3T	3_4	254	3	0	300	0	-300	0.00	0.00	0	0	0
0011	3T	3_4	256	2	0	200	0	-200	0.00	0.00	0	0	0
0011	3T	3_4	261	1	1	100	2330	2230	1.00	23.30	0	4	4
0011	3T	3_4	263	3	0	300	0	-300	0.00	0.00	0	0	0
0011	3T	3_4	264	2	0	200	0	-200	0.00	0.00	0	0	0
0011	3T	3_4	265	1	0	100	0	-100	0.00	0.00	0	0	0
0011	3T	3_5	123	92	11	9200	7690	-1510	0.12	0.84	16	13	-3
0011	3T	3_5	124	85	9	8500	17320	8820	0.11	2.04	15	30	15
0011	3T	3_5	125	66	6	6600	10950	4350	0.09	1.66	11	19	8
0011	3T	3_5	126	40	3	4000	9260	5260	0.08	2.32	7	16	9
0011	3T	3_5	132	41	1	4100	800	-3300	0.02	0.20	7	1	-6
0011	3T	3_5	134	62	5	6200	6800	600	0.08	1.10	10	12	2
0011	3T	3_5	135	35	2	3500	10900	7400	0.06	3.11	6	19	13
0011	3T	3_5	136	34	0	3400	0	-3400	0.00	0.00	6	0	-6
0011	3T	3_5	142	24	2	2400	1760	-640	0.08	0.73	4	3	-1
0011	3T	3_5	143	32	1	3200	940	-2260	0.03	0.29	5	1	-4
0011	3T	3_5	145	25	2	2500	3930	1430	0.08	1.57	4	6	2
0011	3T	3_5	146	12	0	1200	0	-1200	0.00	0.00	2	0	-2
0011	3T	3_5	152	10	0	1000	0	-1000	0.00	0.00	1	0	-1
0011	3T	3_5	153	7	0	700	0	-700	0.00	0.00	1	0	-1
0011	3T	3_5	154	11	1	1100	5180	4080	0.09	4.71	1	9	8
0011	3T	3_5	156	9	1	900	2730	1830	0.11	3.03	1	4	3
0011	3T	3_5	162	7	0	700	0	-700	0.00	0.00	1	0	-1
0011	3T	3_5	163	13	0	1300	0	-1300	0.00	0.00	2	0	-2
0011	3T	3_5	164	6	0	600	0	-600	0.00	0.00	1	0	-1
0011	3T	3_5	165	4	0	400	0	-400	0.00	0.00	0	0	0
0011	3T	3_5	213	13	1	1300	1850	550	0.08	1.42	2	3	1
0011	3T	3_5	214	8	1	800	1120	320	0.13	1.40	1	1	0
0011	3T	3_5	215	8	0	800	0	-800	0.00	0.00	1	0	-1
0011	3T	3_5	216	8	0	800	0	-800	0.00	0.00	1	0	-1
0011	3T	3_5	231	2	0	200	0	-200	0.00	0.00	0	0	0
0011	3T	3_5	234	5	0	500	0	-500	0.00	0.00	0	0	0
0011	3T	3_5	241	2	0	200	0	-200	0.00	0.00	0	0	0
0011	3T	3_5	243	6	0	600	0	-600	0.00	0.00	1	0	-1
0011	3T	3_5	245	4	0	400	0	-400	0.00	0.00	0	0	0
0011	3T	3_5	246	3	0	300	0	-300	0.00	0.00	0	0	0
0011	3T	3_5	251	2	0	200	0	-200	0.00	0.00	0	0	0
0011	3T	3_5	253	2	1	200	520	320	0.50	2.60	0	0	0
0011	3T	3_5	254	1	0	100	0	-100	0.00	0.00	0	0	0
0011	3T	3_5	256	2	0	200	0	-200	0.00	0.00	0	0	0
0011	3T	3_5	261	1	0	100	0	-100	0.00	0.00	0	0	0
0011	3T	3_5	263	1	0	100	0	-100	0.00	0.00	0	0	0
0011	3T	3_5	264	3	0	300	0	-300	0.00	0.00	0	0	0
0011	3T	3_5	265	2	0	200	0	-200	0.00	0.00	0	0	0
0011	3T	3_6	123	73	10	7300	9320	2020	0.14	1.28	12	16	4
0011	3T	3_6	124	69	4	6900	6520	-380	0.06	0.94	12	11	-1
0011	3T	3_6	125	37	1	3700	910	-2790	0.03	0.25	6	1	-5
0011	3T	3_6	126	38	2	3800	1760	-2040	0.05	0.46	6	3	-3
0011	3T	3_6	132	46	4	4600	3840	-760	0.09	0.83	8	6	-2
0011	3T	3_6	134	46	6	4600	13280	8680	0.13	2.89	8	23	15
0011	3T	3_6	135	36	2	3600	1820	-1780	0.06	0.51	6	3	-3
0011	3T	3_6	136	26	1	2600	1130	-1470	0.04	0.43	4	2	-2
0011	3T	3_6	142	23	0	2300	0	-2300	0.00	0.00	4	0	-4
0011	3T	3_6	143	27	0	2700	0	-2700	0.00	0.00	4	0	-4
0011	3T	3_6	145	15	1	1500	2230	730	0.07	1.49	2	3	1
0011	3T	3_6	146	20	0	2000	0	-2000	0.00	0.00	3	0	-3
0011	3T	3_6	152	16	2	1600	2280	680	0.13	1.43	2	4	2
0011	3T	3_6	153	7	1	700	2830	2130	0.14	4.04	1	5	4
0011	3T	3_6	154	14	0	1400	0	-1400	0.00	0.00	2	0	-2
0011	3T	3_6	156	7	1	700	9210	8510	0.14	13.16	1	16	15
0011	3T	3_6	162	4	0	400	0	-400	0.00	0.00	0	0	0
0011	3T	3_6	163	10	1	1000	2920	1920	0.10	2.92	1	5	4
0011	3T	3_6	164	8	0	800	0	-800	0.00	0.00	1	0	-1
0011	3T	3_6	165	4	0	400	0	-400	0.00	0.00	0	0	0
0011	3T	3_6	213	12	1	1200	1080	-120	0.08	0.90	2	1	-1
0011	3T	3_6	214	16	0	1600	0	-1600	0.00	0.00	2	0	-2
0011	3T	3_6	215	7	0	700	0	-700	0.00	0.00	1	0	-1
0011	3T	3_6	216	20	1	2000	820	-1180	0.05	0.41	3	1	-2
0011	3T	3_6	231	4	0	400	0	-400	0.00	0.00	0	0	0
0011	3T	3_6	234	7	0	700	0	-700	0.00	0.00	1	0	-1
0011	3T	3_6	235	6	0	600	0	-600	0.00	0.00	1	0	-1
0011	3T	3_6	236	11	0	1100	0	-1100	0.00	0.00	1	0	-1
0011	3T	3_6	241	4	0	400	0	-400	0.00	0.00	0	0	0
0011	3T	3_6	243	7	1	700	3190	2490	0.14	4.56	1	5	4
0011	3T	3_6	245	3	0	300	0	-300	0.00	0.00	0	0	0
0011	3T	3_6	246	5	0	500	0	-500	0.00	0.00	0	0	0
0011	3T	3_6	251	4	0	400	0	-400	0.00	0.00	0	0	0
0011	3T	3_6	253	8	0	800	0	-800	0.00	0.00	1	0	-1
0011	3T	3_6	254	1	0	100	0	-100	0.00	0.00	0	0	0
0011	3T	3_6	256	5	0	500	0	-500	0.00	0.00	0	0	0
0011	3T	3_6	261	1	0	100	0	-100	0.00	0.00	0	0	0
0011	3T	3_6	263	6	0	600	0	-600	0.00	0.00	1	0	-1
0011	3T	3_6	264	2	0	200	0	-200	0.00	0.00	0	0	0
0011	3T	3_6	265	1	0	100	0	-100	0.00	0.00	0	0	0
0011	3T	3_7	123	70	5	7000	7280	280	0.07	1.04	12	12	0
0011	3T	3_7	124	69	3	6900	3350	-3550	0.04	0.49	12	5	-7
0011	3T	3_7	125	46	1	4600	540	-4060	0.02	0.12	8	0	-8
0011	3T	3_7	126	45	2	4500	1630	-2870	0.04	0.36	7	2	-5
0011	3T	3_7	132	40	1	4000	510	-3490	0.03	0.13	7	0	-7
0011	3T	3_7	134	58	4	5800	21310	15510	0.07	3.67	10	37	27
0011	3T	3_7	135	37	1	3700	890	-2810	0.03	0.24	6	1	-5
0011	3T	3_7	136	32	0	3200	0	-3200	0.00	0.00	5	0	-5
0011	3T	3_7	142	35	3	3500	6090	2590	0.09	1.74	6	10	4
0011	3T	3_7	143	26	1	2600	830	-1770	0.04	0.32	4	1	-3
0011	3T	3_7	145	26	1	2600	670	-1930	0.04	0.26	4	1	-3
0011	3T	3_7	146	14	0	1400	0	-1400	0.00	0.00	2	0	-2
0011	3T	3_7	152	8	0	800	0	-800	0.00	0.00	1	0	-1
0011	3T	3_7	153	15	0	1500	0	-1500	0.00	0.00	2	0	-2
0011	3T	3_7	154	12	1	1200	1610	410	0.08	1.34	2	2	0
0011	3T	3_7	156	6	0	600	0	-600	0.00	0.00	1	0	-1
0011	3T	3_7	162	5	0	500	0	-500	0.00	0.00	0	0	0
0011	3T	3_7	163	7	0	700	0	-700	0.00	0.00	1	0	-1
0011	3T	3_7	164	9	0	900	0	-900	0.00	0.00	1	0	-1
0011	3T	3_7	165	5	1	500	29400	28900	0.20	58.80	0	52	52
0011	3T	3_7	213	8	0	800	0	-800	0.00	0.00	1	0	-1
0011	3T	3_7	214	12	0	1200	0	-1200	0.00	0.00	2	0	-2
0011	3T	3_7	215	6	0	600	0	-600	0.00	0.00	1	0	-1
0011	3T	3_7	216	6	0	600	0	-600	0.00	0.00	1	0	-1
0011	3T	3_7	231	4	0	400	0	-400	0.00	0.00	0	0	0
0011	3T	3_7	234	7	1	700	1830	1130	0.14	2.61	1	3	2
0011	3T	3_7	235	10	0	1000	0	-1000	0.00	0.00	1	0	-1
0011	3T	3_7	236	7	0	700	0	-700	0.00	0.00	1	0	-1
0011	3T	3_7	243	1	0	100	0	-100	0.00	0.00	0	0	0
0011	3T	3_7	245	6	0	600	0	-600	0.00	0.00	1	0	-1
0011	3T	3_7	246	3	0	300	0	-300	0.00	0.00	0	0	0
0011	3T	3_7	251	2	0	200	0	-200	0.00	0.00	0	0	0
0011	3T	3_7	253	1	0	100	0	-100	0.00	0.00	0	0	0
0011	3T	3_7	254	1	0	100	0	-100	0.00	0.00	0	0	0
0011	3T	3_7	256	2	0	200	0	-200	0.00	0.00	0	0	0
0011	3T	3_7	261	2	0	200	0	-200	0.00	0.00	0	0	0
0011	3T	3_7	263	3	0	300	0	-300	0.00	0.00	0	0	0
0011	3T	3_7	264	1	0	100	0	-100	0.00	0.00	0	0	0
0011	3T	3_7	265	4	0	400	0	-400	0.00	0.00	0	0	0
0011	3T	3_8	123	85	7	8500	7940	-560	0.08	0.93	15	14	-1
0011	3T	3_8	124	58	3	5800	2040	-3760	0.05	0.35	10	3	-7
0011	3T	3_8	125	53	4	5300	2770	-2530	0.08	0.52	9	4	-5
0011	3T	3_8	126	24	1	2400	4150	1750	0.04	1.73	4	7	3
0011	3T	3_8	132	48	7	4800	8060	3260	0.15	1.68	8	14	6
0011	3T	3_8	134	57	6	5700	7640	1940	0.11	1.34	10	13	3
0011	3T	3_8	135	48	3	4800	1970	-2830	0.06	0.41	8	3	-5
0011	3T	3_8	136	28	1	2800	1290	-1510	0.04	0.46	4	2	-2
0011	3T	3_8	142	25	1	2500	1030	-1470	0.04	0.41	4	1	-3
0011	3T	3_8	143	32	2	3200	4180	980	0.06	1.31	5	7	2
0011	3T	3_8	145	17	0	1700	0	-1700	0.00	0.00	3	0	-3
0011	3T	3_8	146	19	0	1900	0	-1900	0.00	0.00	3	0	-3
0011	3T	3_8	152	18	1	1800	12030	10230	0.06	6.68	3	21	18
0011	3T	3_8	153	19	0	1900	0	-1900	0.00	0.00	3	0	-3
0011	3T	3_8	154	13	1	1300	830	-470	0.08	0.64	2	1	-1
0011	3T	3_8	156	4	0	400	0	-400	0.00	0.00	0	0	0
0011	3T	3_8	162	6	0	600	0	-600	0.00	0.00	1	0	-1
0011	3T	3_8	163	11	0	1100	0	-1100	0.00	0.00	1	0	-1
0011	3T	3_8	164	6	0	600	0	-600	0.00	0.00	1	0	-1
0011	3T	3_8	165	5	0	500	0	-500	0.00	0.00	0	0	0
0011	3T	3_8	213	15	0	1500	0	-1500	0.00	0.00	2	0	-2
0011	3T	3_8	214	12	2	1200	1250	50	0.17	1.04	2	2	0
0011	3T	3_8	215	7	1	700	990	290	0.14	1.41	1	1	0
0011	3T	3_8	216	4	0	400	0	-400	0.00	0.00	0	0	0
0011	3T	3_8	231	5	0	500	0	-500	0.00	0.00	0	0	0
0011	3T	3_8	234	7	0	700	0	-700	0.00	0.00	1	0	-1
0011	3T	3_8	235	7	1	700	5260	4560	0.14	7.51	1	9	8
0011	3T	3_8	236	5	0	500	0	-500	0.00	0.00	0	0	0
0011	3T	3_8	241	2	0	200	0	-200	0.00	0.00	0	0	0
0011	3T	3_8	243	8	0	800	0	-800	0.00	0.00	1	0	-1
0011	3T	3_8	245	2	0	200	0	-200	0.00	0.00	0	0	0
0011	3T	3_8	246	2	0	200	0	-200	0.00	0.00	0	0	0
0011	3T	3_8	251	2	0	200	0	-200	0.00	0.00	0	0	0
0011	3T	3_8	253	2	0	200	0	-200	0.00	0.00	0	0	0
0011	3T	3_8	254	2	0	200	0	-200	0.00	0.00	0	0	0
0011	3T	3_8	256	3	0	300	0	-300	0.00	0.00	0	0	0
0011	3T	3_8	261	1	0	100	0	-100	0.00	0.00	0	0	0
0011	3T	3_8	263	1	0	100	0	-100	0.00	0.00	0	0	0
0011	3T	3_8	264	3	0	300	0	-300	0.00	0.00	0	0	0
0011	3T	3_8	265	1	0	100	0	-100	0.00	0.00	0	0	0
0011	3T	3_9	123	90	13	9000	19900	10900	0.14	2.21	15	35	20
0011	3T	3_9	124	79	5	7900	4010	-3890	0.06	0.51	13	7	-6
0011	3T	3_9	125	62	2	6200	2500	-3700	0.03	0.40	10	4	-6
0011	3T	3_9	126	47	4	4700	7650	2950	0.09	1.63	8	13	5
0011	3T	3_9	132	54	3	5400	2940	-2460	0.06	0.54	9	5	-4
0011	3T	3_9	134	51	3	5100	1840	-3260	0.06	0.36	9	3	-6
0011	3T	3_9	135	30	1	3000	3060	60	0.03	1.02	5	5	0
0011	3T	3_9	136	23	2	2300	2090	-210	0.09	0.91	4	3	-1
0011	3T	3_9	142	30	2	3000	3500	500	0.07	1.17	5	6	1
0011	3T	3_9	143	33	1	3300	1150	-2150	0.03	0.35	5	2	-3
0011	3T	3_9	145	20	0	2000	0	-2000	0.00	0.00	3	0	-3
0011	3T	3_9	146	9	0	900	0	-900	0.00	0.00	1	0	-1
0011	3T	3_9	152	13	1	1300	640	-660	0.08	0.49	2	1	-1
0011	3T	3_9	153	12	0	1200	0	-1200	0.00	0.00	2	0	-2
0011	3T	3_9	154	12	1	1200	1500	300	0.08	1.25	2	2	0
0011	3T	3_9	156	11	0	1100	0	-1100	0.00	0.00	1	0	-1
0011	3T	3_9	162	6	0	600	0	-600	0.00	0.00	1	0	-1
0011	3T	3_9	163	4	1	400	1380	980	0.25	3.45	0	2	2
0011	3T	3_9	164	7	0	700	0	-700	0.00	0.00	1	0	-1
0011	3T	3_9	165	2	0	200	0	-200	0.00	0.00	0	0	0
0011	3T	3_9	213	15	2	1500	2470	970	0.13	1.65	2	4	2
0011	3T	3_9	214	12	1	1200	730	-470	0.08	0.61	2	1	-1
0011	3T	3_9	215	7	0	700	0	-700	0.00	0.00	1	0	-1
0011	3T	3_9	216	7	0	700	0	-700	0.00	0.00	1	0	-1
0011	3T	3_9	231	3	0	300	0	-300	0.00	0.00	0	0	0
0011	3T	3_9	234	5	0	500	0	-500	0.00	0.00	0	0	0
0011	3T	3_9	235	2	0	200	0	-200	0.00	0.00	0	0	0
0011	3T	3_9	236	2	0	200	0	-200	0.00	0.00	0	0	0
0011	3T	3_9	241	3	0	300	0	-300	0.00	0.00	0	0	0
0011	3T	3_9	243	2	0	200	0	-200	0.00	0.00	0	0	0
0011	3T	3_9	245	2	0	200	0	-200	0.00	0.00	0	0	0
0011	3T	3_9	246	1	0	100	0	-100	0.00	0.00	0	0	0
0011	3T	3_9	253	3	0	300	0	-300	0.00	0.00	0	0	0
0011	3T	3_9	254	1	0	100	0	-100	0.00	0.00	0	0	0
0011	3T	3_9	256	2	0	200	0	-200	0.00	0.00	0	0	0
0011	3T	3_9	261	1	0	100	0	-100	0.00	0.00	0	0	0
0011	3T	3_9	263	2	0	200	0	-200	0.00	0.00	0	0	0
0011	3T	3_9	265	1	0	100	0	-100	0.00	0.00	0	0	0
0011	3T	4_1	123	99	17	9900	12610	2710	0.17	1.27	17	22	5
0011	3T	4_1	124	65	9	6500	6790	290	0.14	1.04	11	12	1
0011	3T	4_1	125	38	1	3800	540	-3260	0.03	0.14	6	0	-6
0011	3T	4_1	126	28	0	2800	0	-2800	0.00	0.00	4	0	-4
0011	3T	4_1	132	37	4	3700	3780	80	0.11	1.02	6	6	0
0011	3T	4_1	134	48	4	4800	3330	-1470	0.08	0.69	8	5	-3
0011	3T	4_1	135	26	0	2600	0	-2600	0.00	0.00	4	0	-4
0011	3T	4_1	136	20	0	2000	0	-2000	0.00	0.00	3	0	-3
0011	3T	4_1	142	29	1	2900	930	-1970	0.03	0.32	5	1	-4
0011	3T	4_1	143	40	2	4000	2350	-1650	0.05	0.59	7	4	-3
0011	3T	4_1	145	16	1	1600	1530	-70	0.06	0.96	2	2	0
0011	3T	4_1	146	10	0	1000	0	-1000	0.00	0.00	1	0	-1
0011	3T	4_1	152	11	1	1100	2460	1360	0.09	2.24	1	4	3
0011	3T	4_1	153	6	0	600	0	-600	0.00	0.00	1	0	-1
0011	3T	4_1	154	2	0	200	0	-200	0.00	0.00	0	0	0
0011	3T	4_1	156	5	0	500	0	-500	0.00	0.00	0	0	0
0011	3T	4_1	162	6	1	600	2070	1470	0.17	3.45	1	3	2
0011	3T	4_1	163	7	1	700	4490	3790	0.14	6.41	1	7	6
0011	3T	4_1	164	3	0	300	0	-300	0.00	0.00	0	0	0
0011	3T	4_1	165	1	0	100	0	-100	0.00	0.00	0	0	0
0011	3T	4_1	213	6	0	600	0	-600	0.00	0.00	1	0	-1
0011	3T	4_1	214	2	0	200	0	-200	0.00	0.00	0	0	0
0011	3T	4_1	215	2	0	200	0	-200	0.00	0.00	0	0	0
0011	3T	4_1	216	3	0	300	0	-300	0.00	0.00	0	0	0
0011	3T	4_1	231	2	0	200	0	-200	0.00	0.00	0	0	0
0011	3T	4_1	234	4	0	400	0	-400	0.00	0.00	0	0	0
0011	3T	4_1	235	3	0	300	0	-300	0.00	0.00	0	0	0
0011	3T	4_1	236	1	0	100	0	-100	0.00	0.00	0	0	0
0011	3T	4_1	241	3	0	300	0	-300	0.00	0.00	0	0	0
0011	3T	4_1	243	1	0	100	0	-100	0.00	0.00	0	0	0
0011	3T	4_1	245	1	0	100	0	-100	0.00	0.00	0	0	0
0011	3T	4_1	253	1	0	100	0	-100	0.00	0.00	0	0	0
0011	3T	4_1	254	1	0	100	0	-100	0.00	0.00	0	0	0
0011	3T	4_1	261	1	0	100	0	-100	0.00	0.00	0	0	0
0011	3T	4_1	263	3	1	300	4110	3810	0.33	13.70	0	7	7
0011	3T	4_1	265	1	0	100	0	-100	0.00	0.00	0	0	0
0011	3T	4_10	123	133	7	13300	5260	-8040	0.05	0.40	23	9	-14
0011	3T	4_10	124	88	3	8800	5010	-3790	0.03	0.57	15	8	-7
0011	3T	4_10	125	54	0	5400	0	-5400	0.00	0.00	9	0	-9
0011	3T	4_10	126	47	3	4700	2960	-1740	0.06	0.63	8	5	-3
0011	3T	4_10	132	68	4	6800	14690	7890	0.06	2.16	12	26	14
0011	3T	4_10	134	61	5	6100	6210	110	0.08	1.02	10	10	0
0011	3T	4_10	135	18	2	1800	5650	3850	0.11	3.14	3	10	7
0011	3T	4_10	136	22	0	2200	0	-2200	0.00	0.00	3	0	-3
0011	3T	4_10	142	35	1	3500	2610	-890	0.03	0.75	6	4	-2
0011	3T	4_10	143	41	1	4100	580	-3520	0.02	0.14	7	1	-6
0011	3T	4_10	145	22	0	2200	0	-2200	0.00	0.00	3	0	-3
0011	3T	4_10	146	22	0	2200	0	-2200	0.00	0.00	3	0	-3
0011	3T	4_10	152	8	1	800	1750	950	0.13	2.19	1	3	2
0011	3T	4_10	153	14	0	1400	0	-1400	0.00	0.00	2	0	-2
0011	3T	4_10	154	8	0	800	0	-800	0.00	0.00	1	0	-1
0011	3T	4_10	156	4	0	400	0	-400	0.00	0.00	0	0	0
0011	3T	4_10	162	3	0	300	0	-300	0.00	0.00	0	0	0
0011	3T	4_10	163	3	0	300	0	-300	0.00	0.00	0	0	0
0011	3T	4_10	164	1	0	100	0	-100	0.00	0.00	0	0	0
0011	3T	4_10	213	4	0	400	0	-400	0.00	0.00	0	0	0
0011	3T	4_10	214	6	0	600	0	-600	0.00	0.00	1	0	-1
0011	3T	4_10	216	3	0	300	0	-300	0.00	0.00	0	0	0
0011	3T	4_10	231	1	0	100	0	-100	0.00	0.00	0	0	0
0011	3T	4_10	234	2	0	200	0	-200	0.00	0.00	0	0	0
0011	3T	4_10	236	1	0	100	0	-100	0.00	0.00	0	0	0
0011	3T	4_10	241	1	0	100	0	-100	0.00	0.00	0	0	0
0011	3T	4_10	243	1	0	100	0	-100	0.00	0.00	0	0	0
0011	3T	4_10	245	2	0	200	0	-200	0.00	0.00	0	0	0
0011	3T	4_10	251	1	0	100	0	-100	0.00	0.00	0	0	0
0011	3T	4_10	254	1	0	100	0	-100	0.00	0.00	0	0	0
0011	3T	4_10	256	1	0	100	0	-100	0.00	0.00	0	0	0
0011	3T	4_11	123	140	18	14000	18830	4830	0.13	1.35	24	33	9
0011	3T	4_11	124	103	5	10300	7620	-2680	0.05	0.74	18	13	-5
0011	3T	4_11	125	83	6	8300	6610	-1690	0.07	0.80	14	11	-3
0011	3T	4_11	126	34	2	3400	2270	-1130	0.06	0.67	6	4	-2
0011	3T	4_11	132	68	6	6800	7940	1140	0.09	1.17	12	14	2
0011	3T	4_11	134	58	4	5800	4250	-1550	0.07	0.73	10	7	-3
0011	3T	4_11	135	38	1	3800	1400	-2400	0.03	0.37	6	2	-4
0011	3T	4_11	136	30	1	3000	4090	1090	0.03	1.36	5	7	2
0011	3T	4_11	142	41	3	4100	8140	4040	0.07	1.99	7	14	7
0011	3T	4_11	143	52	0	5200	0	-5200	0.00	0.00	9	0	-9
0011	3T	4_11	145	23	1	2300	940	-1360	0.04	0.41	4	1	-3
0011	3T	4_11	146	18	0	1800	0	-1800	0.00	0.00	3	0	-3
0011	3T	4_11	152	11	1	1100	490	-610	0.09	0.45	1	0	-1
0011	3T	4_11	153	11	0	1100	0	-1100	0.00	0.00	1	0	-1
0011	3T	4_11	154	8	0	800	0	-800	0.00	0.00	1	0	-1
0011	3T	4_11	156	4	0	400	0	-400	0.00	0.00	0	0	0
0011	3T	4_11	162	1	0	100	0	-100	0.00	0.00	0	0	0
0011	3T	4_11	163	3	0	300	0	-300	0.00	0.00	0	0	0
0011	3T	4_11	165	1	0	100	0	-100	0.00	0.00	0	0	0
0011	3T	4_11	213	3	0	300	0	-300	0.00	0.00	0	0	0
0011	3T	4_11	214	5	0	500	0	-500	0.00	0.00	0	0	0
0011	3T	4_11	215	3	0	300	0	-300	0.00	0.00	0	0	0
0011	3T	4_11	216	2	0	200	0	-200	0.00	0.00	0	0	0
0011	3T	4_11	234	1	0	100	0	-100	0.00	0.00	0	0	0
0011	3T	4_11	236	1	0	100	0	-100	0.00	0.00	0	0	0
0011	3T	4_11	243	1	0	100	0	-100	0.00	0.00	0	0	0
0011	3T	4_11	245	1	0	100	0	-100	0.00	0.00	0	0	0
0011	3T	4_11	246	1	0	100	0	-100	0.00	0.00	0	0	0
0011	3T	4_11	263	1	0	100	0	-100	0.00	0.00	0	0	0
0011	3T	4_12	123	153	25	15300	18350	3050	0.16	1.20	27	32	5
0011	3T	4_12	124	96	11	9600	8320	-1280	0.11	0.87	16	14	-2
0011	3T	4_12	125	64	0	6400	0	-6400	0.00	0.00	11	0	-11
0011	3T	4_12	126	37	0	3700	0	-3700	0.00	0.00	6	0	-6
0011	3T	4_12	132	81	3	8100	3030	-5070	0.04	0.37	14	5	-9
0011	3T	4_12	134	54	5	5400	4740	-660	0.09	0.88	9	8	-1
0011	3T	4_12	135	45	1	4500	2660	-1840	0.02	0.59	7	4	-3
0011	3T	4_12	136	27	2	2700	2770	70	0.07	1.03	4	4	0
0011	3T	4_12	142	29	0	2900	0	-2900	0.00	0.00	5	0	-5
0011	3T	4_12	143	42	2	4200	4060	-140	0.05	0.97	7	7	0
0011	3T	4_12	145	16	1	1600	620	-980	0.06	0.39	2	1	-1
0011	3T	4_12	146	11	0	1100	0	-1100	0.00	0.00	1	0	-1
0011	3T	4_12	152	7	0	700	0	-700	0.00	0.00	1	0	-1
0011	3T	4_12	153	8	0	800	0	-800	0.00	0.00	1	0	-1
0011	3T	4_12	154	6	0	600	0	-600	0.00	0.00	1	0	-1
0011	3T	4_12	156	4	0	400	0	-400	0.00	0.00	0	0	0
0011	3T	4_12	162	1	0	100	0	-100	0.00	0.00	0	0	0
0011	3T	4_12	163	1	0	100	0	-100	0.00	0.00	0	0	0
0011	3T	4_12	164	2	0	200	0	-200	0.00	0.00	0	0	0
0011	3T	4_12	165	1	0	100	0	-100	0.00	0.00	0	0	0
0011	3T	4_12	213	1	0	100	0	-100	0.00	0.00	0	0	0
0011	3T	4_12	214	4	0	400	0	-400	0.00	0.00	0	0	0
0011	3T	4_12	215	2	0	200	0	-200	0.00	0.00	0	0	0
0011	3T	4_12	216	3	0	300	0	-300	0.00	0.00	0	0	0
0011	3T	4_12	243	1	0	100	0	-100	0.00	0.00	0	0	0
0011	3T	4_12	254	1	0	100	0	-100	0.00	0.00	0	0	0
0011	3T	4_12	265	2	0	200	0	-200	0.00	0.00	0	0	0
0011	3T	4_2	123	82	7	8200	8350	150	0.09	1.02	14	14	0
0011	3T	4_2	124	69	1	6900	1450	-5450	0.01	0.21	12	2	-10
0011	3T	4_2	125	51	3	5100	3240	-1860	0.06	0.64	9	5	-4
0011	3T	4_2	126	26	3	2600	3540	940	0.12	1.36	4	6	2
0011	3T	4_2	132	39	2	3900	2190	-1710	0.05	0.56	6	3	-3
0011	3T	4_2	134	34	5	3400	6120	2720	0.15	1.80	6	10	4
0011	3T	4_2	135	27	1	2700	830	-1870	0.04	0.31	4	1	-3
0011	3T	4_2	136	23	0	2300	0	-2300	0.00	0.00	4	0	-4
0011	3T	4_2	142	28	2	2800	2000	-800	0.07	0.71	4	3	-1
0011	3T	4_2	143	13	0	1300	0	-1300	0.00	0.00	2	0	-2
0011	3T	4_2	145	15	1	1500	490	-1010	0.07	0.33	2	0	-2
0011	3T	4_2	146	11	0	1100	0	-1100	0.00	0.00	1	0	-1
0011	3T	4_2	152	4	0	400	0	-400	0.00	0.00	0	0	0
0011	3T	4_2	153	7	0	700	0	-700	0.00	0.00	1	0	-1
0011	3T	4_2	154	11	0	1100	0	-1100	0.00	0.00	1	0	-1
0011	3T	4_2	156	2	0	200	0	-200	0.00	0.00	0	0	0
0011	3T	4_2	162	3	0	300	0	-300	0.00	0.00	0	0	0
0011	3T	4_2	163	5	0	500	0	-500	0.00	0.00	0	0	0
0011	3T	4_2	164	1	0	100	0	-100	0.00	0.00	0	0	0
0011	3T	4_2	165	4	0	400	0	-400	0.00	0.00	0	0	0
0011	3T	4_2	213	8	0	800	0	-800	0.00	0.00	1	0	-1
0011	3T	4_2	214	8	0	800	0	-800	0.00	0.00	1	0	-1
0011	3T	4_2	215	5	0	500	0	-500	0.00	0.00	0	0	0
0011	3T	4_2	216	5	0	500	0	-500	0.00	0.00	0	0	0
0011	3T	4_2	231	5	0	500	0	-500	0.00	0.00	0	0	0
0011	3T	4_2	234	12	0	1200	0	-1200	0.00	0.00	2	0	-2
0011	3T	4_2	235	5	0	500	0	-500	0.00	0.00	0	0	0
0011	3T	4_2	236	4	0	400	0	-400	0.00	0.00	0	0	0
0011	3T	4_2	241	1	0	100	0	-100	0.00	0.00	0	0	0
0011	3T	4_2	243	3	0	300	0	-300	0.00	0.00	0	0	0
0011	3T	4_2	245	1	0	100	0	-100	0.00	0.00	0	0	0
0011	3T	4_2	246	1	0	100	0	-100	0.00	0.00	0	0	0
0011	3T	4_2	251	1	0	100	0	-100	0.00	0.00	0	0	0
0011	3T	4_2	253	2	0	200	0	-200	0.00	0.00	0	0	0
0011	3T	4_2	254	2	0	200	0	-200	0.00	0.00	0	0	0
0011	3T	4_2	256	2	0	200	0	-200	0.00	0.00	0	0	0
0011	3T	4_2	261	2	0	200	0	-200	0.00	0.00	0	0	0
0011	3T	4_2	263	4	0	400	0	-400	0.00	0.00	0	0	0
0011	3T	4_2	264	1	0	100	0	-100	0.00	0.00	0	0	0
0011	3T	4_3	123	64	6	6400	5220	-1180	0.09	0.82	11	9	-2
0011	3T	4_3	124	42	5	4200	4400	200	0.12	1.05	7	7	0
0011	3T	4_3	125	39	3	3900	10580	6680	0.08	2.71	6	18	12
0011	3T	4_3	126	23	0	2300	0	-2300	0.00	0.00	4	0	-4
0011	3T	4_3	132	46	0	4600	0	-4600	0.00	0.00	8	0	-8
0011	3T	4_3	134	41	1	4100	530	-3570	0.02	0.13	7	0	-7
0011	3T	4_3	135	33	4	3300	10590	7290	0.12	3.21	5	18	13
0011	3T	4_3	136	25	4	2500	5510	3010	0.16	2.20	4	9	5
0011	3T	4_3	142	18	1	1800	490	-1310	0.06	0.27	3	0	-3
0011	3T	4_3	143	14	1	1400	1420	20	0.07	1.01	2	2	0
0011	3T	4_3	145	14	1	1400	3740	2340	0.07	2.67	2	6	4
0011	3T	4_3	146	12	1	1200	1460	260	0.08	1.22	2	2	0
0011	3T	4_3	152	12	0	1200	0	-1200	0.00	0.00	2	0	-2
0011	3T	4_3	153	11	0	1100	0	-1100	0.00	0.00	1	0	-1
0011	3T	4_3	154	6	0	600	0	-600	0.00	0.00	1	0	-1
0011	3T	4_3	156	2	0	200	0	-200	0.00	0.00	0	0	0
0011	3T	4_3	162	6	1	600	4720	4120	0.17	7.87	1	8	7
0011	3T	4_3	163	4	0	400	0	-400	0.00	0.00	0	0	0
0011	3T	4_3	164	3	0	300	0	-300	0.00	0.00	0	0	0
0011	3T	4_3	213	11	2	1100	3380	2280	0.18	3.07	1	5	4
0011	3T	4_3	214	14	0	1400	0	-1400	0.00	0.00	2	0	-2
0011	3T	4_3	215	8	1	800	980	180	0.13	1.23	1	1	0
0011	3T	4_3	216	5	0	500	0	-500	0.00	0.00	0	0	0
0011	3T	4_3	231	1	0	100	0	-100	0.00	0.00	0	0	0
0011	3T	4_3	234	7	1	700	2080	1380	0.14	2.97	1	3	2
0011	3T	4_3	235	4	0	400	0	-400	0.00	0.00	0	0	0
0011	3T	4_3	236	8	0	800	0	-800	0.00	0.00	1	0	-1
0011	3T	4_3	241	2	0	200	0	-200	0.00	0.00	0	0	0
0011	3T	4_3	243	4	0	400	0	-400	0.00	0.00	0	0	0
0011	3T	4_3	245	7	0	700	0	-700	0.00	0.00	1	0	-1
0011	3T	4_3	246	4	1	400	1540	1140	0.25	3.85	0	2	2
0011	3T	4_3	253	5	0	500	0	-500	0.00	0.00	0	0	0
0011	3T	4_3	254	5	0	500	0	-500	0.00	0.00	0	0	0
0011	3T	4_3	256	1	0	100	0	-100	0.00	0.00	0	0	0
0011	3T	4_3	261	1	0	100	0	-100	0.00	0.00	0	0	0
0011	3T	4_3	263	1	1	100	1140	1040	1.00	11.40	0	2	2
0011	3T	4_3	264	4	0	400	0	-400	0.00	0.00	0	0	0
0011	3T	4_3	265	5	0	500	0	-500	0.00	0.00	0	0	0
0011	3T	4_4	123	77	9	7700	5950	-1750	0.12	0.77	13	10	-3
0011	3T	4_4	124	55	4	5500	2210	-3290	0.07	0.40	9	3	-6
0011	3T	4_4	125	44	1	4400	1580	-2820	0.02	0.36	7	2	-5
0011	3T	4_4	126	23	3	2300	7450	5150	0.13	3.24	4	13	9
0011	3T	4_4	132	41	3	4100	3940	-160	0.07	0.96	7	6	-1
0011	3T	4_4	134	43	2	4300	1210	-3090	0.05	0.28	7	2	-5
0011	3T	4_4	135	35	5	3500	3850	350	0.14	1.10	6	6	0
0011	3T	4_4	136	30	1	3000	1010	-1990	0.03	0.34	5	1	-4
0011	3T	4_4	142	24	4	2400	10870	8470	0.17	4.53	4	19	15
0011	3T	4_4	143	28	2	2800	3000	200	0.07	1.07	4	5	1
0011	3T	4_4	145	19	0	1900	0	-1900	0.00	0.00	3	0	-3
0011	3T	4_4	146	14	0	1400	0	-1400	0.00	0.00	2	0	-2
0011	3T	4_4	152	12	0	1200	0	-1200	0.00	0.00	2	0	-2
0011	3T	4_4	153	13	0	1300	0	-1300	0.00	0.00	2	0	-2
0011	3T	4_4	154	4	0	400	0	-400	0.00	0.00	0	0	0
0011	3T	4_4	156	8	0	800	0	-800	0.00	0.00	1	0	-1
0011	3T	4_4	162	9	0	900	0	-900	0.00	0.00	1	0	-1
0011	3T	4_4	163	4	0	400	0	-400	0.00	0.00	0	0	0
0011	3T	4_4	164	3	0	300	0	-300	0.00	0.00	0	0	0
0011	3T	4_4	165	3	0	300	0	-300	0.00	0.00	0	0	0
0011	3T	4_4	213	9	1	900	2450	1550	0.11	2.72	1	4	3
0011	3T	4_4	214	9	0	900	0	-900	0.00	0.00	1	0	-1
0011	3T	4_4	215	4	0	400	0	-400	0.00	0.00	0	0	0
0011	3T	4_4	216	5	0	500	0	-500	0.00	0.00	0	0	0
0011	3T	4_4	234	11	0	1100	0	-1100	0.00	0.00	1	0	-1
0011	3T	4_4	235	4	0	400	0	-400	0.00	0.00	0	0	0
0011	3T	4_4	236	4	0	400	0	-400	0.00	0.00	0	0	0
0011	3T	4_4	241	1	0	100	0	-100	0.00	0.00	0	0	0
0011	3T	4_4	243	4	0	400	0	-400	0.00	0.00	0	0	0
0011	3T	4_4	246	7	1	700	3920	3220	0.14	5.60	1	6	5
0011	3T	4_4	251	4	0	400	0	-400	0.00	0.00	0	0	0
0011	3T	4_4	253	2	0	200	0	-200	0.00	0.00	0	0	0
0011	3T	4_4	256	1	0	100	0	-100	0.00	0.00	0	0	0
0011	3T	4_4	261	2	0	200	0	-200	0.00	0.00	0	0	0
0011	3T	4_4	263	1	0	100	0	-100	0.00	0.00	0	0	0
0011	3T	4_4	264	2	0	200	0	-200	0.00	0.00	0	0	0
0011	3T	4_4	265	1	0	100	0	-100	0.00	0.00	0	0	0
0011	3T	4_5	123	86	8	8600	5270	-3330	0.09	0.61	15	9	-6
0011	3T	4_5	124	75	8	7500	6100	-1400	0.11	0.81	13	10	-3
0011	3T	4_5	125	49	3	4900	2330	-2570	0.06	0.48	8	4	-4
0011	3T	4_5	126	41	3	4100	2950	-1150	0.07	0.72	7	5	-2
0011	3T	4_5	132	43	2	4300	1340	-2960	0.05	0.31	7	2	-5
0011	3T	4_5	134	38	2	3800	1060	-2740	0.05	0.28	6	1	-5
0011	3T	4_5	135	25	1	2500	1110	-1390	0.04	0.44	4	1	-3
0011	3T	4_5	136	23	0	2300	0	-2300	0.00	0.00	4	0	-4
0011	3T	4_5	142	24	0	2400	0	-2400	0.00	0.00	4	0	-4
0011	3T	4_5	143	27	2	2700	3530	830	0.07	1.31	4	6	2
0011	3T	4_5	145	15	0	1500	0	-1500	0.00	0.00	2	0	-2
0011	3T	4_5	146	11	0	1100	0	-1100	0.00	0.00	1	0	-1
0011	3T	4_5	152	8	0	800	0	-800	0.00	0.00	1	0	-1
0011	3T	4_5	153	10	1	1000	4020	3020	0.10	4.02	1	7	6
0011	3T	4_5	154	7	0	700	0	-700	0.00	0.00	1	0	-1
0011	3T	4_5	156	8	0	800	0	-800	0.00	0.00	1	0	-1
0011	3T	4_5	162	6	0	600	0	-600	0.00	0.00	1	0	-1
0011	3T	4_5	163	4	1	400	690	290	0.25	1.73	0	1	1
0011	3T	4_5	164	5	0	500	0	-500	0.00	0.00	0	0	0
0011	3T	4_5	165	3	0	300	0	-300	0.00	0.00	0	0	0
0011	3T	4_5	213	10	1	1000	550	-450	0.10	0.55	1	0	-1
0011	3T	4_5	214	1	0	100	0	-100	0.00	0.00	0	0	0
0011	3T	4_5	215	7	1	700	550	-150	0.14	0.79	1	0	-1
0011	3T	4_5	216	4	0	400	0	-400	0.00	0.00	0	0	0
0011	3T	4_5	231	7	0	700	0	-700	0.00	0.00	1	0	-1
0011	3T	4_5	234	3	0	300	0	-300	0.00	0.00	0	0	0
0011	3T	4_5	235	10	0	1000	0	-1000	0.00	0.00	1	0	-1
0011	3T	4_5	236	3	0	300	0	-300	0.00	0.00	0	0	0
0011	3T	4_5	241	2	0	200	0	-200	0.00	0.00	0	0	0
0011	3T	4_5	243	6	0	600	0	-600	0.00	0.00	1	0	-1
0011	3T	4_5	245	5	0	500	0	-500	0.00	0.00	0	0	0
0011	3T	4_5	246	1	0	100	0	-100	0.00	0.00	0	0	0
0011	3T	4_5	253	2	0	200	0	-200	0.00	0.00	0	0	0
0011	3T	4_5	254	1	0	100	0	-100	0.00	0.00	0	0	0
0011	3T	4_5	256	5	0	500	0	-500	0.00	0.00	0	0	0
0011	3T	4_5	261	1	0	100	0	-100	0.00	0.00	0	0	0
0011	3T	4_5	263	1	0	100	0	-100	0.00	0.00	0	0	0
0011	3T	4_6	123	68	8	6800	7990	1190	0.12	1.18	12	14	2
0011	3T	4_6	124	56	6	5600	8910	3310	0.11	1.59	9	15	6
0011	3T	4_6	125	30	2	3000	1850	-1150	0.07	0.62	5	3	-2
0011	3T	4_6	126	33	0	3300	0	-3300	0.00	0.00	5	0	-5
0011	3T	4_6	132	43	4	4300	15900	11600	0.09	3.70	7	28	21
0011	3T	4_6	134	29	2	2900	1430	-1470	0.07	0.49	5	2	-3
0011	3T	4_6	135	31	2	3100	5650	2550	0.06	1.82	5	10	5
0011	3T	4_6	136	23	2	2300	4940	2640	0.09	2.15	4	8	4
0011	3T	4_6	142	31	2	3100	1470	-1630	0.06	0.47	5	2	-3
0011	3T	4_6	143	15	0	1500	0	-1500	0.00	0.00	2	0	-2
0011	3T	4_6	145	12	1	1200	800	-400	0.08	0.67	2	1	-1
0011	3T	4_6	146	8	0	800	0	-800	0.00	0.00	1	0	-1
0011	3T	4_6	152	8	0	800	0	-800	0.00	0.00	1	0	-1
0011	3T	4_6	153	14	1	1400	2910	1510	0.07	2.08	2	5	3
0011	3T	4_6	154	7	0	700	0	-700	0.00	0.00	1	0	-1
0011	3T	4_6	156	3	0	300	0	-300	0.00	0.00	0	0	0
0011	3T	4_6	162	9	1	900	1870	970	0.11	2.08	1	3	2
0011	3T	4_6	163	2	0	200	0	-200	0.00	0.00	0	0	0
0011	3T	4_6	164	2	0	200	0	-200	0.00	0.00	0	0	0
0011	3T	4_6	165	1	0	100	0	-100	0.00	0.00	0	0	0
0011	3T	4_6	213	11	0	1100	0	-1100	0.00	0.00	1	0	-1
0011	3T	4_6	214	6	2	600	1830	1230	0.33	3.05	1	3	2
0011	3T	4_6	215	6	0	600	0	-600	0.00	0.00	1	0	-1
0011	3T	4_6	216	4	1	400	1070	670	0.25	2.68	0	1	1
0011	3T	4_6	231	4	0	400	0	-400	0.00	0.00	0	0	0
0011	3T	4_6	234	7	0	700	0	-700	0.00	0.00	1	0	-1
0011	3T	4_6	235	12	1	1200	1340	140	0.08	1.12	2	2	0
0011	3T	4_6	236	2	1	200	4080	3880	0.50	20.40	0	7	7
0011	3T	4_6	241	2	0	200	0	-200	0.00	0.00	0	0	0
0011	3T	4_6	245	2	0	200	0	-200	0.00	0.00	0	0	0
0011	3T	4_6	246	2	0	200	0	-200	0.00	0.00	0	0	0
0011	3T	4_6	251	4	0	400	0	-400	0.00	0.00	0	0	0
0011	3T	4_6	253	3	0	300	0	-300	0.00	0.00	0	0	0
0011	3T	4_6	254	2	0	200	0	-200	0.00	0.00	0	0	0
0011	3T	4_6	256	1	0	100	0	-100	0.00	0.00	0	0	0
0011	3T	4_6	261	2	0	200	0	-200	0.00	0.00	0	0	0
0011	3T	4_6	263	3	0	300	0	-300	0.00	0.00	0	0	0
0011	3T	4_6	264	2	0	200	0	-200	0.00	0.00	0	0	0
0011	3T	4_7	123	69	7	6900	4340	-2560	0.10	0.63	12	7	-5
0011	3T	4_7	124	60	7	6000	7770	1770	0.12	1.30	10	13	3
0011	3T	4_7	125	36	1	3600	1530	-2070	0.03	0.43	6	2	-4
0011	3T	4_7	126	20	0	2000	0	-2000	0.00	0.00	3	0	-3
0011	3T	4_7	132	33	2	3300	1320	-1980	0.06	0.40	5	2	-3
0011	3T	4_7	134	54	4	5400	3850	-1550	0.07	0.71	9	6	-3
0011	3T	4_7	135	31	0	3100	0	-3100	0.00	0.00	5	0	-5
0011	3T	4_7	136	20	0	2000	0	-2000	0.00	0.00	3	0	-3
0011	3T	4_7	142	22	1	2200	240	-1960	0.05	0.11	3	0	-3
0011	3T	4_7	143	28	3	2800	3640	840	0.11	1.30	4	6	2
0011	3T	4_7	145	23	1	2300	1980	-320	0.04	0.86	4	3	-1
0011	3T	4_7	146	11	2	1100	2150	1050	0.18	1.95	1	3	2
0011	3T	4_7	152	9	1	900	1070	170	0.11	1.19	1	1	0
0011	3T	4_7	153	11	0	1100	0	-1100	0.00	0.00	1	0	-1
0011	3T	4_7	154	10	0	1000	0	-1000	0.00	0.00	1	0	-1
0011	3T	4_7	156	8	1	800	870	70	0.13	1.09	1	1	0
0011	3T	4_7	162	9	0	900	0	-900	0.00	0.00	1	0	-1
0011	3T	4_7	163	1	0	100	0	-100	0.00	0.00	0	0	0
0011	3T	4_7	164	4	0	400	0	-400	0.00	0.00	0	0	0
0011	3T	4_7	165	6	0	600	0	-600	0.00	0.00	1	0	-1
0011	3T	4_7	213	9	0	900	0	-900	0.00	0.00	1	0	-1
0011	3T	4_7	214	6	0	600	0	-600	0.00	0.00	1	0	-1
0011	3T	4_7	215	4	0	400	0	-400	0.00	0.00	0	0	0
0011	3T	4_7	216	4	1	400	960	560	0.25	2.40	0	1	1
0011	3T	4_7	231	3	0	300	0	-300	0.00	0.00	0	0	0
0011	3T	4_7	234	4	0	400	0	-400	0.00	0.00	0	0	0
0011	3T	4_7	235	6	0	600	0	-600	0.00	0.00	1	0	-1
0011	3T	4_7	236	3	0	300	0	-300	0.00	0.00	0	0	0
0011	3T	4_7	245	3	0	300	0	-300	0.00	0.00	0	0	0
0011	3T	4_7	246	2	0	200	0	-200	0.00	0.00	0	0	0
0011	3T	4_7	251	1	0	100	0	-100	0.00	0.00	0	0	0
0011	3T	4_7	253	3	0	300	0	-300	0.00	0.00	0	0	0
0011	3T	4_7	254	1	0	100	0	-100	0.00	0.00	0	0	0
0011	3T	4_7	256	3	0	300	0	-300	0.00	0.00	0	0	0
0011	3T	4_7	261	1	0	100	0	-100	0.00	0.00	0	0	0
0011	3T	4_7	263	3	0	300	0	-300	0.00	0.00	0	0	0
0011	3T	4_7	264	1	0	100	0	-100	0.00	0.00	0	0	0
0011	3T	4_7	265	1	0	100	0	-100	0.00	0.00	0	0	0
0011	3T	4_8	123	78	12	7800	9140	1340	0.15	1.17	13	16	3
0011	3T	4_8	124	62	3	6200	3650	-2550	0.05	0.59	10	6	-4
0011	3T	4_8	125	45	1	4500	650	-3850	0.02	0.14	7	1	-6
0011	3T	4_8	126	35	2	3500	2460	-1040	0.06	0.70	6	4	-2
0011	3T	4_8	132	43	5	4300	6800	2500	0.12	1.58	7	12	5
0011	3T	4_8	134	20	1	2000	1010	-990	0.05	0.51	3	1	-2
0011	3T	4_8	135	31	2	3100	1400	-1700	0.06	0.45	5	2	-3
0011	3T	4_8	136	26	2	2600	5130	2530	0.08	1.97	4	9	5
0011	3T	4_8	142	29	4	2900	2590	-310	0.14	0.89	5	4	-1
0011	3T	4_8	143	30	1	3000	640	-2360	0.03	0.21	5	1	-4
0011	3T	4_8	145	13	2	1300	1310	10	0.15	1.01	2	2	0
0011	3T	4_8	146	14	0	1400	0	-1400	0.00	0.00	2	0	-2
0011	3T	4_8	152	9	0	900	0	-900	0.00	0.00	1	0	-1
0011	3T	4_8	153	14	0	1400	0	-1400	0.00	0.00	2	0	-2
0011	3T	4_8	154	15	0	1500	0	-1500	0.00	0.00	2	0	-2
0011	3T	4_8	156	5	0	500	0	-500	0.00	0.00	0	0	0
0011	3T	4_8	162	10	0	1000	0	-1000	0.00	0.00	1	0	-1
0011	3T	4_8	163	4	0	400	0	-400	0.00	0.00	0	0	0
0011	3T	4_8	164	7	1	700	760	60	0.14	1.09	1	1	0
0011	3T	4_8	165	4	0	400	0	-400	0.00	0.00	0	0	0
0011	3T	4_8	213	7	2	700	3240	2540	0.29	4.63	1	5	4
0011	3T	4_8	214	4	0	400	0	-400	0.00	0.00	0	0	0
0011	3T	4_8	215	6	0	600	0	-600	0.00	0.00	1	0	-1
0011	3T	4_8	216	3	0	300	0	-300	0.00	0.00	0	0	0
0011	3T	4_8	231	6	0	600	0	-600	0.00	0.00	1	0	-1
0011	3T	4_8	234	10	0	1000	0	-1000	0.00	0.00	1	0	-1
0011	3T	4_8	235	1	0	100	0	-100	0.00	0.00	0	0	0
0011	3T	4_8	236	5	1	500	12290	11790	0.20	24.58	0	21	21
0011	3T	4_8	241	1	0	100	0	-100	0.00	0.00	0	0	0
0011	3T	4_8	243	2	0	200	0	-200	0.00	0.00	0	0	0
0011	3T	4_8	245	2	0	200	0	-200	0.00	0.00	0	0	0
0011	3T	4_8	246	1	0	100	0	-100	0.00	0.00	0	0	0
0011	3T	4_8	251	2	0	200	0	-200	0.00	0.00	0	0	0
0011	3T	4_8	254	1	0	100	0	-100	0.00	0.00	0	0	0
0011	3T	4_8	256	2	0	200	0	-200	0.00	0.00	0	0	0
0011	3T	4_8	261	1	0	100	0	-100	0.00	0.00	0	0	0
0011	3T	4_8	265	1	0	100	0	-100	0.00	0.00	0	0	0
0011	3T	4_9	123	92	14	9200	9770	570	0.15	1.06	16	17	1
0011	3T	4_9	124	72	4	7200	3460	-3740	0.06	0.48	12	6	-6
0011	3T	4_9	125	51	9	5100	18500	13400	0.18	3.63	9	32	23
0011	3T	4_9	126	35	2	3500	2630	-870	0.06	0.75	6	4	-2
0011	3T	4_9	132	50	6	5000	7020	2020	0.12	1.40	8	12	4
0011	3T	4_9	134	42	5	4200	5800	1600	0.12	1.38	7	10	3
0011	3T	4_9	135	43	4	4300	2370	-1930	0.09	0.55	7	4	-3
0011	3T	4_9	136	30	3	3000	8810	5810	0.10	2.94	5	15	10
0011	3T	4_9	142	32	2	3200	1530	-1670	0.06	0.48	5	2	-3
0011	3T	4_9	143	17	1	1700	1700	0	0.06	1.00	3	3	0
0011	3T	4_9	145	26	1	2600	1070	-1530	0.04	0.41	4	1	-3
0011	3T	4_9	146	9	1	900	3870	2970	0.11	4.30	1	6	5
0011	3T	4_9	152	9	1	900	1520	620	0.11	1.69	1	2	1
0011	3T	4_9	153	9	0	900	0	-900	0.00	0.00	1	0	-1
0011	3T	4_9	154	4	0	400	0	-400	0.00	0.00	0	0	0
0011	3T	4_9	156	2	0	200	0	-200	0.00	0.00	0	0	0
0011	3T	4_9	162	4	0	400	0	-400	0.00	0.00	0	0	0
0011	3T	4_9	163	5	0	500	0	-500	0.00	0.00	0	0	0
0011	3T	4_9	164	3	0	300	0	-300	0.00	0.00	0	0	0
0011	3T	4_9	213	4	1	400	1890	1490	0.25	4.73	0	3	3
0011	3T	4_9	214	7	1	700	630	-70	0.14	0.90	1	1	0
0011	3T	4_9	215	11	0	1100	0	-1100	0.00	0.00	1	0	-1
0011	3T	4_9	216	2	0	200	0	-200	0.00	0.00	0	0	0
0011	3T	4_9	231	3	0	300	0	-300	0.00	0.00	0	0	0
0011	3T	4_9	234	2	0	200	0	-200	0.00	0.00	0	0	0
0011	3T	4_9	235	3	0	300	0	-300	0.00	0.00	0	0	0
0011	3T	4_9	236	1	0	100	0	-100	0.00	0.00	0	0	0
0011	3T	4_9	243	2	0	200	0	-200	0.00	0.00	0	0	0
0011	3T	4_9	245	2	0	200	0	-200	0.00	0.00	0	0	0
0011	3T	4_9	246	1	0	100	0	-100	0.00	0.00	0	0	0
0011	3T	4_9	251	2	0	200	0	-200	0.00	0.00	0	0	0
0011	3T	4_9	253	3	0	300	0	-300	0.00	0.00	0	0	0
0011	3T	4_9	254	1	0	100	0	-100	0.00	0.00	0	0	0
0011	3T	4_9	256	1	0	100	0	-100	0.00	0.00	0	0	0
0011	3T	4_9	265	1	0	100	0	-100	0.00	0.00	0	0	0
0011	3T	5_1	123	61	2	6100	2490	-3610	0.03	0.41	10	4	-6
0011	3T	5_1	124	55	4	5500	3230	-2270	0.07	0.59	9	5	-4
0011	3T	5_1	125	37	2	3700	5450	1750	0.05	1.47	6	9	3
0011	3T	5_1	126	11	0	1100	0	-1100	0.00	0.00	1	0	-1
0011	3T	5_1	132	37	4	3700	6500	2800	0.11	1.76	6	11	5
0011	3T	5_1	134	39	1	3900	5300	1400	0.03	1.36	6	9	3
0011	3T	5_1	135	27	0	2700	0	-2700	0.00	0.00	4	0	-4
0011	3T	5_1	136	13	0	1300	0	-1300	0.00	0.00	2	0	-2
0011	3T	5_1	142	27	2	2700	1640	-1060	0.07	0.61	4	2	-2
0011	3T	5_1	143	25	1	2500	1060	-1440	0.04	0.42	4	1	-3
0011	3T	5_1	145	18	2	1800	3050	1250	0.11	1.69	3	5	2
0011	3T	5_1	146	7	0	700	0	-700	0.00	0.00	1	0	-1
0011	3T	5_1	152	10	0	1000	0	-1000	0.00	0.00	1	0	-1
0011	3T	5_1	153	15	1	1500	2280	780	0.07	1.52	2	4	2
0011	3T	5_1	154	5	0	500	0	-500	0.00	0.00	0	0	0
0011	3T	5_1	156	3	0	300	0	-300	0.00	0.00	0	0	0
0011	3T	5_1	162	4	1	400	2380	1980	0.25	5.95	0	4	4
0011	3T	5_1	163	2	0	200	0	-200	0.00	0.00	0	0	0
0011	3T	5_1	164	4	0	400	0	-400	0.00	0.00	0	0	0
0011	3T	5_1	165	2	0	200	0	-200	0.00	0.00	0	0	0
0011	3T	5_1	213	4	0	400	0	-400	0.00	0.00	0	0	0
0011	3T	5_1	214	3	0	300	0	-300	0.00	0.00	0	0	0
0011	3T	5_1	215	4	0	400	0	-400	0.00	0.00	0	0	0
0011	3T	5_1	216	1	0	100	0	-100	0.00	0.00	0	0	0
0011	3T	5_1	231	3	0	300	0	-300	0.00	0.00	0	0	0
0011	3T	5_1	234	4	0	400	0	-400	0.00	0.00	0	0	0
0011	3T	5_1	235	3	0	300	0	-300	0.00	0.00	0	0	0
0011	3T	5_1	236	1	0	100	0	-100	0.00	0.00	0	0	0
0011	3T	5_1	241	1	0	100	0	-100	0.00	0.00	0	0	0
0011	3T	5_1	243	2	0	200	0	-200	0.00	0.00	0	0	0
0011	3T	5_1	245	2	0	200	0	-200	0.00	0.00	0	0	0
0011	3T	5_1	246	1	0	100	0	-100	0.00	0.00	0	0	0
0011	3T	5_1	253	1	0	100	0	-100	0.00	0.00	0	0	0
0011	3T	5_1	261	1	0	100	0	-100	0.00	0.00	0	0	0
0011	3T	5_1	264	1	0	100	0	-100	0.00	0.00	0	0	0
0011	3T	5_1	265	2	0	200	0	-200	0.00	0.00	0	0	0
0011	3T	5_10	123	110	20	11000	11320	320	0.18	1.03	19	20	1
0011	3T	5_10	124	96	10	9600	7860	-1740	0.10	0.82	16	13	-3
0011	3T	5_10	125	44	1	4400	1350	-3050	0.02	0.31	7	2	-5
0011	3T	5_10	126	50	3	5000	4560	-440	0.06	0.91	8	8	0
0011	3T	5_10	132	37	2	3700	2020	-1680	0.05	0.55	6	3	-3
0011	3T	5_10	134	42	4	4200	5430	1230	0.10	1.29	7	9	2
0011	3T	5_10	135	35	1	3500	2050	-1450	0.03	0.59	6	3	-3
0011	3T	5_10	136	22	1	2200	2200	0	0.05	1.00	3	3	0
0011	3T	5_10	142	10	2	1000	1920	920	0.20	1.92	1	3	2
0011	3T	5_10	143	12	2	1200	4490	3290	0.17	3.74	2	7	5
0011	3T	5_10	145	12	1	1200	1450	250	0.08	1.21	2	2	0
0011	3T	5_10	146	10	0	1000	0	-1000	0.00	0.00	1	0	-1
0011	3T	5_10	152	2	0	200	0	-200	0.00	0.00	0	0	0
0011	3T	5_10	153	2	0	200	0	-200	0.00	0.00	0	0	0
0011	3T	5_10	154	10	0	1000	0	-1000	0.00	0.00	1	0	-1
0011	3T	5_10	156	4	0	400	0	-400	0.00	0.00	0	0	0
0011	3T	5_10	162	1	0	100	0	-100	0.00	0.00	0	0	0
0011	3T	5_10	163	1	0	100	0	-100	0.00	0.00	0	0	0
0011	3T	5_10	164	1	0	100	0	-100	0.00	0.00	0	0	0
0011	3T	5_10	165	3	0	300	0	-300	0.00	0.00	0	0	0
0011	3T	5_10	213	3	0	300	0	-300	0.00	0.00	0	0	0
0011	3T	5_10	214	2	0	200	0	-200	0.00	0.00	0	0	0
0011	3T	5_10	215	5	1	500	2310	1810	0.20	4.62	0	4	4
0011	3T	5_10	216	4	0	400	0	-400	0.00	0.00	0	0	0
0011	3T	5_10	234	5	0	500	0	-500	0.00	0.00	0	0	0
0011	3T	5_10	241	1	0	100	0	-100	0.00	0.00	0	0	0
0011	3T	5_10	245	1	0	100	0	-100	0.00	0.00	0	0	0
0011	3T	5_10	256	1	0	100	0	-100	0.00	0.00	0	0	0
0011	3T	5_11	123	108	18	10800	7770	-3030	0.17	0.72	19	13	-6
0011	3T	5_11	124	114	10	11400	8210	-3190	0.09	0.72	20	14	-6
0011	3T	5_11	125	64	3	6400	3470	-2930	0.05	0.54	11	6	-5
0011	3T	5_11	126	40	2	4000	6720	2720	0.05	1.68	7	11	4
0011	3T	5_11	132	38	5	3800	3800	0	0.13	1.00	6	6	0
0011	3T	5_11	134	56	8	5600	10150	4550	0.14	1.81	9	17	8
0011	3T	5_11	135	33	2	3300	4270	970	0.06	1.29	5	7	2
0011	3T	5_11	136	17	0	1700	0	-1700	0.00	0.00	3	0	-3
0011	3T	5_11	142	18	0	1800	0	-1800	0.00	0.00	3	0	-3
0011	3T	5_11	143	17	0	1700	0	-1700	0.00	0.00	3	0	-3
0011	3T	5_11	145	14	0	1400	0	-1400	0.00	0.00	2	0	-2
0011	3T	5_11	146	9	0	900	0	-900	0.00	0.00	1	0	-1
0011	3T	5_11	152	5	0	500	0	-500	0.00	0.00	0	0	0
0011	3T	5_11	153	5	0	500	0	-500	0.00	0.00	0	0	0
0011	3T	5_11	154	5	0	500	0	-500	0.00	0.00	0	0	0
0011	3T	5_11	156	2	0	200	0	-200	0.00	0.00	0	0	0
0011	3T	5_11	165	1	0	100	0	-100	0.00	0.00	0	0	0
0011	3T	5_11	213	1	1	100	1060	960	1.00	10.60	0	1	1
0011	3T	5_11	214	2	0	200	0	-200	0.00	0.00	0	0	0
0011	3T	5_11	215	1	0	100	0	-100	0.00	0.00	0	0	0
0011	3T	5_11	234	2	0	200	0	-200	0.00	0.00	0	0	0
0011	3T	5_11	236	2	0	200	0	-200	0.00	0.00	0	0	0
0011	3T	5_11	254	1	0	100	0	-100	0.00	0.00	0	0	0
0011	3T	5_12	123	102	13	10200	7980	-2220	0.13	0.78	18	14	-4
0011	3T	5_12	124	110	12	11000	9350	-1650	0.11	0.85	19	16	-3
0011	3T	5_12	125	43	1	4300	830	-3470	0.02	0.19	7	1	-6
0011	3T	5_12	126	30	0	3000	0	-3000	0.00	0.00	5	0	-5
0011	3T	5_12	132	40	5	4000	4110	110	0.13	1.03	7	7	0
0011	3T	5_12	134	63	6	6300	7010	710	0.10	1.11	11	12	1
0011	3T	5_12	135	31	2	3100	1740	-1360	0.06	0.56	5	3	-2
0011	3T	5_12	136	19	1	1900	1540	-360	0.05	0.81	3	2	-1
0011	3T	5_12	142	16	2	1600	2770	1170	0.13	1.73	2	4	2
0011	3T	5_12	143	15	0	1500	0	-1500	0.00	0.00	2	0	-2
0011	3T	5_12	145	18	1	1800	1750	-50	0.06	0.97	3	3	0
0011	3T	5_12	146	13	0	1300	0	-1300	0.00	0.00	2	0	-2
0011	3T	5_12	152	4	0	400	0	-400	0.00	0.00	0	0	0
0011	3T	5_12	153	7	1	700	1130	430	0.14	1.61	1	2	1
0011	3T	5_12	154	6	0	600	0	-600	0.00	0.00	1	0	-1
0011	3T	5_12	156	2	0	200	0	-200	0.00	0.00	0	0	0
0011	3T	5_12	162	2	1	200	1490	1290	0.50	7.45	0	2	2
0011	3T	5_12	163	1	0	100	0	-100	0.00	0.00	0	0	0
0011	3T	5_12	164	1	0	100	0	-100	0.00	0.00	0	0	0
0011	3T	5_12	214	3	0	300	0	-300	0.00	0.00	0	0	0
0011	3T	5_12	215	1	0	100	0	-100	0.00	0.00	0	0	0
0011	3T	5_12	231	1	0	100	0	-100	0.00	0.00	0	0	0
0011	3T	5_12	234	2	0	200	0	-200	0.00	0.00	0	0	0
0011	3T	5_12	246	1	0	100	0	-100	0.00	0.00	0	0	0
0011	3T	5_12	251	2	0	200	0	-200	0.00	0.00	0	0	0
0011	3T	5_12	253	1	0	100	0	-100	0.00	0.00	0	0	0
0011	3T	5_12	264	1	0	100	0	-100	0.00	0.00	0	0	0
0011	3T	5_2	123	61	2	6100	1620	-4480	0.03	0.27	10	2	-8
0011	3T	5_2	124	47	4	4700	5620	920	0.09	1.20	8	9	1
0011	3T	5_2	125	36	1	3600	1250	-2350	0.03	0.35	6	2	-4
0011	3T	5_2	126	21	2	2100	2190	90	0.10	1.04	3	3	0
0011	3T	5_2	132	30	3	3000	4220	1220	0.10	1.41	5	7	2
0011	3T	5_2	134	31	2	3100	4730	1630	0.06	1.53	5	8	3
0011	3T	5_2	135	13	0	1300	0	-1300	0.00	0.00	2	0	-2
0011	3T	5_2	136	14	1	1400	590	-810	0.07	0.42	2	1	-1
0011	3T	5_2	142	17	1	1700	480	-1220	0.06	0.28	3	0	-3
0011	3T	5_2	143	25	1	2500	1290	-1210	0.04	0.52	4	2	-2
0011	3T	5_2	145	15	1	1500	5400	3900	0.07	3.60	2	9	7
0011	3T	5_2	146	8	0	800	0	-800	0.00	0.00	1	0	-1
0011	3T	5_2	152	13	1	1300	790	-510	0.08	0.61	2	1	-1
0011	3T	5_2	153	8	0	800	0	-800	0.00	0.00	1	0	-1
0011	3T	5_2	154	5	0	500	0	-500	0.00	0.00	0	0	0
0011	3T	5_2	156	5	0	500	0	-500	0.00	0.00	0	0	0
0011	3T	5_2	162	3	0	300	0	-300	0.00	0.00	0	0	0
0011	3T	5_2	163	5	0	500	0	-500	0.00	0.00	0	0	0
0011	3T	5_2	164	3	0	300	0	-300	0.00	0.00	0	0	0
0011	3T	5_2	165	5	1	500	1000	500	0.20	2.00	0	1	1
0011	3T	5_2	214	8	0	800	0	-800	0.00	0.00	1	0	-1
0011	3T	5_2	215	2	0	200	0	-200	0.00	0.00	0	0	0
0011	3T	5_2	216	2	0	200	0	-200	0.00	0.00	0	0	0
0011	3T	5_2	234	5	1	500	870	370	0.20	1.74	0	1	1
0011	3T	5_2	235	2	0	200	0	-200	0.00	0.00	0	0	0
0011	3T	5_2	236	4	0	400	0	-400	0.00	0.00	0	0	0
0011	3T	5_2	241	3	0	300	0	-300	0.00	0.00	0	0	0
0011	3T	5_2	243	1	1	100	3630	3530	1.00	36.30	0	6	6
0011	3T	5_2	246	1	0	100	0	-100	0.00	0.00	0	0	0
0011	3T	5_2	251	1	0	100	0	-100	0.00	0.00	0	0	0
0011	3T	5_2	253	3	0	300	0	-300	0.00	0.00	0	0	0
0011	3T	5_2	254	1	0	100	0	-100	0.00	0.00	0	0	0
0011	3T	5_2	256	1	0	100	0	-100	0.00	0.00	0	0	0
0011	3T	5_2	261	1	0	100	0	-100	0.00	0.00	0	0	0
0011	3T	5_2	265	1	0	100	0	-100	0.00	0.00	0	0	0
0011	3T	5_3	123	57	8	5700	11620	5920	0.14	2.04	10	20	10
0011	3T	5_3	124	56	5	5600	9810	4210	0.09	1.75	9	17	8
0011	3T	5_3	125	29	1	2900	2280	-620	0.03	0.79	5	4	-1
0011	3T	5_3	126	20	1	2000	1060	-940	0.05	0.53	3	1	-2
0011	3T	5_3	132	44	4	4400	4030	-370	0.09	0.92	7	7	0
0011	3T	5_3	134	34	2	3400	2340	-1060	0.06	0.69	6	4	-2
0011	3T	5_3	135	21	1	2100	1810	-290	0.05	0.86	3	3	0
0011	3T	5_3	136	19	0	1900	0	-1900	0.00	0.00	3	0	-3
0011	3T	5_3	142	20	0	2000	0	-2000	0.00	0.00	3	0	-3
0011	3T	5_3	143	24	1	2400	5700	3300	0.04	2.38	4	10	6
0011	3T	5_3	145	14	0	1400	0	-1400	0.00	0.00	2	0	-2
0011	3T	5_3	146	9	0	900	0	-900	0.00	0.00	1	0	-1
0011	3T	5_3	152	8	0	800	0	-800	0.00	0.00	1	0	-1
0011	3T	5_3	153	12	0	1200	0	-1200	0.00	0.00	2	0	-2
0011	3T	5_3	154	3	0	300	0	-300	0.00	0.00	0	0	0
0011	3T	5_3	156	1	1	100	1120	1020	1.00	11.20	0	1	1
0011	3T	5_3	162	4	0	400	0	-400	0.00	0.00	0	0	0
0011	3T	5_3	163	6	0	600	0	-600	0.00	0.00	1	0	-1
0011	3T	5_3	164	3	0	300	0	-300	0.00	0.00	0	0	0
0011	3T	5_3	165	4	0	400	0	-400	0.00	0.00	0	0	0
0011	3T	5_3	213	1	0	100	0	-100	0.00	0.00	0	0	0
0011	3T	5_3	214	4	0	400	0	-400	0.00	0.00	0	0	0
0011	3T	5_3	215	1	0	100	0	-100	0.00	0.00	0	0	0
0011	3T	5_3	216	4	0	400	0	-400	0.00	0.00	0	0	0
0011	3T	5_3	231	1	0	100	0	-100	0.00	0.00	0	0	0
0011	3T	5_3	234	3	0	300	0	-300	0.00	0.00	0	0	0
0011	3T	5_3	236	2	0	200	0	-200	0.00	0.00	0	0	0
0011	3T	5_3	241	4	0	400	0	-400	0.00	0.00	0	0	0
0011	3T	5_3	243	1	0	100	0	-100	0.00	0.00	0	0	0
0011	3T	5_3	245	6	0	600	0	-600	0.00	0.00	1	0	-1
0011	3T	5_3	246	2	0	200	0	-200	0.00	0.00	0	0	0
0011	3T	5_3	253	5	1	500	5410	4910	0.20	10.82	0	9	9
0011	3T	5_3	254	3	0	300	0	-300	0.00	0.00	0	0	0
0011	3T	5_3	256	1	0	100	0	-100	0.00	0.00	0	0	0
0011	3T	5_3	261	2	1	200	14400	14200	0.50	72.00	0	25	25
0011	3T	5_3	263	3	0	300	0	-300	0.00	0.00	0	0	0
0011	3T	5_3	265	1	0	100	0	-100	0.00	0.00	0	0	0
0011	3T	5_4	123	59	4	5900	4730	-1170	0.07	0.80	10	8	-2
0011	3T	5_4	124	48	3	4800	2070	-2730	0.06	0.43	8	3	-5
0011	3T	5_4	125	29	0	2900	0	-2900	0.00	0.00	5	0	-5
0011	3T	5_4	126	31	1	3100	4070	970	0.03	1.31	5	7	2
0011	3T	5_4	132	27	1	2700	590	-2110	0.04	0.22	4	1	-3
0011	3T	5_4	134	34	3	3400	4160	760	0.09	1.22	6	7	1
0011	3T	5_4	135	27	1	2700	950	-1750	0.04	0.35	4	1	-3
0011	3T	5_4	136	18	0	1800	0	-1800	0.00	0.00	3	0	-3
0011	3T	5_4	142	15	1	1500	770	-730	0.07	0.51	2	1	-1
0011	3T	5_4	143	24	0	2400	0	-2400	0.00	0.00	4	0	-4
0011	3T	5_4	145	18	0	1800	0	-1800	0.00	0.00	3	0	-3
0011	3T	5_4	146	14	0	1400	0	-1400	0.00	0.00	2	0	-2
0011	3T	5_4	152	10	0	1000	0	-1000	0.00	0.00	1	0	-1
0011	3T	5_4	153	8	1	800	3880	3080	0.13	4.85	1	6	5
0011	3T	5_4	154	12	0	1200	0	-1200	0.00	0.00	2	0	-2
0011	3T	5_4	162	2	0	200	0	-200	0.00	0.00	0	0	0
0011	3T	5_4	163	3	0	300	0	-300	0.00	0.00	0	0	0
0011	3T	5_4	165	3	0	300	0	-300	0.00	0.00	0	0	0
0011	3T	5_4	213	7	0	700	0	-700	0.00	0.00	1	0	-1
0011	3T	5_4	214	4	0	400	0	-400	0.00	0.00	0	0	0
0011	3T	5_4	215	4	0	400	0	-400	0.00	0.00	0	0	0
0011	3T	5_4	216	3	0	300	0	-300	0.00	0.00	0	0	0
0011	3T	5_4	231	1	0	100	0	-100	0.00	0.00	0	0	0
0011	3T	5_4	234	1	0	100	0	-100	0.00	0.00	0	0	0
0011	3T	5_4	235	4	0	400	0	-400	0.00	0.00	0	0	0
0011	3T	5_4	236	1	0	100	0	-100	0.00	0.00	0	0	0
0011	3T	5_4	241	2	0	200	0	-200	0.00	0.00	0	0	0
0011	3T	5_4	243	2	0	200	0	-200	0.00	0.00	0	0	0
0011	3T	5_4	246	2	0	200	0	-200	0.00	0.00	0	0	0
0011	3T	5_4	251	2	0	200	0	-200	0.00	0.00	0	0	0
0011	3T	5_4	254	3	0	300	0	-300	0.00	0.00	0	0	0
0011	3T	5_5	123	70	12	7000	17540	10540	0.17	2.51	12	31	19
0011	3T	5_5	124	54	7	5400	4290	-1110	0.13	0.79	9	7	-2
0011	3T	5_5	125	39	0	3900	0	-3900	0.00	0.00	6	0	-6
0011	3T	5_5	126	25	1	2500	3900	1400	0.04	1.56	4	6	2
0011	3T	5_5	132	43	1	4300	710	-3590	0.02	0.17	7	1	-6
0011	3T	5_5	134	45	2	4500	1730	-2770	0.04	0.38	7	3	-4
0011	3T	5_5	135	19	1	1900	1070	-830	0.05	0.56	3	1	-2
0011	3T	5_5	136	21	1	2100	690	-1410	0.05	0.33	3	1	-2
0011	3T	5_5	142	13	1	1300	920	-380	0.08	0.71	2	1	-1
0011	3T	5_5	143	29	0	2900	0	-2900	0.00	0.00	5	0	-5
0011	3T	5_5	145	10	0	1000	0	-1000	0.00	0.00	1	0	-1
0011	3T	5_5	146	6	0	600	0	-600	0.00	0.00	1	0	-1
0011	3T	5_5	152	8	0	800	0	-800	0.00	0.00	1	0	-1
0011	3T	5_5	153	4	0	400	0	-400	0.00	0.00	0	0	0
0011	3T	5_5	154	3	0	300	0	-300	0.00	0.00	0	0	0
0011	3T	5_5	156	10	0	1000	0	-1000	0.00	0.00	1	0	-1
0011	3T	5_5	162	3	1	300	24300	24000	0.33	81.00	0	43	43
0011	3T	5_5	163	5	1	500	1740	1240	0.20	3.48	0	3	3
0011	3T	5_5	164	3	0	300	0	-300	0.00	0.00	0	0	0
0011	3T	5_5	165	5	0	500	0	-500	0.00	0.00	0	0	0
0011	3T	5_5	213	4	0	400	0	-400	0.00	0.00	0	0	0
0011	3T	5_5	214	3	0	300	0	-300	0.00	0.00	0	0	0
0011	3T	5_5	215	1	0	100	0	-100	0.00	0.00	0	0	0
0011	3T	5_5	216	1	0	100	0	-100	0.00	0.00	0	0	0
0011	3T	5_5	234	2	0	200	0	-200	0.00	0.00	0	0	0
0011	3T	5_5	235	2	0	200	0	-200	0.00	0.00	0	0	0
0011	3T	5_5	236	1	0	100	0	-100	0.00	0.00	0	0	0
0011	3T	5_5	241	1	0	100	0	-100	0.00	0.00	0	0	0
0011	3T	5_5	243	2	0	200	0	-200	0.00	0.00	0	0	0
0011	3T	5_5	245	1	0	100	0	-100	0.00	0.00	0	0	0
0011	3T	5_5	246	1	0	100	0	-100	0.00	0.00	0	0	0
0011	3T	5_5	253	2	0	200	0	-200	0.00	0.00	0	0	0
0011	3T	5_5	254	1	0	100	0	-100	0.00	0.00	0	0	0
0011	3T	5_5	256	2	0	200	0	-200	0.00	0.00	0	0	0
0011	3T	5_6	123	56	7	5600	6970	1370	0.13	1.24	9	12	3
0011	3T	5_6	124	53	3	5300	1750	-3550	0.06	0.33	9	3	-6
0011	3T	5_6	125	31	1	3100	1780	-1320	0.03	0.57	5	3	-2
0011	3T	5_6	126	22	3	2200	9840	7640	0.14	4.47	3	17	14
0011	3T	5_6	132	29	3	2900	1990	-910	0.10	0.69	5	3	-2
0011	3T	5_6	134	32	1	3200	540	-2660	0.03	0.17	5	0	-5
0011	3T	5_6	135	29	2	2900	2100	-800	0.07	0.72	5	3	-2
0011	3T	5_6	136	16	1	1600	430	-1170	0.06	0.27	2	0	-2
0011	3T	5_6	142	25	1	2500	660	-1840	0.04	0.26	4	1	-3
0011	3T	5_6	143	17	0	1700	0	-1700	0.00	0.00	3	0	-3
0011	3T	5_6	145	17	0	1700	0	-1700	0.00	0.00	3	0	-3
0011	3T	5_6	146	12	1	1200	910	-290	0.08	0.76	2	1	-1
0011	3T	5_6	152	9	0	900	0	-900	0.00	0.00	1	0	-1
0011	3T	5_6	153	11	0	1100	0	-1100	0.00	0.00	1	0	-1
0011	3T	5_6	154	6	0	600	0	-600	0.00	0.00	1	0	-1
0011	3T	5_6	156	2	0	200	0	-200	0.00	0.00	0	0	0
0011	3T	5_6	162	2	0	200	0	-200	0.00	0.00	0	0	0
0011	3T	5_6	163	8	0	800	0	-800	0.00	0.00	1	0	-1
0011	3T	5_6	164	4	0	400	0	-400	0.00	0.00	0	0	0
0011	3T	5_6	165	3	1	300	3340	3040	0.33	11.13	0	5	5
0011	3T	5_6	213	5	0	500	0	-500	0.00	0.00	0	0	0
0011	3T	5_6	214	8	0	800	0	-800	0.00	0.00	1	0	-1
0011	3T	5_6	215	5	1	500	2170	1670	0.20	4.34	0	3	3
0011	3T	5_6	216	1	0	100	0	-100	0.00	0.00	0	0	0
0011	3T	5_6	231	1	0	100	0	-100	0.00	0.00	0	0	0
0011	3T	5_6	234	4	0	400	0	-400	0.00	0.00	0	0	0
0011	3T	5_6	235	2	0	200	0	-200	0.00	0.00	0	0	0
0011	3T	5_6	236	4	2	400	11160	10760	0.50	27.90	0	19	19
0011	3T	5_6	243	4	0	400	0	-400	0.00	0.00	0	0	0
0011	3T	5_6	245	2	0	200	0	-200	0.00	0.00	0	0	0
0011	3T	5_6	246	1	0	100	0	-100	0.00	0.00	0	0	0
0011	3T	5_6	251	2	0	200	0	-200	0.00	0.00	0	0	0
0011	3T	5_6	253	2	0	200	0	-200	0.00	0.00	0	0	0
0011	3T	5_6	254	1	0	100	0	-100	0.00	0.00	0	0	0
0011	3T	5_6	256	1	0	100	0	-100	0.00	0.00	0	0	0
0011	3T	5_6	264	2	0	200	0	-200	0.00	0.00	0	0	0
0011	3T	5_6	265	2	0	200	0	-200	0.00	0.00	0	0	0
0011	3T	5_7	123	65	6	6500	8410	1910	0.09	1.29	11	14	3
0011	3T	5_7	124	57	4	5700	7230	1530	0.07	1.27	10	12	2
0011	3T	5_7	125	34	2	3400	1940	-1460	0.06	0.57	6	3	-3
0011	3T	5_7	126	17	0	1700	0	-1700	0.00	0.00	3	0	-3
0011	3T	5_7	132	35	1	3500	1340	-2160	0.03	0.38	6	2	-4
0011	3T	5_7	134	44	4	4400	3020	-1380	0.09	0.69	7	5	-2
0011	3T	5_7	135	29	3	2900	2650	-250	0.10	0.91	5	4	-1
0011	3T	5_7	136	20	1	2000	1570	-430	0.05	0.79	3	2	-1
0011	3T	5_7	142	37	3	3700	3990	290	0.08	1.08	6	7	1
0011	3T	5_7	143	17	0	1700	0	-1700	0.00	0.00	3	0	-3
0011	3T	5_7	145	18	0	1800	0	-1800	0.00	0.00	3	0	-3
0011	3T	5_7	146	11	1	1100	700	-400	0.09	0.64	1	1	0
0011	3T	5_7	152	9	0	900	0	-900	0.00	0.00	1	0	-1
0011	3T	5_7	153	10	1	1000	930	-70	0.10	0.93	1	1	0
0011	3T	5_7	154	5	0	500	0	-500	0.00	0.00	0	0	0
0011	3T	5_7	156	4	0	400	0	-400	0.00	0.00	0	0	0
0011	3T	5_7	162	5	0	500	0	-500	0.00	0.00	0	0	0
0011	3T	5_7	163	1	0	100	0	-100	0.00	0.00	0	0	0
0011	3T	5_7	164	3	0	300	0	-300	0.00	0.00	0	0	0
0011	3T	5_7	165	3	1	300	770	470	0.33	2.57	0	1	1
0011	3T	5_7	213	4	0	400	0	-400	0.00	0.00	0	0	0
0011	3T	5_7	214	3	0	300	0	-300	0.00	0.00	0	0	0
0011	3T	5_7	216	1	0	100	0	-100	0.00	0.00	0	0	0
0011	3T	5_7	234	2	0	200	0	-200	0.00	0.00	0	0	0
0011	3T	5_7	235	3	0	300	0	-300	0.00	0.00	0	0	0
0011	3T	5_7	236	1	0	100	0	-100	0.00	0.00	0	0	0
0011	3T	5_7	243	1	0	100	0	-100	0.00	0.00	0	0	0
0011	3T	5_7	245	1	0	100	0	-100	0.00	0.00	0	0	0
0011	3T	5_7	253	1	0	100	0	-100	0.00	0.00	0	0	0
0011	3T	5_7	254	2	0	200	0	-200	0.00	0.00	0	0	0
0011	3T	5_7	264	1	0	100	0	-100	0.00	0.00	0	0	0
0011	3T	5_8	123	59	3	5900	5130	-770	0.05	0.87	10	9	-1
0011	3T	5_8	124	55	4	5500	3770	-1730	0.07	0.69	9	6	-3
0011	3T	5_8	125	41	3	4100	4360	260	0.07	1.06	7	7	0
0011	3T	5_8	126	23	2	2300	5210	2910	0.09	2.27	4	9	5
0011	3T	5_8	132	41	5	4100	5380	1280	0.12	1.31	7	9	2
0011	3T	5_8	134	22	2	2200	3390	1190	0.09	1.54	3	6	3
0011	3T	5_8	135	27	2	2700	2580	-120	0.07	0.96	4	4	0
0011	3T	5_8	136	17	1	1700	560	-1140	0.06	0.33	3	0	-3
0011	3T	5_8	142	36	4	3600	2410	-1190	0.11	0.67	6	4	-2
0011	3T	5_8	143	22	0	2200	0	-2200	0.00	0.00	3	0	-3
0011	3T	5_8	145	21	1	2100	1300	-800	0.05	0.62	3	2	-1
0011	3T	5_8	146	9	2	900	1670	770	0.22	1.86	1	2	1
0011	3T	5_8	152	9	0	900	0	-900	0.00	0.00	1	0	-1
0011	3T	5_8	153	6	0	600	0	-600	0.00	0.00	1	0	-1
0011	3T	5_8	154	6	0	600	0	-600	0.00	0.00	1	0	-1
0011	3T	5_8	156	3	0	300	0	-300	0.00	0.00	0	0	0
0011	3T	5_8	162	4	0	400	0	-400	0.00	0.00	0	0	0
0011	3T	5_8	163	6	2	600	4870	4270	0.33	8.12	1	8	7
0011	3T	5_8	164	6	0	600	0	-600	0.00	0.00	1	0	-1
0011	3T	5_8	165	2	0	200	0	-200	0.00	0.00	0	0	0
0011	3T	5_8	213	1	0	100	0	-100	0.00	0.00	0	0	0
0011	3T	5_8	214	5	0	500	0	-500	0.00	0.00	0	0	0
0011	3T	5_8	215	1	0	100	0	-100	0.00	0.00	0	0	0
0011	3T	5_8	216	1	0	100	0	-100	0.00	0.00	0	0	0
0011	3T	5_8	231	2	0	200	0	-200	0.00	0.00	0	0	0
0011	3T	5_8	234	1	0	100	0	-100	0.00	0.00	0	0	0
0011	3T	5_8	235	3	0	300	0	-300	0.00	0.00	0	0	0
0011	3T	5_8	236	5	0	500	0	-500	0.00	0.00	0	0	0
0011	3T	5_8	243	1	0	100	0	-100	0.00	0.00	0	0	0
0011	3T	5_8	246	1	0	100	0	-100	0.00	0.00	0	0	0
0011	3T	5_8	253	1	0	100	0	-100	0.00	0.00	0	0	0
0011	3T	5_8	254	1	0	100	0	-100	0.00	0.00	0	0	0
0011	3T	5_9	123	71	8	7100	6310	-790	0.11	0.89	12	11	-1
0011	3T	5_9	124	65	6	6500	5250	-1250	0.09	0.81	11	9	-2
0011	3T	5_9	125	49	3	4900	3300	-1600	0.06	0.67	8	5	-3
0011	3T	5_9	126	27	1	2700	990	-1710	0.04	0.37	4	1	-3
0011	3T	5_9	132	37	4	3700	5090	1390	0.11	1.38	6	9	3
0011	3T	5_9	134	48	4	4800	7290	2490	0.08	1.52	8	12	4
0011	3T	5_9	135	25	0	2500	0	-2500	0.00	0.00	4	0	-4
0011	3T	5_9	136	15	0	1500	0	-1500	0.00	0.00	2	0	-2
0011	3T	5_9	142	38	0	3800	0	-3800	0.00	0.00	6	0	-6
0011	3T	5_9	143	24	1	2400	900	-1500	0.04	0.38	4	1	-3
0011	3T	5_9	145	24	1	2400	750	-1650	0.04	0.31	4	1	-3
0011	3T	5_9	146	9	1	900	1510	610	0.11	1.68	1	2	1
0011	3T	5_9	152	7	0	700	0	-700	0.00	0.00	1	0	-1
0011	3T	5_9	153	10	0	1000	0	-1000	0.00	0.00	1	0	-1
0011	3T	5_9	154	7	0	700	0	-700	0.00	0.00	1	0	-1
0011	3T	5_9	156	5	0	500	0	-500	0.00	0.00	0	0	0
0011	3T	5_9	162	6	0	600	0	-600	0.00	0.00	1	0	-1
0011	3T	5_9	163	3	0	300	0	-300	0.00	0.00	0	0	0
0011	3T	5_9	164	7	1	700	2460	1760	0.14	3.51	1	4	3
0011	3T	5_9	165	1	0	100	0	-100	0.00	0.00	0	0	0
0011	3T	5_9	213	3	0	300	0	-300	0.00	0.00	0	0	0
0011	3T	5_9	214	3	0	300	0	-300	0.00	0.00	0	0	0
0011	3T	5_9	215	3	1	300	3800	3500	0.33	12.67	0	6	6
0011	3T	5_9	216	1	0	100	0	-100	0.00	0.00	0	0	0
0011	3T	5_9	234	4	0	400	0	-400	0.00	0.00	0	0	0
0011	3T	5_9	235	1	0	100	0	-100	0.00	0.00	0	0	0
0011	3T	5_9	236	1	0	100	0	-100	0.00	0.00	0	0	0
0011	3T	5_9	241	2	0	200	0	-200	0.00	0.00	0	0	0
0011	3T	5_9	245	1	0	100	0	-100	0.00	0.00	0	0	0
0011	3T	5_9	256	1	0	100	0	-100	0.00	0.00	0	0	0
0011	3T	6_1	123	7	0	700	0	-700	0.00	0.00	1	0	-1
0011	3T	6_1	124	5	1	500	560	60	0.20	1.12	0	0	0
0011	3T	6_1	125	3	1	300	940	640	0.33	3.13	0	1	1
0011	3T	6_1	126	1	0	100	0	-100	0.00	0.00	0	0	0
0011	3T	6_1	132	1	0	100	0	-100	0.00	0.00	0	0	0
0011	3T	6_1	134	3	2	300	1220	920	0.67	4.07	0	2	2
0011	3T	6_1	135	1	0	100	0	-100	0.00	0.00	0	0	0
0011	3T	6_1	136	3	0	300	0	-300	0.00	0.00	0	0	0
0011	3T	6_1	142	1	0	100	0	-100	0.00	0.00	0	0	0
0011	3T	6_1	143	2	0	200	0	-200	0.00	0.00	0	0	0
0011	3T	6_1	146	1	0	100	0	-100	0.00	0.00	0	0	0
0011	3T	6_1	154	2	0	200	0	-200	0.00	0.00	0	0	0
0011	3T	6_1	156	1	0	100	0	-100	0.00	0.00	0	0	0
0011	3T	6_1	162	1	0	100	0	-100	0.00	0.00	0	0	0
0011	3T	6_1	216	1	0	100	0	-100	0.00	0.00	0	0	0
0011	3T	6_1	236	1	0	100	0	-100	0.00	0.00	0	0	0
0011	3T	6_10	123	11	2	1100	1100	0	0.18	1.00	1	1	0
0011	3T	6_10	124	6	1	600	370	-230	0.17	0.62	1	0	-1
0011	3T	6_10	125	6	1	600	1810	1210	0.17	3.02	1	3	2
0011	3T	6_10	126	3	0	300	0	-300	0.00	0.00	0	0	0
0011	3T	6_10	134	1	0	100	0	-100	0.00	0.00	0	0	0
0011	3T	6_10	135	1	0	100	0	-100	0.00	0.00	0	0	0
0011	3T	6_10	136	2	0	200	0	-200	0.00	0.00	0	0	0
0011	3T	6_10	143	1	0	100	0	-100	0.00	0.00	0	0	0
0011	3T	6_10	145	2	0	200	0	-200	0.00	0.00	0	0	0
0011	3T	6_10	146	1	0	100	0	-100	0.00	0.00	0	0	0
0011	3T	6_10	153	1	0	100	0	-100	0.00	0.00	0	0	0
0011	3T	6_10	154	1	0	100	0	-100	0.00	0.00	0	0	0
0011	3T	6_10	165	1	0	100	0	-100	0.00	0.00	0	0	0
0011	3T	6_10	213	1	0	100	0	-100	0.00	0.00	0	0	0
0011	3T	6_11	123	6	0	600	0	-600	0.00	0.00	1	0	-1
0011	3T	6_11	124	11	1	1100	870	-230	0.09	0.79	1	1	0
0011	3T	6_11	125	5	1	500	660	160	0.20	1.32	0	1	1
0011	3T	6_11	126	3	0	300	0	-300	0.00	0.00	0	0	0
0011	3T	6_11	132	4	0	400	0	-400	0.00	0.00	0	0	0
0011	3T	6_11	134	5	0	500	0	-500	0.00	0.00	0	0	0
0011	3T	6_11	135	1	0	100	0	-100	0.00	0.00	0	0	0
0011	3T	6_11	136	3	0	300	0	-300	0.00	0.00	0	0	0
0011	3T	6_11	145	1	0	100	0	-100	0.00	0.00	0	0	0
0011	3T	6_11	146	2	0	200	0	-200	0.00	0.00	0	0	0
0011	3T	6_11	153	1	0	100	0	-100	0.00	0.00	0	0	0
0011	3T	6_11	156	1	0	100	0	-100	0.00	0.00	0	0	0
0011	3T	6_11	246	1	0	100	0	-100	0.00	0.00	0	0	0
0011	3T	6_12	123	9	0	900	0	-900	0.00	0.00	1	0	-1
0011	3T	6_12	124	14	1	1400	1250	-150	0.07	0.89	2	2	0
0011	3T	6_12	125	4	1	400	730	330	0.25	1.83	0	1	1
0011	3T	6_12	126	5	0	500	0	-500	0.00	0.00	0	0	0
0011	3T	6_12	132	3	0	300	0	-300	0.00	0.00	0	0	0
0011	3T	6_12	134	4	0	400	0	-400	0.00	0.00	0	0	0
0011	3T	6_12	135	1	0	100	0	-100	0.00	0.00	0	0	0
0011	3T	6_12	136	1	0	100	0	-100	0.00	0.00	0	0	0
0011	3T	6_12	142	2	0	200	0	-200	0.00	0.00	0	0	0
0011	3T	6_12	145	4	0	400	0	-400	0.00	0.00	0	0	0
0011	3T	6_12	153	1	0	100	0	-100	0.00	0.00	0	0	0
0011	3T	6_12	156	1	0	100	0	-100	0.00	0.00	0	0	0
0011	3T	6_2	123	3	1	300	1240	940	0.33	4.13	0	2	2
0011	3T	6_2	124	3	0	300	0	-300	0.00	0.00	0	0	0
0011	3T	6_2	132	1	0	100	0	-100	0.00	0.00	0	0	0
0011	3T	6_2	134	2	0	200	0	-200	0.00	0.00	0	0	0
0011	3T	6_2	135	2	0	200	0	-200	0.00	0.00	0	0	0
0011	3T	6_2	136	1	0	100	0	-100	0.00	0.00	0	0	0
0011	3T	6_2	142	5	0	500	0	-500	0.00	0.00	0	0	0
0011	3T	6_2	143	1	0	100	0	-100	0.00	0.00	0	0	0
0011	3T	6_2	145	2	0	200	0	-200	0.00	0.00	0	0	0
0011	3T	6_2	146	2	0	200	0	-200	0.00	0.00	0	0	0
0011	3T	6_2	154	2	0	200	0	-200	0.00	0.00	0	0	0
0011	3T	6_2	163	1	0	100	0	-100	0.00	0.00	0	0	0
0011	3T	6_2	213	1	0	100	0	-100	0.00	0.00	0	0	0
0011	3T	6_2	215	1	0	100	0	-100	0.00	0.00	0	0	0
0011	3T	6_2	236	1	0	100	0	-100	0.00	0.00	0	0	0
0011	3T	6_2	241	1	0	100	0	-100	0.00	0.00	0	0	0
0011	3T	6_3	123	1	0	100	0	-100	0.00	0.00	0	0	0
0011	3T	6_3	124	3	0	300	0	-300	0.00	0.00	0	0	0
0011	3T	6_3	125	3	0	300	0	-300	0.00	0.00	0	0	0
0011	3T	6_3	126	2	0	200	0	-200	0.00	0.00	0	0	0
0011	3T	6_3	132	7	0	700	0	-700	0.00	0.00	1	0	-1
0011	3T	6_3	134	1	0	100	0	-100	0.00	0.00	0	0	0
0011	3T	6_3	135	1	0	100	0	-100	0.00	0.00	0	0	0
0011	3T	6_3	142	3	0	300	0	-300	0.00	0.00	0	0	0
0011	3T	6_3	143	3	0	300	0	-300	0.00	0.00	0	0	0
0011	3T	6_3	145	2	0	200	0	-200	0.00	0.00	0	0	0
0011	3T	6_3	146	2	0	200	0	-200	0.00	0.00	0	0	0
0011	3T	6_3	152	1	0	100	0	-100	0.00	0.00	0	0	0
0011	3T	6_3	153	1	0	100	0	-100	0.00	0.00	0	0	0
0011	3T	6_3	215	1	0	100	0	-100	0.00	0.00	0	0	0
0011	3T	6_3	256	1	0	100	0	-100	0.00	0.00	0	0	0
0011	3T	6_4	123	7	0	700	0	-700	0.00	0.00	1	0	-1
0011	3T	6_4	124	5	0	500	0	-500	0.00	0.00	0	0	0
0011	3T	6_4	125	4	1	400	1530	1130	0.25	3.83	0	2	2
0011	3T	6_4	126	2	0	200	0	-200	0.00	0.00	0	0	0
0011	3T	6_4	132	4	0	400	0	-400	0.00	0.00	0	0	0
0011	3T	6_4	134	1	0	100	0	-100	0.00	0.00	0	0	0
0011	3T	6_4	135	4	0	400	0	-400	0.00	0.00	0	0	0
0011	3T	6_4	136	1	0	100	0	-100	0.00	0.00	0	0	0
0011	3T	6_4	142	1	0	100	0	-100	0.00	0.00	0	0	0
0011	3T	6_4	143	1	0	100	0	-100	0.00	0.00	0	0	0
0011	3T	6_4	145	2	0	200	0	-200	0.00	0.00	0	0	0
0011	3T	6_4	146	1	0	100	0	-100	0.00	0.00	0	0	0
0011	3T	6_4	154	1	0	100	0	-100	0.00	0.00	0	0	0
0011	3T	6_4	163	1	0	100	0	-100	0.00	0.00	0	0	0
0011	3T	6_5	123	4	0	400	0	-400	0.00	0.00	0	0	0
0011	3T	6_5	124	10	1	1000	530	-470	0.10	0.53	1	0	-1
0011	3T	6_5	125	5	0	500	0	-500	0.00	0.00	0	0	0
0011	3T	6_5	132	3	0	300	0	-300	0.00	0.00	0	0	0
0011	3T	6_5	134	4	0	400	0	-400	0.00	0.00	0	0	0
0011	3T	6_5	135	5	0	500	0	-500	0.00	0.00	0	0	0
0011	3T	6_5	136	1	0	100	0	-100	0.00	0.00	0	0	0
0011	3T	6_5	143	1	0	100	0	-100	0.00	0.00	0	0	0
0011	3T	6_5	145	4	1	400	820	420	0.25	2.05	0	1	1
0011	3T	6_5	164	1	0	100	0	-100	0.00	0.00	0	0	0
0011	3T	6_5	165	1	0	100	0	-100	0.00	0.00	0	0	0
0011	3T	6_6	123	3	0	300	0	-300	0.00	0.00	0	0	0
0011	3T	6_6	124	2	0	200	0	-200	0.00	0.00	0	0	0
0011	3T	6_6	125	6	1	600	1260	660	0.17	2.10	1	2	1
0011	3T	6_6	126	3	0	300	0	-300	0.00	0.00	0	0	0
0011	3T	6_6	132	3	0	300	0	-300	0.00	0.00	0	0	0
0011	3T	6_6	134	3	0	300	0	-300	0.00	0.00	0	0	0
0011	3T	6_6	135	1	0	100	0	-100	0.00	0.00	0	0	0
0011	3T	6_6	136	2	0	200	0	-200	0.00	0.00	0	0	0
0011	3T	6_6	142	2	0	200	0	-200	0.00	0.00	0	0	0
0011	3T	6_6	143	2	0	200	0	-200	0.00	0.00	0	0	0
0011	3T	6_6	145	1	0	100	0	-100	0.00	0.00	0	0	0
0011	3T	6_6	146	2	0	200	0	-200	0.00	0.00	0	0	0
0011	3T	6_6	152	1	0	100	0	-100	0.00	0.00	0	0	0
0011	3T	6_6	153	1	0	100	0	-100	0.00	0.00	0	0	0
0011	3T	6_6	154	1	0	100	0	-100	0.00	0.00	0	0	0
0011	3T	6_6	163	1	0	100	0	-100	0.00	0.00	0	0	0
0011	3T	6_6	164	2	0	200	0	-200	0.00	0.00	0	0	0
0011	3T	6_6	243	1	0	100	0	-100	0.00	0.00	0	0	0
0011	3T	6_7	123	4	0	400	0	-400	0.00	0.00	0	0	0
0011	3T	6_7	124	3	1	300	1480	1180	0.33	4.93	0	2	2
0011	3T	6_7	125	1	0	100	0	-100	0.00	0.00	0	0	0
0011	3T	6_7	126	2	0	200	0	-200	0.00	0.00	0	0	0
0011	3T	6_7	132	2	0	200	0	-200	0.00	0.00	0	0	0
0011	3T	6_7	134	2	1	200	650	450	0.50	3.25	0	1	1
0011	3T	6_7	136	4	1	400	690	290	0.25	1.73	0	1	1
0011	3T	6_7	142	1	0	100	0	-100	0.00	0.00	0	0	0
0011	3T	6_7	143	1	0	100	0	-100	0.00	0.00	0	0	0
0011	3T	6_7	145	1	0	100	0	-100	0.00	0.00	0	0	0
0011	3T	6_7	146	1	0	100	0	-100	0.00	0.00	0	0	0
0011	3T	6_7	153	2	0	200	0	-200	0.00	0.00	0	0	0
0011	3T	6_7	154	1	0	100	0	-100	0.00	0.00	0	0	0
0011	3T	6_7	163	1	0	100	0	-100	0.00	0.00	0	0	0
0011	3T	6_7	165	1	0	100	0	-100	0.00	0.00	0	0	0
0011	3T	6_7	213	1	1	100	2490	2390	1.00	24.90	0	4	4
0011	3T	6_7	243	1	0	100	0	-100	0.00	0.00	0	0	0
0011	3T	6_8	123	3	0	300	0	-300	0.00	0.00	0	0	0
0011	3T	6_8	124	6	0	600	0	-600	0.00	0.00	1	0	-1
0011	3T	6_8	125	1	0	100	0	-100	0.00	0.00	0	0	0
0011	3T	6_8	132	3	1	300	450	150	0.33	1.50	0	0	0
0011	3T	6_8	134	3	0	300	0	-300	0.00	0.00	0	0	0
0011	3T	6_8	135	1	0	100	0	-100	0.00	0.00	0	0	0
0011	3T	6_8	136	3	0	300	0	-300	0.00	0.00	0	0	0
0011	3T	6_8	142	2	0	200	0	-200	0.00	0.00	0	0	0
0011	3T	6_8	143	2	0	200	0	-200	0.00	0.00	0	0	0
0011	3T	6_8	146	1	0	100	0	-100	0.00	0.00	0	0	0
0011	3T	6_8	152	2	0	200	0	-200	0.00	0.00	0	0	0
0011	3T	6_8	153	3	0	300	0	-300	0.00	0.00	0	0	0
0011	3T	6_8	154	1	0	100	0	-100	0.00	0.00	0	0	0
0011	3T	6_8	163	1	0	100	0	-100	0.00	0.00	0	0	0
0011	3T	6_8	164	2	0	200	0	-200	0.00	0.00	0	0	0
0011	3T	6_9	123	6	0	600	0	-600	0.00	0.00	1	0	-1
0011	3T	6_9	124	7	0	700	0	-700	0.00	0.00	1	0	-1
0011	3T	6_9	125	4	0	400	0	-400	0.00	0.00	0	0	0
0011	3T	6_9	126	4	0	400	0	-400	0.00	0.00	0	0	0
0011	3T	6_9	132	3	0	300	0	-300	0.00	0.00	0	0	0
0011	3T	6_9	134	4	0	400	0	-400	0.00	0.00	0	0	0
0011	3T	6_9	135	1	0	100	0	-100	0.00	0.00	0	0	0
0011	3T	6_9	142	2	0	200	0	-200	0.00	0.00	0	0	0
0011	3T	6_9	145	2	0	200	0	-200	0.00	0.00	0	0	0
0011	3T	6_9	146	2	0	200	0	-200	0.00	0.00	0	0	0
0011	3T	6_9	153	1	0	100	0	-100	0.00	0.00	0	0	0
0011	3T	6_9	165	1	0	100	0	-100	0.00	0.00	0	0	0
0011	3T	6_9	216	1	0	100	0	-100	0.00	0.00	0	0	0
0011	3T	6_9	243	1	0	100	0	-100	0.00	0.00	0	0	0
0011	3T	6_9	246	1	0	100	0	-100	0.00	0.00	0	0	0
0011	3T	7_1	123	121	18	12100	19140	7040	0.15	1.58	21	33	12
0011	3T	7_1	124	78	8	7800	7780	-20	0.10	1.00	13	13	0
0011	3T	7_1	125	55	1	5500	580	-4920	0.02	0.11	9	1	-8
0011	3T	7_1	126	31	0	3100	0	-3100	0.00	0.00	5	0	-5
0011	3T	7_1	132	61	3	6100	3750	-2350	0.05	0.61	10	6	-4
0011	3T	7_1	134	67	5	6700	4950	-1750	0.07	0.74	11	8	-3
0011	3T	7_1	135	50	1	5000	740	-4260	0.02	0.15	8	1	-7
0011	3T	7_1	136	24	0	2400	0	-2400	0.00	0.00	4	0	-4
0011	3T	7_1	142	45	3	4500	7210	2710	0.07	1.60	7	12	5
0011	3T	7_1	143	40	3	4000	2630	-1370	0.08	0.66	7	4	-3
0011	3T	7_1	145	12	1	1200	1220	20	0.08	1.02	2	2	0
0011	3T	7_1	146	8	0	800	0	-800	0.00	0.00	1	0	-1
0011	3T	7_1	152	10	0	1000	0	-1000	0.00	0.00	1	0	-1
0011	3T	7_1	153	12	0	1200	0	-1200	0.00	0.00	2	0	-2
0011	3T	7_1	154	10	1	1000	330	-670	0.10	0.33	1	0	-1
0011	3T	7_1	156	2	0	200	0	-200	0.00	0.00	0	0	0
0011	3T	7_1	162	3	0	300	0	-300	0.00	0.00	0	0	0
0011	3T	7_1	163	6	0	600	0	-600	0.00	0.00	1	0	-1
0011	3T	7_1	164	2	0	200	0	-200	0.00	0.00	0	0	0
0011	3T	7_1	165	6	0	600	0	-600	0.00	0.00	1	0	-1
0011	3T	7_1	213	6	1	600	3290	2690	0.17	5.48	1	5	4
0011	3T	7_1	214	4	0	400	0	-400	0.00	0.00	0	0	0
0011	3T	7_1	215	5	1	500	1500	1000	0.20	3.00	0	2	2
0011	3T	7_1	216	2	0	200	0	-200	0.00	0.00	0	0	0
0011	3T	7_1	231	5	0	500	0	-500	0.00	0.00	0	0	0
0011	3T	7_1	234	7	1	700	3240	2540	0.14	4.63	1	5	4
0011	3T	7_1	235	8	1	800	2750	1950	0.13	3.44	1	4	3
0011	3T	7_1	236	5	0	500	0	-500	0.00	0.00	0	0	0
0011	3T	7_1	241	2	0	200	0	-200	0.00	0.00	0	0	0
0011	3T	7_1	243	1	0	100	0	-100	0.00	0.00	0	0	0
0011	3T	7_1	245	4	0	400	0	-400	0.00	0.00	0	0	0
0011	3T	7_1	253	3	0	300	0	-300	0.00	0.00	0	0	0
0011	3T	7_1	254	3	0	300	0	-300	0.00	0.00	0	0	0
0011	3T	7_1	256	1	0	100	0	-100	0.00	0.00	0	0	0
0011	3T	7_1	263	1	0	100	0	-100	0.00	0.00	0	0	0
0011	3T	7_10	123	131	11	13100	7810	-5290	0.08	0.60	23	13	-10
0011	3T	7_10	124	137	12	13700	10290	-3410	0.09	0.75	24	18	-6
0011	3T	7_10	125	74	7	7400	12850	5450	0.09	1.74	13	22	9
0011	3T	7_10	126	58	2	5800	3300	-2500	0.03	0.57	10	5	-5
0011	3T	7_10	132	57	7	5700	7020	1320	0.12	1.23	10	12	2
0011	3T	7_10	134	52	2	5200	1840	-3360	0.04	0.35	9	3	-6
0011	3T	7_10	135	39	6	3900	9110	5210	0.15	2.34	6	16	10
0011	3T	7_10	136	21	0	2100	0	-2100	0.00	0.00	3	0	-3
0011	3T	7_10	142	29	4	2900	6850	3950	0.14	2.36	5	12	7
0011	3T	7_10	143	39	1	3900	2120	-1780	0.03	0.54	6	3	-3
0011	3T	7_10	145	30	0	3000	0	-3000	0.00	0.00	5	0	-5
0011	3T	7_10	146	24	0	2400	0	-2400	0.00	0.00	4	0	-4
0011	3T	7_10	152	5	0	500	0	-500	0.00	0.00	0	0	0
0011	3T	7_10	153	11	0	1100	0	-1100	0.00	0.00	1	0	-1
0011	3T	7_10	154	12	0	1200	0	-1200	0.00	0.00	2	0	-2
0011	3T	7_10	156	7	1	700	5180	4480	0.14	7.40	1	9	8
0011	3T	7_10	162	1	0	100	0	-100	0.00	0.00	0	0	0
0011	3T	7_10	163	5	0	500	0	-500	0.00	0.00	0	0	0
0011	3T	7_10	164	3	0	300	0	-300	0.00	0.00	0	0	0
0011	3T	7_10	165	3	0	300	0	-300	0.00	0.00	0	0	0
0011	3T	7_10	213	3	0	300	0	-300	0.00	0.00	0	0	0
0011	3T	7_10	214	8	0	800	0	-800	0.00	0.00	1	0	-1
0011	3T	7_10	215	8	0	800	0	-800	0.00	0.00	1	0	-1
0011	3T	7_10	216	1	0	100	0	-100	0.00	0.00	0	0	0
0011	3T	7_10	231	1	0	100	0	-100	0.00	0.00	0	0	0
0011	3T	7_10	234	7	0	700	0	-700	0.00	0.00	1	0	-1
0011	3T	7_10	235	2	0	200	0	-200	0.00	0.00	0	0	0
0011	3T	7_10	236	2	0	200	0	-200	0.00	0.00	0	0	0
0011	3T	7_10	241	1	0	100	0	-100	0.00	0.00	0	0	0
0011	3T	7_10	243	4	0	400	0	-400	0.00	0.00	0	0	0
0011	3T	7_10	245	2	0	200	0	-200	0.00	0.00	0	0	0
0011	3T	7_10	251	1	0	100	0	-100	0.00	0.00	0	0	0
0011	3T	7_10	256	1	0	100	0	-100	0.00	0.00	0	0	0
0011	3T	7_10	264	1	0	100	0	-100	0.00	0.00	0	0	0
0011	3T	7_10	265	1	0	100	0	-100	0.00	0.00	0	0	0
0011	3T	7_11	123	137	23	13700	17030	3330	0.17	1.24	24	30	6
0011	3T	7_11	124	165	12	16500	7910	-8590	0.07	0.48	29	14	-15
0011	3T	7_11	125	78	7	7800	10730	2930	0.09	1.38	13	18	5
0011	3T	7_11	126	53	4	5300	7260	1960	0.08	1.37	9	12	3
0011	3T	7_11	132	64	3	6400	5730	-670	0.05	0.90	11	10	-1
0011	3T	7_11	134	72	3	7200	5230	-1970	0.04	0.73	12	9	-3
0011	3T	7_11	135	56	5	5600	12990	7390	0.09	2.32	9	22	13
0011	3T	7_11	136	38	0	3800	0	-3800	0.00	0.00	6	0	-6
0011	3T	7_11	142	37	1	3700	1620	-2080	0.03	0.44	6	2	-4
0011	3T	7_11	143	26	2	2600	5940	3340	0.08	2.28	4	10	6
0011	3T	7_11	145	26	1	2600	3230	630	0.04	1.24	4	5	1
0011	3T	7_11	146	16	0	1600	0	-1600	0.00	0.00	2	0	-2
0011	3T	7_11	152	10	0	1000	0	-1000	0.00	0.00	1	0	-1
0011	3T	7_11	153	6	0	600	0	-600	0.00	0.00	1	0	-1
0011	3T	7_11	154	8	0	800	0	-800	0.00	0.00	1	0	-1
0011	3T	7_11	156	6	0	600	0	-600	0.00	0.00	1	0	-1
0011	3T	7_11	162	3	0	300	0	-300	0.00	0.00	0	0	0
0011	3T	7_11	163	4	0	400	0	-400	0.00	0.00	0	0	0
0011	3T	7_11	164	3	0	300	0	-300	0.00	0.00	0	0	0
0011	3T	7_11	165	3	0	300	0	-300	0.00	0.00	0	0	0
0011	3T	7_11	213	4	0	400	0	-400	0.00	0.00	0	0	0
0011	3T	7_11	214	7	0	700	0	-700	0.00	0.00	1	0	-1
0011	3T	7_11	215	2	0	200	0	-200	0.00	0.00	0	0	0
0011	3T	7_11	216	2	0	200	0	-200	0.00	0.00	0	0	0
0011	3T	7_11	234	2	0	200	0	-200	0.00	0.00	0	0	0
0011	3T	7_11	235	2	0	200	0	-200	0.00	0.00	0	0	0
0011	3T	7_11	236	1	0	100	0	-100	0.00	0.00	0	0	0
0011	3T	7_11	241	3	0	300	0	-300	0.00	0.00	0	0	0
0011	3T	7_11	246	1	0	100	0	-100	0.00	0.00	0	0	0
0011	3T	7_11	251	1	0	100	0	-100	0.00	0.00	0	0	0
0011	3T	7_11	263	1	0	100	0	-100	0.00	0.00	0	0	0
0011	3T	7_11	265	1	0	100	0	-100	0.00	0.00	0	0	0
0011	3T	7_12	123	133	15	13300	12610	-690	0.11	0.95	23	22	-1
0011	3T	7_12	124	132	15	13200	11740	-1460	0.11	0.89	23	20	-3
0011	3T	7_12	125	82	5	8200	9910	1710	0.06	1.21	14	17	3
0011	3T	7_12	126	70	1	7000	820	-6180	0.01	0.12	12	1	-11
0011	3T	7_12	132	59	2	5900	4210	-1690	0.03	0.71	10	7	-3
0011	3T	7_12	134	66	5	6600	8820	2220	0.08	1.34	11	15	4
0011	3T	7_12	135	37	2	3700	3900	200	0.05	1.05	6	6	0
0011	3T	7_12	136	38	0	3800	0	-3800	0.00	0.00	6	0	-6
0011	3T	7_12	142	47	3	4700	4040	-660	0.06	0.86	8	7	-1
0011	3T	7_12	143	39	3	3900	6360	2460	0.08	1.63	6	11	5
0011	3T	7_12	145	40	1	4000	2040	-1960	0.03	0.51	7	3	-4
0011	3T	7_12	146	24	3	2400	7890	5490	0.13	3.29	4	13	9
0011	3T	7_12	152	6	0	600	0	-600	0.00	0.00	1	0	-1
0011	3T	7_12	153	13	0	1300	0	-1300	0.00	0.00	2	0	-2
0011	3T	7_12	154	17	0	1700	0	-1700	0.00	0.00	3	0	-3
0011	3T	7_12	156	7	0	700	0	-700	0.00	0.00	1	0	-1
0011	3T	7_12	162	3	0	300	0	-300	0.00	0.00	0	0	0
0011	3T	7_12	163	3	0	300	0	-300	0.00	0.00	0	0	0
0011	3T	7_12	164	3	0	300	0	-300	0.00	0.00	0	0	0
0011	3T	7_12	165	2	0	200	0	-200	0.00	0.00	0	0	0
0011	3T	7_12	213	3	0	300	0	-300	0.00	0.00	0	0	0
0011	3T	7_12	214	6	0	600	0	-600	0.00	0.00	1	0	-1
0011	3T	7_12	215	1	0	100	0	-100	0.00	0.00	0	0	0
0011	3T	7_12	216	4	0	400	0	-400	0.00	0.00	0	0	0
0011	3T	7_12	231	1	0	100	0	-100	0.00	0.00	0	0	0
0011	3T	7_12	234	2	0	200	0	-200	0.00	0.00	0	0	0
0011	3T	7_12	235	1	0	100	0	-100	0.00	0.00	0	0	0
0011	3T	7_12	236	1	0	100	0	-100	0.00	0.00	0	0	0
0011	3T	7_12	243	2	0	200	0	-200	0.00	0.00	0	0	0
0011	3T	7_12	253	1	0	100	0	-100	0.00	0.00	0	0	0
0011	3T	7_12	254	1	0	100	0	-100	0.00	0.00	0	0	0
0011	3T	7_12	256	1	0	100	0	-100	0.00	0.00	0	0	0
0011	3T	7_2	123	94	6	9400	5950	-3450	0.06	0.63	16	10	-6
0011	3T	7_2	124	65	3	6500	2770	-3730	0.05	0.43	11	4	-7
0011	3T	7_2	125	48	1	4800	1740	-3060	0.02	0.36	8	3	-5
0011	3T	7_2	126	25	2	2500	2630	130	0.08	1.05	4	4	0
0011	3T	7_2	132	61	2	6100	1370	-4730	0.03	0.22	10	2	-8
0011	3T	7_2	134	54	5	5400	10330	4930	0.09	1.91	9	18	9
0011	3T	7_2	135	39	1	3900	5100	1200	0.03	1.31	6	9	3
0011	3T	7_2	136	27	1	2700	21020	18320	0.04	7.79	4	37	33
0011	3T	7_2	142	39	1	3900	1290	-2610	0.03	0.33	6	2	-4
0011	3T	7_2	143	34	0	3400	0	-3400	0.00	0.00	6	0	-6
0011	3T	7_2	145	18	3	1800	4910	3110	0.17	2.73	3	8	5
0011	3T	7_2	146	16	1	1600	3850	2250	0.06	2.41	2	6	4
0011	3T	7_2	152	10	0	1000	0	-1000	0.00	0.00	1	0	-1
0011	3T	7_2	153	10	0	1000	0	-1000	0.00	0.00	1	0	-1
0011	3T	7_2	154	9	0	900	0	-900	0.00	0.00	1	0	-1
0011	3T	7_2	156	4	0	400	0	-400	0.00	0.00	0	0	0
0011	3T	7_2	162	4	0	400	0	-400	0.00	0.00	0	0	0
0011	3T	7_2	163	8	0	800	0	-800	0.00	0.00	1	0	-1
0011	3T	7_2	164	2	0	200	0	-200	0.00	0.00	0	0	0
0011	3T	7_2	165	3	0	300	0	-300	0.00	0.00	0	0	0
0011	3T	7_2	213	11	0	1100	0	-1100	0.00	0.00	1	0	-1
0011	3T	7_2	214	15	0	1500	0	-1500	0.00	0.00	2	0	-2
0011	3T	7_2	215	5	0	500	0	-500	0.00	0.00	0	0	0
0011	3T	7_2	216	4	1	400	6850	6450	0.25	17.13	0	12	12
0011	3T	7_2	231	5	0	500	0	-500	0.00	0.00	0	0	0
0011	3T	7_2	234	8	0	800	0	-800	0.00	0.00	1	0	-1
0011	3T	7_2	235	8	0	800	0	-800	0.00	0.00	1	0	-1
0011	3T	7_2	236	1	0	100	0	-100	0.00	0.00	0	0	0
0011	3T	7_2	241	5	0	500	0	-500	0.00	0.00	0	0	0
0011	3T	7_2	243	3	0	300	0	-300	0.00	0.00	0	0	0
0011	3T	7_2	245	3	0	300	0	-300	0.00	0.00	0	0	0
0011	3T	7_2	246	3	0	300	0	-300	0.00	0.00	0	0	0
0011	3T	7_2	253	3	0	300	0	-300	0.00	0.00	0	0	0
0011	3T	7_2	254	3	0	300	0	-300	0.00	0.00	0	0	0
0011	3T	7_2	256	1	0	100	0	-100	0.00	0.00	0	0	0
0011	3T	7_2	261	1	0	100	0	-100	0.00	0.00	0	0	0
0011	3T	7_2	263	1	0	100	0	-100	0.00	0.00	0	0	0
0011	3T	7_2	264	2	0	200	0	-200	0.00	0.00	0	0	0
0011	3T	7_2	265	1	0	100	0	-100	0.00	0.00	0	0	0
0011	3T	7_3	123	111	6	11100	6080	-5020	0.05	0.55	19	10	-9
0011	3T	7_3	124	58	5	5800	10850	5050	0.09	1.87	10	19	9
0011	3T	7_3	125	55	4	5500	4860	-640	0.07	0.88	9	8	-1
0011	3T	7_3	126	35	1	3500	860	-2640	0.03	0.25	6	1	-5
0011	3T	7_3	132	58	4	5800	2840	-2960	0.07	0.49	10	5	-5
0011	3T	7_3	134	43	5	4300	4050	-250	0.12	0.94	7	7	0
0011	3T	7_3	135	50	4	5000	3530	-1470	0.08	0.71	8	6	-2
0011	3T	7_3	136	32	1	3200	1270	-1930	0.03	0.40	5	2	-3
0011	3T	7_3	142	32	1	3200	1470	-1730	0.03	0.46	5	2	-3
0011	3T	7_3	143	34	2	3400	2190	-1210	0.06	0.64	6	3	-3
0011	3T	7_3	145	20	0	2000	0	-2000	0.00	0.00	3	0	-3
0011	3T	7_3	146	16	0	1600	0	-1600	0.00	0.00	2	0	-2
0011	3T	7_3	152	17	0	1700	0	-1700	0.00	0.00	3	0	-3
0011	3T	7_3	153	21	0	2100	0	-2100	0.00	0.00	3	0	-3
0011	3T	7_3	154	18	0	1800	0	-1800	0.00	0.00	3	0	-3
0011	3T	7_3	156	4	0	400	0	-400	0.00	0.00	0	0	0
0011	3T	7_3	162	5	0	500	0	-500	0.00	0.00	0	0	0
0011	3T	7_3	163	7	0	700	0	-700	0.00	0.00	1	0	-1
0011	3T	7_3	164	3	0	300	0	-300	0.00	0.00	0	0	0
0011	3T	7_3	165	5	0	500	0	-500	0.00	0.00	0	0	0
0011	3T	7_3	213	12	0	1200	0	-1200	0.00	0.00	2	0	-2
0011	3T	7_3	214	13	0	1300	0	-1300	0.00	0.00	2	0	-2
0011	3T	7_3	215	7	0	700	0	-700	0.00	0.00	1	0	-1
0011	3T	7_3	216	4	1	400	2850	2450	0.25	7.13	0	5	5
0011	3T	7_3	231	2	0	200	0	-200	0.00	0.00	0	0	0
0011	3T	7_3	234	9	0	900	0	-900	0.00	0.00	1	0	-1
0011	3T	7_3	235	4	0	400	0	-400	0.00	0.00	0	0	0
0011	3T	7_3	236	4	0	400	0	-400	0.00	0.00	0	0	0
0011	3T	7_3	243	8	0	800	0	-800	0.00	0.00	1	0	-1
0011	3T	7_3	245	2	0	200	0	-200	0.00	0.00	0	0	0
0011	3T	7_3	246	2	0	200	0	-200	0.00	0.00	0	0	0
0011	3T	7_3	251	1	0	100	0	-100	0.00	0.00	0	0	0
0011	3T	7_3	253	1	0	100	0	-100	0.00	0.00	0	0	0
0011	3T	7_3	254	3	0	300	0	-300	0.00	0.00	0	0	0
0011	3T	7_3	256	6	0	600	0	-600	0.00	0.00	1	0	-1
0011	3T	7_3	263	2	0	200	0	-200	0.00	0.00	0	0	0
0011	3T	7_3	265	2	0	200	0	-200	0.00	0.00	0	0	0
0011	3T	7_4	123	103	14	10300	10650	350	0.14	1.03	18	18	0
0011	3T	7_4	124	85	7	8500	4850	-3650	0.08	0.57	15	8	-7
0011	3T	7_4	125	54	4	5400	4190	-1210	0.07	0.78	9	7	-2
0011	3T	7_4	126	44	2	4400	3310	-1090	0.05	0.75	7	5	-2
0011	3T	7_4	132	53	4	5300	3060	-2240	0.08	0.58	9	5	-4
0011	3T	7_4	134	70	5	7000	4570	-2430	0.07	0.65	12	8	-4
0011	3T	7_4	135	37	2	3700	8550	4850	0.05	2.31	6	15	9
0011	3T	7_4	136	31	1	3100	1530	-1570	0.03	0.49	5	2	-3
0011	3T	7_4	142	36	1	3600	4240	640	0.03	1.18	6	7	1
0011	3T	7_4	143	29	2	2900	4080	1180	0.07	1.41	5	7	2
0011	3T	7_4	145	20	1	2000	790	-1210	0.05	0.40	3	1	-2
0011	3T	7_4	146	22	0	2200	0	-2200	0.00	0.00	3	0	-3
0011	3T	7_4	152	13	0	1300	0	-1300	0.00	0.00	2	0	-2
0011	3T	7_4	153	9	0	900	0	-900	0.00	0.00	1	0	-1
0011	3T	7_4	154	15	0	1500	0	-1500	0.00	0.00	2	0	-2
0011	3T	7_4	156	11	0	1100	0	-1100	0.00	0.00	1	0	-1
0011	3T	7_4	162	6	0	600	0	-600	0.00	0.00	1	0	-1
0011	3T	7_4	163	8	0	800	0	-800	0.00	0.00	1	0	-1
0011	3T	7_4	164	4	2	400	13570	13170	0.50	33.93	0	24	24
0011	3T	7_4	165	7	1	700	3440	2740	0.14	4.91	1	6	5
0011	3T	7_4	213	6	0	600	0	-600	0.00	0.00	1	0	-1
0011	3T	7_4	214	9	0	900	0	-900	0.00	0.00	1	0	-1
0011	3T	7_4	215	9	1	900	3520	2620	0.11	3.91	1	6	5
0011	3T	7_4	216	5	0	500	0	-500	0.00	0.00	0	0	0
0011	3T	7_4	231	4	0	400	0	-400	0.00	0.00	0	0	0
0011	3T	7_4	234	7	0	700	0	-700	0.00	0.00	1	0	-1
0011	3T	7_4	235	4	0	400	0	-400	0.00	0.00	0	0	0
0011	3T	7_4	236	4	0	400	0	-400	0.00	0.00	0	0	0
0011	3T	7_4	241	2	0	200	0	-200	0.00	0.00	0	0	0
0011	3T	7_4	243	4	0	400	0	-400	0.00	0.00	0	0	0
0011	3T	7_4	246	4	0	400	0	-400	0.00	0.00	0	0	0
0011	3T	7_4	251	1	0	100	0	-100	0.00	0.00	0	0	0
0011	3T	7_4	253	3	0	300	0	-300	0.00	0.00	0	0	0
0011	3T	7_4	254	3	0	300	0	-300	0.00	0.00	0	0	0
0011	3T	7_4	263	2	0	200	0	-200	0.00	0.00	0	0	0
0011	3T	7_4	264	1	0	100	0	-100	0.00	0.00	0	0	0
0011	3T	7_5	123	98	7	9800	5270	-4530	0.07	0.54	17	9	-8
0011	3T	7_5	124	94	7	9400	4840	-4560	0.07	0.51	16	8	-8
0011	3T	7_5	125	56	6	5600	7630	2030	0.11	1.36	9	13	4
0011	3T	7_5	126	40	5	4000	9340	5340	0.13	2.34	7	16	9
0011	3T	7_5	132	74	5	7400	6400	-1000	0.07	0.86	13	11	-2
0011	3T	7_5	134	49	3	4900	3060	-1840	0.06	0.62	8	5	-3
0011	3T	7_5	135	36	3	3600	2130	-1470	0.08	0.59	6	3	-3
0011	3T	7_5	136	37	4	3700	3650	-50	0.11	0.99	6	6	0
0011	3T	7_5	142	27	2	2700	7340	4640	0.07	2.72	4	12	8
0011	3T	7_5	143	39	2	3900	4020	120	0.05	1.03	6	7	1
0011	3T	7_5	145	18	0	1800	0	-1800	0.00	0.00	3	0	-3
0011	3T	7_5	146	16	0	1600	0	-1600	0.00	0.00	2	0	-2
0011	3T	7_5	152	8	1	800	680	-120	0.13	0.85	1	1	0
0011	3T	7_5	153	13	0	1300	0	-1300	0.00	0.00	2	0	-2
0011	3T	7_5	154	9	1	900	2760	1860	0.11	3.07	1	4	3
0011	3T	7_5	156	7	0	700	0	-700	0.00	0.00	1	0	-1
0011	3T	7_5	162	9	0	900	0	-900	0.00	0.00	1	0	-1
0011	3T	7_5	163	6	0	600	0	-600	0.00	0.00	1	0	-1
0011	3T	7_5	164	9	0	900	0	-900	0.00	0.00	1	0	-1
0011	3T	7_5	165	3	0	300	0	-300	0.00	0.00	0	0	0
0011	3T	7_5	213	10	1	1000	1040	40	0.10	1.04	1	1	0
0011	3T	7_5	214	8	1	800	6930	6130	0.13	8.66	1	12	11
0011	3T	7_5	215	2	0	200	0	-200	0.00	0.00	0	0	0
0011	3T	7_5	216	7	1	700	950	250	0.14	1.36	1	1	0
0011	3T	7_5	231	2	0	200	0	-200	0.00	0.00	0	0	0
0011	3T	7_5	234	5	0	500	0	-500	0.00	0.00	0	0	0
0011	3T	7_5	235	2	0	200	0	-200	0.00	0.00	0	0	0
0011	3T	7_5	241	1	0	100	0	-100	0.00	0.00	0	0	0
0011	3T	7_5	243	3	0	300	0	-300	0.00	0.00	0	0	0
0011	3T	7_5	245	4	0	400	0	-400	0.00	0.00	0	0	0
0011	3T	7_5	246	4	0	400	0	-400	0.00	0.00	0	0	0
0011	3T	7_5	253	4	0	400	0	-400	0.00	0.00	0	0	0
0011	3T	7_5	256	2	0	200	0	-200	0.00	0.00	0	0	0
0011	3T	7_5	261	1	0	100	0	-100	0.00	0.00	0	0	0
0011	3T	7_5	265	1	0	100	0	-100	0.00	0.00	0	0	0
0011	3T	7_6	123	103	8	10300	7810	-2490	0.08	0.76	18	13	-5
0011	3T	7_6	124	80	8	8000	7090	-910	0.10	0.89	14	12	-2
0011	3T	7_6	125	63	5	6300	3800	-2500	0.08	0.60	11	6	-5
0011	3T	7_6	126	41	3	4100	5170	1070	0.07	1.26	7	9	2
0011	3T	7_6	132	64	5	6400	7360	960	0.08	1.15	11	13	2
0011	3T	7_6	134	54	3	5400	2630	-2770	0.06	0.49	9	4	-5
0011	3T	7_6	135	36	2	3600	2860	-740	0.06	0.79	6	5	-1
0011	3T	7_6	136	41	2	4100	1960	-2140	0.05	0.48	7	3	-4
0011	3T	7_6	142	38	3	3800	2370	-1430	0.08	0.62	6	4	-2
0011	3T	7_6	143	18	1	1800	1370	-430	0.06	0.76	3	2	-1
0011	3T	7_6	145	28	0	2800	0	-2800	0.00	0.00	4	0	-4
0011	3T	7_6	146	10	2	1000	5560	4560	0.20	5.56	1	9	8
0011	3T	7_6	152	12	0	1200	0	-1200	0.00	0.00	2	0	-2
0011	3T	7_6	153	10	0	1000	0	-1000	0.00	0.00	1	0	-1
0011	3T	7_6	154	13	2	1300	18140	16840	0.15	13.95	2	32	30
0011	3T	7_6	156	9	1	900	1200	300	0.11	1.33	1	2	1
0011	3T	7_6	162	7	0	700	0	-700	0.00	0.00	1	0	-1
0011	3T	7_6	163	3	0	300	0	-300	0.00	0.00	0	0	0
0011	3T	7_6	164	3	0	300	0	-300	0.00	0.00	0	0	0
0011	3T	7_6	165	2	0	200	0	-200	0.00	0.00	0	0	0
0011	3T	7_6	213	11	4	1100	5310	4210	0.36	4.83	1	9	8
0011	3T	7_6	214	2	0	200	0	-200	0.00	0.00	0	0	0
0011	3T	7_6	215	5	0	500	0	-500	0.00	0.00	0	0	0
0011	3T	7_6	216	6	1	600	790	190	0.17	1.32	1	1	0
0011	3T	7_6	231	3	0	300	0	-300	0.00	0.00	0	0	0
0011	3T	7_6	234	4	0	400	0	-400	0.00	0.00	0	0	0
0011	3T	7_6	235	4	0	400	0	-400	0.00	0.00	0	0	0
0011	3T	7_6	236	5	1	500	12340	11840	0.20	24.68	0	21	21
0011	3T	7_6	241	2	0	200	0	-200	0.00	0.00	0	0	0
0011	3T	7_6	243	2	0	200	0	-200	0.00	0.00	0	0	0
0011	3T	7_6	245	4	0	400	0	-400	0.00	0.00	0	0	0
0011	3T	7_6	246	1	0	100	0	-100	0.00	0.00	0	0	0
0011	3T	7_6	253	4	0	400	0	-400	0.00	0.00	0	0	0
0011	3T	7_6	254	2	0	200	0	-200	0.00	0.00	0	0	0
0011	3T	7_6	263	1	0	100	0	-100	0.00	0.00	0	0	0
0011	3T	7_6	264	4	0	400	0	-400	0.00	0.00	0	0	0
0011	3T	7_7	123	122	17	12200	14500	2300	0.14	1.19	21	25	4
0011	3T	7_7	124	72	7	7200	4670	-2530	0.10	0.65	12	8	-4
0011	3T	7_7	125	58	9	5800	13860	8060	0.16	2.39	10	24	14
0011	3T	7_7	126	41	5	4100	8170	4070	0.12	1.99	7	14	7
0011	3T	7_7	132	64	3	6400	4230	-2170	0.05	0.66	11	7	-4
0011	3T	7_7	134	57	5	5700	4340	-1360	0.09	0.76	10	7	-3
0011	3T	7_7	135	42	0	4200	0	-4200	0.00	0.00	7	0	-7
0011	3T	7_7	136	23	1	2300	1180	-1120	0.04	0.51	4	2	-2
0011	3T	7_7	142	35	3	3500	5820	2320	0.09	1.66	6	10	4
0011	3T	7_7	143	38	1	3800	800	-3000	0.03	0.21	6	1	-5
0011	3T	7_7	145	37	2	3700	1160	-2540	0.05	0.31	6	2	-4
0011	3T	7_7	146	19	0	1900	0	-1900	0.00	0.00	3	0	-3
0011	3T	7_7	152	17	0	1700	0	-1700	0.00	0.00	3	0	-3
0011	3T	7_7	153	7	0	700	0	-700	0.00	0.00	1	0	-1
0011	3T	7_7	154	6	1	600	1000	400	0.17	1.67	1	1	0
0011	3T	7_7	156	13	0	1300	0	-1300	0.00	0.00	2	0	-2
0011	3T	7_7	162	8	1	800	3130	2330	0.13	3.91	1	5	4
0011	3T	7_7	163	14	1	1400	1020	-380	0.07	0.73	2	1	-1
0011	3T	7_7	164	10	1	1000	4760	3760	0.10	4.76	1	8	7
0011	3T	7_7	165	3	0	300	0	-300	0.00	0.00	0	0	0
0011	3T	7_7	213	3	0	300	0	-300	0.00	0.00	0	0	0
0011	3T	7_7	214	3	0	300	0	-300	0.00	0.00	0	0	0
0011	3T	7_7	215	3	0	300	0	-300	0.00	0.00	0	0	0
0011	3T	7_7	216	7	1	700	1700	1000	0.14	2.43	1	3	2
0011	3T	7_7	231	3	0	300	0	-300	0.00	0.00	0	0	0
0011	3T	7_7	235	2	0	200	0	-200	0.00	0.00	0	0	0
0011	3T	7_7	236	5	1	500	1370	870	0.20	2.74	0	2	2
0011	3T	7_7	241	1	0	100	0	-100	0.00	0.00	0	0	0
0011	3T	7_7	245	2	0	200	0	-200	0.00	0.00	0	0	0
0011	3T	7_7	246	1	0	100	0	-100	0.00	0.00	0	0	0
0011	3T	7_7	254	1	0	100	0	-100	0.00	0.00	0	0	0
0011	3T	7_7	256	1	0	100	0	-100	0.00	0.00	0	0	0
0011	3T	7_7	263	1	0	100	0	-100	0.00	0.00	0	0	0
0011	3T	7_7	264	1	0	100	0	-100	0.00	0.00	0	0	0
0011	3T	7_8	123	104	8	10400	4830	-5570	0.08	0.46	18	8	-10
0011	3T	7_8	124	87	8	8700	11180	2480	0.09	1.29	15	19	4
0011	3T	7_8	125	55	0	5500	0	-5500	0.00	0.00	9	0	-9
0011	3T	7_8	126	39	5	3900	10870	6970	0.13	2.79	6	19	13
0011	3T	7_8	132	62	4	6200	2910	-3290	0.06	0.47	10	5	-5
0011	3T	7_8	134	58	5	5800	3700	-2100	0.09	0.64	10	6	-4
0011	3T	7_8	135	40	3	4000	2660	-1340	0.08	0.67	7	4	-3
0011	3T	7_8	136	27	2	2700	1580	-1120	0.07	0.59	4	2	-2
0011	3T	7_8	142	45	3	4500	1450	-3050	0.07	0.32	7	2	-5
0011	3T	7_8	143	46	3	4600	7560	2960	0.07	1.64	8	13	5
0011	3T	7_8	145	17	2	1700	3280	1580	0.12	1.93	3	5	2
0011	3T	7_8	146	14	1	1400	2240	840	0.07	1.60	2	3	1
0011	3T	7_8	152	12	0	1200	0	-1200	0.00	0.00	2	0	-2
0011	3T	7_8	153	17	0	1700	0	-1700	0.00	0.00	3	0	-3
0011	3T	7_8	154	9	1	900	1180	280	0.11	1.31	1	2	1
0011	3T	7_8	156	8	0	800	0	-800	0.00	0.00	1	0	-1
0011	3T	7_8	162	15	0	1500	0	-1500	0.00	0.00	2	0	-2
0011	3T	7_8	163	9	1	900	1330	430	0.11	1.48	1	2	1
0011	3T	7_8	164	4	0	400	0	-400	0.00	0.00	0	0	0
0011	3T	7_8	165	4	0	400	0	-400	0.00	0.00	0	0	0
0011	3T	7_8	213	2	0	200	0	-200	0.00	0.00	0	0	0
0011	3T	7_8	214	7	0	700	0	-700	0.00	0.00	1	0	-1
0011	3T	7_8	215	1	0	100	0	-100	0.00	0.00	0	0	0
0011	3T	7_8	216	3	0	300	0	-300	0.00	0.00	0	0	0
0011	3T	7_8	231	1	0	100	0	-100	0.00	0.00	0	0	0
0011	3T	7_8	234	4	0	400	0	-400	0.00	0.00	0	0	0
0011	3T	7_8	235	5	0	500	0	-500	0.00	0.00	0	0	0
0011	3T	7_8	236	1	0	100	0	-100	0.00	0.00	0	0	0
0011	3T	7_8	241	1	0	100	0	-100	0.00	0.00	0	0	0
0011	3T	7_8	243	2	0	200	0	-200	0.00	0.00	0	0	0
0011	3T	7_8	245	2	0	200	0	-200	0.00	0.00	0	0	0
0011	3T	7_8	246	1	0	100	0	-100	0.00	0.00	0	0	0
0011	3T	7_8	251	1	0	100	0	-100	0.00	0.00	0	0	0
0011	3T	7_8	253	1	0	100	0	-100	0.00	0.00	0	0	0
0011	3T	7_8	254	1	0	100	0	-100	0.00	0.00	0	0	0
0011	3T	7_8	256	3	0	300	0	-300	0.00	0.00	0	0	0
0011	3T	7_8	261	2	0	200	0	-200	0.00	0.00	0	0	0
0011	3T	7_8	265	3	0	300	0	-300	0.00	0.00	0	0	0
0011	3T	7_9	123	104	19	10400	19890	9490	0.18	1.91	18	35	17
0011	3T	7_9	124	133	10	13300	8520	-4780	0.08	0.64	23	15	-8
0011	3T	7_9	125	67	4	6700	5370	-1330	0.06	0.80	11	9	-2
0011	3T	7_9	126	44	1	4400	2350	-2050	0.02	0.53	7	4	-3
0011	3T	7_9	132	78	2	7800	4670	-3130	0.03	0.60	13	8	-5
0011	3T	7_9	134	64	4	6400	5120	-1280	0.06	0.80	11	9	-2
0011	3T	7_9	135	39	3	3900	4250	350	0.08	1.09	6	7	1
0011	3T	7_9	136	21	1	2100	1040	-1060	0.05	0.50	3	1	-2
0011	3T	7_9	142	43	3	4300	4770	470	0.07	1.11	7	8	1
0011	3T	7_9	143	36	2	3600	2290	-1310	0.06	0.64	6	4	-2
0011	3T	7_9	145	34	2	3400	1850	-1550	0.06	0.54	6	3	-3
0011	3T	7_9	146	18	0	1800	0	-1800	0.00	0.00	3	0	-3
0011	3T	7_9	152	16	3	1600	4180	2580	0.19	2.61	2	7	5
0011	3T	7_9	153	12	0	1200	0	-1200	0.00	0.00	2	0	-2
0011	3T	7_9	154	10	0	1000	0	-1000	0.00	0.00	1	0	-1
0011	3T	7_9	156	13	0	1300	0	-1300	0.00	0.00	2	0	-2
0011	3T	7_9	162	5	1	500	2340	1840	0.20	4.68	0	4	4
0011	3T	7_9	163	13	1	1300	2230	930	0.08	1.72	2	3	1
0011	3T	7_9	164	5	0	500	0	-500	0.00	0.00	0	0	0
0011	3T	7_9	213	6	0	600	0	-600	0.00	0.00	1	0	-1
0011	3T	7_9	214	2	0	200	0	-200	0.00	0.00	0	0	0
0011	3T	7_9	215	4	0	400	0	-400	0.00	0.00	0	0	0
0011	3T	7_9	216	1	0	100	0	-100	0.00	0.00	0	0	0
0011	3T	7_9	234	3	0	300	0	-300	0.00	0.00	0	0	0
0011	3T	7_9	241	3	0	300	0	-300	0.00	0.00	0	0	0
0011	3T	7_9	243	2	0	200	0	-200	0.00	0.00	0	0	0
0011	3T	7_9	246	1	0	100	0	-100	0.00	0.00	0	0	0
0011	3T	7_9	253	2	0	200	0	-200	0.00	0.00	0	0	0
0011	3T	7_9	254	1	0	100	0	-100	0.00	0.00	0	0	0
0011	3T	7_9	264	1	0	100	0	-100	0.00	0.00	0	0	0
0011	3T	7_9	265	1	0	100	0	-100	0.00	0.00	0	0	0
0023	3T	03_6	234	2	0	200	0	-200	0.00	0.00	0	0	0
0023	3T	03_6	235	1	0	100	0	-100	0.00	0.00	0	0	0
0023	3T	03_6	236	1	0	100	0	-100	0.00	0.00	0	0	0
0023	3T	03_7	123	17	1	1700	770	-930	0.06	0.45	3	1	-2
0023	3T	03_7	124	17	1	1700	1210	-490	0.06	0.71	3	2	-1
0023	3T	03_7	125	14	2	1400	1180	-220	0.14	0.84	2	2	0
0023	3T	03_7	126	17	0	1700	0	-1700	0.00	0.00	3	0	-3
0023	3T	03_7	134	5	1	500	870	370	0.20	1.74	0	1	1
0023	3T	03_7	135	8	2	800	1940	1140	0.25	2.43	1	3	2
0023	3T	03_7	136	10	0	1000	0	-1000	0.00	0.00	1	0	-1
0023	3T	03_7	145	7	0	700	0	-700	0.00	0.00	1	0	-1
0023	3T	03_7	146	6	0	600	0	-600	0.00	0.00	1	0	-1
0023	3T	03_7	154	1	0	100	0	-100	0.00	0.00	0	0	0
0023	3T	03_7	156	3	0	300	0	-300	0.00	0.00	0	0	0
0023	3T	03_7	236	1	0	100	0	-100	0.00	0.00	0	0	0
0023	3T	03_7	256	1	0	100	0	-100	0.00	0.00	0	0	0
0023	3T	03_8	123	17	5	1700	3630	1930	0.29	2.14	3	6	3
0023	3T	03_8	124	20	0	2000	0	-2000	0.00	0.00	3	0	-3
0023	3T	03_8	125	9	1	900	770	-130	0.11	0.86	1	1	0
0023	3T	03_8	126	14	1	1400	630	-770	0.07	0.45	2	1	-1
0023	3T	03_8	134	7	0	700	0	-700	0.00	0.00	1	0	-1
0023	3T	03_8	135	7	0	700	0	-700	0.00	0.00	1	0	-1
0023	3T	03_8	136	17	0	1700	0	-1700	0.00	0.00	3	0	-3
0023	3T	03_8	145	4	0	400	0	-400	0.00	0.00	0	0	0
0023	3T	03_8	146	6	0	600	0	-600	0.00	0.00	1	0	-1
0023	3T	03_8	152	1	0	100	0	-100	0.00	0.00	0	0	0
0023	3T	03_8	153	1	0	100	0	-100	0.00	0.00	0	0	0
0023	3T	03_8	154	1	1	100	1200	1100	1.00	12.00	0	2	2
0023	3T	03_8	156	3	0	300	0	-300	0.00	0.00	0	0	0
0023	3T	03_8	163	1	0	100	0	-100	0.00	0.00	0	0	0
0023	3T	03_9	123	26	4	2600	3170	570	0.15	1.22	4	5	1
0023	3T	03_9	124	19	1	1900	3310	1410	0.05	1.74	3	5	2
0023	3T	03_9	125	16	0	1600	0	-1600	0.00	0.00	2	0	-2
0023	3T	03_9	126	16	2	1600	1960	360	0.13	1.23	2	3	1
0023	3T	03_9	134	12	2	1200	2190	990	0.17	1.83	2	3	1
0023	3T	03_9	135	16	1	1600	560	-1040	0.06	0.35	2	0	-2
0023	3T	03_9	136	11	1	1100	750	-350	0.09	0.68	1	1	0
0023	3T	03_9	143	1	1	100	1100	1000	1.00	11.00	0	1	1
0023	3T	03_9	145	4	0	400	0	-400	0.00	0.00	0	0	0
0023	3T	03_9	146	1	0	100	0	-100	0.00	0.00	0	0	0
0023	3T	03_9	156	1	0	100	0	-100	0.00	0.00	0	0	0
0006	1T	1	1	11225	6145	1122500	1033440	-89060	0.55	0.92	1986	1829	-157
0006	1T	1	2	1321	404	132100	123360	-8740	0.31	0.93	233	218	-15
0006	1T	2	1	10593	5715	1059300	966830	-92470	0.54	0.91	1874	1711	-163
0006	1T	2	2	1592	542	159200	146650	-12550	0.34	0.92	281	259	-22
0006	1T	3	1	10664	6067	1066400	1013610	-52790	0.57	0.95	1887	1794	-93
0006	1T	3	2	1575	505	157500	139560	-17940	0.32	0.89	278	247	-31
0006	1T	4	1	8671	5238	867100	811670	-55430	0.60	0.94	1534	1436	-98
0006	1T	4	2	1288	455	128800	121050	-7750	0.35	0.94	227	214	-13
0006	1T	5	1	7336	4710	733600	689000	-44600	0.64	0.94	1298	1219	-79
0006	1T	5	2	578	158	57800	53150	-4650	0.27	0.92	102	94	-8
0006	1T	6	1	600	366	60000	53640	-6360	0.61	0.89	106	94	-12
0006	1T	6	2	35	11	3500	4470	970	0.31	1.28	6	7	1
0006	1T	7	1	11864	7497	1186400	1097730	-88670	0.63	0.93	2099	1942	-157
0006	1T	7	2	1008	282	100800	99000	-1800	0.28	0.98	178	175	-3
0006	2F	1	12	4192	1139	419200	362880	-56320	0.27	0.87	741	642	-99
0006	2F	1	13	2873	684	287300	233710	-53590	0.24	0.81	508	413	-95
0006	2F	1	14	1827	330	182700	158750	-23950	0.18	0.87	323	280	-43
0006	2F	1	15	650	68	65000	57750	-7250	0.10	0.89	115	102	-13
0006	2F	1	16	277	22	27700	19350	-8350	0.08	0.70	49	34	-15
0006	2F	1	23	270	39	27000	23350	-3650	0.14	0.86	47	41	-6
0006	2F	1	24	184	23	18400	15290	-3110	0.13	0.83	32	27	-5
0006	2F	1	25	95	7	9500	8570	-930	0.07	0.90	16	15	-1
0006	2F	1	26	59	8	5900	6650	750	0.14	1.13	10	11	1
0006	2F	2	12	3998	1166	399800	350190	-49610	0.29	0.88	707	619	-88
0006	2F	2	13	2531	616	253100	210510	-42590	0.24	0.83	447	372	-75
0006	2F	2	14	1738	357	173800	144180	-29620	0.21	0.83	307	255	-52
0006	2F	2	15	677	84	67700	43320	-24380	0.12	0.64	119	76	-43
0006	2F	2	16	473	62	47300	35200	-12100	0.13	0.74	83	62	-21
0006	2F	2	23	281	45	28100	34930	6830	0.16	1.24	49	61	12
0006	2F	2	24	180	27	18000	14900	-3100	0.15	0.83	31	26	-5
0006	2F	2	25	127	9	12700	5790	-6910	0.07	0.46	22	10	-12
0006	2F	2	26	115	7	11500	3700	-7800	0.06	0.32	20	6	-14
0006	2F	3	12	4191	1266	419100	365260	-53840	0.30	0.87	741	646	-95
0006	2F	3	13	2588	695	258800	229510	-29290	0.27	0.89	458	406	-52
0006	2F	3	14	1640	327	164000	129600	-34400	0.20	0.79	290	229	-61
0006	2F	3	15	781	129	78100	69940	-8160	0.17	0.90	138	123	-15
0006	2F	3	16	424	52	42400	33160	-9240	0.12	0.78	75	58	-17
0006	2F	3	23	286	35	28600	23820	-4780	0.12	0.83	50	42	-8
0006	2F	3	24	147	20	14700	12530	-2170	0.14	0.85	26	22	-4
0006	2F	3	25	130	17	13000	9200	-3800	0.13	0.71	23	16	-7
0006	2F	3	26	104	10	10400	9460	-940	0.10	0.91	18	16	-2
0006	2F	4	12	3546	1102	354600	302360	-52240	0.31	0.85	627	535	-92
0006	2F	4	13	2221	615	222100	205740	-16360	0.28	0.93	393	364	-29
0006	2F	4	14	1335	307	133500	111040	-22460	0.23	0.83	236	196	-40
0006	2F	4	15	527	78	52700	37740	-14960	0.15	0.72	93	66	-27
0006	2F	4	16	276	37	27600	26420	-1180	0.13	0.96	48	46	-2
0006	2F	4	23	266	52	26600	27450	850	0.20	1.03	47	48	1
0006	2F	4	24	141	21	14100	9030	-5070	0.15	0.64	24	15	-9
0006	2F	4	25	129	13	12900	6490	-6410	0.10	0.50	22	11	-11
0006	2F	4	26	74	8	7400	3980	-3420	0.11	0.54	13	7	-6
0006	2F	5	12	3031	1023	303100	258340	-44760	0.34	0.85	536	457	-79
0006	2F	5	13	1781	482	178100	148900	-29200	0.27	0.84	315	263	-52
0006	2F	5	14	1075	270	107500	92880	-14620	0.25	0.86	190	164	-26
0006	2F	5	15	414	65	41400	34880	-6520	0.16	0.84	73	61	-12
0006	2F	5	16	251	41	25100	24790	-310	0.16	0.99	44	43	-1
0006	2F	5	23	135	15	13500	9770	-3730	0.11	0.72	23	17	-6
0006	2F	5	24	66	8	6600	4650	-1950	0.12	0.70	11	8	-3
0006	2F	5	25	45	3	4500	3680	-820	0.07	0.82	7	6	-1
0006	2F	5	26	29	1	2900	460	-2440	0.03	0.16	5	0	-5
0006	2F	6	12	230	66	23000	16040	-6960	0.29	0.70	40	28	-12
0006	2F	6	13	137	28	13700	7400	-6300	0.20	0.54	24	13	-11
0006	2F	6	14	90	14	9000	5770	-3230	0.16	0.64	15	10	-5
0006	2F	6	15	38	5	3800	2700	-1100	0.13	0.71	6	4	-2
0006	2F	6	16	29	3	2900	990	-1910	0.10	0.34	5	1	-4
0006	2F	6	23	8	3	800	4230	3430	0.38	5.29	1	7	6
0006	2F	6	24	5	0	500	0	-500	0.00	0.00	0	0	0
0006	2F	6	25	2	0	200	0	-200	0.00	0.00	0	0	0
0006	2F	7	12	5032	1690	503200	435000	-68200	0.34	0.86	890	769	-121
0006	2F	7	13	2733	702	273300	231780	-41520	0.26	0.85	483	410	-73
0006	2F	7	14	1721	358	172100	132610	-39490	0.21	0.77	304	234	-70
0006	2F	7	15	651	96	65100	49650	-15450	0.15	0.76	115	87	-28
0006	2F	7	16	390	46	39000	24900	-14100	0.12	0.64	69	44	-25
0006	2F	7	23	215	20	21500	12710	-8790	0.09	0.59	38	22	-16
0006	2F	7	24	100	14	10000	8550	-1450	0.14	0.86	17	15	-2
0006	2F	7	25	74	6	7400	4120	-3280	0.08	0.56	13	7	-6
0006	2F	7	26	61	4	6100	3270	-2830	0.07	0.54	10	5	-5
0006	2T	1	12	3748	752	374800	305690	-69110	0.20	0.82	663	541	-122
0006	2T	1	13	2873	492	287300	215960	-71340	0.17	0.75	508	382	-126
0006	2T	1	14	1827	260	182700	159450	-23250	0.14	0.87	323	282	-41
0006	2T	1	15	650	58	65000	73470	8470	0.09	1.13	115	130	15
0006	2T	1	16	277	19	27700	22550	-5150	0.07	0.81	49	39	-10
0006	2T	1	21	444	57	44400	44490	90	0.13	1.00	78	78	0
0006	2T	1	23	270	27	27000	25570	-1430	0.10	0.95	47	45	-2
0006	2T	1	24	184	13	18400	17450	-950	0.07	0.95	32	30	-2
0006	2T	1	25	95	3	9500	5250	-4250	0.03	0.55	16	9	-7
0006	2T	1	26	59	3	5900	4070	-1830	0.05	0.69	10	7	-3
0006	2T	2	12	3446	727	344600	301970	-42630	0.21	0.88	609	534	-75
0006	2T	2	13	2531	459	253100	207190	-45910	0.18	0.82	447	366	-81
0006	2T	2	14	1738	264	173800	143980	-29820	0.15	0.83	307	254	-53
0006	2T	2	15	677	51	67700	37150	-30550	0.08	0.55	119	65	-54
0006	2T	2	16	473	40	47300	32090	-15210	0.08	0.68	83	56	-27
0006	2T	2	21	552	84	55200	60860	5660	0.15	1.10	97	107	10
0006	2T	2	23	281	32	28100	38040	9940	0.11	1.35	49	67	18
0006	2T	2	24	180	15	18000	9980	-8020	0.08	0.55	31	17	-14
0006	2T	2	25	127	5	12700	4960	-7740	0.04	0.39	22	8	-14
0006	2T	2	26	115	6	11500	5130	-6370	0.05	0.45	20	9	-11
0006	2T	3	12	3695	832	369500	307270	-62230	0.23	0.83	653	543	-110
0006	2T	3	13	2588	541	258800	235380	-23420	0.21	0.91	458	416	-42
0006	2T	3	14	1640	234	164000	126410	-37590	0.14	0.77	290	223	-67
0006	2T	3	15	781	96	78100	65200	-12900	0.12	0.83	138	115	-23
0006	2T	3	16	424	37	42400	34390	-8010	0.09	0.81	75	60	-15
0006	2T	3	21	496	69	49600	45430	-4170	0.14	0.92	87	80	-7
0006	2T	3	23	286	17	28600	20540	-8060	0.06	0.72	50	36	-14
0006	2T	3	24	147	11	14700	15790	1090	0.07	1.07	26	27	1
0006	2T	3	25	130	12	13000	10850	-2150	0.09	0.83	23	19	-4
0006	2T	3	26	104	5	10400	3240	-7160	0.05	0.31	18	5	-13
0006	2T	4	12	3197	758	319700	257930	-61770	0.24	0.81	565	456	-109
0006	2T	4	13	2221	501	222100	210840	-11260	0.23	0.95	393	373	-20
0006	2T	4	14	1335	244	133500	115590	-17910	0.18	0.87	236	204	-32
0006	2T	4	15	527	59	52700	42310	-10390	0.11	0.80	93	74	-19
0006	2T	4	16	276	27	27600	26270	-1330	0.10	0.95	48	46	-2
0006	2T	4	21	349	57	34900	36180	1280	0.16	1.04	61	64	3
0006	2T	4	23	266	28	26600	27680	1080	0.11	1.04	47	48	1
0006	2T	4	24	141	15	14100	9980	-4120	0.11	0.71	24	17	-7
0006	2T	4	25	129	11	12900	7700	-5200	0.09	0.60	22	13	-9
0006	2T	4	26	74	6	7400	3670	-3730	0.08	0.50	13	6	-7
0006	2T	5	12	2848	762	284800	228960	-55840	0.27	0.80	504	405	-99
0006	2T	5	13	1781	370	178100	140320	-37780	0.21	0.79	315	248	-67
0006	2T	5	14	1075	211	107500	96670	-10830	0.20	0.90	190	171	-19
0006	2T	5	15	414	50	41400	37820	-3580	0.12	0.91	73	66	-7
0006	2T	5	16	251	34	25100	28870	3770	0.14	1.15	44	51	7
0006	2T	5	21	183	17	18300	16330	-1970	0.09	0.89	32	28	-4
0006	2T	5	23	135	9	13500	11050	-2450	0.07	0.82	23	19	-4
0006	2T	5	24	66	3	6600	2630	-3970	0.05	0.40	11	4	-7
0006	2T	5	25	45	3	4500	6230	1730	0.07	1.38	7	11	4
0006	2T	5	26	29	0	2900	0	-2900	0.00	0.00	5	0	-5
0006	2T	6	12	218	49	21800	14900	-6900	0.22	0.68	38	26	-12
0006	2T	6	13	137	17	13700	5200	-8500	0.12	0.38	24	9	-15
0006	2T	6	14	90	12	9000	6660	-2340	0.13	0.74	15	11	-4
0006	2T	6	15	38	3	3800	2370	-1430	0.08	0.62	6	4	-2
0006	2T	6	16	29	0	2900	0	-2900	0.00	0.00	5	0	-5
0006	2T	6	21	12	1	1200	390	-810	0.08	0.33	2	0	-2
0006	2T	6	23	8	2	800	5770	4970	0.25	7.21	1	10	9
0006	2T	6	24	5	0	500	0	-500	0.00	0.00	0	0	0
0006	2T	6	25	2	0	200	0	-200	0.00	0.00	0	0	0
0006	2T	7	12	4735	1302	473500	414370	-59130	0.27	0.88	838	733	-105
0006	2T	7	13	2733	563	273300	224440	-48860	0.21	0.82	483	397	-86
0006	2T	7	14	1721	283	172100	132310	-39790	0.16	0.77	304	234	-70
0006	2T	7	15	651	74	65100	48580	-16520	0.11	0.75	115	85	-30
0006	2T	7	16	390	34	39000	23850	-15150	0.09	0.61	69	42	-27
0006	2T	7	21	297	30	29700	22120	-7580	0.10	0.74	52	39	-13
0006	2T	7	23	215	10	21500	15070	-6430	0.05	0.70	38	26	-12
0006	2T	7	24	100	9	10000	11280	1280	0.09	1.13	17	19	2
0006	2T	7	25	74	4	7400	5320	-2080	0.05	0.72	13	9	-4
0006	2T	7	26	61	2	6100	1540	-4560	0.03	0.25	10	2	-8
0006	3F	1	123	1794	349	179400	157900	-21500	0.19	0.88	317	279	-38
0006	3F	1	124	1516	255	151600	129000	-22600	0.17	0.85	268	228	-40
0006	3F	1	125	852	88	85200	65160	-20040	0.10	0.76	150	115	-35
0006	3F	1	126	776	82	77600	64020	-13580	0.11	0.83	137	113	-24
0006	3F	1	134	1179	169	117900	95540	-22360	0.14	0.81	208	169	-39
0006	3F	1	135	642	63	64200	45600	-18600	0.10	0.71	113	80	-33
0006	3F	1	136	503	38	50300	42110	-8190	0.08	0.84	89	74	-15
0006	3F	1	145	432	35	43200	34810	-8390	0.08	0.81	76	61	-15
0006	3F	1	146	283	16	28300	15510	-12790	0.06	0.55	50	27	-23
0006	3F	1	156	159	13	15900	20700	4800	0.08	1.30	28	36	8
0006	3F	1	234	104	7	10400	5260	-5140	0.07	0.51	18	9	-9
0006	3F	1	235	61	6	6100	3820	-2280	0.10	0.63	10	6	-4
0006	3F	1	236	51	2	5100	800	-4300	0.04	0.16	9	1	-8
0006	3F	1	245	44	4	4400	6330	1930	0.09	1.44	7	11	4
0006	3F	1	246	39	2	3900	1670	-2230	0.05	0.43	6	2	-4
0006	3F	1	256	26	2	2600	940	-1660	0.08	0.36	4	1	-3
0006	3F	2	123	1633	303	163300	129420	-33880	0.19	0.79	289	229	-60
0006	3F	2	124	1335	226	133500	99740	-33760	0.17	0.75	236	176	-60
0006	3F	2	125	881	126	88100	66980	-21120	0.14	0.76	155	118	-37
0006	3F	2	126	830	88	83000	62860	-20140	0.11	0.76	146	111	-35
0006	3F	2	134	956	133	95600	76370	-19230	0.14	0.80	169	135	-34
0006	3F	2	135	552	82	55200	54430	-770	0.15	0.99	97	96	-1
0006	3F	2	136	549	54	54900	43130	-11770	0.10	0.79	97	76	-21
0006	3F	2	145	395	44	39500	30370	-9130	0.11	0.77	69	53	-16
0006	3F	2	146	370	41	37000	44530	7530	0.11	1.20	65	78	13
0006	3F	2	156	170	13	17000	14920	-2080	0.08	0.88	30	26	-4
0006	3F	2	234	90	8	9000	5180	-3820	0.09	0.58	15	9	-6
0006	3F	2	235	71	6	7100	9280	2180	0.08	1.31	12	16	4
0006	3F	2	236	88	8	8800	5350	-3450	0.09	0.61	15	9	-6
0006	3F	2	245	45	4	4500	3480	-1020	0.09	0.77	7	6	-1
0006	3F	2	246	55	5	5500	5830	330	0.09	1.06	9	10	1
0006	3F	2	256	51	4	5100	5460	360	0.08	1.07	9	9	0
0006	3F	3	123	1739	382	173900	151920	-21980	0.22	0.87	307	268	-39
0006	3F	3	124	1329	242	132900	117940	-14960	0.18	0.89	235	208	-27
0006	3F	3	125	953	109	95300	55910	-39390	0.11	0.59	168	98	-70
0006	3F	3	126	769	84	76900	83850	6950	0.11	1.09	136	148	12
0006	3F	3	134	1001	149	100100	75120	-24980	0.15	0.75	177	132	-45
0006	3F	3	135	646	82	64600	50380	-14220	0.13	0.78	114	89	-25
0006	3F	3	136	467	52	46700	46730	30	0.11	1.00	82	82	0
0006	3F	3	145	438	35	43800	22300	-21500	0.08	0.51	77	39	-38
0006	3F	3	146	322	23	32200	18620	-13580	0.07	0.58	56	32	-24
0006	3F	3	156	154	11	15400	7930	-7470	0.07	0.51	27	14	-13
0006	3F	3	234	88	10	8800	10470	1670	0.11	1.19	15	18	3
0006	3F	3	235	81	8	8100	6320	-1780	0.10	0.78	14	11	-3
0006	3F	3	236	78	3	7800	1900	-5900	0.04	0.24	13	3	-10
0006	3F	3	245	42	5	4200	15020	10820	0.12	3.58	7	26	19
0006	3F	3	246	30	2	3000	1850	-1150	0.07	0.62	5	3	-2
0006	3F	3	256	33	4	3300	5950	2650	0.12	1.80	5	10	5
0006	3F	4	123	1589	369	158900	139200	-19700	0.23	0.88	281	246	-35
0006	3F	4	124	1259	225	125900	88690	-37210	0.18	0.70	222	156	-66
0006	3F	4	125	739	104	73900	60160	-13740	0.14	0.81	130	106	-24
0006	3F	4	126	542	62	54200	60000	5800	0.11	1.11	95	106	11
0006	3F	4	134	856	145	85600	81110	-4490	0.17	0.95	151	143	-8
0006	3F	4	135	505	61	50500	33470	-17030	0.12	0.66	89	59	-30
0006	3F	4	136	373	50	37300	60400	23100	0.13	1.62	66	106	40
0006	3F	4	145	303	24	30300	18270	-12030	0.08	0.60	53	32	-21
0006	3F	4	146	216	18	21600	12800	-8800	0.08	0.59	38	22	-16
0006	3F	4	156	106	4	10600	2590	-8010	0.04	0.24	18	4	-14
0006	3F	4	234	95	14	9500	7930	-1570	0.15	0.83	16	14	-2
0006	3F	4	235	64	10	6400	4430	-1970	0.16	0.69	11	7	-4
0006	3F	4	236	52	4	5200	2130	-3070	0.08	0.41	9	3	-6
0006	3F	4	245	47	2	4700	2310	-2390	0.04	0.49	8	4	-4
0006	3F	4	246	37	3	3700	6810	3110	0.08	1.84	6	12	6
0006	3F	4	256	37	1	3700	490	-3210	0.03	0.13	6	0	-6
0006	3F	5	123	1329	318	132900	107610	-25290	0.24	0.81	235	190	-45
0006	3F	5	124	1082	204	108200	78160	-30040	0.19	0.72	191	138	-53
0006	3F	5	125	608	88	60800	54240	-6560	0.14	0.89	107	96	-11
0006	3F	5	126	403	47	40300	43610	3310	0.12	1.08	71	77	6
0006	3F	5	134	728	133	72800	66280	-6520	0.18	0.91	128	117	-11
0006	3F	5	135	427	42	42700	29990	-12710	0.10	0.70	75	53	-22
0006	3F	5	136	264	25	26400	18220	-8180	0.09	0.69	46	32	-14
0006	3F	5	145	259	30	25900	20960	-4940	0.12	0.81	45	37	-8
0006	3F	5	146	149	21	14900	13900	-1000	0.14	0.93	26	24	-2
0006	3F	5	156	82	8	8200	6800	-1400	0.10	0.83	14	12	-2
0006	3F	5	234	45	4	4500	4260	-240	0.09	0.95	7	7	0
0006	3F	5	235	25	1	2500	390	-2110	0.04	0.16	4	0	-4
0006	3F	5	236	23	2	2300	970	-1330	0.09	0.42	4	1	-3
0006	3F	5	245	18	2	1800	720	-1080	0.11	0.40	3	1	-2
0006	3F	5	246	13	1	1300	1480	180	0.08	1.14	2	2	0
0006	3F	5	256	13	0	1300	0	-1300	0.00	0.00	2	0	-2
0006	3F	6	123	97	12	9700	3940	-5760	0.12	0.41	17	6	-11
0006	3F	6	124	82	19	8200	8790	590	0.23	1.07	14	15	1
0006	3F	6	125	46	7	4600	5960	1360	0.15	1.30	8	10	2
0006	3F	6	126	30	4	3000	2540	-460	0.13	0.85	5	4	-1
0006	3F	6	134	68	10	6800	4350	-2450	0.15	0.64	12	7	-5
0006	3F	6	135	26	1	2600	260	-2340	0.04	0.10	4	0	-4
0006	3F	6	136	25	4	2500	3370	870	0.16	1.35	4	5	1
0006	3F	6	145	27	4	2700	2800	100	0.15	1.04	4	4	0
0006	3F	6	146	15	1	1500	840	-660	0.07	0.56	2	1	-1
0006	3F	6	156	9	2	900	740	-160	0.22	0.82	1	1	0
0006	3F	6	234	1	0	100	0	-100	0.00	0.00	0	0	0
0006	3F	6	235	3	0	300	0	-300	0.00	0.00	0	0	0
0006	3F	6	236	3	0	300	0	-300	0.00	0.00	0	0	0
0006	3F	6	246	2	0	200	0	-200	0.00	0.00	0	0	0
0006	3F	7	123	2138	491	213800	188990	-24810	0.23	0.88	378	334	-44
0006	3F	7	124	1695	332	169500	138410	-31090	0.20	0.82	300	244	-56
0006	3F	7	125	971	124	97100	71590	-25510	0.13	0.74	171	126	-45
0006	3F	7	126	714	93	71400	62370	-9030	0.13	0.87	126	110	-16
0006	3F	7	134	1053	190	105300	94540	-10760	0.18	0.90	186	167	-19
0006	3F	7	135	609	70	60900	42610	-18290	0.11	0.70	107	75	-32
0006	3F	7	136	457	54	45700	39310	-6390	0.12	0.86	80	69	-11
0006	3F	7	145	401	45	40100	33720	-6380	0.11	0.84	70	59	-11
0006	3F	7	146	260	14	26000	11770	-14230	0.05	0.45	46	20	-26
0006	3F	7	156	121	16	12100	18030	5930	0.13	1.49	21	31	10
0006	3F	7	234	65	3	6500	960	-5540	0.05	0.15	11	1	-10
0006	3F	7	235	47	6	4700	4250	-450	0.13	0.90	8	7	-1
0006	3F	7	236	52	2	5200	870	-4330	0.04	0.17	9	1	-8
0006	3F	7	245	25	2	2500	1030	-1470	0.08	0.41	4	1	-3
0006	3F	7	246	25	1	2500	290	-2210	0.04	0.12	4	0	-4
0006	3F	7	256	20	1	2000	550	-1450	0.05	0.28	3	0	-3
0006	3T	1	123	965	75	96500	72230	-24270	0.08	0.75	170	127	-43
0006	3T	1	124	941	65	94100	71270	-22830	0.07	0.76	166	126	-40
0006	3T	1	125	609	34	60900	55490	-5410	0.06	0.91	107	98	-9
0006	3T	1	126	604	29	60400	57110	-3290	0.05	0.95	106	101	-5
0006	3T	1	132	668	38	66800	56190	-10610	0.06	0.84	118	99	-19
0006	3T	1	134	735	33	73500	56960	-16540	0.04	0.77	130	100	-30
0006	3T	1	135	495	23	49500	37320	-12180	0.05	0.75	87	66	-21
0006	3T	1	136	441	15	44100	43140	-960	0.03	0.98	78	76	-2
0006	3T	1	142	451	25	45100	31690	-13410	0.06	0.70	79	56	-23
0006	3T	1	143	444	28	44400	55820	11420	0.06	1.26	78	98	20
0006	3T	1	145	299	11	29900	25110	-4790	0.04	0.84	52	44	-8
0006	3T	1	146	225	5	22500	16430	-6070	0.02	0.73	39	29	-10
0006	3T	1	152	147	5	14700	12900	-1800	0.03	0.88	26	22	-4
0006	3T	1	153	147	2	14700	4430	-10270	0.01	0.30	26	7	-19
0006	3T	1	154	133	3	13300	33080	19780	0.02	2.49	23	58	35
0006	3T	1	156	125	6	12500	17940	5440	0.05	1.44	22	31	9
0006	3T	1	162	78	2	7800	4360	-3440	0.03	0.56	13	7	-6
0006	3T	1	163	62	2	6200	3960	-2240	0.03	0.64	10	7	-3
0006	3T	1	164	58	4	5800	13080	7280	0.07	2.26	10	23	13
0006	3T	1	165	34	0	3400	0	-3400	0.00	0.00	6	0	-6
0006	3T	1	213	123	5	12300	4940	-7360	0.04	0.40	21	8	-13
0006	3T	1	214	87	2	8700	1400	-7300	0.02	0.16	15	2	-13
0006	3T	1	215	77	2	7700	5630	-2070	0.03	0.73	13	9	-4
0006	3T	1	216	82	4	8200	5200	-3000	0.05	0.63	14	9	-5
0006	3T	1	231	38	0	3800	0	-3800	0.00	0.00	6	0	-6
0006	3T	1	234	69	3	6900	10510	3610	0.04	1.52	12	18	6
0006	3T	1	235	41	2	4100	2440	-1660	0.05	0.60	7	4	-3
0006	3T	1	236	41	1	4100	1940	-2160	0.02	0.47	7	3	-4
0006	3T	1	241	37	0	3700	0	-3700	0.00	0.00	6	0	-6
0006	3T	1	243	35	1	3500	3850	350	0.03	1.10	6	6	0
0006	3T	1	245	34	2	3400	5170	1770	0.06	1.52	6	9	3
0006	3T	1	246	29	0	2900	0	-2900	0.00	0.00	5	0	-5
0006	3T	1	251	19	0	1900	0	-1900	0.00	0.00	3	0	-3
0006	3T	1	253	20	1	2000	1890	-110	0.05	0.95	3	3	0
0006	3T	1	254	10	0	1000	0	-1000	0.00	0.00	1	0	-1
0006	3T	1	256	16	0	1600	0	-1600	0.00	0.00	2	0	-2
0006	3T	1	261	12	0	1200	0	-1200	0.00	0.00	2	0	-2
0006	3T	1	263	10	0	1000	0	-1000	0.00	0.00	1	0	-1
0006	3T	1	264	10	0	1000	0	-1000	0.00	0.00	1	0	-1
0006	3T	1	265	10	0	1000	0	-1000	0.00	0.00	1	0	-1
0006	3T	2	123	892	71	89200	89550	350	0.08	1.00	157	158	1
0006	3T	2	124	780	61	78000	71070	-6930	0.08	0.91	138	125	-13
0006	3T	2	125	593	31	59300	38330	-20970	0.05	0.65	104	67	-37
0006	3T	2	126	578	24	57800	30560	-27240	0.04	0.53	102	54	-48
0006	3T	2	132	591	39	59100	57810	-1290	0.07	0.98	104	102	-2
0006	3T	2	134	576	39	57600	40350	-17250	0.07	0.70	101	71	-30
0006	3T	2	135	419	26	41900	36130	-5770	0.06	0.86	74	63	-11
0006	3T	2	136	442	13	44200	41420	-2780	0.03	0.94	78	73	-5
0006	3T	2	142	423	25	42300	35590	-6710	0.06	0.84	74	62	-12
0006	3T	2	143	380	22	38000	41140	3140	0.06	1.08	67	72	5
0006	3T	2	145	276	12	27600	18480	-9120	0.04	0.67	48	32	-16
0006	3T	2	146	291	12	29100	34000	4900	0.04	1.17	51	60	9
0006	3T	2	152	162	6	16200	10340	-5860	0.04	0.64	28	18	-10
0006	3T	2	153	133	1	13300	3240	-10060	0.01	0.24	23	5	-18
0006	3T	2	154	119	4	11900	14410	2510	0.03	1.21	21	25	4
0006	3T	2	156	115	0	11500	0	-11500	0.00	0.00	20	0	-20
0006	3T	2	162	120	3	12000	7200	-4800	0.03	0.60	21	12	-9
0006	3T	2	163	107	5	10700	12110	1410	0.05	1.13	18	21	3
0006	3T	2	164	79	5	7900	6990	-910	0.06	0.88	13	12	-1
0006	3T	2	165	55	0	5500	0	-5500	0.00	0.00	9	0	-9
0006	3T	2	213	111	5	11100	6420	-4680	0.05	0.58	19	11	-8
0006	3T	2	214	105	8	10500	29380	18880	0.08	2.80	18	52	34
0006	3T	2	215	107	4	10700	12980	2280	0.04	1.21	18	22	4
0006	3T	2	216	115	5	11500	18090	6590	0.04	1.57	20	32	12
0006	3T	2	231	39	2	3900	1980	-1920	0.05	0.51	6	3	-3
0006	3T	2	234	58	1	5800	1040	-4760	0.02	0.18	10	1	-9
0006	3T	2	235	44	2	4400	24600	20200	0.05	5.59	7	43	36
0006	3T	2	236	66	4	6600	7100	500	0.06	1.08	11	12	1
0006	3T	2	241	27	1	2700	2210	-490	0.04	0.82	4	3	-1
0006	3T	2	243	32	2	3200	1390	-1810	0.06	0.43	5	2	-3
0006	3T	2	245	27	0	2700	0	-2700	0.00	0.00	4	0	-4
0006	3T	2	246	35	2	3500	10520	7020	0.06	3.01	6	18	12
0006	3T	2	251	19	0	1900	0	-1900	0.00	0.00	3	0	-3
0006	3T	2	253	27	0	2700	0	-2700	0.00	0.00	4	0	-4
0006	3T	2	254	18	0	1800	0	-1800	0.00	0.00	3	0	-3
0006	3T	2	256	32	0	3200	0	-3200	0.00	0.00	5	0	-5
0006	3T	2	261	17	1	1700	3720	2020	0.06	2.19	3	6	3
0006	3T	2	263	22	1	2200	2060	-140	0.05	0.94	3	3	0
0006	3T	2	264	20	0	2000	0	-2000	0.00	0.00	3	0	-3
0006	3T	2	265	19	0	1900	0	-1900	0.00	0.00	3	0	-3
0006	3T	3	123	1001	99	100100	104960	4860	0.10	1.05	177	185	8
0006	3T	3	124	844	68	84400	72520	-11880	0.08	0.86	149	128	-21
0006	3T	3	125	674	32	67400	39020	-28380	0.05	0.58	119	69	-50
0006	3T	3	126	561	23	56100	54340	-1760	0.04	0.97	99	96	-3
0006	3T	3	132	585	50	58500	51360	-7140	0.09	0.88	103	90	-13
0006	3T	3	134	625	47	62500	49900	-12600	0.08	0.80	110	88	-22
0006	3T	3	135	484	31	48400	58430	10030	0.06	1.21	85	103	18
0006	3T	3	136	368	16	36800	32640	-4160	0.04	0.89	65	57	-8
0006	3T	3	142	361	18	36100	28810	-7290	0.05	0.80	63	50	-13
0006	3T	3	143	376	16	37600	42960	5360	0.04	1.14	66	76	10
0006	3T	3	145	281	6	28100	9480	-18620	0.02	0.34	49	16	-33
0006	3T	3	146	254	6	25400	6960	-18440	0.02	0.27	44	12	-32
0006	3T	3	152	176	6	17600	6940	-10660	0.03	0.39	31	12	-19
0006	3T	3	153	162	7	16200	16120	-80	0.04	1.00	28	28	0
0006	3T	3	154	157	5	15700	6470	-9230	0.03	0.41	27	11	-16
0006	3T	3	156	111	5	11100	10740	-360	0.05	0.97	19	19	0
0006	3T	3	162	93	3	9300	4160	-5140	0.03	0.45	16	7	-9
0006	3T	3	163	99	2	9900	2400	-7500	0.02	0.24	17	4	-13
0006	3T	3	164	68	2	6800	6680	-120	0.03	0.98	12	11	-1
0006	3T	3	165	43	0	4300	0	-4300	0.00	0.00	7	0	-7
0006	3T	3	213	116	7	11600	9190	-2410	0.06	0.79	20	16	-4
0006	3T	3	214	106	9	10600	16900	6300	0.08	1.59	18	29	11
0006	3T	3	215	80	2	8000	4010	-3990	0.03	0.50	14	7	-7
0006	3T	3	216	100	6	10000	20630	10630	0.06	2.06	17	36	19
0006	3T	3	231	37	1	3700	3460	-240	0.03	0.94	6	6	0
0006	3T	3	234	60	2	6000	2900	-3100	0.03	0.48	10	5	-5
0006	3T	3	235	51	1	5100	950	-4150	0.02	0.19	9	1	-8
0006	3T	3	236	55	0	5500	0	-5500	0.00	0.00	9	0	-9
0006	3T	3	241	18	2	1800	2470	670	0.11	1.37	3	4	1
0006	3T	3	243	28	0	2800	0	-2800	0.00	0.00	4	0	-4
0006	3T	3	245	28	1	2800	53670	50870	0.04	19.17	4	94	90
0006	3T	3	246	17	0	1700	0	-1700	0.00	0.00	3	0	-3
0006	3T	3	251	23	0	2300	0	-2300	0.00	0.00	4	0	-4
0006	3T	3	253	30	1	3000	1880	-1120	0.03	0.63	5	3	-2
0006	3T	3	254	14	1	1400	4840	3440	0.07	3.46	2	8	6
0006	3T	3	256	18	0	1800	0	-1800	0.00	0.00	3	0	-3
0006	3T	3	261	15	0	1500	0	-1500	0.00	0.00	2	0	-2
0006	3T	3	263	23	0	2300	0	-2300	0.00	0.00	4	0	-4
0006	3T	3	264	13	0	1300	0	-1300	0.00	0.00	2	0	-2
0006	3T	3	265	15	0	1500	0	-1500	0.00	0.00	2	0	-2
0006	3T	4	123	923	104	92300	78840	-13460	0.11	0.85	163	139	-24
0006	3T	4	124	818	60	81800	55150	-26650	0.07	0.67	144	97	-47
0006	3T	4	125	521	31	52100	38660	-13440	0.06	0.74	92	68	-24
0006	3T	4	126	427	23	42700	45940	3240	0.05	1.08	75	81	6
0006	3T	4	132	550	51	55000	65750	10750	0.09	1.20	97	116	19
0006	3T	4	134	543	43	54300	55860	1560	0.08	1.03	96	98	2
0006	3T	4	135	385	22	38500	28040	-10460	0.06	0.73	68	49	-19
0006	3T	4	136	305	19	30500	29270	-1230	0.06	0.96	53	51	-2
0006	3T	4	142	342	24	34200	38300	4100	0.07	1.12	60	67	7
0006	3T	4	143	313	13	31300	21290	-10010	0.04	0.68	55	37	-18
0006	3T	4	145	214	9	21400	19870	-1530	0.04	0.93	37	35	-2
0006	3T	4	146	171	7	17100	11110	-5990	0.04	0.65	30	19	-11
0006	3T	4	152	130	6	13000	13030	30	0.05	1.00	23	23	0
0006	3T	4	153	120	4	12000	7800	-4200	0.03	0.65	21	13	-8
0006	3T	4	154	89	1	8900	1040	-7860	0.01	0.12	15	1	-14
0006	3T	4	156	70	0	7000	0	-7000	0.00	0.00	12	0	-12
0006	3T	4	162	62	3	6200	7920	1720	0.05	1.28	10	14	4
0006	3T	4	163	68	2	6800	3250	-3550	0.03	0.48	12	5	-7
0006	3T	4	164	45	0	4500	0	-4500	0.00	0.00	7	0	-7
0006	3T	4	165	36	0	3600	0	-3600	0.00	0.00	6	0	-6
0006	3T	4	213	83	7	8300	11240	2940	0.08	1.35	14	19	5
0006	3T	4	214	80	4	8000	10800	2800	0.05	1.35	14	19	5
0006	3T	4	215	72	2	7200	2380	-4820	0.03	0.33	12	4	-8
0006	3T	4	216	45	2	4500	4200	-300	0.04	0.93	7	7	0
0006	3T	4	231	33	1	3300	1150	-2150	0.03	0.35	5	2	-3
0006	3T	4	234	69	3	6900	10000	3100	0.04	1.45	12	17	5
0006	3T	4	235	41	1	4100	2640	-1460	0.02	0.64	7	4	-3
0006	3T	4	236	39	1	3900	3920	20	0.03	1.01	6	6	0
0006	3T	4	241	19	0	1900	0	-1900	0.00	0.00	3	0	-3
0006	3T	4	243	26	0	2600	0	-2600	0.00	0.00	4	0	-4
0006	3T	4	245	20	0	2000	0	-2000	0.00	0.00	3	0	-3
0006	3T	4	246	26	2	2600	8440	5840	0.08	3.25	4	14	10
0006	3T	4	251	16	0	1600	0	-1600	0.00	0.00	2	0	-2
0006	3T	4	253	23	0	2300	0	-2300	0.00	0.00	4	0	-4
0006	3T	4	254	27	1	2700	2690	-10	0.04	1.00	4	4	0
0006	3T	4	256	25	0	2500	0	-2500	0.00	0.00	4	0	-4
0006	3T	4	261	8	1	800	1370	570	0.13	1.71	1	2	1
0006	3T	4	263	13	1	1300	680	-620	0.08	0.52	2	1	-1
0006	3T	4	264	11	0	1100	0	-1100	0.00	0.00	1	0	-1
0006	3T	4	265	12	0	1200	0	-1200	0.00	0.00	2	0	-2
0006	3T	5	123	831	87	83100	65550	-17550	0.10	0.79	147	116	-31
0006	3T	5	124	785	76	78500	66460	-12040	0.10	0.85	138	117	-21
0006	3T	5	125	462	33	46200	49110	2910	0.07	1.06	81	86	5
0006	3T	5	126	322	14	32200	24880	-7320	0.04	0.77	56	44	-12
0006	3T	5	132	423	37	42300	38630	-3670	0.09	0.91	74	68	-6
0006	3T	5	134	473	39	47300	42090	-5210	0.08	0.89	83	74	-9
0006	3T	5	135	334	18	33400	18160	-15240	0.05	0.54	59	32	-27
0006	3T	5	136	209	10	20900	24950	4050	0.05	1.19	36	44	8
0006	3T	5	142	251	18	25100	21000	-4100	0.07	0.84	44	37	-7
0006	3T	5	143	255	14	25500	18440	-7060	0.05	0.72	45	32	-13
0006	3T	5	145	186	12	18600	25450	6850	0.06	1.37	32	45	13
0006	3T	5	146	104	9	10400	11050	650	0.09	1.06	18	19	1
0006	3T	5	152	103	7	10300	9130	-1170	0.07	0.89	18	16	-2
0006	3T	5	153	93	1	9300	1800	-7500	0.01	0.19	16	3	-13
0006	3T	5	154	73	0	7300	0	-7300	0.00	0.00	12	0	-12
0006	3T	5	156	58	2	5800	2440	-3360	0.03	0.42	10	4	-6
0006	3T	5	162	46	6	4600	37660	33060	0.13	8.19	8	66	58
0006	3T	5	163	55	1	5500	630	-4870	0.02	0.11	9	1	-8
0006	3T	5	164	45	1	4500	1960	-2540	0.02	0.44	7	3	-4
0006	3T	5	165	24	0	2400	0	-2400	0.00	0.00	4	0	-4
0006	3T	5	213	44	2	4400	6840	2440	0.05	1.55	7	12	5
0006	3T	5	214	37	0	3700	0	-3700	0.00	0.00	6	0	-6
0006	3T	5	215	37	2	3700	5830	2130	0.05	1.58	6	10	4
0006	3T	5	216	28	1	2800	2430	-370	0.04	0.87	4	4	0
0006	3T	5	231	31	0	3100	0	-3100	0.00	0.00	5	0	-5
0006	3T	5	234	26	0	2600	0	-2600	0.00	0.00	4	0	-4
0006	3T	5	235	20	0	2000	0	-2000	0.00	0.00	3	0	-3
0006	3T	5	236	18	0	1800	0	-1800	0.00	0.00	3	0	-3
0006	3T	5	241	9	0	900	0	-900	0.00	0.00	1	0	-1
0006	3T	5	243	19	0	1900	0	-1900	0.00	0.00	3	0	-3
0006	3T	5	245	8	0	800	0	-800	0.00	0.00	1	0	-1
0006	3T	5	246	8	0	800	0	-800	0.00	0.00	1	0	-1
0006	3T	5	251	6	0	600	0	-600	0.00	0.00	1	0	-1
0006	3T	5	253	5	0	500	0	-500	0.00	0.00	0	0	0
0006	3T	5	254	10	0	1000	0	-1000	0.00	0.00	1	0	-1
0006	3T	5	256	11	0	1100	0	-1100	0.00	0.00	1	0	-1
0006	3T	5	261	7	0	700	0	-700	0.00	0.00	1	0	-1
0006	3T	5	263	5	0	500	0	-500	0.00	0.00	0	0	0
0006	3T	5	264	5	0	500	0	-500	0.00	0.00	0	0	0
0006	3T	5	265	2	0	200	0	-200	0.00	0.00	0	0	0
0006	3T	6	123	70	2	7000	1090	-5910	0.03	0.16	12	1	-11
0006	3T	6	124	60	6	6000	7810	1810	0.10	1.30	10	13	3
0006	3T	6	125	31	4	3100	8460	5360	0.13	2.73	5	14	9
0006	3T	6	126	26	1	2600	1080	-1520	0.04	0.42	4	1	-3
0006	3T	6	132	25	2	2500	1440	-1060	0.08	0.58	4	2	-2
0006	3T	6	134	48	2	4800	1550	-3250	0.04	0.32	8	2	-6
0006	3T	6	135	20	0	2000	0	-2000	0.00	0.00	3	0	-3
0006	3T	6	136	18	2	1800	3520	1720	0.11	1.96	3	6	3
0006	3T	6	142	17	1	1700	3480	1780	0.06	2.05	3	6	3
0006	3T	6	143	20	0	2000	0	-2000	0.00	0.00	3	0	-3
0006	3T	6	145	17	1	1700	820	-880	0.06	0.48	3	1	-2
0006	3T	6	146	9	0	900	0	-900	0.00	0.00	1	0	-1
0006	3T	6	152	11	0	1100	0	-1100	0.00	0.00	1	0	-1
0006	3T	6	153	6	0	600	0	-600	0.00	0.00	1	0	-1
0006	3T	6	154	10	0	1000	0	-1000	0.00	0.00	1	0	-1
0006	3T	6	156	4	0	400	0	-400	0.00	0.00	0	0	0
0006	3T	6	162	1	0	100	0	-100	0.00	0.00	0	0	0
0006	3T	6	163	7	0	700	0	-700	0.00	0.00	1	0	-1
0006	3T	6	164	6	0	600	0	-600	0.00	0.00	1	0	-1
0006	3T	6	165	5	0	500	0	-500	0.00	0.00	0	0	0
0006	3T	6	213	1	0	100	0	-100	0.00	0.00	0	0	0
0006	3T	6	214	4	0	400	0	-400	0.00	0.00	0	0	0
0006	3T	6	215	4	0	400	0	-400	0.00	0.00	0	0	0
0006	3T	6	216	3	0	300	0	-300	0.00	0.00	0	0	0
0006	3T	6	231	1	0	100	0	-100	0.00	0.00	0	0	0
0006	3T	6	234	1	0	100	0	-100	0.00	0.00	0	0	0
0006	3T	6	235	1	0	100	0	-100	0.00	0.00	0	0	0
0006	3T	6	236	3	0	300	0	-300	0.00	0.00	0	0	0
0006	3T	6	241	1	0	100	0	-100	0.00	0.00	0	0	0
0006	3T	6	246	2	0	200	0	-200	0.00	0.00	0	0	0
0006	3T	6	253	2	0	200	0	-200	0.00	0.00	0	0	0
0006	3T	7	123	1377	164	137700	132540	-5160	0.12	0.96	243	234	-9
0006	3T	7	124	1200	108	120000	92320	-27680	0.09	0.77	212	163	-49
0006	3T	7	125	766	56	76600	67010	-9590	0.07	0.87	135	118	-17
0006	3T	7	126	575	41	57500	60120	2620	0.07	1.05	101	106	5
0006	3T	7	132	656	59	65600	64980	-620	0.09	0.99	116	115	-1
0006	3T	7	134	658	43	65800	47780	-18020	0.07	0.73	116	84	-32
0006	3T	7	135	462	27	46200	42870	-3330	0.06	0.93	81	75	-6
0006	3T	7	136	363	20	36300	28250	-8050	0.06	0.78	64	50	-14
0006	3T	7	142	408	30	40800	47500	6700	0.07	1.16	72	84	12
0006	3T	7	143	395	20	39500	27820	-11680	0.05	0.70	69	49	-20
0006	3T	7	145	288	9	28800	11190	-17610	0.03	0.39	50	19	-31
0006	3T	7	146	199	2	19900	3790	-16110	0.01	0.19	35	6	-29
0006	3T	7	152	148	3	14800	4430	-10370	0.02	0.30	26	7	-19
0006	3T	7	153	147	2	14700	3960	-10740	0.01	0.27	26	7	-19
0006	3T	7	154	113	6	11300	14560	3260	0.05	1.29	20	25	5
0006	3T	7	156	81	3	8100	14720	6620	0.04	1.82	14	26	12
0006	3T	7	162	84	2	8400	3390	-5010	0.02	0.40	14	6	-8
0006	3T	7	163	94	2	9400	3250	-6150	0.02	0.35	16	5	-11
0006	3T	7	164	61	0	6100	0	-6100	0.00	0.00	10	0	-10
0006	3T	7	165	40	1	4000	3440	-560	0.03	0.86	7	6	-1
0006	3T	7	213	71	6	7100	10450	3350	0.08	1.47	12	18	6
0006	3T	7	214	68	4	6800	12080	5280	0.06	1.78	12	21	9
0006	3T	7	215	46	1	4600	2210	-2390	0.02	0.48	8	3	-5
0006	3T	7	216	44	2	4400	3550	-850	0.05	0.81	7	6	-1
0006	3T	7	231	34	2	3400	3830	430	0.06	1.13	6	6	0
0006	3T	7	234	45	0	4500	0	-4500	0.00	0.00	7	0	-7
0006	3T	7	235	34	0	3400	0	-3400	0.00	0.00	6	0	-6
0006	3T	7	236	35	0	3500	0	-3500	0.00	0.00	6	0	-6
0006	3T	7	241	19	0	1900	0	-1900	0.00	0.00	3	0	-3
0006	3T	7	243	20	1	2000	1390	-610	0.05	0.70	3	2	-1
0006	3T	7	245	16	1	1600	1220	-380	0.06	0.76	2	2	0
0006	3T	7	246	17	1	1700	840	-860	0.06	0.49	3	1	-2
0006	3T	7	251	11	0	1100	0	-1100	0.00	0.00	1	0	-1
0006	3T	7	253	13	0	1300	0	-1300	0.00	0.00	2	0	-2
0006	3T	7	254	9	0	900	0	-900	0.00	0.00	1	0	-1
0006	3T	7	256	12	0	1200	0	-1200	0.00	0.00	2	0	-2
0006	3T	7	261	11	0	1100	0	-1100	0.00	0.00	1	0	-1
0006	3T	7	263	17	1	1700	1700	0	0.06	1.00	3	3	0
0006	3T	7	264	8	0	800	0	-800	0.00	0.00	1	0	-1
0006	3T	7	265	8	0	800	0	-800	0.00	0.00	1	0	-1
0023	3T	04_1	123	20	0	2000	0	-2000	0.00	0.00	3	0	-3
0023	3T	04_1	124	10	0	1000	0	-1000	0.00	0.00	1	0	-1
0023	3T	04_1	125	4	0	400	0	-400	0.00	0.00	0	0	0
0023	3T	04_1	126	8	1	800	2110	1310	0.13	2.64	1	3	2
0023	3T	04_1	134	6	0	600	0	-600	0.00	0.00	1	0	-1
0023	3T	04_1	135	6	0	600	0	-600	0.00	0.00	1	0	-1
0023	3T	04_1	136	4	0	400	0	-400	0.00	0.00	0	0	0
0023	3T	04_1	142	1	0	100	0	-100	0.00	0.00	0	0	0
0023	3T	04_1	143	5	0	500	0	-500	0.00	0.00	0	0	0
0023	3T	04_1	145	2	0	200	0	-200	0.00	0.00	0	0	0
0023	3T	04_1	146	3	0	300	0	-300	0.00	0.00	0	0	0
0023	3T	04_1	234	1	0	100	0	-100	0.00	0.00	0	0	0
0023	3T	04_1	253	1	1	100	1720	1620	1.00	17.20	0	3	3
0023	3T	04_10	123	17	1	1700	1120	-580	0.06	0.66	3	1	-2
0023	3T	04_10	124	57	3	5700	5590	-110	0.05	0.98	10	9	-1
0016	1T	1	1	11149	6399	1114900	1037450	-77450	0.57	0.93	1973	1836	-137
0016	1T	1	2	1696	666	169600	155340	-14260	0.39	0.92	300	274	-26
0016	1T	2	1	10676	5942	1067600	964450	-103150	0.56	0.90	1889	1706	-183
0016	1T	2	2	1748	708	174800	166330	-8470	0.41	0.95	309	294	-15
0016	1T	3	1	10798	6233	1079800	1009740	-70060	0.58	0.94	1911	1787	-124
0016	1T	3	2	1798	662	179800	165680	-14120	0.37	0.92	318	293	-25
0016	1T	4	1	8757	5349	875700	812470	-63230	0.61	0.93	1549	1438	-111
0016	1T	4	2	1485	573	148500	135830	-12670	0.39	0.91	262	240	-22
0016	1T	5	1	7744	4912	774400	708160	-66240	0.63	0.91	1370	1253	-117
0016	1T	5	2	449	139	44900	36000	-8900	0.31	0.80	79	63	-16
0016	1T	6	1	619	372	61900	52930	-8970	0.60	0.86	109	93	-16
0016	1T	6	2	35	15	3500	3560	60	0.43	1.02	6	6	0
0016	1T	7	1	12618	7878	1261800	1164480	-97320	0.62	0.92	2233	2061	-172
0016	1T	7	2	860	284	86000	75510	-10490	0.33	0.88	152	133	-19
0016	2F	1	12	5547	1717	554700	468710	-85990	0.31	0.84	981	829	-152
0016	2F	1	13	3394	1028	339400	276200	-63200	0.30	0.81	600	488	-112
0016	2F	1	14	1317	356	131700	98600	-33100	0.27	0.75	233	174	-59
0016	2F	1	15	131	35	13100	10350	-2750	0.27	0.79	23	18	-5
0016	2F	1	16	245	50	24500	18900	-5600	0.20	0.77	43	33	-10
0016	2F	1	23	142	30	14200	11690	-2510	0.21	0.82	25	20	-5
0016	2F	1	24	70	18	7000	9690	2690	0.26	1.38	12	17	5
0016	2F	1	25	2	0	200	0	-200	0.00	0.00	0	0	0
0016	2F	1	26	26	2	2600	900	-1700	0.08	0.35	4	1	-3
0016	2F	2	12	4469	1524	446900	377840	-69060	0.34	0.85	790	668	-122
0016	2F	2	13	3346	1058	334600	280470	-54130	0.32	0.84	592	496	-96
0016	2F	2	14	1570	490	157000	124550	-32450	0.31	0.79	277	220	-57
0016	2F	2	15	384	97	38400	30220	-8180	0.25	0.79	67	53	-14
0016	2F	2	16	401	82	40100	38040	-2060	0.20	0.95	70	67	-3
0016	2F	2	23	75	17	7500	7100	-400	0.23	0.95	13	12	-1
0016	2F	2	24	102	26	10200	10570	370	0.25	1.04	18	18	0
0016	2F	2	25	39	8	3900	2510	-1390	0.21	0.64	6	4	-2
0016	2F	2	26	98	14	9800	5660	-4140	0.14	0.58	17	10	-7
0016	2F	3	12	4832	1679	483200	417450	-65750	0.35	0.86	855	738	-117
0016	2F	3	13	3041	960	304100	240160	-63940	0.32	0.79	538	425	-113
0016	2F	3	14	1725	463	172500	125790	-46710	0.27	0.73	305	222	-83
0016	2F	3	15	530	121	53000	41480	-11520	0.23	0.78	93	73	-20
0016	2F	3	16	337	66	33700	32410	-1290	0.20	0.96	59	57	-2
0016	2F	3	23	107	25	10700	8740	-1960	0.23	0.82	18	15	-3
0016	2F	3	24	90	24	9000	9450	450	0.27	1.05	15	16	1
0016	2F	3	25	94	11	9400	4650	-4750	0.12	0.49	16	8	-8
0016	2F	3	26	97	18	9700	6890	-2810	0.19	0.71	17	12	-5
0016	2F	4	12	4236	1512	423600	361500	-62100	0.36	0.85	749	639	-110
0016	2F	4	13	2425	817	242500	199480	-43020	0.34	0.82	429	353	-76
0016	2F	4	14	1297	401	129700	106450	-23250	0.31	0.82	229	188	-41
0016	2F	4	15	398	101	39800	37150	-2650	0.25	0.93	70	65	-5
0016	2F	4	16	167	30	16700	12310	-4390	0.18	0.74	29	21	-8
0016	2F	4	23	135	32	13500	9150	-4350	0.24	0.68	23	16	-7
0016	2F	4	24	117	28	11700	9630	-2070	0.24	0.82	20	17	-3
0016	2F	4	25	92	19	9200	11160	1960	0.21	1.21	16	19	3
0016	2F	4	26	60	13	6000	5520	-480	0.22	0.92	10	9	-1
0016	2F	5	12	3993	1465	399300	327070	-72230	0.37	0.82	706	578	-128
0016	2F	5	13	1812	561	181200	138770	-42430	0.31	0.77	320	245	-75
0016	2F	5	14	1115	341	111500	85820	-25680	0.31	0.77	197	151	-46
0016	2F	5	15	288	63	28800	22340	-6460	0.22	0.78	50	39	-11
0016	2F	5	16	222	44	22200	15520	-6680	0.20	0.70	39	27	-12
0016	2F	5	23	36	3	3600	1060	-2540	0.08	0.29	6	1	-5
0016	2F	5	24	26	2	2600	410	-2190	0.08	0.16	4	0	-4
0016	2F	5	25	19	4	1900	1870	-30	0.21	0.98	3	3	0
0016	2F	5	26	19	1	1900	860	-1040	0.05	0.45	3	1	-2
0016	2F	6	12	307	114	30700	24980	-5720	0.37	0.81	54	44	-10
0016	2F	6	13	152	49	15200	11480	-3720	0.32	0.76	26	20	-6
0016	2F	6	14	89	22	8900	6240	-2660	0.25	0.70	15	11	-4
0016	2F	6	15	24	6	2400	2570	170	0.25	1.07	4	4	0
0016	2F	6	16	22	5	2200	2140	-60	0.23	0.97	3	3	0
0016	2F	6	23	4	0	400	0	-400	0.00	0.00	0	0	0
0016	2F	6	24	3	0	300	0	-300	0.00	0.00	0	0	0
0016	2F	6	25	3	0	300	0	-300	0.00	0.00	0	0	0
0016	2F	6	26	2	0	200	0	-200	0.00	0.00	0	0	0
0016	2F	7	12	7000	2428	700000	595430	-104570	0.35	0.85	1238	1053	-185
0016	2F	7	13	2963	883	296300	233910	-62390	0.30	0.79	524	414	-110
0016	2F	7	14	1481	402	148100	108340	-39760	0.27	0.73	262	191	-71
0016	2F	7	15	402	83	40200	34400	-5800	0.21	0.86	71	60	-11
0016	2F	7	16	335	66	33500	29730	-3770	0.20	0.89	59	52	-7
0016	2F	7	23	53	13	5300	5310	10	0.25	1.00	9	9	0
0016	2F	7	24	29	6	2900	2400	-500	0.21	0.83	5	4	-1
0016	2F	7	25	37	2	3700	570	-3130	0.05	0.15	6	1	-5
0016	2F	7	26	38	5	3800	5140	1340	0.13	1.35	6	9	3
0016	2T	1	12	5481	1261	548100	443570	-104530	0.23	0.81	970	785	-185
0016	2T	1	13	3394	704	339400	250660	-88740	0.21	0.74	600	443	-157
0016	2T	1	14	1317	263	131700	100600	-31100	0.20	0.76	233	178	-55
0016	2T	1	15	131	22	13100	9880	-3220	0.17	0.75	23	17	-6
0016	2T	1	16	245	31	24500	18250	-6250	0.13	0.74	43	32	-11
0016	2T	1	21	66	7	6600	5590	-1010	0.11	0.85	11	9	-2
0016	2T	1	23	142	19	14200	11380	-2820	0.13	0.80	25	20	-5
0016	2T	1	24	70	9	7000	11470	4470	0.13	1.64	12	20	8
0016	2T	1	25	2	0	200	0	-200	0.00	0.00	0	0	0
0016	2T	1	26	26	0	2600	0	-2600	0.00	0.00	4	0	-4
0016	2T	2	12	4435	1082	443500	350530	-92970	0.24	0.79	784	620	-164
0016	2T	2	13	3346	781	334600	283750	-50850	0.23	0.85	592	502	-90
0016	2T	2	14	1570	344	157000	123350	-33650	0.22	0.79	277	218	-59
0016	2T	2	15	384	65	38400	28700	-9700	0.17	0.75	67	50	-17
0016	2T	2	16	401	61	40100	37860	-2240	0.15	0.94	70	67	-3
0016	2T	2	21	34	3	3400	3680	280	0.09	1.08	6	6	0
0016	2T	2	23	75	9	7500	7980	480	0.12	1.06	13	14	1
0016	2T	2	24	102	17	10200	10790	590	0.17	1.06	18	19	1
0016	2T	2	25	39	6	3900	3970	70	0.15	1.02	6	7	1
0016	2T	2	26	98	6	9800	3230	-6570	0.06	0.33	17	5	-12
0016	2T	3	12	4782	1264	478200	413120	-65080	0.26	0.86	846	731	-115
0016	2T	3	13	3041	688	304100	236350	-67750	0.23	0.78	538	418	-120
0016	2T	3	14	1725	335	172500	131300	-41200	0.19	0.76	305	232	-73
0016	2T	3	15	530	89	53000	44640	-8360	0.17	0.84	93	79	-14
0016	2T	3	16	337	44	33700	35070	1370	0.13	1.04	59	62	3
0016	2T	3	21	50	4	5000	3620	-1380	0.08	0.72	8	6	-2
0016	2T	3	23	107	15	10700	10920	220	0.14	1.02	18	19	1
0016	2T	3	24	90	13	9000	8540	-460	0.14	0.95	15	15	0
0016	2T	3	25	94	7	9400	6500	-2900	0.07	0.69	16	11	-5
0016	2T	3	26	97	13	9700	12530	2830	0.13	1.29	17	22	5
0016	2T	4	12	4194	1144	419400	339950	-79450	0.27	0.81	742	601	-141
0016	2T	4	13	2425	617	242500	199890	-42610	0.25	0.82	429	353	-76
0016	2T	4	14	1297	300	129700	107330	-22370	0.23	0.83	229	189	-40
0016	2T	4	15	398	75	39800	42220	2420	0.19	1.06	70	74	4
0016	2T	4	16	167	20	16700	13220	-3480	0.12	0.79	29	23	-6
0016	2T	4	21	42	7	4200	4990	790	0.17	1.19	7	8	1
0016	2T	4	23	135	20	13500	8560	-4940	0.15	0.63	23	15	-8
0016	2T	4	24	117	17	11700	9390	-2310	0.15	0.80	20	16	-4
0016	2T	4	25	92	11	9200	13280	4080	0.12	1.44	16	23	7
0016	2T	4	26	60	9	6000	5220	-780	0.15	0.87	10	9	-1
0016	2T	5	12	3978	1145	397800	314020	-83780	0.29	0.79	704	555	-149
0016	2T	5	13	1812	403	181200	129130	-52070	0.22	0.71	320	228	-92
0016	2T	5	14	1115	248	111500	88310	-23190	0.22	0.79	197	156	-41
0016	2T	5	15	288	43	28800	19860	-8940	0.15	0.69	50	35	-15
0016	2T	5	16	222	36	22200	18330	-3870	0.16	0.83	39	32	-7
0016	2T	5	21	15	1	1500	2060	560	0.07	1.37	2	3	1
0016	2T	5	23	36	0	3600	0	-3600	0.00	0.00	6	0	-6
0016	2T	5	24	26	0	2600	0	-2600	0.00	0.00	4	0	-4
0016	2T	5	25	19	2	1900	1480	-420	0.11	0.78	3	2	-1
0016	2T	5	26	19	0	1900	0	-1900	0.00	0.00	3	0	-3
0016	2T	6	12	305	87	30500	22910	-7590	0.29	0.75	53	40	-13
0016	2T	6	13	152	37	15200	10950	-4250	0.24	0.72	26	19	-7
0016	2T	6	14	89	16	8900	5560	-3340	0.18	0.62	15	9	-6
0016	2T	6	15	24	1	2400	1220	-1180	0.04	0.51	4	2	-2
0016	2T	6	16	22	4	2200	2530	330	0.18	1.15	3	4	1
0016	2T	6	21	2	0	200	0	-200	0.00	0.00	0	0	0
0016	2T	6	23	4	0	400	0	-400	0.00	0.00	0	0	0
0016	2T	6	24	3	0	300	0	-300	0.00	0.00	0	0	0
0016	2T	6	25	3	0	300	0	-300	0.00	0.00	0	0	0
0016	2T	6	26	2	0	200	0	-200	0.00	0.00	0	0	0
0016	2T	7	12	6993	1906	699300	578420	-120880	0.27	0.83	1237	1023	-214
0016	2T	7	13	2963	664	296300	220980	-75320	0.22	0.75	524	391	-133
0016	2T	7	14	1481	308	148100	114290	-33810	0.21	0.77	262	202	-60
0016	2T	7	15	402	69	40200	37510	-2690	0.17	0.93	71	66	-5
0016	2T	7	16	335	49	33500	31580	-1920	0.15	0.94	59	55	-4
0016	2T	7	21	7	0	700	0	-700	0.00	0.00	1	0	-1
0016	2T	7	23	53	6	5300	4810	-490	0.11	0.91	9	8	-1
0016	2T	7	24	29	2	2900	1990	-910	0.07	0.69	5	3	-2
0016	2T	7	25	37	2	3700	1430	-2270	0.05	0.39	6	2	-4
0016	2T	7	26	38	1	3800	660	-3140	0.03	0.17	6	1	-5
0016	3F	1	123	328	92	32800	27240	-5560	0.28	0.83	58	48	-10
0016	3F	1	124	1624	376	162400	128460	-33940	0.23	0.79	287	227	-60
0016	3F	1	125	955	160	95500	74230	-21270	0.17	0.78	169	131	-38
0016	3F	1	126	2482	235	248200	218960	-29240	0.09	0.88	439	387	-52
0016	3F	1	134	1074	253	107400	86130	-21270	0.24	0.80	190	152	-38
0016	3F	1	135	736	138	73600	58210	-15390	0.19	0.79	130	103	-27
0016	3F	1	136	1206	117	120600	81570	-39030	0.10	0.68	213	144	-69
0016	3F	1	145	206	37	20600	15980	-4620	0.18	0.78	36	28	-8
0016	3F	1	146	309	45	30900	27840	-3060	0.15	0.90	54	49	-5
0016	3F	1	156	23	7	2300	3050	750	0.30	1.33	4	5	1
0016	3F	1	234	36	8	3600	3720	120	0.22	1.03	6	6	0
0016	3F	1	235	36	9	3600	3920	320	0.25	1.09	6	6	0
0016	3F	1	236	52	5	5200	1920	-3280	0.10	0.37	9	3	-6
0016	3F	1	245	20	1	2000	1890	-110	0.05	0.95	3	3	0
0016	3F	1	246	10	1	1000	880	-120	0.10	0.88	1	1	0
0016	3F	1	256	1	0	100	0	-100	0.00	0.00	0	0	0
0016	3F	2	123	316	89	31600	24270	-7330	0.28	0.77	55	42	-13
0016	3F	2	124	1211	294	121100	98560	-22540	0.24	0.81	214	174	-40
0016	3F	2	125	1005	204	100500	82210	-18290	0.20	0.82	177	145	-32
0016	3F	2	126	1692	229	169200	134560	-34640	0.14	0.80	299	238	-61
0016	3F	2	134	868	182	86800	63560	-23240	0.21	0.73	153	112	-41
0016	3F	2	135	748	147	74800	52400	-22400	0.20	0.70	132	92	-40
0016	3F	2	136	1281	169	128100	98070	-30030	0.13	0.77	226	173	-53
0016	3F	2	145	287	57	28700	24250	-4450	0.20	0.84	50	42	-8
0016	3F	2	146	416	60	41600	31990	-9610	0.14	0.77	73	56	-17
0016	3F	2	156	100	18	10000	9520	-480	0.18	0.95	17	16	-1
0016	3F	2	234	21	2	2100	950	-1150	0.10	0.45	3	1	-2
0016	3F	2	235	9	1	900	270	-630	0.11	0.30	1	0	-1
0016	3F	2	236	28	2	2800	780	-2020	0.07	0.28	4	1	-3
0016	3F	2	245	26	4	2600	1670	-930	0.15	0.64	4	2	-2
0016	3F	2	246	27	4	2700	1630	-1070	0.15	0.60	4	2	-2
0016	3F	2	256	12	0	1200	0	-1200	0.00	0.00	2	0	-2
0016	3F	3	123	508	151	50800	39750	-11050	0.30	0.78	89	70	-19
0016	3F	3	124	1602	352	160200	113230	-46970	0.22	0.71	283	200	-83
0016	3F	3	125	1201	214	120100	84050	-36050	0.18	0.70	212	148	-64
0016	3F	3	126	1322	205	132200	124230	-7970	0.16	0.94	233	219	-14
0016	3F	3	134	874	189	87400	65470	-21930	0.22	0.75	154	115	-39
0016	3F	3	135	827	155	82700	61400	-21300	0.19	0.74	146	108	-38
0016	3F	3	136	845	118	84500	65210	-19290	0.14	0.77	149	115	-34
0016	3F	3	145	435	70	43500	28250	-15250	0.16	0.65	76	50	-26
0016	3F	3	146	279	35	27900	19720	-8180	0.13	0.71	49	34	-15
0016	3F	3	156	103	16	10300	11330	1030	0.16	1.10	18	20	2
0016	3F	3	234	24	7	2400	2760	360	0.29	1.15	4	4	0
0016	3F	3	235	36	7	3600	3140	-460	0.19	0.87	6	5	-1
0016	3F	3	236	28	6	2800	3480	680	0.21	1.24	4	6	2
0016	3F	3	245	23	5	2300	2170	-130	0.22	0.94	4	3	-1
0016	3F	3	246	23	3	2300	2000	-300	0.13	0.87	4	3	-1
0016	3F	3	256	10	1	1000	260	-740	0.10	0.26	1	0	-1
0016	3F	4	123	739	238	73900	67130	-6770	0.32	0.91	130	118	-12
0016	3F	4	124	1715	364	171500	117810	-53690	0.21	0.69	303	208	-95
0016	3F	4	125	810	167	81000	73170	-7830	0.21	0.90	143	129	-14
0016	3F	4	126	772	92	77200	54590	-22610	0.12	0.71	136	96	-40
0016	3F	4	134	869	203	86900	69150	-17750	0.23	0.80	153	122	-31
0016	3F	4	135	578	127	57800	48850	-8950	0.22	0.85	102	86	-16
0016	3F	4	136	485	68	48500	33270	-15230	0.14	0.69	85	58	-27
0016	3F	4	145	231	47	23100	20290	-2810	0.20	0.88	40	35	-5
0016	3F	4	146	169	19	16900	13150	-3750	0.11	0.78	29	23	-6
0016	3F	4	156	75	9	7500	5690	-1810	0.12	0.76	13	10	-3
0016	3F	4	234	29	6	2900	2220	-680	0.21	0.77	5	3	-2
0016	3F	4	235	48	5	4800	1650	-3150	0.10	0.34	8	2	-6
0016	3F	4	236	34	3	3400	1090	-2310	0.09	0.32	6	1	-5
0016	3F	4	245	41	5	4100	1960	-2140	0.12	0.48	7	3	-4
0016	3F	4	246	27	1	2700	380	-2320	0.04	0.14	4	0	-4
0016	3F	4	256	19	3	1900	1280	-620	0.16	0.67	3	2	-1
0016	3F	5	123	882	253	88200	63830	-24370	0.29	0.72	156	112	-44
0016	3F	5	124	1830	395	183000	128440	-54560	0.22	0.70	323	227	-96
0016	3F	5	125	676	124	67600	52890	-14710	0.18	0.78	119	93	-26
0016	3F	5	126	446	83	44600	43540	-1060	0.19	0.98	78	77	-1
0016	3F	5	134	651	143	65100	47080	-18020	0.22	0.72	115	83	-32
0016	3F	5	135	409	71	40900	31860	-9040	0.17	0.78	72	56	-16
0016	3F	5	136	253	46	25300	26830	1530	0.18	1.06	44	47	3
0016	3F	5	145	202	45	20200	18480	-1720	0.22	0.91	35	32	-3
0016	3F	5	146	106	29	10600	13300	2700	0.27	1.25	18	23	5
0016	3F	5	156	37	5	3700	3020	-680	0.14	0.82	6	5	-1
0016	3F	5	234	9	2	900	1000	100	0.22	1.11	1	1	0
0016	3F	5	235	11	2	1100	610	-490	0.18	0.55	1	1	0
0016	3F	5	236	9	0	900	0	-900	0.00	0.00	1	0	-1
0016	3F	5	245	4	0	400	0	-400	0.00	0.00	0	0	0
0016	3F	5	246	6	0	600	0	-600	0.00	0.00	1	0	-1
0016	3F	5	256	3	0	300	0	-300	0.00	0.00	0	0	0
0016	3F	6	123	64	15	6400	4910	-1490	0.23	0.77	11	8	-3
0016	3F	6	124	133	27	13300	8470	-4830	0.20	0.64	23	14	-9
0016	3F	6	125	53	9	5300	4330	-970	0.17	0.82	9	7	-2
0016	3F	6	126	50	10	5000	3610	-1390	0.20	0.72	8	6	-2
0016	3F	6	134	51	12	5100	3440	-1660	0.24	0.67	9	6	-3
0016	3F	6	135	44	8	4400	3170	-1230	0.18	0.72	7	5	-2
0016	3F	6	136	23	1	2300	670	-1630	0.04	0.29	4	1	-3
0016	3F	6	145	16	2	1600	1320	-280	0.13	0.83	2	2	0
0016	3F	6	146	10	5	1000	4880	3880	0.50	4.88	1	8	7
0016	3F	6	156	5	1	500	250	-250	0.20	0.50	0	0	0
0016	3F	6	235	1	0	100	0	-100	0.00	0.00	0	0	0
0016	3F	6	236	1	0	100	0	-100	0.00	0.00	0	0	0
0016	3F	7	123	1552	455	155200	131080	-24120	0.29	0.84	274	232	-42
0016	3F	7	124	3047	637	304700	223860	-80840	0.21	0.73	539	396	-143
0016	3F	7	125	1182	223	118200	92830	-25370	0.19	0.79	209	164	-45
0016	3F	7	126	850	127	85000	72950	-12050	0.15	0.86	150	129	-21
0016	3F	7	134	927	201	92700	71520	-21180	0.22	0.77	164	126	-38
0016	3F	7	135	661	84	66100	34520	-31580	0.13	0.52	116	61	-55
0016	3F	7	136	464	56	46400	27820	-18580	0.12	0.60	82	49	-33
0016	3F	7	145	222	38	22200	17140	-5060	0.17	0.77	39	30	-9
0016	3F	7	146	163	26	16300	17040	740	0.16	1.05	28	30	2
0016	3F	7	156	58	7	5800	3230	-2570	0.12	0.56	10	5	-5
0016	3F	7	234	14	3	1400	1570	170	0.21	1.12	2	2	0
0016	3F	7	235	13	3	1300	1270	-30	0.23	0.98	2	2	0
0016	3F	7	236	6	1	600	410	-190	0.17	0.68	1	0	-1
0016	3F	7	245	3	1	300	440	140	0.33	1.47	0	0	0
0016	3F	7	246	2	0	200	0	-200	0.00	0.00	0	0	0
0016	3F	7	256	3	0	300	0	-300	0.00	0.00	0	0	0
0016	3T	1	123	258	30	25800	15730	-10070	0.12	0.61	45	27	-18
0016	3T	1	124	1611	162	161100	127640	-33460	0.10	0.79	285	225	-60
0016	3T	1	125	938	65	93800	79670	-14130	0.07	0.85	166	141	-25
0016	3T	1	126	2441	104	244100	217980	-26120	0.04	0.89	432	385	-47
0016	3T	1	132	69	7	6900	6030	-870	0.10	0.87	12	10	-2
0016	3T	1	134	1074	100	107400	81590	-25810	0.09	0.76	190	144	-46
0016	3T	1	135	735	54	73500	57550	-15950	0.07	0.78	130	101	-29
0016	3T	1	136	1192	48	119200	66310	-52890	0.04	0.56	210	117	-93
0016	3T	1	145	200	15	20000	22010	2010	0.08	1.10	35	38	3
0016	3T	1	146	298	16	29800	24260	-5540	0.05	0.81	52	42	-10
0016	3T	1	152	6	0	600	0	-600	0.00	0.00	1	0	-1
0016	3T	1	153	1	0	100	0	-100	0.00	0.00	0	0	0
0016	3T	1	154	6	1	600	1490	890	0.17	2.48	1	2	1
0016	3T	1	156	20	2	2000	2070	70	0.10	1.04	3	3	0
0016	3T	1	163	14	0	1400	0	-1400	0.00	0.00	2	0	-2
0016	3T	1	164	11	1	1100	1260	160	0.09	1.15	1	2	1
0016	3T	1	165	3	0	300	0	-300	0.00	0.00	0	0	0
0016	3T	1	213	1	0	100	0	-100	0.00	0.00	0	0	0
0016	3T	1	214	13	1	1300	940	-360	0.08	0.72	2	1	-1
0016	3T	1	215	11	0	1100	0	-1100	0.00	0.00	1	0	-1
0016	3T	1	216	41	1	4100	4290	190	0.02	1.05	7	7	0
0016	3T	1	234	36	1	3600	1520	-2080	0.03	0.42	6	2	-4
0016	3T	1	235	36	4	3600	5580	1980	0.11	1.55	6	9	3
0016	3T	1	236	52	4	5200	5310	110	0.08	1.02	9	9	0
0016	3T	1	245	20	1	2000	5110	3110	0.05	2.56	3	9	6
0016	3T	1	246	10	1	1000	3910	2910	0.10	3.91	1	6	5
0016	3T	1	256	1	0	100	0	-100	0.00	0.00	0	0	0
0016	3T	2	123	278	37	27800	25700	-2100	0.13	0.92	49	45	-4
0016	3T	2	124	1208	118	120800	98470	-22330	0.10	0.82	213	174	-39
0016	3T	2	125	996	79	99600	79560	-20040	0.08	0.80	176	140	-36
0016	3T	2	126	1671	93	167100	136650	-30450	0.06	0.82	295	241	-54
0016	3T	2	132	34	2	3400	2050	-1350	0.06	0.60	6	3	-3
0016	3T	2	134	868	87	86800	74560	-12240	0.10	0.86	153	131	-22
0016	3T	2	135	740	62	74000	59800	-14200	0.08	0.81	130	105	-25
0016	3T	2	136	1279	78	127900	115800	-12100	0.06	0.91	226	204	-22
0016	3T	2	142	1	0	100	0	-100	0.00	0.00	0	0	0
0016	3T	2	145	282	14	28200	13560	-14640	0.05	0.48	49	24	-25
0016	3T	2	146	407	29	40700	33850	-6850	0.07	0.83	72	59	-13
0016	3T	2	152	4	1	400	1160	760	0.25	2.90	0	2	2
0016	3T	2	153	8	0	800	0	-800	0.00	0.00	1	0	-1
0016	3T	2	154	5	0	500	0	-500	0.00	0.00	0	0	0
0016	3T	2	156	100	6	10000	8640	-1360	0.06	0.86	17	15	-2
0016	3T	2	163	2	0	200	0	-200	0.00	0.00	0	0	0
0016	3T	2	164	9	1	900	860	-40	0.11	0.96	1	1	0
0016	3T	2	213	4	0	400	0	-400	0.00	0.00	0	0	0
0016	3T	2	214	2	0	200	0	-200	0.00	0.00	0	0	0
0016	3T	2	215	5	0	500	0	-500	0.00	0.00	0	0	0
0016	3T	2	216	21	1	2100	4180	2080	0.05	1.99	3	7	4
0016	3T	2	234	21	2	2100	2880	780	0.10	1.37	3	5	2
0016	3T	2	235	9	0	900	0	-900	0.00	0.00	1	0	-1
0016	3T	2	236	27	0	2700	0	-2700	0.00	0.00	4	0	-4
0016	3T	2	245	26	1	2600	2140	-460	0.04	0.82	4	3	-1
0016	3T	2	246	26	0	2600	0	-2600	0.00	0.00	4	0	-4
0016	3T	2	256	12	0	1200	0	-1200	0.00	0.00	2	0	-2
0016	3T	2	263	1	0	100	0	-100	0.00	0.00	0	0	0
0016	3T	2	264	1	0	100	0	-100	0.00	0.00	0	0	0
0016	3T	3	123	495	69	49500	44140	-5360	0.14	0.89	87	78	-9
0016	3T	3	124	1597	138	159700	93080	-66620	0.09	0.58	282	164	-118
0016	3T	3	125	1189	101	118900	96800	-22100	0.08	0.81	210	171	-39
0016	3T	3	126	1288	106	128800	146940	18140	0.08	1.14	227	260	33
0016	3T	3	132	11	0	1100	0	-1100	0.00	0.00	1	0	-1
0016	3T	3	134	868	82	86800	71440	-15360	0.09	0.82	153	126	-27
0016	3T	3	135	822	62	82200	59860	-22340	0.08	0.73	145	105	-40
0016	3T	3	136	842	47	84200	72270	-11930	0.06	0.86	149	127	-22
0016	3T	3	143	6	0	600	0	-600	0.00	0.00	1	0	-1
0016	3T	3	145	415	18	41500	14360	-27140	0.04	0.35	73	25	-48
0016	3T	3	146	273	11	27300	20290	-7010	0.04	0.74	48	35	-13
0016	3T	3	152	2	0	200	0	-200	0.00	0.00	0	0	0
0016	3T	3	153	5	0	500	0	-500	0.00	0.00	0	0	0
0016	3T	3	154	20	1	2000	980	-1020	0.05	0.49	3	1	-2
0016	3T	3	156	102	5	10200	12440	2240	0.05	1.22	18	22	4
0016	3T	3	162	1	0	100	0	-100	0.00	0.00	0	0	0
0016	3T	3	163	3	0	300	0	-300	0.00	0.00	0	0	0
0016	3T	3	164	6	1	600	1080	480	0.17	1.80	1	1	0
0016	3T	3	165	1	0	100	0	-100	0.00	0.00	0	0	0
0016	3T	3	213	2	0	200	0	-200	0.00	0.00	0	0	0
0016	3T	3	214	5	0	500	0	-500	0.00	0.00	0	0	0
0016	3T	3	215	10	0	1000	0	-1000	0.00	0.00	1	0	-1
0016	3T	3	216	33	0	3300	0	-3300	0.00	0.00	5	0	-5
0016	3T	3	234	24	3	2400	5200	2800	0.13	2.17	4	9	5
0016	3T	3	235	36	2	3600	3390	-210	0.06	0.94	6	6	0
0016	3T	3	236	27	0	2700	0	-2700	0.00	0.00	4	0	-4
0016	3T	3	245	23	1	2300	860	-1440	0.04	0.37	4	1	-3
0016	3T	3	246	23	2	2300	3080	780	0.09	1.34	4	5	1
0016	3T	3	256	10	0	1000	0	-1000	0.00	0.00	1	0	-1
0016	3T	3	263	1	0	100	0	-100	0.00	0.00	0	0	0
0016	3T	4	123	735	106	73500	61590	-11910	0.14	0.84	130	109	-21
0016	3T	4	124	1698	170	169800	138600	-31200	0.10	0.82	300	245	-55
0016	3T	4	125	799	64	79900	65890	-14010	0.08	0.82	141	116	-25
0016	3T	4	126	759	42	75900	59070	-16830	0.06	0.78	134	104	-30
0016	3T	4	132	3	0	300	0	-300	0.00	0.00	0	0	0
0016	3T	4	134	863	96	86300	79290	-7010	0.11	0.92	152	140	-12
0016	3T	4	135	576	61	57600	53140	-4460	0.11	0.92	101	94	-7
0016	3T	4	136	484	37	48400	34260	-14140	0.08	0.71	85	60	-25
0016	3T	4	143	6	0	600	0	-600	0.00	0.00	1	0	-1
0016	3T	4	145	223	21	22300	27000	4700	0.09	1.21	39	47	8
0016	3T	4	146	167	8	16700	9340	-7360	0.05	0.56	29	16	-13
0016	3T	4	153	2	0	200	0	-200	0.00	0.00	0	0	0
0016	3T	4	154	8	1	800	1560	760	0.13	1.95	1	2	1
0016	3T	4	156	75	2	7500	3400	-4100	0.03	0.45	13	6	-7
0016	3T	4	163	1	0	100	0	-100	0.00	0.00	0	0	0
0016	3T	4	164	2	0	200	0	-200	0.00	0.00	0	0	0
0016	3T	4	213	1	0	100	0	-100	0.00	0.00	0	0	0
0016	3T	4	214	17	2	1700	2140	440	0.12	1.26	3	3	0
0016	3T	4	215	11	1	1100	1530	430	0.09	1.39	1	2	1
0016	3T	4	216	13	0	1300	0	-1300	0.00	0.00	2	0	-2
0016	3T	4	234	29	1	2900	940	-1960	0.03	0.32	5	1	-4
0016	3T	4	235	48	1	4800	780	-4020	0.02	0.16	8	1	-7
0016	3T	4	236	34	3	3400	3060	-340	0.09	0.90	6	5	-1
0016	3T	4	245	40	0	4000	0	-4000	0.00	0.00	7	0	-7
0016	3T	4	246	27	1	2700	1100	-1600	0.04	0.41	4	1	-3
0016	3T	4	254	1	0	100	0	-100	0.00	0.00	0	0	0
0016	3T	4	256	19	1	1900	1140	-760	0.05	0.60	3	2	-1
0016	3T	5	123	875	116	87500	63030	-24470	0.13	0.72	154	111	-43
0016	3T	5	124	1825	195	182500	132990	-49510	0.11	0.73	323	235	-88
0016	3T	5	125	671	58	67100	55710	-11390	0.09	0.83	118	98	-20
0016	3T	5	126	442	34	44200	49230	5030	0.08	1.11	78	87	9
0016	3T	5	132	6	0	600	0	-600	0.00	0.00	1	0	-1
0016	3T	5	134	640	44	64000	34100	-29900	0.07	0.53	113	60	-53
0016	3T	5	135	407	27	40700	25280	-15420	0.07	0.62	72	44	-28
0016	3T	5	136	253	22	25300	24130	-1170	0.09	0.95	44	42	-2
0016	3T	5	142	1	0	100	0	-100	0.00	0.00	0	0	0
0016	3T	5	143	11	0	1100	0	-1100	0.00	0.00	1	0	-1
0016	3T	5	145	192	14	19200	15950	-3250	0.07	0.83	33	28	-5
0016	3T	5	146	106	9	10600	10830	230	0.08	1.02	18	19	1
0016	3T	5	152	1	0	100	0	-100	0.00	0.00	0	0	0
0016	3T	5	153	2	0	200	0	-200	0.00	0.00	0	0	0
0016	3T	5	154	10	1	1000	990	-10	0.10	0.99	1	1	0
0016	3T	5	156	37	3	3700	3570	-130	0.08	0.96	6	6	0
0016	3T	5	213	1	0	100	0	-100	0.00	0.00	0	0	0
0016	3T	5	214	4	0	400	0	-400	0.00	0.00	0	0	0
0016	3T	5	215	4	0	400	0	-400	0.00	0.00	0	0	0
0016	3T	5	216	4	0	400	0	-400	0.00	0.00	0	0	0
0016	3T	5	234	9	0	900	0	-900	0.00	0.00	1	0	-1
0016	3T	5	235	10	0	1000	0	-1000	0.00	0.00	1	0	-1
0016	3T	5	236	9	0	900	0	-900	0.00	0.00	1	0	-1
0016	3T	5	245	4	0	400	0	-400	0.00	0.00	0	0	0
0016	3T	5	246	6	0	600	0	-600	0.00	0.00	1	0	-1
0016	3T	5	253	1	1	100	1720	1620	1.00	17.20	0	3	3
0016	3T	5	256	2	0	200	0	-200	0.00	0.00	0	0	0
0016	3T	5	265	1	0	100	0	-100	0.00	0.00	0	0	0
0016	3T	6	123	62	8	6200	4850	-1350	0.13	0.78	10	8	-2
0016	3T	6	124	133	12	13300	7580	-5720	0.09	0.57	23	13	-10
0016	3T	6	125	52	5	5200	4700	-500	0.10	0.90	9	8	-1
0016	3T	6	126	49	4	4900	4440	-460	0.08	0.91	8	7	-1
0016	3T	6	132	2	0	200	0	-200	0.00	0.00	0	0	0
0016	3T	6	134	49	5	4900	3120	-1780	0.10	0.64	8	5	-3
0016	3T	6	135	44	4	4400	2820	-1580	0.09	0.64	7	4	-3
0016	3T	6	136	23	0	2300	0	-2300	0.00	0.00	4	0	-4
0016	3T	6	143	2	0	200	0	-200	0.00	0.00	0	0	0
0016	3T	6	145	16	1	1600	820	-780	0.06	0.51	2	1	-1
0016	3T	6	146	10	2	1000	2390	1390	0.20	2.39	1	4	3
0016	3T	6	156	5	0	500	0	-500	0.00	0.00	0	0	0
0016	3T	6	215	1	0	100	0	-100	0.00	0.00	0	0	0
0016	3T	6	216	1	0	100	0	-100	0.00	0.00	0	0	0
0016	3T	6	235	1	0	100	0	-100	0.00	0.00	0	0	0
0016	3T	6	236	1	0	100	0	-100	0.00	0.00	0	0	0
0016	3T	7	123	1528	222	152800	139820	-12980	0.15	0.92	270	247	-23
0016	3T	7	124	3041	276	304100	215360	-88740	0.09	0.71	538	381	-157
0016	3T	7	125	1179	99	117900	87440	-30460	0.08	0.74	208	154	-54
0016	3T	7	126	847	53	84700	70970	-13730	0.06	0.84	149	125	-24
0016	3T	7	132	22	0	2200	0	-2200	0.00	0.00	3	0	-3
0016	3T	7	134	906	91	90600	77940	-12660	0.10	0.86	160	137	-23
0016	3T	7	135	653	42	65300	39880	-25420	0.06	0.61	115	70	-45
0016	3T	7	136	464	28	46400	33390	-13010	0.06	0.72	82	59	-23
0016	3T	7	142	5	0	500	0	-500	0.00	0.00	0	0	0
0016	3T	7	143	21	4	2100	4570	2470	0.19	2.18	3	8	5
0016	3T	7	145	218	14	21800	18310	-3490	0.06	0.84	38	32	-6
0016	3T	7	146	163	13	16300	16480	180	0.08	1.01	28	29	1
0016	3T	7	152	2	0	200	0	-200	0.00	0.00	0	0	0
0016	3T	7	153	8	0	800	0	-800	0.00	0.00	1	0	-1
0016	3T	7	154	4	0	400	0	-400	0.00	0.00	0	0	0
0016	3T	7	156	56	4	5600	5600	0	0.07	1.00	9	9	0
0016	3T	7	165	2	0	200	0	-200	0.00	0.00	0	0	0
0016	3T	7	213	2	0	200	0	-200	0.00	0.00	0	0	0
0016	3T	7	214	1	0	100	0	-100	0.00	0.00	0	0	0
0016	3T	7	215	1	0	100	0	-100	0.00	0.00	0	0	0
0016	3T	7	216	3	0	300	0	-300	0.00	0.00	0	0	0
0016	3T	7	234	14	0	1400	0	-1400	0.00	0.00	2	0	-2
0016	3T	7	235	13	1	1300	2130	830	0.08	1.64	2	3	1
0016	3T	7	236	6	0	600	0	-600	0.00	0.00	1	0	-1
0016	3T	7	245	2	0	200	0	-200	0.00	0.00	0	0	0
0016	3T	7	246	2	0	200	0	-200	0.00	0.00	0	0	0
0016	3T	7	254	1	0	100	0	-100	0.00	0.00	0	0	0
0016	3T	7	256	3	0	300	0	-300	0.00	0.00	0	0	0
0023	3T	04_10	125	29	2	2900	2250	-650	0.07	0.78	5	3	-2
0023	3T	04_10	126	13	1	1300	1640	340	0.08	1.26	2	2	0
0023	3T	04_10	134	26	2	2600	2430	-170	0.08	0.93	4	4	0
0023	3T	04_10	135	30	1	3000	1390	-1610	0.03	0.46	5	2	-3
0023	3T	04_10	136	6	0	600	0	-600	0.00	0.00	1	0	-1
0023	3T	04_10	145	9	1	900	1660	760	0.11	1.84	1	2	1
0023	3T	04_10	146	3	0	300	0	-300	0.00	0.00	0	0	0
0023	3T	04_10	156	1	0	100	0	-100	0.00	0.00	0	0	0
0023	3T	04_10	214	1	0	100	0	-100	0.00	0.00	0	0	0
0023	3T	04_10	246	1	0	100	0	-100	0.00	0.00	0	0	0
0023	3T	04_11	123	14	2	1400	1660	260	0.14	1.19	2	2	0
0023	3T	04_11	124	56	5	5600	4360	-1240	0.09	0.78	9	7	-2
0021	1T	1_1	1	6210	3247	621000	586250	-34750	0.52	0.94	1099	1037	-62
0021	1T	1_1	2	1648	645	164800	147120	-17680	0.39	0.89	291	260	-31
0021	1T	1_2	1	1142	703	114200	101730	-12470	0.62	0.89	202	180	-22
0021	1T	1_2	2	23	6	2300	1940	-360	0.26	0.84	4	3	-1
0021	1T	1_3	1	8	5	800	860	60	0.63	1.08	1	1	0
0021	1T	1_4	1	617	399	61700	55010	-6690	0.65	0.89	109	97	-12
0021	1T	1_4	2	3	2	300	460	160	0.67	1.53	0	0	0
0021	1T	1_5	1	625	378	62500	55100	-7400	0.60	0.88	110	97	-13
0021	1T	1_5	2	18	8	1800	2940	1140	0.44	1.63	3	5	2
0021	1T	1_else	1	2457	1652	245700	225590	-20110	0.67	0.92	434	399	-35
0021	1T	1_else	2	4	1	400	150	-250	0.25	0.38	0	0	0
0021	1T	2_1	1	5787	2929	578700	532090	-46610	0.51	0.92	1024	941	-83
0021	1T	2_1	2	1728	690	172800	162340	-10460	0.40	0.94	305	287	-18
0021	1T	2_2	1	1298	798	129800	116430	-13370	0.61	0.90	229	206	-23
0021	1T	2_2	2	32	14	3200	3670	470	0.44	1.15	5	6	1
0021	1T	2_3	1	8	5	800	690	-110	0.63	0.86	1	1	0
0021	1T	2_4	1	666	439	66600	61690	-4910	0.66	0.93	117	109	-8
0021	1T	2_4	2	1	1	100	150	50	1.00	1.50	0	0	0
0021	1T	2_5	1	655	377	65500	57940	-7560	0.58	0.88	115	102	-13
0021	1T	2_5	2	41	20	4100	4890	790	0.49	1.19	7	8	1
0021	1T	2_else	1	2127	1382	212700	188740	-23960	0.65	0.89	376	334	-42
0021	1T	2_else	2	12	3	1200	550	-650	0.25	0.46	2	0	-2
0021	1T	3_1	1	5117	2683	511700	484340	-27360	0.52	0.95	905	857	-48
0021	1T	3_1	2	1664	625	166400	156030	-10370	0.38	0.94	294	276	-18
0021	1T	3_2	1	1049	660	104900	98810	-6090	0.63	0.94	185	174	-11
0021	1T	3_2	2	37	16	3700	4200	500	0.43	1.14	6	7	1
0021	1T	3_3	1	677	371	67700	61130	-6570	0.55	0.90	119	108	-11
0021	1T	3_3	2	152	46	15200	14130	-1070	0.30	0.93	26	25	-1
0021	1T	3_4	1	656	436	65600	56430	-9170	0.66	0.86	116	99	-17
0021	1T	3_4	2	3	0	300	0	-300	0.00	0.00	0	0	0
0021	1T	3_5	1	598	375	59800	56130	-3670	0.63	0.94	105	99	-6
0021	1T	3_5	2	36	13	3600	2380	-1220	0.36	0.66	6	4	-2
0021	1T	3_6	1	344	257	34400	32180	-2220	0.75	0.94	60	56	-4
0021	1T	3_6	2	8	4	800	1090	290	0.50	1.36	1	1	0
0021	1T	3_else	1	2047	1355	204700	191390	-13310	0.66	0.93	362	338	-24
0021	1T	3_else	2	42	17	4200	3890	-310	0.40	0.93	7	6	-1
0021	1T	4_1	1	3198	1681	319800	290220	-29580	0.53	0.91	566	513	-53
0021	1T	4_1	2	1154	461	115400	101350	-14050	0.40	0.88	204	179	-25
0021	1T	4_2	1	507	341	50700	48120	-2580	0.67	0.95	89	85	-4
0021	1T	4_2	2	8	3	800	890	90	0.38	1.11	1	1	0
0021	1T	4_3	1	1401	847	140100	136650	-3450	0.60	0.98	247	241	-6
0021	1T	4_3	2	355	118	35500	37050	1550	0.33	1.04	62	65	3
0021	1T	4_4	1	438	316	43800	41110	-2690	0.72	0.94	77	72	-5
0021	1T	4_4	2	1	0	100	0	-100	0.00	0.00	0	0	0
0021	1T	4_5	1	435	296	43500	42240	-1260	0.68	0.97	76	74	-2
0021	1T	4_5	2	10	4	1000	770	-230	0.40	0.77	1	1	0
0021	1T	4_6	1	621	429	62100	56090	-6010	0.69	0.90	109	99	-10
0021	1T	4_6	2	8	2	800	720	-80	0.25	0.90	1	1	0
0021	1T	4_else	1	2057	1409	205700	184230	-21470	0.68	0.90	364	326	-38
0021	1T	4_else	2	10	0	1000	0	-1000	0.00	0.00	1	0	-1
0021	1T	5_1	1	144	84	14400	12860	-1540	0.58	0.89	25	22	-3
0021	1T	5_1	2	21	11	2100	2570	470	0.52	1.22	3	4	1
0021	1T	5_2	1	10	6	1000	770	-230	0.60	0.77	1	1	0
0021	1T	5_3	1	4348	2539	434800	406490	-28310	0.58	0.93	769	719	-50
0021	1T	5_3	2	442	139	44200	36720	-7480	0.31	0.83	78	64	-14
0021	1T	5_4	1	16	8	1600	980	-620	0.50	0.61	2	1	-1
0021	1T	5_4	2	1	0	100	0	-100	0.00	0.00	0	0	0
0021	1T	5_5	1	4	3	400	560	160	0.75	1.40	0	0	0
0021	1T	5_6	1	1942	1393	194200	173890	-20310	0.72	0.90	343	307	-36
0021	1T	5_6	2	27	3	2700	1090	-1610	0.11	0.40	4	1	-3
0021	1T	5_else	1	1234	874	123400	112490	-10910	0.71	0.91	218	199	-19
0021	1T	5_else	2	2	1	200	820	620	0.50	4.10	0	1	1
0021	1T	6_3	1	372	199	37200	31330	-5870	0.53	0.84	65	55	-10
0021	1T	6_3	2	35	16	3500	4070	570	0.46	1.16	6	7	1
0021	1T	6_4	1	11	5	1100	760	-340	0.45	0.69	1	1	0
0021	1T	6_4	2	3	2	300	870	570	0.67	2.90	0	1	1
0021	1T	6_6	1	160	121	16000	14610	-1390	0.76	0.91	28	25	-3
0021	1T	6_6	2	2	1	200	190	-10	0.50	0.95	0	0	0
0021	1T	6_else	1	62	44	6200	5330	-870	0.71	0.86	10	9	-1
0021	1T	7_3	1	7538	4466	753800	699240	-54560	0.59	0.93	1334	1237	-97
0021	1T	7_3	2	844	285	84400	79110	-5290	0.34	0.94	149	140	-9
0021	1T	7_4	1	2254	1455	225400	205940	-19460	0.65	0.91	398	364	-34
0021	1T	7_4	2	63	18	6300	4560	-1740	0.29	0.72	11	8	-3
0021	1T	7_5	1	16	13	1600	1540	-60	0.81	0.96	2	2	0
0021	1T	7_5	2	1	1	100	180	80	1.00	1.80	0	0	0
0021	1T	7_7	1	1125	784	112500	98640	-13860	0.70	0.88	199	174	-25
0021	1T	7_7	2	7	1	700	210	-490	0.14	0.30	1	0	-1
0021	1T	7_else	1	1595	1135	159500	149860	-9640	0.71	0.94	282	265	-17
0021	2F	1_1	12	3379	1002	337900	295790	-42110	0.30	0.88	598	523	-75
0021	2F	1_1	13	1683	536	168300	134650	-33650	0.32	0.80	297	238	-59
0021	2F	1_1	14	807	200	80700	57770	-22930	0.25	0.72	142	102	-40
0021	2F	1_1	15	129	31	12900	10240	-2660	0.24	0.79	22	18	-4
0021	2F	1_1	16	184	38	18400	15190	-3210	0.21	0.83	32	26	-6
0021	2F	1_1	23	98	28	9800	11690	1890	0.29	1.19	17	20	3
0021	2F	1_1	24	151	37	15100	17000	1900	0.25	1.13	26	30	4
0021	2F	1_1	25	10	1	1000	270	-730	0.10	0.27	1	0	-1
0021	2F	1_1	26	78	11	7800	5620	-2180	0.14	0.72	13	9	-4
0021	2F	1_2	12	693	240	69300	67310	-1990	0.35	0.97	122	119	-3
0021	2F	1_2	13	319	100	31900	26190	-5710	0.31	0.82	56	46	-10
0021	2F	1_2	14	78	21	7800	6180	-1620	0.27	0.79	13	10	-3
0021	2F	1_2	15	1	0	100	0	-100	0.00	0.00	0	0	0
0021	2F	1_2	23	1	1	100	490	390	1.00	4.90	0	0	0
0021	2F	1_2	24	4	0	400	0	-400	0.00	0.00	0	0	0
0021	2F	1_3	12	6	1	600	470	-130	0.17	0.78	1	0	-1
0021	2F	1_3	13	1	0	100	0	-100	0.00	0.00	0	0	0
0021	2F	1_4	12	295	98	29500	28180	-1320	0.33	0.96	52	49	-3
0021	2F	1_4	13	237	65	23700	19780	-3920	0.27	0.83	41	35	-6
0021	2F	1_4	14	28	7	2800	1950	-850	0.25	0.70	4	3	-1
0021	2F	1_4	15	1	0	100	0	-100	0.00	0.00	0	0	0
0021	2F	1_5	12	339	102	33900	24140	-9760	0.30	0.71	60	42	-18
0021	2F	1_5	13	170	52	17000	13400	-3600	0.31	0.79	30	23	-7
0021	2F	1_5	14	87	21	8700	5450	-3250	0.24	0.63	15	9	-6
0021	2F	1_5	15	5	0	500	0	-500	0.00	0.00	0	0	0
0021	2F	1_5	16	3	0	300	0	-300	0.00	0.00	0	0	0
0021	2F	1_5	24	1	0	100	0	-100	0.00	0.00	0	0	0
0021	2F	1_5	25	1	0	100	0	-100	0.00	0.00	0	0	0
0021	2F	1_else	12	1385	420	138500	115160	-23340	0.30	0.83	245	203	-42
0021	2F	1_else	13	1072	241	107200	93240	-13960	0.22	0.87	189	165	-24
0021	2F	1_else	23	3	0	300	0	-300	0.00	0.00	0	0	0
0021	2F	2_1	12	2668	877	266800	240200	-26600	0.33	0.90	472	425	-47
0021	2F	2_1	13	1442	447	144200	114000	-30200	0.31	0.79	255	201	-54
0021	2F	2_1	14	952	306	95200	75120	-20080	0.32	0.79	168	132	-36
0021	2F	2_1	15	291	78	29100	25020	-4080	0.27	0.86	51	44	-7
0021	2F	2_1	16	287	52	28700	26560	-2140	0.18	0.93	50	47	-3
0021	2F	2_1	23	121	28	12100	9440	-2660	0.23	0.78	21	16	-5
0021	2F	2_1	24	100	21	10000	7040	-2960	0.21	0.70	17	12	-5
0021	2F	2_1	25	55	11	5500	5150	-350	0.20	0.94	9	9	0
0021	2F	2_1	26	147	22	14700	9870	-4830	0.15	0.67	26	17	-9
0021	2F	2_2	12	657	212	65700	55760	-9940	0.32	0.85	116	98	-18
0021	2F	2_2	13	418	157	41800	38030	-3770	0.38	0.91	73	67	-6
0021	2F	2_2	14	152	50	15200	12680	-2520	0.33	0.83	26	22	-4
0021	2F	2_2	15	15	3	1500	1010	-490	0.20	0.67	2	1	-1
0021	2F	2_2	16	10	3	1000	2240	1240	0.30	2.24	1	3	2
0021	2F	2_2	23	2	2	200	580	380	1.00	2.90	0	1	1
0021	2F	2_2	24	2	0	200	0	-200	0.00	0.00	0	0	0
0021	2F	2_2	26	1	0	100	0	-100	0.00	0.00	0	0	0
0021	2F	2_3	12	5	3	500	620	120	0.60	1.24	0	1	1
0021	2F	2_3	13	3	2	300	570	270	0.67	1.90	0	1	1
0021	2F	2_4	12	336	115	33600	28900	-4700	0.34	0.86	59	51	-8
0021	2F	2_4	13	235	81	23500	21650	-1850	0.34	0.92	41	38	-3
0021	2F	2_4	14	76	22	7600	5640	-1960	0.29	0.74	13	9	-4
0021	2F	2_4	15	13	3	1300	860	-440	0.23	0.66	2	1	-1
0021	2F	2_4	16	1	0	100	0	-100	0.00	0.00	0	0	0
0021	2F	2_5	12	321	112	32100	28140	-3960	0.35	0.88	56	49	-7
0021	2F	2_5	13	198	62	19800	14660	-5140	0.31	0.74	35	25	-10
0021	2F	2_5	14	110	35	11000	11390	390	0.32	1.04	19	20	1
0021	2F	2_5	15	9	6	900	1990	1090	0.67	2.21	1	3	2
0021	2F	2_5	16	11	2	1100	950	-150	0.18	0.86	1	1	0
0021	2F	2_5	23	2	0	200	0	-200	0.00	0.00	0	0	0
0021	2F	2_5	24	2	1	200	190	-10	0.50	0.95	0	0	0
0021	2F	2_5	25	1	0	100	0	-100	0.00	0.00	0	0	0
0021	2F	2_5	26	2	2	200	790	590	1.00	3.95	0	1	1
0021	2F	2_else	12	1516	488	151600	125860	-25740	0.32	0.83	268	222	-46
0021	2F	2_else	13	453	139	45300	40200	-5100	0.31	0.89	80	71	-9
0021	2F	2_else	14	98	32	9800	6720	-3080	0.33	0.69	17	11	-6
0021	2F	2_else	15	4	1	400	230	-170	0.25	0.58	0	0	0
0021	2F	2_else	23	1	0	100	0	-100	0.00	0.00	0	0	0
0021	2F	3_1	12	2266	763	226600	207910	-18690	0.34	0.92	401	367	-34
0021	2F	3_1	13	1278	426	127800	112370	-15430	0.33	0.88	226	198	-28
0021	2F	3_1	14	935	237	93500	65390	-28110	0.25	0.70	165	115	-50
0021	2F	3_1	15	386	88	38600	29680	-8920	0.23	0.77	68	52	-16
0021	2F	3_1	16	255	53	25500	28970	3470	0.21	1.14	45	51	6
0021	2F	3_1	23	130	29	13000	11950	-1050	0.22	0.92	23	21	-2
0021	2F	3_1	24	90	18	9000	7520	-1480	0.20	0.84	15	13	-2
0021	2F	3_1	25	108	16	10800	6960	-3840	0.15	0.64	19	12	-7
0021	2F	3_1	26	135	22	13500	8830	-4670	0.16	0.65	23	15	-8
0021	2F	3_2	12	529	182	52900	45290	-7610	0.34	0.86	93	80	-13
0021	2F	3_2	13	341	100	34100	24040	-10060	0.29	0.70	60	42	-18
0021	2F	3_2	14	127	41	12700	10620	-2080	0.32	0.84	22	18	-4
0021	2F	3_2	15	21	5	2100	1340	-760	0.24	0.64	3	2	-1
0021	2F	3_2	16	6	3	600	1440	840	0.50	2.40	1	2	1
0021	2F	3_2	23	3	1	300	340	40	0.33	1.13	0	0	0
0021	2F	3_2	24	1	0	100	0	-100	0.00	0.00	0	0	0
0021	2F	3_3	12	283	95	28300	25080	-3220	0.34	0.89	50	44	-6
0021	2F	3_3	13	184	55	18400	14840	-3560	0.30	0.81	32	26	-6
0021	2F	3_3	14	143	44	14300	13380	-920	0.31	0.94	25	23	-2
0021	2F	3_3	15	39	5	3900	2240	-1660	0.13	0.57	6	3	-3
0021	2F	3_3	16	18	4	1800	1430	-370	0.22	0.79	3	2	-1
0021	2F	3_3	23	15	1	1500	330	-1170	0.07	0.22	2	0	-2
0021	2F	3_3	24	16	3	1600	3450	1850	0.19	2.16	2	6	4
0021	2F	3_3	25	9	1	900	410	-490	0.11	0.46	1	0	-1
0021	2F	3_3	26	6	1	600	300	-300	0.17	0.50	1	0	-1
0021	2F	3_4	12	351	116	35100	30870	-4230	0.33	0.88	62	54	-8
0021	2F	3_4	13	218	69	21800	15820	-5980	0.32	0.73	38	28	-10
0021	2F	3_4	14	75	17	7500	4880	-2620	0.23	0.65	13	8	-5
0021	2F	3_4	15	7	1	700	200	-500	0.14	0.29	1	0	-1
0021	2F	3_4	16	3	0	300	0	-300	0.00	0.00	0	0	0
0021	2F	3_5	12	275	101	27500	24520	-2980	0.37	0.89	48	43	-5
0021	2F	3_5	13	193	68	19300	15080	-4220	0.35	0.78	34	26	-8
0021	2F	3_5	14	97	25	9700	6200	-3500	0.26	0.64	17	10	-7
0021	2F	3_5	15	9	1	900	460	-440	0.11	0.51	1	0	-1
0021	2F	3_5	16	13	2	1300	1360	60	0.15	1.05	2	2	0
0021	2F	3_5	23	1	0	100	0	-100	0.00	0.00	0	0	0
0021	2F	3_5	24	1	0	100	0	-100	0.00	0.00	0	0	0
0021	2F	3_5	25	2	0	200	0	-200	0.00	0.00	0	0	0
0021	2F	3_5	26	3	1	300	370	70	0.33	1.23	0	0	0
0021	2F	3_6	12	236	97	23600	17900	-5700	0.41	0.76	41	31	-10
0021	2F	3_6	13	72	24	7200	6310	-890	0.33	0.88	12	11	-1
0021	2F	3_6	14	26	3	2600	960	-1640	0.12	0.37	4	1	-3
0021	2F	3_6	26	1	0	100	0	-100	0.00	0.00	0	0	0
0021	2F	3_else	12	1265	458	126500	105420	-21080	0.36	0.83	223	186	-37
0021	2F	3_else	13	467	159	46700	35910	-10790	0.34	0.77	82	63	-19
0021	2F	3_else	14	219	67	21900	14330	-7570	0.31	0.65	38	25	-13
0021	2F	3_else	15	31	9	3100	3270	170	0.29	1.05	5	5	0
0021	2F	3_else	16	27	4	2700	670	-2030	0.15	0.25	4	1	-3
0021	2F	3_else	23	3	0	300	0	-300	0.00	0.00	0	0	0
0021	2F	3_else	24	3	0	300	0	-300	0.00	0.00	0	0	0
0021	2F	3_else	25	3	1	300	360	60	0.33	1.20	0	0	0
0021	2F	4_1	12	1396	462	139600	123570	-16030	0.33	0.89	247	218	-29
0021	2F	4_1	13	875	290	87500	71300	-16200	0.33	0.81	154	126	-28
0021	2F	4_1	14	581	189	58100	49440	-8660	0.33	0.85	102	87	-15
0021	2F	4_1	15	233	60	23300	23680	380	0.26	1.02	41	41	0
0021	2F	4_1	16	95	18	9500	10030	530	0.19	1.06	16	17	1
0021	2F	4_1	23	117	28	11700	9300	-2400	0.24	0.79	20	16	-4
0021	2F	4_1	24	75	18	7500	7150	-350	0.24	0.95	13	12	-1
0021	2F	4_1	25	83	14	8300	7730	-570	0.17	0.93	14	13	-1
0021	2F	4_1	26	37	8	3700	4070	370	0.22	1.10	6	7	1
0021	2F	4_2	12	246	90	24600	21620	-2980	0.37	0.88	43	38	-5
0021	2F	4_2	13	163	60	16300	16070	-230	0.37	0.99	28	28	0
0021	2F	4_2	14	80	26	8000	6950	-1050	0.33	0.87	14	12	-2
0021	2F	4_2	15	11	3	1100	920	-180	0.27	0.84	1	1	0
0021	2F	4_2	16	2	0	200	0	-200	0.00	0.00	0	0	0
0021	2F	4_3	12	566	179	56600	43660	-12940	0.32	0.77	100	77	-23
0021	2F	4_3	13	398	143	39800	35090	-4710	0.36	0.88	70	62	-8
0021	2F	4_3	14	290	88	29000	24730	-4270	0.30	0.85	51	43	-8
0021	2F	4_3	15	75	20	7500	7400	-100	0.27	0.99	13	13	0
0021	2F	4_3	16	48	11	4800	4890	90	0.23	1.02	8	8	0
0021	2F	4_3	23	51	14	5100	4600	-500	0.27	0.90	9	8	-1
0021	2F	4_3	24	45	8	4500	3100	-1400	0.18	0.69	7	5	-2
0021	2F	4_3	25	31	6	3100	4480	1380	0.19	1.45	5	7	2
0021	2F	4_3	26	22	3	2200	550	-1650	0.14	0.25	3	0	-3
0021	2F	4_4	12	259	91	25900	22010	-3890	0.35	0.85	45	38	-7
0021	2F	4_4	13	130	43	13000	9600	-3400	0.33	0.74	23	16	-7
0021	2F	4_4	14	42	13	4200	4230	30	0.31	1.01	7	7	0
0021	2F	4_4	15	5	0	500	0	-500	0.00	0.00	0	0	0
0021	2F	4_5	12	222	77	22200	17150	-5050	0.35	0.77	39	30	-9
0021	2F	4_5	13	137	59	13700	14350	650	0.43	1.05	24	25	1
0021	2F	4_5	14	55	24	5500	6180	680	0.44	1.12	9	10	1
0021	2F	4_5	15	11	2	1100	380	-720	0.18	0.35	1	0	-1
0021	2F	4_5	16	1	0	100	0	-100	0.00	0.00	0	0	0
0021	2F	4_5	25	1	0	100	0	-100	0.00	0.00	0	0	0
0021	2F	4_6	12	413	162	41300	33320	-7980	0.39	0.81	73	58	-15
0021	2F	4_6	13	146	48	14600	13390	-1210	0.33	0.92	25	23	-2
0021	2F	4_6	14	29	4	2900	1620	-1280	0.14	0.56	5	2	-3
0021	2F	4_6	15	4	1	400	400	0	0.25	1.00	0	0	0
0021	2F	4_6	23	2	0	200	0	-200	0.00	0.00	0	0	0
0021	2F	4_6	24	1	0	100	0	-100	0.00	0.00	0	0	0
0021	2F	4_else	12	1290	455	129000	110710	-18290	0.35	0.86	228	195	-33
0021	2F	4_else	13	684	189	68400	55630	-12770	0.28	0.81	121	98	-23
0021	2F	4_else	14	83	29	8300	10130	1830	0.35	1.22	14	17	3
0021	2F	4_else	23	6	0	600	0	-600	0.00	0.00	1	0	-1
0021	2F	5_1	12	54	19	5400	4090	-1310	0.35	0.76	9	7	-2
0021	2F	5_1	13	49	16	4900	3650	-1250	0.33	0.74	8	6	-2
0021	2F	5_1	14	23	8	2300	1540	-760	0.35	0.67	4	2	-2
0021	2F	5_1	15	12	4	1200	1190	-10	0.33	0.99	2	2	0
0021	2F	5_1	16	3	1	300	480	180	0.33	1.60	0	0	0
0021	2F	5_1	23	1	0	100	0	-100	0.00	0.00	0	0	0
0021	2F	5_1	24	3	0	300	0	-300	0.00	0.00	0	0	0
0021	2F	5_1	25	1	0	100	0	-100	0.00	0.00	0	0	0
0021	2F	5_2	12	4	2	400	680	280	0.50	1.70	0	1	1
0021	2F	5_2	13	4	1	400	280	-120	0.25	0.70	0	0	0
0021	2F	5_2	14	2	2	200	680	480	1.00	3.40	0	1	1
0021	2F	5_3	12	1730	568	173000	150050	-22950	0.33	0.87	306	265	-41
0021	2F	5_3	13	1097	350	109700	87230	-22470	0.32	0.80	194	154	-40
0021	2F	5_3	14	950	293	95000	74490	-20510	0.31	0.78	168	131	-37
0021	2F	5_3	15	255	57	25500	21420	-4080	0.22	0.84	45	37	-8
0021	2F	5_3	16	183	36	18300	12110	-6190	0.20	0.66	32	21	-11
0021	2F	5_3	23	32	6	3200	2950	-250	0.19	0.92	5	5	0
0021	2F	5_3	24	23	2	2300	410	-1890	0.09	0.18	4	0	-4
0021	2F	5_3	25	21	3	2100	1390	-710	0.14	0.66	3	2	-1
0021	2F	5_3	26	20	3	2000	1880	-120	0.15	0.94	3	3	0
0021	2F	5_4	12	10	3	1000	870	-130	0.30	0.87	1	1	0
0021	2F	5_4	13	4	1	400	370	-30	0.25	0.93	0	0	0
0021	2F	5_4	14	2	0	200	0	-200	0.00	0.00	0	0	0
0021	2F	5_5	12	2	0	200	0	-200	0.00	0.00	0	0	0
0021	2F	5_5	13	2	0	200	0	-200	0.00	0.00	0	0	0
0021	2F	5_6	12	1481	598	148100	117410	-30690	0.40	0.79	262	207	-55
0021	2F	5_6	13	351	88	35100	22950	-12150	0.25	0.65	62	40	-22
0021	2F	5_6	14	52	10	5200	3580	-1620	0.19	0.69	9	6	-3
0021	2F	5_6	15	3	0	300	0	-300	0.00	0.00	0	0	0
0021	2F	5_6	16	3	1	300	1170	870	0.33	3.90	0	2	2
0021	2F	5_6	23	5	0	500	0	-500	0.00	0.00	0	0	0
0021	2F	5_6	24	1	0	100	0	-100	0.00	0.00	0	0	0
0021	2F	5_6	25	1	0	100	0	-100	0.00	0.00	0	0	0
0021	2F	5_else	12	1001	370	100100	86660	-13440	0.37	0.87	177	153	-24
0021	2F	5_else	13	186	51	18600	13500	-5100	0.27	0.73	32	23	-9
0021	2F	5_else	14	43	11	4300	3200	-1100	0.26	0.74	7	5	-2
0021	2F	6_3	12	145	46	14500	11860	-2640	0.32	0.82	25	20	-5
0021	2F	6_3	13	91	35	9100	8240	-860	0.38	0.91	16	14	-2
0021	2F	6_3	14	82	19	8200	5460	-2740	0.23	0.67	14	9	-5
0021	2F	6_3	15	22	4	2200	2040	-160	0.18	0.93	3	3	0
0021	2F	6_3	16	14	3	1400	1440	40	0.21	1.03	2	2	0
0021	2F	6_3	23	3	0	300	0	-300	0.00	0.00	0	0	0
0021	2F	6_3	24	2	0	200	0	-200	0.00	0.00	0	0	0
0021	2F	6_3	25	2	0	200	0	-200	0.00	0.00	0	0	0
0021	2F	6_3	26	3	0	300	0	-300	0.00	0.00	0	0	0
0021	2F	6_4	12	3	1	300	480	180	0.33	1.60	0	0	0
0021	2F	6_4	13	6	3	600	730	130	0.50	1.22	1	1	0
0021	2F	6_4	14	2	0	200	0	-200	0.00	0.00	0	0	0
0021	2F	6_6	12	130	57	13000	10920	-2080	0.44	0.84	23	19	-4
0021	2F	6_6	13	23	5	2300	1210	-1090	0.22	0.53	4	2	-2
0021	2F	6_6	14	4	1	400	330	-70	0.25	0.83	0	0	0
0021	2F	6_else	12	36	14	3600	3060	-540	0.39	0.85	6	5	-1
0021	2F	6_else	13	13	4	1300	790	-510	0.31	0.61	2	1	-1
0021	2F	6_else	14	9	3	900	780	-120	0.33	0.87	1	1	0
0021	2F	6_else	15	1	1	100	270	170	1.00	2.70	0	0	0
0021	2F	6_else	16	3	0	300	0	-300	0.00	0.00	0	0	0
0021	2F	7_3	12	3514	1177	351400	302540	-48860	0.33	0.86	621	535	-86
0021	2F	7_3	13	1974	590	197400	156780	-40620	0.30	0.79	349	277	-72
0021	2F	7_3	14	1213	338	121300	88830	-32470	0.28	0.73	214	157	-57
0021	2F	7_3	15	382	76	38200	28630	-9570	0.20	0.75	67	50	-17
0021	2F	7_3	16	266	54	26600	23540	-3060	0.20	0.88	47	41	-6
0021	2F	7_3	23	65	14	6500	4910	-1590	0.22	0.76	11	8	-3
0021	2F	7_3	24	30	6	3000	2400	-600	0.20	0.80	5	4	-1
0021	2F	7_3	25	29	2	2900	570	-2330	0.07	0.20	5	1	-4
0021	2F	7_3	26	40	5	4000	4630	630	0.13	1.16	7	8	1
0021	2F	7_4	12	1474	528	147400	121110	-26290	0.36	0.82	260	214	-46
0021	2F	7_4	13	512	145	51200	40730	-10470	0.28	0.80	90	72	-18
0021	2F	7_4	14	172	35	17200	11230	-5970	0.20	0.65	30	19	-11
0021	2F	7_4	15	23	2	2300	1450	-850	0.09	0.63	4	2	-2
0021	2F	7_4	16	9	2	900	2270	1370	0.22	2.52	1	4	3
0021	2F	7_4	23	3	1	300	720	420	0.33	2.40	0	1	1
0021	2F	7_4	24	3	0	300	0	-300	0.00	0.00	0	0	0
0021	2F	7_4	25	4	0	400	0	-400	0.00	0.00	0	0	0
0021	2F	7_4	26	1	0	100	0	-100	0.00	0.00	0	0	0
0021	2F	7_5	12	7	0	700	0	-700	0.00	0.00	1	0	-1
0021	2F	7_5	13	4	1	400	240	-160	0.25	0.60	0	0	0
0021	2F	7_5	14	3	1	300	360	60	0.33	1.20	0	0	0
0021	2F	7_5	15	1	0	100	0	-100	0.00	0.00	0	0	0
0021	2F	7_7	12	981	319	98100	73770	-24330	0.33	0.75	173	130	-43
0021	2F	7_7	13	73	17	7300	5630	-1670	0.23	0.77	12	9	-3
0021	2F	7_7	14	19	2	1900	700	-1200	0.11	0.37	3	1	-2
0021	2F	7_7	23	1	0	100	0	-100	0.00	0.00	0	0	0
0021	2F	7_else	12	1142	414	114200	99560	-14640	0.36	0.87	202	176	-26
0021	2F	7_else	13	347	114	34700	30230	-4470	0.33	0.87	61	53	-8
0021	2F	7_else	14	100	25	10000	7850	-2150	0.25	0.79	17	13	-4
0021	2F	7_else	16	1	0	100	0	-100	0.00	0.00	0	0	0
0021	2T	1_1	12	3170	668	317000	267930	-49070	0.21	0.85	561	474	-87
0021	2T	1_1	13	1683	357	168300	127560	-40740	0.21	0.76	297	225	-72
0021	2T	1_1	14	807	143	80700	63040	-17660	0.18	0.78	142	111	-31
0021	2T	1_1	15	129	24	12900	13260	360	0.19	1.03	22	23	1
0021	2T	1_1	16	184	25	18400	17390	-1010	0.14	0.95	32	30	-2
0021	2T	1_1	21	209	22	20900	16570	-4330	0.11	0.79	36	29	-7
0021	2T	1_1	23	98	18	9800	12140	2340	0.18	1.24	17	21	4
0021	2T	1_1	24	151	19	15100	13470	-1630	0.13	0.89	26	23	-3
0021	2T	1_1	25	10	1	1000	320	-680	0.10	0.32	1	0	-1
0021	2T	1_1	26	78	7	7800	5160	-2640	0.09	0.66	13	9	-4
0021	2T	1_2	12	686	183	68600	62200	-6400	0.27	0.91	121	110	-11
0021	2T	1_2	13	319	67	31900	21290	-10610	0.21	0.67	56	37	-19
0021	2T	1_2	14	78	12	7800	4160	-3640	0.15	0.53	13	7	-6
0021	2T	1_2	15	1	0	100	0	-100	0.00	0.00	0	0	0
0021	2T	1_2	21	7	1	700	1800	1100	0.14	2.57	1	3	2
0021	2T	1_2	23	1	0	100	0	-100	0.00	0.00	0	0	0
0021	2T	1_2	24	4	0	400	0	-400	0.00	0.00	0	0	0
0021	2T	1_3	12	6	1	600	480	-120	0.17	0.80	1	0	-1
0021	2T	1_3	13	1	0	100	0	-100	0.00	0.00	0	0	0
0021	2T	1_4	12	295	80	29500	28680	-820	0.27	0.97	52	50	-2
0021	2T	1_4	13	237	51	23700	18920	-4780	0.22	0.80	41	33	-8
0021	2T	1_4	14	28	7	2800	2360	-440	0.25	0.84	4	4	0
0021	2T	1_4	15	1	0	100	0	-100	0.00	0.00	0	0	0
0021	2T	1_5	12	337	75	33700	22440	-11260	0.22	0.67	59	39	-20
0021	2T	1_5	13	170	40	17000	12740	-4260	0.24	0.75	30	22	-8
0021	2T	1_5	14	87	13	8700	4530	-4170	0.15	0.52	15	8	-7
0021	2T	1_5	15	5	0	500	0	-500	0.00	0.00	0	0	0
0021	2T	1_5	16	3	0	300	0	-300	0.00	0.00	0	0	0
0021	2T	1_5	21	2	1	200	390	190	0.50	1.95	0	0	0
0021	2T	1_5	24	1	0	100	0	-100	0.00	0.00	0	0	0
0021	2T	1_5	25	1	0	100	0	-100	0.00	0.00	0	0	0
0021	2T	1_else	12	1385	336	138500	115540	-22960	0.24	0.83	245	204	-41
0021	2T	1_else	13	1072	176	107200	78040	-29160	0.16	0.73	189	138	-51
0021	2T	1_else	23	3	0	300	0	-300	0.00	0.00	0	0	0
0021	2T	2_1	12	2581	584	258100	214560	-43540	0.23	0.83	456	379	-77
0021	2T	2_1	13	1442	325	144200	119250	-24950	0.23	0.83	255	211	-44
0021	2T	2_1	14	952	216	95200	76980	-18220	0.23	0.81	168	136	-32
0021	2T	2_1	15	291	45	29100	20450	-8650	0.15	0.70	51	36	-15
0021	2T	2_1	16	287	39	28700	24500	-4200	0.14	0.85	50	43	-7
0021	2T	2_1	21	87	8	8700	7140	-1560	0.09	0.82	15	12	-3
0021	2T	2_1	23	121	13	12100	7140	-4960	0.11	0.59	21	12	-9
0021	2T	2_1	24	100	13	10000	6200	-3800	0.13	0.62	17	10	-7
0021	2T	2_1	25	55	7	5500	5530	30	0.13	1.01	9	9	0
0021	2T	2_1	26	147	13	14700	9090	-5610	0.09	0.62	26	16	-10
0021	2T	2_2	12	650	156	65000	51900	-13100	0.24	0.80	115	91	-24
0021	2T	2_2	13	418	114	41800	35460	-6340	0.27	0.85	73	62	-11
0021	2T	2_2	14	152	38	15200	12660	-2540	0.25	0.83	26	22	-4
0021	2T	2_2	15	15	3	1500	1420	-80	0.20	0.95	2	2	0
0021	2T	2_2	16	10	2	1000	2950	1950	0.20	2.95	1	5	4
0021	2T	2_2	21	7	1	700	550	-150	0.14	0.79	1	0	-1
0021	2T	2_2	23	2	2	200	790	590	1.00	3.95	0	1	1
0021	2T	2_2	24	2	0	200	0	-200	0.00	0.00	0	0	0
0021	2T	2_2	26	1	0	100	0	-100	0.00	0.00	0	0	0
0021	2T	2_3	12	5	1	500	200	-300	0.20	0.40	0	0	0
0021	2T	2_3	13	3	2	300	580	280	0.67	1.93	0	1	1
0021	2T	2_4	12	336	92	33600	27810	-5790	0.27	0.83	59	49	-10
0021	2T	2_4	13	235	58	23500	20180	-3320	0.25	0.86	41	35	-6
0021	2T	2_4	14	76	15	7600	4980	-2620	0.20	0.66	13	8	-5
0021	2T	2_4	15	13	3	1300	1240	-60	0.23	0.95	2	2	0
0021	2T	2_4	16	1	0	100	0	-100	0.00	0.00	0	0	0
0021	2T	2_5	12	312	75	31200	24660	-6540	0.24	0.79	55	43	-12
0021	2T	2_5	13	198	41	19800	12940	-6860	0.21	0.65	35	22	-13
0021	2T	2_5	14	110	25	11000	10490	-510	0.23	0.95	19	18	-1
0021	2T	2_5	15	9	4	900	2270	1370	0.44	2.52	1	4	3
0021	2T	2_5	16	11	2	1100	980	-120	0.18	0.89	1	1	0
0021	2T	2_5	21	9	2	900	2520	1620	0.22	2.80	1	4	3
0021	2T	2_5	23	2	0	200	0	-200	0.00	0.00	0	0	0
0021	2T	2_5	24	2	1	200	220	20	0.50	1.10	0	0	0
0021	2T	2_5	25	1	0	100	0	-100	0.00	0.00	0	0	0
0021	2T	2_5	26	2	2	200	1460	1260	1.00	7.30	0	2	2
0021	2T	2_else	12	1516	394	151600	121830	-29770	0.26	0.80	268	215	-53
0021	2T	2_else	13	453	103	45300	35000	-10300	0.23	0.77	80	61	-19
0021	2T	2_else	14	98	23	9800	6810	-2990	0.23	0.69	17	12	-5
0021	2T	2_else	15	4	1	400	260	-140	0.25	0.65	0	0	0
0021	2T	2_else	23	1	0	100	0	-100	0.00	0.00	0	0	0
0021	2T	3_1	12	2101	514	210100	191320	-18780	0.24	0.91	371	338	-33
0021	2T	3_1	13	1278	288	127800	107300	-20500	0.23	0.84	226	189	-37
0021	2T	3_1	14	935	166	93500	64460	-29040	0.18	0.69	165	114	-51
0021	2T	3_1	15	386	64	38600	34340	-4260	0.17	0.89	68	60	-8
0021	2T	3_1	16	255	31	25500	25840	340	0.12	1.01	45	45	0
0021	2T	3_1	21	165	19	16500	16410	-90	0.12	0.99	29	29	0
0021	2T	3_1	23	130	17	13000	11530	-1470	0.13	0.89	23	20	-3
0021	2T	3_1	24	90	12	9000	7920	-1080	0.13	0.88	15	14	-1
0021	2T	3_1	25	108	8	10800	8420	-2380	0.07	0.78	19	14	-5
0021	2T	3_1	26	135	14	13500	11550	-1950	0.10	0.86	23	20	-3
0021	2T	3_2	12	523	141	52300	45260	-7040	0.27	0.87	92	80	-12
0021	2T	3_2	13	341	72	34100	23360	-10740	0.21	0.69	60	41	-19
0021	2T	3_2	14	127	34	12700	11130	-1570	0.27	0.88	22	19	-3
0021	2T	3_2	15	21	5	2100	2090	-10	0.24	1.00	3	3	0
0021	2T	3_2	16	6	3	600	2350	1750	0.50	3.92	1	4	3
0021	2T	3_2	21	6	1	600	1130	530	0.17	1.88	1	2	1
0021	2T	3_2	23	3	1	300	1230	930	0.33	4.10	0	2	2
0021	2T	3_2	24	1	0	100	0	-100	0.00	0.00	0	0	0
0021	2T	3_3	12	273	63	27300	21550	-5750	0.23	0.79	48	38	-10
0021	2T	3_3	13	184	42	18400	15300	-3100	0.23	0.83	32	27	-5
0021	2T	3_3	14	143	28	14300	12510	-1790	0.20	0.87	25	22	-3
0021	2T	3_3	15	39	4	3900	2820	-1080	0.10	0.72	6	4	-2
0021	2T	3_3	16	18	3	1800	1550	-250	0.17	0.86	3	2	-1
0021	2T	3_3	21	10	1	1000	860	-140	0.10	0.86	1	1	0
0021	2T	3_3	23	15	1	1500	810	-690	0.07	0.54	2	1	-1
0021	2T	3_3	24	16	1	1600	870	-730	0.06	0.54	2	1	-1
0021	2T	3_3	25	9	1	900	740	-160	0.11	0.82	1	1	0
0021	2T	3_3	26	6	1	600	960	360	0.17	1.60	1	1	0
0021	2T	3_4	12	350	87	35000	27220	-7780	0.25	0.78	61	48	-13
0021	2T	3_4	13	218	50	21800	14590	-7210	0.23	0.67	38	25	-13
0021	2T	3_4	14	75	15	7500	5220	-2280	0.20	0.70	13	9	-4
0021	2T	3_4	15	7	1	700	420	-280	0.14	0.60	1	0	-1
0021	2T	3_4	16	3	0	300	0	-300	0.00	0.00	0	0	0
0021	2T	3_4	21	1	0	100	0	-100	0.00	0.00	0	0	0
0021	2T	3_5	12	270	80	27000	23680	-3320	0.30	0.88	47	41	-6
0021	2T	3_5	13	193	54	19300	14990	-4310	0.28	0.78	34	26	-8
0021	2T	3_5	14	97	20	9700	5950	-3750	0.21	0.61	17	10	-7
0021	2T	3_5	15	9	0	900	0	-900	0.00	0.00	1	0	-1
0021	2T	3_5	16	13	2	1300	1730	430	0.15	1.33	2	3	1
0021	2T	3_5	21	5	0	500	0	-500	0.00	0.00	0	0	0
0021	2T	3_5	23	1	0	100	0	-100	0.00	0.00	0	0	0
0021	2T	3_5	24	1	0	100	0	-100	0.00	0.00	0	0	0
0021	2T	3_5	25	2	0	200	0	-200	0.00	0.00	0	0	0
0021	2T	3_5	26	3	1	300	560	260	0.33	1.87	0	0	0
0021	2T	3_6	12	235	85	23500	19610	-3890	0.36	0.83	41	34	-7
0021	2T	3_6	13	72	23	7200	6910	-290	0.32	0.96	12	12	0
0021	2T	3_6	14	26	3	2600	1080	-1520	0.12	0.42	4	1	-3
0021	2T	3_6	21	1	0	100	0	-100	0.00	0.00	0	0	0
0021	2T	3_6	26	1	0	100	0	-100	0.00	0.00	0	0	0
0021	2T	3_else	12	1265	363	126500	103990	-22510	0.29	0.82	223	184	-39
0021	2T	3_else	13	467	108	46700	33150	-13550	0.23	0.71	82	58	-24
0021	2T	3_else	14	219	48	21900	16660	-5240	0.22	0.76	38	29	-9
0021	2T	3_else	15	31	6	3100	3230	130	0.19	1.04	5	5	0
0021	2T	3_else	16	27	3	2700	740	-1960	0.11	0.27	4	1	-3
0021	2T	3_else	23	3	0	300	0	-300	0.00	0.00	0	0	0
0021	2T	3_else	24	3	0	300	0	-300	0.00	0.00	0	0	0
0021	2T	3_else	25	3	1	300	490	190	0.33	1.63	0	0	0
0021	2T	4_1	12	1297	311	129700	108640	-21060	0.24	0.84	229	192	-37
0021	2T	4_1	13	875	210	87500	73240	-14260	0.24	0.84	154	129	-25
0021	2T	4_1	14	581	131	58100	49220	-8880	0.23	0.85	102	87	-15
0021	2T	4_1	15	233	44	23300	26130	2830	0.19	1.12	41	46	5
0021	2T	4_1	16	95	12	9500	9850	350	0.13	1.04	16	17	1
0021	2T	4_1	21	99	17	9900	11320	1420	0.17	1.14	17	20	3
0021	2T	4_1	23	117	21	11700	11890	190	0.18	1.02	20	21	1
0021	2T	4_1	24	75	13	7500	8610	1110	0.17	1.15	13	15	2
0021	2T	4_1	25	83	8	8300	9510	1210	0.10	1.15	14	16	2
0021	2T	4_1	26	37	4	3700	2990	-710	0.11	0.81	6	5	-1
0021	2T	4_2	12	246	75	24600	21930	-2670	0.30	0.89	43	38	-5
0021	2T	4_2	13	163	45	16300	16550	250	0.28	1.02	28	29	1
0021	2T	4_2	14	80	21	8000	7250	-750	0.26	0.91	14	12	-2
0021	2T	4_2	15	11	3	1100	1190	90	0.27	1.08	1	2	1
0021	2T	4_2	16	2	0	200	0	-200	0.00	0.00	0	0	0
0021	2T	4_3	12	552	138	55200	41870	-13330	0.25	0.76	97	74	-23
0021	2T	4_3	13	398	106	39800	34950	-4850	0.27	0.88	70	61	-9
0021	2T	4_3	14	290	69	29000	28910	-90	0.24	1.00	51	51	0
0021	2T	4_3	15	75	15	7500	9110	1610	0.20	1.21	13	16	3
0021	2T	4_3	16	48	8	4800	5790	990	0.17	1.21	8	10	2
0021	2T	4_3	21	14	1	1400	480	-920	0.07	0.34	2	0	-2
0021	2T	4_3	23	51	11	5100	4610	-490	0.22	0.90	9	8	-1
0021	2T	4_3	24	45	4	4500	2040	-2460	0.09	0.45	7	3	-4
0021	2T	4_3	25	31	3	3100	1970	-1130	0.10	0.64	5	3	-2
0021	2T	4_3	26	22	2	2200	580	-1620	0.09	0.26	3	1	-2
0021	2T	4_4	12	259	75	25900	21140	-4760	0.29	0.82	45	37	-8
0021	2T	4_4	13	130	34	13000	9010	-3990	0.26	0.69	23	15	-8
0021	2T	4_4	14	42	12	4200	4400	200	0.29	1.05	7	7	0
0021	2T	4_4	15	5	0	500	0	-500	0.00	0.00	0	0	0
0021	2T	4_5	12	221	59	22100	16150	-5950	0.27	0.73	39	28	-11
0021	2T	4_5	13	137	47	13700	13460	-240	0.34	0.98	24	23	-1
0021	2T	4_5	14	55	16	5500	5280	-220	0.29	0.96	9	9	0
0021	2T	4_5	15	11	1	1100	300	-800	0.09	0.27	1	0	-1
0021	2T	4_5	16	1	0	100	0	-100	0.00	0.00	0	0	0
0021	2T	4_5	21	1	0	100	0	-100	0.00	0.00	0	0	0
0021	2T	4_5	25	1	0	100	0	-100	0.00	0.00	0	0	0
0021	2T	4_6	12	411	131	41100	31570	-9530	0.32	0.77	72	55	-17
0021	2T	4_6	13	146	40	14600	13500	-1100	0.27	0.92	25	23	-2
0021	2T	4_6	14	29	4	2900	1470	-1430	0.14	0.51	5	2	-3
0021	2T	4_6	15	4	1	400	470	70	0.25	1.18	0	0	0
0021	2T	4_6	21	2	0	200	0	-200	0.00	0.00	0	0	0
0021	2T	4_6	23	2	0	200	0	-200	0.00	0.00	0	0	0
0021	2T	4_6	24	1	0	100	0	-100	0.00	0.00	0	0	0
0021	2T	4_else	12	1290	352	129000	102420	-26580	0.27	0.79	228	181	-47
0021	2T	4_else	13	684	149	68400	54670	-13730	0.22	0.80	121	96	-25
0021	2T	4_else	14	83	25	8300	9540	1240	0.30	1.15	14	16	2
0021	2T	4_else	23	6	0	600	0	-600	0.00	0.00	1	0	-1
0021	2T	5_1	12	52	14	5200	3950	-1250	0.27	0.76	9	6	-3
0021	2T	5_1	13	49	11	4900	3510	-1390	0.22	0.72	8	6	-2
0021	2T	5_1	14	23	6	2300	1410	-890	0.26	0.61	4	2	-2
0021	2T	5_1	15	12	3	1200	1400	200	0.25	1.17	2	2	0
0021	2T	5_1	16	3	1	300	670	370	0.33	2.23	0	1	1
0021	2T	5_1	21	2	0	200	0	-200	0.00	0.00	0	0	0
0021	2T	5_1	23	1	0	100	0	-100	0.00	0.00	0	0	0
0021	2T	5_1	24	3	0	300	0	-300	0.00	0.00	0	0	0
0021	2T	5_1	25	1	0	100	0	-100	0.00	0.00	0	0	0
0021	2T	5_2	12	4	0	400	0	-400	0.00	0.00	0	0	0
0021	2T	5_2	13	4	1	400	290	-110	0.25	0.73	0	0	0
0021	2T	5_2	14	2	2	200	760	560	1.00	3.80	0	1	1
0021	2T	5_3	12	1713	433	171300	148450	-22850	0.25	0.87	303	262	-41
0021	2T	5_3	13	1097	247	109700	83790	-25910	0.23	0.76	194	148	-46
0021	2T	5_3	14	950	207	95000	76330	-18670	0.22	0.80	168	135	-33
0021	2T	5_3	15	255	40	25500	19260	-6240	0.16	0.76	45	34	-11
0021	2T	5_3	16	183	25	18300	13110	-5190	0.14	0.72	32	23	-9
0021	2T	5_3	21	17	1	1700	2060	360	0.06	1.21	3	3	0
0021	2T	5_3	23	32	2	3200	2100	-1100	0.06	0.66	5	3	-2
0021	2T	5_3	24	23	0	2300	0	-2300	0.00	0.00	4	0	-4
0021	2T	5_3	25	21	1	2100	360	-1740	0.05	0.17	3	0	-3
0021	2T	5_3	26	20	1	2000	760	-1240	0.05	0.38	3	1	-2
0021	2T	5_4	12	10	2	1000	650	-350	0.20	0.65	1	1	0
0021	2T	5_4	13	4	1	400	380	-20	0.25	0.95	0	0	0
0021	2T	5_4	14	2	0	200	0	-200	0.00	0.00	0	0	0
0021	2T	5_5	12	2	0	200	0	-200	0.00	0.00	0	0	0
0021	2T	5_5	13	2	0	200	0	-200	0.00	0.00	0	0	0
0021	2T	5_6	12	1477	484	147700	113530	-34170	0.33	0.77	261	200	-61
0021	2T	5_6	13	351	76	35100	22920	-12180	0.22	0.65	62	40	-22
0021	2T	5_6	14	52	10	5200	4010	-1190	0.19	0.77	9	7	-2
0021	2T	5_6	15	3	0	300	0	-300	0.00	0.00	0	0	0
0021	2T	5_6	16	3	1	300	1210	910	0.33	4.03	0	2	2
0021	2T	5_6	21	4	0	400	0	-400	0.00	0.00	0	0	0
0021	2T	5_6	23	5	0	500	0	-500	0.00	0.00	0	0	0
0021	2T	5_6	24	1	0	100	0	-100	0.00	0.00	0	0	0
0021	2T	5_6	25	1	0	100	0	-100	0.00	0.00	0	0	0
0021	2T	5_else	12	1000	292	100000	81540	-18460	0.29	0.82	176	144	-32
0021	2T	5_else	13	186	39	18600	13230	-5370	0.21	0.71	32	23	-9
0021	2T	5_else	14	43	9	4300	2940	-1360	0.21	0.68	7	5	-2
0021	2T	5_else	21	1	0	100	0	-100	0.00	0.00	0	0	0
0021	2T	6_3	12	144	33	14400	10330	-4070	0.23	0.72	25	18	-7
0021	2T	6_3	13	91	26	9100	7640	-1460	0.29	0.84	16	13	-3
0021	2T	6_3	14	82	13	8200	4530	-3670	0.16	0.55	14	8	-6
0021	2T	6_3	15	22	1	2200	1220	-980	0.05	0.55	3	2	-1
0021	2T	6_3	16	14	3	1400	2100	700	0.21	1.50	2	3	1
0021	2T	6_3	21	1	0	100	0	-100	0.00	0.00	0	0	0
0021	2T	6_3	23	3	0	300	0	-300	0.00	0.00	0	0	0
0021	2T	6_3	24	2	0	200	0	-200	0.00	0.00	0	0	0
0021	2T	6_3	25	2	0	200	0	-200	0.00	0.00	0	0	0
0021	2T	6_3	26	3	0	300	0	-300	0.00	0.00	0	0	0
0021	2T	6_4	12	3	1	300	560	260	0.33	1.87	0	0	0
0021	2T	6_4	13	6	1	600	290	-310	0.17	0.48	1	0	-1
0021	2T	6_4	14	2	0	200	0	-200	0.00	0.00	0	0	0
0021	2T	6_6	12	129	46	12900	10610	-2290	0.36	0.82	22	18	-4
0021	2T	6_6	13	23	5	2300	1410	-890	0.22	0.61	4	2	-2
0021	2T	6_6	14	4	1	400	410	10	0.25	1.03	0	0	0
0021	2T	6_6	21	1	0	100	0	-100	0.00	0.00	0	0	0
0021	2T	6_else	12	36	10	3600	2510	-1090	0.28	0.70	6	4	-2
0021	2T	6_else	13	13	4	1300	870	-430	0.31	0.67	2	1	-1
0021	2T	6_else	14	9	3	900	870	-30	0.33	0.97	1	1	0
0021	2T	6_else	15	1	0	100	0	-100	0.00	0.00	0	0	0
0021	2T	6_else	16	3	0	300	0	-300	0.00	0.00	0	0	0
0021	2T	7_3	12	3506	897	350600	287630	-62970	0.26	0.82	620	509	-111
0021	2T	7_3	13	1974	437	197400	145890	-51510	0.22	0.74	349	258	-91
0021	2T	7_3	14	1213	254	121300	93190	-28110	0.21	0.77	214	164	-50
0021	2T	7_3	15	382	62	38200	30850	-7350	0.16	0.81	67	54	-13
0021	2T	7_3	16	266	39	26600	24840	-1760	0.15	0.93	47	43	-4
0021	2T	7_3	21	8	0	800	0	-800	0.00	0.00	1	0	-1
0021	2T	7_3	23	65	9	6500	5740	-760	0.14	0.88	11	10	-1
0021	2T	7_3	24	30	2	3000	1990	-1010	0.07	0.66	5	3	-2
0021	2T	7_3	25	29	2	2900	1430	-1470	0.07	0.49	5	2	-3
0021	2T	7_3	26	40	0	4000	0	-4000	0.00	0.00	7	0	-7
0021	2T	7_4	12	1473	414	147300	119550	-27750	0.28	0.81	260	211	-49
0021	2T	7_4	13	512	109	51200	37550	-13650	0.21	0.73	90	66	-24
0021	2T	7_4	14	172	27	17200	11810	-5390	0.16	0.69	30	20	-10
0021	2T	7_4	15	23	2	2300	2330	30	0.09	1.01	4	4	0
0021	2T	7_4	16	9	2	900	2520	1620	0.22	2.80	1	4	3
0021	2T	7_4	21	1	0	100	0	-100	0.00	0.00	0	0	0
0021	2T	7_4	23	3	0	300	0	-300	0.00	0.00	0	0	0
0021	2T	7_4	24	3	0	300	0	-300	0.00	0.00	0	0	0
0021	2T	7_4	25	4	0	400	0	-400	0.00	0.00	0	0	0
0021	2T	7_4	26	1	0	100	0	-100	0.00	0.00	0	0	0
0021	2T	7_5	12	7	0	700	0	-700	0.00	0.00	1	0	-1
0021	2T	7_5	13	4	1	400	290	-110	0.25	0.73	0	0	0
0021	2T	7_5	14	3	1	300	560	260	0.33	1.87	0	0	0
0021	2T	7_5	15	1	0	100	0	-100	0.00	0.00	0	0	0
0021	2T	7_7	12	980	266	98000	75300	-22700	0.27	0.77	173	133	-40
0021	2T	7_7	13	73	15	7300	6110	-1190	0.21	0.84	12	10	-2
0021	2T	7_7	14	19	2	1900	810	-1090	0.11	0.43	3	1	-2
0021	2T	7_7	21	1	0	100	0	-100	0.00	0.00	0	0	0
0021	2T	7_7	23	1	0	100	0	-100	0.00	0.00	0	0	0
0021	2T	7_else	12	1142	345	114200	98120	-16080	0.30	0.86	202	173	-29
0021	2T	7_else	13	347	92	34700	30730	-3970	0.27	0.89	61	54	-7
0021	2T	7_else	14	100	20	10000	7370	-2630	0.20	0.74	17	13	-4
0021	2T	7_else	16	1	0	100	0	-100	0.00	0.00	0	0	0
0021	3F	1_1	123	531	127	53100	42540	-10560	0.24	0.80	93	75	-18
0021	3F	1_1	124	1124	273	112400	91520	-20880	0.24	0.81	198	161	-37
0021	3F	1_1	125	782	139	78200	65810	-12390	0.18	0.84	138	116	-22
0021	3F	1_1	126	895	110	89500	76430	-13070	0.12	0.85	158	135	-23
0021	3F	1_1	134	561	150	56100	42820	-13280	0.27	0.76	99	75	-24
0021	3F	1_1	135	438	81	43800	30920	-12880	0.18	0.71	77	54	-23
0021	3F	1_1	136	364	44	36400	29540	-6860	0.12	0.81	64	52	-12
0021	3F	1_1	145	166	33	16600	15050	-1550	0.20	0.91	29	26	-3
0021	3F	1_1	146	184	25	18400	16260	-2140	0.14	0.88	32	28	-4
0021	3F	1_1	156	28	5	2800	2020	-780	0.18	0.72	4	3	-1
0021	3F	1_1	234	15	3	1500	1560	60	0.20	1.04	2	2	0
0021	3F	1_1	235	42	10	4200	5310	1110	0.24	1.26	7	9	2
0021	3F	1_1	236	35	5	3500	2080	-1420	0.14	0.59	6	3	-3
0021	3F	1_1	245	51	4	5100	1460	-3640	0.08	0.29	9	2	-7
0021	3F	1_1	246	44	6	4400	5100	700	0.14	1.16	7	9	2
0021	3F	1_1	256	6	0	600	0	-600	0.00	0.00	1	0	-1
0021	3F	1_2	123	37	10	3700	2710	-990	0.27	0.73	6	4	-2
0021	3F	1_2	124	295	55	29500	21800	-7700	0.19	0.74	52	38	-14
0021	3F	1_2	125	177	26	17700	15390	-2310	0.15	0.87	31	27	-4
0021	3F	1_2	126	183	19	18300	19750	1450	0.10	1.08	32	34	2
0021	3F	1_2	134	132	26	13200	9950	-3250	0.20	0.75	23	17	-6
0021	3F	1_2	135	95	18	9500	9400	-100	0.19	0.99	16	16	0
0021	3F	1_2	136	67	7	6700	6720	20	0.10	1.00	11	11	0
0021	3F	1_2	145	14	2	1400	1120	-280	0.14	0.80	2	1	-1
0021	3F	1_2	146	26	2	2600	1200	-1400	0.08	0.46	4	2	-2
0021	3F	1_2	236	1	0	100	0	-100	0.00	0.00	0	0	0
0021	3F	1_2	245	2	0	200	0	-200	0.00	0.00	0	0	0
0021	3F	1_2	246	2	0	200	0	-200	0.00	0.00	0	0	0
0021	3F	1_3	123	1	0	100	0	-100	0.00	0.00	0	0	0
0021	3F	1_3	124	2	0	200	0	-200	0.00	0.00	0	0	0
0021	3F	1_3	125	1	0	100	0	-100	0.00	0.00	0	0	0
0021	3F	1_3	126	2	0	200	0	-200	0.00	0.00	0	0	0
0021	3F	1_3	136	1	1	100	550	450	1.00	5.50	0	0	0
0021	3F	1_4	123	2	1	200	230	30	0.50	1.15	0	0	0
0021	3F	1_4	124	113	18	11300	7610	-3690	0.16	0.67	20	13	-7
0021	3F	1_4	125	27	3	2700	1350	-1350	0.11	0.50	4	2	-2
0021	3F	1_4	126	152	12	15200	13580	-1620	0.08	0.89	26	24	-2
0021	3F	1_4	134	55	6	5500	3390	-2110	0.11	0.62	9	6	-3
0021	3F	1_4	135	42	6	4200	2940	-1260	0.14	0.70	7	5	-2
0021	3F	1_4	136	138	11	13800	11000	-2800	0.08	0.80	24	19	-5
0021	3F	1_4	145	9	1	900	340	-560	0.11	0.38	1	0	-1
0021	3F	1_4	146	11	1	1100	1250	150	0.09	1.14	1	2	1
0021	3F	1_5	123	18	4	1800	1730	-70	0.22	0.96	3	3	0
0021	3F	1_5	124	110	26	11000	7210	-3790	0.24	0.66	19	12	-7
0021	3F	1_5	125	79	9	7900	4390	-3510	0.11	0.56	13	7	-6
0021	3F	1_5	126	131	14	13100	13630	530	0.11	1.04	23	24	1
0021	3F	1_5	134	52	13	5200	4490	-710	0.25	0.86	9	7	-2
0021	3F	1_5	135	44	13	4400	5430	1030	0.30	1.23	7	9	2
0021	3F	1_5	136	62	7	6200	6390	190	0.11	1.03	10	11	1
0021	3F	1_5	145	20	2	2000	1470	-530	0.10	0.74	3	2	-1
0021	3F	1_5	146	24	1	2400	440	-1960	0.04	0.18	4	0	-4
0021	3F	1_5	156	3	0	300	0	-300	0.00	0.00	0	0	0
0021	3F	1_5	245	1	0	100	0	-100	0.00	0.00	0	0	0
0021	3F	1_else	123	1073	221	107300	82810	-24490	0.21	0.77	189	146	-43
0021	3F	1_else	124	200	31	20000	14830	-5170	0.16	0.74	35	26	-9
0021	3F	1_else	126	51	5	5100	3460	-1640	0.10	0.68	9	6	-3
0021	3F	1_else	134	166	25	16600	18880	2280	0.15	1.14	29	33	4
0021	3F	2_1	123	366	107	36600	29980	-6620	0.29	0.82	64	53	-11
0021	3F	2_1	124	713	181	71300	59760	-11540	0.25	0.84	126	105	-21
0021	3F	2_1	125	629	134	62900	54130	-8770	0.21	0.86	111	95	-16
0021	3F	2_1	126	798	144	79800	76330	-3470	0.18	0.96	141	135	-6
0021	3F	2_1	134	359	75	35900	23490	-12410	0.21	0.65	63	41	-22
0021	3F	2_1	135	388	87	38800	28680	-10120	0.22	0.74	68	50	-18
0021	3F	2_1	136	405	66	40500	30160	-10340	0.16	0.74	71	53	-18
0021	3F	2_1	145	189	41	18900	15220	-3680	0.22	0.81	33	26	-7
0021	3F	2_1	146	208	35	20800	20360	-440	0.17	0.98	36	36	0
0021	3F	2_1	156	71	12	7100	6150	-950	0.17	0.87	12	10	-2
0021	3F	2_1	234	26	4	2600	1640	-960	0.15	0.63	4	2	-2
0021	3F	2_1	235	28	8	2800	2940	140	0.29	1.05	4	5	1
0021	3F	2_1	236	44	7	4400	3520	-880	0.16	0.80	7	6	-1
0021	3F	2_1	245	32	3	3200	1180	-2020	0.09	0.37	5	2	-3
0021	3F	2_1	246	32	4	3200	1520	-1680	0.13	0.48	5	2	-3
0021	3F	2_1	256	21	4	2100	2970	870	0.19	1.41	3	5	2
0021	3F	2_2	123	45	13	4500	4590	90	0.29	1.02	7	8	1
0021	3F	2_2	124	208	47	20800	14750	-6050	0.23	0.71	36	26	-10
0021	3F	2_2	125	173	34	17300	15170	-2130	0.20	0.88	30	26	-4
0021	3F	2_2	126	229	31	22900	19570	-3330	0.14	0.85	40	34	-6
0021	3F	2_2	134	108	23	10800	7540	-3260	0.21	0.70	19	13	-6
0021	3F	2_2	135	106	23	10600	11300	700	0.22	1.07	18	20	2
0021	3F	2_2	136	163	22	16300	12560	-3740	0.13	0.77	28	22	-6
0021	3F	2_2	145	26	2	2600	680	-1920	0.08	0.26	4	1	-3
0021	3F	2_2	146	38	5	3800	2470	-1330	0.13	0.65	6	4	-2
0021	3F	2_2	156	6	0	600	0	-600	0.00	0.00	1	0	-1
0021	3F	2_2	234	1	1	100	390	290	1.00	3.90	0	0	0
0021	3F	2_2	236	1	1	100	360	260	1.00	3.60	0	0	0
0021	3F	2_3	124	1	0	100	0	-100	0.00	0.00	0	0	0
0021	3F	2_3	125	1	0	100	0	-100	0.00	0.00	0	0	0
0021	3F	2_3	126	3	0	300	0	-300	0.00	0.00	0	0	0
0021	3F	2_3	134	1	0	100	0	-100	0.00	0.00	0	0	0
0021	3F	2_3	136	2	0	200	0	-200	0.00	0.00	0	0	0
0021	3F	2_4	123	21	7	2100	1980	-120	0.33	0.94	3	3	0
0021	3F	2_4	124	126	36	12600	13960	1360	0.29	1.11	22	24	2
0021	3F	2_4	125	83	10	8300	5010	-3290	0.12	0.60	14	8	-6
0021	3F	2_4	126	106	5	10600	4600	-6000	0.05	0.43	18	8	-10
0021	3F	2_4	134	74	17	7400	6090	-1310	0.23	0.82	13	10	-3
0021	3F	2_4	135	74	15	7400	7010	-390	0.20	0.95	13	12	-1
0021	3F	2_4	136	75	4	7500	4140	-3360	0.05	0.55	13	7	-6
0021	3F	2_4	145	13	0	1300	0	-1300	0.00	0.00	2	0	-2
0021	3F	2_4	146	27	2	2700	2560	-140	0.07	0.95	4	4	0
0021	3F	2_4	156	4	1	400	1110	710	0.25	2.78	0	1	1
0021	3F	2_5	123	18	5	1800	1640	-160	0.28	0.91	3	2	-1
0021	3F	2_5	124	111	28	11100	9010	-2090	0.25	0.81	19	15	-4
0021	3F	2_5	125	83	16	8300	7050	-1250	0.19	0.85	14	12	-2
0021	3F	2_5	126	108	16	10800	11050	250	0.15	1.02	19	19	0
0021	3F	2_5	134	67	15	6700	6310	-390	0.22	0.94	11	11	0
0021	3F	2_5	135	46	8	4600	2430	-2170	0.17	0.53	8	4	-4
0021	3F	2_5	136	76	8	7600	6450	-1150	0.11	0.85	13	11	-2
0021	3F	2_5	145	24	4	2400	1950	-450	0.17	0.81	4	3	-1
0021	3F	2_5	146	25	2	2500	1020	-1480	0.08	0.41	4	1	-3
0021	3F	2_5	156	5	3	500	1990	1490	0.60	3.98	0	3	3
0021	3F	2_5	234	1	0	100	0	-100	0.00	0.00	0	0	0
0021	3F	2_5	236	1	0	100	0	-100	0.00	0.00	0	0	0
0021	3F	2_5	246	1	0	100	0	-100	0.00	0.00	0	0	0
0021	3F	2_else	123	777	200	77700	70890	-6810	0.26	0.91	137	125	-12
0021	3F	2_else	124	663	123	66300	50280	-16020	0.19	0.76	117	88	-29
0021	3F	2_else	125	36	5	3600	3780	180	0.14	1.05	6	6	0
0021	3F	2_else	126	33	5	3300	1960	-1340	0.15	0.59	5	3	-2
0021	3F	2_else	134	295	54	29500	19460	-10040	0.18	0.66	52	34	-18
0021	3F	2_else	135	13	2	1300	730	-570	0.15	0.56	2	1	-1
0021	3F	2_else	136	9	2	900	920	20	0.22	1.02	1	1	0
0021	3F	2_else	146	6	1	600	310	-290	0.17	0.52	1	0	-1
0021	3F	3_1	123	324	99	32400	27800	-4600	0.31	0.86	57	49	-8
0021	3F	3_1	124	595	141	59500	42770	-16730	0.24	0.72	105	75	-30
0021	3F	3_1	125	537	114	53700	43020	-10680	0.21	0.80	95	76	-19
0021	3F	3_1	126	689	111	68900	59590	-9310	0.16	0.86	121	105	-16
0021	3F	3_1	134	286	75	28600	24460	-4140	0.26	0.86	50	43	-7
0021	3F	3_1	135	334	72	33400	23970	-9430	0.22	0.72	59	42	-17
0021	3F	3_1	136	402	63	40200	28530	-11670	0.16	0.71	71	50	-21
0021	3F	3_1	145	229	45	22900	17930	-4970	0.20	0.78	40	31	-9
0021	3F	3_1	146	166	20	16600	10420	-6180	0.12	0.63	29	18	-11
0021	3F	3_1	156	109	17	10900	9080	-1820	0.16	0.83	19	16	-3
0021	3F	3_1	234	23	7	2300	2430	130	0.30	1.06	4	4	0
0021	3F	3_1	235	47	8	4700	2760	-1940	0.17	0.59	8	4	-4
0021	3F	3_1	236	44	7	4400	5760	1360	0.16	1.31	7	10	3
0021	3F	3_1	245	32	9	3200	3950	750	0.28	1.23	5	6	1
0021	3F	3_1	246	19	3	1900	1080	-820	0.16	0.57	3	1	-2
0021	3F	3_1	256	28	4	2800	1990	-810	0.14	0.71	4	3	-1
0021	3F	3_2	123	33	15	3300	4400	1100	0.45	1.33	5	7	2
0021	3F	3_2	124	161	33	16100	9380	-6720	0.20	0.58	28	16	-12
0021	3F	3_2	125	149	20	14900	8150	-6750	0.13	0.55	26	14	-12
0021	3F	3_2	126	185	24	18500	12090	-6410	0.13	0.65	32	21	-11
0021	3F	3_2	134	74	20	7400	6000	-1400	0.27	0.81	13	10	-3
0021	3F	3_2	135	121	23	12100	8700	-3400	0.19	0.72	21	15	-6
0021	3F	3_2	136	131	10	13100	6480	-6620	0.08	0.49	23	11	-12
0021	3F	3_2	145	39	6	3900	2610	-1290	0.15	0.67	6	4	-2
0021	3F	3_2	146	31	8	3100	4550	1450	0.26	1.47	5	8	3
0021	3F	3_2	156	4	0	400	0	-400	0.00	0.00	0	0	0
0021	3F	3_2	234	2	0	200	0	-200	0.00	0.00	0	0	0
0021	3F	3_2	236	1	0	100	0	-100	0.00	0.00	0	0	0
0021	3F	3_3	123	44	13	4400	3660	-740	0.30	0.83	7	6	-1
0021	3F	3_3	124	81	18	8100	4820	-3280	0.22	0.60	14	8	-6
0021	3F	3_3	125	99	18	9900	7930	-1970	0.18	0.80	17	14	-3
0021	3F	3_3	126	48	5	4800	2680	-2120	0.10	0.56	8	4	-4
0021	3F	3_3	134	59	13	5900	4380	-1520	0.22	0.74	10	7	-3
0021	3F	3_3	135	50	5	5000	2600	-2400	0.10	0.52	8	4	-4
0021	3F	3_3	136	40	3	4000	1300	-2700	0.08	0.33	7	2	-5
0021	3F	3_3	145	52	4	5200	1190	-4010	0.08	0.23	9	2	-7
0021	3F	3_3	146	17	2	1700	1010	-690	0.12	0.59	3	1	-2
0021	3F	3_3	156	5	0	500	0	-500	0.00	0.00	0	0	0
0021	3F	3_3	234	3	1	300	360	60	0.33	1.20	0	0	0
0021	3F	3_3	235	5	1	500	470	-30	0.20	0.94	0	0	0
0021	3F	3_3	236	5	1	500	380	-120	0.20	0.76	0	0	0
0021	3F	3_3	245	5	0	500	0	-500	0.00	0.00	0	0	0
0021	3F	3_3	246	3	0	300	0	-300	0.00	0.00	0	0	0
0021	3F	3_4	123	25	6	2500	1810	-690	0.24	0.72	4	3	-1
0021	3F	3_4	124	150	33	15000	13710	-1290	0.22	0.91	26	24	-2
0021	3F	3_4	125	83	8	8300	3630	-4670	0.10	0.44	14	6	-8
0021	3F	3_4	126	92	6	9200	5850	-3350	0.07	0.64	16	10	-6
0021	3F	3_4	134	66	13	6600	4780	-1820	0.20	0.72	11	8	-3
0021	3F	3_4	135	68	12	6800	3730	-3070	0.18	0.55	12	6	-6
0021	3F	3_4	136	63	7	6300	4750	-1550	0.11	0.75	11	8	-3
0021	3F	3_4	145	21	2	2100	570	-1530	0.10	0.27	3	1	-2
0021	3F	3_4	146	12	1	1200	440	-760	0.08	0.37	2	0	-2
0021	3F	3_4	156	1	1	100	750	650	1.00	7.50	0	1	1
0021	3F	3_5	123	25	10	2500	2420	-80	0.40	0.97	4	4	0
0021	3F	3_5	124	111	30	11100	9840	-1260	0.27	0.89	19	17	-2
0021	3F	3_5	125	80	15	8000	5820	-2180	0.19	0.73	14	10	-4
0021	3F	3_5	126	61	7	6100	3610	-2490	0.11	0.59	10	6	-4
0021	3F	3_5	134	67	11	6700	4220	-2480	0.16	0.63	11	7	-4
0021	3F	3_5	135	53	6	5300	3010	-2290	0.11	0.57	9	5	-4
0021	3F	3_5	136	62	10	6200	6810	610	0.16	1.10	10	12	2
0021	3F	3_5	145	32	5	3200	1860	-1340	0.16	0.58	5	3	-2
0021	3F	3_5	146	17	2	1700	2060	360	0.12	1.21	3	3	0
0021	3F	3_5	156	2	0	200	0	-200	0.00	0.00	0	0	0
0021	3F	3_5	236	1	0	100	0	-100	0.00	0.00	0	0	0
0021	3F	3_5	245	1	0	100	0	-100	0.00	0.00	0	0	0
0021	3F	3_5	256	2	0	200	0	-200	0.00	0.00	0	0	0
0021	3F	3_6	123	32	11	3200	2310	-890	0.34	0.72	5	4	-1
0021	3F	3_6	124	116	20	11600	6140	-5460	0.17	0.53	20	10	-10
0021	3F	3_6	125	57	7	5700	3060	-2640	0.12	0.54	10	5	-5
0021	3F	3_6	126	30	5	3000	3180	180	0.17	1.06	5	5	0
0021	3F	3_6	134	30	4	3000	1750	-1250	0.13	0.58	5	3	-2
0021	3F	3_6	135	25	5	2500	3390	890	0.20	1.36	4	6	2
0021	3F	3_6	136	9	0	900	0	-900	0.00	0.00	1	0	-1
0021	3F	3_6	145	4	0	400	0	-400	0.00	0.00	0	0	0
0021	3F	3_6	146	3	0	300	0	-300	0.00	0.00	0	0	0
0021	3F	3_else	123	325	86	32500	22230	-10270	0.26	0.68	57	39	-18
0021	3F	3_else	124	486	100	48600	34490	-14110	0.21	0.71	86	61	-25
0021	3F	3_else	125	202	36	20200	16070	-4130	0.18	0.80	35	28	-7
0021	3F	3_else	126	126	23	12600	13260	660	0.18	1.05	22	23	1
0021	3F	3_else	134	159	30	15900	10750	-5150	0.19	0.68	28	19	-9
0021	3F	3_else	135	89	23	8900	8860	-40	0.26	1.00	15	15	0
0021	3F	3_else	136	61	9	6100	3480	-2620	0.15	0.57	10	6	-4
0021	3F	3_else	145	33	6	3300	1720	-1580	0.18	0.52	5	3	-2
0021	3F	3_else	146	16	2	1600	1130	-470	0.13	0.71	2	2	0
0021	3F	3_else	156	6	0	600	0	-600	0.00	0.00	1	0	-1
0021	3F	3_else	234	1	0	100	0	-100	0.00	0.00	0	0	0
0021	3F	3_else	235	2	1	200	360	160	0.50	1.80	0	0	0
0021	3F	3_else	256	1	0	100	0	-100	0.00	0.00	0	0	0
0021	3F	4_1	123	181	60	18100	16680	-1420	0.33	0.92	32	29	-3
0021	3F	4_1	124	424	107	42400	34230	-8170	0.25	0.81	75	60	-15
0021	3F	4_1	125	371	91	37100	36180	-920	0.25	0.98	65	64	-1
0021	3F	4_1	126	355	52	35500	30270	-5230	0.15	0.85	62	53	-9
0021	3F	4_1	134	244	69	24400	19070	-5330	0.28	0.78	43	33	-10
0021	3F	4_1	135	254	54	25400	19130	-6270	0.21	0.75	44	33	-11
0021	3F	4_1	136	208	32	20800	16110	-4690	0.15	0.77	36	28	-8
0021	3F	4_1	145	117	20	11700	8390	-3310	0.17	0.72	20	14	-6
0021	3F	4_1	146	89	11	8900	8240	-660	0.12	0.93	15	14	-1
0021	3F	4_1	156	51	7	5100	3780	-1320	0.14	0.74	9	6	-3
0021	3F	4_1	234	16	3	1600	810	-790	0.19	0.51	2	1	-1
0021	3F	4_1	235	49	6	4900	1640	-3260	0.12	0.33	8	2	-6
0021	3F	4_1	236	37	6	3700	4600	900	0.16	1.24	6	8	2
0021	3F	4_1	245	25	4	2500	1310	-1190	0.16	0.52	4	2	-2
0021	3F	4_1	246	18	1	1800	610	-1190	0.06	0.34	3	1	-2
0021	3F	4_1	256	20	3	2000	1400	-600	0.15	0.70	3	2	-1
0021	3F	4_2	123	25	7	2500	1960	-540	0.28	0.78	4	3	-1
0021	3F	4_2	124	85	20	8500	6610	-1890	0.24	0.78	15	11	-4
0021	3F	4_2	125	75	17	7500	8200	700	0.23	1.09	13	14	1
0021	3F	4_2	126	59	10	5900	7980	2080	0.17	1.35	10	14	4
0021	3F	4_2	134	50	16	5000	5070	70	0.32	1.01	8	8	0
0021	3F	4_2	135	53	13	5300	5260	-40	0.25	0.99	9	9	0
0021	3F	4_2	136	48	10	4800	9540	4740	0.21	1.99	8	16	8
0021	3F	4_2	145	15	2	1500	740	-760	0.13	0.49	2	1	-1
0021	3F	4_2	146	24	3	2400	2510	110	0.13	1.05	4	4	0
0021	3F	4_2	156	2	0	200	0	-200	0.00	0.00	0	0	0
0021	3F	4_3	123	79	21	7900	5820	-2080	0.27	0.74	13	10	-3
0021	3F	4_3	124	192	33	19200	8730	-10470	0.17	0.45	33	15	-18
0021	3F	4_3	125	153	26	15300	10430	-4870	0.17	0.68	27	18	-9
0021	3F	4_3	126	95	9	9500	5640	-3860	0.09	0.59	16	9	-7
0021	3F	4_3	134	128	28	12800	9020	-3780	0.22	0.70	22	15	-7
0021	3F	4_3	135	101	28	10100	10600	500	0.28	1.05	17	18	1
0021	3F	4_3	136	73	10	7300	3070	-4230	0.14	0.42	12	5	-7
0021	3F	4_3	145	66	8	6600	3140	-3460	0.12	0.48	11	5	-6
0021	3F	4_3	146	36	3	3600	2240	-1360	0.08	0.62	6	3	-3
0021	3F	4_3	156	11	3	1100	1430	330	0.27	1.30	1	2	1
0021	3F	4_3	234	13	4	1300	2460	1160	0.31	1.89	2	4	2
0021	3F	4_3	235	22	4	2200	1730	-470	0.18	0.79	3	3	0
0021	3F	4_3	236	10	3	1000	1320	320	0.30	1.32	1	2	1
0021	3F	4_3	245	17	3	1700	1520	-180	0.18	0.89	3	2	-1
0021	3F	4_3	246	6	0	600	0	-600	0.00	0.00	1	0	-1
0021	3F	4_3	256	5	0	500	0	-500	0.00	0.00	0	0	0
0021	3F	4_4	123	25	5	2500	1680	-820	0.20	0.67	4	2	-2
0021	3F	4_4	124	110	21	11000	8320	-2680	0.19	0.76	19	14	-5
0021	3F	4_4	125	73	7	7300	2700	-4600	0.10	0.37	12	4	-8
0021	3F	4_4	126	51	5	5100	2240	-2860	0.10	0.44	9	3	-6
0021	3F	4_4	134	44	11	4400	3890	-510	0.25	0.88	7	6	-1
0021	3F	4_4	135	48	7	4800	3430	-1370	0.15	0.71	8	6	-2
0021	3F	4_4	136	30	3	3000	1210	-1790	0.10	0.40	5	2	-3
0021	3F	4_4	145	8	0	800	0	-800	0.00	0.00	1	0	-1
0021	3F	4_4	146	8	0	800	0	-800	0.00	0.00	1	0	-1
0021	3F	4_4	156	2	0	200	0	-200	0.00	0.00	0	0	0
0021	3F	4_5	123	25	5	2500	1220	-1280	0.20	0.49	4	2	-2
0021	3F	4_5	124	88	16	8800	5500	-3300	0.18	0.63	15	9	-6
0021	3F	4_5	125	67	14	6700	5510	-1190	0.21	0.82	11	9	-2
0021	3F	4_5	126	40	2	4000	1200	-2800	0.05	0.30	7	2	-5
0021	3F	4_5	134	56	10	5600	3310	-2290	0.18	0.59	9	5	-4
0021	3F	4_5	135	46	12	4600	4890	290	0.26	1.06	8	8	0
0021	3F	4_5	136	24	3	2400	1580	-820	0.13	0.66	4	2	-2
0021	3F	4_5	145	14	3	1400	1950	550	0.21	1.39	2	3	1
0021	3F	4_5	146	8	0	800	0	-800	0.00	0.00	1	0	-1
0021	3F	4_5	156	2	1	200	380	180	0.50	1.90	0	0	0
0021	3F	4_6	123	56	15	5600	3550	-2050	0.27	0.63	9	6	-3
0021	3F	4_6	124	209	33	20900	10650	-10250	0.16	0.51	36	18	-18
0021	3F	4_6	125	93	14	9300	7100	-2200	0.15	0.76	16	12	-4
0021	3F	4_6	126	54	3	5400	4060	-1340	0.06	0.75	9	7	-2
0021	3F	4_6	134	66	11	6600	6130	-470	0.17	0.93	11	10	-1
0021	3F	4_6	135	38	4	3800	4270	470	0.11	1.12	6	7	1
0021	3F	4_6	136	21	1	2100	220	-1880	0.05	0.10	3	0	-3
0021	3F	4_6	145	12	0	1200	0	-1200	0.00	0.00	2	0	-2
0021	3F	4_6	146	6	0	600	0	-600	0.00	0.00	1	0	-1
0021	3F	4_6	234	1	0	100	0	-100	0.00	0.00	0	0	0
0021	3F	4_6	235	1	0	100	0	-100	0.00	0.00	0	0	0
0021	3F	4_else	123	1106	259	110600	98960	-11640	0.23	0.89	195	175	-20
0021	3F	4_else	124	104	13	10400	4590	-5810	0.13	0.44	18	8	-10
0021	3F	4_else	125	6	3	600	1860	1260	0.50	3.10	1	3	2
0021	3F	4_else	126	44	6	4400	7250	2850	0.14	1.65	7	12	5
0021	3F	4_else	134	105	17	10500	8590	-1910	0.16	0.82	18	15	-3
0021	3F	4_else	135	3	0	300	0	-300	0.00	0.00	0	0	0
0021	3F	4_else	136	5	0	500	0	-500	0.00	0.00	0	0	0
0021	3F	4_else	145	1	0	100	0	-100	0.00	0.00	0	0	0
0021	3F	4_else	146	2	1	200	520	320	0.50	2.60	0	0	0
0021	3F	5_1	123	8	3	800	620	-180	0.38	0.78	1	1	0
0021	3F	5_1	124	27	7	2700	1680	-1020	0.26	0.62	4	2	-2
0021	3F	5_1	125	9	4	900	1060	160	0.44	1.18	1	1	0
0021	3F	5_1	126	9	2	900	530	-370	0.22	0.59	1	0	-1
0021	3F	5_1	134	17	8	1700	2170	470	0.47	1.28	3	3	0
0021	3F	5_1	135	9	1	900	470	-430	0.11	0.52	1	0	-1
0021	3F	5_1	136	11	2	1100	620	-480	0.18	0.56	1	1	0
0021	3F	5_1	145	7	2	700	620	-80	0.29	0.89	1	1	0
0021	3F	5_1	146	4	0	400	0	-400	0.00	0.00	0	0	0
0021	3F	5_1	156	4	0	400	0	-400	0.00	0.00	0	0	0
0021	3F	5_1	235	1	0	100	0	-100	0.00	0.00	0	0	0
0021	3F	5_1	246	2	0	200	0	-200	0.00	0.00	0	0	0
0021	3F	5_2	124	1	1	100	330	230	1.00	3.30	0	0	0
0021	3F	5_2	125	2	0	200	0	-200	0.00	0.00	0	0	0
0021	3F	5_2	126	1	0	100	0	-100	0.00	0.00	0	0	0
0021	3F	5_2	134	4	0	400	0	-400	0.00	0.00	0	0	0
0021	3F	5_3	123	231	67	23100	17060	-6040	0.29	0.74	40	30	-10
0021	3F	5_3	124	581	145	58100	44810	-13290	0.25	0.77	102	79	-23
0021	3F	5_3	125	436	79	43600	29500	-14100	0.18	0.68	77	52	-25
0021	3F	5_3	126	378	70	37800	34110	-3690	0.19	0.90	66	60	-6
0021	3F	5_3	134	321	76	32100	23830	-8270	0.24	0.74	56	42	-14
0021	3F	5_3	135	281	54	28100	20450	-7650	0.19	0.73	49	36	-13
0021	3F	5_3	136	236	42	23600	19460	-4140	0.18	0.82	41	34	-7
0021	3F	5_3	145	210	47	21000	17430	-3570	0.22	0.83	37	30	-7
0021	3F	5_3	146	126	24	12600	11080	-1520	0.19	0.88	22	19	-3
0021	3F	5_3	156	45	4	4500	1810	-2690	0.09	0.40	7	3	-4
0021	3F	5_3	234	8	1	800	390	-410	0.13	0.49	1	0	-1
0021	3F	5_3	235	9	1	900	620	-280	0.11	0.69	1	1	0
0021	3F	5_3	236	8	1	800	290	-510	0.13	0.36	1	0	-1
0021	3F	5_3	245	4	0	400	0	-400	0.00	0.00	0	0	0
0021	3F	5_3	246	7	1	700	430	-270	0.14	0.61	1	0	-1
0021	3F	5_3	256	3	0	300	0	-300	0.00	0.00	0	0	0
0021	3F	5_4	123	1	0	100	0	-100	0.00	0.00	0	0	0
0021	3F	5_4	124	6	0	600	0	-600	0.00	0.00	1	0	-1
0021	3F	5_4	125	2	0	200	0	-200	0.00	0.00	0	0	0
0021	3F	5_4	126	1	1	100	710	610	1.00	7.10	0	1	1
0021	3F	5_4	135	2	0	200	0	-200	0.00	0.00	0	0	0
0021	3F	5_4	146	1	0	100	0	-100	0.00	0.00	0	0	0
0021	3F	5_5	125	1	0	100	0	-100	0.00	0.00	0	0	0
0021	3F	5_5	126	1	0	100	0	-100	0.00	0.00	0	0	0
0021	3F	5_5	135	1	0	100	0	-100	0.00	0.00	0	0	0
0021	3F	5_5	136	1	0	100	0	-100	0.00	0.00	0	0	0
0021	3F	5_6	123	325	99	32500	23650	-8850	0.30	0.73	57	41	-16
0021	3F	5_6	124	883	175	88300	63380	-24920	0.20	0.72	156	112	-44
0021	3F	5_6	125	177	22	17700	12030	-5670	0.12	0.68	31	21	-10
0021	3F	5_6	126	91	12	9100	12070	2970	0.13	1.33	16	21	5
0021	3F	5_6	134	175	29	17500	12750	-4750	0.17	0.73	30	22	-8
0021	3F	5_6	135	84	5	8400	3330	-5070	0.06	0.40	14	5	-9
0021	3F	5_6	136	35	3	3500	2810	-690	0.09	0.80	6	4	-2
0021	3F	5_6	145	6	0	600	0	-600	0.00	0.00	1	0	-1
0021	3F	5_6	146	5	0	500	0	-500	0.00	0.00	0	0	0
0021	3F	5_6	234	2	0	200	0	-200	0.00	0.00	0	0	0
0021	3F	5_6	235	3	0	300	0	-300	0.00	0.00	0	0	0
0021	3F	5_6	246	1	0	100	0	-100	0.00	0.00	0	0	0
0021	3F	5_else	123	756	188	75600	67100	-8500	0.25	0.89	133	118	-15
0021	3F	5_else	124	207	33	20700	16840	-3860	0.16	0.81	36	29	-7
0021	3F	5_else	125	9	0	900	0	-900	0.00	0.00	1	0	-1
0021	3F	5_else	126	29	3	2900	1580	-1320	0.10	0.54	5	2	-3
0021	3F	5_else	134	102	14	10200	5920	-4280	0.14	0.58	18	10	-8
0021	3F	5_else	135	3	1	300	420	120	0.33	1.40	0	0	0
0021	3F	5_else	136	11	1	1100	660	-440	0.09	0.60	1	1	0
0021	3F	6_3	123	21	4	2100	1170	-930	0.19	0.56	3	2	-1
0021	3F	6_3	124	48	13	4800	4240	-560	0.27	0.88	8	7	-1
0021	3F	6_3	125	32	6	3200	3120	-80	0.19	0.98	5	5	0
0021	3F	6_3	126	37	8	3700	3010	-690	0.22	0.81	6	5	-1
0021	3F	6_3	134	23	9	2300	2670	370	0.39	1.16	4	4	0
0021	3F	6_3	135	19	4	1900	1790	-110	0.21	0.94	3	3	0
0021	3F	6_3	136	25	1	2500	400	-2100	0.04	0.16	4	0	-4
0021	3F	6_3	145	20	1	2000	230	-1770	0.05	0.12	3	0	-3
0021	3F	6_3	146	12	4	1200	4180	2980	0.33	3.48	2	7	5
0021	3F	6_3	156	4	0	400	0	-400	0.00	0.00	0	0	0
0021	3F	6_3	234	1	0	100	0	-100	0.00	0.00	0	0	0
0021	3F	6_3	235	1	0	100	0	-100	0.00	0.00	0	0	0
0021	3F	6_4	123	1	0	100	0	-100	0.00	0.00	0	0	0
0021	3F	6_4	124	1	0	100	0	-100	0.00	0.00	0	0	0
0021	3F	6_4	125	1	0	100	0	-100	0.00	0.00	0	0	0
0021	3F	6_4	134	1	0	100	0	-100	0.00	0.00	0	0	0
0021	3F	6_4	135	2	0	200	0	-200	0.00	0.00	0	0	0
0021	3F	6_4	145	1	0	100	0	-100	0.00	0.00	0	0	0
0021	3F	6_6	123	37	12	3700	3850	150	0.32	1.04	6	6	0
0021	3F	6_6	124	78	14	7800	5730	-2070	0.18	0.73	13	10	-3
0021	3F	6_6	125	7	1	700	400	-300	0.14	0.57	1	0	-1
0021	3F	6_6	126	7	0	700	0	-700	0.00	0.00	1	0	-1
0021	3F	6_6	134	8	1	800	220	-580	0.13	0.28	1	0	-1
0021	3F	6_6	135	11	1	1100	570	-530	0.09	0.52	1	1	0
0021	3F	6_6	136	1	0	100	0	-100	0.00	0.00	0	0	0
0021	3F	6_else	123	9	3	900	1230	330	0.33	1.37	1	2	1
0021	3F	6_else	124	13	3	1300	840	-460	0.23	0.65	2	1	-1
0021	3F	6_else	125	6	1	600	300	-300	0.17	0.50	1	0	-1
0021	3F	6_else	126	5	1	500	400	-100	0.20	0.80	0	0	0
0021	3F	6_else	134	3	0	300	0	-300	0.00	0.00	0	0	0
0021	3F	6_else	135	3	1	300	150	-150	0.33	0.50	0	0	0
0021	3F	6_else	145	3	2	300	630	330	0.67	2.10	0	1	1
0021	3F	6_else	146	1	0	100	0	-100	0.00	0.00	0	0	0
0021	3F	7_3	123	675	183	67500	55450	-12050	0.27	0.82	119	98	-21
0021	3F	7_3	124	1063	257	106300	81850	-24450	0.24	0.77	188	144	-44
0021	3F	7_3	125	808	159	80800	62780	-18020	0.20	0.78	143	111	-32
0021	3F	7_3	126	658	119	65800	62700	-3100	0.18	0.95	116	110	-6
0021	3F	7_3	134	505	105	50500	36650	-13850	0.21	0.73	89	64	-25
0021	3F	7_3	135	440	54	44000	19330	-24670	0.12	0.44	77	34	-43
0021	3F	7_3	136	413	62	41300	36230	-5070	0.15	0.88	73	64	-9
0021	3F	7_3	145	197	31	19700	13210	-6490	0.16	0.67	34	23	-11
0021	3F	7_3	146	181	26	18100	16430	-1670	0.14	0.91	32	29	-3
0021	3F	7_3	156	62	6	6200	2710	-3490	0.10	0.44	10	4	-6
0021	3F	7_3	234	19	2	1900	920	-980	0.11	0.48	3	1	-2
0021	3F	7_3	235	15	3	1500	1270	-230	0.20	0.85	2	2	0
0021	3F	7_3	236	11	2	1100	1860	760	0.18	1.69	1	3	2
0021	3F	7_3	245	7	1	700	440	-260	0.14	0.63	1	0	-1
0021	3F	7_3	246	7	2	700	960	260	0.29	1.37	1	1	0
0021	3F	7_3	256	3	0	300	0	-300	0.00	0.00	0	0	0
0021	3F	7_4	123	328	96	32800	26470	-6330	0.29	0.81	58	46	-12
0021	3F	7_4	124	715	143	71500	51940	-19560	0.20	0.73	126	91	-35
0021	3F	7_4	125	271	36	27100	17290	-9810	0.13	0.64	47	30	-17
0021	3F	7_4	126	153	13	15300	10820	-4480	0.08	0.71	27	19	-8
0021	3F	7_4	134	222	45	22200	18680	-3520	0.20	0.84	39	33	-6
0021	3F	7_4	135	133	15	13300	8720	-4580	0.11	0.66	23	15	-8
0021	3F	7_4	136	65	1	6500	540	-5960	0.02	0.08	11	0	-11
0021	3F	7_4	145	36	3	3600	2320	-1280	0.08	0.64	6	4	-2
0021	3F	7_4	146	25	3	2500	2840	340	0.12	1.14	4	5	1
0021	3F	7_4	156	8	0	800	0	-800	0.00	0.00	1	0	-1
0021	3F	7_4	234	2	1	200	770	570	0.50	3.85	0	1	1
0021	3F	7_4	235	1	0	100	0	-100	0.00	0.00	0	0	0
0021	3F	7_4	245	1	0	100	0	-100	0.00	0.00	0	0	0
0021	3F	7_4	256	2	0	200	0	-200	0.00	0.00	0	0	0
0021	3F	7_5	124	5	1	500	190	-310	0.20	0.38	0	0	0
0021	3F	7_5	126	1	0	100	0	-100	0.00	0.00	0	0	0
0021	3F	7_5	134	2	1	200	220	20	0.50	1.10	0	0	0
0021	3F	7_7	123	153	27	15300	8790	-6510	0.18	0.57	27	15	-12
0021	3F	7_7	124	690	112	69000	45120	-23880	0.16	0.65	122	79	-43
0021	3F	7_7	125	38	4	3800	1840	-1960	0.11	0.48	6	3	-3
0021	3F	7_7	126	91	9	9100	11380	2280	0.10	1.25	16	20	4
0021	3F	7_7	134	40	7	4000	3490	-510	0.18	0.87	7	6	-1
0021	3F	7_7	135	13	0	1300	0	-1300	0.00	0.00	2	0	-2
0021	3F	7_7	136	14	0	1400	0	-1400	0.00	0.00	2	0	-2
0021	3F	7_7	145	5	1	500	280	-220	0.20	0.56	0	0	0
0021	3F	7_7	146	1	0	100	0	-100	0.00	0.00	0	0	0
0021	3F	7_7	235	1	0	100	0	-100	0.00	0.00	0	0	0
0021	3F	7_else	123	915	225	91500	77300	-14200	0.25	0.84	161	136	-25
0021	3F	7_else	124	169	25	16900	12660	-4240	0.15	0.75	29	22	-7
0021	3F	7_else	125	19	3	1900	1290	-610	0.16	0.68	3	2	-1
0021	3F	7_else	126	38	6	3800	4250	450	0.16	1.12	6	7	1
0021	3F	7_else	134	152	21	15200	12290	-2910	0.14	0.81	26	21	-5
0021	3F	7_else	135	7	2	700	550	-150	0.29	0.79	1	0	-1
0021	3F	7_else	136	12	1	1200	340	-860	0.08	0.28	2	0	-2
0021	3F	7_else	145	5	0	500	0	-500	0.00	0.00	0	0	0
0021	3F	7_else	146	1	0	100	0	-100	0.00	0.00	0	0	0
0021	3T	1_1	123	528	44	52800	34100	-18700	0.08	0.65	93	60	-33
0021	3T	1_1	124	1103	94	110300	85040	-25260	0.09	0.77	195	150	-45
0021	3T	1_1	125	735	53	73500	62920	-10580	0.07	0.86	130	111	-19
0021	3T	1_1	126	752	33	75200	78410	3210	0.04	1.04	133	138	5
0021	3T	1_1	132	3	0	300	0	-300	0.00	0.00	0	0	0
0021	3T	1_1	134	551	47	55100	33840	-21260	0.09	0.61	97	59	-38
0021	3T	1_1	135	434	36	43400	33920	-9480	0.08	0.78	76	60	-16
0021	3T	1_1	136	357	17	35700	28710	-6990	0.05	0.80	63	50	-13
0021	3T	1_1	142	1	0	100	0	-100	0.00	0.00	0	0	0
0021	3T	1_1	143	10	0	1000	0	-1000	0.00	0.00	1	0	-1
0021	3T	1_1	145	165	16	16500	25580	9080	0.10	1.55	29	45	16
0021	3T	1_1	146	182	9	18200	18160	-40	0.05	1.00	32	32	0
0021	3T	1_1	152	1	0	100	0	-100	0.00	0.00	0	0	0
0021	3T	1_1	153	4	0	400	0	-400	0.00	0.00	0	0	0
0021	3T	1_1	154	1	1	100	2120	2020	1.00	21.20	0	3	3
0021	3T	1_1	156	22	1	2200	2750	550	0.05	1.25	3	4	1
0021	3T	1_1	163	7	0	700	0	-700	0.00	0.00	1	0	-1
0021	3T	1_1	164	2	1	200	1260	1060	0.50	6.30	0	2	2
0021	3T	1_1	165	6	0	600	0	-600	0.00	0.00	1	0	-1
0021	3T	1_1	214	20	0	2000	0	-2000	0.00	0.00	3	0	-3
0021	3T	1_1	215	46	1	4600	2080	-2520	0.02	0.45	8	3	-5
0021	3T	1_1	216	143	4	14300	9130	-5170	0.03	0.64	25	16	-9
0021	3T	1_1	234	15	2	1500	3500	2000	0.13	2.33	2	6	4
0021	3T	1_1	235	41	4	4100	6700	2600	0.10	1.63	7	11	4
0021	3T	1_1	236	35	4	3500	3770	270	0.11	1.08	6	6	0
0021	3T	1_1	245	51	0	5100	0	-5100	0.00	0.00	9	0	-9
0021	3T	1_1	246	44	2	4400	4460	60	0.05	1.01	7	7	0
0021	3T	1_1	253	1	0	100	0	-100	0.00	0.00	0	0	0
0021	3T	1_1	256	5	0	500	0	-500	0.00	0.00	0	0	0
0021	3T	1_1	265	1	0	100	0	-100	0.00	0.00	0	0	0
0021	3T	1_2	123	37	7	3700	4920	1220	0.19	1.33	6	8	2
0021	3T	1_2	124	294	26	29400	25240	-4160	0.09	0.86	52	44	-8
0021	3T	1_2	125	175	14	17500	20750	3250	0.08	1.19	30	36	6
0021	3T	1_2	126	179	8	17900	15480	-2420	0.04	0.86	31	27	-4
0021	3T	1_2	134	132	15	13200	13490	290	0.11	1.02	23	23	0
0021	3T	1_2	135	95	7	9500	8810	-690	0.07	0.93	16	15	-1
0021	3T	1_2	136	67	4	6700	7830	1130	0.06	1.17	11	13	2
0021	3T	1_2	145	14	2	1400	2720	1320	0.14	1.94	2	4	2
0021	3T	1_2	146	26	0	2600	0	-2600	0.00	0.00	4	0	-4
0021	3T	1_2	214	1	0	100	0	-100	0.00	0.00	0	0	0
0021	3T	1_2	215	2	0	200	0	-200	0.00	0.00	0	0	0
0021	3T	1_2	216	4	0	400	0	-400	0.00	0.00	0	0	0
0021	3T	1_2	236	1	0	100	0	-100	0.00	0.00	0	0	0
0021	3T	1_2	245	2	0	200	0	-200	0.00	0.00	0	0	0
0021	3T	1_2	246	2	0	200	0	-200	0.00	0.00	0	0	0
0021	3T	1_3	123	1	0	100	0	-100	0.00	0.00	0	0	0
0021	3T	1_3	124	2	0	200	0	-200	0.00	0.00	0	0	0
0021	3T	1_3	125	1	0	100	0	-100	0.00	0.00	0	0	0
0021	3T	1_3	126	2	0	200	0	-200	0.00	0.00	0	0	0
0021	3T	1_3	136	1	0	100	0	-100	0.00	0.00	0	0	0
0021	3T	1_4	123	2	1	200	390	190	0.50	1.95	0	0	0
0021	3T	1_4	124	113	7	11300	6020	-5280	0.06	0.53	20	10	-10
0021	3T	1_4	125	27	1	2700	480	-2220	0.04	0.18	4	0	-4
0021	3T	1_4	126	152	10	15200	22160	6960	0.07	1.46	26	39	13
0021	3T	1_4	134	55	2	5500	3070	-2430	0.04	0.56	9	5	-4
0021	3T	1_4	135	42	1	4200	1070	-3130	0.02	0.25	7	1	-6
0021	3T	1_4	136	138	6	13800	11560	-2240	0.04	0.84	24	20	-4
0021	3T	1_4	145	9	1	900	970	70	0.11	1.08	1	1	0
0021	3T	1_4	146	11	1	1100	1890	790	0.09	1.72	1	3	2
0021	3T	1_5	123	18	3	1800	2720	920	0.17	1.51	3	4	1
0021	3T	1_5	124	109	12	10900	8450	-2450	0.11	0.78	19	14	-5
0021	3T	1_5	125	79	2	7900	2560	-5340	0.03	0.32	13	4	-9
0021	3T	1_5	126	130	8	13000	12590	-410	0.06	0.97	23	22	-1
0021	3T	1_5	134	52	5	5200	4080	-1120	0.10	0.78	9	7	-2
0021	3T	1_5	135	44	6	4400	5290	890	0.14	1.20	7	9	2
0021	3T	1_5	136	62	5	6200	7940	1740	0.08	1.28	10	14	4
0021	3T	1_5	145	20	1	2000	2300	300	0.05	1.15	3	4	1
0021	3T	1_5	146	24	0	2400	0	-2400	0.00	0.00	4	0	-4
0021	3T	1_5	156	3	0	300	0	-300	0.00	0.00	0	0	0
0021	3T	1_5	214	1	0	100	0	-100	0.00	0.00	0	0	0
0021	3T	1_5	216	1	1	100	1850	1750	1.00	18.50	0	3	3
0021	3T	1_5	245	1	0	100	0	-100	0.00	0.00	0	0	0
0021	3T	1_else	123	1069	98	106900	69440	-37460	0.09	0.65	189	122	-67
0021	3T	1_else	124	200	16	20000	19210	-790	0.08	0.96	35	34	-1
0021	3T	1_else	126	51	2	5100	2350	-2750	0.04	0.46	9	4	-5
0021	3T	1_else	132	4	1	400	1180	780	0.25	2.95	0	2	2
0021	3T	1_else	134	166	8	16600	11760	-4840	0.05	0.71	29	20	-9
0021	3T	2_1	123	360	46	36000	39360	3360	0.13	1.09	63	69	6
0021	3T	2_1	124	705	76	70500	65580	-4920	0.11	0.93	124	116	-8
0021	3T	2_1	125	616	48	61600	52050	-9550	0.08	0.84	109	92	-17
0021	3T	2_1	126	732	45	73200	66730	-6470	0.06	0.91	129	118	-11
0021	3T	2_1	132	5	0	500	0	-500	0.00	0.00	0	0	0
0021	3T	2_1	134	354	37	35400	26580	-8820	0.10	0.75	62	47	-15
0021	3T	2_1	135	384	36	38400	37990	-410	0.09	0.99	67	67	0
0021	3T	2_1	136	399	27	39900	41230	1330	0.07	1.03	70	72	2
0021	3T	2_1	142	1	0	100	0	-100	0.00	0.00	0	0	0
0021	3T	2_1	143	5	1	500	620	120	0.20	1.24	0	1	1
0021	3T	2_1	145	187	14	18700	15690	-3010	0.07	0.84	33	27	-6
0021	3T	2_1	146	202	14	20200	18300	-1900	0.07	0.91	35	32	-3
0021	3T	2_1	153	4	0	400	0	-400	0.00	0.00	0	0	0
0021	3T	2_1	154	2	0	200	0	-200	0.00	0.00	0	0	0
0021	3T	2_1	156	70	3	7000	4340	-2660	0.04	0.62	12	7	-5
0021	3T	2_1	163	6	0	600	0	-600	0.00	0.00	1	0	-1
0021	3T	2_1	164	6	1	600	860	260	0.17	1.43	1	1	0
0021	3T	2_1	165	1	0	100	0	-100	0.00	0.00	0	0	0
0021	3T	2_1	213	1	0	100	0	-100	0.00	0.00	0	0	0
0021	3T	2_1	214	7	0	700	0	-700	0.00	0.00	1	0	-1
0021	3T	2_1	215	13	0	1300	0	-1300	0.00	0.00	2	0	-2
0021	3T	2_1	216	66	6	6600	20450	13850	0.09	3.10	11	36	25
0021	3T	2_1	234	26	0	2600	0	-2600	0.00	0.00	4	0	-4
0021	3T	2_1	235	28	1	2800	1280	-1520	0.04	0.46	4	2	-2
0021	3T	2_1	236	44	1	4400	2020	-2380	0.02	0.46	7	3	-4
0021	3T	2_1	245	32	1	3200	2140	-1060	0.03	0.67	5	3	-2
0021	3T	2_1	246	32	0	3200	0	-3200	0.00	0.00	5	0	-5
0021	3T	2_1	256	21	1	2100	8720	6620	0.05	4.15	3	15	12
0021	3T	2_2	123	45	6	4500	3800	-700	0.13	0.84	7	6	-1
0021	3T	2_2	124	207	13	20700	12680	-8020	0.06	0.61	36	22	-14
0021	3T	2_2	125	172	12	17200	9200	-8000	0.07	0.53	30	16	-14
0021	3T	2_2	126	224	14	22400	15010	-7390	0.06	0.67	39	26	-13
0021	3T	2_2	134	108	11	10800	7780	-3020	0.10	0.72	19	13	-6
0021	3T	2_2	135	106	9	10600	9160	-1440	0.08	0.86	18	16	-2
0021	3T	2_2	136	163	11	16300	9430	-6870	0.07	0.58	28	16	-12
0021	3T	2_2	145	26	0	2600	0	-2600	0.00	0.00	4	0	-4
0021	3T	2_2	146	38	3	3800	3370	-430	0.08	0.89	6	5	-1
0021	3T	2_2	156	6	0	600	0	-600	0.00	0.00	1	0	-1
0021	3T	2_2	214	1	0	100	0	-100	0.00	0.00	0	0	0
0021	3T	2_2	215	1	0	100	0	-100	0.00	0.00	0	0	0
0021	3T	2_2	216	5	0	500	0	-500	0.00	0.00	0	0	0
0021	3T	2_2	234	1	1	100	1050	950	1.00	10.50	0	1	1
0021	3T	2_2	236	1	1	100	700	600	1.00	7.00	0	1	1
0021	3T	2_3	124	1	0	100	0	-100	0.00	0.00	0	0	0
0021	3T	2_3	125	1	0	100	0	-100	0.00	0.00	0	0	0
0021	3T	2_3	126	3	0	300	0	-300	0.00	0.00	0	0	0
0021	3T	2_3	134	1	0	100	0	-100	0.00	0.00	0	0	0
0021	3T	2_3	136	2	0	200	0	-200	0.00	0.00	0	0	0
0021	3T	2_4	123	21	6	2100	3150	1050	0.29	1.50	3	5	2
0021	3T	2_4	124	126	21	12600	18060	5460	0.17	1.43	22	31	9
0021	3T	2_4	125	83	5	8300	4520	-3780	0.06	0.54	14	8	-6
0021	3T	2_4	126	106	2	10600	4330	-6270	0.02	0.41	18	7	-11
0021	3T	2_4	134	74	8	7400	6850	-550	0.11	0.93	13	12	-1
0021	3T	2_4	135	74	8	7400	8230	830	0.11	1.11	13	14	1
0021	3T	2_4	136	75	3	7500	6620	-880	0.04	0.88	13	11	-2
0021	3T	2_4	145	13	0	1300	0	-1300	0.00	0.00	2	0	-2
0021	3T	2_4	146	27	0	2700	0	-2700	0.00	0.00	4	0	-4
0021	3T	2_4	156	4	1	400	2420	2020	0.25	6.05	0	4	4
0021	3T	2_5	123	18	1	1800	820	-980	0.06	0.46	3	1	-2
0021	3T	2_5	124	110	13	11000	8940	-2060	0.12	0.81	19	15	-4
0021	3T	2_5	125	79	5	7900	6510	-1390	0.06	0.82	13	11	-2
0021	3T	2_5	126	104	9	10400	11000	600	0.09	1.06	18	19	1
0021	3T	2_5	134	67	3	6700	2580	-4120	0.04	0.39	11	4	-7
0021	3T	2_5	135	46	5	4600	3320	-1280	0.11	0.72	8	5	-3
0021	3T	2_5	136	76	3	7600	2250	-5350	0.04	0.30	13	3	-10
0021	3T	2_5	145	24	0	2400	0	-2400	0.00	0.00	4	0	-4
0021	3T	2_5	146	24	2	2400	2740	340	0.08	1.14	4	4	0
0021	3T	2_5	156	5	2	500	3240	2740	0.40	6.48	0	5	5
0021	3T	2_5	164	1	0	100	0	-100	0.00	0.00	0	0	0
0021	3T	2_5	214	1	0	100	0	-100	0.00	0.00	0	0	0
0021	3T	2_5	215	4	2	400	5630	5230	0.50	14.08	0	9	9
0021	3T	2_5	216	4	0	400	0	-400	0.00	0.00	0	0	0
0021	3T	2_5	234	1	0	100	0	-100	0.00	0.00	0	0	0
0021	3T	2_5	236	1	0	100	0	-100	0.00	0.00	0	0	0
0021	3T	2_5	246	1	0	100	0	-100	0.00	0.00	0	0	0
0021	3T	2_else	123	777	86	77700	69330	-8370	0.11	0.89	137	122	-15
0021	3T	2_else	124	662	59	66200	53120	-13080	0.09	0.80	117	94	-23
0021	3T	2_else	125	36	0	3600	0	-3600	0.00	0.00	6	0	-6
0021	3T	2_else	126	33	3	3300	2150	-1150	0.09	0.65	5	3	-2
0021	3T	2_else	134	269	23	26900	21270	-5630	0.09	0.79	47	37	-10
0021	3T	2_else	135	9	0	900	0	-900	0.00	0.00	1	0	-1
0021	3T	2_else	136	9	0	900	0	-900	0.00	0.00	1	0	-1
0021	3T	2_else	142	1	0	100	0	-100	0.00	0.00	0	0	0
0021	3T	2_else	143	26	2	2600	1630	-970	0.08	0.63	4	2	-2
0021	3T	2_else	146	6	1	600	700	100	0.17	1.17	1	1	0
0021	3T	2_else	153	4	0	400	0	-400	0.00	0.00	0	0	0
0021	3T	3_1	123	318	39	31800	28510	-3290	0.12	0.90	56	50	-6
0021	3T	3_1	124	567	46	56700	29330	-27370	0.08	0.52	100	51	-49
0021	3T	3_1	125	492	45	49200	45490	-3710	0.09	0.92	87	80	-7
0021	3T	3_1	126	600	56	60000	72560	12560	0.09	1.21	106	128	22
0021	3T	3_1	134	282	29	28200	25430	-2770	0.10	0.90	49	45	-4
0021	3T	3_1	135	333	30	33300	27890	-5410	0.09	0.84	58	49	-9
0021	3T	3_1	136	401	26	40100	32100	-8000	0.06	0.80	70	56	-14
0021	3T	3_1	142	3	0	300	0	-300	0.00	0.00	0	0	0
0021	3T	3_1	143	4	0	400	0	-400	0.00	0.00	0	0	0
0021	3T	3_1	145	229	11	22900	12030	-10870	0.05	0.53	40	21	-19
0021	3T	3_1	146	164	4	16400	5770	-10630	0.02	0.35	29	10	-19
0021	3T	3_1	153	1	0	100	0	-100	0.00	0.00	0	0	0
0021	3T	3_1	156	108	7	10800	15150	4350	0.06	1.40	19	26	7
0021	3T	3_1	163	1	0	100	0	-100	0.00	0.00	0	0	0
0021	3T	3_1	164	2	0	200	0	-200	0.00	0.00	0	0	0
0021	3T	3_1	165	1	0	100	0	-100	0.00	0.00	0	0	0
0021	3T	3_1	213	6	1	600	560	-40	0.17	0.93	1	0	-1
0021	3T	3_1	214	25	1	2500	1020	-1480	0.04	0.41	4	1	-3
0021	3T	3_1	215	45	1	4500	2250	-2250	0.02	0.50	7	3	-4
0021	3T	3_1	216	89	0	8900	0	-8900	0.00	0.00	15	0	-15
0021	3T	3_1	234	23	3	2300	3970	1670	0.13	1.73	4	7	3
0021	3T	3_1	235	47	1	4700	1830	-2870	0.02	0.39	8	3	-5
0021	3T	3_1	236	44	1	4400	2180	-2220	0.02	0.50	7	3	-4
0021	3T	3_1	245	32	3	3200	3770	570	0.09	1.18	5	6	1
0021	3T	3_1	246	19	0	1900	0	-1900	0.00	0.00	3	0	-3
0021	3T	3_1	256	28	0	2800	0	-2800	0.00	0.00	4	0	-4
0021	3T	3_2	123	33	3	3300	3020	-280	0.09	0.92	5	5	0
0021	3T	3_2	124	160	13	16000	10610	-5390	0.08	0.66	28	18	-10
0021	3T	3_2	125	146	9	14600	9850	-4750	0.06	0.67	25	17	-8
0021	3T	3_2	126	183	13	18300	16280	-2020	0.07	0.89	32	28	-4
0021	3T	3_2	134	74	9	7400	6430	-970	0.12	0.87	13	11	-2
0021	3T	3_2	135	121	10	12100	6910	-5190	0.08	0.57	21	12	-9
0021	3T	3_2	136	131	2	13100	4080	-9020	0.02	0.31	23	7	-16
0021	3T	3_2	145	38	1	3800	780	-3020	0.03	0.21	6	1	-5
0021	3T	3_2	146	31	3	3100	3760	660	0.10	1.21	5	6	1
0021	3T	3_2	154	1	1	100	980	880	1.00	9.80	0	1	1
0021	3T	3_2	156	4	0	400	0	-400	0.00	0.00	0	0	0
0021	3T	3_2	214	1	0	100	0	-100	0.00	0.00	0	0	0
0021	3T	3_2	215	3	1	300	3000	2700	0.33	10.00	0	5	5
0021	3T	3_2	216	2	0	200	0	-200	0.00	0.00	0	0	0
0021	3T	3_2	234	2	0	200	0	-200	0.00	0.00	0	0	0
0021	3T	3_2	236	1	0	100	0	-100	0.00	0.00	0	0	0
0021	3T	3_3	123	44	5	4400	4550	150	0.11	1.03	7	8	1
0021	3T	3_3	124	80	10	8000	6350	-1650	0.13	0.79	14	11	-3
0021	3T	3_3	125	94	10	9400	8170	-1230	0.11	0.87	16	14	-2
0021	3T	3_3	126	44	3	4400	4190	-210	0.07	0.95	7	7	0
0021	3T	3_3	134	59	9	5900	7220	1320	0.15	1.22	10	12	2
0021	3T	3_3	135	50	1	5000	1530	-3470	0.02	0.31	8	2	-6
0021	3T	3_3	136	40	0	4000	0	-4000	0.00	0.00	7	0	-7
0021	3T	3_3	145	50	2	5000	1220	-3780	0.04	0.24	8	2	-6
0021	3T	3_3	146	17	0	1700	0	-1700	0.00	0.00	3	0	-3
0021	3T	3_3	154	2	0	200	0	-200	0.00	0.00	0	0	0
0021	3T	3_3	156	5	0	500	0	-500	0.00	0.00	0	0	0
0021	3T	3_3	214	1	0	100	0	-100	0.00	0.00	0	0	0
0021	3T	3_3	215	5	0	500	0	-500	0.00	0.00	0	0	0
0021	3T	3_3	216	4	0	400	0	-400	0.00	0.00	0	0	0
0021	3T	3_3	234	3	0	300	0	-300	0.00	0.00	0	0	0
0021	3T	3_3	235	5	0	500	0	-500	0.00	0.00	0	0	0
0021	3T	3_3	236	5	0	500	0	-500	0.00	0.00	0	0	0
0021	3T	3_3	245	5	0	500	0	-500	0.00	0.00	0	0	0
0021	3T	3_3	246	3	0	300	0	-300	0.00	0.00	0	0	0
0021	3T	3_4	123	25	5	2500	2450	-50	0.20	0.98	4	4	0
0021	3T	3_4	124	150	17	15000	14110	-890	0.11	0.94	26	24	-2
0021	3T	3_4	125	82	3	8200	2600	-5600	0.04	0.32	14	4	-10
0021	3T	3_4	126	92	3	9200	3670	-5530	0.03	0.40	16	6	-10
0021	3T	3_4	134	66	4	6600	4670	-1930	0.06	0.71	11	8	-3
0021	3T	3_4	135	68	5	6800	3670	-3130	0.07	0.54	12	6	-6
0021	3T	3_4	136	63	3	6300	2730	-3570	0.05	0.43	11	4	-7
0021	3T	3_4	145	20	1	2000	750	-1250	0.05	0.38	3	1	-2
0021	3T	3_4	146	12	1	1200	850	-350	0.08	0.71	2	1	-1
0021	3T	3_4	154	1	0	100	0	-100	0.00	0.00	0	0	0
0021	3T	3_4	156	1	1	100	1820	1720	1.00	18.20	0	3	3
0021	3T	3_4	215	1	0	100	0	-100	0.00	0.00	0	0	0
0021	3T	3_5	123	25	4	2500	2260	-240	0.16	0.90	4	4	0
0021	3T	3_5	124	107	12	10700	8460	-2240	0.11	0.79	18	14	-4
0021	3T	3_5	125	79	7	7900	6470	-1430	0.09	0.82	13	11	-2
0021	3T	3_5	126	59	4	5900	5640	-260	0.07	0.96	10	9	-1
0021	3T	3_5	134	67	6	6700	3960	-2740	0.09	0.59	11	7	-4
0021	3T	3_5	135	53	2	5300	1880	-3420	0.04	0.35	9	3	-6
0021	3T	3_5	136	62	6	6200	7870	1670	0.10	1.27	10	13	3
0021	3T	3_5	142	2	0	200	0	-200	0.00	0.00	0	0	0
0021	3T	3_5	145	30	2	3000	1590	-1410	0.07	0.53	5	2	-3
0021	3T	3_5	146	17	2	1700	3370	1670	0.12	1.98	3	5	2
0021	3T	3_5	154	2	0	200	0	-200	0.00	0.00	0	0	0
0021	3T	3_5	156	2	0	200	0	-200	0.00	0.00	0	0	0
0021	3T	3_5	214	2	0	200	0	-200	0.00	0.00	0	0	0
0021	3T	3_5	215	1	0	100	0	-100	0.00	0.00	0	0	0
0021	3T	3_5	216	2	0	200	0	-200	0.00	0.00	0	0	0
0021	3T	3_5	236	1	0	100	0	-100	0.00	0.00	0	0	0
0021	3T	3_5	245	1	0	100	0	-100	0.00	0.00	0	0	0
0021	3T	3_5	256	2	0	200	0	-200	0.00	0.00	0	0	0
0021	3T	3_6	123	32	8	3200	3170	-30	0.25	0.99	5	5	0
0021	3T	3_6	124	116	10	11600	5200	-6400	0.09	0.45	20	9	-11
0021	3T	3_6	125	57	4	5700	3090	-2610	0.07	0.54	10	5	-5
0021	3T	3_6	126	29	4	2900	4870	1970	0.14	1.68	5	8	3
0021	3T	3_6	134	30	1	3000	600	-2400	0.03	0.20	5	1	-4
0021	3T	3_6	135	25	3	2500	3630	1130	0.12	1.45	4	6	2
0021	3T	3_6	136	9	0	900	0	-900	0.00	0.00	1	0	-1
0021	3T	3_6	145	4	0	400	0	-400	0.00	0.00	0	0	0
0021	3T	3_6	146	3	0	300	0	-300	0.00	0.00	0	0	0
0021	3T	3_6	216	1	0	100	0	-100	0.00	0.00	0	0	0
0021	3T	3_else	123	324	38	32400	23010	-9390	0.12	0.71	57	40	-17
0021	3T	3_else	124	484	37	48400	26750	-21650	0.08	0.55	85	47	-38
0021	3T	3_else	125	202	21	20200	20610	410	0.10	1.02	35	36	1
0021	3T	3_else	126	126	13	12600	16640	4040	0.10	1.32	22	29	7
0021	3T	3_else	132	1	0	100	0	-100	0.00	0.00	0	0	0
0021	3T	3_else	134	157	17	15700	14310	-1390	0.11	0.91	27	25	-2
0021	3T	3_else	135	89	4	8900	6440	-2460	0.04	0.72	15	11	-4
0021	3T	3_else	136	61	3	6100	2250	-3850	0.05	0.37	10	3	-7
0021	3T	3_else	142	2	2	200	1910	1710	1.00	9.55	0	3	3
0021	3T	3_else	143	2	0	200	0	-200	0.00	0.00	0	0	0
0021	3T	3_else	145	33	3	3300	2450	-850	0.09	0.74	5	4	-1
0021	3T	3_else	146	15	0	1500	0	-1500	0.00	0.00	2	0	-2
0021	3T	3_else	156	6	0	600	0	-600	0.00	0.00	1	0	-1
0021	3T	3_else	164	1	0	100	0	-100	0.00	0.00	0	0	0
0021	3T	3_else	234	1	0	100	0	-100	0.00	0.00	0	0	0
0021	3T	3_else	235	2	0	200	0	-200	0.00	0.00	0	0	0
0021	3T	3_else	256	1	0	100	0	-100	0.00	0.00	0	0	0
0021	3T	4_1	123	176	24	17600	18510	910	0.14	1.05	31	32	1
0021	3T	4_1	124	400	42	40000	34120	-5880	0.11	0.85	70	60	-10
0021	3T	4_1	125	347	27	34700	30970	-3730	0.08	0.89	61	54	-7
0021	3T	4_1	126	309	17	30900	19310	-11590	0.06	0.62	54	34	-20
0021	3T	4_1	134	237	34	23700	25690	1990	0.14	1.08	41	45	4
0021	3T	4_1	135	254	23	25400	17340	-8060	0.09	0.68	44	30	-14
0021	3T	4_1	136	208	18	20800	22550	1750	0.09	1.08	36	39	3
0021	3T	4_1	143	7	0	700	0	-700	0.00	0.00	1	0	-1
0021	3T	4_1	145	115	7	11500	9140	-2360	0.06	0.79	20	16	-4
0021	3T	4_1	146	89	4	8900	6930	-1970	0.04	0.78	15	12	-3
0021	3T	4_1	154	2	0	200	0	-200	0.00	0.00	0	0	0
0021	3T	4_1	156	51	3	5100	3860	-1240	0.06	0.76	9	6	-3
0021	3T	4_1	213	5	0	500	0	-500	0.00	0.00	0	0	0
0021	3T	4_1	214	24	3	2400	3290	890	0.13	1.37	4	5	1
0021	3T	4_1	215	24	1	2400	1530	-870	0.04	0.64	4	2	-2
0021	3T	4_1	216	46	3	4600	15130	10530	0.07	3.29	8	26	18
0021	3T	4_1	234	16	1	1600	2050	450	0.06	1.28	2	3	1
0021	3T	4_1	235	49	2	4900	1650	-3250	0.04	0.34	8	2	-6
0021	3T	4_1	236	37	4	3700	6180	2480	0.11	1.67	6	10	4
0021	3T	4_1	245	25	2	2500	2710	210	0.08	1.08	4	4	0
0021	3T	4_1	246	18	0	1800	0	-1800	0.00	0.00	3	0	-3
0021	3T	4_1	256	20	0	2000	0	-2000	0.00	0.00	3	0	-3
0021	3T	4_2	123	25	5	2500	3370	870	0.20	1.35	4	5	1
0021	3T	4_2	124	85	7	8500	4950	-3550	0.08	0.58	15	8	-7
0021	3T	4_2	125	75	9	7500	8770	1270	0.12	1.17	13	15	2
0021	3T	4_2	126	59	4	5900	3630	-2270	0.07	0.62	10	6	-4
0021	3T	4_2	134	49	8	4900	4850	-50	0.16	0.99	8	8	0
0021	3T	4_2	135	53	7	5300	7730	2430	0.13	1.46	9	13	4
0021	3T	4_2	136	48	5	4800	12810	8010	0.10	2.67	8	22	14
0021	3T	4_2	143	1	0	100	0	-100	0.00	0.00	0	0	0
0021	3T	4_2	145	14	1	1400	820	-580	0.07	0.59	2	1	-1
0021	3T	4_2	146	24	1	2400	3250	850	0.04	1.35	4	5	1
0021	3T	4_2	154	1	0	100	0	-100	0.00	0.00	0	0	0
0021	3T	4_2	156	2	0	200	0	-200	0.00	0.00	0	0	0
0021	3T	4_3	123	78	11	7800	7500	-300	0.14	0.96	13	13	0
0021	3T	4_3	124	187	14	18700	10840	-7860	0.07	0.58	33	19	-14
0021	3T	4_3	125	150	12	15000	8840	-6160	0.08	0.59	26	15	-11
0021	3T	4_3	126	89	5	8900	8900	0	0.06	1.00	15	15	0
0021	3T	4_3	134	128	12	12800	11380	-1420	0.09	0.89	22	20	-2
0021	3T	4_3	135	100	13	10000	12130	2130	0.13	1.21	17	21	4
0021	3T	4_3	136	73	7	7300	5290	-2010	0.10	0.72	12	9	-3
0021	3T	4_3	142	1	0	100	0	-100	0.00	0.00	0	0	0
0021	3T	4_3	145	65	6	6500	8200	1700	0.09	1.26	11	14	3
0021	3T	4_3	146	36	1	3600	730	-2870	0.03	0.20	6	1	-5
0021	3T	4_3	153	1	0	100	0	-100	0.00	0.00	0	0	0
0021	3T	4_3	154	1	0	100	0	-100	0.00	0.00	0	0	0
0021	3T	4_3	156	11	1	1100	2080	980	0.09	1.89	1	3	2
0021	3T	4_3	213	1	0	100	0	-100	0.00	0.00	0	0	0
0021	3T	4_3	214	4	0	400	0	-400	0.00	0.00	0	0	0
0021	3T	4_3	215	3	0	300	0	-300	0.00	0.00	0	0	0
0021	3T	4_3	216	6	0	600	0	-600	0.00	0.00	1	0	-1
0021	3T	4_3	234	13	1	1300	940	-360	0.08	0.72	2	1	-1
0021	3T	4_3	235	22	2	2200	3160	960	0.09	1.44	3	5	2
0021	3T	4_3	236	10	2	1000	2380	1380	0.20	2.38	1	4	3
0021	3T	4_3	245	17	0	1700	0	-1700	0.00	0.00	3	0	-3
0021	3T	4_3	246	6	0	600	0	-600	0.00	0.00	1	0	-1
0021	3T	4_3	256	5	0	500	0	-500	0.00	0.00	0	0	0
0021	3T	4_4	123	25	2	2500	990	-1510	0.08	0.40	4	1	-3
0021	3T	4_4	124	110	13	11000	10780	-220	0.12	0.98	19	19	0
0021	3T	4_4	125	73	3	7300	1770	-5530	0.04	0.24	12	3	-9
0021	3T	4_4	126	51	2	5100	1850	-3250	0.04	0.36	9	3	-6
0021	3T	4_4	134	44	5	4400	3740	-660	0.11	0.85	7	6	-1
0021	3T	4_4	135	48	5	4800	5020	220	0.10	1.05	8	8	0
0021	3T	4_4	136	30	2	3000	2020	-980	0.07	0.67	5	3	-2
0021	3T	4_4	145	8	0	800	0	-800	0.00	0.00	1	0	-1
0021	3T	4_4	146	8	0	800	0	-800	0.00	0.00	1	0	-1
0021	3T	4_4	156	2	0	200	0	-200	0.00	0.00	0	0	0
0021	3T	4_5	123	25	4	2500	1820	-680	0.16	0.73	4	3	-1
0021	3T	4_5	124	88	8	8800	7480	-1320	0.09	0.85	15	13	-2
0021	3T	4_5	125	66	5	6600	4570	-2030	0.08	0.69	11	8	-3
0021	3T	4_5	126	40	1	4000	1550	-2450	0.03	0.39	7	2	-5
0021	3T	4_5	134	56	7	5600	5590	-10	0.13	1.00	9	9	0
0021	3T	4_5	135	46	6	4600	4480	-120	0.13	0.97	8	7	-1
0021	3T	4_5	136	24	2	2400	2150	-250	0.08	0.90	4	3	-1
0021	3T	4_5	145	14	1	1400	2980	1580	0.07	2.13	2	5	3
0021	3T	4_5	146	8	0	800	0	-800	0.00	0.00	1	0	-1
0021	3T	4_5	156	2	0	200	0	-200	0.00	0.00	0	0	0
0021	3T	4_5	215	1	0	100	0	-100	0.00	0.00	0	0	0
0021	3T	4_6	123	56	9	5600	4210	-1390	0.16	0.75	9	7	-2
0021	3T	4_6	124	208	16	20800	10720	-10080	0.08	0.52	36	18	-18
0021	3T	4_6	125	93	8	9300	7270	-2030	0.09	0.78	16	12	-4
0021	3T	4_6	126	52	3	5200	7600	2400	0.06	1.46	9	13	4
0021	3T	4_6	134	66	6	6600	10520	3920	0.09	1.59	11	18	7
0021	3T	4_6	135	38	4	3800	6740	2940	0.11	1.77	6	11	5
0021	3T	4_6	136	21	0	2100	0	-2100	0.00	0.00	3	0	-3
0021	3T	4_6	142	1	0	100	0	-100	0.00	0.00	0	0	0
0021	3T	4_6	145	11	0	1100	0	-1100	0.00	0.00	1	0	-1
0021	3T	4_6	146	6	0	600	0	-600	0.00	0.00	1	0	-1
0021	3T	4_6	154	1	0	100	0	-100	0.00	0.00	0	0	0
0021	3T	4_6	216	2	0	200	0	-200	0.00	0.00	0	0	0
0021	3T	4_6	234	1	0	100	0	-100	0.00	0.00	0	0	0
0021	3T	4_6	235	1	0	100	0	-100	0.00	0.00	0	0	0
0021	3T	4_else	123	1093	114	109300	97190	-12110	0.10	0.89	193	172	-21
0021	3T	4_else	124	101	5	10100	3070	-7030	0.05	0.30	17	5	-12
0021	3T	4_else	125	6	1	600	1250	650	0.17	2.08	1	2	1
0021	3T	4_else	126	44	2	4400	2260	-2140	0.05	0.51	7	4	-3
0021	3T	4_else	132	13	1	1300	680	-620	0.08	0.52	2	1	-1
0021	3T	4_else	134	37	2	3700	3000	-700	0.05	0.81	6	5	-1
0021	3T	4_else	135	3	0	300	0	-300	0.00	0.00	0	0	0
0021	3T	4_else	136	5	0	500	0	-500	0.00	0.00	0	0	0
0021	3T	4_else	142	3	0	300	0	-300	0.00	0.00	0	0	0
0021	3T	4_else	143	68	9	6800	11950	5150	0.13	1.76	12	21	9
0021	3T	4_else	145	1	0	100	0	-100	0.00	0.00	0	0	0
0021	3T	4_else	146	2	1	200	820	620	0.50	4.10	0	1	1
0021	3T	5_1	123	8	2	800	1080	280	0.25	1.35	1	1	0
0021	3T	5_1	124	25	2	2500	1050	-1450	0.08	0.42	4	1	-3
0021	3T	5_1	125	9	1	900	800	-100	0.11	0.89	1	1	0
0021	3T	5_1	126	8	0	800	0	-800	0.00	0.00	1	0	-1
0021	3T	5_1	134	17	2	1700	1500	-200	0.12	0.88	3	2	-1
0021	3T	5_1	135	9	1	900	1580	680	0.11	1.76	1	2	1
0021	3T	5_1	136	11	1	1100	890	-210	0.09	0.81	1	1	0
0021	3T	5_1	142	1	1	100	530	430	1.00	5.30	0	0	0
0021	3T	5_1	145	7	1	700	800	100	0.14	1.14	1	1	0
0021	3T	5_1	146	4	0	400	0	-400	0.00	0.00	0	0	0
0021	3T	5_1	156	4	0	400	0	-400	0.00	0.00	0	0	0
0021	3T	5_1	214	1	0	100	0	-100	0.00	0.00	0	0	0
0021	3T	5_1	216	1	0	100	0	-100	0.00	0.00	0	0	0
0021	3T	5_1	235	1	0	100	0	-100	0.00	0.00	0	0	0
0021	3T	5_1	246	2	0	200	0	-200	0.00	0.00	0	0	0
0021	3T	5_2	124	1	0	100	0	-100	0.00	0.00	0	0	0
0021	3T	5_2	125	2	0	200	0	-200	0.00	0.00	0	0	0
0021	3T	5_2	126	1	0	100	0	-100	0.00	0.00	0	0	0
0021	3T	5_2	134	4	0	400	0	-400	0.00	0.00	0	0	0
0021	3T	5_3	123	231	30	23100	20210	-2890	0.13	0.87	40	35	-5
0021	3T	5_3	124	572	65	57200	44150	-13050	0.11	0.77	101	78	-23
0021	3T	5_3	125	433	34	43300	33740	-9560	0.08	0.78	76	59	-17
0021	3T	5_3	126	367	26	36700	40020	3320	0.07	1.09	64	70	6
0021	3T	5_3	134	317	24	31700	19310	-12390	0.08	0.61	56	34	-22
0021	3T	5_3	135	279	14	27900	9200	-18700	0.05	0.33	49	16	-33
0021	3T	5_3	136	236	24	23600	25740	2140	0.10	1.09	41	45	4
0021	3T	5_3	142	6	0	600	0	-600	0.00	0.00	1	0	-1
0021	3T	5_3	143	4	0	400	0	-400	0.00	0.00	0	0	0
0021	3T	5_3	145	201	9	20100	10150	-9950	0.04	0.50	35	17	-18
0021	3T	5_3	146	125	7	12500	9640	-2860	0.06	0.77	22	17	-5
0021	3T	5_3	153	2	0	200	0	-200	0.00	0.00	0	0	0
0021	3T	5_3	154	9	2	900	1730	830	0.22	1.92	1	3	2
0021	3T	5_3	156	45	3	4500	3070	-1430	0.07	0.68	7	5	-2
0021	3T	5_3	164	1	0	100	0	-100	0.00	0.00	0	0	0
0021	3T	5_3	214	3	0	300	0	-300	0.00	0.00	0	0	0
0021	3T	5_3	215	3	0	300	0	-300	0.00	0.00	0	0	0
0021	3T	5_3	216	11	0	1100	0	-1100	0.00	0.00	1	0	-1
0021	3T	5_3	234	8	0	800	0	-800	0.00	0.00	1	0	-1
0021	3T	5_3	235	9	1	900	2810	1910	0.11	3.12	1	4	3
0021	3T	5_3	236	8	0	800	0	-800	0.00	0.00	1	0	-1
0021	3T	5_3	245	4	0	400	0	-400	0.00	0.00	0	0	0
0021	3T	5_3	246	7	0	700	0	-700	0.00	0.00	1	0	-1
0021	3T	5_3	256	2	0	200	0	-200	0.00	0.00	0	0	0
0021	3T	5_3	265	1	0	100	0	-100	0.00	0.00	0	0	0
0021	3T	5_4	123	1	0	100	0	-100	0.00	0.00	0	0	0
0021	3T	5_4	124	6	0	600	0	-600	0.00	0.00	1	0	-1
0021	3T	5_4	125	2	0	200	0	-200	0.00	0.00	0	0	0
0021	3T	5_4	126	1	1	100	1180	1080	1.00	11.80	0	2	2
0021	3T	5_4	135	2	0	200	0	-200	0.00	0.00	0	0	0
0021	3T	5_4	146	1	0	100	0	-100	0.00	0.00	0	0	0
0021	3T	5_5	125	1	0	100	0	-100	0.00	0.00	0	0	0
0021	3T	5_5	126	1	0	100	0	-100	0.00	0.00	0	0	0
0021	3T	5_5	135	1	0	100	0	-100	0.00	0.00	0	0	0
0021	3T	5_5	136	1	0	100	0	-100	0.00	0.00	0	0	0
0021	3T	5_6	123	324	50	32400	23000	-9400	0.15	0.71	57	40	-17
0021	3T	5_6	124	883	96	88300	65130	-23170	0.11	0.74	156	115	-41
0021	3T	5_6	125	175	13	17500	11460	-6040	0.07	0.65	30	20	-10
0021	3T	5_6	126	89	7	8900	14130	5230	0.08	1.59	15	25	10
0021	3T	5_6	132	1	0	100	0	-100	0.00	0.00	0	0	0
0021	3T	5_6	134	175	11	17500	11190	-6310	0.06	0.64	30	19	-11
0021	3T	5_6	135	83	3	8300	2240	-6060	0.04	0.27	14	3	-11
0021	3T	5_6	136	35	2	3500	3720	220	0.06	1.06	6	6	0
0021	3T	5_6	145	6	0	600	0	-600	0.00	0.00	1	0	-1
0021	3T	5_6	146	5	0	500	0	-500	0.00	0.00	0	0	0
0021	3T	5_6	153	1	0	100	0	-100	0.00	0.00	0	0	0
0021	3T	5_6	215	2	0	200	0	-200	0.00	0.00	0	0	0
0021	3T	5_6	216	2	0	200	0	-200	0.00	0.00	0	0	0
0021	3T	5_6	234	2	0	200	0	-200	0.00	0.00	0	0	0
0021	3T	5_6	235	3	0	300	0	-300	0.00	0.00	0	0	0
0021	3T	5_6	246	1	0	100	0	-100	0.00	0.00	0	0	0
0021	3T	5_else	123	755	79	75500	62500	-13000	0.10	0.83	133	110	-23
0021	3T	5_else	124	207	18	20700	18240	-2460	0.09	0.88	36	32	-4
0021	3T	5_else	125	9	0	900	0	-900	0.00	0.00	1	0	-1
0021	3T	5_else	126	29	1	2900	1100	-1800	0.03	0.38	5	1	-4
0021	3T	5_else	134	76	1	7600	2230	-5370	0.01	0.29	13	3	-10
0021	3T	5_else	135	3	1	300	660	360	0.33	2.20	0	1	1
0021	3T	5_else	136	11	1	1100	1140	40	0.09	1.04	1	2	1
0021	3T	5_else	143	26	2	2600	2690	90	0.08	1.03	4	4	0
0021	3T	5_else	213	1	0	100	0	-100	0.00	0.00	0	0	0
0021	3T	6_3	123	21	1	2100	520	-1580	0.05	0.25	3	0	-3
0021	3T	6_3	124	47	6	4700	4320	-380	0.13	0.92	8	7	-1
0021	3T	6_3	125	32	5	3200	7460	4260	0.16	2.33	5	13	8
0021	3T	6_3	126	36	2	3600	2540	-1060	0.06	0.71	6	4	-2
0021	3T	6_3	134	22	5	2200	3470	1270	0.23	1.58	3	6	3
0021	3T	6_3	135	19	1	1900	660	-1240	0.05	0.35	3	1	-2
0021	3T	6_3	136	25	1	2500	870	-1630	0.04	0.35	4	1	-3
0021	3T	6_3	142	1	0	100	0	-100	0.00	0.00	0	0	0
0021	3T	6_3	143	1	0	100	0	-100	0.00	0.00	0	0	0
0021	3T	6_3	145	20	0	2000	0	-2000	0.00	0.00	3	0	-3
0021	3T	6_3	146	12	1	1200	640	-560	0.08	0.53	2	1	-1
0021	3T	6_3	156	4	0	400	0	-400	0.00	0.00	0	0	0
0021	3T	6_3	216	1	0	100	0	-100	0.00	0.00	0	0	0
0021	3T	6_3	234	1	0	100	0	-100	0.00	0.00	0	0	0
0021	3T	6_3	235	1	0	100	0	-100	0.00	0.00	0	0	0
0021	3T	6_4	123	1	0	100	0	-100	0.00	0.00	0	0	0
0021	3T	6_4	124	1	0	100	0	-100	0.00	0.00	0	0	0
0021	3T	6_4	125	1	0	100	0	-100	0.00	0.00	0	0	0
0021	3T	6_4	134	1	0	100	0	-100	0.00	0.00	0	0	0
0021	3T	6_4	135	2	0	200	0	-200	0.00	0.00	0	0	0
0021	3T	6_4	145	1	0	100	0	-100	0.00	0.00	0	0	0
0021	3T	6_6	123	37	7	3700	3880	180	0.19	1.05	6	6	0
0021	3T	6_6	124	78	7	7800	4350	-3450	0.09	0.56	13	7	-6
0021	3T	6_6	125	7	0	700	0	-700	0.00	0.00	1	0	-1
0021	3T	6_6	126	6	0	600	0	-600	0.00	0.00	1	0	-1
0021	3T	6_6	134	8	1	800	430	-370	0.13	0.54	1	0	-1
0021	3T	6_6	135	11	1	1100	1150	50	0.09	1.05	1	2	1
0021	3T	6_6	136	1	0	100	0	-100	0.00	0.00	0	0	0
0021	3T	6_6	216	1	0	100	0	-100	0.00	0.00	0	0	0
0021	3T	6_else	123	8	2	800	1610	810	0.25	2.01	1	2	1
0021	3T	6_else	124	13	2	1300	880	-420	0.15	0.68	2	1	-1
0021	3T	6_else	125	6	1	600	670	70	0.17	1.12	1	1	0
0021	3T	6_else	126	5	1	500	1080	580	0.20	2.16	0	1	1
0021	3T	6_else	132	1	0	100	0	-100	0.00	0.00	0	0	0
0021	3T	6_else	134	3	0	300	0	-300	0.00	0.00	0	0	0
0021	3T	6_else	135	3	1	300	320	20	0.33	1.07	0	0	0
0021	3T	6_else	145	3	1	300	770	470	0.33	2.57	0	1	1
0021	3T	6_else	146	1	0	100	0	-100	0.00	0.00	0	0	0
0021	3T	7_3	123	667	84	66700	59950	-6750	0.13	0.90	118	106	-12
0021	3T	7_3	124	1053	102	105300	77630	-27670	0.10	0.74	186	137	-49
0021	3T	7_3	125	807	73	80700	70330	-10370	0.09	0.87	142	124	-18
0021	3T	7_3	126	655	48	65500	61440	-4060	0.07	0.94	115	108	-7
0021	3T	7_3	132	5	0	500	0	-500	0.00	0.00	0	0	0
0021	3T	7_3	134	487	37	48700	30040	-18660	0.08	0.62	86	53	-33
0021	3T	7_3	135	439	24	43900	19070	-24830	0.05	0.43	77	33	-44
0021	3T	7_3	136	412	32	41200	47350	6150	0.08	1.15	72	83	11
0021	3T	7_3	142	9	1	900	520	-380	0.11	0.58	1	0	-1
0021	3T	7_3	143	18	0	1800	0	-1800	0.00	0.00	3	0	-3
0021	3T	7_3	145	195	12	19500	13580	-5920	0.06	0.70	34	24	-10
0021	3T	7_3	146	180	10	18000	12580	-5420	0.06	0.70	31	22	-9
0021	3T	7_3	153	1	0	100	0	-100	0.00	0.00	0	0	0
0021	3T	7_3	154	2	0	200	0	-200	0.00	0.00	0	0	0
0021	3T	7_3	156	62	2	6200	1160	-5040	0.03	0.19	10	2	-8
0021	3T	7_3	163	1	0	100	0	-100	0.00	0.00	0	0	0
0021	3T	7_3	164	1	0	100	0	-100	0.00	0.00	0	0	0
0021	3T	7_3	213	3	0	300	0	-300	0.00	0.00	0	0	0
0021	3T	7_3	214	1	0	100	0	-100	0.00	0.00	0	0	0
0021	3T	7_3	215	1	0	100	0	-100	0.00	0.00	0	0	0
0021	3T	7_3	216	3	0	300	0	-300	0.00	0.00	0	0	0
0021	3T	7_3	234	19	0	1900	0	-1900	0.00	0.00	3	0	-3
0021	3T	7_3	235	15	1	1500	2130	630	0.07	1.42	2	3	1
0021	3T	7_3	236	10	0	1000	0	-1000	0.00	0.00	1	0	-1
0021	3T	7_3	245	7	0	700	0	-700	0.00	0.00	1	0	-1
0021	3T	7_3	246	7	1	700	1210	510	0.14	1.73	1	2	1
0021	3T	7_3	256	3	0	300	0	-300	0.00	0.00	0	0	0
0021	3T	7_3	263	1	0	100	0	-100	0.00	0.00	0	0	0
0021	3T	7_4	123	327	48	32700	28020	-4680	0.15	0.86	57	49	-8
0021	3T	7_4	124	710	58	71000	43750	-27250	0.08	0.62	125	77	-48
0021	3T	7_4	125	271	13	27100	12550	-14550	0.05	0.46	47	22	-25
0021	3T	7_4	126	152	8	15200	13760	-1440	0.05	0.91	26	24	-2
0021	3T	7_4	132	1	0	100	0	-100	0.00	0.00	0	0	0
0021	3T	7_4	134	221	26	22100	24290	2190	0.12	1.10	39	42	3
0021	3T	7_4	135	133	9	13300	9080	-4220	0.07	0.68	23	16	-7
0021	3T	7_4	136	65	0	6500	0	-6500	0.00	0.00	11	0	-11
0021	3T	7_4	142	5	2	500	1690	1190	0.40	3.38	0	2	2
0021	3T	7_4	143	1	0	100	0	-100	0.00	0.00	0	0	0
0021	3T	7_4	145	34	1	3400	1860	-1540	0.03	0.55	6	3	-3
0021	3T	7_4	146	24	2	2400	6840	4440	0.08	2.85	4	12	8
0021	3T	7_4	154	2	0	200	0	-200	0.00	0.00	0	0	0
0021	3T	7_4	156	8	0	800	0	-800	0.00	0.00	1	0	-1
0021	3T	7_4	164	1	0	100	0	-100	0.00	0.00	0	0	0
0021	3T	7_4	216	1	0	100	0	-100	0.00	0.00	0	0	0
0021	3T	7_4	234	2	0	200	0	-200	0.00	0.00	0	0	0
0021	3T	7_4	235	1	0	100	0	-100	0.00	0.00	0	0	0
0021	3T	7_4	245	1	0	100	0	-100	0.00	0.00	0	0	0
0021	3T	7_4	256	2	0	200	0	-200	0.00	0.00	0	0	0
0021	3T	7_5	124	5	0	500	0	-500	0.00	0.00	0	0	0
0021	3T	7_5	126	1	0	100	0	-100	0.00	0.00	0	0	0
0021	3T	7_5	134	2	1	200	570	370	0.50	2.85	0	1	1
0021	3T	7_7	123	153	15	15300	10720	-4580	0.10	0.70	27	18	-9
0021	3T	7_7	124	689	55	68900	43630	-25270	0.08	0.63	121	77	-44
0021	3T	7_7	125	38	2	3800	1600	-2200	0.05	0.42	6	2	-4
0021	3T	7_7	126	90	5	9000	10900	1900	0.06	1.21	15	19	4
0021	3T	7_7	134	40	3	4000	2720	-1280	0.08	0.68	7	4	-3
0021	3T	7_7	135	13	0	1300	0	-1300	0.00	0.00	2	0	-2
0021	3T	7_7	136	14	0	1400	0	-1400	0.00	0.00	2	0	-2
0021	3T	7_7	142	1	0	100	0	-100	0.00	0.00	0	0	0
0021	3T	7_7	145	5	0	500	0	-500	0.00	0.00	0	0	0
0021	3T	7_7	146	1	0	100	0	-100	0.00	0.00	0	0	0
0021	3T	7_7	216	1	0	100	0	-100	0.00	0.00	0	0	0
0021	3T	7_7	235	1	0	100	0	-100	0.00	0.00	0	0	0
0021	3T	7_else	123	913	113	91300	78320	-12980	0.12	0.86	161	138	-23
0021	3T	7_else	124	168	12	16800	10540	-6260	0.07	0.63	29	18	-11
0021	3T	7_else	125	19	2	1900	1620	-280	0.11	0.85	3	2	-1
0021	3T	7_else	126	38	2	3800	2050	-1750	0.05	0.54	6	3	-3
0021	3T	7_else	132	2	0	200	0	-200	0.00	0.00	0	0	0
0021	3T	7_else	134	80	4	8000	7000	-1000	0.05	0.88	14	12	-2
0021	3T	7_else	135	7	1	700	610	-90	0.14	0.87	1	1	0
0021	3T	7_else	136	11	1	1100	850	-250	0.09	0.77	1	1	0
0021	3T	7_else	142	1	1	100	520	420	1.00	5.20	0	0	0
0021	3T	7_else	143	72	4	7200	7280	80	0.06	1.01	12	12	0
0021	3T	7_else	145	5	0	500	0	-500	0.00	0.00	0	0	0
0021	3T	7_else	146	1	0	100	0	-100	0.00	0.00	0	0	0
0021	3T	7_else	163	1	0	100	0	-100	0.00	0.00	0	0	0
0023	3T	04_11	125	38	2	3800	1950	-1850	0.05	0.51	6	3	-3
0023	3T	04_11	126	16	0	1600	0	-1600	0.00	0.00	2	0	-2
0023	3T	04_11	134	26	2	2600	1450	-1150	0.08	0.56	4	2	-2
0023	3T	04_11	135	31	2	3100	1690	-1410	0.06	0.55	5	2	-3
0023	3T	04_11	136	6	0	600	0	-600	0.00	0.00	1	0	-1
0023	3T	04_11	145	13	0	1300	0	-1300	0.00	0.00	2	0	-2
0023	3T	04_11	146	5	1	500	3370	2870	0.20	6.74	0	5	5
0023	3T	04_11	156	1	0	100	0	-100	0.00	0.00	0	0	0
0023	3T	04_11	216	1	0	100	0	-100	0.00	0.00	0	0	0
0023	3T	04_12	123	11	0	1100	0	-1100	0.00	0.00	1	0	-1
0023	3T	04_12	124	87	5	8700	4300	-4400	0.06	0.49	15	7	-8
0023	3T	04_12	125	48	4	4800	6290	1490	0.08	1.31	8	11	3
0023	3T	04_12	126	9	0	900	0	-900	0.00	0.00	1	0	-1
0023	3T	04_12	134	20	1	2000	730	-1270	0.05	0.37	3	1	-2
0023	3T	04_12	135	27	2	2700	2840	140	0.07	1.05	4	5	1
0023	3T	04_12	136	3	0	300	0	-300	0.00	0.00	0	0	0
0023	3T	04_12	145	8	0	800	0	-800	0.00	0.00	1	0	-1
0023	3T	04_12	146	1	1	100	2330	2230	1.00	23.30	0	4	4
0023	3T	04_12	154	1	0	100	0	-100	0.00	0.00	0	0	0
0023	3T	04_12	216	2	0	200	0	-200	0.00	0.00	0	0	0
0023	3T	04_2	123	13	1	1300	2200	900	0.08	1.69	2	3	1
0023	3T	04_2	124	10	0	1000	0	-1000	0.00	0.00	1	0	-1
0023	3T	04_2	125	10	1	1000	1190	190	0.10	1.19	1	2	1
0023	3T	04_2	126	8	0	800	0	-800	0.00	0.00	1	0	-1
0023	3T	04_2	134	5	0	500	0	-500	0.00	0.00	0	0	0
0023	3T	04_2	135	7	0	700	0	-700	0.00	0.00	1	0	-1
0023	3T	04_2	136	6	0	600	0	-600	0.00	0.00	1	0	-1
0023	3T	04_2	143	1	0	100	0	-100	0.00	0.00	0	0	0
0023	3T	04_2	145	5	0	500	0	-500	0.00	0.00	0	0	0
0023	3T	04_2	146	8	0	800	0	-800	0.00	0.00	1	0	-1
0023	3T	04_2	156	1	0	100	0	-100	0.00	0.00	0	0	0
0023	3T	04_2	236	1	0	100	0	-100	0.00	0.00	0	0	0
0023	3T	04_2	246	1	0	100	0	-100	0.00	0.00	0	0	0
0023	3T	04_3	123	16	2	1600	2060	460	0.13	1.29	2	3	1
0023	3T	04_3	124	23	6	2300	5640	3340	0.26	2.45	4	9	5
0023	3T	04_3	125	9	0	900	0	-900	0.00	0.00	1	0	-1
0023	3T	04_3	126	20	2	2000	2980	980	0.10	1.49	3	5	2
0023	3T	04_3	134	4	1	400	1970	1570	0.25	4.93	0	3	3
0023	3T	04_3	135	10	1	1000	1220	220	0.10	1.22	1	2	1
0023	3T	04_3	136	9	0	900	0	-900	0.00	0.00	1	0	-1
0023	3T	04_3	143	1	0	100	0	-100	0.00	0.00	0	0	0
0023	3T	04_3	145	5	1	500	1420	920	0.20	2.84	0	2	2
0023	3T	04_3	163	1	0	100	0	-100	0.00	0.00	0	0	0
0023	3T	04_3	236	1	0	100	0	-100	0.00	0.00	0	0	0
0023	3T	04_3	245	1	0	100	0	-100	0.00	0.00	0	0	0
0023	3T	04_3	246	2	0	200	0	-200	0.00	0.00	0	0	0
0023	3T	04_4	123	7	0	700	0	-700	0.00	0.00	1	0	-1
0023	3T	04_4	124	18	1	1800	1480	-320	0.06	0.82	3	2	-1
0023	3T	04_4	125	18	1	1800	1120	-680	0.06	0.62	3	1	-2
0023	3T	04_4	126	17	2	1700	6100	4400	0.12	3.59	3	10	7
0023	3T	04_4	134	9	0	900	0	-900	0.00	0.00	1	0	-1
0023	3T	04_4	135	16	1	1600	1300	-300	0.06	0.81	2	2	0
0023	3T	04_4	136	7	2	700	3340	2640	0.29	4.77	1	5	4
0023	3T	04_4	145	6	0	600	0	-600	0.00	0.00	1	0	-1
0023	3T	04_4	146	9	0	900	0	-900	0.00	0.00	1	0	-1
0023	3T	04_4	156	2	0	200	0	-200	0.00	0.00	0	0	0
0023	3T	04_4	164	1	0	100	0	-100	0.00	0.00	0	0	0
0023	3T	04_4	214	2	0	200	0	-200	0.00	0.00	0	0	0
0023	3T	04_4	216	2	0	200	0	-200	0.00	0.00	0	0	0
0023	3T	04_4	236	1	0	100	0	-100	0.00	0.00	0	0	0
0023	3T	04_4	245	1	0	100	0	-100	0.00	0.00	0	0	0
0023	3T	04_4	246	1	0	100	0	-100	0.00	0.00	0	0	0
0023	3T	04_5	123	23	6	2300	4770	2470	0.26	2.07	4	8	4
0023	3T	04_5	124	31	1	3100	1260	-1840	0.03	0.41	5	2	-3
0023	3T	04_5	125	24	3	2400	4560	2160	0.13	1.90	4	8	4
0023	3T	04_5	126	12	1	1200	1320	120	0.08	1.10	2	2	0
0023	3T	04_5	134	8	2	800	1590	790	0.25	1.99	1	2	1
0023	3T	04_5	135	9	0	900	0	-900	0.00	0.00	1	0	-1
0023	3T	04_5	136	5	0	500	0	-500	0.00	0.00	0	0	0
0023	3T	04_5	143	2	0	200	0	-200	0.00	0.00	0	0	0
0023	3T	04_5	145	5	1	500	1380	880	0.20	2.76	0	2	2
0023	3T	04_5	146	5	0	500	0	-500	0.00	0.00	0	0	0
0023	3T	04_5	152	1	0	100	0	-100	0.00	0.00	0	0	0
0023	3T	04_5	156	1	1	100	1350	1250	1.00	13.50	0	2	2
0023	3T	04_5	214	1	0	100	0	-100	0.00	0.00	0	0	0
0023	3T	04_5	234	1	0	100	0	-100	0.00	0.00	0	0	0
0023	3T	04_5	236	3	0	300	0	-300	0.00	0.00	0	0	0
0023	3T	04_5	246	1	0	100	0	-100	0.00	0.00	0	0	0
0023	3T	04_5	256	1	0	100	0	-100	0.00	0.00	0	0	0
0023	3T	04_6	123	11	1	1100	360	-740	0.09	0.33	1	0	-1
0023	3T	04_6	124	13	0	1300	0	-1300	0.00	0.00	2	0	-2
0023	3T	04_6	125	13	3	1300	5860	4560	0.23	4.51	2	10	8
0023	3T	04_6	126	14	1	1400	2610	1210	0.07	1.86	2	4	2
0023	3T	04_6	134	11	2	1100	1180	80	0.18	1.07	1	2	1
0023	3T	04_6	135	10	2	1000	1470	470	0.20	1.47	1	2	1
0023	3T	04_6	136	7	1	700	760	60	0.14	1.09	1	1	0
0023	3T	04_6	145	8	0	800	0	-800	0.00	0.00	1	0	-1
0023	3T	04_6	146	11	0	1100	0	-1100	0.00	0.00	1	0	-1
0023	3T	04_6	156	1	0	100	0	-100	0.00	0.00	0	0	0
0023	3T	04_6	216	2	0	200	0	-200	0.00	0.00	0	0	0
0023	3T	04_6	235	3	1	300	400	100	0.33	1.33	0	0	0
0023	3T	04_6	245	1	0	100	0	-100	0.00	0.00	0	0	0
0023	3T	04_7	123	10	0	1000	0	-1000	0.00	0.00	1	0	-1
0023	3T	04_7	124	23	2	2300	2250	-50	0.09	0.98	4	3	-1
0023	3T	04_7	125	15	0	1500	0	-1500	0.00	0.00	2	0	-2
0023	3T	04_7	126	23	3	2300	2530	230	0.13	1.10	4	4	0
0023	3T	04_7	134	12	0	1200	0	-1200	0.00	0.00	2	0	-2
0023	3T	04_7	135	17	0	1700	0	-1700	0.00	0.00	3	0	-3
0023	3T	04_7	136	5	3	500	8470	7970	0.60	16.94	0	14	14
0023	3T	04_7	143	1	0	100	0	-100	0.00	0.00	0	0	0
0023	3T	04_7	145	5	0	500	0	-500	0.00	0.00	0	0	0
0023	3T	04_7	146	4	0	400	0	-400	0.00	0.00	0	0	0
0023	3T	04_7	156	5	0	500	0	-500	0.00	0.00	0	0	0
0023	3T	04_7	164	1	0	100	0	-100	0.00	0.00	0	0	0
0023	3T	04_7	214	1	0	100	0	-100	0.00	0.00	0	0	0
0023	3T	04_7	235	1	0	100	0	-100	0.00	0.00	0	0	0
0023	3T	04_7	246	1	0	100	0	-100	0.00	0.00	0	0	0
0023	3T	04_8	123	12	0	1200	0	-1200	0.00	0.00	2	0	-2
0023	3T	04_8	124	26	0	2600	0	-2600	0.00	0.00	4	0	-4
0023	3T	04_8	125	19	1	1900	2400	500	0.05	1.26	3	4	1
0023	3T	04_8	126	27	2	2700	2750	50	0.07	1.02	4	4	0
0023	3T	04_8	132	1	0	100	0	-100	0.00	0.00	0	0	0
0023	3T	04_8	134	14	2	1400	2850	1450	0.14	2.04	2	5	3
0023	3T	04_8	135	17	2	1700	2090	390	0.12	1.23	3	3	0
0023	3T	04_8	136	12	1	1200	750	-450	0.08	0.63	2	1	-1
0023	3T	04_8	143	1	0	100	0	-100	0.00	0.00	0	0	0
0023	3T	04_8	145	7	0	700	0	-700	0.00	0.00	1	0	-1
0023	3T	04_8	146	7	0	700	0	-700	0.00	0.00	1	0	-1
0023	3T	04_8	156	1	0	100	0	-100	0.00	0.00	0	0	0
0023	3T	04_8	246	1	0	100	0	-100	0.00	0.00	0	0	0
0023	3T	04_9	123	7	1	700	680	-20	0.14	0.97	1	1	0
0023	3T	04_9	124	32	4	3200	4780	1580	0.13	1.49	5	8	3
0023	3T	04_9	125	31	0	3100	0	-3100	0.00	0.00	5	0	-5
0023	3T	04_9	126	23	1	2300	1430	-870	0.04	0.62	4	2	-2
0023	3T	04_9	134	9	1	900	690	-210	0.11	0.77	1	1	0
0023	3T	04_9	135	21	3	2100	4120	2020	0.14	1.96	3	7	4
0023	3T	04_9	136	20	0	2000	0	-2000	0.00	0.00	3	0	-3
0023	3T	04_9	143	1	0	100	0	-100	0.00	0.00	0	0	0
0023	3T	04_9	145	6	1	600	1110	510	0.17	1.85	1	1	0
0023	3T	04_9	146	1	0	100	0	-100	0.00	0.00	0	0	0
0023	3T	04_9	156	4	0	400	0	-400	0.00	0.00	0	0	0
0023	3T	04_9	164	1	0	100	0	-100	0.00	0.00	0	0	0
0023	3T	04_9	165	3	1	300	1470	1170	0.33	4.90	0	2	2
0023	3T	05_1	123	1	0	100	0	-100	0.00	0.00	0	0	0
0023	3T	05_1	124	75	8	7500	7500	0	0.11	1.00	13	13	0
0023	3T	05_1	125	2	0	200	0	-200	0.00	0.00	0	0	0
0023	3T	05_1	126	1	0	100	0	-100	0.00	0.00	0	0	0
0023	3T	05_1	134	25	1	2500	730	-1770	0.04	0.29	4	1	-3
0023	3T	05_1	135	3	0	300	0	-300	0.00	0.00	0	0	0
0023	3T	05_1	136	1	0	100	0	-100	0.00	0.00	0	0	0
0023	3T	05_1	142	1	0	100	0	-100	0.00	0.00	0	0	0
0023	3T	05_1	143	1	0	100	0	-100	0.00	0.00	0	0	0
0023	3T	05_1	145	2	0	200	0	-200	0.00	0.00	0	0	0
0023	3T	05_1	146	7	0	700	0	-700	0.00	0.00	1	0	-1
0023	3T	05_10	123	25	2	2500	1290	-1210	0.08	0.52	4	2	-2
0023	3T	05_10	124	52	5	5200	3620	-1580	0.10	0.70	9	6	-3
0023	3T	05_10	125	44	3	4400	2620	-1780	0.07	0.60	7	4	-3
0023	3T	05_10	126	5	0	500	0	-500	0.00	0.00	0	0	0
0023	3T	05_10	134	28	1	2800	980	-1820	0.04	0.35	4	1	-3
0023	3T	05_10	135	29	2	2900	1120	-1780	0.07	0.39	5	1	-4
0023	3T	05_10	136	8	0	800	0	-800	0.00	0.00	1	0	-1
0023	3T	05_10	143	1	0	100	0	-100	0.00	0.00	0	0	0
0023	3T	05_10	145	1	0	100	0	-100	0.00	0.00	0	0	0
0023	3T	05_10	146	1	0	100	0	-100	0.00	0.00	0	0	0
0023	3T	05_10	214	2	0	200	0	-200	0.00	0.00	0	0	0
0023	3T	05_10	215	2	0	200	0	-200	0.00	0.00	0	0	0
0023	3T	05_10	216	2	0	200	0	-200	0.00	0.00	0	0	0
0023	3T	05_10	235	1	0	100	0	-100	0.00	0.00	0	0	0
0023	3T	05_10	246	1	0	100	0	-100	0.00	0.00	0	0	0
0023	3T	05_11	123	9	0	900	0	-900	0.00	0.00	1	0	-1
0023	3T	05_11	124	48	4	4800	3470	-1330	0.08	0.72	8	6	-2
0023	3T	05_11	125	63	2	6300	2040	-4260	0.03	0.32	11	3	-8
0023	3T	05_11	126	20	3	2000	3360	1360	0.15	1.68	3	5	2
0023	3T	05_11	134	19	3	1900	2850	950	0.16	1.50	3	5	2
0023	3T	05_11	135	39	5	3900	4900	1000	0.13	1.26	6	8	2
0023	3T	05_11	136	9	1	900	1440	540	0.11	1.60	1	2	1
0023	3T	05_11	145	8	2	800	1810	1010	0.25	2.26	1	3	2
0023	3T	05_11	146	4	0	400	0	-400	0.00	0.00	0	0	0
0023	3T	05_12	123	22	1	2200	520	-1680	0.05	0.24	3	0	-3
0023	3T	05_12	124	52	9	5200	8630	3430	0.17	1.66	9	15	6
0023	3T	05_12	125	65	6	6500	7060	560	0.09	1.09	11	12	1
0023	3T	05_12	126	5	1	500	1770	1270	0.20	3.54	0	3	3
0023	3T	05_12	134	23	1	2300	710	-1590	0.04	0.31	4	1	-3
0023	3T	05_12	135	57	1	5700	610	-5090	0.02	0.11	10	1	-9
0023	3T	05_12	136	3	1	300	890	590	0.33	2.97	0	1	1
0023	3T	05_12	142	1	0	100	0	-100	0.00	0.00	0	0	0
0023	3T	05_12	143	2	0	200	0	-200	0.00	0.00	0	0	0
0023	3T	05_12	145	4	1	400	800	400	0.25	2.00	0	1	1
0023	3T	05_2	123	8	1	800	1790	990	0.13	2.24	1	3	2
0023	3T	05_2	124	14	2	1400	2110	710	0.14	1.51	2	3	1
0023	3T	05_2	125	17	2	1700	3400	1700	0.12	2.00	3	6	3
0023	3T	05_2	126	12	0	1200	0	-1200	0.00	0.00	2	0	-2
0023	3T	05_2	134	20	1	2000	680	-1320	0.05	0.34	3	1	-2
0023	3T	05_2	135	13	1	1300	1000	-300	0.08	0.77	2	1	-1
0023	3T	05_2	136	12	0	1200	0	-1200	0.00	0.00	2	0	-2
0023	3T	05_2	145	6	1	600	2060	1460	0.17	3.43	1	3	2
0023	3T	05_2	156	1	0	100	0	-100	0.00	0.00	0	0	0
0023	3T	05_2	164	2	0	200	0	-200	0.00	0.00	0	0	0
0023	3T	05_2	216	1	0	100	0	-100	0.00	0.00	0	0	0
0023	3T	05_2	245	1	0	100	0	-100	0.00	0.00	0	0	0
0023	3T	05_3	123	6	1	600	770	170	0.17	1.28	1	1	0
0023	3T	05_3	124	15	0	1500	0	-1500	0.00	0.00	2	0	-2
0023	3T	05_3	125	28	2	2800	1660	-1140	0.07	0.59	4	2	-2
0023	3T	05_3	126	17	1	1700	1260	-440	0.06	0.74	3	2	-1
0023	3T	05_3	134	13	0	1300	0	-1300	0.00	0.00	2	0	-2
0023	3T	05_3	135	11	0	1100	0	-1100	0.00	0.00	1	0	-1
0023	3T	05_3	136	6	0	600	0	-600	0.00	0.00	1	0	-1
0023	3T	05_3	145	8	1	800	5110	4310	0.13	6.39	1	9	8
0023	3T	05_3	146	4	0	400	0	-400	0.00	0.00	0	0	0
0023	3T	05_3	156	6	0	600	0	-600	0.00	0.00	1	0	-1
0023	3T	05_3	216	3	0	300	0	-300	0.00	0.00	0	0	0
0023	3T	05_3	235	4	0	400	0	-400	0.00	0.00	0	0	0
0023	3T	05_3	236	3	1	300	740	440	0.33	2.47	0	1	1
0023	3T	05_3	245	2	0	200	0	-200	0.00	0.00	0	0	0
0023	3T	05_3	246	1	0	100	0	-100	0.00	0.00	0	0	0
0023	3T	05_4	123	4	0	400	0	-400	0.00	0.00	0	0	0
0023	3T	05_4	124	25	1	2500	990	-1510	0.04	0.40	4	1	-3
0023	3T	05_4	125	13	0	1300	0	-1300	0.00	0.00	2	0	-2
0023	3T	05_4	126	16	0	1600	0	-1600	0.00	0.00	2	0	-2
0023	3T	05_4	134	8	1	800	1560	760	0.13	1.95	1	2	1
0023	3T	05_4	135	18	1	1800	1190	-610	0.06	0.66	3	2	-1
0023	3T	05_4	136	8	3	800	2890	2090	0.38	3.61	1	5	4
0023	3T	05_4	145	8	1	800	1120	320	0.13	1.40	1	1	0
0023	3T	05_4	146	9	0	900	0	-900	0.00	0.00	1	0	-1
0023	3T	05_4	156	3	0	300	0	-300	0.00	0.00	0	0	0
0023	3T	05_4	215	1	0	100	0	-100	0.00	0.00	0	0	0
0023	3T	05_4	216	2	0	200	0	-200	0.00	0.00	0	0	0
0023	3T	05_4	235	4	0	400	0	-400	0.00	0.00	0	0	0
0023	3T	05_4	256	2	0	200	0	-200	0.00	0.00	0	0	0
0023	3T	05_5	123	4	0	400	0	-400	0.00	0.00	0	0	0
0023	3T	05_5	124	21	0	2100	0	-2100	0.00	0.00	3	0	-3
0023	3T	05_5	125	18	3	1800	5110	3310	0.17	2.84	3	9	6
0023	3T	05_5	126	21	0	2100	0	-2100	0.00	0.00	3	0	-3
0023	3T	05_5	134	4	0	400	0	-400	0.00	0.00	0	0	0
0023	3T	05_5	135	16	1	1600	1130	-470	0.06	0.71	2	2	0
0023	3T	05_5	136	12	0	1200	0	-1200	0.00	0.00	2	0	-2
0023	3T	05_5	145	6	0	600	0	-600	0.00	0.00	1	0	-1
0023	3T	05_5	146	8	0	800	0	-800	0.00	0.00	1	0	-1
0023	3T	05_5	156	1	0	100	0	-100	0.00	0.00	0	0	0
0023	3T	05_5	214	2	1	200	3350	3150	0.50	16.75	0	5	5
0023	3T	05_5	215	1	1	100	2250	2150	1.00	22.50	0	3	3
0023	3T	05_5	216	5	0	500	0	-500	0.00	0.00	0	0	0
0023	3T	05_5	235	1	0	100	0	-100	0.00	0.00	0	0	0
0023	3T	05_5	245	1	1	100	860	760	1.00	8.60	0	1	1
0023	3T	05_5	246	1	0	100	0	-100	0.00	0.00	0	0	0
0023	3T	05_6	123	5	0	500	0	-500	0.00	0.00	0	0	0
0023	3T	05_6	124	16	1	1600	640	-960	0.06	0.40	2	1	-1
0023	3T	05_6	125	30	0	3000	0	-3000	0.00	0.00	5	0	-5
0023	3T	05_6	126	20	1	2000	780	-1220	0.05	0.39	3	1	-2
0023	3T	05_6	134	8	1	800	710	-90	0.13	0.89	1	1	0
0023	3T	05_6	135	12	0	1200	0	-1200	0.00	0.00	2	0	-2
0023	3T	05_6	136	13	0	1300	0	-1300	0.00	0.00	2	0	-2
0023	3T	05_6	145	15	2	1500	2530	1030	0.13	1.69	2	4	2
0023	3T	05_6	146	4	0	400	0	-400	0.00	0.00	0	0	0
0023	3T	05_6	156	1	0	100	0	-100	0.00	0.00	0	0	0
0023	3T	05_6	165	2	0	200	0	-200	0.00	0.00	0	0	0
0023	3T	05_6	215	3	0	300	0	-300	0.00	0.00	0	0	0
0023	3T	05_6	216	3	0	300	0	-300	0.00	0.00	0	0	0
0023	3T	05_6	234	2	0	200	0	-200	0.00	0.00	0	0	0
0023	3T	05_6	235	4	0	400	0	-400	0.00	0.00	0	0	0
0023	3T	05_6	236	2	2	200	4540	4340	1.00	22.70	0	8	8
0023	3T	05_6	246	1	0	100	0	-100	0.00	0.00	0	0	0
0023	3T	05_6	256	1	0	100	0	-100	0.00	0.00	0	0	0
0023	3T	05_7	123	11	1	1100	450	-650	0.09	0.41	1	0	-1
0023	3T	05_7	124	40	3	4000	2970	-1030	0.08	0.74	7	5	-2
0023	3T	05_7	125	41	2	4100	5540	1440	0.05	1.35	7	9	2
0023	3T	05_7	126	14	0	1400	0	-1400	0.00	0.00	2	0	-2
0023	3T	05_7	134	15	0	1500	0	-1500	0.00	0.00	2	0	-2
0023	3T	05_7	135	27	1	2700	960	-1740	0.04	0.36	4	1	-3
0023	3T	05_7	136	10	0	1000	0	-1000	0.00	0.00	1	0	-1
0023	3T	05_7	145	8	0	800	0	-800	0.00	0.00	1	0	-1
0023	3T	05_7	146	4	0	400	0	-400	0.00	0.00	0	0	0
0023	3T	05_7	156	1	0	100	0	-100	0.00	0.00	0	0	0
0023	3T	05_7	214	2	0	200	0	-200	0.00	0.00	0	0	0
0023	3T	05_7	215	1	0	100	0	-100	0.00	0.00	0	0	0
0023	3T	05_7	216	6	0	600	0	-600	0.00	0.00	1	0	-1
0023	3T	05_7	235	1	0	100	0	-100	0.00	0.00	0	0	0
0023	3T	05_7	236	1	0	100	0	-100	0.00	0.00	0	0	0
0023	3T	05_7	245	1	0	100	0	-100	0.00	0.00	0	0	0
0023	3T	05_7	246	1	0	100	0	-100	0.00	0.00	0	0	0
0023	3T	05_8	123	7	0	700	0	-700	0.00	0.00	1	0	-1
0023	3T	05_8	124	32	5	3200	5320	2120	0.16	1.66	5	9	4
0023	3T	05_8	125	38	3	3800	2360	-1440	0.08	0.62	6	4	-2
0023	3T	05_8	126	28	3	2800	6080	3280	0.11	2.17	4	10	6
0023	3T	05_8	134	18	0	1800	0	-1800	0.00	0.00	3	0	-3
0023	3T	05_8	135	25	2	2500	1520	-980	0.08	0.61	4	2	-2
0023	3T	05_8	136	14	2	1400	1750	350	0.14	1.25	2	3	1
0023	3T	05_8	142	1	0	100	0	-100	0.00	0.00	0	0	0
0023	3T	05_8	145	5	1	500	680	180	0.20	1.36	0	1	1
0023	3T	05_8	146	3	1	300	810	510	0.33	2.70	0	1	1
0023	3T	05_8	153	1	0	100	0	-100	0.00	0.00	0	0	0
0023	3T	05_8	156	1	0	100	0	-100	0.00	0.00	0	0	0
0023	3T	05_8	214	1	0	100	0	-100	0.00	0.00	0	0	0
0023	3T	05_8	215	2	0	200	0	-200	0.00	0.00	0	0	0
0023	3T	05_8	216	2	0	200	0	-200	0.00	0.00	0	0	0
0023	3T	05_8	234	2	0	200	0	-200	0.00	0.00	0	0	0
0023	3T	05_8	235	2	0	200	0	-200	0.00	0.00	0	0	0
0023	3T	05_8	236	1	0	100	0	-100	0.00	0.00	0	0	0
0023	3T	05_9	123	46	8	4600	4850	250	0.17	1.05	8	8	0
0023	3T	05_9	124	48	3	4800	3610	-1190	0.06	0.75	8	6	-2
0023	3T	05_9	125	26	1	2600	590	-2010	0.04	0.23	4	1	-3
0023	3T	05_9	126	16	2	1600	1310	-290	0.13	0.82	2	2	0
0023	3T	05_9	132	4	0	400	0	-400	0.00	0.00	0	0	0
0023	3T	05_9	134	14	0	1400	0	-1400	0.00	0.00	2	0	-2
0023	3T	05_9	135	10	0	1000	0	-1000	0.00	0.00	1	0	-1
0023	3T	05_9	136	3	0	300	0	-300	0.00	0.00	0	0	0
0023	3T	05_9	142	2	0	200	0	-200	0.00	0.00	0	0	0
0023	3T	05_9	145	1	0	100	0	-100	0.00	0.00	0	0	0
0023	3T	05_9	152	1	1	100	1160	1060	1.00	11.60	0	2	2
0023	3T	05_9	153	1	0	100	0	-100	0.00	0.00	0	0	0
0023	3T	06_1	123	22	1	2200	750	-1450	0.05	0.34	3	1	-2
0023	3T	06_1	124	64	7	6400	7880	1480	0.11	1.23	11	13	2
0023	3T	06_1	125	23	0	2300	0	-2300	0.00	0.00	4	0	-4
0023	3T	06_1	126	20	0	2000	0	-2000	0.00	0.00	3	0	-3
0023	3T	06_1	134	12	1	1200	640	-560	0.08	0.53	2	1	-1
0023	3T	06_1	135	6	0	600	0	-600	0.00	0.00	1	0	-1
0023	3T	06_1	136	4	0	400	0	-400	0.00	0.00	0	0	0
0023	3T	06_1	143	1	0	100	0	-100	0.00	0.00	0	0	0
0023	3T	06_1	145	3	0	300	0	-300	0.00	0.00	0	0	0
0023	3T	06_1	146	1	0	100	0	-100	0.00	0.00	0	0	0
0023	3T	06_1	153	3	0	300	0	-300	0.00	0.00	0	0	0
0023	3T	06_1	156	1	0	100	0	-100	0.00	0.00	0	0	0
0023	3T	06_1	234	1	0	100	0	-100	0.00	0.00	0	0	0
0023	3T	06_1	235	1	0	100	0	-100	0.00	0.00	0	0	0
0023	3T	06_1	253	1	0	100	0	-100	0.00	0.00	0	0	0
0023	3T	06_10	123	7	1	700	1930	1230	0.14	2.76	1	3	2
0023	3T	06_10	124	54	7	5400	4530	-870	0.13	0.84	9	8	-1
0023	3T	06_10	125	69	9	6900	12960	6060	0.13	1.88	12	22	10
0023	3T	06_10	126	11	0	1100	0	-1100	0.00	0.00	1	0	-1
0023	3T	06_10	134	25	2	2500	1060	-1440	0.08	0.42	4	1	-3
0023	3T	06_10	135	42	0	4200	0	-4200	0.00	0.00	7	0	-7
0023	3T	06_10	136	11	1	1100	1440	340	0.09	1.31	1	2	1
0023	3T	06_10	145	9	0	900	0	-900	0.00	0.00	1	0	-1
0023	3T	06_10	146	2	0	200	0	-200	0.00	0.00	0	0	0
0023	3T	06_10	165	1	0	100	0	-100	0.00	0.00	0	0	0
0023	3T	06_10	216	1	0	100	0	-100	0.00	0.00	0	0	0
0023	3T	06_10	256	1	0	100	0	-100	0.00	0.00	0	0	0
0023	3T	06_11	123	16	6	1600	3770	2170	0.38	2.36	2	6	4
0023	3T	06_11	124	51	9	5100	5870	770	0.18	1.15	9	10	1
0023	3T	06_11	125	64	3	6400	3700	-2700	0.05	0.58	11	6	-5
0023	3T	06_11	126	8	1	800	1420	620	0.13	1.78	1	2	1
0023	3T	06_11	134	40	4	4000	4890	890	0.10	1.22	7	8	1
0023	3T	06_11	135	53	3	5300	3760	-1540	0.06	0.71	9	6	-3
0023	3T	06_11	136	3	0	300	0	-300	0.00	0.00	0	0	0
0023	3T	06_11	145	11	2	1100	2070	970	0.18	1.88	1	3	2
0023	3T	06_11	146	2	0	200	0	-200	0.00	0.00	0	0	0
0023	3T	06_12	123	6	1	600	480	-120	0.17	0.80	1	0	-1
0023	3T	06_12	124	41	7	4100	5850	1750	0.17	1.43	7	10	3
0023	3T	06_12	125	115	6	11500	8680	-2820	0.05	0.75	20	15	-5
0023	3T	06_12	134	20	4	2000	3800	1800	0.20	1.90	3	6	3
0023	3T	06_12	135	73	6	7300	5430	-1870	0.08	0.74	12	9	-3
0023	3T	06_12	136	2	0	200	0	-200	0.00	0.00	0	0	0
0023	3T	06_12	145	7	2	700	2460	1760	0.29	3.51	1	4	3
0023	3T	06_12	146	1	0	100	0	-100	0.00	0.00	0	0	0
0023	3T	06_2	123	6	1	600	650	50	0.17	1.08	1	1	0
0023	3T	06_2	124	21	1	2100	1050	-1050	0.05	0.50	3	1	-2
0023	3T	06_2	125	21	1	2100	1730	-370	0.05	0.82	3	3	0
0023	3T	06_2	126	27	0	2700	0	-2700	0.00	0.00	4	0	-4
0023	3T	06_2	134	10	0	1000	0	-1000	0.00	0.00	1	0	-1
0023	3T	06_2	135	17	0	1700	0	-1700	0.00	0.00	3	0	-3
0023	3T	06_2	136	10	0	1000	0	-1000	0.00	0.00	1	0	-1
0023	3T	06_2	145	4	0	400	0	-400	0.00	0.00	0	0	0
0023	3T	06_2	146	4	0	400	0	-400	0.00	0.00	0	0	0
0023	3T	06_2	153	1	0	100	0	-100	0.00	0.00	0	0	0
0023	3T	06_2	156	1	0	100	0	-100	0.00	0.00	0	0	0
0023	3T	06_2	215	2	0	200	0	-200	0.00	0.00	0	0	0
0023	3T	06_2	234	2	0	200	0	-200	0.00	0.00	0	0	0
0023	3T	06_2	235	4	0	400	0	-400	0.00	0.00	0	0	0
0023	3T	06_2	236	2	0	200	0	-200	0.00	0.00	0	0	0
0023	3T	06_2	246	1	0	100	0	-100	0.00	0.00	0	0	0
0023	3T	06_3	123	7	2	700	1880	1180	0.29	2.69	1	3	2
0023	3T	06_3	124	9	0	900	0	-900	0.00	0.00	1	0	-1
0023	3T	06_3	125	23	2	2300	1000	-1300	0.09	0.43	4	1	-3
0023	3T	06_3	126	19	1	1900	7950	6050	0.05	4.18	3	14	11
0023	3T	06_3	134	8	0	800	0	-800	0.00	0.00	1	0	-1
0023	3T	06_3	135	12	1	1200	5630	4430	0.08	4.69	2	9	7
0023	3T	06_3	136	19	2	1900	2200	300	0.11	1.16	3	3	0
0023	3T	06_3	145	4	0	400	0	-400	0.00	0.00	0	0	0
0023	3T	06_3	146	6	1	600	5360	4760	0.17	8.93	1	9	8
0023	3T	06_3	152	1	0	100	0	-100	0.00	0.00	0	0	0
0023	3T	06_3	153	1	0	100	0	-100	0.00	0.00	0	0	0
0023	3T	06_3	154	1	0	100	0	-100	0.00	0.00	0	0	0
0023	3T	06_3	215	1	0	100	0	-100	0.00	0.00	0	0	0
0023	3T	06_3	216	6	1	600	2860	2260	0.17	4.77	1	5	4
0023	3T	06_3	234	1	0	100	0	-100	0.00	0.00	0	0	0
0023	3T	06_3	235	2	0	200	0	-200	0.00	0.00	0	0	0
0023	3T	06_3	245	2	0	200	0	-200	0.00	0.00	0	0	0
0023	3T	06_3	246	3	0	300	0	-300	0.00	0.00	0	0	0
0023	3T	06_3	253	1	0	100	0	-100	0.00	0.00	0	0	0
0023	3T	06_3	256	1	0	100	0	-100	0.00	0.00	0	0	0
0023	3T	06_4	123	46	10	4600	8320	3720	0.22	1.81	8	14	6
0023	3T	06_4	124	72	5	7200	5140	-2060	0.07	0.71	12	9	-3
0023	3T	06_4	125	20	3	2000	2000	0	0.15	1.00	3	3	0
0023	3T	06_4	126	13	2	1300	2130	830	0.15	1.64	2	3	1
0023	3T	06_4	132	1	0	100	0	-100	0.00	0.00	0	0	0
0023	3T	06_4	134	22	4	2200	2050	-150	0.18	0.93	3	3	0
0023	3T	06_4	135	4	0	400	0	-400	0.00	0.00	0	0	0
0023	3T	06_4	136	3	0	300	0	-300	0.00	0.00	0	0	0
0023	3T	06_4	145	1	0	100	0	-100	0.00	0.00	0	0	0
0023	3T	06_4	153	4	0	400	0	-400	0.00	0.00	0	0	0
0023	3T	06_5	123	5	0	500	0	-500	0.00	0.00	0	0	0
0023	3T	06_5	124	15	2	1500	4070	2570	0.13	2.71	2	7	5
0023	3T	06_5	125	17	1	1700	1340	-360	0.06	0.79	3	2	-1
0023	3T	06_5	126	17	0	1700	0	-1700	0.00	0.00	3	0	-3
0023	3T	06_5	134	12	0	1200	0	-1200	0.00	0.00	2	0	-2
0023	3T	06_5	135	19	0	1900	0	-1900	0.00	0.00	3	0	-3
0023	3T	06_5	136	14	0	1400	0	-1400	0.00	0.00	2	0	-2
0023	3T	06_5	145	7	1	700	830	130	0.14	1.19	1	1	0
0023	3T	06_5	146	5	0	500	0	-500	0.00	0.00	0	0	0
0023	3T	06_5	164	1	0	100	0	-100	0.00	0.00	0	0	0
0023	3T	06_5	215	1	1	100	2080	1980	1.00	20.80	0	3	3
0023	3T	06_5	216	5	0	500	0	-500	0.00	0.00	0	0	0
0023	3T	06_5	235	2	0	200	0	-200	0.00	0.00	0	0	0
0023	3T	06_5	236	4	0	400	0	-400	0.00	0.00	0	0	0
0023	3T	06_5	246	3	0	300	0	-300	0.00	0.00	0	0	0
0023	3T	06_5	253	1	1	100	960	860	1.00	9.60	0	1	1
0023	3T	06_5	256	1	0	100	0	-100	0.00	0.00	0	0	0
0023	3T	06_6	123	7	0	700	0	-700	0.00	0.00	1	0	-1
0023	3T	06_6	124	14	0	1400	0	-1400	0.00	0.00	2	0	-2
0023	3T	06_6	125	25	1	2500	1500	-1000	0.04	0.60	4	2	-2
0023	3T	06_6	126	22	1	2200	330	-1870	0.05	0.15	3	0	-3
0023	3T	06_6	134	13	2	1300	2970	1670	0.15	2.28	2	5	3
0023	3T	06_6	135	13	2	1300	1600	300	0.15	1.23	2	2	0
0023	3T	06_6	136	17	3	1700	2330	630	0.18	1.37	3	4	1
0023	3T	06_6	142	1	0	100	0	-100	0.00	0.00	0	0	0
0023	3T	06_6	145	6	0	600	0	-600	0.00	0.00	1	0	-1
0023	3T	06_6	146	6	0	600	0	-600	0.00	0.00	1	0	-1
0023	3T	06_6	153	2	0	200	0	-200	0.00	0.00	0	0	0
0023	3T	06_6	156	1	0	100	0	-100	0.00	0.00	0	0	0
0023	3T	06_6	213	1	0	100	0	-100	0.00	0.00	0	0	0
0023	3T	06_6	214	1	0	100	0	-100	0.00	0.00	0	0	0
0023	3T	06_6	215	2	0	200	0	-200	0.00	0.00	0	0	0
0023	3T	06_6	216	1	0	100	0	-100	0.00	0.00	0	0	0
0023	3T	06_6	234	2	0	200	0	-200	0.00	0.00	0	0	0
0023	3T	06_6	235	1	0	100	0	-100	0.00	0.00	0	0	0
0023	3T	06_6	245	1	0	100	0	-100	0.00	0.00	0	0	0
0023	3T	06_6	246	1	0	100	0	-100	0.00	0.00	0	0	0
0023	3T	06_6	256	1	0	100	0	-100	0.00	0.00	0	0	0
0023	3T	06_7	123	8	1	800	780	-20	0.13	0.98	1	1	0
0023	3T	06_7	124	36	3	3600	4210	610	0.08	1.17	6	7	1
0023	3T	06_7	125	39	2	3900	1170	-2730	0.05	0.30	6	2	-4
0023	3T	06_7	126	27	1	2700	920	-1780	0.04	0.34	4	1	-3
0023	3T	06_7	134	18	0	1800	0	-1800	0.00	0.00	3	0	-3
0023	3T	06_7	135	21	1	2100	470	-1630	0.05	0.22	3	0	-3
0023	3T	06_7	136	26	0	2600	0	-2600	0.00	0.00	4	0	-4
0023	3T	06_7	143	1	0	100	0	-100	0.00	0.00	0	0	0
0023	3T	06_7	145	8	0	800	0	-800	0.00	0.00	1	0	-1
0023	3T	06_7	146	10	0	1000	0	-1000	0.00	0.00	1	0	-1
0023	3T	06_7	153	3	1	300	730	430	0.33	2.43	0	1	1
0023	3T	06_7	156	3	0	300	0	-300	0.00	0.00	0	0	0
0023	3T	06_7	163	1	0	100	0	-100	0.00	0.00	0	0	0
0023	3T	06_7	165	1	0	100	0	-100	0.00	0.00	0	0	0
0023	3T	06_7	215	1	0	100	0	-100	0.00	0.00	0	0	0
0023	3T	06_7	236	1	0	100	0	-100	0.00	0.00	0	0	0
0023	3T	06_7	246	2	2	200	3850	3650	1.00	19.25	0	6	6
0023	3T	06_8	123	9	2	900	1420	520	0.22	1.58	1	2	1
0023	3T	06_8	124	20	0	2000	0	-2000	0.00	0.00	3	0	-3
0023	3T	06_8	125	31	0	3100	0	-3100	0.00	0.00	5	0	-5
0023	3T	06_8	126	28	2	2800	4270	1470	0.07	1.53	4	7	3
0023	3T	06_8	134	29	1	2900	680	-2220	0.03	0.23	5	1	-4
0023	3T	06_8	135	31	6	3100	4970	1870	0.19	1.60	5	8	3
0023	3T	06_8	136	10	0	1000	0	-1000	0.00	0.00	1	0	-1
0023	3T	06_8	142	3	0	300	0	-300	0.00	0.00	0	0	0
0023	3T	06_8	145	8	2	800	1870	1070	0.25	2.34	1	3	2
0023	3T	06_8	146	10	1	1000	2960	1960	0.10	2.96	1	5	4
0023	3T	06_8	153	2	0	200	0	-200	0.00	0.00	0	0	0
0023	3T	06_8	156	1	0	100	0	-100	0.00	0.00	0	0	0
0023	3T	06_8	163	1	0	100	0	-100	0.00	0.00	0	0	0
0023	3T	06_8	164	1	0	100	0	-100	0.00	0.00	0	0	0
0023	3T	06_8	215	1	0	100	0	-100	0.00	0.00	0	0	0
0023	3T	06_8	216	2	0	200	0	-200	0.00	0.00	0	0	0
0023	3T	06_9	123	15	1	1500	310	-1190	0.07	0.21	2	0	-2
0023	3T	06_9	124	54	8	5400	5300	-100	0.15	0.98	9	9	0
0023	3T	06_9	125	35	1	3500	570	-2930	0.03	0.16	6	1	-5
0023	3T	06_9	126	5	0	500	0	-500	0.00	0.00	0	0	0
0023	3T	06_9	134	23	1	2300	1040	-1260	0.04	0.45	4	1	-3
0023	3T	06_9	135	27	1	2700	810	-1890	0.04	0.30	4	1	-3
0023	3T	06_9	136	5	0	500	0	-500	0.00	0.00	0	0	0
0023	3T	06_9	143	1	0	100	0	-100	0.00	0.00	0	0	0
0023	3T	06_9	145	11	0	1100	0	-1100	0.00	0.00	1	0	-1
0023	3T	06_9	146	2	0	200	0	-200	0.00	0.00	0	0	0
0023	3T	06_9	153	1	0	100	0	-100	0.00	0.00	0	0	0
0023	3T	06_9	215	2	0	200	0	-200	0.00	0.00	0	0	0
0023	3T	06_9	235	2	0	200	0	-200	0.00	0.00	0	0	0
0023	3T	07_1	123	24	2	2400	2350	-50	0.08	0.98	4	4	0
0023	3T	07_1	124	16	0	1600	0	-1600	0.00	0.00	2	0	-2
0023	3T	07_1	125	15	1	1500	1300	-200	0.07	0.87	2	2	0
0023	3T	07_1	126	7	0	700	0	-700	0.00	0.00	1	0	-1
0023	3T	07_1	132	2	0	200	0	-200	0.00	0.00	0	0	0
0023	3T	07_1	134	13	1	1300	620	-680	0.08	0.48	2	1	-1
0023	3T	07_1	135	7	1	700	1140	440	0.14	1.63	1	2	1
0023	3T	07_1	136	5	0	500	0	-500	0.00	0.00	0	0	0
0023	3T	07_1	145	5	0	500	0	-500	0.00	0.00	0	0	0
0023	3T	07_1	152	1	0	100	0	-100	0.00	0.00	0	0	0
0023	3T	07_1	156	1	0	100	0	-100	0.00	0.00	0	0	0
0023	3T	07_10	123	39	5	3900	3000	-900	0.13	0.77	6	5	-1
0023	3T	07_10	124	87	10	8700	7480	-1220	0.11	0.86	15	13	-2
0023	3T	07_10	125	34	1	3400	1310	-2090	0.03	0.39	6	2	-4
0023	3T	07_10	126	15	0	1500	0	-1500	0.00	0.00	2	0	-2
0023	3T	07_10	132	1	0	100	0	-100	0.00	0.00	0	0	0
0023	3T	07_10	134	31	3	3100	2350	-750	0.10	0.76	5	4	-1
0023	3T	07_10	135	20	1	2000	1540	-460	0.05	0.77	3	2	-1
0023	3T	07_10	136	9	0	900	0	-900	0.00	0.00	1	0	-1
0023	3T	07_10	145	3	1	300	540	240	0.33	1.80	0	0	0
0023	3T	07_10	146	4	0	400	0	-400	0.00	0.00	0	0	0
0023	3T	07_10	154	1	0	100	0	-100	0.00	0.00	0	0	0
0023	3T	07_10	156	1	0	100	0	-100	0.00	0.00	0	0	0
0023	3T	07_10	235	1	0	100	0	-100	0.00	0.00	0	0	0
0023	3T	07_11	123	31	5	3100	3340	240	0.16	1.08	5	5	0
0023	3T	07_11	124	95	5	9500	4530	-4970	0.05	0.48	16	8	-8
0023	3T	07_11	125	26	2	2600	1540	-1060	0.08	0.59	4	2	-2
0023	3T	07_11	126	12	1	1200	4610	3410	0.08	3.84	2	8	6
0023	3T	07_11	134	39	4	3900	3240	-660	0.10	0.83	6	5	-1
0023	3T	07_11	135	33	1	3300	460	-2840	0.03	0.14	5	0	-5
0023	3T	07_11	136	6	0	600	0	-600	0.00	0.00	1	0	-1
0023	3T	07_11	145	2	0	200	0	-200	0.00	0.00	0	0	0
0023	3T	07_11	146	2	1	200	760	560	0.50	3.80	0	1	1
0023	3T	07_11	156	1	0	100	0	-100	0.00	0.00	0	0	0
0023	3T	07_12	123	16	2	1600	2090	490	0.13	1.31	2	3	1
0023	3T	07_12	124	114	7	11400	5440	-5960	0.06	0.48	20	9	-11
0023	3T	07_12	125	22	1	2200	1590	-610	0.05	0.72	3	2	-1
0023	3T	07_12	126	28	2	2800	2960	160	0.07	1.06	4	5	1
0023	3T	07_12	132	1	0	100	0	-100	0.00	0.00	0	0	0
0023	3T	07_12	134	29	0	2900	0	-2900	0.00	0.00	5	0	-5
0023	3T	07_12	135	14	0	1400	0	-1400	0.00	0.00	2	0	-2
0023	3T	07_12	136	6	0	600	0	-600	0.00	0.00	1	0	-1
0023	3T	07_12	145	8	1	800	1100	300	0.13	1.38	1	1	0
0023	3T	07_12	146	3	1	300	3020	2720	0.33	10.07	0	5	5
0023	3T	07_2	123	20	4	2000	4850	2850	0.20	2.43	3	8	5
0023	3T	07_2	124	17	1	1700	850	-850	0.06	0.50	3	1	-2
0023	3T	07_2	125	13	1	1300	1250	-50	0.08	0.96	2	2	0
0023	3T	07_2	126	24	1	2400	4860	2460	0.04	2.03	4	8	4
0023	3T	07_2	134	6	0	600	0	-600	0.00	0.00	1	0	-1
0023	3T	07_2	135	4	0	400	0	-400	0.00	0.00	0	0	0
0023	3T	07_2	136	12	1	1200	2060	860	0.08	1.72	2	3	1
0023	3T	07_2	143	1	0	100	0	-100	0.00	0.00	0	0	0
0023	3T	07_2	145	2	0	200	0	-200	0.00	0.00	0	0	0
0023	3T	07_2	146	3	0	300	0	-300	0.00	0.00	0	0	0
0023	3T	07_2	152	1	0	100	0	-100	0.00	0.00	0	0	0
0023	3T	07_2	156	3	0	300	0	-300	0.00	0.00	0	0	0
0023	3T	07_2	235	2	0	200	0	-200	0.00	0.00	0	0	0
0023	3T	07_2	245	1	0	100	0	-100	0.00	0.00	0	0	0
0023	3T	07_2	256	1	0	100	0	-100	0.00	0.00	0	0	0
0023	3T	07_3	123	14	3	1400	2320	920	0.21	1.66	2	4	2
0023	3T	07_3	124	20	0	2000	0	-2000	0.00	0.00	3	0	-3
0023	3T	07_3	125	26	1	2600	5680	3080	0.04	2.18	4	10	6
0023	3T	07_3	126	23	2	2300	2110	-190	0.09	0.92	4	3	-1
0023	3T	07_3	134	12	0	1200	0	-1200	0.00	0.00	2	0	-2
0023	3T	07_3	135	22	0	2200	0	-2200	0.00	0.00	3	0	-3
0023	3T	07_3	136	10	1	1000	1170	170	0.10	1.17	1	2	1
0023	3T	07_3	145	4	0	400	0	-400	0.00	0.00	0	0	0
0023	3T	07_3	146	4	0	400	0	-400	0.00	0.00	0	0	0
0023	3T	07_3	156	5	0	500	0	-500	0.00	0.00	0	0	0
0023	3T	07_3	214	1	0	100	0	-100	0.00	0.00	0	0	0
0023	3T	07_3	216	1	0	100	0	-100	0.00	0.00	0	0	0
0023	3T	07_3	234	1	0	100	0	-100	0.00	0.00	0	0	0
0023	3T	07_3	235	1	0	100	0	-100	0.00	0.00	0	0	0
0023	3T	07_3	236	1	0	100	0	-100	0.00	0.00	0	0	0
0023	3T	07_3	245	1	0	100	0	-100	0.00	0.00	0	0	0
0023	3T	07_4	123	13	2	1300	1310	10	0.15	1.01	2	2	0
0023	3T	07_4	124	21	1	2100	700	-1400	0.05	0.33	3	1	-2
0023	3T	07_4	125	32	3	3200	2690	-510	0.09	0.84	5	4	-1
0023	3T	07_4	126	34	3	3400	5570	2170	0.09	1.64	6	9	3
0023	3T	07_4	134	15	1	1500	950	-550	0.07	0.63	2	1	-1
0023	3T	07_4	135	17	1	1700	1230	-470	0.06	0.72	3	2	-1
0023	3T	07_4	136	15	1	1500	1460	-40	0.07	0.97	2	2	0
0023	3T	07_4	145	6	0	600	0	-600	0.00	0.00	1	0	-1
0023	3T	07_4	146	2	0	200	0	-200	0.00	0.00	0	0	0
0023	3T	07_4	156	6	0	600	0	-600	0.00	0.00	1	0	-1
0023	3T	07_4	235	1	0	100	0	-100	0.00	0.00	0	0	0
0023	3T	07_4	236	1	0	100	0	-100	0.00	0.00	0	0	0
0023	3T	07_4	245	1	0	100	0	-100	0.00	0.00	0	0	0
0023	3T	07_4	246	1	0	100	0	-100	0.00	0.00	0	0	0
0023	3T	07_5	123	19	2	1900	1210	-690	0.11	0.64	3	2	-1
0023	3T	07_5	124	29	2	2900	1920	-980	0.07	0.66	5	3	-2
0023	3T	07_5	125	19	2	1900	2870	970	0.11	1.51	3	5	2
0023	3T	07_5	126	24	1	2400	1300	-1100	0.04	0.54	4	2	-2
0023	3T	07_5	134	11	0	1100	0	-1100	0.00	0.00	1	0	-1
0023	3T	07_5	135	5	0	500	0	-500	0.00	0.00	0	0	0
0023	3T	07_5	136	15	4	1500	4180	2680	0.27	2.79	2	7	5
0023	3T	07_5	145	2	0	200	0	-200	0.00	0.00	0	0	0
0023	3T	07_5	146	5	0	500	0	-500	0.00	0.00	0	0	0
0023	3T	07_5	156	4	2	400	3070	2670	0.50	7.68	0	5	5
0023	3T	07_5	216	2	0	200	0	-200	0.00	0.00	0	0	0
0023	3T	07_5	235	3	0	300	0	-300	0.00	0.00	0	0	0
0023	3T	07_5	236	4	1	400	1260	860	0.25	3.15	0	2	2
0023	3T	07_5	256	2	0	200	0	-200	0.00	0.00	0	0	0
0023	3T	07_6	123	13	2	1300	890	-410	0.15	0.68	2	1	-1
0023	3T	07_6	124	23	1	2300	780	-1520	0.04	0.34	4	1	-3
0023	3T	07_6	125	28	3	2800	4110	1310	0.11	1.47	4	7	3
0023	3T	07_6	126	38	3	3800	3860	60	0.08	1.02	6	6	0
0023	3T	07_6	134	8	1	800	2190	1390	0.13	2.74	1	3	2
0023	3T	07_6	135	18	1	1800	1070	-730	0.06	0.59	3	1	-2
0023	3T	07_6	136	15	4	1500	5740	4240	0.27	3.83	2	10	8
0023	3T	07_6	145	5	0	500	0	-500	0.00	0.00	0	0	0
0023	3T	07_6	146	6	0	600	0	-600	0.00	0.00	1	0	-1
0023	3T	07_6	156	8	3	800	3190	2390	0.38	3.99	1	5	4
0023	3T	07_6	213	1	0	100	0	-100	0.00	0.00	0	0	0
0023	3T	07_6	235	1	0	100	0	-100	0.00	0.00	0	0	0
0023	3T	07_6	236	2	0	200	0	-200	0.00	0.00	0	0	0
0023	3T	07_7	123	5	0	500	0	-500	0.00	0.00	0	0	0
0023	3T	07_7	124	30	4	3000	2700	-300	0.13	0.90	5	4	-1
0023	3T	07_7	125	13	1	1300	1180	-120	0.08	0.91	2	2	0
0023	3T	07_7	134	83	14	8300	7300	-1000	0.17	0.88	14	12	-2
0023	3T	07_7	135	12	0	1200	0	-1200	0.00	0.00	2	0	-2
0023	3T	07_7	143	1	0	100	0	-100	0.00	0.00	0	0	0
0023	3T	07_7	145	57	5	5700	3780	-1920	0.09	0.66	10	6	-4
0023	3T	07_7	146	1	0	100	0	-100	0.00	0.00	0	0	0
0023	3T	07_7	154	1	0	100	0	-100	0.00	0.00	0	0	0
0023	3T	07_8	123	35	0	3500	0	-3500	0.00	0.00	6	0	-6
0023	3T	07_8	124	45	2	4500	1020	-3480	0.04	0.23	7	1	-6
0023	3T	07_8	125	27	4	2700	3780	1080	0.15	1.40	4	6	2
0023	3T	07_8	126	11	0	1100	0	-1100	0.00	0.00	1	0	-1
0023	3T	07_8	134	20	0	2000	0	-2000	0.00	0.00	3	0	-3
0023	3T	07_8	135	18	1	1800	750	-1050	0.06	0.42	3	1	-2
0023	3T	07_8	136	5	0	500	0	-500	0.00	0.00	0	0	0
0023	3T	07_8	143	4	0	400	0	-400	0.00	0.00	0	0	0
0023	3T	07_8	145	5	1	500	1590	1090	0.20	3.18	0	2	2
0023	3T	07_8	146	8	1	800	860	60	0.13	1.08	1	1	0
0023	3T	07_8	153	4	0	400	0	-400	0.00	0.00	0	0	0
0023	3T	07_8	156	1	0	100	0	-100	0.00	0.00	0	0	0
0023	3T	07_8	163	1	0	100	0	-100	0.00	0.00	0	0	0
0023	3T	07_8	165	1	0	100	0	-100	0.00	0.00	0	0	0
0023	3T	07_8	213	3	0	300	0	-300	0.00	0.00	0	0	0
0023	3T	07_8	214	1	1	100	840	740	1.00	8.40	0	1	1
0023	3T	07_8	215	2	0	200	0	-200	0.00	0.00	0	0	0
0023	3T	07_8	216	2	0	200	0	-200	0.00	0.00	0	0	0
0023	3T	07_8	245	1	0	100	0	-100	0.00	0.00	0	0	0
0023	3T	07_9	123	26	1	2600	760	-1840	0.04	0.29	4	1	-3
0023	3T	07_9	124	74	3	7400	2370	-5030	0.04	0.32	13	4	-9
0023	3T	07_9	125	25	4	2500	2930	430	0.16	1.17	4	5	1
0023	3T	07_9	126	7	1	700	1500	800	0.14	2.14	1	2	1
0023	3T	07_9	134	41	3	4100	2000	-2100	0.07	0.49	7	3	-4
0023	3T	07_9	135	13	1	1300	350	-950	0.08	0.27	2	0	-2
0023	3T	07_9	136	1	0	100	0	-100	0.00	0.00	0	0	0
0023	3T	07_9	143	1	0	100	0	-100	0.00	0.00	0	0	0
0023	3T	07_9	145	5	1	500	800	300	0.20	1.60	0	1	1
0023	3T	07_9	146	2	0	200	0	-200	0.00	0.00	0	0	0
0023	3T	07_9	153	3	0	300	0	-300	0.00	0.00	0	0	0
0023	3T	07_9	154	1	0	100	0	-100	0.00	0.00	0	0	0
0023	3T	07_9	214	2	0	200	0	-200	0.00	0.00	0	0	0
0023	3T	07_9	263	1	0	100	0	-100	0.00	0.00	0	0	0
0023	3T	07_9	264	1	0	100	0	-100	0.00	0.00	0	0	0
0023	3T	08_1	123	19	1	1900	550	-1350	0.05	0.29	3	0	-3
0023	3T	08_1	124	21	0	2100	0	-2100	0.00	0.00	3	0	-3
0023	3T	08_1	125	18	2	1800	1210	-590	0.11	0.67	3	2	-1
0023	3T	08_1	126	6	2	600	1790	1190	0.33	2.98	1	3	2
0023	3T	08_1	132	4	0	400	0	-400	0.00	0.00	0	0	0
0023	3T	08_1	134	9	0	900	0	-900	0.00	0.00	1	0	-1
0023	3T	08_1	135	8	0	800	0	-800	0.00	0.00	1	0	-1
0023	3T	08_1	136	7	0	700	0	-700	0.00	0.00	1	0	-1
0023	3T	08_1	142	4	0	400	0	-400	0.00	0.00	0	0	0
0023	3T	08_1	143	1	0	100	0	-100	0.00	0.00	0	0	0
0023	3T	08_1	145	7	0	700	0	-700	0.00	0.00	1	0	-1
0023	3T	08_1	146	2	0	200	0	-200	0.00	0.00	0	0	0
0023	3T	08_1	152	2	0	200	0	-200	0.00	0.00	0	0	0
0023	3T	08_1	156	2	0	200	0	-200	0.00	0.00	0	0	0
0023	3T	08_1	235	1	0	100	0	-100	0.00	0.00	0	0	0
0023	3T	08_10	123	30	5	3000	2730	-270	0.17	0.91	5	4	-1
0023	3T	08_10	124	95	9	9500	6450	-3050	0.09	0.68	16	11	-5
0023	3T	08_10	125	33	0	3300	0	-3300	0.00	0.00	5	0	-5
0023	3T	08_10	126	29	2	2900	2080	-820	0.07	0.72	5	3	-2
0023	3T	08_10	134	24	3	2400	2180	-220	0.13	0.91	4	3	-1
0023	3T	08_10	135	10	1	1000	490	-510	0.10	0.49	1	0	-1
0023	3T	08_10	136	12	1	1200	880	-320	0.08	0.73	2	1	-1
0023	3T	08_10	146	3	0	300	0	-300	0.00	0.00	0	0	0
0023	3T	08_10	156	1	0	100	0	-100	0.00	0.00	0	0	0
0023	3T	08_10	213	1	0	100	0	-100	0.00	0.00	0	0	0
0023	3T	08_10	236	1	1	100	700	600	1.00	7.00	0	1	1
0023	3T	08_11	123	34	6	3400	3060	-340	0.18	0.90	6	5	-1
0023	3T	08_11	124	119	13	11900	8490	-3410	0.11	0.71	21	15	-6
0023	3T	08_11	125	26	1	2600	790	-1810	0.04	0.30	4	1	-3
0023	3T	08_11	126	11	1	1100	1610	510	0.09	1.46	1	2	1
0023	3T	08_11	134	25	3	2500	2840	340	0.12	1.14	4	5	1
0023	3T	08_11	135	12	1	1200	900	-300	0.08	0.75	2	1	-1
0023	3T	08_11	136	5	0	500	0	-500	0.00	0.00	0	0	0
0023	3T	08_11	145	3	1	300	690	390	0.33	2.30	0	1	1
0023	3T	08_11	146	2	0	200	0	-200	0.00	0.00	0	0	0
0023	3T	08_11	216	1	0	100	0	-100	0.00	0.00	0	0	0
0023	3T	08_12	123	27	7	2700	3440	740	0.26	1.27	4	6	2
0023	3T	08_12	124	194	23	19400	19190	-210	0.12	0.99	34	33	-1
0023	3T	08_12	125	16	2	1600	1950	350	0.13	1.22	2	3	1
0023	3T	08_12	126	1	0	100	0	-100	0.00	0.00	0	0	0
0023	3T	08_12	134	16	2	1600	1610	10	0.13	1.01	2	2	0
0023	3T	08_12	135	6	0	600	0	-600	0.00	0.00	1	0	-1
0023	3T	08_12	136	4	0	400	0	-400	0.00	0.00	0	0	0
0023	3T	08_2	123	24	2	2400	2590	190	0.08	1.08	4	4	0
0023	3T	08_2	124	15	1	1500	940	-560	0.07	0.63	2	1	-1
0023	3T	08_2	125	23	2	2300	3080	780	0.09	1.34	4	5	1
0023	3T	08_2	126	24	2	2400	1780	-620	0.08	0.74	4	3	-1
0023	3T	08_2	132	2	0	200	0	-200	0.00	0.00	0	0	0
0023	3T	08_2	134	12	0	1200	0	-1200	0.00	0.00	2	0	-2
0023	3T	08_2	135	12	1	1200	910	-290	0.08	0.76	2	1	-1
0023	3T	08_2	136	9	0	900	0	-900	0.00	0.00	1	0	-1
0023	3T	08_2	142	1	0	100	0	-100	0.00	0.00	0	0	0
0023	3T	08_2	143	1	0	100	0	-100	0.00	0.00	0	0	0
0023	3T	08_2	145	8	0	800	0	-800	0.00	0.00	1	0	-1
0023	3T	08_2	146	5	0	500	0	-500	0.00	0.00	0	0	0
0023	3T	08_2	153	1	0	100	0	-100	0.00	0.00	0	0	0
0023	3T	08_2	156	2	0	200	0	-200	0.00	0.00	0	0	0
0023	3T	08_2	215	1	0	100	0	-100	0.00	0.00	0	0	0
0023	3T	08_2	234	1	0	100	0	-100	0.00	0.00	0	0	0
0023	3T	08_3	123	15	1	1500	910	-590	0.07	0.61	2	1	-1
0023	3T	08_3	124	27	3	2700	2540	-160	0.11	0.94	4	4	0
0023	3T	08_3	125	23	1	2300	1430	-870	0.04	0.62	4	2	-2
0023	3T	08_3	126	29	3	2900	2910	10	0.10	1.00	5	5	0
0023	3T	08_3	134	8	2	800	1390	590	0.25	1.74	1	2	1
0023	3T	08_3	135	10	0	1000	0	-1000	0.00	0.00	1	0	-1
0023	3T	08_3	136	22	2	2200	2500	300	0.09	1.14	3	4	1
0023	3T	08_3	145	7	1	700	1220	520	0.14	1.74	1	2	1
0023	3T	08_3	146	11	1	1100	1300	200	0.09	1.18	1	2	1
0023	3T	08_3	156	5	0	500	0	-500	0.00	0.00	0	0	0
0023	3T	08_3	236	2	0	200	0	-200	0.00	0.00	0	0	0
0023	3T	08_3	246	1	0	100	0	-100	0.00	0.00	0	0	0
0023	3T	08_4	123	17	2	1700	1080	-620	0.12	0.64	3	1	-2
0023	3T	08_4	124	32	4	3200	3320	120	0.13	1.04	5	5	0
0023	3T	08_4	125	21	3	2100	2140	40	0.14	1.02	3	3	0
0023	3T	08_4	126	42	4	4200	4160	-40	0.10	0.99	7	7	0
0023	3T	08_4	132	1	0	100	0	-100	0.00	0.00	0	0	0
0023	3T	08_4	134	19	3	1900	1580	-320	0.16	0.83	3	2	-1
0023	3T	08_4	135	23	2	2300	1100	-1200	0.09	0.48	4	1	-3
0023	3T	08_4	136	17	1	1700	720	-980	0.06	0.42	3	1	-2
0023	3T	08_4	145	8	0	800	0	-800	0.00	0.00	1	0	-1
0023	3T	08_4	146	10	0	1000	0	-1000	0.00	0.00	1	0	-1
0023	3T	08_4	156	3	0	300	0	-300	0.00	0.00	0	0	0
0023	3T	08_4	165	1	0	100	0	-100	0.00	0.00	0	0	0
0023	3T	08_4	246	1	0	100	0	-100	0.00	0.00	0	0	0
0023	3T	08_5	123	25	2	2500	1590	-910	0.08	0.64	4	2	-2
0023	3T	08_5	124	35	7	3500	5980	2480	0.20	1.71	6	10	4
0023	3T	08_5	125	29	2	2900	2790	-110	0.07	0.96	5	4	-1
0023	3T	08_5	126	22	0	2200	0	-2200	0.00	0.00	3	0	-3
0023	3T	08_5	134	21	2	2100	1360	-740	0.10	0.65	3	2	-1
0023	3T	08_5	135	19	1	1900	820	-1080	0.05	0.43	3	1	-2
0023	3T	08_5	136	22	1	2200	730	-1470	0.05	0.33	3	1	-2
0023	3T	08_5	145	6	0	600	0	-600	0.00	0.00	1	0	-1
0023	3T	08_5	146	7	0	700	0	-700	0.00	0.00	1	0	-1
0023	3T	08_5	156	3	0	300	0	-300	0.00	0.00	0	0	0
0023	3T	08_5	246	1	0	100	0	-100	0.00	0.00	0	0	0
0023	3T	08_6	123	10	1	1000	440	-560	0.10	0.44	1	0	-1
0023	3T	08_6	124	21	1	2100	5780	3680	0.05	2.75	3	10	7
0023	3T	08_6	125	19	1	1900	580	-1320	0.05	0.31	3	1	-2
0023	3T	08_6	126	29	1	2900	1130	-1770	0.03	0.39	5	2	-3
0023	3T	08_6	134	14	3	1400	2150	750	0.21	1.54	2	3	1
0023	3T	08_6	135	11	1	1100	780	-320	0.09	0.71	1	1	0
0023	3T	08_6	136	17	3	1700	2910	1210	0.18	1.71	3	5	2
0023	3T	08_6	143	2	0	200	0	-200	0.00	0.00	0	0	0
0023	3T	08_6	145	7	0	700	0	-700	0.00	0.00	1	0	-1
0023	3T	08_6	146	11	3	1100	2630	1530	0.27	2.39	1	4	3
0023	3T	08_6	154	1	0	100	0	-100	0.00	0.00	0	0	0
0023	3T	08_6	156	3	0	300	0	-300	0.00	0.00	0	0	0
0023	3T	08_6	214	1	0	100	0	-100	0.00	0.00	0	0	0
0023	3T	08_6	216	1	0	100	0	-100	0.00	0.00	0	0	0
0023	3T	08_6	234	2	0	200	0	-200	0.00	0.00	0	0	0
0023	3T	08_6	245	1	0	100	0	-100	0.00	0.00	0	0	0
0023	3T	08_6	246	1	1	100	1210	1110	1.00	12.10	0	2	2
0023	3T	08_7	123	15	1	1500	1030	-470	0.07	0.69	2	1	-1
0023	3T	08_7	124	18	1	1800	760	-1040	0.06	0.42	3	1	-2
0023	3T	08_7	125	22	2	2200	1800	-400	0.09	0.82	3	3	0
0023	3T	08_7	126	32	0	3200	0	-3200	0.00	0.00	5	0	-5
0023	3T	08_7	134	9	1	900	470	-430	0.11	0.52	1	0	-1
0023	3T	08_7	135	13	0	1300	0	-1300	0.00	0.00	2	0	-2
0023	3T	08_7	136	30	0	3000	0	-3000	0.00	0.00	5	0	-5
0023	3T	08_7	145	10	1	1000	1910	910	0.10	1.91	1	3	2
0023	3T	08_7	146	6	1	600	680	80	0.17	1.13	1	1	0
0023	3T	08_7	154	1	0	100	0	-100	0.00	0.00	0	0	0
0023	3T	08_7	156	4	0	400	0	-400	0.00	0.00	0	0	0
0023	3T	08_7	214	2	0	200	0	-200	0.00	0.00	0	0	0
0023	3T	08_7	215	1	0	100	0	-100	0.00	0.00	0	0	0
0023	3T	08_7	236	1	0	100	0	-100	0.00	0.00	0	0	0
0023	3T	08_8	123	10	1	1000	660	-340	0.10	0.66	1	1	0
0023	3T	08_8	124	10	1	1000	540	-460	0.10	0.54	1	0	-1
0023	3T	08_8	125	10	2	1000	1020	20	0.20	1.02	1	1	0
0023	3T	08_8	126	10	2	1000	1860	860	0.20	1.86	1	3	2
0023	3T	08_8	132	1	0	100	0	-100	0.00	0.00	0	0	0
0023	3T	08_8	134	17	3	1700	3230	1530	0.18	1.90	3	5	2
0023	3T	08_8	135	7	1	700	1380	680	0.14	1.97	1	2	1
0023	3T	08_8	136	11	1	1100	1020	-80	0.09	0.93	1	1	0
0023	3T	08_8	145	6	0	600	0	-600	0.00	0.00	1	0	-1
0023	3T	08_8	146	4	0	400	0	-400	0.00	0.00	0	0	0
0023	3T	08_8	156	1	0	100	0	-100	0.00	0.00	0	0	0
0023	3T	08_8	234	1	0	100	0	-100	0.00	0.00	0	0	0
0023	3T	08_8	235	1	0	100	0	-100	0.00	0.00	0	0	0
0023	3T	08_9	123	36	7	3600	4400	800	0.19	1.22	6	7	1
0023	3T	08_9	124	53	3	5300	2340	-2960	0.06	0.44	9	4	-5
0023	3T	08_9	125	29	5	2900	9220	6320	0.17	3.18	5	16	11
0023	3T	08_9	126	20	0	2000	0	-2000	0.00	0.00	3	0	-3
0023	3T	08_9	134	20	4	2000	2900	900	0.20	1.45	3	5	2
0023	3T	08_9	135	15	1	1500	1530	30	0.07	1.02	2	2	0
0023	3T	08_9	136	7	2	700	2680	1980	0.29	3.83	1	4	3
0023	3T	08_9	145	4	0	400	0	-400	0.00	0.00	0	0	0
0023	3T	08_9	146	6	0	600	0	-600	0.00	0.00	1	0	-1
0023	3T	08_9	156	3	0	300	0	-300	0.00	0.00	0	0	0
0023	3T	09_1	123	78	9	7800	4650	-3150	0.12	0.60	13	8	-5
0023	3T	09_1	124	58	8	5800	5800	0	0.14	1.00	10	10	0
0023	3T	09_1	125	15	2	1500	1110	-390	0.13	0.74	2	1	-1
0023	3T	09_1	126	15	1	1500	1210	-290	0.07	0.81	2	2	0
0023	3T	09_1	134	4	1	400	520	120	0.25	1.30	0	0	0
0023	3T	09_1	135	4	0	400	0	-400	0.00	0.00	0	0	0
0023	3T	09_1	136	2	0	200	0	-200	0.00	0.00	0	0	0
0023	3T	09_1	143	2	0	200	0	-200	0.00	0.00	0	0	0
0023	3T	09_1	145	1	0	100	0	-100	0.00	0.00	0	0	0
0023	3T	09_1	153	1	0	100	0	-100	0.00	0.00	0	0	0
0023	3T	09_10	123	30	4	3000	1890	-1110	0.13	0.63	5	3	-2
0023	3T	09_10	124	90	8	9000	5510	-3490	0.09	0.61	15	9	-6
0023	3T	09_10	125	28	5	2800	5100	2300	0.18	1.82	4	9	5
0023	3T	09_10	126	13	1	1300	850	-450	0.08	0.65	2	1	-1
0023	3T	09_10	134	27	2	2700	1190	-1510	0.07	0.44	4	2	-2
0023	3T	09_10	135	24	1	2400	570	-1830	0.04	0.24	4	1	-3
0023	3T	09_10	136	8	1	800	2920	2120	0.13	3.65	1	5	4
0023	3T	09_10	142	1	0	100	0	-100	0.00	0.00	0	0	0
0023	3T	09_10	145	6	0	600	0	-600	0.00	0.00	1	0	-1
0023	3T	09_10	146	1	0	100	0	-100	0.00	0.00	0	0	0
0023	3T	09_10	235	2	0	200	0	-200	0.00	0.00	0	0	0
0023	3T	09_11	123	18	2	1800	650	-1150	0.11	0.36	3	1	-2
0023	3T	09_11	124	137	8	13700	5760	-7940	0.06	0.42	24	10	-14
0023	3T	09_11	125	29	5	2900	3390	490	0.17	1.17	5	6	1
0023	3T	09_11	126	8	0	800	0	-800	0.00	0.00	1	0	-1
0023	3T	09_11	134	24	3	2400	3170	770	0.13	1.32	4	5	1
0023	3T	09_11	135	25	2	2500	3000	500	0.08	1.20	4	5	1
0023	3T	09_11	136	5	0	500	0	-500	0.00	0.00	0	0	0
0023	3T	09_11	146	1	1	100	830	730	1.00	8.30	0	1	1
0023	3T	09_11	214	1	0	100	0	-100	0.00	0.00	0	0	0
0023	3T	09_11	216	1	0	100	0	-100	0.00	0.00	0	0	0
0023	3T	09_12	123	30	7	3000	2880	-120	0.23	0.96	5	5	0
0023	3T	09_12	124	175	17	17500	11630	-5870	0.10	0.66	30	20	-10
0023	3T	09_12	125	29	2	2900	1890	-1010	0.07	0.65	5	3	-2
0023	3T	09_12	126	4	0	400	0	-400	0.00	0.00	0	0	0
0023	3T	09_12	134	18	0	1800	0	-1800	0.00	0.00	3	0	-3
0023	3T	09_12	135	9	2	900	1370	470	0.22	1.52	1	2	1
0023	3T	09_12	136	1	0	100	0	-100	0.00	0.00	0	0	0
0023	3T	09_12	145	1	0	100	0	-100	0.00	0.00	0	0	0
0023	3T	09_2	123	30	2	3000	1230	-1770	0.07	0.41	5	2	-3
0023	3T	09_2	124	20	2	2000	2380	380	0.10	1.19	3	4	1
0023	3T	09_2	125	15	1	1500	840	-660	0.07	0.56	2	1	-1
0023	3T	09_2	126	21	3	2100	3900	1800	0.14	1.86	3	6	3
0023	3T	09_2	132	2	0	200	0	-200	0.00	0.00	0	0	0
0023	3T	09_2	134	10	2	1000	1740	740	0.20	1.74	1	3	2
0023	3T	09_2	135	9	1	900	840	-60	0.11	0.93	1	1	0
0023	3T	09_2	136	4	0	400	0	-400	0.00	0.00	0	0	0
0023	3T	09_2	142	1	0	100	0	-100	0.00	0.00	0	0	0
0023	3T	09_2	143	2	0	200	0	-200	0.00	0.00	0	0	0
0023	3T	09_2	145	2	0	200	0	-200	0.00	0.00	0	0	0
0023	3T	09_2	146	2	0	200	0	-200	0.00	0.00	0	0	0
0023	3T	09_2	153	1	0	100	0	-100	0.00	0.00	0	0	0
0023	3T	09_2	156	2	0	200	0	-200	0.00	0.00	0	0	0
0023	3T	09_2	165	1	0	100	0	-100	0.00	0.00	0	0	0
0023	3T	09_2	234	2	0	200	0	-200	0.00	0.00	0	0	0
0023	3T	09_3	123	12	2	1200	1240	40	0.17	1.03	2	2	0
0023	3T	09_3	124	19	2	1900	2290	390	0.11	1.21	3	4	1
0023	3T	09_3	125	26	3	2600	2510	-90	0.12	0.97	4	4	0
0023	3T	09_3	126	42	1	4200	4450	250	0.02	1.06	7	7	0
0023	3T	09_3	134	4	0	400	0	-400	0.00	0.00	0	0	0
0023	3T	09_3	135	13	1	1300	2760	1460	0.08	2.12	2	4	2
0023	3T	09_3	136	22	0	2200	0	-2200	0.00	0.00	3	0	-3
0023	3T	09_3	145	5	0	500	0	-500	0.00	0.00	0	0	0
0023	3T	09_3	146	14	1	1400	2140	740	0.07	1.53	2	3	1
0023	3T	09_3	156	5	0	500	0	-500	0.00	0.00	0	0	0
0023	3T	09_3	216	2	0	200	0	-200	0.00	0.00	0	0	0
0023	3T	09_3	234	2	0	200	0	-200	0.00	0.00	0	0	0
0023	3T	09_3	235	2	0	200	0	-200	0.00	0.00	0	0	0
0023	3T	09_3	236	1	0	100	0	-100	0.00	0.00	0	0	0
0023	3T	09_3	246	2	1	200	1100	900	0.50	5.50	0	1	1
0023	3T	09_4	123	8	3	800	4800	4000	0.38	6.00	1	8	7
0023	3T	09_4	124	15	0	1500	0	-1500	0.00	0.00	2	0	-2
0023	3T	09_4	125	19	1	1900	1000	-900	0.05	0.53	3	1	-2
0023	3T	09_4	126	40	0	4000	0	-4000	0.00	0.00	7	0	-7
0023	3T	09_4	134	11	0	1100	0	-1100	0.00	0.00	1	0	-1
0023	3T	09_4	135	14	2	1400	1530	130	0.14	1.09	2	2	0
0023	3T	09_4	136	19	1	1900	2260	360	0.05	1.19	3	4	1
0023	3T	09_4	145	6	0	600	0	-600	0.00	0.00	1	0	-1
0023	3T	09_4	146	8	0	800	0	-800	0.00	0.00	1	0	-1
0023	3T	09_4	156	7	1	700	710	10	0.14	1.01	1	1	0
0023	3T	09_4	216	1	0	100	0	-100	0.00	0.00	0	0	0
0023	3T	09_4	236	2	0	200	0	-200	0.00	0.00	0	0	0
0023	3T	09_4	246	1	0	100	0	-100	0.00	0.00	0	0	0
0023	3T	09_5	123	74	13	7400	6380	-1020	0.18	0.86	13	11	-2
0023	3T	09_5	124	52	12	5200	6810	1610	0.23	1.31	9	12	3
0023	3T	09_5	125	20	2	2000	1690	-310	0.10	0.85	3	2	-1
0023	3T	09_5	126	8	2	800	3600	2800	0.25	4.50	1	6	5
0023	3T	09_5	132	2	0	200	0	-200	0.00	0.00	0	0	0
0023	3T	09_5	134	15	1	1500	550	-950	0.07	0.37	2	0	-2
0023	3T	09_5	135	8	1	800	540	-260	0.13	0.68	1	0	-1
0023	3T	09_5	136	3	0	300	0	-300	0.00	0.00	0	0	0
0023	3T	09_5	142	1	0	100	0	-100	0.00	0.00	0	0	0
0023	3T	09_5	143	1	1	100	760	660	1.00	7.60	0	1	1
0023	3T	09_5	145	1	0	100	0	-100	0.00	0.00	0	0	0
0023	3T	09_5	146	6	1	600	870	270	0.17	1.45	1	1	0
0023	3T	09_5	156	1	0	100	0	-100	0.00	0.00	0	0	0
0023	3T	09_5	234	1	0	100	0	-100	0.00	0.00	0	0	0
0023	3T	09_6	123	6	0	600	0	-600	0.00	0.00	1	0	-1
0023	3T	09_6	124	29	4	2900	1710	-1190	0.14	0.59	5	3	-2
0023	3T	09_6	125	15	1	1500	1700	200	0.07	1.13	2	3	1
0023	3T	09_6	126	17	0	1700	0	-1700	0.00	0.00	3	0	-3
0023	3T	09_6	134	14	2	1400	950	-450	0.14	0.68	2	1	-1
0023	3T	09_6	135	11	2	1100	2330	1230	0.18	2.12	1	4	3
0023	3T	09_6	136	18	3	1800	5410	3610	0.17	3.01	3	9	6
0023	3T	09_6	145	7	0	700	0	-700	0.00	0.00	1	0	-1
0023	3T	09_6	146	7	1	700	710	10	0.14	1.01	1	1	0
0023	3T	09_6	156	6	0	600	0	-600	0.00	0.00	1	0	-1
0023	3T	09_6	216	3	0	300	0	-300	0.00	0.00	0	0	0
0023	3T	09_6	234	2	1	200	1180	980	0.50	5.90	0	2	2
0023	3T	09_7	123	19	4	1900	2140	240	0.21	1.13	3	3	0
0023	3T	09_7	124	32	5	3200	4310	1110	0.16	1.35	5	7	2
0023	3T	09_7	125	14	1	1400	720	-680	0.07	0.51	2	1	-1
0023	3T	09_7	126	25	1	2500	570	-1930	0.04	0.23	4	1	-3
0023	3T	09_7	134	16	1	1600	800	-800	0.06	0.50	2	1	-1
0023	3T	09_7	135	18	1	1800	500	-1300	0.06	0.28	3	0	-3
0023	3T	09_7	136	19	1	1900	1180	-720	0.05	0.62	3	2	-1
0023	3T	09_7	142	1	1	100	660	560	1.00	6.60	0	1	1
0023	3T	09_7	145	6	0	600	0	-600	0.00	0.00	1	0	-1
0023	3T	09_7	146	4	0	400	0	-400	0.00	0.00	0	0	0
0023	3T	09_7	156	2	1	200	1140	940	0.50	5.70	0	2	2
0023	3T	09_7	214	1	0	100	0	-100	0.00	0.00	0	0	0
0023	3T	09_7	215	1	0	100	0	-100	0.00	0.00	0	0	0
0023	3T	09_7	234	2	0	200	0	-200	0.00	0.00	0	0	0
0023	3T	09_7	236	4	0	400	0	-400	0.00	0.00	0	0	0
0023	3T	09_7	246	1	0	100	0	-100	0.00	0.00	0	0	0
0023	3T	09_8	123	23	4	2300	2400	100	0.17	1.04	4	4	0
0023	3T	09_8	124	31	3	3100	2310	-790	0.10	0.75	5	4	-1
0023	3T	09_8	125	23	3	2300	3190	890	0.13	1.39	4	5	1
0023	3T	09_8	126	14	0	1400	0	-1400	0.00	0.00	2	0	-2
0023	3T	09_8	134	18	3	1800	1450	-350	0.17	0.81	3	2	-1
0023	3T	09_8	135	15	1	1500	810	-690	0.07	0.54	2	1	-1
0023	3T	09_8	136	14	1	1400	700	-700	0.07	0.50	2	1	-1
0023	3T	09_8	145	1	0	100	0	-100	0.00	0.00	0	0	0
0023	3T	09_8	146	2	0	200	0	-200	0.00	0.00	0	0	0
0023	3T	09_8	156	1	0	100	0	-100	0.00	0.00	0	0	0
0023	3T	09_8	213	2	0	200	0	-200	0.00	0.00	0	0	0
0023	3T	09_8	215	1	0	100	0	-100	0.00	0.00	0	0	0
0023	3T	09_8	216	1	0	100	0	-100	0.00	0.00	0	0	0
0023	3T	09_8	234	1	0	100	0	-100	0.00	0.00	0	0	0
0023	3T	09_8	236	2	0	200	0	-200	0.00	0.00	0	0	0
0023	3T	09_9	123	24	3	2400	2020	-380	0.13	0.84	4	3	-1
0023	3T	09_9	124	39	2	3900	1450	-2450	0.05	0.37	6	2	-4
0023	3T	09_9	125	34	3	3400	3260	-140	0.09	0.96	6	5	-1
0023	3T	09_9	126	28	1	2800	570	-2230	0.04	0.20	4	1	-3
0023	3T	09_9	134	24	2	2400	2170	-230	0.08	0.90	4	3	-1
0023	3T	09_9	135	14	1	1400	610	-790	0.07	0.44	2	1	-1
0023	3T	09_9	136	19	1	1900	1170	-730	0.05	0.62	3	2	-1
0023	3T	09_9	145	4	0	400	0	-400	0.00	0.00	0	0	0
0023	3T	09_9	146	7	0	700	0	-700	0.00	0.00	1	0	-1
0023	3T	09_9	154	2	0	200	0	-200	0.00	0.00	0	0	0
0023	3T	09_9	156	3	0	300	0	-300	0.00	0.00	0	0	0
0023	3T	09_9	164	1	0	100	0	-100	0.00	0.00	0	0	0
0023	3T	10_1	123	108	14	10800	9040	-1760	0.13	0.84	19	16	-3
0023	3T	10_1	124	33	1	3300	680	-2620	0.03	0.21	5	1	-4
0023	3T	10_1	125	13	0	1300	0	-1300	0.00	0.00	2	0	-2
0023	3T	10_1	126	18	1	1800	390	-1410	0.06	0.22	3	0	-3
0023	3T	10_1	134	8	0	800	0	-800	0.00	0.00	1	0	-1
0023	3T	10_1	135	6	1	600	820	220	0.17	1.37	1	1	0
0023	3T	10_1	142	1	0	100	0	-100	0.00	0.00	0	0	0
0023	3T	10_1	143	4	0	400	0	-400	0.00	0.00	0	0	0
0023	3T	10_1	145	1	0	100	0	-100	0.00	0.00	0	0	0
0023	3T	10_1	163	1	0	100	0	-100	0.00	0.00	0	0	0
0023	3T	10_10	123	23	2	2300	870	-1430	0.09	0.38	4	1	-3
0023	3T	10_10	124	57	3	5700	2720	-2980	0.05	0.48	10	4	-6
0023	3T	10_10	125	26	1	2600	570	-2030	0.04	0.22	4	1	-3
0023	3T	10_10	126	26	3	2600	4390	1790	0.12	1.69	4	7	3
0023	3T	10_10	134	15	3	1500	1890	390	0.20	1.26	2	3	1
0023	3T	10_10	135	10	1	1000	620	-380	0.10	0.62	1	1	0
0023	3T	10_10	136	13	0	1300	0	-1300	0.00	0.00	2	0	-2
0023	3T	10_10	143	1	0	100	0	-100	0.00	0.00	0	0	0
0023	3T	10_10	145	7	0	700	0	-700	0.00	0.00	1	0	-1
0023	3T	10_10	146	10	0	1000	0	-1000	0.00	0.00	1	0	-1
0023	3T	10_10	156	6	0	600	0	-600	0.00	0.00	1	0	-1
0023	3T	10_10	164	1	0	100	0	-100	0.00	0.00	0	0	0
0023	3T	10_10	213	1	0	100	0	-100	0.00	0.00	0	0	0
0023	3T	10_10	216	1	0	100	0	-100	0.00	0.00	0	0	0
0023	3T	10_10	246	1	0	100	0	-100	0.00	0.00	0	0	0
0023	3T	10_11	123	16	3	1600	1640	40	0.19	1.03	2	2	0
0023	3T	10_11	124	103	13	10300	11470	1170	0.13	1.11	18	20	2
0023	3T	10_11	125	29	1	2900	760	-2140	0.03	0.26	5	1	-4
0023	3T	10_11	126	3	1	300	970	670	0.33	3.23	0	1	1
0023	3T	10_11	134	31	0	3100	0	-3100	0.00	0.00	5	0	-5
0023	3T	10_11	135	23	1	2300	440	-1860	0.04	0.19	4	0	-4
0023	3T	10_11	136	4	0	400	0	-400	0.00	0.00	0	0	0
0023	3T	10_11	145	9	0	900	0	-900	0.00	0.00	1	0	-1
0023	3T	10_11	154	1	0	100	0	-100	0.00	0.00	0	0	0
0023	3T	10_11	156	1	0	100	0	-100	0.00	0.00	0	0	0
0023	3T	10_12	123	16	6	1600	3010	1410	0.38	1.88	2	5	3
0023	3T	10_12	124	136	17	13600	15390	1790	0.13	1.13	24	27	3
0023	3T	10_12	125	24	4	2400	3830	1430	0.17	1.60	4	6	2
0023	3T	10_12	126	2	0	200	0	-200	0.00	0.00	0	0	0
0023	3T	10_12	134	26	2	2600	1560	-1040	0.08	0.60	4	2	-2
0023	3T	10_12	135	23	2	2300	1620	-680	0.09	0.70	4	2	-2
0023	3T	10_12	136	1	0	100	0	-100	0.00	0.00	0	0	0
0023	3T	10_12	145	6	0	600	0	-600	0.00	0.00	1	0	-1
0023	3T	10_12	213	1	0	100	0	-100	0.00	0.00	0	0	0
0023	3T	10_2	123	137	13	13700	6930	-6770	0.09	0.51	24	12	-12
0023	3T	10_2	124	41	5	4100	1940	-2160	0.12	0.47	7	3	-4
0023	3T	10_2	125	15	4	1500	3450	1950	0.27	2.30	2	6	4
0023	3T	10_2	126	1	0	100	0	-100	0.00	0.00	0	0	0
0023	3T	10_2	134	9	0	900	0	-900	0.00	0.00	1	0	-1
0023	3T	10_2	135	9	0	900	0	-900	0.00	0.00	1	0	-1
0023	3T	10_2	143	1	0	100	0	-100	0.00	0.00	0	0	0
0023	3T	10_2	145	1	0	100	0	-100	0.00	0.00	0	0	0
0023	3T	10_2	146	1	1	100	1520	1420	1.00	15.20	0	2	2
0023	3T	10_3	123	14	5	1400	2770	1370	0.36	1.98	2	4	2
0023	3T	10_3	124	11	1	1100	560	-540	0.09	0.51	1	0	-1
0023	3T	10_3	125	5	0	500	0	-500	0.00	0.00	0	0	0
0023	3T	10_3	134	90	6	9000	3790	-5210	0.07	0.42	15	6	-9
0023	3T	10_3	135	23	1	2300	820	-1480	0.04	0.36	4	1	-3
0023	3T	10_3	136	4	0	400	0	-400	0.00	0.00	0	0	0
0023	3T	10_3	146	2	0	200	0	-200	0.00	0.00	0	0	0
0023	3T	10_3	153	1	0	100	0	-100	0.00	0.00	0	0	0
0023	3T	10_3	163	2	0	200	0	-200	0.00	0.00	0	0	0
0023	3T	10_3	164	1	0	100	0	-100	0.00	0.00	0	0	0
0023	3T	10_3	215	1	0	100	0	-100	0.00	0.00	0	0	0
0023	3T	10_3	234	1	0	100	0	-100	0.00	0.00	0	0	0
0023	3T	10_3	235	3	0	300	0	-300	0.00	0.00	0	0	0
0023	3T	10_3	245	2	0	200	0	-200	0.00	0.00	0	0	0
0023	3T	10_3	246	2	0	200	0	-200	0.00	0.00	0	0	0
0023	3T	10_4	123	120	13	12000	5140	-6860	0.11	0.43	21	9	-12
0023	3T	10_4	124	14	2	1400	3020	1620	0.14	2.16	2	5	3
0023	3T	10_4	125	18	1	1800	700	-1100	0.06	0.39	3	1	-2
0023	3T	10_4	126	8	0	800	0	-800	0.00	0.00	1	0	-1
0023	3T	10_4	134	6	0	600	0	-600	0.00	0.00	1	0	-1
0023	3T	10_4	135	9	0	900	0	-900	0.00	0.00	1	0	-1
0023	3T	10_4	136	1	0	100	0	-100	0.00	0.00	0	0	0
0023	3T	10_4	145	5	0	500	0	-500	0.00	0.00	0	0	0
0023	3T	10_4	146	1	0	100	0	-100	0.00	0.00	0	0	0
0023	3T	10_4	164	1	0	100	0	-100	0.00	0.00	0	0	0
0023	3T	10_4	165	1	0	100	0	-100	0.00	0.00	0	0	0
0023	3T	10_4	215	1	0	100	0	-100	0.00	0.00	0	0	0
0023	3T	10_4	235	8	0	800	0	-800	0.00	0.00	1	0	-1
0023	3T	10_4	245	2	0	200	0	-200	0.00	0.00	0	0	0
0023	3T	10_4	246	1	0	100	0	-100	0.00	0.00	0	0	0
0023	3T	10_5	123	10	1	1000	1010	10	0.10	1.01	1	1	0
0023	3T	10_5	124	2	0	200	0	-200	0.00	0.00	0	0	0
0023	3T	10_5	125	13	0	1300	0	-1300	0.00	0.00	2	0	-2
0023	3T	10_5	126	5	0	500	0	-500	0.00	0.00	0	0	0
0023	3T	10_5	134	2	0	200	0	-200	0.00	0.00	0	0	0
0023	3T	10_5	135	28	4	2800	4030	1230	0.14	1.44	4	7	3
0023	3T	10_5	136	2	0	200	0	-200	0.00	0.00	0	0	0
0023	3T	10_5	143	1	0	100	0	-100	0.00	0.00	0	0	0
0023	3T	10_5	145	9	0	900	0	-900	0.00	0.00	1	0	-1
0023	3T	10_5	146	1	0	100	0	-100	0.00	0.00	0	0	0
0023	3T	10_5	154	1	0	100	0	-100	0.00	0.00	0	0	0
0023	3T	10_5	163	1	0	100	0	-100	0.00	0.00	0	0	0
0023	3T	10_5	164	1	0	100	0	-100	0.00	0.00	0	0	0
0023	3T	10_5	216	3	0	300	0	-300	0.00	0.00	0	0	0
0023	3T	10_5	234	1	0	100	0	-100	0.00	0.00	0	0	0
0023	3T	10_5	235	7	0	700	0	-700	0.00	0.00	1	0	-1
0023	3T	10_5	236	4	1	400	1560	1160	0.25	3.90	0	2	2
0023	3T	10_5	243	4	0	400	0	-400	0.00	0.00	0	0	0
0023	3T	10_5	245	21	1	2100	4990	2890	0.05	2.38	3	8	5
0023	3T	10_5	246	8	0	800	0	-800	0.00	0.00	1	0	-1
0023	3T	10_5	265	1	0	100	0	-100	0.00	0.00	0	0	0
0023	3T	10_6	123	11	1	1100	390	-710	0.09	0.35	1	0	-1
0023	3T	10_6	124	1	0	100	0	-100	0.00	0.00	0	0	0
0023	3T	10_6	125	12	1	1200	1780	580	0.08	1.48	2	3	1
0023	3T	10_6	126	1	0	100	0	-100	0.00	0.00	0	0	0
0023	3T	10_6	135	7	0	700	0	-700	0.00	0.00	1	0	-1
0023	3T	10_6	136	2	0	200	0	-200	0.00	0.00	0	0	0
0023	3T	10_6	143	6	0	600	0	-600	0.00	0.00	1	0	-1
0023	3T	10_6	145	13	0	1300	0	-1300	0.00	0.00	2	0	-2
0023	3T	10_6	163	6	0	600	0	-600	0.00	0.00	1	0	-1
0023	3T	10_6	165	1	0	100	0	-100	0.00	0.00	0	0	0
0023	3T	10_6	215	3	0	300	0	-300	0.00	0.00	0	0	0
0023	3T	10_6	216	1	0	100	0	-100	0.00	0.00	0	0	0
0023	3T	10_6	234	3	0	300	0	-300	0.00	0.00	0	0	0
0023	3T	10_6	235	15	0	1500	0	-1500	0.00	0.00	2	0	-2
0023	3T	10_6	236	4	0	400	0	-400	0.00	0.00	0	0	0
0023	3T	10_6	243	3	0	300	0	-300	0.00	0.00	0	0	0
0023	3T	10_6	245	13	0	1300	0	-1300	0.00	0.00	2	0	-2
0023	3T	10_6	256	2	0	200	0	-200	0.00	0.00	0	0	0
0023	3T	10_6	263	25	0	2500	0	-2500	0.00	0.00	4	0	-4
0023	3T	10_6	264	1	0	100	0	-100	0.00	0.00	0	0	0
0023	3T	10_7	123	42	4	4200	4640	440	0.10	1.10	7	8	1
0023	3T	10_7	143	5	1	500	1210	710	0.20	2.42	0	2	2
0023	3T	10_7	213	28	0	2800	0	-2800	0.00	0.00	4	0	-4
0023	3T	10_7	243	12	0	1200	0	-1200	0.00	0.00	2	0	-2
0023	3T	10_8	123	2	1	200	790	590	0.50	3.95	0	1	1
0023	3T	10_8	124	18	1	1800	1410	-390	0.06	0.78	3	2	-1
0023	3T	10_8	125	7	0	700	0	-700	0.00	0.00	1	0	-1
0023	3T	10_8	126	12	2	1200	7130	5930	0.17	5.94	2	12	10
0023	3T	10_8	134	11	2	1100	1800	700	0.18	1.64	1	3	2
0023	3T	10_8	135	6	0	600	0	-600	0.00	0.00	1	0	-1
0023	3T	10_8	136	13	0	1300	0	-1300	0.00	0.00	2	0	-2
0023	3T	10_8	145	9	0	900	0	-900	0.00	0.00	1	0	-1
0023	3T	10_8	146	2	0	200	0	-200	0.00	0.00	0	0	0
0023	3T	10_8	153	3	1	300	1530	1230	0.33	5.10	0	2	2
0023	3T	10_8	214	3	1	300	2150	1850	0.33	7.17	0	3	3
0023	3T	10_8	215	4	0	400	0	-400	0.00	0.00	0	0	0
0023	3T	10_8	216	8	0	800	0	-800	0.00	0.00	1	0	-1
0023	3T	10_8	234	2	0	200	0	-200	0.00	0.00	0	0	0
0023	3T	10_8	235	5	0	500	0	-500	0.00	0.00	0	0	0
0023	3T	10_8	236	1	0	100	0	-100	0.00	0.00	0	0	0
0023	3T	10_8	241	1	0	100	0	-100	0.00	0.00	0	0	0
0023	3T	10_8	245	5	0	500	0	-500	0.00	0.00	0	0	0
0023	3T	10_8	246	6	0	600	0	-600	0.00	0.00	1	0	-1
0023	3T	10_8	261	1	0	100	0	-100	0.00	0.00	0	0	0
0023	3T	10_8	264	1	0	100	0	-100	0.00	0.00	0	0	0
0023	3T	10_8	265	1	0	100	0	-100	0.00	0.00	0	0	0
0023	3T	10_9	123	9	2	900	1310	410	0.22	1.46	1	2	1
0023	3T	10_9	124	32	3	3200	2350	-850	0.09	0.73	5	4	-1
0023	3T	10_9	125	13	2	1300	2160	860	0.15	1.66	2	3	1
0023	3T	10_9	126	3	0	300	0	-300	0.00	0.00	0	0	0
0023	3T	10_9	134	17	0	1700	0	-1700	0.00	0.00	3	0	-3
0023	3T	10_9	135	11	1	1100	2170	1070	0.09	1.97	1	3	2
0023	3T	10_9	136	4	0	400	0	-400	0.00	0.00	0	0	0
0023	3T	10_9	145	18	1	1800	2980	1180	0.06	1.66	3	5	2
0023	3T	10_9	146	1	0	100	0	-100	0.00	0.00	0	0	0
0023	3T	10_9	154	1	0	100	0	-100	0.00	0.00	0	0	0
0023	3T	10_9	163	1	0	100	0	-100	0.00	0.00	0	0	0
0023	3T	10_9	215	6	0	600	0	-600	0.00	0.00	1	0	-1
0023	3T	10_9	216	8	0	800	0	-800	0.00	0.00	1	0	-1
0023	3T	10_9	235	5	0	500	0	-500	0.00	0.00	0	0	0
0023	3T	10_9	236	2	0	200	0	-200	0.00	0.00	0	0	0
0023	3T	10_9	245	2	0	200	0	-200	0.00	0.00	0	0	0
0023	3T	10_9	246	2	1	200	5140	4940	0.50	25.70	0	9	9
0023	3T	10_9	256	3	0	300	0	-300	0.00	0.00	0	0	0
0023	3T	11_1	123	35	5	3500	2860	-640	0.14	0.82	6	5	-1
0023	3T	11_1	124	44	2	4400	1860	-2540	0.05	0.42	7	3	-4
0023	3T	11_1	125	32	2	3200	2620	-580	0.06	0.82	5	4	-1
0023	3T	11_1	126	4	1	400	800	400	0.25	2.00	0	1	1
0023	3T	11_1	132	3	1	300	810	510	0.33	2.70	0	1	1
0023	3T	11_1	134	5	0	500	0	-500	0.00	0.00	0	0	0
0023	3T	11_1	135	5	1	500	870	370	0.20	1.74	0	1	1
0023	3T	11_1	136	2	0	200	0	-200	0.00	0.00	0	0	0
0023	3T	11_1	143	1	0	100	0	-100	0.00	0.00	0	0	0
0023	3T	11_1	145	2	0	200	0	-200	0.00	0.00	0	0	0
0023	3T	11_1	146	1	0	100	0	-100	0.00	0.00	0	0	0
0023	3T	11_1	152	1	0	100	0	-100	0.00	0.00	0	0	0
0023	3T	11_1	156	2	0	200	0	-200	0.00	0.00	0	0	0
0023	3T	11_1	256	1	0	100	0	-100	0.00	0.00	0	0	0
0023	3T	11_10	123	12	0	1200	0	-1200	0.00	0.00	2	0	-2
0023	3T	11_10	124	33	3	3300	2700	-600	0.09	0.82	5	4	-1
0023	3T	11_10	125	40	3	4000	2580	-1420	0.08	0.65	7	4	-3
0023	3T	11_10	126	15	1	1500	930	-570	0.07	0.62	2	1	-1
0023	3T	11_10	134	24	3	2400	2830	430	0.13	1.18	4	5	1
0023	3T	11_10	135	28	1	2800	710	-2090	0.04	0.25	4	1	-3
0023	3T	11_10	136	12	1	1200	980	-220	0.08	0.82	2	1	-1
0023	3T	11_10	145	12	2	1200	1850	650	0.17	1.54	2	3	1
0023	3T	11_10	146	3	0	300	0	-300	0.00	0.00	0	0	0
0023	3T	11_10	164	1	0	100	0	-100	0.00	0.00	0	0	0
0023	3T	11_10	216	2	0	200	0	-200	0.00	0.00	0	0	0
0023	3T	11_10	235	1	0	100	0	-100	0.00	0.00	0	0	0
0023	3T	11_10	236	1	0	100	0	-100	0.00	0.00	0	0	0
0023	3T	11_10	246	1	0	100	0	-100	0.00	0.00	0	0	0
0023	3T	11_11	123	10	1	1000	450	-550	0.10	0.45	1	0	-1
0023	3T	11_11	124	70	8	7000	9200	2200	0.11	1.31	12	16	4
0023	3T	11_11	125	64	2	6400	8150	1750	0.03	1.27	11	14	3
0023	3T	11_11	126	10	0	1000	0	-1000	0.00	0.00	1	0	-1
0023	3T	11_11	132	1	0	100	0	-100	0.00	0.00	0	0	0
0023	3T	11_11	134	24	2	2400	1300	-1100	0.08	0.54	4	2	-2
0023	3T	11_11	135	33	1	3300	910	-2390	0.03	0.28	5	1	-4
0023	3T	11_11	136	3	0	300	0	-300	0.00	0.00	0	0	0
0023	3T	11_11	145	7	0	700	0	-700	0.00	0.00	1	0	-1
0023	3T	11_11	146	2	0	200	0	-200	0.00	0.00	0	0	0
0023	3T	11_12	123	4	0	400	0	-400	0.00	0.00	0	0	0
0023	3T	11_12	124	90	6	9000	3880	-5120	0.07	0.43	15	6	-9
0023	3T	11_12	125	72	3	7200	6050	-1150	0.04	0.84	12	10	-2
0023	3T	11_12	126	1	0	100	0	-100	0.00	0.00	0	0	0
0023	3T	11_12	134	23	4	2300	3730	1430	0.17	1.62	4	6	2
0023	3T	11_12	135	31	1	3100	990	-2110	0.03	0.32	5	1	-4
0023	3T	11_12	142	1	0	100	0	-100	0.00	0.00	0	0	0
0023	3T	11_12	145	7	1	700	2590	1890	0.14	3.70	1	4	3
0023	3T	11_2	123	10	1	1000	1160	160	0.10	1.16	1	2	1
0023	3T	11_2	124	18	0	1800	0	-1800	0.00	0.00	3	0	-3
0023	3T	11_2	125	16	1	1600	1130	-470	0.06	0.71	2	2	0
0023	3T	11_2	126	21	1	2100	1760	-340	0.05	0.84	3	3	0
0023	3T	11_2	134	9	0	900	0	-900	0.00	0.00	1	0	-1
0023	3T	11_2	135	9	1	900	820	-80	0.11	0.91	1	1	0
0023	3T	11_2	136	16	1	1600	6050	4450	0.06	3.78	2	10	8
0023	3T	11_2	143	2	1	200	2470	2270	0.50	12.35	0	4	4
0023	3T	11_2	145	8	0	800	0	-800	0.00	0.00	1	0	-1
0023	3T	11_2	146	3	0	300	0	-300	0.00	0.00	0	0	0
0023	3T	11_2	156	1	0	100	0	-100	0.00	0.00	0	0	0
0023	3T	11_2	234	1	0	100	0	-100	0.00	0.00	0	0	0
0023	3T	11_2	235	2	0	200	0	-200	0.00	0.00	0	0	0
0023	3T	11_2	236	1	0	100	0	-100	0.00	0.00	0	0	0
0023	3T	11_3	123	10	2	1000	1420	420	0.20	1.42	1	2	1
0023	3T	11_3	124	20	2	2000	2520	520	0.10	1.26	3	4	1
0023	3T	11_3	125	11	1	1100	2400	1300	0.09	2.18	1	4	3
0023	3T	11_3	126	29	0	2900	0	-2900	0.00	0.00	5	0	-5
0023	3T	11_3	134	10	1	1000	1650	650	0.10	1.65	1	2	1
0023	3T	11_3	135	9	0	900	0	-900	0.00	0.00	1	0	-1
0023	3T	11_3	136	16	0	1600	0	-1600	0.00	0.00	2	0	-2
0023	3T	11_3	145	4	0	400	0	-400	0.00	0.00	0	0	0
0023	3T	11_3	146	11	0	1100	0	-1100	0.00	0.00	1	0	-1
0023	3T	11_3	156	2	0	200	0	-200	0.00	0.00	0	0	0
0023	3T	11_3	235	1	0	100	0	-100	0.00	0.00	0	0	0
0023	3T	11_3	236	1	0	100	0	-100	0.00	0.00	0	0	0
0023	3T	11_3	246	1	0	100	0	-100	0.00	0.00	0	0	0
0023	3T	11_4	123	9	1	900	500	-400	0.11	0.56	1	0	-1
0023	3T	11_4	124	16	1	1600	1880	280	0.06	1.18	2	3	1
0023	3T	11_4	125	11	0	1100	0	-1100	0.00	0.00	1	0	-1
0023	3T	11_4	126	28	3	2800	7100	4300	0.11	2.54	4	12	8
0023	3T	11_4	134	10	1	1000	1860	860	0.10	1.86	1	3	2
0023	3T	11_4	135	10	0	1000	0	-1000	0.00	0.00	1	0	-1
0023	3T	11_4	136	22	1	2200	1890	-310	0.05	0.86	3	3	0
0023	3T	11_4	142	1	0	100	0	-100	0.00	0.00	0	0	0
0023	3T	11_4	145	5	0	500	0	-500	0.00	0.00	0	0	0
0023	3T	11_4	146	4	0	400	0	-400	0.00	0.00	0	0	0
0023	3T	11_4	154	1	0	100	0	-100	0.00	0.00	0	0	0
0023	3T	11_4	156	3	0	300	0	-300	0.00	0.00	0	0	0
0023	3T	11_4	234	2	0	200	0	-200	0.00	0.00	0	0	0
0023	3T	11_4	235	1	0	100	0	-100	0.00	0.00	0	0	0
0023	3T	11_4	246	1	0	100	0	-100	0.00	0.00	0	0	0
0023	3T	11_5	123	95	12	9500	5190	-4310	0.13	0.55	16	9	-7
0023	3T	11_5	124	59	10	5900	4080	-1820	0.17	0.69	10	7	-3
0023	3T	11_5	125	16	4	1600	1950	350	0.25	1.22	2	3	1
0023	3T	11_5	126	11	0	1100	0	-1100	0.00	0.00	1	0	-1
0023	3T	11_5	134	1	0	100	0	-100	0.00	0.00	0	0	0
0023	3T	11_5	136	1	0	100	0	-100	0.00	0.00	0	0	0
0023	3T	11_5	146	1	0	100	0	-100	0.00	0.00	0	0	0
0023	3T	11_6	123	6	0	600	0	-600	0.00	0.00	1	0	-1
0023	3T	11_6	124	13	2	1300	5980	4680	0.15	4.60	2	10	8
0023	3T	11_6	125	5	1	500	850	350	0.20	1.70	0	1	1
0023	3T	11_6	126	8	1	800	2210	1410	0.13	2.76	1	3	2
0023	3T	11_6	134	114	15	11400	9000	-2400	0.13	0.79	20	15	-5
0023	3T	11_6	135	12	0	1200	0	-1200	0.00	0.00	2	0	-2
0023	3T	11_6	136	4	0	400	0	-400	0.00	0.00	0	0	0
0023	3T	11_6	142	2	0	200	0	-200	0.00	0.00	0	0	0
0023	3T	11_6	145	3	0	300	0	-300	0.00	0.00	0	0	0
0023	3T	11_6	146	6	1	600	790	190	0.17	1.32	1	1	0
0023	3T	11_6	234	1	0	100	0	-100	0.00	0.00	0	0	0
0023	3T	11_7	123	16	4	1600	2520	920	0.25	1.58	2	4	2
0023	3T	11_7	124	24	4	2400	5240	2840	0.17	2.18	4	9	5
0023	3T	11_7	125	22	1	2200	430	-1770	0.05	0.20	3	0	-3
0023	3T	11_7	126	23	3	2300	6740	4440	0.13	2.93	4	11	7
0023	3T	11_7	134	13	0	1300	0	-1300	0.00	0.00	2	0	-2
0023	3T	11_7	135	9	2	900	2080	1180	0.22	2.31	1	3	2
0023	3T	11_7	136	14	1	1400	1390	-10	0.07	0.99	2	2	0
0023	3T	11_7	145	4	2	400	1190	790	0.50	2.98	0	2	2
0023	3T	11_7	146	6	1	600	970	370	0.17	1.62	1	1	0
0023	3T	11_7	156	1	0	100	0	-100	0.00	0.00	0	0	0
0023	3T	11_7	215	2	0	200	0	-200	0.00	0.00	0	0	0
0023	3T	11_7	236	2	0	200	0	-200	0.00	0.00	0	0	0
0023	3T	11_7	246	1	0	100	0	-100	0.00	0.00	0	0	0
0023	3T	11_7	256	1	0	100	0	-100	0.00	0.00	0	0	0
0023	3T	11_8	123	11	1	1100	620	-480	0.09	0.56	1	1	0
0023	3T	11_8	124	12	1	1200	3080	1880	0.08	2.57	2	5	3
0023	3T	11_8	125	17	0	1700	0	-1700	0.00	0.00	3	0	-3
0023	3T	11_8	126	25	0	2500	0	-2500	0.00	0.00	4	0	-4
0023	3T	11_8	134	9	1	900	1010	110	0.11	1.12	1	1	0
0023	3T	11_8	135	12	1	1200	1030	-170	0.08	0.86	2	1	-1
0023	3T	11_8	136	14	0	1400	0	-1400	0.00	0.00	2	0	-2
0023	3T	11_8	145	9	0	900	0	-900	0.00	0.00	1	0	-1
0023	3T	11_8	146	3	0	300	0	-300	0.00	0.00	0	0	0
0023	3T	11_8	154	1	0	100	0	-100	0.00	0.00	0	0	0
0023	3T	11_8	156	3	0	300	0	-300	0.00	0.00	0	0	0
0023	3T	11_8	235	3	1	300	650	350	0.33	2.17	0	1	1
0023	3T	11_8	245	1	0	100	0	-100	0.00	0.00	0	0	0
0023	3T	11_8	256	1	0	100	0	-100	0.00	0.00	0	0	0
0023	3T	11_9	123	15	0	1500	0	-1500	0.00	0.00	2	0	-2
0023	3T	11_9	124	30	3	3000	3770	770	0.10	1.26	5	6	1
0023	3T	11_9	125	19	0	1900	0	-1900	0.00	0.00	3	0	-3
0023	3T	11_9	126	26	2	2600	3580	980	0.08	1.38	4	6	2
0023	3T	11_9	134	12	2	1200	2790	1590	0.17	2.33	2	4	2
0023	3T	11_9	135	15	0	1500	0	-1500	0.00	0.00	2	0	-2
0023	3T	11_9	136	15	1	1500	750	-750	0.07	0.50	2	1	-1
0023	3T	11_9	145	6	0	600	0	-600	0.00	0.00	1	0	-1
0023	3T	11_9	146	6	0	600	0	-600	0.00	0.00	1	0	-1
0023	3T	11_9	214	1	0	100	0	-100	0.00	0.00	0	0	0
0023	3T	11_9	215	1	0	100	0	-100	0.00	0.00	0	0	0
0023	3T	11_9	235	1	0	100	0	-100	0.00	0.00	0	0	0
0023	3T	11_9	236	2	0	200	0	-200	0.00	0.00	0	0	0
0023	3T	11_9	246	1	0	100	0	-100	0.00	0.00	0	0	0
0023	3T	11_9	256	1	0	100	0	-100	0.00	0.00	0	0	0
0023	3T	12_1	123	23	1	2300	1490	-810	0.04	0.65	4	2	-2
0023	3T	12_1	124	25	2	2500	1850	-650	0.08	0.74	4	3	-1
0023	3T	12_1	125	16	1	1600	530	-1070	0.06	0.33	2	0	-2
0023	3T	12_1	126	11	1	1100	1160	60	0.09	1.05	1	2	1
0023	3T	12_1	132	2	0	200	0	-200	0.00	0.00	0	0	0
0023	3T	12_1	134	9	1	900	660	-240	0.11	0.73	1	1	0
0023	3T	12_1	135	5	0	500	0	-500	0.00	0.00	0	0	0
0023	3T	12_1	136	3	1	300	1590	1290	0.33	5.30	0	2	2
0023	3T	12_1	142	1	0	100	0	-100	0.00	0.00	0	0	0
0023	3T	12_1	143	2	0	200	0	-200	0.00	0.00	0	0	0
0023	3T	12_1	145	4	0	400	0	-400	0.00	0.00	0	0	0
0023	3T	12_1	146	5	0	500	0	-500	0.00	0.00	0	0	0
0023	3T	12_1	234	2	0	200	0	-200	0.00	0.00	0	0	0
0023	3T	12_10	123	10	2	1000	940	-60	0.20	0.94	1	1	0
0023	3T	12_10	124	54	4	5400	2320	-3080	0.07	0.43	9	4	-5
0023	3T	12_10	125	70	7	7000	10980	3980	0.10	1.57	12	19	7
0023	3T	12_10	126	10	1	1000	760	-240	0.10	0.76	1	1	0
0023	3T	12_10	134	19	1	1900	550	-1350	0.05	0.29	3	0	-3
0023	3T	12_10	135	40	4	4000	4430	430	0.10	1.11	7	7	0
0023	3T	12_10	136	9	0	900	0	-900	0.00	0.00	1	0	-1
0023	3T	12_10	142	1	0	100	0	-100	0.00	0.00	0	0	0
0023	3T	12_10	145	5	0	500	0	-500	0.00	0.00	0	0	0
0023	3T	12_10	216	2	0	200	0	-200	0.00	0.00	0	0	0
0023	3T	12_10	245	1	0	100	0	-100	0.00	0.00	0	0	0
0023	3T	12_11	123	6	0	600	0	-600	0.00	0.00	1	0	-1
0023	3T	12_11	124	33	5	3300	3290	-10	0.15	1.00	5	5	0
0023	3T	12_11	125	84	7	8400	9120	720	0.08	1.09	14	16	2
0023	3T	12_11	126	10	2	1000	2860	1860	0.20	2.86	1	5	4
0023	3T	12_11	132	1	0	100	0	-100	0.00	0.00	0	0	0
0023	3T	12_11	134	31	5	3100	5700	2600	0.16	1.84	5	10	5
0023	3T	12_11	135	60	3	6000	2910	-3090	0.05	0.49	10	5	-5
0023	3T	12_11	136	4	1	400	1480	1080	0.25	3.70	0	2	2
0023	3T	12_11	143	1	0	100	0	-100	0.00	0.00	0	0	0
0023	3T	12_11	145	5	0	500	0	-500	0.00	0.00	0	0	0
0023	3T	12_11	153	1	0	100	0	-100	0.00	0.00	0	0	0
0023	3T	12_11	216	1	0	100	0	-100	0.00	0.00	0	0	0
0023	3T	12_12	123	4	0	400	0	-400	0.00	0.00	0	0	0
0023	3T	12_12	124	37	5	3700	4140	440	0.14	1.12	6	7	1
0023	3T	12_12	125	82	5	8200	4680	-3520	0.06	0.57	14	8	-6
0023	3T	12_12	126	7	0	700	0	-700	0.00	0.00	1	0	-1
0023	3T	12_12	132	3	1	300	1240	940	0.33	4.13	0	2	2
0023	3T	12_12	134	13	3	1300	2870	1570	0.23	2.21	2	5	3
0023	3T	12_12	135	68	4	6800	9680	2880	0.06	1.42	12	17	5
0023	3T	12_12	136	3	0	300	0	-300	0.00	0.00	0	0	0
0023	3T	12_12	145	8	0	800	0	-800	0.00	0.00	1	0	-1
0023	3T	12_12	246	1	0	100	0	-100	0.00	0.00	0	0	0
0023	3T	12_2	123	21	1	2100	490	-1610	0.05	0.23	3	0	-3
0023	3T	12_2	124	25	1	2500	1090	-1410	0.04	0.44	4	1	-3
0023	3T	12_2	125	21	0	2100	0	-2100	0.00	0.00	3	0	-3
0023	3T	12_2	126	10	0	1000	0	-1000	0.00	0.00	1	0	-1
0023	3T	12_2	134	10	2	1000	2370	1370	0.20	2.37	1	4	3
0023	3T	12_2	135	16	1	1600	670	-930	0.06	0.42	2	1	-1
0023	3T	12_2	136	7	1	700	1280	580	0.14	1.83	1	2	1
0023	3T	12_2	143	2	0	200	0	-200	0.00	0.00	0	0	0
0023	3T	12_2	145	8	0	800	0	-800	0.00	0.00	1	0	-1
0023	3T	12_2	146	1	0	100	0	-100	0.00	0.00	0	0	0
0023	3T	12_2	156	1	0	100	0	-100	0.00	0.00	0	0	0
0023	3T	12_2	234	1	1	100	490	390	1.00	4.90	0	0	0
0023	3T	12_2	235	3	0	300	0	-300	0.00	0.00	0	0	0
0023	3T	12_3	123	16	2	1600	1460	-140	0.13	0.91	2	2	0
0023	3T	12_3	124	26	1	2600	920	-1680	0.04	0.35	4	1	-3
0023	3T	12_3	125	22	2	2200	3370	1170	0.09	1.53	3	5	2
0023	3T	12_3	126	14	0	1400	0	-1400	0.00	0.00	2	0	-2
0023	3T	12_3	134	10	0	1000	0	-1000	0.00	0.00	1	0	-1
0023	3T	12_3	135	13	1	1300	850	-450	0.08	0.65	2	1	-1
0023	3T	12_3	136	8	0	800	0	-800	0.00	0.00	1	0	-1
0023	3T	12_3	145	6	0	600	0	-600	0.00	0.00	1	0	-1
0023	3T	12_3	146	5	0	500	0	-500	0.00	0.00	0	0	0
0023	3T	12_3	156	3	0	300	0	-300	0.00	0.00	0	0	0
0023	3T	12_3	213	1	0	100	0	-100	0.00	0.00	0	0	0
0023	3T	12_3	214	2	0	200	0	-200	0.00	0.00	0	0	0
0023	3T	12_3	234	1	0	100	0	-100	0.00	0.00	0	0	0
0023	3T	12_3	235	1	0	100	0	-100	0.00	0.00	0	0	0
0023	3T	12_3	236	1	1	100	1380	1280	1.00	13.80	0	2	2
0023	3T	12_3	246	1	1	100	390	290	1.00	3.90	0	0	0
0023	3T	12_4	123	15	1	1500	690	-810	0.07	0.46	2	1	-1
0023	3T	12_4	124	31	6	3100	4900	1800	0.19	1.58	5	8	3
0023	3T	12_4	125	20	0	2000	0	-2000	0.00	0.00	3	0	-3
0023	3T	12_4	126	13	1	1300	660	-640	0.08	0.51	2	1	-1
0023	3T	12_4	134	12	1	1200	950	-250	0.08	0.79	2	1	-1
0023	3T	12_4	135	14	2	1400	1580	180	0.14	1.13	2	2	0
0023	3T	12_4	136	4	0	400	0	-400	0.00	0.00	0	0	0
0023	3T	12_4	145	9	1	900	910	10	0.11	1.01	1	1	0
0023	3T	12_4	146	6	0	600	0	-600	0.00	0.00	1	0	-1
0023	3T	12_4	154	1	0	100	0	-100	0.00	0.00	0	0	0
0023	3T	12_4	156	1	0	100	0	-100	0.00	0.00	0	0	0
0023	3T	12_4	215	1	0	100	0	-100	0.00	0.00	0	0	0
0023	3T	12_4	216	2	0	200	0	-200	0.00	0.00	0	0	0
0023	3T	12_4	235	1	0	100	0	-100	0.00	0.00	0	0	0
0023	3T	12_4	236	2	0	200	0	-200	0.00	0.00	0	0	0
0023	3T	12_4	256	2	0	200	0	-200	0.00	0.00	0	0	0
0023	3T	12_5	123	28	0	2800	0	-2800	0.00	0.00	4	0	-4
0023	3T	12_5	124	16	2	1600	1310	-290	0.13	0.82	2	2	0
0023	3T	12_5	125	9	1	900	570	-330	0.11	0.63	1	1	0
0023	3T	12_5	126	96	12	9600	11410	1810	0.13	1.19	16	20	4
0023	3T	12_5	135	1	0	100	0	-100	0.00	0.00	0	0	0
0023	3T	12_5	136	24	3	2400	1740	-660	0.13	0.73	4	3	-1
0023	3T	12_5	145	1	1	100	1690	1590	1.00	16.90	0	2	2
0023	3T	12_5	146	6	0	600	0	-600	0.00	0.00	1	0	-1
0023	3T	12_6	123	22	6	2200	3520	1320	0.27	1.60	3	6	3
0023	3T	12_6	124	35	3	3500	2010	-1490	0.09	0.57	6	3	-3
0023	3T	12_6	125	16	0	1600	0	-1600	0.00	0.00	2	0	-2
0023	3T	12_6	126	14	1	1400	480	-920	0.07	0.34	2	0	-2
0023	3T	12_6	134	10	1	1000	540	-460	0.10	0.54	1	0	-1
0023	3T	12_6	135	10	1	1000	740	-260	0.10	0.74	1	1	0
0023	3T	12_6	136	17	3	1700	3110	1410	0.18	1.83	3	5	2
0023	3T	12_6	146	1	0	100	0	-100	0.00	0.00	0	0	0
0023	3T	12_6	156	3	0	300	0	-300	0.00	0.00	0	0	0
0023	3T	12_6	215	2	0	200	0	-200	0.00	0.00	0	0	0
0023	3T	12_6	234	1	0	100	0	-100	0.00	0.00	0	0	0
0023	3T	12_6	235	1	0	100	0	-100	0.00	0.00	0	0	0
0023	3T	12_6	245	2	0	200	0	-200	0.00	0.00	0	0	0
0023	3T	12_6	246	1	0	100	0	-100	0.00	0.00	0	0	0
0023	3T	12_7	123	30	6	3000	4240	1240	0.20	1.41	5	7	2
0023	3T	12_7	124	35	5	3500	3270	-230	0.14	0.93	6	5	-1
0023	3T	12_7	125	26	1	2600	1000	-1600	0.04	0.38	4	1	-3
0023	3T	12_7	126	16	0	1600	0	-1600	0.00	0.00	2	0	-2
0023	3T	12_7	134	10	1	1000	950	-50	0.10	0.95	1	1	0
0023	3T	12_7	135	16	0	1600	0	-1600	0.00	0.00	2	0	-2
0023	3T	12_7	136	14	1	1400	540	-860	0.07	0.39	2	0	-2
0023	3T	12_7	145	7	1	700	750	50	0.14	1.07	1	1	0
0023	3T	12_7	146	3	1	300	730	430	0.33	2.43	0	1	1
0023	3T	12_7	152	1	0	100	0	-100	0.00	0.00	0	0	0
0023	3T	12_7	156	1	0	100	0	-100	0.00	0.00	0	0	0
0023	3T	12_7	213	1	0	100	0	-100	0.00	0.00	0	0	0
0023	3T	12_7	216	1	0	100	0	-100	0.00	0.00	0	0	0
0023	3T	12_7	234	1	0	100	0	-100	0.00	0.00	0	0	0
0023	3T	12_7	246	1	0	100	0	-100	0.00	0.00	0	0	0
0023	3T	12_8	123	17	3	1700	1440	-260	0.18	0.85	3	2	-1
0023	3T	12_8	124	36	4	3600	2300	-1300	0.11	0.64	6	4	-2
0023	3T	12_8	125	25	2	2500	3370	870	0.08	1.35	4	5	1
0023	3T	12_8	126	21	0	2100	0	-2100	0.00	0.00	3	0	-3
0023	3T	12_8	134	17	1	1700	940	-760	0.06	0.55	3	1	-2
0023	3T	12_8	135	9	0	900	0	-900	0.00	0.00	1	0	-1
0023	3T	12_8	136	17	1	1700	830	-870	0.06	0.49	3	1	-2
0023	3T	12_8	143	1	0	100	0	-100	0.00	0.00	0	0	0
0023	3T	12_8	145	6	1	600	1450	850	0.17	2.42	1	2	1
0023	3T	12_8	146	5	0	500	0	-500	0.00	0.00	0	0	0
0023	3T	12_8	156	3	1	300	1270	970	0.33	4.23	0	2	2
0023	3T	12_9	123	37	5	3700	3140	-560	0.14	0.85	6	5	-1
0023	3T	12_9	124	59	4	5900	2860	-3040	0.07	0.48	10	5	-5
0023	3T	12_9	125	30	1	3000	1020	-1980	0.03	0.34	5	1	-4
0023	3T	12_9	126	31	3	3100	2340	-760	0.10	0.75	5	4	-1
0023	3T	12_9	134	7	1	700	1050	350	0.14	1.50	1	1	0
0023	3T	12_9	135	16	1	1600	690	-910	0.06	0.43	2	1	-1
0023	3T	12_9	136	17	1	1700	800	-900	0.06	0.47	3	1	-2
0023	3T	12_9	145	3	1	300	700	400	0.33	2.33	0	1	1
0023	3T	12_9	146	5	0	500	0	-500	0.00	0.00	0	0	0
0023	3T	12_9	163	1	0	100	0	-100	0.00	0.00	0	0	0
0023	3T	13_1	123	11	1	1100	450	-650	0.09	0.41	1	0	-1
0023	3T	13_1	124	17	1	1700	690	-1010	0.06	0.41	3	1	-2
0023	3T	13_1	125	12	2	1200	1430	230	0.17	1.19	2	2	0
0023	3T	13_1	126	10	1	1000	780	-220	0.10	0.78	1	1	0
0023	3T	13_1	132	1	0	100	0	-100	0.00	0.00	0	0	0
0023	3T	13_1	134	8	1	800	840	40	0.13	1.05	1	1	0
0023	3T	13_1	135	9	0	900	0	-900	0.00	0.00	1	0	-1
0023	3T	13_1	136	4	0	400	0	-400	0.00	0.00	0	0	0
0023	3T	13_1	143	2	0	200	0	-200	0.00	0.00	0	0	0
0023	3T	13_1	145	2	0	200	0	-200	0.00	0.00	0	0	0
0023	3T	13_1	146	2	0	200	0	-200	0.00	0.00	0	0	0
0023	3T	13_1	156	1	0	100	0	-100	0.00	0.00	0	0	0
0023	3T	13_1	163	1	0	100	0	-100	0.00	0.00	0	0	0
0023	3T	13_10	123	30	2	3000	2020	-980	0.07	0.67	5	3	-2
0023	3T	13_10	124	70	9	7000	5610	-1390	0.13	0.80	12	9	-3
0023	3T	13_10	125	24	4	2400	3130	730	0.17	1.30	4	5	1
0023	3T	13_10	126	35	4	3500	7400	3900	0.11	2.11	6	13	7
0023	3T	13_10	134	21	5	2100	4210	2110	0.24	2.00	3	7	4
0023	3T	13_10	135	8	0	800	0	-800	0.00	0.00	1	0	-1
0023	3T	13_10	136	12	0	1200	0	-1200	0.00	0.00	2	0	-2
0023	3T	13_10	145	3	0	300	0	-300	0.00	0.00	0	0	0
0023	3T	13_10	146	2	0	200	0	-200	0.00	0.00	0	0	0
0023	3T	13_10	156	2	1	200	1050	850	0.50	5.25	0	1	1
0023	3T	13_10	216	1	0	100	0	-100	0.00	0.00	0	0	0
0023	3T	13_10	235	1	0	100	0	-100	0.00	0.00	0	0	0
0023	3T	13_11	123	48	8	4800	5310	510	0.17	1.11	8	9	1
0023	3T	13_11	124	81	6	8100	6710	-1390	0.07	0.83	14	11	-3
0023	3T	13_11	125	25	2	2500	1420	-1080	0.08	0.57	4	2	-2
0023	3T	13_11	126	42	2	4200	3750	-450	0.05	0.89	7	6	-1
0023	3T	13_11	134	20	1	2000	480	-1520	0.05	0.24	3	0	-3
0023	3T	13_11	135	8	2	800	2380	1580	0.25	2.98	1	4	3
0023	3T	13_11	136	4	0	400	0	-400	0.00	0.00	0	0	0
0023	3T	13_11	145	1	0	100	0	-100	0.00	0.00	0	0	0
0023	3T	13_11	146	5	0	500	0	-500	0.00	0.00	0	0	0
0023	3T	13_11	156	1	0	100	0	-100	0.00	0.00	0	0	0
0023	3T	13_11	235	1	0	100	0	-100	0.00	0.00	0	0	0
0023	3T	13_12	123	29	1	2900	570	-2330	0.03	0.20	5	1	-4
0023	3T	13_12	124	111	5	11100	4210	-6890	0.05	0.38	19	7	-12
0023	3T	13_12	125	16	1	1600	760	-840	0.06	0.48	2	1	-1
0023	3T	13_12	126	40	1	4000	1840	-2160	0.03	0.46	7	3	-4
0023	3T	13_12	134	15	1	1500	610	-890	0.07	0.41	2	1	-1
0023	3T	13_12	135	7	0	700	0	-700	0.00	0.00	1	0	-1
0023	3T	13_12	136	13	1	1300	1030	-270	0.08	0.79	2	1	-1
0023	3T	13_12	156	1	0	100	0	-100	0.00	0.00	0	0	0
0023	3T	13_12	236	1	0	100	0	-100	0.00	0.00	0	0	0
0023	3T	13_2	123	21	4	2100	3740	1640	0.19	1.78	3	6	3
0023	3T	13_2	124	17	1	1700	590	-1110	0.06	0.35	3	1	-2
0023	3T	13_2	125	14	1	1400	1500	100	0.07	1.07	2	2	0
0023	3T	13_2	126	9	1	900	1210	310	0.11	1.34	1	2	1
0023	3T	13_2	134	10	2	1000	990	-10	0.20	0.99	1	1	0
0023	3T	13_2	135	8	2	800	1600	800	0.25	2.00	1	2	1
0023	3T	13_2	136	10	2	1000	1590	590	0.20	1.59	1	2	1
0023	3T	13_2	145	2	0	200	0	-200	0.00	0.00	0	0	0
0023	3T	13_2	146	5	1	500	700	200	0.20	1.40	0	1	1
0023	3T	13_2	152	1	0	100	0	-100	0.00	0.00	0	0	0
0023	3T	13_2	154	2	0	200	0	-200	0.00	0.00	0	0	0
0023	3T	13_2	156	1	0	100	0	-100	0.00	0.00	0	0	0
0023	3T	13_2	235	1	0	100	0	-100	0.00	0.00	0	0	0
0023	3T	13_3	123	13	3	1300	2120	820	0.23	1.63	2	3	1
0023	3T	13_3	124	21	1	2100	1220	-880	0.05	0.58	3	2	-1
0023	3T	13_3	125	13	2	1300	2280	980	0.15	1.75	2	4	2
0023	3T	13_3	126	18	1	1800	1370	-430	0.06	0.76	3	2	-1
0023	3T	13_3	134	10	2	1000	1580	580	0.20	1.58	1	2	1
0023	3T	13_3	135	4	0	400	0	-400	0.00	0.00	0	0	0
0023	3T	13_3	136	11	0	1100	0	-1100	0.00	0.00	1	0	-1
0023	3T	13_3	145	6	0	600	0	-600	0.00	0.00	1	0	-1
0023	3T	13_3	146	5	0	500	0	-500	0.00	0.00	0	0	0
0023	3T	13_3	156	1	0	100	0	-100	0.00	0.00	0	0	0
0023	3T	13_3	216	1	0	100	0	-100	0.00	0.00	0	0	0
0023	3T	13_3	234	1	0	100	0	-100	0.00	0.00	0	0	0
0023	3T	13_3	235	2	1	200	680	480	0.50	3.40	0	1	1
0023	3T	13_3	236	1	0	100	0	-100	0.00	0.00	0	0	0
0023	3T	13_3	245	1	0	100	0	-100	0.00	0.00	0	0	0
0023	3T	13_4	123	8	0	800	0	-800	0.00	0.00	1	0	-1
0023	3T	13_4	124	24	1	2400	390	-2010	0.04	0.16	4	0	-4
0023	3T	13_4	125	15	2	1500	1990	490	0.13	1.33	2	3	1
0023	3T	13_4	126	24	0	2400	0	-2400	0.00	0.00	4	0	-4
0023	3T	13_4	134	17	0	1700	0	-1700	0.00	0.00	3	0	-3
0023	3T	13_4	135	8	0	800	0	-800	0.00	0.00	1	0	-1
0023	3T	13_4	136	10	0	1000	0	-1000	0.00	0.00	1	0	-1
0023	3T	13_4	145	6	0	600	0	-600	0.00	0.00	1	0	-1
0023	3T	13_4	146	4	2	400	2130	1730	0.50	5.33	0	3	3
0023	3T	13_4	156	3	0	300	0	-300	0.00	0.00	0	0	0
0023	3T	13_4	163	1	0	100	0	-100	0.00	0.00	0	0	0
0023	3T	13_4	165	1	0	100	0	-100	0.00	0.00	0	0	0
0023	3T	13_4	235	2	0	200	0	-200	0.00	0.00	0	0	0
0023	3T	13_4	246	1	0	100	0	-100	0.00	0.00	0	0	0
0023	3T	13_4	256	1	0	100	0	-100	0.00	0.00	0	0	0
0023	3T	13_5	123	13	1	1300	1020	-280	0.08	0.78	2	1	-1
0023	3T	13_5	124	32	6	3200	5000	1800	0.19	1.56	5	8	3
0023	3T	13_5	125	17	2	1700	1030	-670	0.12	0.61	3	1	-2
0023	3T	13_5	126	15	1	1500	1020	-480	0.07	0.68	2	1	-1
0023	3T	13_5	134	13	1	1300	1350	50	0.08	1.04	2	2	0
0023	3T	13_5	135	14	1	1400	620	-780	0.07	0.44	2	1	-1
0023	3T	13_5	136	8	0	800	0	-800	0.00	0.00	1	0	-1
0023	3T	13_5	145	7	0	700	0	-700	0.00	0.00	1	0	-1
0023	3T	13_5	146	4	0	400	0	-400	0.00	0.00	0	0	0
0023	3T	13_5	156	1	0	100	0	-100	0.00	0.00	0	0	0
0023	3T	13_5	164	2	0	200	0	-200	0.00	0.00	0	0	0
0023	3T	13_5	165	1	1	100	1060	960	1.00	10.60	0	1	1
0023	3T	13_5	216	1	0	100	0	-100	0.00	0.00	0	0	0
0023	3T	13_5	236	2	0	200	0	-200	0.00	0.00	0	0	0
0023	3T	13_6	123	10	0	1000	0	-1000	0.00	0.00	1	0	-1
0023	3T	13_6	124	29	6	2900	5120	2220	0.21	1.77	5	9	4
0023	3T	13_6	125	12	1	1200	1160	-40	0.08	0.97	2	2	0
0023	3T	13_6	126	16	0	1600	0	-1600	0.00	0.00	2	0	-2
0023	3T	13_6	134	10	0	1000	0	-1000	0.00	0.00	1	0	-1
0023	3T	13_6	135	11	0	1100	0	-1100	0.00	0.00	1	0	-1
0023	3T	13_6	136	18	1	1800	460	-1340	0.06	0.26	3	0	-3
0023	3T	13_6	145	2	0	200	0	-200	0.00	0.00	0	0	0
0023	3T	13_6	146	5	0	500	0	-500	0.00	0.00	0	0	0
0023	3T	13_6	156	2	0	200	0	-200	0.00	0.00	0	0	0
0023	3T	13_6	236	1	0	100	0	-100	0.00	0.00	0	0	0
0023	3T	13_6	256	1	0	100	0	-100	0.00	0.00	0	0	0
0023	3T	13_7	123	17	5	1700	4910	3210	0.29	2.89	3	8	5
0023	3T	13_7	124	26	5	2600	3530	930	0.19	1.36	4	6	2
0023	3T	13_7	125	30	0	3000	0	-3000	0.00	0.00	5	0	-5
0023	3T	13_7	126	20	1	2000	710	-1290	0.05	0.36	3	1	-2
0023	3T	13_7	134	18	3	1800	2070	270	0.17	1.15	3	3	0
0023	3T	13_7	135	8	1	800	890	90	0.13	1.11	1	1	0
0023	3T	13_7	136	12	0	1200	0	-1200	0.00	0.00	2	0	-2
0023	3T	13_7	145	5	1	500	980	480	0.20	1.96	0	1	1
0023	3T	13_7	146	6	0	600	0	-600	0.00	0.00	1	0	-1
0023	3T	13_7	154	1	0	100	0	-100	0.00	0.00	0	0	0
0023	3T	13_7	156	1	0	100	0	-100	0.00	0.00	0	0	0
0023	3T	13_7	235	1	0	100	0	-100	0.00	0.00	0	0	0
0023	3T	13_7	245	1	0	100	0	-100	0.00	0.00	0	0	0
0023	3T	13_7	256	1	0	100	0	-100	0.00	0.00	0	0	0
0023	3T	13_8	123	19	1	1900	480	-1420	0.05	0.25	3	0	-3
0023	3T	13_8	124	28	5	2800	2640	-160	0.18	0.94	4	4	0
0023	3T	13_8	125	15	1	1500	870	-630	0.07	0.58	2	1	-1
0023	3T	13_8	126	19	0	1900	0	-1900	0.00	0.00	3	0	-3
0023	3T	13_8	134	14	1	1400	650	-750	0.07	0.46	2	1	-1
0023	3T	13_8	135	11	3	1100	3880	2780	0.27	3.53	1	6	5
0023	3T	13_8	136	15	0	1500	0	-1500	0.00	0.00	2	0	-2
0023	3T	13_8	145	4	0	400	0	-400	0.00	0.00	0	0	0
0023	3T	13_8	146	8	0	800	0	-800	0.00	0.00	1	0	-1
0023	3T	13_8	156	2	0	200	0	-200	0.00	0.00	0	0	0
0023	3T	13_8	163	1	0	100	0	-100	0.00	0.00	0	0	0
0023	3T	13_8	234	1	0	100	0	-100	0.00	0.00	0	0	0
0023	3T	13_8	256	1	0	100	0	-100	0.00	0.00	0	0	0
0023	3T	13_9	123	30	4	3000	2630	-370	0.13	0.88	5	4	-1
0023	3T	13_9	124	36	4	3600	3220	-380	0.11	0.89	6	5	-1
0023	3T	13_9	125	24	1	2400	460	-1940	0.04	0.19	4	0	-4
0023	3T	13_9	126	14	0	1400	0	-1400	0.00	0.00	2	0	-2
0023	3T	13_9	134	23	3	2300	1920	-380	0.13	0.83	4	3	-1
0023	3T	13_9	135	15	2	1500	1590	90	0.13	1.06	2	2	0
0023	3T	13_9	136	16	0	1600	0	-1600	0.00	0.00	2	0	-2
0023	3T	13_9	145	1	0	100	0	-100	0.00	0.00	0	0	0
0023	3T	13_9	146	2	0	200	0	-200	0.00	0.00	0	0	0
0023	3T	13_9	156	1	0	100	0	-100	0.00	0.00	0	0	0
0023	3T	14_1	123	21	5	2100	4690	2590	0.24	2.23	3	8	5
0023	3T	14_1	124	52	4	5200	2640	-2560	0.08	0.51	9	4	-5
0023	3T	14_1	125	3	0	300	0	-300	0.00	0.00	0	0	0
0023	3T	14_1	126	2	1	200	900	700	0.50	4.50	0	1	1
0023	3T	14_1	134	10	0	1000	0	-1000	0.00	0.00	1	0	-1
0023	3T	14_1	135	3	0	300	0	-300	0.00	0.00	0	0	0
0023	3T	14_1	142	1	0	100	0	-100	0.00	0.00	0	0	0
0023	3T	14_1	145	3	0	300	0	-300	0.00	0.00	0	0	0
0023	3T	14_1	146	5	0	500	0	-500	0.00	0.00	0	0	0
0023	3T	14_10	123	15	2	1500	1220	-280	0.13	0.81	2	2	0
0023	3T	14_10	124	48	5	4800	3600	-1200	0.10	0.75	8	6	-2
0023	3T	14_10	125	28	1	2800	1220	-1580	0.04	0.44	4	2	-2
0023	3T	14_10	126	20	1	2000	1890	-110	0.05	0.95	3	3	0
0023	3T	14_10	134	14	0	1400	0	-1400	0.00	0.00	2	0	-2
0023	3T	14_10	135	19	1	1900	980	-920	0.05	0.52	3	1	-2
0023	3T	14_10	136	9	0	900	0	-900	0.00	0.00	1	0	-1
0023	3T	14_10	145	5	0	500	0	-500	0.00	0.00	0	0	0
0023	3T	14_10	146	3	1	300	950	650	0.33	3.17	0	1	1
0023	3T	14_10	154	1	0	100	0	-100	0.00	0.00	0	0	0
0023	3T	14_10	156	2	0	200	0	-200	0.00	0.00	0	0	0
0023	3T	14_10	216	1	0	100	0	-100	0.00	0.00	0	0	0
0023	3T	14_10	234	1	0	100	0	-100	0.00	0.00	0	0	0
0023	3T	14_10	235	1	0	100	0	-100	0.00	0.00	0	0	0
0023	3T	14_10	245	1	0	100	0	-100	0.00	0.00	0	0	0
0023	3T	14_11	123	30	4	3000	1900	-1100	0.13	0.63	5	3	-2
0023	3T	14_11	124	106	4	10600	3220	-7380	0.04	0.30	18	5	-13
0023	3T	14_11	125	25	2	2500	5770	3270	0.08	2.31	4	10	6
0023	3T	14_11	126	16	2	1600	4650	3050	0.13	2.91	2	8	6
0023	3T	14_11	134	21	5	2100	4660	2560	0.24	2.22	3	8	5
0023	3T	14_11	135	11	0	1100	0	-1100	0.00	0.00	1	0	-1
0023	3T	14_11	136	9	0	900	0	-900	0.00	0.00	1	0	-1
0023	3T	14_11	145	1	0	100	0	-100	0.00	0.00	0	0	0
0023	3T	14_11	146	2	0	200	0	-200	0.00	0.00	0	0	0
0023	3T	14_11	156	1	0	100	0	-100	0.00	0.00	0	0	0
0023	3T	14_12	123	33	2	3300	1310	-1990	0.06	0.40	5	2	-3
0023	3T	14_12	124	150	10	15000	9170	-5830	0.07	0.61	26	16	-10
0023	3T	14_12	125	11	0	1100	0	-1100	0.00	0.00	1	0	-1
0023	3T	14_12	126	25	0	2500	0	-2500	0.00	0.00	4	0	-4
0023	3T	14_12	134	11	0	1100	0	-1100	0.00	0.00	1	0	-1
0023	3T	14_12	135	4	1	400	920	520	0.25	2.30	0	1	1
0023	3T	14_12	136	5	0	500	0	-500	0.00	0.00	0	0	0
0023	3T	14_2	123	21	1	2100	1040	-1060	0.05	0.50	3	1	-2
0023	3T	14_2	124	28	5	2800	3630	830	0.18	1.30	4	6	2
0023	3T	14_2	125	20	2	2000	4590	2590	0.10	2.30	3	8	5
0023	3T	14_2	126	29	2	2900	7390	4490	0.07	2.55	5	13	8
0023	3T	14_2	134	17	0	1700	0	-1700	0.00	0.00	3	0	-3
0023	3T	14_2	135	6	0	600	0	-600	0.00	0.00	1	0	-1
0023	3T	14_2	136	14	2	1400	4300	2900	0.14	3.07	2	7	5
0023	3T	14_2	145	2	0	200	0	-200	0.00	0.00	0	0	0
0023	3T	14_2	146	11	0	1100	0	-1100	0.00	0.00	1	0	-1
0023	3T	14_2	156	7	0	700	0	-700	0.00	0.00	1	0	-1
0023	3T	14_2	216	1	0	100	0	-100	0.00	0.00	0	0	0
0023	3T	14_2	235	2	0	200	0	-200	0.00	0.00	0	0	0
0023	3T	14_2	256	1	0	100	0	-100	0.00	0.00	0	0	0
0023	3T	14_3	123	39	4	3900	3080	-820	0.10	0.79	6	5	-1
0023	3T	14_3	124	29	2	2900	1320	-1580	0.07	0.46	5	2	-3
0023	3T	14_3	125	25	3	2500	2540	40	0.12	1.02	4	4	0
0023	3T	14_3	126	7	1	700	710	10	0.14	1.01	1	1	0
0023	3T	14_3	134	8	0	800	0	-800	0.00	0.00	1	0	-1
0023	3T	14_3	135	8	0	800	0	-800	0.00	0.00	1	0	-1
0023	3T	14_3	136	6	0	600	0	-600	0.00	0.00	1	0	-1
0023	3T	14_3	142	1	1	100	800	700	1.00	8.00	0	1	1
0023	3T	14_3	146	2	0	200	0	-200	0.00	0.00	0	0	0
0023	3T	14_3	152	2	0	200	0	-200	0.00	0.00	0	0	0
0023	3T	14_3	156	2	0	200	0	-200	0.00	0.00	0	0	0
0023	3T	14_4	123	13	1	1300	470	-830	0.08	0.36	2	0	-2
0023	3T	14_4	124	21	0	2100	0	-2100	0.00	0.00	3	0	-3
0023	3T	14_4	125	19	1	1900	760	-1140	0.05	0.40	3	1	-2
0023	3T	14_4	126	28	2	2800	3090	290	0.07	1.10	4	5	1
0023	3T	14_4	134	10	1	1000	1320	320	0.10	1.32	1	2	1
0023	3T	14_4	135	14	1	1400	1680	280	0.07	1.20	2	2	0
0023	3T	14_4	136	20	4	2000	3940	1940	0.20	1.97	3	6	3
0023	3T	14_4	145	6	0	600	0	-600	0.00	0.00	1	0	-1
0023	3T	14_4	146	13	0	1300	0	-1300	0.00	0.00	2	0	-2
0023	3T	14_4	156	6	2	600	3850	3250	0.33	6.42	1	6	5
0023	3T	14_4	215	1	0	100	0	-100	0.00	0.00	0	0	0
0023	3T	14_4	235	1	0	100	0	-100	0.00	0.00	0	0	0
0023	3T	14_4	243	1	0	100	0	-100	0.00	0.00	0	0	0
0023	3T	14_4	256	1	0	100	0	-100	0.00	0.00	0	0	0
0023	3T	14_5	123	51	4	5100	3520	-1580	0.08	0.69	9	6	-3
0023	3T	14_5	124	31	3	3100	2370	-730	0.10	0.76	5	4	-1
0023	3T	14_5	125	19	7	1900	5520	3620	0.37	2.91	3	9	6
0023	3T	14_5	126	13	0	1300	0	-1300	0.00	0.00	2	0	-2
0023	3T	14_5	134	4	0	400	0	-400	0.00	0.00	0	0	0
0023	3T	14_5	135	7	2	700	1420	720	0.29	2.03	1	2	1
0023	3T	14_5	136	3	0	300	0	-300	0.00	0.00	0	0	0
0023	3T	14_5	143	2	0	200	0	-200	0.00	0.00	0	0	0
0023	3T	14_5	145	4	1	400	1800	1400	0.25	4.50	0	3	3
0023	3T	14_5	146	1	0	100	0	-100	0.00	0.00	0	0	0
0023	3T	14_5	152	1	0	100	0	-100	0.00	0.00	0	0	0
0023	3T	14_5	156	3	0	300	0	-300	0.00	0.00	0	0	0
0023	3T	14_6	123	4	0	400	0	-400	0.00	0.00	0	0	0
0023	3T	14_6	124	13	0	1300	0	-1300	0.00	0.00	2	0	-2
0023	3T	14_6	125	14	0	1400	0	-1400	0.00	0.00	2	0	-2
0023	3T	14_6	126	13	0	1300	0	-1300	0.00	0.00	2	0	-2
0023	3T	14_6	132	1	0	100	0	-100	0.00	0.00	0	0	0
0023	3T	14_6	134	4	0	400	0	-400	0.00	0.00	0	0	0
0023	3T	14_6	135	14	1	1400	1010	-390	0.07	0.72	2	1	-1
0023	3T	14_6	136	10	0	1000	0	-1000	0.00	0.00	1	0	-1
0023	3T	14_6	145	9	0	900	0	-900	0.00	0.00	1	0	-1
0023	3T	14_6	146	6	0	600	0	-600	0.00	0.00	1	0	-1
0023	3T	14_6	156	13	0	1300	0	-1300	0.00	0.00	2	0	-2
0023	3T	14_6	216	2	0	200	0	-200	0.00	0.00	0	0	0
0023	3T	14_6	234	1	0	100	0	-100	0.00	0.00	0	0	0
0023	3T	14_6	235	1	0	100	0	-100	0.00	0.00	0	0	0
0023	3T	14_6	236	1	0	100	0	-100	0.00	0.00	0	0	0
0023	3T	14_6	245	1	0	100	0	-100	0.00	0.00	0	0	0
0023	3T	14_6	246	1	0	100	0	-100	0.00	0.00	0	0	0
0023	3T	14_6	256	1	1	100	2670	2570	1.00	26.70	0	4	4
0023	3T	14_7	123	5	0	500	0	-500	0.00	0.00	0	0	0
0023	3T	14_7	124	7	0	700	0	-700	0.00	0.00	1	0	-1
0023	3T	14_7	125	14	0	1400	0	-1400	0.00	0.00	2	0	-2
0023	3T	14_7	126	27	1	2700	1330	-1370	0.04	0.49	4	2	-2
0023	3T	14_7	134	5	0	500	0	-500	0.00	0.00	0	0	0
0023	3T	14_7	135	8	1	800	1710	910	0.13	2.14	1	3	2
0023	3T	14_7	136	18	0	1800	0	-1800	0.00	0.00	3	0	-3
0023	3T	14_7	145	8	0	800	0	-800	0.00	0.00	1	0	-1
0023	3T	14_7	146	4	0	400	0	-400	0.00	0.00	0	0	0
0023	3T	14_7	156	6	0	600	0	-600	0.00	0.00	1	0	-1
0023	3T	14_7	216	1	0	100	0	-100	0.00	0.00	0	0	0
0023	3T	14_7	234	2	0	200	0	-200	0.00	0.00	0	0	0
0023	3T	14_7	236	2	0	200	0	-200	0.00	0.00	0	0	0
0023	3T	14_7	246	1	0	100	0	-100	0.00	0.00	0	0	0
0023	3T	14_8	123	12	0	1200	0	-1200	0.00	0.00	2	0	-2
0023	3T	14_8	124	7	0	700	0	-700	0.00	0.00	1	0	-1
0023	3T	14_8	125	10	0	1000	0	-1000	0.00	0.00	1	0	-1
0023	3T	14_8	126	18	2	1800	6190	4390	0.11	3.44	3	10	7
0023	3T	14_8	134	4	0	400	0	-400	0.00	0.00	0	0	0
0023	3T	14_8	135	8	0	800	0	-800	0.00	0.00	1	0	-1
0023	3T	14_8	136	14	0	1400	0	-1400	0.00	0.00	2	0	-2
0023	3T	14_8	143	1	1	100	1400	1300	1.00	14.00	0	2	2
0023	3T	14_8	145	8	0	800	0	-800	0.00	0.00	1	0	-1
0023	3T	14_8	146	8	0	800	0	-800	0.00	0.00	1	0	-1
0023	3T	14_8	156	4	0	400	0	-400	0.00	0.00	0	0	0
0023	3T	14_8	234	2	0	200	0	-200	0.00	0.00	0	0	0
0023	3T	14_8	235	1	0	100	0	-100	0.00	0.00	0	0	0
0023	3T	14_8	236	2	0	200	0	-200	0.00	0.00	0	0	0
0023	3T	14_8	245	2	0	200	0	-200	0.00	0.00	0	0	0
0023	3T	14_8	256	1	0	100	0	-100	0.00	0.00	0	0	0
0023	3T	14_9	123	12	3	1200	2020	820	0.25	1.68	2	3	1
0023	3T	14_9	124	25	1	2500	740	-1760	0.04	0.30	4	1	-3
0023	3T	14_9	125	16	1	1600	2750	1150	0.06	1.72	2	4	2
0023	3T	14_9	126	27	1	2700	1850	-850	0.04	0.69	4	3	-1
0023	3T	14_9	134	4	0	400	0	-400	0.00	0.00	0	0	0
0023	3T	14_9	135	11	0	1100	0	-1100	0.00	0.00	1	0	-1
0023	3T	14_9	136	9	1	900	1380	480	0.11	1.53	1	2	1
0023	3T	14_9	145	5	0	500	0	-500	0.00	0.00	0	0	0
0023	3T	14_9	146	5	0	500	0	-500	0.00	0.00	0	0	0
0023	3T	14_9	215	1	0	100	0	-100	0.00	0.00	0	0	0
0023	3T	14_9	236	1	0	100	0	-100	0.00	0.00	0	0	0
0023	3T	14_9	245	1	0	100	0	-100	0.00	0.00	0	0	0
0023	3T	14_9	246	1	0	100	0	-100	0.00	0.00	0	0	0
0023	3T	15_1	123	41	3	4100	1770	-2330	0.07	0.43	7	3	-4
0023	3T	15_1	124	54	7	5400	4380	-1020	0.13	0.81	9	7	-2
0023	3T	15_1	125	30	3	3000	3260	260	0.10	1.09	5	5	0
0023	3T	15_1	126	21	1	2100	700	-1400	0.05	0.33	3	1	-2
0023	3T	15_1	134	9	1	900	1040	140	0.11	1.16	1	1	0
0023	3T	15_1	135	12	0	1200	0	-1200	0.00	0.00	2	0	-2
0023	3T	15_1	136	7	1	700	400	-300	0.14	0.57	1	0	-1
0023	3T	15_1	142	1	0	100	0	-100	0.00	0.00	0	0	0
0023	3T	15_1	143	3	0	300	0	-300	0.00	0.00	0	0	0
0023	3T	15_1	145	2	0	200	0	-200	0.00	0.00	0	0	0
0023	3T	15_1	146	1	0	100	0	-100	0.00	0.00	0	0	0
0023	3T	15_1	152	2	0	200	0	-200	0.00	0.00	0	0	0
0023	3T	15_1	165	1	0	100	0	-100	0.00	0.00	0	0	0
0023	3T	15_10	123	32	5	3200	2720	-480	0.16	0.85	5	4	-1
0023	3T	15_10	124	82	5	8200	3720	-4480	0.06	0.45	14	6	-8
0023	3T	15_10	125	41	2	4100	3800	-300	0.05	0.93	7	6	-1
0023	3T	15_10	126	17	2	1700	2820	1120	0.12	1.66	3	4	1
0023	3T	15_10	134	25	2	2500	2130	-370	0.08	0.85	4	3	-1
0023	3T	15_10	135	23	1	2300	620	-1680	0.04	0.27	4	1	-3
0023	3T	15_10	136	17	1	1700	990	-710	0.06	0.58	3	1	-2
0023	3T	15_10	145	2	0	200	0	-200	0.00	0.00	0	0	0
0023	3T	15_10	146	4	0	400	0	-400	0.00	0.00	0	0	0
0023	3T	15_10	156	1	0	100	0	-100	0.00	0.00	0	0	0
0023	3T	15_10	234	1	0	100	0	-100	0.00	0.00	0	0	0
0023	3T	15_11	123	40	6	4000	3440	-560	0.15	0.86	7	6	-1
0023	3T	15_11	124	118	11	11800	9820	-1980	0.09	0.83	20	17	-3
0023	3T	15_11	125	40	3	4000	3150	-850	0.08	0.79	7	5	-2
0023	3T	15_11	126	13	0	1300	0	-1300	0.00	0.00	2	0	-2
0023	3T	15_11	134	27	2	2700	2030	-670	0.07	0.75	4	3	-1
0023	3T	15_11	135	13	0	1300	0	-1300	0.00	0.00	2	0	-2
0023	3T	15_11	136	5	0	500	0	-500	0.00	0.00	0	0	0
0023	3T	15_11	146	2	0	200	0	-200	0.00	0.00	0	0	0
0023	3T	15_11	156	1	0	100	0	-100	0.00	0.00	0	0	0
0023	3T	15_12	123	20	1	2000	540	-1460	0.05	0.27	3	0	-3
0023	3T	15_12	124	152	15	15200	11000	-4200	0.10	0.72	26	19	-7
0023	3T	15_12	125	32	2	3200	1520	-1680	0.06	0.48	5	2	-3
0023	3T	15_12	126	9	0	900	0	-900	0.00	0.00	1	0	-1
0023	3T	15_12	134	21	0	2100	0	-2100	0.00	0.00	3	0	-3
0023	3T	15_12	135	13	3	1300	2770	1470	0.23	2.13	2	4	2
0023	3T	15_12	136	4	0	400	0	-400	0.00	0.00	0	0	0
0023	3T	15_12	156	1	0	100	0	-100	0.00	0.00	0	0	0
0023	3T	15_2	123	22	2	2200	1770	-430	0.09	0.80	3	3	0
0023	3T	15_2	124	17	2	1700	1700	0	0.12	1.00	3	3	0
0023	3T	15_2	125	21	1	2100	790	-1310	0.05	0.38	3	1	-2
0023	3T	15_2	126	20	3	2000	5430	3430	0.15	2.72	3	9	6
0023	3T	15_2	132	5	0	500	0	-500	0.00	0.00	0	0	0
0023	3T	15_2	134	16	0	1600	0	-1600	0.00	0.00	2	0	-2
0023	3T	15_2	135	6	0	600	0	-600	0.00	0.00	1	0	-1
0023	3T	15_2	136	10	2	1000	3940	2940	0.20	3.94	1	6	5
0023	3T	15_2	142	6	0	600	0	-600	0.00	0.00	1	0	-1
0023	3T	15_2	145	2	1	200	1180	980	0.50	5.90	0	2	2
0023	3T	15_2	146	4	0	400	0	-400	0.00	0.00	0	0	0
0023	3T	15_2	153	1	0	100	0	-100	0.00	0.00	0	0	0
0023	3T	15_2	156	4	0	400	0	-400	0.00	0.00	0	0	0
0023	3T	15_2	253	1	0	100	0	-100	0.00	0.00	0	0	0
0023	3T	15_3	123	3	0	300	0	-300	0.00	0.00	0	0	0
0023	3T	15_3	124	14	0	1400	0	-1400	0.00	0.00	2	0	-2
0023	3T	15_3	125	25	2	2500	2820	320	0.08	1.13	4	4	0
0023	3T	15_3	126	27	1	2700	1770	-930	0.04	0.66	4	3	-1
0023	3T	15_3	132	1	0	100	0	-100	0.00	0.00	0	0	0
0023	3T	15_3	134	9	2	900	1410	510	0.22	1.57	1	2	1
0023	3T	15_3	135	15	1	1500	1130	-370	0.07	0.75	2	2	0
0023	3T	15_3	136	26	0	2600	0	-2600	0.00	0.00	4	0	-4
0023	3T	15_3	143	1	0	100	0	-100	0.00	0.00	0	0	0
0023	3T	15_3	145	8	0	800	0	-800	0.00	0.00	1	0	-1
0023	3T	15_3	146	13	0	1300	0	-1300	0.00	0.00	2	0	-2
0023	3T	15_3	156	10	0	1000	0	-1000	0.00	0.00	1	0	-1
0023	3T	15_3	164	1	0	100	0	-100	0.00	0.00	0	0	0
0023	3T	15_3	236	2	0	200	0	-200	0.00	0.00	0	0	0
0023	3T	15_4	123	1	0	100	0	-100	0.00	0.00	0	0	0
0023	3T	15_4	124	4	0	400	0	-400	0.00	0.00	0	0	0
0023	3T	15_4	125	12	0	1200	0	-1200	0.00	0.00	2	0	-2
0023	3T	15_4	126	20	2	2000	1970	-30	0.10	0.99	3	3	0
0023	3T	15_4	134	9	1	900	1070	170	0.11	1.19	1	1	0
0023	3T	15_4	135	16	0	1600	0	-1600	0.00	0.00	2	0	-2
0023	3T	15_4	136	36	5	3600	6280	2680	0.14	1.74	6	11	5
0023	3T	15_4	143	1	0	100	0	-100	0.00	0.00	0	0	0
0023	3T	15_4	145	5	0	500	0	-500	0.00	0.00	0	0	0
0023	3T	15_4	146	19	0	1900	0	-1900	0.00	0.00	3	0	-3
0023	3T	15_4	154	1	0	100	0	-100	0.00	0.00	0	0	0
0023	3T	15_4	156	14	1	1400	4610	3210	0.07	3.29	2	8	6
0023	3T	15_4	236	3	0	300	0	-300	0.00	0.00	0	0	0
0023	3T	15_4	256	2	0	200	0	-200	0.00	0.00	0	0	0
0023	3T	15_5	123	13	0	1300	0	-1300	0.00	0.00	2	0	-2
0023	3T	15_5	124	66	8	6600	4540	-2060	0.12	0.69	11	8	-3
0023	3T	15_5	125	3	0	300	0	-300	0.00	0.00	0	0	0
0023	3T	15_5	126	1	0	100	0	-100	0.00	0.00	0	0	0
0023	3T	15_5	134	84	13	8400	7640	-760	0.15	0.91	14	13	-1
0023	3T	15_5	135	3	0	300	0	-300	0.00	0.00	0	0	0
0023	3T	15_5	136	4	0	400	0	-400	0.00	0.00	0	0	0
0023	3T	15_5	143	1	0	100	0	-100	0.00	0.00	0	0	0
0023	3T	15_5	145	1	0	100	0	-100	0.00	0.00	0	0	0
0023	3T	15_5	146	2	0	200	0	-200	0.00	0.00	0	0	0
0023	3T	15_6	123	9	1	900	390	-510	0.11	0.43	1	0	-1
0023	3T	15_6	124	27	0	2700	0	-2700	0.00	0.00	4	0	-4
0023	3T	15_6	125	29	5	2900	4920	2020	0.17	1.70	5	8	3
0023	3T	15_6	126	37	1	3700	930	-2770	0.03	0.25	6	1	-5
0023	3T	15_6	134	3	0	300	0	-300	0.00	0.00	0	0	0
0023	3T	15_6	135	18	0	1800	0	-1800	0.00	0.00	3	0	-3
0023	3T	15_6	136	6	1	600	960	360	0.17	1.60	1	1	0
0023	3T	15_6	145	4	0	400	0	-400	0.00	0.00	0	0	0
0023	3T	15_6	156	3	0	300	0	-300	0.00	0.00	0	0	0
0023	3T	15_6	214	1	0	100	0	-100	0.00	0.00	0	0	0
0023	3T	15_6	215	1	0	100	0	-100	0.00	0.00	0	0	0
0023	3T	15_6	216	1	0	100	0	-100	0.00	0.00	0	0	0
0023	3T	15_6	235	2	1	200	1340	1140	0.50	6.70	0	2	2
0023	3T	15_6	236	1	0	100	0	-100	0.00	0.00	0	0	0
0023	3T	15_6	245	1	0	100	0	-100	0.00	0.00	0	0	0
0023	3T	15_6	246	1	0	100	0	-100	0.00	0.00	0	0	0
0023	3T	15_6	256	1	0	100	0	-100	0.00	0.00	0	0	0
0023	3T	15_7	123	16	3	1600	3780	2180	0.19	2.36	2	6	4
0023	3T	15_7	124	24	0	2400	0	-2400	0.00	0.00	4	0	-4
0023	3T	15_7	125	33	2	3300	5970	2670	0.06	1.81	5	10	5
0023	3T	15_7	126	28	0	2800	0	-2800	0.00	0.00	4	0	-4
0023	3T	15_7	134	5	0	500	0	-500	0.00	0.00	0	0	0
0023	3T	15_7	135	12	1	1200	550	-650	0.08	0.46	2	0	-2
0023	3T	15_7	136	16	1	1600	1570	-30	0.06	0.98	2	2	0
0023	3T	15_7	145	5	0	500	0	-500	0.00	0.00	0	0	0
0023	3T	15_7	146	5	0	500	0	-500	0.00	0.00	0	0	0
0023	3T	15_7	156	5	1	500	1370	870	0.20	2.74	0	2	2
0023	3T	15_7	164	2	1	200	1370	1170	0.50	6.85	0	2	2
0023	3T	15_7	216	1	0	100	0	-100	0.00	0.00	0	0	0
0023	3T	15_7	234	1	0	100	0	-100	0.00	0.00	0	0	0
0023	3T	15_7	235	2	0	200	0	-200	0.00	0.00	0	0	0
0023	3T	15_7	236	1	0	100	0	-100	0.00	0.00	0	0	0
0023	3T	15_7	245	1	1	100	2140	2040	1.00	21.40	0	3	3
0023	3T	15_8	123	21	1	2100	550	-1550	0.05	0.26	3	0	-3
0023	3T	15_8	124	206	29	20600	12260	-8340	0.14	0.60	36	21	-15
0023	3T	15_8	125	3	0	300	0	-300	0.00	0.00	0	0	0
0023	3T	15_8	126	2	0	200	0	-200	0.00	0.00	0	0	0
0023	3T	15_8	136	1	0	100	0	-100	0.00	0.00	0	0	0
0023	3T	15_9	123	32	5	3200	3130	-70	0.16	0.98	5	5	0
0023	3T	15_9	124	54	5	5400	4220	-1180	0.09	0.78	9	7	-2
0023	3T	15_9	125	32	1	3200	2020	-1180	0.03	0.63	5	3	-2
0023	3T	15_9	126	24	2	2400	2360	-40	0.08	0.98	4	4	0
0023	3T	15_9	134	14	2	1400	2100	700	0.14	1.50	2	3	1
0023	3T	15_9	135	20	1	2000	1020	-980	0.05	0.51	3	1	-2
0023	3T	15_9	136	9	1	900	820	-80	0.11	0.91	1	1	0
0023	3T	15_9	145	4	0	400	0	-400	0.00	0.00	0	0	0
0023	3T	15_9	146	1	0	100	0	-100	0.00	0.00	0	0	0
0023	3T	15_9	156	2	0	200	0	-200	0.00	0.00	0	0	0
0023	3T	15_9	164	1	0	100	0	-100	0.00	0.00	0	0	0
0023	3T	15_9	236	1	0	100	0	-100	0.00	0.00	0	0	0
0023	3T	16_1	123	59	9	5900	6330	430	0.15	1.07	10	11	1
0023	3T	16_1	124	63	5	6300	3020	-3280	0.08	0.48	11	5	-6
0023	3T	16_1	125	21	2	2100	1230	-870	0.10	0.59	3	2	-1
0023	3T	16_1	126	10	0	1000	0	-1000	0.00	0.00	1	0	-1
0023	3T	16_1	132	8	0	800	0	-800	0.00	0.00	1	0	-1
0023	3T	16_1	134	14	2	1400	3230	1830	0.14	2.31	2	5	3
0023	3T	16_1	136	3	0	300	0	-300	0.00	0.00	0	0	0
0023	3T	16_1	142	1	0	100	0	-100	0.00	0.00	0	0	0
0023	3T	16_1	143	1	0	100	0	-100	0.00	0.00	0	0	0
0023	3T	16_1	145	1	0	100	0	-100	0.00	0.00	0	0	0
0023	3T	16_1	146	1	1	100	560	460	1.00	5.60	0	0	0
0023	3T	16_1	152	1	0	100	0	-100	0.00	0.00	0	0	0
0023	3T	16_10	123	20	2	2000	1260	-740	0.10	0.63	3	2	-1
0023	3T	16_10	124	96	11	9600	8820	-780	0.11	0.92	16	15	-1
0023	3T	16_10	125	39	3	3900	2080	-1820	0.08	0.53	6	3	-3
0023	3T	16_10	126	35	3	3500	2410	-1090	0.09	0.69	6	4	-2
0023	3T	16_10	134	16	2	1600	1200	-400	0.13	0.75	2	2	0
0023	3T	16_10	135	21	2	2100	2640	540	0.10	1.26	3	4	1
0023	3T	16_10	136	3	0	300	0	-300	0.00	0.00	0	0	0
0023	3T	16_10	145	3	0	300	0	-300	0.00	0.00	0	0	0
0023	3T	16_10	156	2	1	200	760	560	0.50	3.80	0	1	1
0023	3T	16_10	214	1	0	100	0	-100	0.00	0.00	0	0	0
0023	3T	16_10	234	1	0	100	0	-100	0.00	0.00	0	0	0
0023	3T	16_11	123	31	6	3100	2810	-290	0.19	0.91	5	4	-1
0023	3T	16_11	124	131	16	13100	15640	2540	0.12	1.19	23	27	4
0023	3T	16_11	125	28	2	2800	2300	-500	0.07	0.82	4	4	0
0023	3T	16_11	126	7	1	700	2540	1840	0.14	3.63	1	4	3
0023	3T	16_11	134	34	2	3400	1640	-1760	0.06	0.48	6	2	-4
0023	3T	16_11	135	21	2	2100	1300	-800	0.10	0.62	3	2	-1
0023	3T	16_11	136	1	0	100	0	-100	0.00	0.00	0	0	0
0023	3T	16_11	146	1	0	100	0	-100	0.00	0.00	0	0	0
0023	3T	16_12	123	24	7	2400	4860	2460	0.29	2.03	4	8	4
0023	3T	16_12	124	175	16	17500	13240	-4260	0.09	0.76	30	23	-7
0023	3T	16_12	125	21	1	2100	760	-1340	0.05	0.36	3	1	-2
0023	3T	16_12	126	4	0	400	0	-400	0.00	0.00	0	0	0
0023	3T	16_12	134	25	0	2500	0	-2500	0.00	0.00	4	0	-4
0023	3T	16_12	135	13	3	1300	2370	1070	0.23	1.82	2	4	2
0023	3T	16_12	136	3	0	300	0	-300	0.00	0.00	0	0	0
0023	3T	16_12	145	1	0	100	0	-100	0.00	0.00	0	0	0
0023	3T	16_2	123	34	3	3400	2240	-1160	0.09	0.66	6	3	-3
0023	3T	16_2	124	17	1	1700	700	-1000	0.06	0.41	3	1	-2
0023	3T	16_2	125	27	2	2700	2000	-700	0.07	0.74	4	3	-1
0023	3T	16_2	126	17	3	1700	3790	2090	0.18	2.23	3	6	3
0023	3T	16_2	132	2	0	200	0	-200	0.00	0.00	0	0	0
0023	3T	16_2	134	6	1	600	1220	620	0.17	2.03	1	2	1
0023	3T	16_2	135	3	0	300	0	-300	0.00	0.00	0	0	0
0023	3T	16_2	136	10	0	1000	0	-1000	0.00	0.00	1	0	-1
0023	3T	16_2	143	7	0	700	0	-700	0.00	0.00	1	0	-1
0023	3T	16_2	145	5	1	500	800	300	0.20	1.60	0	1	1
0023	3T	16_2	146	6	1	600	1030	430	0.17	1.72	1	1	0
0023	3T	16_2	156	3	0	300	0	-300	0.00	0.00	0	0	0
0023	3T	16_2	163	2	0	200	0	-200	0.00	0.00	0	0	0
0023	3T	16_2	236	1	0	100	0	-100	0.00	0.00	0	0	0
0023	3T	16_3	123	11	0	1100	0	-1100	0.00	0.00	1	0	-1
0023	3T	16_3	124	13	0	1300	0	-1300	0.00	0.00	2	0	-2
0023	3T	16_3	125	19	0	1900	0	-1900	0.00	0.00	3	0	-3
0023	3T	16_3	126	26	1	2600	930	-1670	0.04	0.36	4	1	-3
0023	3T	16_3	134	7	0	700	0	-700	0.00	0.00	1	0	-1
0023	3T	16_3	135	14	0	1400	0	-1400	0.00	0.00	2	0	-2
0023	3T	16_3	136	14	0	1400	0	-1400	0.00	0.00	2	0	-2
0023	3T	16_3	145	8	0	800	0	-800	0.00	0.00	1	0	-1
0023	3T	16_3	146	11	1	1100	610	-490	0.09	0.55	1	1	0
0023	3T	16_3	153	1	0	100	0	-100	0.00	0.00	0	0	0
0023	3T	16_3	156	4	0	400	0	-400	0.00	0.00	0	0	0
0023	3T	16_3	214	1	0	100	0	-100	0.00	0.00	0	0	0
0023	3T	16_3	236	2	1	200	1970	1770	0.50	9.85	0	3	3
0023	3T	16_3	246	1	0	100	0	-100	0.00	0.00	0	0	0
0023	3T	16_4	123	16	0	1600	0	-1600	0.00	0.00	2	0	-2
0023	3T	16_4	124	12	2	1200	2430	1230	0.17	2.03	2	4	2
0023	3T	16_4	125	26	4	2600	4760	2160	0.15	1.83	4	8	4
0023	3T	16_4	126	24	2	2400	3070	670	0.08	1.28	4	5	1
0023	3T	16_4	134	10	0	1000	0	-1000	0.00	0.00	1	0	-1
0023	3T	16_4	135	14	0	1400	0	-1400	0.00	0.00	2	0	-2
0023	3T	16_4	136	22	1	2200	2920	720	0.05	1.33	3	5	2
0023	3T	16_4	145	13	0	1300	0	-1300	0.00	0.00	2	0	-2
0023	3T	16_4	146	6	1	600	2300	1700	0.17	3.83	1	4	3
0023	3T	16_4	156	5	0	500	0	-500	0.00	0.00	0	0	0
0023	3T	16_4	214	1	0	100	0	-100	0.00	0.00	0	0	0
0023	3T	16_4	235	1	0	100	0	-100	0.00	0.00	0	0	0
0023	3T	16_4	236	2	0	200	0	-200	0.00	0.00	0	0	0
0023	3T	16_4	245	1	0	100	0	-100	0.00	0.00	0	0	0
0023	3T	16_4	246	1	0	100	0	-100	0.00	0.00	0	0	0
0023	3T	16_4	256	2	0	200	0	-200	0.00	0.00	0	0	0
0023	3T	16_5	123	13	1	1300	760	-540	0.08	0.58	2	1	-1
0023	3T	16_5	124	16	2	1600	1500	-100	0.13	0.94	2	2	0
0023	3T	16_5	125	29	3	2900	1910	-990	0.10	0.66	5	3	-2
0023	3T	16_5	126	27	1	2700	1230	-1470	0.04	0.46	4	2	-2
0023	3T	16_5	134	15	2	1500	1670	170	0.13	1.11	2	2	0
0023	3T	16_5	135	19	1	1900	1300	-600	0.05	0.68	3	2	-1
0023	3T	16_5	136	20	2	2000	2020	20	0.10	1.01	3	3	0
0023	3T	16_5	145	6	0	600	0	-600	0.00	0.00	1	0	-1
0023	3T	16_5	146	2	1	200	850	650	0.50	4.25	0	1	1
0023	3T	16_5	156	3	1	300	1600	1300	0.33	5.33	0	2	2
0023	3T	16_5	165	1	0	100	0	-100	0.00	0.00	0	0	0
0023	3T	16_5	234	1	0	100	0	-100	0.00	0.00	0	0	0
0023	3T	16_5	235	1	0	100	0	-100	0.00	0.00	0	0	0
0023	3T	16_5	246	1	0	100	0	-100	0.00	0.00	0	0	0
0023	3T	16_5	256	3	0	300	0	-300	0.00	0.00	0	0	0
0023	3T	16_6	123	147	33	14700	14210	-490	0.22	0.97	26	25	-1
0023	3T	16_6	124	44	2	4400	1600	-2800	0.05	0.36	7	2	-5
0023	3T	16_6	125	4	0	400	0	-400	0.00	0.00	0	0	0
0023	3T	16_6	126	9	0	900	0	-900	0.00	0.00	1	0	-1
0023	3T	16_6	134	15	3	1500	2300	800	0.20	1.53	2	4	2
0023	3T	16_6	135	3	0	300	0	-300	0.00	0.00	0	0	0
0023	3T	16_6	136	2	0	200	0	-200	0.00	0.00	0	0	0
0023	3T	16_6	165	1	0	100	0	-100	0.00	0.00	0	0	0
0023	3T	16_7	123	5	0	500	0	-500	0.00	0.00	0	0	0
0023	3T	16_7	124	31	3	3100	2330	-770	0.10	0.75	5	4	-1
0023	3T	16_7	125	14	1	1400	530	-870	0.07	0.38	2	0	-2
0023	3T	16_7	126	28	2	2800	2300	-500	0.07	0.82	4	4	0
0023	3T	16_7	134	6	0	600	0	-600	0.00	0.00	1	0	-1
0023	3T	16_7	135	10	0	1000	0	-1000	0.00	0.00	1	0	-1
0023	3T	16_7	136	9	0	900	0	-900	0.00	0.00	1	0	-1
0023	3T	16_7	145	4	0	400	0	-400	0.00	0.00	0	0	0
0023	3T	16_7	146	6	0	600	0	-600	0.00	0.00	1	0	-1
0023	3T	16_7	156	6	0	600	0	-600	0.00	0.00	1	0	-1
0023	3T	16_7	164	1	0	100	0	-100	0.00	0.00	0	0	0
0023	3T	16_7	165	1	0	100	0	-100	0.00	0.00	0	0	0
0023	3T	16_7	216	2	0	200	0	-200	0.00	0.00	0	0	0
0023	3T	16_7	236	2	1	200	610	410	0.50	3.05	0	1	1
0023	3T	16_7	245	2	0	200	0	-200	0.00	0.00	0	0	0
0023	3T	16_7	256	4	1	400	1030	630	0.25	2.58	0	1	1
0023	3T	16_8	123	4	1	400	740	340	0.25	1.85	0	1	1
0023	3T	16_8	124	31	3	3100	2280	-820	0.10	0.74	5	4	-1
0023	3T	16_8	125	25	2	2500	3020	520	0.08	1.21	4	5	1
0023	3T	16_8	126	38	4	3800	3580	-220	0.11	0.94	6	6	0
0023	3T	16_8	134	14	0	1400	0	-1400	0.00	0.00	2	0	-2
0023	3T	16_8	135	8	1	800	890	90	0.13	1.11	1	1	0
0023	3T	16_8	136	11	1	1100	2350	1250	0.09	2.14	1	4	3
0023	3T	16_8	145	4	0	400	0	-400	0.00	0.00	0	0	0
0023	3T	16_8	146	5	1	500	930	430	0.20	1.86	0	1	1
0023	3T	16_8	156	3	0	300	0	-300	0.00	0.00	0	0	0
0023	3T	16_8	213	1	0	100	0	-100	0.00	0.00	0	0	0
0023	3T	16_8	214	2	0	200	0	-200	0.00	0.00	0	0	0
0023	3T	16_8	215	2	0	200	0	-200	0.00	0.00	0	0	0
0023	3T	16_8	216	1	0	100	0	-100	0.00	0.00	0	0	0
0023	3T	16_8	234	1	0	100	0	-100	0.00	0.00	0	0	0
0023	3T	16_8	235	2	0	200	0	-200	0.00	0.00	0	0	0
0023	3T	16_8	236	1	0	100	0	-100	0.00	0.00	0	0	0
0023	3T	16_8	256	2	0	200	0	-200	0.00	0.00	0	0	0
0023	3T	16_9	123	6	0	600	0	-600	0.00	0.00	1	0	-1
0023	3T	16_9	124	58	8	5800	5380	-420	0.14	0.93	10	9	-1
0023	3T	16_9	125	9	0	900	0	-900	0.00	0.00	1	0	-1
0023	3T	16_9	126	1	0	100	0	-100	0.00	0.00	0	0	0
0023	3T	16_9	134	19	2	1900	1360	-540	0.11	0.72	3	2	-1
0023	3T	16_9	135	2	0	200	0	-200	0.00	0.00	0	0	0
0023	3T	16_9	136	1	0	100	0	-100	0.00	0.00	0	0	0
0023	3T	16_9	143	1	1	100	970	870	1.00	9.70	0	1	1
0023	3T	16_9	145	18	1	1800	890	-910	0.06	0.49	3	1	-2
0023	3T	16_9	146	3	0	300	0	-300	0.00	0.00	0	0	0
0023	3T	17_1	123	36	2	3600	1170	-2430	0.06	0.33	6	2	-4
0023	3T	17_1	124	58	4	5800	2780	-3020	0.07	0.48	10	4	-6
0023	3T	17_1	125	29	2	2900	2240	-660	0.07	0.77	5	3	-2
0023	3T	17_1	126	18	2	1800	4110	2310	0.11	2.28	3	7	4
0023	3T	17_1	132	1	0	100	0	-100	0.00	0.00	0	0	0
0023	3T	17_1	134	23	3	2300	4110	1810	0.13	1.79	4	7	3
0023	3T	17_1	135	3	0	300	0	-300	0.00	0.00	0	0	0
0023	3T	17_1	136	2	1	200	630	430	0.50	3.15	0	1	1
0023	3T	17_1	143	2	0	200	0	-200	0.00	0.00	0	0	0
0023	3T	17_1	146	2	0	200	0	-200	0.00	0.00	0	0	0
0023	3T	17_10	123	44	6	4400	3150	-1250	0.14	0.72	7	5	-2
0023	3T	17_10	124	69	7	6900	5020	-1880	0.10	0.73	12	8	-4
0023	3T	17_10	125	31	1	3100	780	-2320	0.03	0.25	5	1	-4
0023	3T	17_10	126	5	1	500	670	170	0.20	1.34	0	1	1
0023	3T	17_10	134	24	2	2400	1690	-710	0.08	0.70	4	2	-2
0023	3T	17_10	135	9	2	900	2470	1570	0.22	2.74	1	4	3
0023	3T	17_10	143	4	0	400	0	-400	0.00	0.00	0	0	0
0023	3T	17_10	145	4	0	400	0	-400	0.00	0.00	0	0	0
0023	3T	17_10	146	2	0	200	0	-200	0.00	0.00	0	0	0
0023	3T	17_10	153	1	0	100	0	-100	0.00	0.00	0	0	0
0023	3T	17_10	163	2	0	200	0	-200	0.00	0.00	0	0	0
0023	3T	17_10	213	2	0	200	0	-200	0.00	0.00	0	0	0
0023	3T	17_10	215	1	0	100	0	-100	0.00	0.00	0	0	0
0023	3T	17_10	261	1	0	100	0	-100	0.00	0.00	0	0	0
0023	3T	17_11	123	83	12	8300	10050	1750	0.14	1.21	14	17	3
0023	3T	17_11	124	43	4	4300	3500	-800	0.09	0.81	7	6	-1
0023	3T	17_11	125	27	1	2700	830	-1870	0.04	0.31	4	1	-3
0023	3T	17_11	126	1	0	100	0	-100	0.00	0.00	0	0	0
0023	3T	17_11	134	14	1	1400	410	-990	0.07	0.29	2	0	-2
0023	3T	17_11	135	7	1	700	1210	510	0.14	1.73	1	2	1
0023	3T	17_11	143	6	0	600	0	-600	0.00	0.00	1	0	-1
0023	3T	17_11	145	4	2	400	1790	1390	0.50	4.48	0	3	3
0023	3T	17_11	213	1	0	100	0	-100	0.00	0.00	0	0	0
0023	3T	17_11	214	1	0	100	0	-100	0.00	0.00	0	0	0
0023	3T	17_11	216	2	0	200	0	-200	0.00	0.00	0	0	0
0023	3T	17_12	123	56	8	5600	5380	-220	0.14	0.96	9	9	0
0023	3T	17_12	124	136	10	13600	9010	-4590	0.07	0.66	24	15	-9
0023	3T	17_12	125	30	2	3000	2570	-430	0.07	0.86	5	4	-1
0023	3T	17_12	134	19	2	1900	1220	-680	0.11	0.64	3	2	-1
0023	3T	17_12	153	1	0	100	0	-100	0.00	0.00	0	0	0
0023	3T	17_12	215	1	0	100	0	-100	0.00	0.00	0	0	0
0023	3T	17_12	256	1	0	100	0	-100	0.00	0.00	0	0	0
0023	3T	17_2	123	21	3	2100	2300	200	0.14	1.10	3	4	1
0023	3T	17_2	124	33	0	3300	0	-3300	0.00	0.00	5	0	-5
0023	3T	17_2	125	20	0	2000	0	-2000	0.00	0.00	3	0	-3
0023	3T	17_2	126	18	1	1800	3520	1720	0.06	1.96	3	6	3
0023	3T	17_2	132	8	0	800	0	-800	0.00	0.00	1	0	-1
0023	3T	17_2	134	11	0	1100	0	-1100	0.00	0.00	1	0	-1
0023	3T	17_2	135	4	0	400	0	-400	0.00	0.00	0	0	0
0023	3T	17_2	136	2	0	200	0	-200	0.00	0.00	0	0	0
0023	3T	17_2	142	3	0	300	0	-300	0.00	0.00	0	0	0
0023	3T	17_2	146	4	0	400	0	-400	0.00	0.00	0	0	0
0023	3T	17_2	153	1	0	100	0	-100	0.00	0.00	0	0	0
0023	3T	17_2	156	1	0	100	0	-100	0.00	0.00	0	0	0
0023	3T	17_2	162	1	0	100	0	-100	0.00	0.00	0	0	0
0023	3T	17_2	234	1	0	100	0	-100	0.00	0.00	0	0	0
0023	3T	17_2	253	2	0	200	0	-200	0.00	0.00	0	0	0
0023	3T	17_3	123	2	0	200	0	-200	0.00	0.00	0	0	0
0023	3T	17_3	124	23	3	2300	2320	20	0.13	1.01	4	4	0
0023	3T	17_3	125	22	1	2200	1100	-1100	0.05	0.50	3	1	-2
0023	3T	17_3	126	23	0	2300	0	-2300	0.00	0.00	4	0	-4
0023	3T	17_3	132	1	0	100	0	-100	0.00	0.00	0	0	0
0023	3T	17_3	134	13	0	1300	0	-1300	0.00	0.00	2	0	-2
0023	3T	17_3	135	17	1	1700	1300	-400	0.06	0.76	3	2	-1
0023	3T	17_3	136	8	0	800	0	-800	0.00	0.00	1	0	-1
0023	3T	17_3	145	6	0	600	0	-600	0.00	0.00	1	0	-1
0023	3T	17_3	146	8	0	800	0	-800	0.00	0.00	1	0	-1
0023	3T	17_3	156	5	0	500	0	-500	0.00	0.00	0	0	0
0023	3T	17_3	164	1	0	100	0	-100	0.00	0.00	0	0	0
0023	3T	17_3	165	1	0	100	0	-100	0.00	0.00	0	0	0
0023	3T	17_3	215	1	0	100	0	-100	0.00	0.00	0	0	0
0023	3T	17_3	216	3	1	300	9520	9220	0.33	31.73	0	16	16
0023	3T	17_3	234	1	0	100	0	-100	0.00	0.00	0	0	0
0023	3T	17_3	235	3	0	300	0	-300	0.00	0.00	0	0	0
0023	3T	17_3	236	5	0	500	0	-500	0.00	0.00	0	0	0
0023	3T	17_3	245	1	0	100	0	-100	0.00	0.00	0	0	0
0023	3T	17_3	246	2	0	200	0	-200	0.00	0.00	0	0	0
0023	3T	17_3	256	1	0	100	0	-100	0.00	0.00	0	0	0
0023	3T	17_4	123	18	4	1800	1820	20	0.22	1.01	3	3	0
0023	3T	17_4	124	56	3	5600	1650	-3950	0.05	0.29	9	2	-7
0023	3T	17_4	125	24	3	2400	2090	-310	0.13	0.87	4	3	-1
0023	3T	17_4	126	8	0	800	0	-800	0.00	0.00	1	0	-1
0023	3T	17_4	134	37	5	3700	2870	-830	0.14	0.78	6	5	-1
0023	3T	17_4	135	8	0	800	0	-800	0.00	0.00	1	0	-1
0023	3T	17_4	136	6	0	600	0	-600	0.00	0.00	1	0	-1
0023	3T	17_4	142	1	0	100	0	-100	0.00	0.00	0	0	0
0023	3T	17_4	145	3	0	300	0	-300	0.00	0.00	0	0	0
0023	3T	17_4	146	6	1	600	1470	870	0.17	2.45	1	2	1
0023	3T	17_4	156	1	0	100	0	-100	0.00	0.00	0	0	0
0023	3T	17_4	216	1	0	100	0	-100	0.00	0.00	0	0	0
0023	3T	17_4	234	2	0	200	0	-200	0.00	0.00	0	0	0
0023	3T	17_4	235	3	1	300	870	570	0.33	2.90	0	1	1
0023	3T	17_4	236	1	0	100	0	-100	0.00	0.00	0	0	0
0023	3T	17_4	245	1	0	100	0	-100	0.00	0.00	0	0	0
0023	3T	17_4	246	1	0	100	0	-100	0.00	0.00	0	0	0
0023	3T	17_5	123	20	5	2000	2940	940	0.25	1.47	3	5	2
0023	3T	17_5	124	40	3	4000	1740	-2260	0.08	0.44	7	3	-4
0023	3T	17_5	125	19	0	1900	0	-1900	0.00	0.00	3	0	-3
0023	3T	17_5	126	18	2	1800	12880	11080	0.11	7.16	3	22	19
0023	3T	17_5	134	27	2	2700	1450	-1250	0.07	0.54	4	2	-2
0023	3T	17_5	135	15	1	1500	860	-640	0.07	0.57	2	1	-1
0023	3T	17_5	136	7	0	700	0	-700	0.00	0.00	1	0	-1
0023	3T	17_5	145	2	0	200	0	-200	0.00	0.00	0	0	0
0023	3T	17_5	146	1	0	100	0	-100	0.00	0.00	0	0	0
0023	3T	17_5	214	1	0	100	0	-100	0.00	0.00	0	0	0
0023	3T	17_5	235	1	0	100	0	-100	0.00	0.00	0	0	0
0023	3T	17_5	245	1	0	100	0	-100	0.00	0.00	0	0	0
0023	3T	17_5	256	1	0	100	0	-100	0.00	0.00	0	0	0
0023	3T	17_6	123	16	3	1600	1630	30	0.19	1.02	2	2	0
0023	3T	17_6	124	32	4	3200	2740	-460	0.13	0.86	5	4	-1
0023	3T	17_6	125	38	3	3800	3020	-780	0.08	0.79	6	5	-1
0023	3T	17_6	126	17	0	1700	0	-1700	0.00	0.00	3	0	-3
0023	3T	17_6	134	15	1	1500	420	-1080	0.07	0.28	2	0	-2
0023	3T	17_6	135	6	0	600	0	-600	0.00	0.00	1	0	-1
0023	3T	17_6	136	10	1	1000	1160	160	0.10	1.16	1	2	1
0023	3T	17_6	145	5	0	500	0	-500	0.00	0.00	0	0	0
0023	3T	17_6	146	5	0	500	0	-500	0.00	0.00	0	0	0
0023	3T	17_6	156	3	0	300	0	-300	0.00	0.00	0	0	0
0023	3T	17_6	234	1	0	100	0	-100	0.00	0.00	0	0	0
0023	3T	17_6	235	3	0	300	0	-300	0.00	0.00	0	0	0
0023	3T	17_6	236	1	0	100	0	-100	0.00	0.00	0	0	0
0023	3T	17_6	245	2	0	200	0	-200	0.00	0.00	0	0	0
0023	3T	17_6	246	1	0	100	0	-100	0.00	0.00	0	0	0
0023	3T	17_7	123	15	2	1500	1940	440	0.13	1.29	2	3	1
0023	3T	17_7	124	31	3	3100	2080	-1020	0.10	0.67	5	3	-2
0023	3T	17_7	125	27	3	2700	1810	-890	0.11	0.67	4	3	-1
0023	3T	17_7	126	25	1	2500	880	-1620	0.04	0.35	4	1	-3
0023	3T	17_7	134	15	2	1500	1500	0	0.13	1.00	2	2	0
0023	3T	17_7	135	25	1	2500	500	-2000	0.04	0.20	4	0	-4
0023	3T	17_7	136	10	1	1000	1090	90	0.10	1.09	1	1	0
0023	3T	17_7	145	8	1	800	2670	1870	0.13	3.34	1	4	3
0023	3T	17_7	146	3	0	300	0	-300	0.00	0.00	0	0	0
0023	3T	17_7	216	2	0	200	0	-200	0.00	0.00	0	0	0
0023	3T	17_7	234	1	0	100	0	-100	0.00	0.00	0	0	0
0023	3T	17_7	235	1	0	100	0	-100	0.00	0.00	0	0	0
0023	3T	17_7	236	2	0	200	0	-200	0.00	0.00	0	0	0
0023	3T	17_7	245	1	0	100	0	-100	0.00	0.00	0	0	0
0023	3T	17_7	246	3	0	300	0	-300	0.00	0.00	0	0	0
0023	3T	17_8	123	9	0	900	0	-900	0.00	0.00	1	0	-1
0023	3T	17_8	124	33	2	3300	900	-2400	0.06	0.27	5	1	-4
0023	3T	17_8	125	31	2	3100	2040	-1060	0.06	0.66	5	3	-2
0023	3T	17_8	126	25	2	2500	2980	480	0.08	1.19	4	5	1
0023	3T	17_8	134	21	1	2100	580	-1520	0.05	0.28	3	1	-2
0023	3T	17_8	135	23	2	2300	1580	-720	0.09	0.69	4	2	-2
0023	3T	17_8	136	6	1	600	970	370	0.17	1.62	1	1	0
0023	3T	17_8	145	13	0	1300	0	-1300	0.00	0.00	2	0	-2
0023	3T	17_8	146	4	1	400	780	380	0.25	1.95	0	1	1
0023	3T	17_8	164	3	0	300	0	-300	0.00	0.00	0	0	0
0023	3T	17_8	214	1	0	100	0	-100	0.00	0.00	0	0	0
0023	3T	17_8	216	1	0	100	0	-100	0.00	0.00	0	0	0
0023	3T	17_8	236	1	0	100	0	-100	0.00	0.00	0	0	0
0023	3T	17_8	246	1	0	100	0	-100	0.00	0.00	0	0	0
0023	3T	17_9	123	43	12	4300	6720	2420	0.28	1.56	7	11	4
0023	3T	17_9	124	61	5	6100	2330	-3770	0.08	0.38	10	4	-6
0023	3T	17_9	125	14	4	1400	3710	2310	0.29	2.65	2	6	4
0023	3T	17_9	126	8	0	800	0	-800	0.00	0.00	1	0	-1
0023	3T	17_9	134	50	8	5000	5340	340	0.16	1.07	8	9	1
0023	3T	17_9	135	11	3	1100	3350	2250	0.27	3.05	1	5	4
0023	3T	17_9	136	3	0	300	0	-300	0.00	0.00	0	0	0
0023	3T	17_9	142	1	0	100	0	-100	0.00	0.00	0	0	0
0023	3T	17_9	145	1	0	100	0	-100	0.00	0.00	0	0	0
0023	3T	17_9	146	1	0	100	0	-100	0.00	0.00	0	0	0
0023	3T	18_1	123	32	4	3200	3190	-10	0.13	1.00	5	5	0
0023	3T	18_1	124	101	14	10100	8570	-1530	0.14	0.85	17	15	-2
0023	3T	18_1	125	85	5	8500	3860	-4640	0.06	0.45	15	6	-9
0023	3T	18_1	126	7	0	700	0	-700	0.00	0.00	1	0	-1
0023	3T	18_1	132	4	1	400	960	560	0.25	2.40	0	1	1
0023	3T	18_1	134	15	1	1500	480	-1020	0.07	0.32	2	0	-2
0023	3T	18_1	135	12	0	1200	0	-1200	0.00	0.00	2	0	-2
0023	3T	18_1	136	2	0	200	0	-200	0.00	0.00	0	0	0
0023	3T	18_1	145	1	0	100	0	-100	0.00	0.00	0	0	0
0023	3T	18_1	153	1	0	100	0	-100	0.00	0.00	0	0	0
0023	3T	18_1	154	2	0	200	0	-200	0.00	0.00	0	0	0
0023	3T	18_10	123	15	0	1500	0	-1500	0.00	0.00	2	0	-2
0023	3T	18_10	124	71	5	7100	3290	-3810	0.07	0.46	12	5	-7
0023	3T	18_10	125	27	4	2700	3670	970	0.15	1.36	4	6	2
0023	3T	18_10	126	14	0	1400	0	-1400	0.00	0.00	2	0	-2
0023	3T	18_10	134	13	4	1300	2170	870	0.31	1.67	2	3	1
0023	3T	18_10	135	12	2	1200	1660	460	0.17	1.38	2	2	0
0023	3T	18_10	136	15	1	1500	1080	-420	0.07	0.72	2	1	-1
0023	3T	18_10	145	5	0	500	0	-500	0.00	0.00	0	0	0
0023	3T	18_10	146	2	1	200	570	370	0.50	2.85	0	1	1
0023	3T	18_11	123	23	3	2300	1310	-990	0.13	0.57	4	2	-2
0023	3T	18_11	124	79	6	7900	4080	-3820	0.08	0.52	13	7	-6
0023	3T	18_11	125	27	2	2700	1080	-1620	0.07	0.40	4	1	-3
0023	3T	18_11	126	15	1	1500	1370	-130	0.07	0.91	2	2	0
0023	3T	18_11	134	22	2	2200	860	-1340	0.09	0.39	3	1	-2
0023	3T	18_11	135	37	2	3700	1830	-1870	0.05	0.49	6	3	-3
0023	3T	18_11	136	17	0	1700	0	-1700	0.00	0.00	3	0	-3
0023	3T	18_11	145	7	1	700	970	270	0.14	1.39	1	1	0
0023	3T	18_11	146	10	2	1000	1450	450	0.20	1.45	1	2	1
0023	3T	18_11	154	1	0	100	0	-100	0.00	0.00	0	0	0
0023	3T	18_11	156	1	1	100	1820	1720	1.00	18.20	0	3	3
0023	3T	18_12	123	24	3	2400	1180	-1220	0.13	0.49	4	2	-2
0023	3T	18_12	124	188	25	18800	19700	900	0.13	1.05	33	34	1
0023	3T	18_12	125	13	1	1300	820	-480	0.08	0.63	2	1	-1
0023	3T	18_12	126	28	1	2800	4220	1420	0.04	1.51	4	7	3
0023	3T	18_12	134	16	2	1600	1690	90	0.13	1.06	2	2	0
0023	3T	18_12	135	7	0	700	0	-700	0.00	0.00	1	0	-1
0023	3T	18_12	136	1	1	100	960	860	1.00	9.60	0	1	1
0023	3T	18_12	145	2	0	200	0	-200	0.00	0.00	0	0	0
0023	3T	18_12	146	1	0	100	0	-100	0.00	0.00	0	0	0
0023	3T	18_2	123	23	3	2300	2970	670	0.13	1.29	4	5	1
0023	3T	18_2	124	130	10	13000	8530	-4470	0.08	0.66	23	15	-8
0023	3T	18_2	125	20	2	2000	1630	-370	0.10	0.82	3	2	-1
0023	3T	18_2	126	5	0	500	0	-500	0.00	0.00	0	0	0
0023	3T	18_2	134	46	3	4600	2350	-2250	0.07	0.51	8	4	-4
0023	3T	18_2	135	7	1	700	1750	1050	0.14	2.50	1	3	2
0023	3T	18_2	136	1	0	100	0	-100	0.00	0.00	0	0	0
0023	3T	18_2	145	1	0	100	0	-100	0.00	0.00	0	0	0
0023	3T	18_2	146	1	0	100	0	-100	0.00	0.00	0	0	0
0023	3T	18_2	154	2	0	200	0	-200	0.00	0.00	0	0	0
0023	3T	18_2	164	1	0	100	0	-100	0.00	0.00	0	0	0
0023	3T	18_3	123	36	4	3600	5740	2140	0.11	1.59	6	10	4
0023	3T	18_3	124	54	4	5400	4950	-450	0.07	0.92	9	8	-1
0023	3T	18_3	125	33	5	3300	5110	1810	0.15	1.55	5	9	4
0023	3T	18_3	126	9	1	900	1980	1080	0.11	2.20	1	3	2
0023	3T	18_3	134	45	4	4500	2630	-1870	0.09	0.58	7	4	-3
0023	3T	18_3	135	38	2	3800	1330	-2470	0.05	0.35	6	2	-4
0023	3T	18_3	136	3	0	300	0	-300	0.00	0.00	0	0	0
0023	3T	18_3	143	5	1	500	1820	1320	0.20	3.64	0	3	3
0023	3T	18_3	145	7	1	700	800	100	0.14	1.14	1	1	0
0023	3T	18_3	146	2	0	200	0	-200	0.00	0.00	0	0	0
0023	3T	18_3	153	1	0	100	0	-100	0.00	0.00	0	0	0
0023	3T	18_3	154	3	1	300	1550	1250	0.33	5.17	0	2	2
0023	3T	18_3	163	7	1	700	960	260	0.14	1.37	1	1	0
0023	3T	18_4	123	101	7	10100	3380	-6720	0.07	0.33	17	5	-12
0023	3T	18_4	124	78	9	7800	3790	-4010	0.12	0.49	13	6	-7
0023	3T	18_4	125	80	10	8000	5320	-2680	0.13	0.67	14	9	-5
0023	3T	18_4	126	17	0	1700	0	-1700	0.00	0.00	3	0	-3
0023	3T	18_4	134	2	0	200	0	-200	0.00	0.00	0	0	0
0023	3T	18_4	136	1	0	100	0	-100	0.00	0.00	0	0	0
0023	3T	18_4	145	1	0	100	0	-100	0.00	0.00	0	0	0
0023	3T	18_5	123	30	0	3000	0	-3000	0.00	0.00	5	0	-5
0023	3T	18_5	124	19	1	1900	620	-1280	0.05	0.33	3	1	-2
0023	3T	18_5	125	7	2	700	1230	530	0.29	1.76	1	2	1
0023	3T	18_5	126	14	1	1400	860	-540	0.07	0.61	2	1	-1
0023	3T	18_5	134	10	4	1000	5190	4190	0.40	5.19	1	9	8
0023	3T	18_5	135	22	4	2200	3390	1190	0.18	1.54	3	6	3
0023	3T	18_5	136	8	1	800	1270	470	0.13	1.59	1	2	1
0023	3T	18_5	143	3	0	300	0	-300	0.00	0.00	0	0	0
0023	3T	18_5	145	4	0	400	0	-400	0.00	0.00	0	0	0
0023	3T	18_5	153	3	0	300	0	-300	0.00	0.00	0	0	0
0023	3T	18_5	154	2	0	200	0	-200	0.00	0.00	0	0	0
0023	3T	18_5	163	5	1	500	740	240	0.20	1.48	0	1	1
0023	3T	18_5	214	3	1	300	890	590	0.33	2.97	0	1	1
0023	3T	18_5	215	11	0	1100	0	-1100	0.00	0.00	1	0	-1
0023	3T	18_5	216	11	1	1100	810	-290	0.09	0.74	1	1	0
0023	3T	18_5	235	3	0	300	0	-300	0.00	0.00	0	0	0
0023	3T	18_5	236	6	0	600	0	-600	0.00	0.00	1	0	-1
0023	3T	18_5	245	5	0	500	0	-500	0.00	0.00	0	0	0
0023	3T	18_5	246	5	1	500	6080	5580	0.20	12.16	0	10	10
0023	3T	18_5	254	1	0	100	0	-100	0.00	0.00	0	0	0
0023	3T	18_6	123	16	1	1600	1410	-190	0.06	0.88	2	2	0
0023	3T	18_6	124	20	2	2000	1030	-970	0.10	0.52	3	1	-2
0023	3T	18_6	125	16	0	1600	0	-1600	0.00	0.00	2	0	-2
0023	3T	18_6	126	15	0	1500	0	-1500	0.00	0.00	2	0	-2
0023	3T	18_6	134	6	0	600	0	-600	0.00	0.00	1	0	-1
0023	3T	18_6	135	18	1	1800	1100	-700	0.06	0.61	3	1	-2
0023	3T	18_6	136	20	0	2000	0	-2000	0.00	0.00	3	0	-3
0023	3T	18_6	142	2	0	200	0	-200	0.00	0.00	0	0	0
0023	3T	18_6	143	5	0	500	0	-500	0.00	0.00	0	0	0
0023	3T	18_6	145	5	0	500	0	-500	0.00	0.00	0	0	0
0023	3T	18_6	146	7	1	700	1240	540	0.14	1.77	1	2	1
0023	3T	18_6	153	1	0	100	0	-100	0.00	0.00	0	0	0
0023	3T	18_6	163	6	0	600	0	-600	0.00	0.00	1	0	-1
0023	3T	18_6	215	2	0	200	0	-200	0.00	0.00	0	0	0
0023	3T	18_6	216	7	0	700	0	-700	0.00	0.00	1	0	-1
0023	3T	18_6	234	2	0	200	0	-200	0.00	0.00	0	0	0
0023	3T	18_6	235	3	0	300	0	-300	0.00	0.00	0	0	0
0023	3T	18_6	236	3	0	300	0	-300	0.00	0.00	0	0	0
0023	3T	18_6	246	2	0	200	0	-200	0.00	0.00	0	0	0
0023	3T	18_6	253	1	0	100	0	-100	0.00	0.00	0	0	0
0023	3T	18_7	123	36	1	3600	580	-3020	0.03	0.16	6	1	-5
0023	3T	18_7	124	17	1	1700	1650	-50	0.06	0.97	3	2	-1
0023	3T	18_7	125	43	0	4300	0	-4300	0.00	0.00	7	0	-7
0023	3T	18_7	126	25	1	2500	1530	-970	0.04	0.61	4	2	-2
0023	3T	18_7	134	16	1	1600	680	-920	0.06	0.43	2	1	-1
0023	3T	18_7	135	17	0	1700	0	-1700	0.00	0.00	3	0	-3
0023	3T	18_7	136	16	2	1600	2910	1310	0.13	1.82	2	5	3
0023	3T	18_7	142	1	0	100	0	-100	0.00	0.00	0	0	0
0023	3T	18_7	145	4	0	400	0	-400	0.00	0.00	0	0	0
0023	3T	18_7	146	1	0	100	0	-100	0.00	0.00	0	0	0
0023	3T	18_7	153	1	0	100	0	-100	0.00	0.00	0	0	0
0023	3T	18_7	156	1	0	100	0	-100	0.00	0.00	0	0	0
0023	3T	18_7	213	2	0	200	0	-200	0.00	0.00	0	0	0
0023	3T	18_7	215	2	0	200	0	-200	0.00	0.00	0	0	0
0023	3T	18_7	216	8	0	800	0	-800	0.00	0.00	1	0	-1
0023	3T	18_7	234	2	0	200	0	-200	0.00	0.00	0	0	0
0023	3T	18_7	235	2	0	200	0	-200	0.00	0.00	0	0	0
0023	3T	18_7	236	2	0	200	0	-200	0.00	0.00	0	0	0
0023	3T	18_8	123	6	0	600	0	-600	0.00	0.00	1	0	-1
0023	3T	18_8	124	21	4	2100	2680	580	0.19	1.28	3	4	1
0023	3T	18_8	125	28	1	2800	2740	-60	0.04	0.98	4	4	0
0023	3T	18_8	126	22	0	2200	0	-2200	0.00	0.00	3	0	-3
0023	3T	18_8	134	11	2	1100	1390	290	0.18	1.26	1	2	1
0023	3T	18_8	135	30	3	3000	3710	710	0.10	1.24	5	6	1
0023	3T	18_8	136	17	2	1700	1230	-470	0.12	0.72	3	2	-1
0023	3T	18_8	142	1	1	100	850	750	1.00	8.50	0	1	1
0023	3T	18_8	145	7	1	700	630	-70	0.14	0.90	1	1	0
0023	3T	18_8	146	3	0	300	0	-300	0.00	0.00	0	0	0
0023	3T	18_8	164	1	1	100	1250	1150	1.00	12.50	0	2	2
0023	3T	18_8	214	2	0	200	0	-200	0.00	0.00	0	0	0
0023	3T	18_8	235	1	1	100	1210	1110	1.00	12.10	0	2	2
0023	3T	18_8	236	1	0	100	0	-100	0.00	0.00	0	0	0
0023	3T	18_9	123	8	3	800	3140	2340	0.38	3.93	1	5	4
0023	3T	18_9	124	20	3	2000	1820	-180	0.15	0.91	3	3	0
0023	3T	18_9	125	32	3	3200	4320	1120	0.09	1.35	5	7	2
0023	3T	18_9	126	25	2	2500	1250	-1250	0.08	0.50	4	2	-2
0023	3T	18_9	134	19	2	1900	1810	-90	0.11	0.95	3	3	0
0023	3T	18_9	135	33	1	3300	520	-2780	0.03	0.16	5	0	-5
0023	3T	18_9	136	22	1	2200	1140	-1060	0.05	0.52	3	2	-1
0023	3T	18_9	145	6	0	600	0	-600	0.00	0.00	1	0	-1
0023	3T	18_9	146	7	2	700	1160	460	0.29	1.66	1	2	1
0023	3T	18_9	214	1	0	100	0	-100	0.00	0.00	0	0	0
0023	3T	18_9	216	2	0	200	0	-200	0.00	0.00	0	0	0
0023	3T	18_9	236	2	0	200	0	-200	0.00	0.00	0	0	0
0023	3T	18_9	245	3	0	300	0	-300	0.00	0.00	0	0	0
0023	3T	18_9	246	1	0	100	0	-100	0.00	0.00	0	0	0
0023	3T	19_1	123	20	2	2000	1740	-260	0.10	0.87	3	3	0
0023	3T	19_1	124	35	2	3500	1770	-1730	0.06	0.51	6	3	-3
0023	3T	19_1	125	29	2	2900	1270	-1630	0.07	0.44	5	2	-3
0023	3T	19_1	126	15	0	1500	0	-1500	0.00	0.00	2	0	-2
0023	3T	19_1	132	2	0	200	0	-200	0.00	0.00	0	0	0
0023	3T	19_1	134	9	1	900	520	-380	0.11	0.58	1	0	-1
0023	3T	19_1	135	6	0	600	0	-600	0.00	0.00	1	0	-1
0023	3T	19_1	136	2	0	200	0	-200	0.00	0.00	0	0	0
0023	3T	19_1	142	1	0	100	0	-100	0.00	0.00	0	0	0
0023	3T	19_1	145	3	0	300	0	-300	0.00	0.00	0	0	0
0023	3T	19_1	156	1	0	100	0	-100	0.00	0.00	0	0	0
0023	3T	19_1	163	1	0	100	0	-100	0.00	0.00	0	0	0
0023	3T	19_10	123	30	3	3000	2910	-90	0.10	0.97	5	5	0
0023	3T	19_10	124	95	6	9500	5500	-4000	0.06	0.58	16	9	-7
0023	3T	19_10	125	29	2	2900	1920	-980	0.07	0.66	5	3	-2
0023	3T	19_10	126	9	0	900	0	-900	0.00	0.00	1	0	-1
0023	3T	19_10	134	31	2	3100	1780	-1320	0.06	0.57	5	3	-2
0023	3T	19_10	135	12	1	1200	700	-500	0.08	0.58	2	1	-1
0023	3T	19_10	136	5	0	500	0	-500	0.00	0.00	0	0	0
0023	3T	19_10	145	1	0	100	0	-100	0.00	0.00	0	0	0
0023	3T	19_10	146	1	0	100	0	-100	0.00	0.00	0	0	0
0023	3T	19_11	123	31	4	3100	3500	400	0.13	1.13	5	6	1
0023	3T	19_11	124	119	13	11900	10140	-1760	0.11	0.85	21	17	-4
0023	3T	19_11	125	23	0	2300	0	-2300	0.00	0.00	4	0	-4
0023	3T	19_11	126	8	0	800	0	-800	0.00	0.00	1	0	-1
0023	3T	19_11	134	26	0	2600	0	-2600	0.00	0.00	4	0	-4
0023	3T	19_11	135	19	2	1900	1100	-800	0.11	0.58	3	1	-2
0023	3T	19_11	136	3	0	300	0	-300	0.00	0.00	0	0	0
0023	3T	19_11	145	2	0	200	0	-200	0.00	0.00	0	0	0
0023	3T	19_12	123	35	7	3500	5770	2270	0.20	1.65	6	10	4
0023	3T	19_12	124	152	8	15200	8600	-6600	0.05	0.57	26	15	-11
0023	3T	19_12	125	14	1	1400	1270	-130	0.07	0.91	2	2	0
0023	3T	19_12	126	6	0	600	0	-600	0.00	0.00	1	0	-1
0023	3T	19_12	134	9	0	900	0	-900	0.00	0.00	1	0	-1
0023	3T	19_12	135	7	1	700	490	-210	0.14	0.70	1	0	-1
0023	3T	19_12	136	2	0	200	0	-200	0.00	0.00	0	0	0
0023	3T	19_12	146	2	0	200	0	-200	0.00	0.00	0	0	0
0023	3T	19_2	123	8	0	800	0	-800	0.00	0.00	1	0	-1
0023	3T	19_2	124	22	2	2200	2120	-80	0.09	0.96	3	3	0
0023	3T	19_2	125	14	0	1400	0	-1400	0.00	0.00	2	0	-2
0023	3T	19_2	126	11	0	1100	0	-1100	0.00	0.00	1	0	-1
0023	3T	19_2	132	1	0	100	0	-100	0.00	0.00	0	0	0
0023	3T	19_2	134	15	0	1500	0	-1500	0.00	0.00	2	0	-2
0023	3T	19_2	135	7	0	700	0	-700	0.00	0.00	1	0	-1
0023	3T	19_2	136	5	0	500	0	-500	0.00	0.00	0	0	0
0023	3T	19_2	142	1	0	100	0	-100	0.00	0.00	0	0	0
0023	3T	19_2	143	1	0	100	0	-100	0.00	0.00	0	0	0
0023	3T	19_2	145	3	0	300	0	-300	0.00	0.00	0	0	0
0023	3T	19_2	146	3	0	300	0	-300	0.00	0.00	0	0	0
0023	3T	19_2	154	1	0	100	0	-100	0.00	0.00	0	0	0
0023	3T	19_2	235	2	0	200	0	-200	0.00	0.00	0	0	0
0023	3T	19_3	123	12	0	1200	0	-1200	0.00	0.00	2	0	-2
0023	3T	19_3	124	8	0	800	0	-800	0.00	0.00	1	0	-1
0023	3T	19_3	125	16	0	1600	0	-1600	0.00	0.00	2	0	-2
0023	3T	19_3	126	20	1	2000	3120	1120	0.05	1.56	3	5	2
0023	3T	19_3	134	6	1	600	800	200	0.17	1.33	1	1	0
0023	3T	19_3	135	8	0	800	0	-800	0.00	0.00	1	0	-1
0023	3T	19_3	136	20	0	2000	0	-2000	0.00	0.00	3	0	-3
0023	3T	19_3	145	2	0	200	0	-200	0.00	0.00	0	0	0
0023	3T	19_3	146	5	0	500	0	-500	0.00	0.00	0	0	0
0023	3T	19_3	156	2	0	200	0	-200	0.00	0.00	0	0	0
0023	3T	19_3	235	2	0	200	0	-200	0.00	0.00	0	0	0
0023	3T	19_3	236	2	0	200	0	-200	0.00	0.00	0	0	0
0023	3T	19_3	246	3	0	300	0	-300	0.00	0.00	0	0	0
0023	3T	19_4	123	8	1	800	550	-250	0.13	0.69	1	0	-1
0023	3T	19_4	124	9	0	900	0	-900	0.00	0.00	1	0	-1
0023	3T	19_4	125	11	1	1100	830	-270	0.09	0.75	1	1	0
0023	3T	19_4	126	27	0	2700	0	-2700	0.00	0.00	4	0	-4
0023	3T	19_4	134	8	1	800	790	-10	0.13	0.99	1	1	0
0023	3T	19_4	135	9	0	900	0	-900	0.00	0.00	1	0	-1
0023	3T	19_4	136	25	2	2500	2520	20	0.08	1.01	4	4	0
0023	3T	19_4	146	3	1	300	880	580	0.33	2.93	0	1	1
0023	3T	19_4	156	1	0	100	0	-100	0.00	0.00	0	0	0
0023	3T	19_4	215	2	0	200	0	-200	0.00	0.00	0	0	0
0023	3T	19_4	216	3	0	300	0	-300	0.00	0.00	0	0	0
0023	3T	19_4	234	1	0	100	0	-100	0.00	0.00	0	0	0
0023	3T	19_4	235	2	0	200	0	-200	0.00	0.00	0	0	0
0023	3T	19_4	236	2	0	200	0	-200	0.00	0.00	0	0	0
0023	3T	19_4	246	2	0	200	0	-200	0.00	0.00	0	0	0
0023	3T	19_5	123	5	1	500	550	50	0.20	1.10	0	0	0
0023	3T	19_5	124	56	9	5600	4800	-800	0.16	0.86	9	8	-1
0023	3T	19_5	125	4	0	400	0	-400	0.00	0.00	0	0	0
0023	3T	19_5	126	1	0	100	0	-100	0.00	0.00	0	0	0
0023	3T	19_5	134	15	5	1500	4220	2720	0.33	2.81	2	7	5
0023	3T	19_5	135	2	0	200	0	-200	0.00	0.00	0	0	0
0023	3T	19_5	136	3	0	300	0	-300	0.00	0.00	0	0	0
0023	3T	19_5	145	7	1	700	760	60	0.14	1.09	1	1	0
0023	3T	19_6	123	4	0	400	0	-400	0.00	0.00	0	0	0
0023	3T	19_6	124	18	1	1800	510	-1290	0.06	0.28	3	0	-3
0023	3T	19_6	125	9	0	900	0	-900	0.00	0.00	1	0	-1
0023	3T	19_6	126	20	0	2000	0	-2000	0.00	0.00	3	0	-3
0023	3T	19_6	134	11	1	1100	440	-660	0.09	0.40	1	0	-1
0023	3T	19_6	135	10	3	1000	2150	1150	0.30	2.15	1	3	2
0023	3T	19_6	136	16	2	1600	1530	-70	0.13	0.96	2	2	0
0023	3T	19_6	142	2	0	200	0	-200	0.00	0.00	0	0	0
0023	3T	19_6	145	2	1	200	2220	2020	0.50	11.10	0	3	3
0023	3T	19_6	146	3	0	300	0	-300	0.00	0.00	0	0	0
0023	3T	19_6	156	1	0	100	0	-100	0.00	0.00	0	0	0
0023	3T	19_6	214	2	0	200	0	-200	0.00	0.00	0	0	0
0023	3T	19_6	216	3	1	300	2670	2370	0.33	8.90	0	4	4
0023	3T	19_6	234	1	0	100	0	-100	0.00	0.00	0	0	0
0023	3T	19_6	235	1	0	100	0	-100	0.00	0.00	0	0	0
0023	3T	19_6	236	5	0	500	0	-500	0.00	0.00	0	0	0
0023	3T	19_6	245	1	0	100	0	-100	0.00	0.00	0	0	0
0023	3T	19_6	246	2	0	200	0	-200	0.00	0.00	0	0	0
0023	3T	19_7	123	9	0	900	0	-900	0.00	0.00	1	0	-1
0023	3T	19_7	124	44	4	4400	2040	-2360	0.09	0.46	7	3	-4
0023	3T	19_7	125	9	0	900	0	-900	0.00	0.00	1	0	-1
0023	3T	19_7	126	1	0	100	0	-100	0.00	0.00	0	0	0
0023	3T	19_7	134	46	8	4600	4900	300	0.17	1.07	8	8	0
0023	3T	19_7	135	22	4	2200	4370	2170	0.18	1.99	3	7	4
0023	3T	19_7	136	23	6	2300	6330	4030	0.26	2.75	4	11	7
0023	3T	19_7	142	1	0	100	0	-100	0.00	0.00	0	0	0
0023	3T	19_7	145	18	2	1800	1940	140	0.11	1.08	3	3	0
0023	3T	19_7	146	3	0	300	0	-300	0.00	0.00	0	0	0
0023	3T	19_7	156	1	0	100	0	-100	0.00	0.00	0	0	0
0023	3T	19_7	164	1	0	100	0	-100	0.00	0.00	0	0	0
0023	3T	19_8	123	12	1	1200	380	-820	0.08	0.32	2	0	-2
0023	3T	19_8	124	50	6	5000	5020	20	0.12	1.00	8	8	0
0023	3T	19_8	125	6	0	600	0	-600	0.00	0.00	1	0	-1
0023	3T	19_8	126	12	1	1200	3650	2450	0.08	3.04	2	6	4
0023	3T	19_8	134	23	2	2300	1080	-1220	0.09	0.47	4	1	-3
0023	3T	19_8	135	21	1	2100	650	-1450	0.05	0.31	3	1	-2
0023	3T	19_8	136	33	3	3300	2220	-1080	0.09	0.67	5	3	-2
0023	3T	19_8	145	5	0	500	0	-500	0.00	0.00	0	0	0
0023	3T	19_8	146	5	0	500	0	-500	0.00	0.00	0	0	0
0023	3T	19_9	123	29	1	2900	430	-2470	0.03	0.15	5	0	-5
0023	3T	19_9	124	70	10	7000	5830	-1170	0.14	0.83	12	10	-2
0023	3T	19_9	125	13	1	1300	560	-740	0.08	0.43	2	0	-2
0023	3T	19_9	126	9	2	900	1720	820	0.22	1.91	1	3	2
0023	3T	19_9	134	20	3	2000	2220	220	0.15	1.11	3	3	0
0023	3T	19_9	135	20	2	2000	1000	-1000	0.10	0.50	3	1	-2
0023	3T	19_9	136	10	1	1000	690	-310	0.10	0.69	1	1	0
0023	3T	19_9	145	4	0	400	0	-400	0.00	0.00	0	0	0
0023	3T	19_9	146	2	0	200	0	-200	0.00	0.00	0	0	0
0023	3T	19_9	216	1	0	100	0	-100	0.00	0.00	0	0	0
0023	3T	20_1	123	55	2	5500	1540	-3960	0.04	0.28	9	2	-7
0023	3T	20_1	124	40	3	4000	2730	-1270	0.08	0.68	7	4	-3
0023	3T	20_1	125	16	0	1600	0	-1600	0.00	0.00	2	0	-2
0023	3T	20_1	126	16	2	1600	2330	730	0.13	1.46	2	4	2
0023	3T	20_1	132	1	0	100	0	-100	0.00	0.00	0	0	0
0023	3T	20_1	134	7	1	700	2200	1500	0.14	3.14	1	3	2
0023	3T	20_1	135	4	0	400	0	-400	0.00	0.00	0	0	0
0023	3T	20_1	136	8	1	800	2430	1630	0.13	3.04	1	4	3
0023	3T	20_1	142	2	0	200	0	-200	0.00	0.00	0	0	0
0023	3T	20_1	143	2	0	200	0	-200	0.00	0.00	0	0	0
0023	3T	20_1	146	5	0	500	0	-500	0.00	0.00	0	0	0
0023	3T	20_1	153	3	0	300	0	-300	0.00	0.00	0	0	0
0023	3T	20_1	156	2	0	200	0	-200	0.00	0.00	0	0	0
0023	3T	20_10	123	19	2	1900	1110	-790	0.11	0.58	3	1	-2
0023	3T	20_10	124	77	10	7700	7900	200	0.13	1.03	13	13	0
0023	3T	20_10	125	40	1	4000	960	-3040	0.03	0.24	7	1	-6
0023	3T	20_10	126	20	0	2000	0	-2000	0.00	0.00	3	0	-3
0023	3T	20_10	134	31	2	3100	1600	-1500	0.06	0.52	5	2	-3
0023	3T	20_10	135	20	1	2000	830	-1170	0.05	0.42	3	1	-2
0023	3T	20_10	136	11	1	1100	1160	60	0.09	1.05	1	2	1
0023	3T	20_10	145	2	0	200	0	-200	0.00	0.00	0	0	0
0023	3T	20_10	146	2	0	200	0	-200	0.00	0.00	0	0	0
0023	3T	20_10	154	1	0	100	0	-100	0.00	0.00	0	0	0
0023	3T	20_11	123	33	9	3300	5590	2290	0.27	1.69	5	9	4
0023	3T	20_11	124	95	6	9500	5050	-4450	0.06	0.53	16	8	-8
0023	3T	20_11	125	33	1	3300	510	-2790	0.03	0.15	5	0	-5
0023	3T	20_11	126	19	2	1900	1410	-490	0.11	0.74	3	2	-1
0023	3T	20_11	134	27	2	2700	1960	-740	0.07	0.73	4	3	-1
0023	3T	20_11	135	20	7	2000	5790	3790	0.35	2.90	3	10	7
0023	3T	20_11	136	9	0	900	0	-900	0.00	0.00	1	0	-1
0023	3T	20_11	145	1	0	100	0	-100	0.00	0.00	0	0	0
0023	3T	20_11	146	1	0	100	0	-100	0.00	0.00	0	0	0
0023	3T	20_11	154	1	1	100	980	880	1.00	9.80	0	1	1
0023	3T	20_12	123	46	6	4600	4840	240	0.13	1.05	8	8	0
0023	3T	20_12	124	126	8	12600	6590	-6010	0.06	0.52	22	11	-11
0023	3T	20_12	125	22	2	2200	2090	-110	0.09	0.95	3	3	0
0023	3T	20_12	126	10	0	1000	0	-1000	0.00	0.00	1	0	-1
0023	3T	20_12	134	15	4	1500	2390	890	0.27	1.59	2	4	2
0023	3T	20_12	135	10	0	1000	0	-1000	0.00	0.00	1	0	-1
0023	3T	20_12	136	5	1	500	1530	1030	0.20	3.06	0	2	2
0023	3T	20_12	145	1	0	100	0	-100	0.00	0.00	0	0	0
0023	3T	20_12	146	1	0	100	0	-100	0.00	0.00	0	0	0
0023	3T	20_12	156	1	0	100	0	-100	0.00	0.00	0	0	0
0023	3T	20_2	123	15	1	1500	880	-620	0.07	0.59	2	1	-1
0023	3T	20_2	124	26	3	2600	3640	1040	0.12	1.40	4	6	2
0023	3T	20_2	125	20	3	2000	3580	1580	0.15	1.79	3	6	3
0023	3T	20_2	126	17	0	1700	0	-1700	0.00	0.00	3	0	-3
0023	3T	20_2	134	13	2	1300	1390	90	0.15	1.07	2	2	0
0023	3T	20_2	135	7	0	700	0	-700	0.00	0.00	1	0	-1
0023	3T	20_2	136	5	0	500	0	-500	0.00	0.00	0	0	0
0023	3T	20_2	145	6	0	600	0	-600	0.00	0.00	1	0	-1
0023	3T	20_2	146	1	0	100	0	-100	0.00	0.00	0	0	0
0023	3T	20_2	156	2	1	200	1320	1120	0.50	6.60	0	2	2
0023	3T	20_2	165	1	0	100	0	-100	0.00	0.00	0	0	0
0023	3T	20_2	235	1	0	100	0	-100	0.00	0.00	0	0	0
0023	3T	20_2	236	2	0	200	0	-200	0.00	0.00	0	0	0
0023	3T	20_2	246	1	0	100	0	-100	0.00	0.00	0	0	0
0023	3T	20_3	123	6	0	600	0	-600	0.00	0.00	1	0	-1
0023	3T	20_3	124	18	3	1800	3820	2020	0.17	2.12	3	6	3
0023	3T	20_3	125	17	1	1700	1430	-270	0.06	0.84	3	2	-1
0023	3T	20_3	126	26	2	2600	5830	3230	0.08	2.24	4	10	6
0023	3T	20_3	134	8	1	800	1000	200	0.13	1.25	1	1	0
0023	3T	20_3	135	11	0	1100	0	-1100	0.00	0.00	1	0	-1
0023	3T	20_3	136	6	0	600	0	-600	0.00	0.00	1	0	-1
0023	3T	20_3	145	6	2	600	4020	3420	0.33	6.70	1	7	6
0023	3T	20_3	146	4	0	400	0	-400	0.00	0.00	0	0	0
0023	3T	20_3	156	3	0	300	0	-300	0.00	0.00	0	0	0
0023	3T	20_3	163	1	0	100	0	-100	0.00	0.00	0	0	0
0023	3T	20_3	214	1	0	100	0	-100	0.00	0.00	0	0	0
0023	3T	20_3	216	1	0	100	0	-100	0.00	0.00	0	0	0
0023	3T	20_3	234	2	0	200	0	-200	0.00	0.00	0	0	0
0023	3T	20_3	246	1	0	100	0	-100	0.00	0.00	0	0	0
0023	3T	20_4	123	4	0	400	0	-400	0.00	0.00	0	0	0
0023	3T	20_4	124	18	0	1800	0	-1800	0.00	0.00	3	0	-3
0023	3T	20_4	125	14	1	1400	800	-600	0.07	0.57	2	1	-1
0023	3T	20_4	126	17	1	1700	3110	1410	0.06	1.83	3	5	2
0023	3T	20_4	134	11	0	1100	0	-1100	0.00	0.00	1	0	-1
0023	3T	20_4	135	13	0	1300	0	-1300	0.00	0.00	2	0	-2
0023	3T	20_4	136	19	0	1900	0	-1900	0.00	0.00	3	0	-3
0023	3T	20_4	145	3	0	300	0	-300	0.00	0.00	0	0	0
0023	3T	20_4	146	10	0	1000	0	-1000	0.00	0.00	1	0	-1
0023	3T	20_4	154	1	0	100	0	-100	0.00	0.00	0	0	0
0023	3T	20_4	156	4	0	400	0	-400	0.00	0.00	0	0	0
0023	3T	20_4	215	2	0	200	0	-200	0.00	0.00	0	0	0
0023	3T	20_4	216	2	0	200	0	-200	0.00	0.00	0	0	0
0023	3T	20_4	234	1	0	100	0	-100	0.00	0.00	0	0	0
0023	3T	20_4	236	1	0	100	0	-100	0.00	0.00	0	0	0
0023	3T	20_4	245	4	0	400	0	-400	0.00	0.00	0	0	0
0023	3T	20_5	123	9	1	900	660	-240	0.11	0.73	1	1	0
0023	3T	20_5	124	201	22	20100	11180	-8920	0.11	0.56	35	19	-16
0023	3T	20_5	125	14	0	1400	0	-1400	0.00	0.00	2	0	-2
0023	3T	20_5	126	4	0	400	0	-400	0.00	0.00	0	0	0
0023	3T	20_5	135	1	0	100	0	-100	0.00	0.00	0	0	0
0023	3T	20_5	145	1	0	100	0	-100	0.00	0.00	0	0	0
0023	3T	20_6	123	5	0	500	0	-500	0.00	0.00	0	0	0
0023	3T	20_6	124	25	4	2500	5830	3330	0.16	2.33	4	10	6
0023	3T	20_6	125	37	4	3700	2790	-910	0.11	0.75	6	4	-2
0023	3T	20_6	126	14	0	1400	0	-1400	0.00	0.00	2	0	-2
0023	3T	20_6	134	25	4	2500	3240	740	0.16	1.30	4	5	1
0023	3T	20_6	135	42	3	4200	2110	-2090	0.07	0.50	7	3	-4
0023	3T	20_6	136	10	1	1000	750	-250	0.10	0.75	1	1	0
0023	3T	20_6	142	1	0	100	0	-100	0.00	0.00	0	0	0
0023	3T	20_6	145	19	1	1900	650	-1250	0.05	0.34	3	1	-2
0023	3T	20_6	146	8	1	800	730	-70	0.13	0.91	1	1	0
0023	3T	20_6	156	3	0	300	0	-300	0.00	0.00	0	0	0
0023	3T	20_6	164	1	0	100	0	-100	0.00	0.00	0	0	0
0023	3T	20_6	165	2	0	200	0	-200	0.00	0.00	0	0	0
0023	3T	20_7	123	5	0	500	0	-500	0.00	0.00	0	0	0
0023	3T	20_7	124	36	5	3600	4640	1040	0.14	1.29	6	8	2
0023	3T	20_7	125	40	1	4000	1240	-2760	0.03	0.31	7	2	-5
0023	3T	20_7	126	23	2	2300	1980	-320	0.09	0.86	4	3	-1
0023	3T	20_7	134	24	5	2400	3550	1150	0.21	1.48	4	6	2
0023	3T	20_7	135	33	5	3300	5750	2450	0.15	1.74	5	10	5
0023	3T	20_7	136	7	1	700	790	90	0.14	1.13	1	1	0
0023	3T	20_7	142	2	0	200	0	-200	0.00	0.00	0	0	0
0023	3T	20_7	145	24	1	2400	640	-1760	0.04	0.27	4	1	-3
0023	3T	20_7	146	18	3	1800	2500	700	0.17	1.39	3	4	1
0023	3T	20_7	154	2	0	200	0	-200	0.00	0.00	0	0	0
0023	3T	20_7	156	2	0	200	0	-200	0.00	0.00	0	0	0
0023	3T	20_8	123	95	19	9500	9730	230	0.20	1.02	16	17	1
0023	3T	20_8	124	52	7	5200	6230	1030	0.13	1.20	9	11	2
0023	3T	20_8	125	10	2	1000	2010	1010	0.20	2.01	1	3	2
0023	3T	20_8	126	5	0	500	0	-500	0.00	0.00	0	0	0
0023	3T	20_8	132	1	1	100	1370	1270	1.00	13.70	0	2	2
0023	3T	20_8	134	28	4	2800	2890	90	0.14	1.03	4	5	1
0023	3T	20_8	135	7	2	700	2820	2120	0.29	4.03	1	4	3
0023	3T	20_8	136	1	0	100	0	-100	0.00	0.00	0	0	0
0023	3T	20_8	164	1	0	100	0	-100	0.00	0.00	0	0	0
0023	3T	20_8	214	1	0	100	0	-100	0.00	0.00	0	0	0
0023	3T	20_9	123	19	3	1900	2460	560	0.16	1.29	3	4	1
0023	3T	20_9	124	45	2	4500	1310	-3190	0.04	0.29	7	2	-5
0023	3T	20_9	125	24	3	2400	8900	6500	0.13	3.71	4	15	11
0023	3T	20_9	126	15	1	1500	1820	320	0.07	1.21	2	3	1
0023	3T	20_9	134	30	1	3000	640	-2360	0.03	0.21	5	1	-4
0023	3T	20_9	135	32	6	3200	5450	2250	0.19	1.70	5	9	4
0023	3T	20_9	136	15	1	1500	790	-710	0.07	0.53	2	1	-1
0023	3T	20_9	142	2	0	200	0	-200	0.00	0.00	0	0	0
0023	3T	20_9	145	10	0	1000	0	-1000	0.00	0.00	1	0	-1
0023	3T	20_9	146	5	1	500	730	230	0.20	1.46	0	1	1
0023	3T	20_9	164	1	0	100	0	-100	0.00	0.00	0	0	0
0023	3T	20_9	165	1	0	100	0	-100	0.00	0.00	0	0	0
0023	3T	21_1	123	35	7	3500	4640	1140	0.20	1.33	6	8	2
0023	3T	21_1	124	70	11	7000	9000	2000	0.16	1.29	12	15	3
0023	3T	21_1	125	26	4	2600	3150	550	0.15	1.21	4	5	1
0023	3T	21_1	126	13	0	1300	0	-1300	0.00	0.00	2	0	-2
0023	3T	21_1	134	36	6	3600	3320	-280	0.17	0.92	6	5	-1
0023	3T	21_1	135	10	1	1000	500	-500	0.10	0.50	1	0	-1
0023	3T	21_1	136	5	1	500	380	-120	0.20	0.76	0	0	0
0023	3T	21_1	145	1	0	100	0	-100	0.00	0.00	0	0	0
0023	3T	21_1	152	1	0	100	0	-100	0.00	0.00	0	0	0
0023	3T	21_1	153	1	0	100	0	-100	0.00	0.00	0	0	0
0023	3T	21_1	156	2	0	200	0	-200	0.00	0.00	0	0	0
0023	3T	21_10	123	22	4	2200	3560	1360	0.18	1.62	3	6	3
0023	3T	21_10	124	89	5	8900	3390	-5510	0.06	0.38	15	6	-9
0023	3T	21_10	125	20	1	2000	1450	-550	0.05	0.73	3	2	-1
0023	3T	21_10	126	24	1	2400	1170	-1230	0.04	0.49	4	2	-2
0023	3T	21_10	134	27	2	2700	1390	-1310	0.07	0.51	4	2	-2
0023	3T	21_10	135	26	5	2600	4310	1710	0.19	1.66	4	7	3
0023	3T	21_10	136	9	2	900	2780	1880	0.22	3.09	1	4	3
0023	3T	21_10	145	1	0	100	0	-100	0.00	0.00	0	0	0
0023	3T	21_10	146	6	1	600	1170	570	0.17	1.95	1	2	1
0023	3T	21_10	154	1	0	100	0	-100	0.00	0.00	0	0	0
0023	3T	21_11	123	23	2	2300	1180	-1120	0.09	0.51	4	2	-2
0023	3T	21_11	124	126	10	12600	5550	-7050	0.08	0.44	22	9	-13
0023	3T	21_11	125	29	3	2900	2890	-10	0.10	1.00	5	5	0
0023	3T	21_11	126	13	0	1300	0	-1300	0.00	0.00	2	0	-2
0023	3T	21_11	134	30	1	3000	640	-2360	0.03	0.21	5	1	-4
0023	3T	21_11	135	12	1	1200	960	-240	0.08	0.80	2	1	-1
0023	3T	21_11	136	11	0	1100	0	-1100	0.00	0.00	1	0	-1
0023	3T	21_11	145	2	0	200	0	-200	0.00	0.00	0	0	0
0023	3T	21_11	146	2	0	200	0	-200	0.00	0.00	0	0	0
0023	3T	21_11	234	1	0	100	0	-100	0.00	0.00	0	0	0
0023	3T	21_12	123	18	2	1800	1300	-500	0.11	0.72	3	2	-1
0023	3T	21_12	124	192	15	19200	14380	-4820	0.08	0.75	33	25	-8
0023	3T	21_12	125	11	2	1100	2000	900	0.18	1.82	1	3	2
0023	3T	21_12	126	5	2	500	3430	2930	0.40	6.86	0	6	6
0023	3T	21_12	134	19	3	1900	2490	590	0.16	1.31	3	4	1
0023	3T	21_12	135	7	0	700	0	-700	0.00	0.00	1	0	-1
0023	3T	21_12	136	6	0	600	0	-600	0.00	0.00	1	0	-1
0023	3T	21_12	145	1	0	100	0	-100	0.00	0.00	0	0	0
0023	3T	21_2	123	1	0	100	0	-100	0.00	0.00	0	0	0
0023	3T	21_2	124	53	3	5300	1700	-3600	0.06	0.32	9	3	-6
0023	3T	21_2	125	6	0	600	0	-600	0.00	0.00	1	0	-1
0023	3T	21_2	126	3	0	300	0	-300	0.00	0.00	0	0	0
0023	3T	21_2	134	21	4	2100	4760	2660	0.19	2.27	3	8	5
0023	3T	21_2	136	2	0	200	0	-200	0.00	0.00	0	0	0
0023	3T	21_2	142	6	0	600	0	-600	0.00	0.00	1	0	-1
0023	3T	21_2	145	6	0	600	0	-600	0.00	0.00	1	0	-1
0023	3T	21_2	146	11	0	1100	0	-1100	0.00	0.00	1	0	-1
0023	3T	21_2	163	1	0	100	0	-100	0.00	0.00	0	0	0
0023	3T	21_3	124	3	1	300	1280	980	0.33	4.27	0	2	2
0023	3T	21_3	125	17	1	1700	1500	-200	0.06	0.88	3	2	-1
0023	3T	21_3	134	18	0	1800	0	-1800	0.00	0.00	3	0	-3
0023	3T	21_3	135	163	25	16300	14250	-2050	0.15	0.87	28	25	-3
0023	3T	21_3	136	2	0	200	0	-200	0.00	0.00	0	0	0
0023	3T	21_3	153	10	0	1000	0	-1000	0.00	0.00	1	0	-1
0023	3T	21_4	123	19	1	1900	900	-1000	0.05	0.47	3	1	-2
0023	3T	21_4	124	103	15	10300	8880	-1420	0.15	0.86	18	15	-3
0023	3T	21_4	125	20	1	2000	480	-1520	0.05	0.24	3	0	-3
0023	3T	21_4	134	65	9	6500	5010	-1490	0.14	0.77	11	8	-3
0023	3T	21_4	135	35	8	3500	5410	1910	0.23	1.55	6	9	3
0023	3T	21_4	136	2	0	200	0	-200	0.00	0.00	0	0	0
0023	3T	21_4	145	4	0	400	0	-400	0.00	0.00	0	0	0
0023	3T	21_4	156	1	0	100	0	-100	0.00	0.00	0	0	0
0023	3T	21_5	123	41	6	4100	5020	920	0.15	1.22	7	8	1
0023	3T	21_5	124	65	2	6500	1360	-5140	0.03	0.21	11	2	-9
0023	3T	21_5	125	79	13	7900	7460	-440	0.16	0.94	13	13	0
0023	3T	21_5	126	31	2	3100	1610	-1490	0.06	0.52	5	2	-3
0023	3T	21_5	134	1	0	100	0	-100	0.00	0.00	0	0	0
0023	3T	21_5	135	2	0	200	0	-200	0.00	0.00	0	0	0
0023	3T	21_5	163	1	0	100	0	-100	0.00	0.00	0	0	0
0023	3T	21_5	214	1	0	100	0	-100	0.00	0.00	0	0	0
0023	3T	21_5	216	3	0	300	0	-300	0.00	0.00	0	0	0
0023	3T	21_5	235	1	0	100	0	-100	0.00	0.00	0	0	0
0023	3T	21_6	123	11	1	1100	550	-550	0.09	0.50	1	0	-1
0023	3T	21_6	124	43	2	4300	2040	-2260	0.05	0.47	7	3	-4
0023	3T	21_6	125	18	1	1800	990	-810	0.06	0.55	3	1	-2
0023	3T	21_6	126	21	2	2100	2900	800	0.10	1.38	3	5	2
0023	3T	21_6	134	13	0	1300	0	-1300	0.00	0.00	2	0	-2
0023	3T	21_6	135	4	2	400	2270	1870	0.50	5.68	0	4	4
0023	3T	21_6	136	12	0	1200	0	-1200	0.00	0.00	2	0	-2
0023	3T	21_6	145	1	0	100	0	-100	0.00	0.00	0	0	0
0023	3T	21_6	146	1	0	100	0	-100	0.00	0.00	0	0	0
0023	3T	21_6	153	1	0	100	0	-100	0.00	0.00	0	0	0
0023	3T	21_6	154	1	0	100	0	-100	0.00	0.00	0	0	0
0023	3T	21_6	164	1	0	100	0	-100	0.00	0.00	0	0	0
0023	3T	21_6	213	1	0	100	0	-100	0.00	0.00	0	0	0
0023	3T	21_6	214	3	0	300	0	-300	0.00	0.00	0	0	0
0023	3T	21_6	215	4	0	400	0	-400	0.00	0.00	0	0	0
0023	3T	21_6	216	5	0	500	0	-500	0.00	0.00	0	0	0
0023	3T	21_6	234	1	0	100	0	-100	0.00	0.00	0	0	0
0023	3T	21_6	236	1	0	100	0	-100	0.00	0.00	0	0	0
0023	3T	21_6	246	5	0	500	0	-500	0.00	0.00	0	0	0
0023	3T	21_7	123	40	5	4000	3960	-40	0.13	0.99	7	7	0
0023	3T	21_7	124	56	6	5600	3570	-2030	0.11	0.64	9	6	-3
0023	3T	21_7	125	31	2	3100	1690	-1410	0.06	0.55	5	2	-3
0023	3T	21_7	126	10	0	1000	0	-1000	0.00	0.00	1	0	-1
0023	3T	21_7	134	23	0	2300	0	-2300	0.00	0.00	4	0	-4
0023	3T	21_7	135	18	1	1800	1000	-800	0.06	0.56	3	1	-2
0023	3T	21_7	136	3	0	300	0	-300	0.00	0.00	0	0	0
0023	3T	21_7	145	6	0	600	0	-600	0.00	0.00	1	0	-1
0023	3T	21_7	146	2	0	200	0	-200	0.00	0.00	0	0	0
0023	3T	21_7	153	1	0	100	0	-100	0.00	0.00	0	0	0
0023	3T	21_7	154	3	1	300	2130	1830	0.33	7.10	0	3	3
0023	3T	21_7	216	1	0	100	0	-100	0.00	0.00	0	0	0
0023	3T	21_7	234	1	0	100	0	-100	0.00	0.00	0	0	0
0023	3T	21_8	123	12	1	1200	870	-330	0.08	0.73	2	1	-1
0023	3T	21_8	124	37	8	3700	5340	1640	0.22	1.44	6	9	3
0023	3T	21_8	125	32	4	3200	10760	7560	0.13	3.36	5	19	14
0023	3T	21_8	126	19	2	1900	1860	-40	0.11	0.98	3	3	0
0023	3T	21_8	134	27	1	2700	310	-2390	0.04	0.11	4	0	-4
0023	3T	21_8	135	23	1	2300	430	-1870	0.04	0.19	4	0	-4
0023	3T	21_8	136	16	2	1600	1120	-480	0.13	0.70	2	1	-1
0023	3T	21_8	145	12	0	1200	0	-1200	0.00	0.00	2	0	-2
0023	3T	21_8	146	5	0	500	0	-500	0.00	0.00	0	0	0
0023	3T	21_8	153	1	0	100	0	-100	0.00	0.00	0	0	0
0023	3T	21_8	156	1	0	100	0	-100	0.00	0.00	0	0	0
0023	3T	21_9	123	14	0	1400	0	-1400	0.00	0.00	2	0	-2
0023	3T	21_9	124	31	3	3100	2890	-210	0.10	0.93	5	5	0
0023	3T	21_9	125	31	3	3100	2020	-1080	0.10	0.65	5	3	-2
0023	3T	21_9	126	25	3	2500	3110	610	0.12	1.24	4	5	1
0023	3T	21_9	134	11	2	1100	1110	10	0.18	1.01	1	1	0
0023	3T	21_9	135	15	2	1500	3650	2150	0.13	2.43	2	6	4
0023	3T	21_9	136	8	1	800	1010	210	0.13	1.26	1	1	0
0023	3T	21_9	145	8	0	800	0	-800	0.00	0.00	1	0	-1
0023	3T	21_9	146	3	0	300	0	-300	0.00	0.00	0	0	0
0023	3T	21_9	153	2	0	200	0	-200	0.00	0.00	0	0	0
0023	3T	21_9	156	1	0	100	0	-100	0.00	0.00	0	0	0
0023	3T	21_9	216	4	0	400	0	-400	0.00	0.00	0	0	0
0023	3T	21_9	234	1	0	100	0	-100	0.00	0.00	0	0	0
0023	3T	22_1	123	28	4	2800	1840	-960	0.14	0.66	4	3	-1
0023	3T	22_1	124	36	3	3600	2230	-1370	0.08	0.62	6	3	-3
0023	3T	22_1	125	17	2	1700	2440	740	0.12	1.44	3	4	1
0023	3T	22_1	126	5	0	500	0	-500	0.00	0.00	0	0	0
0023	3T	22_1	132	1	0	100	0	-100	0.00	0.00	0	0	0
0023	3T	22_1	134	9	2	900	2120	1220	0.22	2.36	1	3	2
0023	3T	22_1	135	9	0	900	0	-900	0.00	0.00	1	0	-1
0023	3T	22_1	136	2	0	200	0	-200	0.00	0.00	0	0	0
0023	3T	22_1	142	1	0	100	0	-100	0.00	0.00	0	0	0
0023	3T	22_1	143	1	1	100	770	670	1.00	7.70	0	1	1
0023	3T	22_1	145	1	0	100	0	-100	0.00	0.00	0	0	0
0023	3T	22_10	123	28	5	2800	3170	370	0.18	1.13	4	5	1
0023	3T	22_10	124	60	7	6000	6550	550	0.12	1.09	10	11	1
0023	3T	22_10	125	32	3	3200	2930	-270	0.09	0.92	5	5	0
0023	3T	22_10	126	14	1	1400	730	-670	0.07	0.52	2	1	-1
0023	3T	22_10	134	21	1	2100	1260	-840	0.05	0.60	3	2	-1
0023	3T	22_10	135	24	2	2400	1610	-790	0.08	0.67	4	2	-2
0023	3T	22_10	136	5	0	500	0	-500	0.00	0.00	0	0	0
0023	3T	22_10	145	6	0	600	0	-600	0.00	0.00	1	0	-1
0023	3T	22_10	146	4	0	400	0	-400	0.00	0.00	0	0	0
0023	3T	22_10	165	1	0	100	0	-100	0.00	0.00	0	0	0
0023	3T	22_11	123	30	5	3000	3580	580	0.17	1.19	5	6	1
0023	3T	22_11	124	79	9	7900	5780	-2120	0.11	0.73	13	10	-3
0023	3T	22_11	125	31	2	3100	2220	-880	0.06	0.72	5	3	-2
0023	3T	22_11	126	10	0	1000	0	-1000	0.00	0.00	1	0	-1
0023	3T	22_11	134	23	0	2300	0	-2300	0.00	0.00	4	0	-4
0023	3T	22_11	135	25	3	2500	4800	2300	0.12	1.92	4	8	4
0023	3T	22_11	136	2	0	200	0	-200	0.00	0.00	0	0	0
0023	3T	22_11	145	5	0	500	0	-500	0.00	0.00	0	0	0
0023	3T	22_11	146	2	0	200	0	-200	0.00	0.00	0	0	0
0023	3T	22_12	123	2	0	200	0	-200	0.00	0.00	0	0	0
0023	3T	22_12	124	73	8	7300	10170	2870	0.11	1.39	12	18	6
0023	3T	22_12	125	95	8	9500	15830	6330	0.08	1.67	16	28	12
0023	3T	22_12	126	4	0	400	0	-400	0.00	0.00	0	0	0
0023	3T	22_12	134	25	1	2500	1080	-1420	0.04	0.43	4	1	-3
0023	3T	22_12	135	21	2	2100	2380	280	0.10	1.13	3	4	1
0023	3T	22_12	136	2	1	200	1550	1350	0.50	7.75	0	2	2
0023	3T	22_12	145	5	0	500	0	-500	0.00	0.00	0	0	0
0023	3T	22_12	215	1	0	100	0	-100	0.00	0.00	0	0	0
0023	3T	22_2	123	14	1	1400	940	-460	0.07	0.67	2	1	-1
0023	3T	22_2	124	22	0	2200	0	-2200	0.00	0.00	3	0	-3
0023	3T	22_2	125	8	1	800	1360	560	0.13	1.70	1	2	1
0023	3T	22_2	126	17	1	1700	2140	440	0.06	1.26	3	3	0
0023	3T	22_2	132	1	1	100	670	570	1.00	6.70	0	1	1
0023	3T	22_2	134	14	1	1400	440	-960	0.07	0.31	2	0	-2
0023	3T	22_2	135	8	0	800	0	-800	0.00	0.00	1	0	-1
0023	3T	22_2	136	13	0	1300	0	-1300	0.00	0.00	2	0	-2
0023	3T	22_2	145	4	0	400	0	-400	0.00	0.00	0	0	0
0023	3T	22_2	146	1	0	100	0	-100	0.00	0.00	0	0	0
0023	3T	22_2	156	2	0	200	0	-200	0.00	0.00	0	0	0
0023	3T	22_2	234	1	0	100	0	-100	0.00	0.00	0	0	0
0023	3T	22_3	123	14	1	1400	690	-710	0.07	0.49	2	1	-1
0023	3T	22_3	124	24	3	2400	2360	-40	0.13	0.98	4	4	0
0023	3T	22_3	125	13	4	1300	5130	3830	0.31	3.95	2	9	7
0023	3T	22_3	126	16	0	1600	0	-1600	0.00	0.00	2	0	-2
0023	3T	22_3	134	9	1	900	470	-430	0.11	0.52	1	0	-1
0023	3T	22_3	135	18	0	1800	0	-1800	0.00	0.00	3	0	-3
0023	3T	22_3	136	9	0	900	0	-900	0.00	0.00	1	0	-1
0023	3T	22_3	145	7	0	700	0	-700	0.00	0.00	1	0	-1
0023	3T	22_3	146	2	1	200	3940	3740	0.50	19.70	0	6	6
0023	3T	22_3	235	1	0	100	0	-100	0.00	0.00	0	0	0
0023	3T	22_3	245	1	0	100	0	-100	0.00	0.00	0	0	0
0023	3T	22_3	246	2	0	200	0	-200	0.00	0.00	0	0	0
0023	3T	22_4	123	13	1	1300	650	-650	0.08	0.50	2	1	-1
0023	3T	22_4	124	28	1	2800	1060	-1740	0.04	0.38	4	1	-3
0023	3T	22_4	125	12	1	1200	700	-500	0.08	0.58	2	1	-1
0023	3T	22_4	126	16	1	1600	1220	-380	0.06	0.76	2	2	0
0023	3T	22_4	134	10	2	1000	3540	2540	0.20	3.54	1	6	5
0023	3T	22_4	135	14	1	1400	370	-1030	0.07	0.26	2	0	-2
0023	3T	22_4	136	14	0	1400	0	-1400	0.00	0.00	2	0	-2
0023	3T	22_4	145	7	0	700	0	-700	0.00	0.00	1	0	-1
0023	3T	22_4	146	6	1	600	1860	1260	0.17	3.10	1	3	2
0023	3T	22_4	156	2	0	200	0	-200	0.00	0.00	0	0	0
0023	3T	22_4	215	2	0	200	0	-200	0.00	0.00	0	0	0
0023	3T	22_4	234	1	0	100	0	-100	0.00	0.00	0	0	0
0023	3T	22_4	245	1	0	100	0	-100	0.00	0.00	0	0	0
0023	3T	22_5	123	18	2	1800	1470	-330	0.11	0.82	3	2	-1
0023	3T	22_5	124	23	3	2300	2250	-50	0.13	0.98	4	3	-1
0023	3T	22_5	125	10	0	1000	0	-1000	0.00	0.00	1	0	-1
0023	3T	22_5	126	12	0	1200	0	-1200	0.00	0.00	2	0	-2
0023	3T	22_5	134	12	1	1200	520	-680	0.08	0.43	2	0	-2
0023	3T	22_5	135	16	1	1600	2310	710	0.06	1.44	2	4	2
0023	3T	22_5	136	15	0	1500	0	-1500	0.00	0.00	2	0	-2
0023	3T	22_5	145	4	0	400	0	-400	0.00	0.00	0	0	0
0023	3T	22_5	146	6	0	600	0	-600	0.00	0.00	1	0	-1
0023	3T	22_5	156	2	0	200	0	-200	0.00	0.00	0	0	0
0023	3T	22_5	214	1	0	100	0	-100	0.00	0.00	0	0	0
0023	3T	22_5	216	1	0	100	0	-100	0.00	0.00	0	0	0
0023	3T	22_5	234	1	0	100	0	-100	0.00	0.00	0	0	0
0023	3T	22_5	236	4	1	400	590	190	0.25	1.48	0	1	1
0023	3T	22_5	245	1	0	100	0	-100	0.00	0.00	0	0	0
0023	3T	22_6	123	13	0	1300	0	-1300	0.00	0.00	2	0	-2
0023	3T	22_6	124	28	2	2800	1890	-910	0.07	0.68	4	3	-1
0023	3T	22_6	125	13	1	1300	660	-640	0.08	0.51	2	1	-1
0023	3T	22_6	126	17	2	1700	1670	-30	0.12	0.98	3	2	-1
0023	3T	22_6	134	11	0	1100	0	-1100	0.00	0.00	1	0	-1
0023	3T	22_6	135	11	1	1100	680	-420	0.09	0.62	1	1	0
0023	3T	22_6	136	9	0	900	0	-900	0.00	0.00	1	0	-1
0023	3T	22_6	143	2	0	200	0	-200	0.00	0.00	0	0	0
0023	3T	22_6	145	8	0	800	0	-800	0.00	0.00	1	0	-1
0023	3T	22_6	146	4	0	400	0	-400	0.00	0.00	0	0	0
0023	3T	22_6	154	1	0	100	0	-100	0.00	0.00	0	0	0
0023	3T	22_6	156	4	1	400	1200	800	0.25	3.00	0	2	2
0023	3T	22_6	234	1	0	100	0	-100	0.00	0.00	0	0	0
0023	3T	22_6	236	1	0	100	0	-100	0.00	0.00	0	0	0
0023	3T	22_6	245	2	0	200	0	-200	0.00	0.00	0	0	0
0023	3T	22_7	123	18	3	1800	2630	830	0.17	1.46	3	4	1
0023	3T	22_7	124	30	4	3000	4190	1190	0.13	1.40	5	7	2
0023	3T	22_7	125	25	4	2500	3790	1290	0.16	1.52	4	6	2
0023	3T	22_7	126	12	1	1200	4150	2950	0.08	3.46	2	7	5
0023	3T	22_7	134	17	2	1700	1520	-180	0.12	0.89	3	2	-1
0023	3T	22_7	135	10	1	1000	940	-60	0.10	0.94	1	1	0
0023	3T	22_7	136	6	0	600	0	-600	0.00	0.00	1	0	-1
0023	3T	22_7	145	3	0	300	0	-300	0.00	0.00	0	0	0
0023	3T	22_7	146	3	0	300	0	-300	0.00	0.00	0	0	0
0023	3T	22_7	156	3	0	300	0	-300	0.00	0.00	0	0	0
0023	3T	22_7	246	1	0	100	0	-100	0.00	0.00	0	0	0
0023	3T	22_7	256	1	0	100	0	-100	0.00	0.00	0	0	0
0023	3T	22_8	123	11	3	1100	1850	750	0.27	1.68	1	3	2
0023	3T	22_8	124	65	5	6500	2390	-4110	0.08	0.37	11	4	-7
0023	3T	22_8	125	3	0	300	0	-300	0.00	0.00	0	0	0
0023	3T	22_8	134	16	2	1600	930	-670	0.13	0.58	2	1	-1
0023	3T	22_8	135	3	0	300	0	-300	0.00	0.00	0	0	0
0023	3T	22_8	136	2	0	200	0	-200	0.00	0.00	0	0	0
0023	3T	22_8	145	4	1	400	780	380	0.25	1.95	0	1	1
0023	3T	22_9	123	24	3	2400	2400	0	0.13	1.00	4	4	0
0023	3T	22_9	124	29	2	2900	1490	-1410	0.07	0.51	5	2	-3
0023	3T	22_9	125	26	1	2600	1380	-1220	0.04	0.53	4	2	-2
0023	3T	22_9	126	23	3	2300	5950	3650	0.13	2.59	4	10	6
0023	3T	22_9	134	16	1	1600	1010	-590	0.06	0.63	2	1	-1
0023	3T	22_9	135	8	1	800	580	-220	0.13	0.73	1	1	0
0023	3T	22_9	136	12	0	1200	0	-1200	0.00	0.00	2	0	-2
0023	3T	22_9	145	6	1	600	910	310	0.17	1.52	1	1	0
0023	3T	22_9	146	2	0	200	0	-200	0.00	0.00	0	0	0
0023	3T	22_9	215	1	0	100	0	-100	0.00	0.00	0	0	0
0023	3T	22_9	234	2	1	200	2050	1850	0.50	10.25	0	3	3
0023	3T	23_1	123	47	11	4700	8240	3540	0.23	1.75	8	14	6
0023	3T	23_1	124	48	4	4800	2560	-2240	0.08	0.53	8	4	-4
0023	3T	23_1	125	10	0	1000	0	-1000	0.00	0.00	1	0	-1
0023	3T	23_1	126	3	1	300	550	250	0.33	1.83	0	0	0
0023	3T	23_1	132	1	0	100	0	-100	0.00	0.00	0	0	0
0023	3T	23_1	134	6	0	600	0	-600	0.00	0.00	1	0	-1
0023	3T	23_1	135	6	2	600	1320	720	0.33	2.20	1	2	1
0023	3T	23_1	136	4	0	400	0	-400	0.00	0.00	0	0	0
0023	3T	23_1	142	1	0	100	0	-100	0.00	0.00	0	0	0
0023	3T	23_1	143	1	0	100	0	-100	0.00	0.00	0	0	0
0023	3T	23_1	146	1	1	100	680	580	1.00	6.80	0	1	1
0023	3T	23_1	152	1	0	100	0	-100	0.00	0.00	0	0	0
0023	3T	23_10	123	18	1	1800	380	-1420	0.06	0.21	3	0	-3
0023	3T	23_10	124	118	4	11800	3120	-8680	0.03	0.26	20	5	-15
0023	3T	23_10	125	33	2	3300	2350	-950	0.06	0.71	5	4	-1
0023	3T	23_10	126	2	0	200	0	-200	0.00	0.00	0	0	0
0023	3T	23_10	134	45	6	4500	5820	1320	0.13	1.29	7	10	3
0023	3T	23_10	135	3	0	300	0	-300	0.00	0.00	0	0	0
0023	3T	23_10	136	1	0	100	0	-100	0.00	0.00	0	0	0
0023	3T	23_10	145	15	0	1500	0	-1500	0.00	0.00	2	0	-2
0023	3T	23_10	146	3	1	300	9820	9520	0.33	32.73	0	17	17
0023	3T	23_10	235	1	0	100	0	-100	0.00	0.00	0	0	0
0023	3T	23_10	245	4	0	400	0	-400	0.00	0.00	0	0	0
0023	3T	23_10	246	1	0	100	0	-100	0.00	0.00	0	0	0
0023	3T	23_11	123	111	13	11100	8080	-3020	0.12	0.73	19	14	-5
0023	3T	23_11	124	29	1	2900	5430	2530	0.03	1.87	5	9	4
0023	3T	23_11	125	4	0	400	0	-400	0.00	0.00	0	0	0
0023	3T	23_11	134	13	0	1300	0	-1300	0.00	0.00	2	0	-2
0023	3T	23_11	135	9	0	900	0	-900	0.00	0.00	1	0	-1
0023	3T	23_11	143	3	0	300	0	-300	0.00	0.00	0	0	0
0023	3T	23_11	164	1	0	100	0	-100	0.00	0.00	0	0	0
0023	3T	23_11	215	2	0	200	0	-200	0.00	0.00	0	0	0
0023	3T	23_12	123	132	14	13200	11350	-1850	0.11	0.86	23	20	-3
0023	3T	23_12	124	74	5	7400	3320	-4080	0.07	0.45	13	5	-8
0023	3T	23_12	125	2	0	200	0	-200	0.00	0.00	0	0	0
0023	3T	23_12	134	19	1	1900	1970	70	0.05	1.04	3	3	0
0023	3T	23_12	214	1	0	100	0	-100	0.00	0.00	0	0	0
0023	3T	23_2	123	119	17	11900	9760	-2140	0.14	0.82	21	17	-4
0023	3T	23_2	124	73	7	7300	3580	-3720	0.10	0.49	12	6	-6
0023	3T	23_2	125	20	2	2000	1210	-790	0.10	0.61	3	2	-1
0023	3T	23_2	126	5	1	500	1110	610	0.20	2.22	0	1	1
0023	3T	23_2	134	1	0	100	0	-100	0.00	0.00	0	0	0
0023	3T	23_3	123	12	1	1200	560	-640	0.08	0.47	2	0	-2
0023	3T	23_3	124	6	0	600	0	-600	0.00	0.00	1	0	-1
0023	3T	23_3	125	1	0	100	0	-100	0.00	0.00	0	0	0
0023	3T	23_3	132	2	0	200	0	-200	0.00	0.00	0	0	0
0023	3T	23_3	134	53	5	5300	3370	-1930	0.09	0.64	9	5	-4
0023	3T	23_3	135	13	1	1300	500	-800	0.08	0.38	2	0	-2
0023	3T	23_3	136	5	0	500	0	-500	0.00	0.00	0	0	0
0023	3T	23_3	145	1	0	100	0	-100	0.00	0.00	0	0	0
0023	3T	23_3	234	1	0	100	0	-100	0.00	0.00	0	0	0
0023	3T	23_4	123	4	0	400	0	-400	0.00	0.00	0	0	0
0023	3T	23_4	124	27	4	2700	3200	500	0.15	1.19	4	5	1
0023	3T	23_4	125	23	1	2300	1420	-880	0.04	0.62	4	2	-2
0023	3T	23_4	126	10	0	1000	0	-1000	0.00	0.00	1	0	-1
0023	3T	23_4	134	26	0	2600	0	-2600	0.00	0.00	4	0	-4
0023	3T	23_4	135	21	3	2100	1280	-820	0.14	0.61	3	2	-1
0023	3T	23_4	136	14	2	1400	1130	-270	0.14	0.81	2	2	0
0023	3T	23_4	145	22	2	2200	1610	-590	0.09	0.73	3	2	-1
0023	3T	23_4	146	9	0	900	0	-900	0.00	0.00	1	0	-1
0023	3T	23_4	154	2	0	200	0	-200	0.00	0.00	0	0	0
0023	3T	23_4	156	1	0	100	0	-100	0.00	0.00	0	0	0
0023	3T	23_5	123	12	3	1200	2810	1610	0.25	2.34	2	4	2
0023	3T	23_5	124	31	2	3100	2860	-240	0.06	0.92	5	5	0
0023	3T	23_5	125	25	3	2500	2370	-130	0.12	0.95	4	4	0
0023	3T	23_5	126	20	0	2000	0	-2000	0.00	0.00	3	0	-3
0023	3T	23_5	134	14	1	1400	1300	-100	0.07	0.93	2	2	0
0023	3T	23_5	135	14	0	1400	0	-1400	0.00	0.00	2	0	-2
0023	3T	23_5	136	7	1	700	1610	910	0.14	2.30	1	2	1
0023	3T	23_5	145	12	1	1200	820	-380	0.08	0.68	2	1	-1
0023	3T	23_5	146	8	0	800	0	-800	0.00	0.00	1	0	-1
0023	3T	23_5	156	2	0	200	0	-200	0.00	0.00	0	0	0
0023	3T	23_5	215	2	0	200	0	-200	0.00	0.00	0	0	0
0023	3T	23_5	234	2	0	200	0	-200	0.00	0.00	0	0	0
0023	3T	23_5	235	1	0	100	0	-100	0.00	0.00	0	0	0
0023	3T	23_5	245	3	0	300	0	-300	0.00	0.00	0	0	0
0023	3T	23_5	246	3	0	300	0	-300	0.00	0.00	0	0	0
0023	3T	23_6	123	2	0	200	0	-200	0.00	0.00	0	0	0
0023	3T	23_6	124	24	2	2400	3570	1170	0.08	1.49	4	6	2
0023	3T	23_6	125	16	1	1600	620	-980	0.06	0.39	2	1	-1
0023	3T	23_6	126	18	2	1800	2270	470	0.11	1.26	3	4	1
0023	3T	23_6	134	10	1	1000	1020	20	0.10	1.02	1	1	0
0023	3T	23_6	135	16	0	1600	0	-1600	0.00	0.00	2	0	-2
0023	3T	23_6	136	12	2	1200	7470	6270	0.17	6.23	2	13	11
0023	3T	23_6	145	16	1	1600	1760	160	0.06	1.10	2	3	1
0023	3T	23_6	146	4	0	400	0	-400	0.00	0.00	0	0	0
0023	3T	23_6	216	2	0	200	0	-200	0.00	0.00	0	0	0
0023	3T	23_6	234	2	0	200	0	-200	0.00	0.00	0	0	0
0023	3T	23_6	235	1	0	100	0	-100	0.00	0.00	0	0	0
0023	3T	23_6	236	1	0	100	0	-100	0.00	0.00	0	0	0
0023	3T	23_6	245	2	0	200	0	-200	0.00	0.00	0	0	0
0023	3T	23_6	246	1	0	100	0	-100	0.00	0.00	0	0	0
0023	3T	23_6	256	1	0	100	0	-100	0.00	0.00	0	0	0
0023	3T	23_7	123	15	1	1500	360	-1140	0.07	0.24	2	0	-2
0023	3T	23_7	124	27	2	2700	1720	-980	0.07	0.64	4	3	-1
0023	3T	23_7	125	20	2	2000	2890	890	0.10	1.45	3	5	2
0023	3T	23_7	126	6	0	600	0	-600	0.00	0.00	1	0	-1
0023	3T	23_7	134	16	0	1600	0	-1600	0.00	0.00	2	0	-2
0023	3T	23_7	135	13	0	1300	0	-1300	0.00	0.00	2	0	-2
0023	3T	23_7	136	4	0	400	0	-400	0.00	0.00	0	0	0
0023	3T	23_7	142	1	0	100	0	-100	0.00	0.00	0	0	0
0023	3T	23_7	145	5	0	500	0	-500	0.00	0.00	0	0	0
0023	3T	23_7	146	4	0	400	0	-400	0.00	0.00	0	0	0
0023	3T	23_7	234	1	0	100	0	-100	0.00	0.00	0	0	0
0023	3T	23_7	245	1	0	100	0	-100	0.00	0.00	0	0	0
0023	3T	23_7	246	1	0	100	0	-100	0.00	0.00	0	0	0
0023	3T	23_8	123	13	2	1300	1780	480	0.15	1.37	2	3	1
0023	3T	23_8	124	10	1	1000	980	-20	0.10	0.98	1	1	0
0023	3T	23_8	125	9	0	900	0	-900	0.00	0.00	1	0	-1
0023	3T	23_8	126	2	0	200	0	-200	0.00	0.00	0	0	0
0023	3T	23_8	134	7	0	700	0	-700	0.00	0.00	1	0	-1
0023	3T	23_8	135	5	0	500	0	-500	0.00	0.00	0	0	0
0023	3T	23_8	136	4	1	400	1370	970	0.25	3.43	0	2	2
0023	3T	23_8	145	10	2	1000	1590	590	0.20	1.59	1	2	1
0023	3T	23_8	146	4	0	400	0	-400	0.00	0.00	0	0	0
0023	3T	23_8	156	3	0	300	0	-300	0.00	0.00	0	0	0
0023	3T	23_8	235	2	0	200	0	-200	0.00	0.00	0	0	0
0023	3T	23_8	246	1	0	100	0	-100	0.00	0.00	0	0	0
0023	3T	23_9	123	26	3	2600	1880	-720	0.12	0.72	4	3	-1
0023	3T	23_9	124	38	2	3800	1830	-1970	0.05	0.48	6	3	-3
0023	3T	23_9	125	22	1	2200	1270	-930	0.05	0.58	3	2	-1
0023	3T	23_9	126	13	0	1300	0	-1300	0.00	0.00	2	0	-2
0023	3T	23_9	134	11	1	1100	450	-650	0.09	0.41	1	0	-1
0023	3T	23_9	135	19	1	1900	820	-1080	0.05	0.43	3	1	-2
0023	3T	23_9	136	7	0	700	0	-700	0.00	0.00	1	0	-1
0023	3T	23_9	145	11	0	1100	0	-1100	0.00	0.00	1	0	-1
0023	3T	23_9	146	5	0	500	0	-500	0.00	0.00	0	0	0
0023	3T	23_9	156	3	0	300	0	-300	0.00	0.00	0	0	0
0023	3T	23_9	214	2	0	200	0	-200	0.00	0.00	0	0	0
0023	3T	23_9	234	2	0	200	0	-200	0.00	0.00	0	0	0
0023	3T	23_9	235	1	0	100	0	-100	0.00	0.00	0	0	0
0023	3T	23_9	246	1	0	100	0	-100	0.00	0.00	0	0	0
0023	3T	23_9	256	1	0	100	0	-100	0.00	0.00	0	0	0
0023	3T	24_1	123	41	5	4100	2780	-1320	0.12	0.68	7	4	-3
0023	3T	24_1	124	23	5	2300	2300	0	0.22	1.00	4	4	0
0023	3T	24_1	125	13	2	1300	1520	220	0.15	1.17	2	2	0
0023	3T	24_1	126	6	0	600	0	-600	0.00	0.00	1	0	-1
0023	3T	24_1	132	1	0	100	0	-100	0.00	0.00	0	0	0
0023	3T	24_1	134	8	1	800	520	-280	0.13	0.65	1	0	-1
0023	3T	24_1	135	3	1	300	940	640	0.33	3.13	0	1	1
0023	3T	24_1	136	2	0	200	0	-200	0.00	0.00	0	0	0
0023	3T	24_1	142	2	0	200	0	-200	0.00	0.00	0	0	0
0023	3T	24_1	143	1	0	100	0	-100	0.00	0.00	0	0	0
0023	3T	24_1	145	5	0	500	0	-500	0.00	0.00	0	0	0
0023	3T	24_1	152	3	0	300	0	-300	0.00	0.00	0	0	0
0023	3T	24_1	156	1	0	100	0	-100	0.00	0.00	0	0	0
0023	3T	24_1	235	1	0	100	0	-100	0.00	0.00	0	0	0
0023	3T	24_10	123	50	11	5000	6600	1600	0.22	1.32	8	11	3
0023	3T	24_10	124	87	8	8700	5400	-3300	0.09	0.62	15	9	-6
0023	3T	24_10	125	35	2	3500	1160	-2340	0.06	0.33	6	2	-4
0023	3T	24_10	126	28	1	2800	690	-2110	0.04	0.25	4	1	-3
0023	3T	24_10	134	19	1	1900	1320	-580	0.05	0.69	3	2	-1
0023	3T	24_10	135	12	2	1200	1740	540	0.17	1.45	2	3	1
0023	3T	24_10	136	7	0	700	0	-700	0.00	0.00	1	0	-1
0023	3T	24_10	143	1	0	100	0	-100	0.00	0.00	0	0	0
0023	3T	24_10	145	1	0	100	0	-100	0.00	0.00	0	0	0
0023	3T	24_10	146	1	0	100	0	-100	0.00	0.00	0	0	0
0023	3T	24_11	123	58	7	5800	4200	-1600	0.12	0.72	10	7	-3
0023	3T	24_11	124	109	4	10900	2620	-8280	0.04	0.24	19	4	-15
0023	3T	24_11	125	33	1	3300	560	-2740	0.03	0.17	5	0	-5
0023	3T	24_11	126	16	0	1600	0	-1600	0.00	0.00	2	0	-2
0023	3T	24_11	134	14	1	1400	680	-720	0.07	0.49	2	1	-1
0023	3T	24_11	135	11	0	1100	0	-1100	0.00	0.00	1	0	-1
0023	3T	24_11	136	4	0	400	0	-400	0.00	0.00	0	0	0
0023	3T	24_11	145	1	0	100	0	-100	0.00	0.00	0	0	0
0023	3T	24_11	146	1	0	100	0	-100	0.00	0.00	0	0	0
0023	3T	24_11	215	1	0	100	0	-100	0.00	0.00	0	0	0
0023	3T	24_12	123	22	2	2200	1160	-1040	0.09	0.53	3	2	-1
0023	3T	24_12	124	133	9	13300	7370	-5930	0.07	0.55	23	13	-10
0023	3T	24_12	125	15	1	1500	880	-620	0.07	0.59	2	1	-1
0023	3T	24_12	126	40	1	4000	2310	-1690	0.03	0.58	7	4	-3
0023	3T	24_12	134	18	5	1800	3470	1670	0.28	1.93	3	6	3
0023	3T	24_12	135	7	0	700	0	-700	0.00	0.00	1	0	-1
0023	3T	24_12	136	5	1	500	1140	640	0.20	2.28	0	2	2
0023	3T	24_12	145	3	0	300	0	-300	0.00	0.00	0	0	0
0023	3T	24_12	146	1	0	100	0	-100	0.00	0.00	0	0	0
0023	3T	24_2	123	49	8	4900	3430	-1470	0.16	0.70	8	6	-2
0023	3T	24_2	124	26	3	2600	1230	-1370	0.12	0.47	4	2	-2
0023	3T	24_2	125	13	3	1300	3550	2250	0.23	2.73	2	6	4
0023	3T	24_2	126	20	1	2000	1010	-990	0.05	0.51	3	1	-2
0023	3T	24_2	134	15	2	1500	950	-550	0.13	0.63	2	1	-1
0023	3T	24_2	135	7	1	700	860	160	0.14	1.23	1	1	0
0023	3T	24_2	136	13	0	1300	0	-1300	0.00	0.00	2	0	-2
0023	3T	24_2	143	1	0	100	0	-100	0.00	0.00	0	0	0
0023	3T	24_2	145	2	0	200	0	-200	0.00	0.00	0	0	0
0023	3T	24_2	146	3	0	300	0	-300	0.00	0.00	0	0	0
0023	3T	24_2	153	1	0	100	0	-100	0.00	0.00	0	0	0
0023	3T	24_2	234	1	0	100	0	-100	0.00	0.00	0	0	0
0023	3T	24_2	235	1	0	100	0	-100	0.00	0.00	0	0	0
0023	3T	24_3	123	20	2	2000	1310	-690	0.10	0.66	3	2	-1
0023	3T	24_3	124	23	3	2300	2830	530	0.13	1.23	4	5	1
0023	3T	24_3	125	23	1	2300	990	-1310	0.04	0.43	4	1	-3
0023	3T	24_3	126	21	0	2100	0	-2100	0.00	0.00	3	0	-3
0023	3T	24_3	134	14	2	1400	1250	-150	0.14	0.89	2	2	0
0023	3T	24_3	135	6	2	600	2180	1580	0.33	3.63	1	3	2
0023	3T	24_3	136	23	1	2300	670	-1630	0.04	0.29	4	1	-3
0023	3T	24_3	145	5	0	500	0	-500	0.00	0.00	0	0	0
0023	3T	24_3	146	2	0	200	0	-200	0.00	0.00	0	0	0
0023	3T	24_3	236	1	0	100	0	-100	0.00	0.00	0	0	0
0023	3T	24_4	123	18	0	1800	0	-1800	0.00	0.00	3	0	-3
0023	3T	24_4	124	26	3	2600	2130	-470	0.12	0.82	4	3	-1
0023	3T	24_4	125	19	2	1900	4640	2740	0.11	2.44	3	8	5
0023	3T	24_4	126	24	4	2400	3100	700	0.17	1.29	4	5	1
0023	3T	24_4	134	18	1	1800	500	-1300	0.06	0.28	3	0	-3
0023	3T	24_4	135	9	1	900	600	-300	0.11	0.67	1	1	0
0023	3T	24_4	136	18	1	1800	2070	270	0.06	1.15	3	3	0
0023	3T	24_4	143	1	0	100	0	-100	0.00	0.00	0	0	0
0023	3T	24_4	145	1	0	100	0	-100	0.00	0.00	0	0	0
0023	3T	24_4	146	6	0	600	0	-600	0.00	0.00	1	0	-1
0023	3T	24_4	154	1	0	100	0	-100	0.00	0.00	0	0	0
0023	3T	24_4	156	1	0	100	0	-100	0.00	0.00	0	0	0
0023	3T	24_4	216	1	0	100	0	-100	0.00	0.00	0	0	0
0023	3T	24_4	235	1	0	100	0	-100	0.00	0.00	0	0	0
0023	3T	24_5	123	31	8	3100	3180	80	0.26	1.03	5	5	0
0023	3T	24_5	124	50	11	5000	4560	-440	0.22	0.91	8	8	0
0023	3T	24_5	125	17	5	1700	2470	770	0.29	1.45	3	4	1
0023	3T	24_5	126	9	0	900	0	-900	0.00	0.00	1	0	-1
0023	3T	24_5	134	26	6	2600	3890	1290	0.23	1.50	4	6	2
0023	3T	24_5	135	20	2	2000	1390	-610	0.10	0.70	3	2	-1
0023	3T	24_5	136	4	0	400	0	-400	0.00	0.00	0	0	0
0023	3T	24_5	145	10	0	1000	0	-1000	0.00	0.00	1	0	-1
0023	3T	24_5	146	1	0	100	0	-100	0.00	0.00	0	0	0
0023	3T	24_5	156	1	0	100	0	-100	0.00	0.00	0	0	0
0023	3T	24_6	123	25	4	2500	1800	-700	0.16	0.72	4	3	-1
0023	3T	24_6	124	38	7	3800	3630	-170	0.18	0.96	6	6	0
0023	3T	24_6	125	16	1	1600	950	-650	0.06	0.59	2	1	-1
0023	3T	24_6	126	28	1	2800	1080	-1720	0.04	0.39	4	1	-3
0023	3T	24_6	134	12	3	1200	2400	1200	0.25	2.00	2	4	2
0023	3T	24_6	135	9	1	900	860	-40	0.11	0.96	1	1	0
0023	3T	24_6	136	16	0	1600	0	-1600	0.00	0.00	2	0	-2
0023	3T	24_6	142	1	1	100	1020	920	1.00	10.20	0	1	1
0023	3T	24_6	143	1	0	100	0	-100	0.00	0.00	0	0	0
0023	3T	24_6	145	3	0	300	0	-300	0.00	0.00	0	0	0
0023	3T	24_6	146	2	0	200	0	-200	0.00	0.00	0	0	0
0023	3T	24_6	235	1	0	100	0	-100	0.00	0.00	0	0	0
0023	3T	24_7	123	8	1	800	380	-420	0.13	0.48	1	0	-1
0023	3T	24_7	124	20	3	2000	2370	370	0.15	1.19	3	4	1
0023	3T	24_7	125	17	3	1700	3040	1340	0.18	1.79	3	5	2
0023	3T	24_7	126	18	2	1800	2260	460	0.11	1.26	3	4	1
0023	3T	24_7	134	12	2	1200	990	-210	0.17	0.83	2	1	-1
0023	3T	24_7	135	11	2	1100	970	-130	0.18	0.88	1	1	0
0023	3T	24_7	136	17	3	1700	2450	750	0.18	1.44	3	4	1
0023	3T	24_7	145	3	0	300	0	-300	0.00	0.00	0	0	0
0023	3T	24_7	146	3	0	300	0	-300	0.00	0.00	0	0	0
0023	3T	24_8	123	28	4	2800	3470	670	0.14	1.24	4	6	2
0023	3T	24_8	124	22	7	2200	6700	4500	0.32	3.05	3	11	8
0023	3T	24_8	125	19	5	1900	4730	2830	0.26	2.49	3	8	5
0023	3T	24_8	126	18	1	1800	550	-1250	0.06	0.31	3	0	-3
0023	3T	24_8	134	18	2	1800	1490	-310	0.11	0.83	3	2	-1
0023	3T	24_8	135	12	2	1200	940	-260	0.17	0.78	2	1	-1
0023	3T	24_8	136	13	0	1300	0	-1300	0.00	0.00	2	0	-2
0023	3T	24_8	143	1	0	100	0	-100	0.00	0.00	0	0	0
0023	3T	24_8	145	6	2	600	1600	1000	0.33	2.67	1	2	1
0023	3T	24_8	146	1	0	100	0	-100	0.00	0.00	0	0	0
0023	3T	24_8	156	1	1	100	730	630	1.00	7.30	0	1	1
0023	3T	24_8	165	1	0	100	0	-100	0.00	0.00	0	0	0
0023	3T	24_8	216	1	0	100	0	-100	0.00	0.00	0	0	0
0023	3T	24_9	123	40	5	4000	1990	-2010	0.13	0.50	7	3	-4
0023	3T	24_9	124	69	3	6900	1620	-5280	0.04	0.23	12	2	-10
0023	3T	24_9	125	19	2	1900	1570	-330	0.11	0.83	3	2	-1
0023	3T	24_9	126	19	0	1900	0	-1900	0.00	0.00	3	0	-3
0023	3T	24_9	132	1	0	100	0	-100	0.00	0.00	0	0	0
0023	3T	24_9	134	20	2	2000	950	-1050	0.10	0.48	3	1	-2
0023	3T	24_9	135	9	0	900	0	-900	0.00	0.00	1	0	-1
0023	3T	24_9	136	13	2	1300	1730	430	0.15	1.33	2	3	1
0023	3T	24_9	143	1	0	100	0	-100	0.00	0.00	0	0	0
0023	3T	24_9	145	1	1	100	660	560	1.00	6.60	0	1	1
0023	3T	24_9	146	2	0	200	0	-200	0.00	0.00	0	0	0
0023	3T	24_9	154	2	0	200	0	-200	0.00	0.00	0	0	0
0023	3T	24_9	156	1	0	100	0	-100	0.00	0.00	0	0	0
0023	3T	24_9	236	1	0	100	0	-100	0.00	0.00	0	0	0
