description	bettype	bet_kumiban	betcnt	hitcnt	betamt	hitamt	incomeamt	hitrate	incomerate	daily_betamt	daily_hitamt	daily_incomeamt
0023	1T	1	63793	37580	6379300	5877590	-501710	0.59	0.92	11290	10402	-888
0023	1T	2	7588	2870	758800	688750	-70050	0.38	0.91	1343	1219	-124
0023	2F	12	34251	11496	3425100	2900190	-524910	0.34	0.85	6062	5133	-929
0023	2F	13	16121	5024	1612100	1293130	-318970	0.31	0.80	2853	2288	-565
0023	2F	14	8036	2281	803600	614770	-188830	0.28	0.77	1422	1088	-334
0023	2F	15	2177	482	217700	178470	-39230	0.22	0.82	385	315	-70
0023	2F	16	1565	303	156500	132960	-23540	0.19	0.85	276	235	-41
0023	2F	23	571	110	57100	41020	-16080	0.19	0.72	101	72	-29
0023	2F	24	478	92	47800	37220	-10580	0.19	0.78	84	65	-19
0023	2F	25	273	44	27300	18200	-9100	0.16	0.67	48	32	-16
0023	2F	26	428	60	42800	29220	-13580	0.14	0.68	75	51	-24
0023	2T	12	33873	8643	3387300	2762920	-624380	0.26	0.82	5995	4890	-1105
0023	2T	13	16121	3616	1612100	1242510	-369590	0.22	0.77	2853	2199	-654
0023	2T	14	8036	1644	803600	623340	-180260	0.20	0.78	1422	1103	-319
0023	2T	15	2177	340	217700	188140	-29560	0.16	0.86	385	332	-53
0023	2T	16	1565	215	156500	132060	-24440	0.14	0.84	276	233	-43
0023	2T	21	378	33	37800	23560	-14240	0.09	0.62	66	41	-25
0023	2T	23	571	62	57100	38260	-18840	0.11	0.67	101	67	-34
0023	2T	24	478	62	47800	43010	-4790	0.13	0.90	84	76	-8
0023	2T	25	273	27	27300	20450	-6850	0.10	0.75	48	36	-12
0023	2T	26	428	27	42800	19500	-23300	0.06	0.46	75	34	-41
0023	3F	123	7077	1939	707700	572450	-135250	0.27	0.81	1252	1013	-239
0023	3F	124	13820	2922	1382000	1012190	-369810	0.21	0.73	2446	1791	-655
0023	3F	125	6880	1226	688000	557310	-130690	0.18	0.81	1217	986	-231
0023	3F	126	4955	724	495500	412940	-82560	0.15	0.83	876	730	-146
0023	3F	134	4935	1098	493500	366280	-127220	0.22	0.74	873	648	-225
0023	3F	135	4270	783	427000	307890	-119110	0.18	0.72	755	544	-211
0023	3F	136	2705	412	270500	201680	-68820	0.15	0.75	478	356	-122
0023	3F	145	1451	251	145100	104760	-40340	0.17	0.72	256	185	-71
0023	3F	146	1062	147	106200	92090	-14110	0.14	0.87	187	162	-25
0023	3F	156	431	66	43100	36310	-6790	0.15	0.84	76	64	-12
0023	3F	234	123	19	12300	6160	-6140	0.15	0.50	21	10	-11
0023	3F	235	190	27	19000	11640	-7360	0.14	0.61	33	20	-13
0023	3F	236	176	22	17600	13600	-4000	0.13	0.77	31	24	-7
0023	3F	245	122	18	12200	7300	-4900	0.15	0.60	21	12	-9
0023	3F	246	133	21	13300	13090	-210	0.16	0.98	23	23	0
0023	3F	256	63	9	6300	3830	-2470	0.14	0.61	11	6	-5
0023	3T	123	6942	875	694200	598280	-95920	0.13	0.86	1228	1058	-170
0023	3T	124	13690	1234	1369000	989920	-379080	0.09	0.72	2423	1752	-671
0023	3T	125	6763	522	676300	584550	-91750	0.08	0.86	1196	1034	-162
0023	3T	126	4777	274	477700	420370	-57330	0.06	0.88	845	744	-101
0023	3T	132	85	6	8500	5470	-3030	0.07	0.64	15	9	-6
0023	3T	134	4796	449	479600	358790	-120810	0.09	0.75	848	635	-213
0023	3T	135	4202	327	420200	314590	-105610	0.08	0.75	743	556	-187
0023	3T	136	2657	169	265700	221200	-44500	0.06	0.83	470	391	-79
0023	3T	142	71	4	7100	3330	-3770	0.06	0.47	12	5	-7
0023	3T	143	139	9	13900	13420	-480	0.06	0.97	24	23	-1
0023	3T	145	1395	78	139500	92850	-46650	0.06	0.67	246	164	-82
0023	3T	146	1025	56	102500	82130	-20370	0.05	0.80	181	145	-36
0023	3T	152	27	1	2700	1160	-1540	0.04	0.43	4	2	-2
0023	3T	153	68	2	6800	2260	-4540	0.03	0.33	12	4	-8
0023	3T	154	56	4	5600	5860	260	0.07	1.05	9	10	1
0023	3T	156	406	23	40600	36950	-3650	0.06	0.91	71	65	-6
0023	3T	162	2	0	200	0	-200	0.00	0.00	0	0	0
0023	3T	163	48	2	4800	1700	-3100	0.04	0.35	8	3	-5
0023	3T	164	37	3	3700	5230	1530	0.08	1.41	6	9	3
0023	3T	165	25	2	2500	2530	30	0.08	1.01	4	4	0
0023	3T	213	50	0	5000	0	-5000	0.00	0.00	8	0	-8
0023	3T	214	58	4	5800	7230	1430	0.07	1.25	10	12	2
0023	3T	215	90	2	9000	4330	-4670	0.02	0.48	15	7	-8
0023	3T	216	174	4	17400	15860	-1540	0.02	0.91	30	28	-2
0023	3T	234	103	4	10300	5880	-4420	0.04	0.57	18	10	-8
0023	3T	235	182	6	18200	5150	-13050	0.03	0.28	32	9	-23
0023	3T	236	150	11	15000	14070	-930	0.07	0.94	26	24	-2
0023	3T	241	1	0	100	0	-100	0.00	0.00	0	0	0
0023	3T	243	20	0	2000	0	-2000	0.00	0.00	3	0	-3
0023	3T	245	121	3	12100	7990	-4110	0.02	0.66	21	14	-7
0023	3T	246	130	7	13000	17770	4770	0.05	1.37	23	31	8
0023	3T	253	8	2	800	2680	1880	0.25	3.35	1	4	3
0023	3T	254	1	0	100	0	-100	0.00	0.00	0	0	0
0023	3T	256	61	3	6100	5150	-950	0.05	0.84	10	9	-1
0023	3T	261	2	0	200	0	-200	0.00	0.00	0	0	0
0023	3T	263	26	0	2600	0	-2600	0.00	0.00	4	0	-4
0023	3T	264	3	0	300	0	-300	0.00	0.00	0	0	0
0023	3T	265	2	0	200	0	-200	0.00	0.00	0	0	0
0024	1T	1	67548	38697	6754800	6207670	-547130	0.57	0.92	11955	10987	-968
0024	1T	2	5710	2196	571000	509820	-61180	0.38	0.89	1010	902	-108
0024	2F	12	38199	12407	3819900	3229250	-590650	0.32	0.85	6760	5715	-1045
0024	2F	13	15829	4871	1582900	1256110	-326790	0.31	0.79	2801	2223	-578
0024	2F	14	8619	2361	861900	668570	-193330	0.27	0.78	1525	1183	-342
0024	2F	15	2234	500	223400	205920	-17480	0.22	0.92	395	364	-31
0024	2F	16	1719	333	171900	166410	-5490	0.19	0.97	304	294	-10
0024	2F	23	316	66	31600	24520	-7080	0.21	0.78	55	43	-12
0024	2F	24	283	54	28300	18960	-9340	0.19	0.67	50	33	-17
0024	2F	25	252	39	25200	15960	-9240	0.15	0.63	44	28	-16
0024	2F	26	339	61	33900	33170	-730	0.18	0.98	60	58	-2
0024	2T	12	38152	9292	3815200	3109990	-705210	0.24	0.82	6752	5504	-1248
0024	2T	13	15829	3535	1582900	1233240	-349660	0.22	0.78	2801	2182	-619
0024	2T	14	8619	1696	861900	685420	-176480	0.20	0.80	1525	1213	-312
0024	2T	15	2234	343	223400	207730	-15670	0.15	0.93	395	367	-28
0024	2T	16	1719	238	171900	177340	5440	0.14	1.03	304	313	9
0024	2T	21	47	3	4700	3380	-1320	0.06	0.72	8	5	-3
0024	2T	23	316	38	31600	24900	-6700	0.12	0.79	55	44	-11
0024	2T	24	283	26	28300	15710	-12590	0.09	0.56	50	27	-23
0024	2T	25	252	28	25200	17800	-7400	0.11	0.71	44	31	-13
0024	2T	26	339	37	33900	31390	-2510	0.11	0.93	60	55	-5
0024	3F	123	9610	2520	961000	769610	-191390	0.26	0.80	1700	1362	-338
0024	3F	124	15772	3293	1577200	1182350	-394850	0.21	0.75	2791	2092	-699
0024	3F	125	6037	1075	603700	497330	-106370	0.18	0.82	1068	880	-188
0024	3F	126	5377	773	537700	454760	-82940	0.14	0.85	951	804	-147
0024	3F	134	5052	1137	505200	383500	-121700	0.23	0.76	894	678	-216
0024	3F	135	3401	639	340100	238850	-101250	0.19	0.70	601	422	-179
0024	3F	136	3327	526	332700	262620	-70080	0.16	0.79	588	464	-124
0024	3F	145	1387	264	138700	111840	-26860	0.19	0.81	245	197	-48
0024	3F	146	1176	151	117600	79140	-38460	0.13	0.67	208	140	-68
0024	3F	156	392	57	39200	38820	-380	0.15	0.99	69	68	-1
0024	3F	234	65	11	6500	5510	-990	0.17	0.85	11	9	-2
0024	3F	235	62	10	6200	3300	-2900	0.16	0.53	10	5	-5
0024	3F	236	98	14	9800	10470	670	0.14	1.07	17	18	1
0024	3F	245	47	6	4700	2110	-2590	0.13	0.45	8	3	-5
0024	3F	246	65	4	6500	1220	-5280	0.06	0.19	11	2	-9
0024	3F	256	43	6	4300	2230	-2070	0.14	0.52	7	3	-4
0024	3T	123	9372	1085	937200	783220	-153980	0.12	0.84	1658	1386	-272
0024	3T	124	15662	1368	1566200	1182210	-383990	0.09	0.75	2772	2092	-680
0024	3T	125	6027	450	602700	529140	-73560	0.07	0.88	1066	936	-130
0024	3T	126	5331	305	533100	457350	-75750	0.06	0.86	943	809	-134
0024	3T	132	237	25	23700	17100	-6600	0.11	0.72	41	30	-11
0024	3T	134	4940	489	494000	402750	-91250	0.10	0.82	874	712	-162
0024	3T	135	3368	255	336800	248140	-88660	0.08	0.74	596	439	-157
0024	3T	136	3306	220	330600	272570	-58030	0.07	0.82	585	482	-103
0024	3T	142	100	5	10000	6500	-3500	0.05	0.65	17	11	-6
0024	3T	143	112	8	11200	13300	2100	0.07	1.19	19	23	4
0024	3T	145	1372	94	137200	127200	-10000	0.07	0.93	242	225	-17
0024	3T	146	1148	55	114800	74970	-39830	0.05	0.65	203	132	-71
0024	3T	152	10	1	1000	1160	160	0.10	1.16	1	2	1
0024	3T	153	33	4	3300	6260	2960	0.12	1.90	5	11	6
0024	3T	154	15	3	1500	4590	3090	0.20	3.06	2	8	6
0024	3T	156	368	17	36800	30150	-6650	0.05	0.82	65	53	-12
0024	3T	162	11	0	1100	0	-1100	0.00	0.00	1	0	-1
0024	3T	163	21	3	2100	22080	19980	0.14	10.51	3	39	36
0024	3T	164	28	1	2800	1700	-1100	0.04	0.61	4	3	-1
0024	3T	165	24	0	2400	0	-2400	0.00	0.00	4	0	-4
0024	3T	213	1	0	100	0	-100	0.00	0.00	0	0	0
0024	3T	214	10	0	1000	0	-1000	0.00	0.00	1	0	-1
0024	3T	216	35	2	3500	11500	8000	0.06	3.29	6	20	14
0024	3T	234	64	2	6400	1710	-4690	0.03	0.27	11	3	-8
0024	3T	235	57	2	5700	2210	-3490	0.04	0.39	10	3	-7
0024	3T	236	96	5	9600	9130	-470	0.05	0.95	16	16	0
0024	3T	243	1	0	100	0	-100	0.00	0.00	0	0	0
0024	3T	245	44	2	4400	3010	-1390	0.05	0.68	7	5	-2
0024	3T	246	62	1	6200	390	-5810	0.02	0.06	10	0	-10
0024	3T	253	5	1	500	960	460	0.20	1.92	0	1	1
0024	3T	254	3	0	300	0	-300	0.00	0.00	0	0	0
0024	3T	256	39	2	3900	1440	-2460	0.05	0.37	6	2	-4
0024	3T	263	2	0	200	0	-200	0.00	0.00	0	0	0
0024	3T	264	3	0	300	0	-300	0.00	0.00	0	0	0
0024	3T	265	4	0	400	0	-400	0.00	0.00	0	0	0
0045	1T	1	21741	15254	2174100	1970290	-203810	0.70	0.91	3847	3487	-360
0045	1T	2	10128	3298	1012800	865850	-146950	0.33	0.85	1792	1532	-260
0045	2F	12	8362	3146	836200	687280	-148920	0.38	0.82	1480	1216	-264
0045	2F	13	5571	1775	557100	473130	-83970	0.32	0.85	986	837	-149
0045	2F	14	4458	1042	445800	352690	-93110	0.23	0.79	789	624	-165
0045	2F	15	3359	453	335900	263350	-72550	0.13	0.78	594	466	-128
0045	2F	16	1803	208	180300	159610	-20690	0.12	0.89	319	282	-37
0045	2F	23	603	81	60300	34460	-25840	0.13	0.57	106	60	-46
0045	2F	24	1638	208	163800	115220	-48580	0.13	0.70	289	203	-86
0045	2F	25	2269	218	226900	151630	-75270	0.10	0.67	401	268	-133
0045	2F	26	2175	163	217500	151800	-65700	0.07	0.70	384	268	-116
0045	2T	12	7283	2267	728300	576390	-151910	0.31	0.79	1289	1020	-269
0045	2T	13	4947	1279	494700	388360	-106340	0.26	0.79	875	687	-188
0045	2T	14	4232	821	423200	324510	-98690	0.19	0.77	749	574	-175
0045	2T	15	3226	361	322600	255330	-67270	0.11	0.79	570	451	-119
0045	2T	16	1680	171	168000	151050	-16950	0.10	0.90	297	267	-30
0045	2T	21	1079	144	107900	96140	-11760	0.13	0.89	190	170	-20
0045	2T	23	521	43	52100	27340	-24760	0.08	0.52	92	48	-44
0045	2T	24	1405	120	140500	93250	-47250	0.09	0.66	248	165	-83
0045	2T	25	2071	154	207100	146740	-60360	0.07	0.71	366	259	-107
0045	2T	26	1944	116	194400	138840	-55560	0.06	0.71	344	245	-99
0045	3F	123	2006	591	200600	168030	-32570	0.29	0.84	355	297	-58
0045	3F	124	3502	772	350200	261620	-88580	0.22	0.75	619	463	-156
0045	3F	125	2164	330	216400	166570	-49830	0.15	0.77	383	294	-89
0045	3F	126	2824	281	282400	222730	-59670	0.10	0.79	499	394	-105
0045	3F	134	2178	451	217800	175640	-42160	0.21	0.81	385	310	-75
0045	3F	135	1673	211	167300	128990	-38310	0.13	0.77	296	228	-68
0045	3F	136	1761	170	176100	136380	-39720	0.10	0.77	311	241	-70
0045	3F	145	1451	158	145100	109390	-35710	0.11	0.75	256	193	-63
0045	3F	146	1445	117	144500	107890	-36610	0.08	0.75	255	190	-65
0045	3F	156	1118	51	111800	78720	-33080	0.05	0.70	197	139	-58
0045	3F	234	108	7	10800	11320	520	0.06	1.05	19	20	1
0045	3F	235	107	5	10700	6600	-4100	0.05	0.62	18	11	-7
0045	3F	236	143	5	14300	8520	-5780	0.03	0.60	25	15	-10
0045	3F	245	159	6	15900	7710	-8190	0.04	0.48	28	13	-15
0045	3F	246	206	9	20600	6580	-14020	0.04	0.32	36	11	-25
0045	3F	256	294	12	29400	10430	-18970	0.04	0.35	52	18	-34
0045	3T	123	1398	215	139800	124450	-15350	0.15	0.89	247	220	-27
0045	3T	124	2384	257	238400	174430	-63970	0.11	0.73	421	308	-113
0045	3T	125	1002	97	100200	76000	-24200	0.10	0.76	177	134	-43
0045	3T	126	1861	107	186100	161990	-24110	0.06	0.87	329	286	-43
0045	3T	132	293	34	29300	23100	-6200	0.12	0.79	51	40	-11
0045	3T	134	1363	156	136300	126480	-9820	0.11	0.93	241	223	-18
0045	3T	135	913	63	91300	66000	-25300	0.07	0.72	161	116	-45
0011	1T	1	62085	36091	6208500	5763470	-445030	0.58	0.93	10988	10200	-788
0011	1T	2	6714	2110	671400	630080	-41320	0.31	0.94	1188	1115	-73
0011	2F	12	25955	7971	2595500	2264740	-330760	0.31	0.87	4593	4008	-585
0011	2F	13	15200	3744	1520000	1281780	-238220	0.25	0.84	2690	2268	-422
0011	2F	14	9313	1875	931300	718430	-212870	0.20	0.77	1648	1271	-377
0011	2F	15	3557	503	355700	291040	-64660	0.14	0.82	629	515	-114
0011	2F	16	1862	251	186200	183120	-3080	0.13	0.98	329	324	-5
0011	2F	23	1320	154	132000	89120	-42880	0.12	0.68	233	157	-76
0011	2F	24	770	99	77000	86910	9910	0.13	1.13	136	153	17
0011	2F	25	544	55	54400	42230	-12170	0.10	0.78	96	74	-22
0011	2F	26	403	43	40300	29190	-11110	0.11	0.72	71	51	-20
0011	2T	12	23908	5646	2390800	2017710	-373090	0.24	0.84	4231	3571	-660
0011	2T	13	15200	2892	1520000	1290400	-229600	0.19	0.85	2690	2283	-407
0011	2T	14	9313	1438	931300	702580	-228720	0.15	0.75	1648	1243	-405
0011	2T	15	3557	377	355700	304840	-50860	0.11	0.86	629	539	-90
0011	2T	16	1862	180	186200	187690	1490	0.10	1.01	329	332	3
0011	2T	21	2047	287	204700	212620	7920	0.14	1.04	362	376	14
0011	2T	23	1320	95	132000	94870	-37130	0.07	0.72	233	167	-66
0011	2T	24	770	66	77000	82650	5650	0.09	1.07	136	146	10
0011	2T	25	544	38	54400	42580	-11820	0.07	0.78	96	75	-21
0011	2T	26	403	28	40300	36660	-3640	0.07	0.91	71	64	-7
0011	3F	123	11530	2469	1153000	998400	-154600	0.21	0.87	2040	1767	-273
0011	3F	124	9016	1594	901600	710280	-191320	0.18	0.79	1595	1257	-338
0011	3F	125	5127	676	512700	420590	-92110	0.13	0.82	907	744	-163
0011	3F	126	3754	406	375400	325520	-49880	0.11	0.87	664	576	-88
0011	3F	134	6092	935	609200	502310	-106890	0.15	0.82	1078	889	-189
0011	3F	135	3454	387	345400	270130	-75270	0.11	0.78	611	478	-133
0011	3F	136	2481	231	248100	183480	-64620	0.09	0.74	439	324	-115
0011	3F	145	2322	226	232200	186500	-45700	0.10	0.80	410	330	-80
0011	3F	146	1455	115	145500	113680	-31820	0.08	0.78	257	201	-56
0011	3F	156	716	59	71600	63660	-7940	0.08	0.89	126	112	-14
0011	3F	234	481	50	48100	32900	-15200	0.10	0.68	85	58	-27
0011	3F	235	381	42	38100	27790	-10310	0.11	0.73	67	49	-18
0011	3F	236	299	30	29900	29010	-890	0.10	0.97	52	51	-1
0011	3F	245	244	12	24400	18560	-5840	0.05	0.76	43	32	-11
0011	3F	246	189	8	18900	5260	-13640	0.04	0.28	33	9	-24
0011	3F	256	157	9	15700	6790	-8910	0.06	0.43	27	12	-15
0011	3T	123	7111	741	711100	708110	-2990	0.10	1.00	1258	1253	-5
0011	3T	124	6179	502	617900	535750	-82150	0.08	0.87	1093	948	-145
0011	3T	125	3953	242	395300	360020	-35280	0.06	0.91	699	637	-62
0011	3T	126	2977	152	297700	264070	-33630	0.05	0.89	526	467	-59
0011	3T	132	3783	253	378300	325620	-52680	0.07	0.86	669	576	-93
0011	3T	134	3863	283	386300	400630	14330	0.07	1.04	683	709	26
0011	3T	135	2616	122	261600	187890	-73710	0.05	0.72	463	332	-131
0011	3T	136	2042	74	204200	141720	-62480	0.04	0.69	361	250	-111
0011	3T	142	2248	126	224800	168440	-56360	0.06	0.75	397	298	-99
0011	3T	143	2229	101	222900	183160	-39740	0.05	0.82	394	324	-70
0011	3T	145	1628	59	162800	100110	-62690	0.04	0.61	288	177	-111
0011	3T	146	1131	42	113100	78770	-34330	0.04	0.70	200	139	-61
0011	3T	152	769	31	76900	62650	-14250	0.04	0.81	136	110	-26
0011	3T	153	838	21	83800	38370	-45430	0.03	0.46	148	67	-81
0011	3T	154	694	18	69400	68480	-920	0.03	0.99	122	121	-1
0011	3T	156	486	14	48600	38650	-9950	0.03	0.80	86	68	-18
0011	3T	162	392	14	39200	67250	28050	0.04	1.72	69	119	50
0011	3T	163	439	17	43900	31570	-12330	0.04	0.72	77	55	-22
0011	3T	164	324	9	32400	37210	4810	0.03	1.15	57	65	8
0011	3T	165	230	6	23000	39700	16700	0.03	1.73	40	70	30
0011	3T	213	479	31	47900	47360	-540	0.06	0.99	84	83	-1
0011	3T	214	479	21	47900	37510	-10390	0.04	0.78	84	66	-18
0011	3T	215	336	12	33600	21240	-12360	0.04	0.63	59	37	-22
0011	3T	216	337	13	33700	34590	890	0.04	1.03	59	61	2
0011	3T	231	157	3	15700	6310	-9390	0.02	0.40	27	11	-16
0011	3T	234	311	7	31100	17110	-13990	0.02	0.55	55	30	-25
0011	3T	235	256	6	25600	12500	-13100	0.02	0.49	45	22	-23
0011	3T	236	214	7	21400	46390	24990	0.03	2.17	37	82	45
0011	3T	241	110	1	11000	1010	-9990	0.01	0.09	19	1	-18
0011	3T	243	170	8	17000	17660	660	0.05	1.04	30	31	1
0011	3T	245	143	1	14300	72950	58650	0.01	5.10	25	129	104
0011	3T	246	123	3	12300	6350	-5950	0.02	0.52	21	11	-10
0011	3T	251	69	0	6900	0	-6900	0.00	0.00	12	0	-12
0011	3T	253	125	3	12500	8610	-3890	0.02	0.69	22	15	-7
0011	3T	254	101	1	10100	5630	-4470	0.01	0.56	17	9	-8
0011	3T	256	96	0	9600	0	-9600	0.00	0.00	16	0	-16
0011	3T	261	48	2	4800	16730	11930	0.04	3.49	8	29	21
0011	3T	263	85	3	8500	10520	2020	0.04	1.24	15	18	3
0011	3T	264	66	1	6600	2820	-3780	0.02	0.43	11	4	-7
0011	3T	265	61	0	6100	0	-6100	0.00	0.00	10	0	-10
0037	1T	1	67030	38572	6703000	6161870	-541130	0.58	0.92	11863	10905	-958
0037	1T	2	5878	2318	587800	542810	-44990	0.39	0.92	1040	960	-80
0037	2F	12	38547	12502	3854700	3263120	-591580	0.32	0.85	6822	5775	-1047
0037	2F	13	15622	4848	1562200	1248500	-313700	0.31	0.80	2764	2209	-555
0037	2F	14	8338	2295	833800	627900	-205900	0.28	0.75	1475	1111	-364
0037	2F	15	1906	414	190600	152550	-38050	0.22	0.80	337	270	-67
0037	2F	16	1667	316	166700	148670	-18030	0.19	0.89	295	263	-32
0037	2F	23	369	75	36900	24980	-11920	0.20	0.68	65	44	-21
0037	2F	24	325	67	32500	27410	-5090	0.21	0.84	57	48	-9
0037	2F	25	263	39	26300	15580	-10720	0.15	0.59	46	27	-19
0037	2F	26	361	57	36100	26850	-9250	0.16	0.74	63	47	-16
0037	2T	12	38463	9347	3846300	3127070	-719230	0.24	0.81	6807	5534	-1273
0037	2T	13	15622	3467	1562200	1196970	-365230	0.22	0.77	2764	2118	-646
0037	2T	14	8338	1650	833800	646690	-187110	0.20	0.78	1475	1144	-331
0037	2T	15	1906	282	190600	149640	-40960	0.15	0.79	337	264	-73
0037	2T	16	1667	218	166700	151060	-15640	0.13	0.91	295	267	-28
0037	2T	21	84	10	8400	9740	1340	0.12	1.16	14	17	3
0037	2T	23	369	33	36900	19390	-17510	0.09	0.53	65	34	-31
0037	2T	24	325	44	32500	29190	-3310	0.14	0.90	57	51	-6
0037	2T	25	263	23	26300	16040	-10260	0.09	0.61	46	28	-18
0037	2T	26	361	31	36100	25750	-10350	0.09	0.71	63	45	-18
0037	3F	123	9324	2354	932400	762210	-170190	0.25	0.82	1650	1349	-301
0037	3F	124	16244	3340	1624400	1245790	-378610	0.21	0.77	2875	2204	-671
0021	1T	1	61576	36899	6157600	5676480	-481120	0.60	0.92	10898	10046	-852
0021	1T	2	8446	3177	844600	777100	-67500	0.38	0.92	1494	1375	-119
0021	2F	12	32911	11114	3291100	2822620	-468480	0.34	0.86	5824	4995	-829
0021	2F	13	16253	5036	1625300	1328730	-296570	0.31	0.82	2876	2351	-525
0021	2F	14	7846	2249	784600	600970	-183630	0.29	0.77	1388	1063	-325
0021	2F	15	1999	461	199900	164320	-35580	0.23	0.82	353	290	-63
0021	2F	16	1446	287	144600	134740	-9860	0.20	0.93	255	238	-17
0021	2F	23	666	153	66600	57300	-9300	0.23	0.86	117	101	-16
0021	2F	24	554	114	55400	48260	-7140	0.21	0.87	98	85	-13
0021	2F	25	362	55	36200	27320	-8880	0.15	0.75	64	48	-16
0021	2F	26	496	78	49600	36910	-12690	0.16	0.74	87	65	-22
0021	2T	12	32250	8356	3225000	2667310	-557690	0.26	0.83	5707	4720	-987
0021	2T	13	16253	3667	1625300	1267840	-357460	0.23	0.78	2876	2243	-633
0021	2T	14	7846	1639	784600	614090	-170510	0.21	0.78	1388	1086	-302
0021	2T	15	1999	332	199900	174060	-25840	0.17	0.87	353	308	-45
0021	2T	16	1446	201	144600	138120	-6480	0.14	0.96	255	244	-11
0021	2T	21	661	75	66100	61230	-4870	0.11	0.93	116	108	-8
0021	2T	23	666	95	66600	57980	-8620	0.14	0.87	117	102	-15
0021	2T	24	554	65	55400	41320	-14080	0.12	0.75	98	73	-25
0021	2T	25	362	32	36200	28770	-7430	0.09	0.79	64	50	-14
0021	2T	26	496	45	49600	33110	-16490	0.09	0.67	87	58	-29
0021	3F	123	8654	2214	865400	716290	-149110	0.26	0.83	1531	1267	-264
0021	3F	124	11065	2365	1106500	820120	-286380	0.21	0.74	1958	1451	-507
0021	3F	125	5934	1081	593400	461350	-132050	0.18	0.78	1050	816	-234
0021	3F	126	6120	873	612000	540820	-71180	0.14	0.88	1083	957	-126
0021	3F	134	4879	1048	487900	372730	-115170	0.21	0.76	863	659	-204
0021	3F	135	3537	655	353700	256460	-97240	0.19	0.73	626	453	-173
0021	3F	136	3363	446	336300	252570	-83730	0.13	0.75	595	447	-148
0021	3F	145	1594	273	159400	110650	-48750	0.17	0.69	282	195	-87
0021	3F	146	1341	184	134100	113520	-20580	0.14	0.85	237	200	-37
0021	3F	156	435	60	43500	31210	-12290	0.14	0.72	76	55	-21
0021	3F	234	134	27	13400	11730	-1670	0.20	0.88	23	20	-3
0021	3F	235	227	42	22700	17100	-5600	0.19	0.75	40	30	-10
0021	3F	236	199	33	19900	20170	270	0.17	1.01	35	35	0
0021	3F	245	178	24	17800	9860	-7940	0.13	0.55	31	17	-14
0021	3F	246	142	17	14200	9700	-4500	0.12	0.68	25	17	-8
0021	3F	256	91	11	9100	6360	-2740	0.12	0.70	16	11	-5
0021	3T	123	8601	1000	860100	718400	-141700	0.12	0.84	1522	1271	-251
0021	3T	124	10933	1010	1093300	798780	-294520	0.09	0.73	1935	1413	-522
0021	3T	125	5778	448	577800	458940	-118860	0.08	0.79	1022	812	-210
0021	3T	126	5724	365	572400	547360	-25040	0.06	0.96	1013	968	-45
0021	3T	132	36	2	3600	1860	-1740	0.06	0.52	6	3	-3
0021	3T	134	4634	423	463400	361440	-101960	0.09	0.78	820	639	-181
0021	3T	135	3519	277	351900	257750	-94150	0.08	0.73	622	456	-166
0021	3T	136	3347	212	334700	289980	-44720	0.06	0.87	592	513	-79
0021	3T	142	39	7	3900	5170	1270	0.18	1.33	6	9	3
0021	3T	143	245	18	24500	24170	-330	0.07	0.99	43	42	-1
0021	3T	145	1567	93	156700	114380	-42320	0.06	0.73	277	202	-75
0021	3T	146	1326	67	132600	100340	-32260	0.05	0.76	234	177	-57
0021	3T	152	1	0	100	0	-100	0.00	0.00	0	0	0
0021	3T	153	18	0	1800	0	-1800	0.00	0.00	3	0	-3
0021	3T	154	27	4	2700	4830	2130	0.15	1.79	4	8	4
0021	3T	156	427	24	42700	39890	-2810	0.06	0.93	75	70	-5
0021	3T	163	16	0	1600	0	-1600	0.00	0.00	2	0	-2
0021	3T	164	15	2	1500	2120	620	0.13	1.41	2	3	1
0021	3T	165	8	0	800	0	-800	0.00	0.00	1	0	-1
0021	3T	213	17	1	1700	560	-1140	0.06	0.33	3	0	-3
0021	3T	214	93	4	9300	4310	-4990	0.04	0.46	16	7	-9
0021	3T	215	155	6	15500	14490	-1010	0.04	0.93	27	25	-2
0021	3T	216	396	14	39600	46560	6960	0.04	1.18	70	82	12
0021	3T	234	134	8	13400	11510	-1890	0.06	0.86	23	20	-3
0021	3T	235	226	12	22600	19560	-3040	0.05	0.87	40	34	-6
0021	3T	236	198	13	19800	17230	-2570	0.07	0.87	35	30	-5
0021	3T	245	178	6	17800	8620	-9180	0.03	0.48	31	15	-16
0021	3T	246	142	3	14200	5670	-8530	0.02	0.40	25	10	-15
0021	3T	253	1	0	100	0	-100	0.00	0.00	0	0	0
0021	3T	256	89	1	8900	8720	-180	0.01	0.98	15	15	0
0021	3T	263	1	0	100	0	-100	0.00	0.00	0	0	0
0021	3T	265	2	0	200	0	-200	0.00	0.00	0	0	0
0037	3F	125	6075	1071	607500	497080	-110420	0.18	0.82	1075	879	-196
0037	3F	126	5487	737	548700	451530	-97170	0.13	0.82	971	799	-172
0037	3F	134	6244	1366	624400	493140	-131260	0.22	0.79	1105	872	-233
0037	3F	135	3234	616	323400	234730	-88670	0.19	0.73	572	415	-157
0037	3F	136	3149	457	314900	243800	-71100	0.15	0.77	557	431	-126
0037	3F	145	1290	233	129000	90410	-38590	0.18	0.70	228	160	-68
0037	3F	146	1160	167	116000	86480	-29520	0.14	0.75	205	153	-52
0037	3F	156	348	60	34800	32700	-2100	0.17	0.94	61	57	-4
0037	3F	234	108	22	10800	8040	-2760	0.20	0.74	19	14	-5
0037	3F	235	67	21	6700	6900	200	0.31	1.03	11	12	1
0037	3F	236	115	14	11500	8270	-3230	0.12	0.72	20	14	-6
0037	3F	245	46	3	4600	970	-3630	0.07	0.21	8	1	-7
0037	3F	246	77	8	7700	2640	-5060	0.10	0.34	13	4	-9
0037	3F	256	48	10	4800	5640	840	0.21	1.18	8	9	1
0037	3T	123	9211	1047	921100	783910	-137190	0.11	0.85	1630	1387	-243
0037	3T	124	16171	1411	1617100	1219640	-397460	0.09	0.75	2862	2158	-704
0037	3T	125	6052	442	605200	540470	-64730	0.07	0.89	1071	956	-115
0037	3T	126	5420	278	542000	415720	-126280	0.05	0.77	959	735	-224
0037	3T	132	112	9	11200	8000	-3200	0.08	0.71	19	14	-5
0037	3T	134	6188	590	618800	500300	-118500	0.10	0.81	1095	885	-210
0037	3T	135	3195	249	319500	234870	-84630	0.08	0.74	565	415	-150
0037	3T	136	3125	186	312500	236350	-76150	0.06	0.76	553	418	-135
0037	3T	142	56	2	5600	5540	-60	0.04	0.99	9	9	0
0037	3T	143	56	6	5600	13200	7600	0.11	2.36	9	23	14
0037	3T	145	1256	65	125600	72620	-52980	0.05	0.58	222	128	-94
0037	3T	146	1136	56	113600	74080	-39520	0.05	0.65	201	131	-70
0037	3T	152	16	0	1600	0	-1600	0.00	0.00	2	0	-2
0037	3T	153	39	1	3900	1420	-2480	0.03	0.36	6	2	-4
0016	1T	1	62361	37085	6236100	5749680	-486420	0.59	0.92	11037	10176	-861
0016	1T	2	8071	3047	807100	738250	-68850	0.38	0.91	1428	1306	-122
0016	2F	12	30384	10439	3038400	2572980	-465420	0.34	0.85	5377	4553	-824
0016	2F	13	17133	5356	1713300	1380470	-332830	0.31	0.81	3032	2443	-589
0016	2F	14	8594	2475	859400	655790	-203610	0.29	0.76	1521	1160	-361
0016	2F	15	2157	506	215700	178510	-37190	0.23	0.83	381	315	-66
0016	2F	16	1729	343	172900	149050	-23850	0.20	0.86	306	263	-43
0016	2F	23	552	120	55200	43050	-12150	0.22	0.78	97	76	-21
0016	2F	24	437	104	43700	42150	-1550	0.24	0.96	77	74	-3
0016	2F	25	286	44	28600	20760	-7840	0.15	0.73	50	36	-14
0016	2F	26	340	53	34000	24970	-9030	0.16	0.73	60	44	-16
0016	2T	12	30168	7889	3016800	2462520	-554280	0.26	0.82	5339	4358	-981
0016	2T	13	17133	3894	1713300	1331710	-381590	0.23	0.78	3032	2357	-675
0016	2T	14	8594	1814	859400	670740	-188660	0.21	0.78	1521	1187	-334
0016	2T	15	2157	364	215700	184030	-31670	0.17	0.85	381	325	-56
0016	2T	16	1729	245	172900	156840	-16060	0.14	0.91	306	277	-29
0016	2T	21	216	22	21600	19940	-1660	0.10	0.92	38	35	-3
0016	2T	23	552	69	55200	43650	-11550	0.13	0.79	97	77	-20
0016	2T	24	437	58	43700	42180	-1520	0.13	0.97	77	74	-3
0016	2T	25	286	28	28600	26660	-1940	0.10	0.93	50	47	-3
0016	2T	26	340	29	34000	21640	-12360	0.09	0.64	60	38	-22
0016	3F	123	4389	1293	438900	358210	-80690	0.29	0.82	776	634	-142
0016	3F	124	11162	2445	1116200	818830	-297370	0.22	0.73	1975	1449	-526
0016	3F	125	5882	1101	588200	463710	-124490	0.19	0.79	1041	820	-221
0016	3F	126	7614	981	761400	652440	-108960	0.13	0.86	1347	1154	-193
0016	3F	134	5314	1183	531400	406350	-125050	0.22	0.76	940	719	-221
0016	3F	135	4003	730	400300	290410	-109890	0.18	0.73	708	514	-194
0016	3F	136	4557	575	455700	333440	-122260	0.13	0.73	806	590	-216
0016	3F	145	1599	296	159900	125710	-34190	0.19	0.79	283	222	-61
0016	3F	146	1452	219	145200	127920	-17280	0.15	0.88	256	226	-30
0016	3F	156	401	63	40100	36090	-4010	0.16	0.90	70	63	-7
0016	3F	234	133	28	13300	12220	-1080	0.21	0.92	23	21	-2
0016	3F	235	154	27	15400	10860	-4540	0.18	0.71	27	19	-8
0016	3F	236	158	17	15800	7680	-8120	0.11	0.49	27	13	-14
0016	3F	245	117	16	11700	8130	-3570	0.14	0.69	20	14	-6
0016	3F	246	95	9	9500	4890	-4610	0.09	0.51	16	8	-8
0016	3F	256	48	4	4800	1540	-3260	0.08	0.32	8	2	-6
0016	3T	123	4231	588	423100	354860	-68240	0.14	0.84	748	628	-120
0016	3T	124	11113	1071	1111300	813720	-297580	0.10	0.73	1966	1440	-526
0016	3T	125	5824	471	582400	469770	-112630	0.08	0.81	1030	831	-199
0016	3T	126	7497	436	749700	685280	-64420	0.06	0.91	1326	1212	-114
0016	3T	132	147	9	14700	8080	-6620	0.06	0.55	26	14	-12
0016	3T	134	5268	505	526800	422040	-104760	0.10	0.80	932	746	-186
0016	3T	135	3977	312	397700	298330	-99370	0.08	0.75	703	528	-175
0016	3T	136	4537	260	453700	346160	-107540	0.06	0.76	803	612	-191
0016	3T	142	7	0	700	0	-700	0.00	0.00	1	0	-1
0016	3T	143	46	4	4600	4570	-30	0.09	0.99	8	8	0
0016	3T	145	1546	97	154600	112010	-42590	0.06	0.72	273	198	-75
0016	3T	146	1424	88	142400	117440	-24960	0.06	0.82	252	207	-45
0016	3T	152	15	1	1500	1160	-340	0.07	0.77	2	2	0
0016	3T	153	26	0	2600	0	-2600	0.00	0.00	4	0	-4
0016	3T	154	53	4	5300	5020	-280	0.08	0.95	9	8	-1
0016	3T	156	395	22	39500	35720	-3780	0.06	0.90	69	63	-6
0016	3T	162	1	0	100	0	-100	0.00	0.00	0	0	0
0016	3T	163	20	0	2000	0	-2000	0.00	0.00	3	0	-3
0016	3T	164	28	3	2800	3200	400	0.11	1.14	4	5	1
0016	3T	165	6	0	600	0	-600	0.00	0.00	1	0	-1
0016	3T	213	11	0	1100	0	-1100	0.00	0.00	1	0	-1
0016	3T	214	42	3	4200	3080	-1120	0.07	0.73	7	5	-2
0016	3T	215	43	1	4300	1530	-2770	0.02	0.36	7	2	-5
0016	3T	216	116	2	11600	8470	-3130	0.02	0.73	20	14	-6
0016	3T	234	133	7	13300	10540	-2760	0.05	0.79	23	18	-5
0016	3T	235	153	8	15300	11880	-3420	0.05	0.78	27	21	-6
0016	3T	236	156	7	15600	8370	-7230	0.04	0.54	27	14	-13
0016	3T	245	115	3	11500	8110	-3390	0.03	0.71	20	14	-6
0016	3T	246	94	4	9400	8090	-1310	0.04	0.86	16	14	-2
0037	3T	154	34	0	3400	0	-3400	0.00	0.00	6	0	-6
0037	3T	156	341	19	34100	32400	-1700	0.06	0.95	60	57	-3
0037	3T	162	11	1	1100	1030	-70	0.09	0.94	1	1	0
0037	3T	163	24	1	2400	2880	480	0.04	1.20	4	5	1
0037	3T	164	24	1	2400	1700	-700	0.04	0.71	4	3	-1
0037	3T	165	7	0	700	0	-700	0.00	0.00	1	0	-1
0037	3T	213	1	0	100	0	-100	0.00	0.00	0	0	0
0037	3T	214	17	1	1700	1250	-450	0.06	0.74	3	2	-1
0037	3T	215	7	0	700	0	-700	0.00	0.00	1	0	-1
0037	3T	216	56	3	5600	15750	10150	0.05	2.81	9	27	18
0037	3T	234	108	3	10800	2950	-7850	0.03	0.27	19	5	-14
0037	3T	235	60	5	6000	9310	3310	0.08	1.55	10	16	6
0037	3T	236	114	4	11400	7520	-3880	0.04	0.66	20	13	-7
0037	3T	245	44	1	4400	860	-3540	0.02	0.20	7	1	-6
0037	3T	246	74	2	7400	1580	-5820	0.03	0.21	13	2	-11
0037	3T	253	7	1	700	960	260	0.14	1.37	1	1	0
0037	3T	254	2	0	200	0	-200	0.00	0.00	0	0	0
0037	3T	256	48	3	4800	6960	2160	0.06	1.45	8	12	4
0037	3T	263	1	0	100	0	-100	0.00	0.00	0	0	0
0037	3T	264	3	0	300	0	-300	0.00	0.00	0	0	0
0045	3T	136	1219	61	121900	106160	-15740	0.05	0.87	215	187	-28
0045	3T	142	199	16	19900	13040	-6860	0.08	0.66	35	23	-12
0045	3T	143	117	5	11700	4100	-7600	0.04	0.35	20	7	-13
0045	3T	145	654	35	65400	46520	-18880	0.05	0.71	115	82	-33
0045	3T	146	979	39	97900	72820	-25080	0.04	0.74	173	128	-45
0045	3T	152	52	3	5200	2870	-2330	0.06	0.55	9	5	-4
0045	3T	153	151	4	15100	15890	790	0.03	1.05	26	28	2
0045	3T	154	313	9	31300	31450	150	0.03	1.00	55	55	0
0045	3T	156	911	21	91100	78240	-12860	0.02	0.86	161	138	-23
0045	3T	162	61	1	6100	850	-5250	0.02	0.14	10	1	-9
0045	3T	163	78	7	7800	17270	9470	0.09	2.21	13	30	17
0038	1T	1	62981	37281	6298100	5810450	-487650	0.59	0.92	11147	10283	-864
0038	1T	2	7958	2982	795800	733660	-62140	0.37	0.92	1408	1298	-110
0038	2F	12	31611	10656	3161100	2671790	-489310	0.34	0.85	5594	4728	-866
0038	2F	13	17100	5225	1710000	1369850	-340150	0.31	0.80	3026	2424	-602
0038	2F	14	8511	2394	851100	654270	-196830	0.28	0.77	1506	1158	-348
0038	2F	15	1910	466	191000	158510	-32490	0.24	0.83	338	280	-58
0038	2F	16	1514	301	151400	123160	-28240	0.20	0.81	267	217	-50
0038	2F	23	689	155	68900	57460	-11440	0.22	0.83	121	101	-20
0038	2F	24	434	85	43400	36510	-6890	0.20	0.84	76	64	-12
0038	2F	25	213	36	21300	15080	-6220	0.17	0.71	37	26	-11
0038	2F	26	317	53	31700	24090	-7610	0.17	0.76	56	42	-14
0038	2T	12	31390	8035	3139000	2548090	-590910	0.26	0.81	5555	4509	-1046
0038	2T	13	17100	3769	1710000	1305310	-404690	0.22	0.76	3026	2310	-716
0038	2T	14	8511	1739	851100	654180	-196920	0.20	0.77	1506	1157	-349
0038	2T	15	1910	329	191000	159280	-31720	0.17	0.83	338	281	-57
0038	2T	16	1514	209	151400	130000	-21400	0.14	0.86	267	230	-37
0038	2T	21	221	21	22100	19150	-2950	0.10	0.87	39	33	-6
0038	2T	23	689	96	68900	62930	-5970	0.14	0.91	121	111	-10
0038	2T	24	434	51	43400	35400	-8000	0.12	0.82	76	62	-14
0038	2T	25	213	28	21300	21090	-210	0.13	0.99	37	37	0
0038	2T	26	317	30	31700	23190	-8510	0.09	0.73	56	41	-15
0038	3F	123	5001	1410	500100	407950	-92150	0.28	0.82	885	722	-163
0038	3F	124	11687	2567	1168700	884240	-284460	0.22	0.76	2068	1565	-503
0038	3F	125	5795	1046	579500	452260	-127240	0.18	0.78	1025	800	-225
0038	3F	126	8065	956	806500	675220	-131280	0.12	0.84	1427	1195	-232
0038	3F	134	5285	1162	528500	409780	-118720	0.22	0.78	935	725	-210
0038	3F	135	4052	746	405200	304010	-101190	0.18	0.75	717	538	-179
0038	3F	136	4601	574	460100	358960	-101140	0.12	0.78	814	635	-179
0038	3F	145	1710	297	171000	128680	-42320	0.17	0.75	302	227	-75
0038	3F	146	1433	202	143300	122480	-20820	0.14	0.85	253	216	-37
0038	3F	156	333	57	33300	27440	-5860	0.17	0.82	58	48	-10
0038	3F	234	137	27	13700	11370	-2330	0.20	0.83	24	20	-4
0038	3F	235	213	42	21300	19160	-2140	0.20	0.90	37	33	-4
0038	3F	236	199	32	19900	16180	-3720	0.16	0.81	35	28	-7
0038	3F	245	122	14	12200	5940	-6260	0.11	0.49	21	10	-11
0038	3F	246	86	5	8600	2910	-5690	0.06	0.34	15	5	-10
0038	3F	256	30	6	3000	4730	1730	0.20	1.58	5	8	3
0038	3T	123	4913	641	491300	412650	-78650	0.13	0.84	869	730	-139
0038	3T	124	11635	1113	1163500	882190	-281310	0.10	0.76	2059	1561	-498
0038	3T	125	5747	443	574700	465400	-109300	0.08	0.81	1017	823	-194
0038	3T	126	7934	420	793400	700000	-93400	0.05	0.88	1404	1238	-166
0038	3T	132	82	7	8200	5380	-2820	0.09	0.66	14	9	-5
0038	3T	134	5235	504	523500	421710	-101790	0.10	0.81	926	746	-180
0038	3T	135	4015	302	401500	287710	-113790	0.08	0.72	710	509	-201
0038	3T	136	4584	248	458400	344730	-113670	0.05	0.75	811	610	-201
0038	3T	142	8	0	800	0	-800	0.00	0.00	1	0	-1
0038	3T	143	50	2	5000	5840	840	0.04	1.17	8	10	2
0038	3T	145	1661	88	166100	100240	-65860	0.05	0.60	293	177	-116
0038	3T	146	1394	79	139400	108310	-31090	0.06	0.78	246	191	-55
0038	3T	152	14	0	1400	0	-1400	0.00	0.00	2	0	-2
0038	3T	153	37	3	3700	2910	-790	0.08	0.79	6	5	-1
0038	3T	154	49	3	4900	2210	-2690	0.06	0.45	8	3	-5
0038	3T	156	325	19	32500	29210	-3290	0.06	0.90	57	51	-6
0038	3T	162	1	0	100	0	-100	0.00	0.00	0	0	0
0038	3T	163	17	2	1700	3020	1320	0.12	1.78	3	5	2
0038	3T	164	39	1	3900	1980	-1920	0.03	0.51	6	3	-3
0038	3T	165	8	1	800	1310	510	0.13	1.64	1	2	1
0038	3T	213	6	0	600	0	-600	0.00	0.00	1	0	-1
0038	3T	214	44	1	4400	1510	-2890	0.02	0.34	7	2	-5
0038	3T	215	34	0	3400	0	-3400	0.00	0.00	6	0	-6
0038	3T	216	130	9	13000	33120	20120	0.07	2.55	23	58	35
0038	3T	234	136	8	13600	14910	1310	0.06	1.10	24	26	2
0038	3T	235	211	11	21100	21140	40	0.05	1.00	37	37	0
0038	3T	236	198	12	19800	15310	-4490	0.06	0.77	35	27	-8
0038	3T	243	1	0	100	0	-100	0.00	0.00	0	0	0
0038	3T	245	121	2	12100	7300	-4800	0.02	0.60	21	12	-9
0038	3T	246	86	0	8600	0	-8600	0.00	0.00	15	0	-15
0038	3T	253	2	0	200	0	-200	0.00	0.00	0	0	0
0038	3T	254	1	0	100	0	-100	0.00	0.00	0	0	0
0038	3T	256	29	1	2900	2270	-630	0.03	0.78	5	4	-1
0038	3T	263	1	0	100	0	-100	0.00	0.00	0	0	0
0038	3T	265	1	0	100	0	-100	0.00	0.00	0	0	0
0045	3T	164	79	1	7900	2260	-5640	0.01	0.29	13	4	-9
0045	3T	165	22	0	2200	0	-2200	0.00	0.00	3	0	-3
0045	3T	213	61	6	6100	6290	190	0.10	1.03	10	11	1
0045	3T	214	121	8	12100	16940	4840	0.07	1.40	21	29	8
0045	3T	215	72	1	7200	1600	-5600	0.01	0.22	12	2	-10
0045	3T	216	216	1	21600	3060	-18540	0.00	0.14	38	5	-33
0045	3T	231	239	7	23900	13130	-10770	0.03	0.55	42	23	-19
0045	3T	234	64	0	6400	0	-6400	0.00	0.00	11	0	-11
0045	3T	235	47	0	4700	0	-4700	0.00	0.00	8	0	-8
0045	3T	236	65	2	6500	13420	6920	0.03	2.06	11	23	12
0045	3T	241	731	28	73100	48940	-24160	0.04	0.67	129	86	-43
0045	3T	243	6	0	600	0	-600	0.00	0.00	1	0	-1
0045	3T	245	84	0	8400	0	-8400	0.00	0.00	14	0	-14
0045	3T	246	140	3	14000	4990	-9010	0.02	0.36	24	8	-16
0045	3T	251	1018	25	101800	87840	-13960	0.02	0.86	180	155	-25
0045	3T	253	33	1	3300	5800	2500	0.03	1.76	5	10	5
0045	3T	254	33	0	3300	0	-3300	0.00	0.00	5	0	-5
0045	3T	256	217	6	21700	10020	-11680	0.03	0.46	38	17	-21
0045	3T	261	655	12	65500	71470	5970	0.02	1.09	115	126	11
0045	3T	263	26	0	2600	0	-2600	0.00	0.00	4	0	-4
0045	3T	264	24	0	2400	0	-2400	0.00	0.00	4	0	-4
0045	3T	265	17	1	1700	6750	5050	0.06	3.97	3	11	8
0025	1T	1	64239	37641	6423900	5919690	-504210	0.59	0.92	11369	10477	-892
0025	1T	2	6714	2492	671400	591690	-79710	0.37	0.88	1188	1047	-141
0025	2F	12	37372	12224	3737200	3168580	-568620	0.33	0.85	6614	5608	-1006
0025	2F	13	14179	4465	1417900	1139220	-278680	0.31	0.80	2509	2016	-493
0025	2F	14	7497	2161	749700	588980	-160720	0.29	0.79	1326	1042	-284
0025	2F	15	2237	503	223700	188780	-34920	0.22	0.84	395	334	-61
0025	2F	16	1306	266	130600	119960	-10640	0.20	0.92	231	212	-19
0025	2F	23	690	156	69000	61980	-7020	0.23	0.90	122	109	-13
0025	2F	24	259	44	25900	16810	-9090	0.17	0.65	45	29	-16
0025	2F	25	260	38	26000	15140	-10860	0.15	0.58	46	26	-20
0025	2F	26	249	44	24900	25280	380	0.18	1.02	44	44	0
0025	2T	12	37318	9202	3731800	3058170	-673630	0.25	0.82	6604	5412	-1192
0025	2T	13	14179	3236	1417900	1105650	-312250	0.23	0.78	2509	1956	-553
0025	2T	14	7497	1572	749700	588440	-161260	0.21	0.78	1326	1041	-285
0025	2T	15	2237	353	223700	190190	-33510	0.16	0.85	395	336	-59
0025	2T	16	1306	183	130600	126780	-3820	0.14	0.97	231	224	-7
0025	2T	21	54	5	5400	6430	1030	0.09	1.19	9	11	2
0025	2T	23	690	86	69000	55860	-13140	0.12	0.81	122	98	-24
0025	2T	24	259	19	25900	11540	-14360	0.07	0.45	45	20	-25
0025	2T	25	260	23	26000	15840	-10160	0.09	0.61	46	28	-18
0025	2T	26	249	24	24900	22440	-2460	0.10	0.90	44	39	-5
0025	3F	123	7206	2049	720600	604640	-115960	0.28	0.84	1275	1070	-205
0025	3F	124	17117	3424	1711700	1296180	-415520	0.20	0.76	3029	2294	-735
0025	3F	125	5627	996	562700	443260	-119440	0.18	0.79	995	784	-211
0025	3F	126	6359	891	635900	572600	-63300	0.14	0.90	1125	1013	-112
0025	3F	134	4494	1037	449400	363760	-85640	0.23	0.81	795	643	-152
0025	3F	135	3307	613	330700	239610	-91090	0.19	0.72	585	424	-161
0025	3F	136	3238	496	323800	240820	-82980	0.15	0.74	573	426	-147
0025	3F	145	1548	283	154800	117510	-37290	0.18	0.76	273	207	-66
0025	3F	146	1076	164	107600	94370	-13230	0.15	0.88	190	167	-23
0025	3F	156	357	58	35700	30580	-5120	0.16	0.86	63	54	-9
0025	3F	234	235	45	23500	20250	-3250	0.19	0.86	41	35	-6
0025	3F	235	128	28	12800	10470	-2330	0.22	0.82	22	18	-4
0025	3F	236	176	27	17600	16570	-1030	0.15	0.94	31	29	-2
0025	3F	245	53	8	5300	3420	-1880	0.15	0.65	9	6	-3
0025	3F	246	51	5	5100	4050	-1050	0.10	0.79	9	7	-2
0025	3F	256	42	3	4200	950	-3250	0.07	0.23	7	1	-6
0025	3T	123	7052	913	705200	623170	-82030	0.13	0.88	1248	1102	-146
0025	3T	124	17000	1464	1700000	1304020	-395980	0.09	0.77	3008	2308	-700
0025	3T	125	5585	398	558500	440480	-118020	0.07	0.79	988	779	-209
0025	3T	126	6331	369	633100	596650	-36450	0.06	0.94	1120	1056	-64
0025	3T	132	150	14	15000	10410	-4590	0.09	0.69	26	18	-8
0025	3T	134	4275	427	427500	358660	-68840	0.10	0.84	756	634	-122
0025	3T	135	3240	256	324000	251830	-72170	0.08	0.78	573	445	-128
0025	3T	136	3220	211	322000	244020	-77980	0.07	0.76	569	431	-138
0025	3T	142	108	10	10800	9360	-1440	0.09	0.87	19	16	-3
0025	3T	143	219	15	21900	16630	-5270	0.07	0.76	38	29	-9
0025	3T	145	1500	96	150000	109480	-40520	0.06	0.73	265	193	-72
0025	3T	146	1053	59	105300	74540	-30760	0.06	0.71	186	131	-55
0025	3T	152	38	2	3800	2550	-1250	0.05	0.67	6	4	-2
0025	3T	153	67	2	6700	6330	-370	0.03	0.94	11	11	0
0025	3T	154	48	0	4800	0	-4800	0.00	0.00	8	0	-8
0025	3T	156	346	14	34600	22130	-12470	0.04	0.64	61	39	-22
0025	3T	163	18	0	1800	0	-1800	0.00	0.00	3	0	-3
0025	3T	164	23	0	2300	0	-2300	0.00	0.00	4	0	-4
0025	3T	165	11	0	1100	0	-1100	0.00	0.00	1	0	-1
0025	3T	213	4	0	400	0	-400	0.00	0.00	0	0	0
0025	3T	214	9	1	900	890	-10	0.11	0.99	1	1	0
0025	3T	215	4	0	400	0	-400	0.00	0.00	0	0	0
0025	3T	216	28	1	2800	8510	5710	0.04	3.04	4	15	11
0025	3T	234	230	8	23000	12230	-10770	0.03	0.53	40	21	-19
0025	3T	235	114	7	11400	6870	-4530	0.06	0.60	20	12	-8
0025	3T	236	174	5	17400	11120	-6280	0.03	0.64	30	19	-11
0025	3T	243	5	0	500	0	-500	0.00	0.00	0	0	0
0025	3T	245	49	1	4900	2160	-2740	0.02	0.44	8	3	-5
0025	3T	246	51	0	5100	0	-5100	0.00	0.00	9	0	-9
0025	3T	253	14	0	1400	0	-1400	0.00	0.00	2	0	-2
0025	3T	254	4	0	400	0	-400	0.00	0.00	0	0	0
0025	3T	256	40	1	4000	730	-3270	0.03	0.18	7	1	-6
0025	3T	263	2	0	200	0	-200	0.00	0.00	0	0	0
0025	3T	265	2	0	200	0	-200	0.00	0.00	0	0	0
0046	1T	1	21242	15003	2124200	1932660	-191540	0.71	0.91	3759	3420	-339
0046	1T	2	10613	3423	1061300	909850	-151450	0.32	0.86	1878	1610	-268
0046	2F	12	6217	2414	621700	495350	-126350	0.39	0.80	1100	876	-224
0046	2F	13	5352	1726	535200	456340	-78860	0.32	0.85	947	807	-140
0046	2F	14	5036	1122	503600	379040	-124560	0.22	0.75	891	670	-221
0046	2F	15	3718	525	371800	309880	-61920	0.14	0.83	658	548	-110
0046	2F	16	2153	239	215300	200860	-14440	0.11	0.93	381	355	-26
0046	2F	23	822	139	82200	58010	-24190	0.17	0.71	145	102	-43
0046	2F	24	1814	232	181400	124040	-57360	0.13	0.68	321	219	-102
0046	2F	25	2467	240	246700	161770	-84930	0.10	0.66	436	286	-150
0046	2F	26	2124	157	212400	145460	-66940	0.07	0.68	375	257	-118
0046	2T	12	5524	1797	552400	430800	-121600	0.33	0.78	977	762	-215
0046	2T	13	4943	1304	494300	394600	-99700	0.26	0.80	874	698	-176
0046	2T	14	4750	851	475000	339690	-135310	0.18	0.72	840	601	-239
0046	2T	15	3534	418	353400	290090	-63310	0.12	0.82	625	513	-112
0046	2T	16	2016	203	201600	198680	-2920	0.10	0.99	356	351	-5
0046	2T	21	693	69	69300	49930	-19370	0.10	0.72	122	88	-34
0046	2T	23	756	80	75600	57530	-18070	0.11	0.76	133	101	-32
0046	2T	24	1515	140	151500	103550	-47950	0.09	0.68	268	183	-85
0046	2T	25	2252	168	225200	161980	-63220	0.07	0.72	398	286	-112
0046	2T	26	1869	106	186900	122130	-64770	0.06	0.65	330	216	-114
0046	3F	123	1543	470	154300	125970	-28330	0.30	0.82	273	222	-51
0046	3F	124	2249	485	224900	162640	-62260	0.22	0.72	398	287	-111
0046	3F	125	2044	307	204400	174070	-30330	0.15	0.85	361	308	-53
0046	3F	126	2113	226	211300	164800	-46500	0.11	0.78	373	291	-82
0046	3F	134	1678	314	167800	117540	-50260	0.19	0.70	296	208	-88
0026	1T	1	63087	37247	6308700	5810280	-498420	0.59	0.92	11165	10283	-882
0026	1T	2	8092	2968	809200	730280	-78920	0.37	0.90	1432	1292	-140
0026	2F	12	31744	10671	3174400	2666100	-508300	0.34	0.84	5618	4718	-900
0026	2F	13	16605	5101	1660500	1330150	-330350	0.31	0.80	2938	2354	-584
0026	2F	14	8965	2489	896500	705050	-191450	0.28	0.79	1586	1247	-339
0026	2F	15	2182	490	218200	178470	-39730	0.22	0.82	386	315	-71
0026	2F	16	1622	334	162200	152250	-9950	0.21	0.94	287	269	-18
0026	2F	23	777	174	77700	63820	-13880	0.22	0.82	137	112	-25
0026	2F	24	507	99	50700	41570	-9130	0.20	0.82	89	73	-16
0026	2F	25	271	33	27100	13960	-13140	0.12	0.52	47	24	-23
0026	2F	26	334	62	33400	25240	-8160	0.19	0.76	59	44	-15
0026	2T	12	31575	8064	3157500	2572440	-585060	0.26	0.81	5588	4552	-1036
0026	2T	13	16605	3731	1660500	1284030	-376470	0.22	0.77	2938	2272	-666
0026	2T	14	8965	1836	896500	719840	-176660	0.20	0.80	1586	1274	-312
0026	2T	15	2182	348	218200	179000	-39200	0.16	0.82	386	316	-70
0026	2T	16	1622	240	162200	166150	3950	0.15	1.02	287	294	7
0026	2T	21	169	18	16900	15470	-1430	0.11	0.92	29	27	-2
0026	2T	23	777	90	77700	52730	-24970	0.12	0.68	137	93	-44
0026	2T	24	507	57	50700	41690	-9010	0.11	0.82	89	73	-16
0026	2T	25	271	21	27100	15110	-11990	0.08	0.56	47	26	-21
0026	2T	26	334	34	33400	23070	-10330	0.10	0.69	59	40	-19
0026	3F	123	5123	1531	512300	436020	-76280	0.30	0.85	906	771	-135
0026	3F	124	11466	2509	1146600	844080	-302520	0.22	0.74	2029	1493	-536
0026	3F	125	6320	1180	632000	528620	-103380	0.19	0.84	1118	935	-183
0026	3F	126	7752	979	775200	666470	-108730	0.13	0.86	1372	1179	-193
0026	3F	134	5099	1105	509900	387230	-122670	0.22	0.76	902	685	-217
0026	3F	135	3815	664	381500	267410	-114090	0.17	0.70	675	473	-202
0026	3F	136	4188	553	418800	330760	-88040	0.13	0.79	741	585	-156
0026	3F	145	1821	301	182100	125910	-56190	0.17	0.69	322	222	-100
0026	3F	146	1438	185	143800	119220	-24580	0.13	0.83	254	211	-43
0026	3F	156	341	61	34100	32010	-2090	0.18	0.94	60	56	-4
0026	3F	234	169	29	16900	10250	-6650	0.17	0.61	29	18	-11
0026	3F	235	218	31	21800	13020	-8780	0.14	0.60	38	23	-15
0026	3F	236	228	31	22800	21440	-1360	0.14	0.94	40	37	-3
0026	3F	245	142	16	14200	8420	-5780	0.11	0.59	25	14	-11
0026	3F	246	90	8	9000	9690	690	0.09	1.08	15	17	2
0026	3F	256	44	5	4400	2250	-2150	0.11	0.51	7	3	-4
0026	3T	123	5049	688	504900	443290	-61610	0.14	0.88	893	784	-109
0026	3T	124	11410	1086	1141000	843930	-297070	0.10	0.74	2019	1493	-526
0026	3T	125	6260	495	626000	530850	-95150	0.08	0.85	1107	939	-168
0026	3T	126	7678	444	767800	724800	-43000	0.06	0.94	1358	1282	-76
0026	3T	132	63	6	6300	4200	-2100	0.10	0.67	11	7	-4
0026	3T	134	4986	471	498600	400410	-98190	0.09	0.80	882	708	-174
0026	3T	135	3781	288	378100	288420	-89680	0.08	0.76	669	510	-159
0026	3T	136	4180	242	418000	318460	-99540	0.06	0.76	739	563	-176
0026	3T	142	20	0	2000	0	-2000	0.00	0.00	3	0	-3
0026	3T	143	113	6	11300	5660	-5640	0.05	0.50	20	10	-10
0026	3T	145	1778	103	177800	121000	-56800	0.06	0.68	314	214	-100
0026	3T	146	1404	74	140400	119840	-20560	0.05	0.85	248	212	-36
0026	3T	152	16	0	1600	0	-1600	0.00	0.00	2	0	-2
0026	3T	153	34	1	3400	1390	-2010	0.03	0.41	6	2	-4
0026	3T	154	43	2	4300	2730	-1570	0.05	0.63	7	4	-3
0026	3T	156	332	22	33200	34170	970	0.07	1.03	58	60	2
0026	3T	163	8	1	800	840	40	0.13	1.05	1	1	0
0026	3T	164	34	2	3400	6050	2650	0.06	1.78	6	10	4
0026	3T	165	9	1	900	1080	180	0.11	1.20	1	1	0
0026	3T	213	11	0	1100	0	-1100	0.00	0.00	1	0	-1
0026	3T	214	36	0	3600	0	-3600	0.00	0.00	6	0	-6
0026	3T	215	44	1	4400	2250	-2150	0.02	0.51	7	3	-4
0026	3T	216	74	3	7400	14140	6740	0.04	1.91	13	25	12
0026	3T	234	167	9	16700	10180	-6520	0.05	0.61	29	18	-11
0026	3T	235	216	9	21600	19750	-1850	0.04	0.91	38	34	-4
0026	3T	236	227	11	22700	20180	-2520	0.05	0.89	40	35	-5
0026	3T	243	2	0	200	0	-200	0.00	0.00	0	0	0
0026	3T	245	142	3	14200	4910	-9290	0.02	0.35	25	8	-17
0026	3T	246	90	2	9000	30560	21560	0.02	3.40	15	54	39
0026	3T	253	2	0	200	0	-200	0.00	0.00	0	0	0
0026	3T	256	44	0	4400	0	-4400	0.00	0.00	7	0	-7
0026	3T	263	1	0	100	0	-100	0.00	0.00	0	0	0
0046	3F	135	1649	203	164900	119860	-45040	0.12	0.73	291	212	-79
0046	3F	136	2020	190	202000	173690	-28310	0.09	0.86	357	307	-50
0046	3F	145	1479	157	147900	109020	-38880	0.11	0.74	261	192	-69
0046	3F	146	1713	145	171300	145540	-25760	0.08	0.85	303	257	-46
0046	3F	156	1334	41	133400	68070	-65330	0.03	0.51	236	120	-116
0046	3F	234	119	11	11900	14690	2790	0.09	1.23	21	26	5
0046	3F	235	129	9	12900	5200	-7700	0.07	0.40	22	9	-13
0046	3F	236	159	3	15900	3200	-12700	0.02	0.20	28	5	-23
0046	3F	245	278	21	27800	25870	-1930	0.08	0.93	49	45	-4
0046	3F	246	326	26	32600	24700	-7900	0.08	0.76	57	43	-14
0046	3F	256	455	25	45500	26740	-18760	0.05	0.59	80	47	-33
0046	3T	123	922	135	92200	69180	-23020	0.15	0.75	163	122	-41
0046	3T	124	1263	141	126300	82060	-44240	0.11	0.65	223	145	-78
0046	3T	125	1088	100	108800	98260	-10540	0.09	0.90	192	173	-19
0046	3T	126	1364	81	136400	105020	-31380	0.06	0.77	241	185	-56
0046	3T	132	236	28	23600	22610	-990	0.12	0.96	41	40	-1
0046	3T	134	1008	116	100800	90950	-9850	0.12	0.90	178	160	-18
0046	3T	135	1013	67	101300	77780	-23520	0.07	0.77	179	137	-42
0046	3T	136	1571	79	157100	149770	-7330	0.05	0.95	278	265	-13
0046	3T	142	150	12	15000	12680	-2320	0.08	0.85	26	22	-4
0046	3T	143	90	3	9000	1860	-7140	0.03	0.21	15	3	-12
0046	3T	145	960	44	96000	67050	-28950	0.05	0.70	169	118	-51
0046	3T	146	1392	56	139200	105030	-34170	0.04	0.75	246	185	-61
0046	3T	152	152	2	15200	2290	-12910	0.01	0.15	26	4	-22
0046	3T	153	154	8	15400	20470	5070	0.05	1.33	27	36	9
0046	3T	154	160	4	16000	10000	-6000	0.03	0.63	28	17	-11
0046	3T	156	1198	14	119800	43760	-76040	0.01	0.37	212	77	-135
0046	3T	162	59	5	5900	12690	6790	0.08	2.15	10	22	12
0027	1T	1	61543	36758	6154300	5667580	-486720	0.60	0.92	10892	10031	-861
0027	1T	2	9056	3269	905600	805270	-100330	0.36	0.89	1602	1425	-177
0027	2F	12	29696	10207	2969600	2489040	-480560	0.34	0.84	5255	4405	-850
0027	2F	13	15445	4880	1544500	1239480	-305020	0.32	0.80	2733	2193	-540
0027	2F	14	9733	2745	973300	756770	-216530	0.28	0.78	1722	1339	-383
0027	2F	15	3262	728	326200	276360	-49840	0.22	0.85	577	489	-88
0027	2F	16	2013	393	201300	183400	-17900	0.20	0.91	356	324	-32
0027	2F	23	1038	245	103800	96440	-7360	0.24	0.93	183	170	-13
0027	2F	24	529	97	52900	34540	-18360	0.18	0.65	93	61	-32
0027	2F	25	519	75	51900	35170	-16730	0.14	0.68	91	62	-29
0027	2F	26	519	91	51900	47690	-4210	0.18	0.92	91	84	-7
0027	2T	12	28975	7722	2897500	2357940	-539560	0.27	0.81	5128	4173	-955
0027	2T	13	15445	3587	1544500	1196760	-347740	0.23	0.77	2733	2118	-615
0027	2T	14	9733	2013	973300	762310	-210990	0.21	0.78	1722	1349	-373
0027	2T	15	3262	523	326200	281880	-44320	0.16	0.86	577	498	-79
0027	2T	16	2013	283	201300	191830	-9470	0.14	0.95	356	339	-17
0027	2T	21	721	73	72100	61270	-10830	0.10	0.85	127	108	-19
0027	2T	23	1038	142	103800	87560	-16240	0.14	0.84	183	154	-29
0027	2T	24	529	55	52900	31600	-21300	0.10	0.60	93	55	-38
0027	2T	25	519	52	51900	39180	-12720	0.10	0.75	91	69	-22
0027	2T	26	519	51	51900	42410	-9490	0.10	0.82	91	75	-16
0027	3F	123	5736	1625	573600	457340	-116260	0.28	0.80	1015	809	-206
0027	3F	124	11236	2433	1123600	835610	-287990	0.22	0.74	1988	1478	-510
0027	3F	125	5343	998	534300	442400	-91900	0.19	0.83	945	783	-162
0027	3F	126	6155	855	615500	507280	-108220	0.14	0.82	1089	897	-192
0027	3F	134	4076	960	407600	328140	-79460	0.24	0.81	721	580	-141
0027	3F	135	3734	683	373400	267700	-105700	0.18	0.72	660	473	-187
0027	3F	136	4197	592	419700	311910	-107790	0.14	0.74	742	552	-190
0027	3F	145	1993	340	199300	143520	-55780	0.17	0.72	352	254	-98
0027	3F	146	1615	218	161500	110690	-50810	0.13	0.69	285	195	-90
0027	3F	156	638	98	63800	54650	-9150	0.15	0.86	112	96	-16
0027	3F	234	171	38	17100	15760	-1340	0.22	0.92	30	27	-3
0027	3F	235	288	58	28800	25480	-3320	0.20	0.88	50	45	-5
0027	3F	236	382	52	38200	28610	-9590	0.14	0.75	67	50	-17
0027	3F	245	158	17	15800	6980	-8820	0.11	0.44	27	12	-15
0027	3F	246	106	6	10600	2380	-8220	0.06	0.22	18	4	-14
0027	3F	256	125	11	12500	7720	-4780	0.09	0.62	22	13	-9
0027	3T	123	5650	733	565000	463060	-101940	0.13	0.82	1000	819	-181
0027	3T	124	11127	1064	1112700	835230	-277470	0.10	0.75	1969	1478	-491
0027	3T	125	5074	418	507400	416550	-90850	0.08	0.82	898	737	-161
0027	3T	126	5786	375	578600	535060	-43540	0.06	0.92	1024	947	-77
0027	3T	132	78	7	7800	6670	-1130	0.09	0.86	13	11	-2
0027	3T	134	3982	408	398200	322500	-75700	0.10	0.81	704	570	-134
0027	3T	135	3696	294	369600	270850	-98750	0.08	0.73	654	479	-175
0027	3T	136	4195	280	419500	343730	-75770	0.07	0.82	742	608	-134
0027	3T	142	20	1	2000	1800	-200	0.05	0.90	3	3	0
0027	3T	143	94	5	9400	7680	-1720	0.05	0.82	16	13	-3
0027	3T	145	1970	115	197000	132780	-64220	0.06	0.67	348	235	-113
0027	3T	146	1580	94	158000	114260	-43740	0.06	0.72	279	202	-77
0027	3T	152	12	2	1200	3420	2220	0.17	2.85	2	6	4
0027	3T	153	38	2	3800	4730	930	0.05	1.24	6	8	2
0027	3T	154	23	2	2300	4160	1860	0.09	1.81	4	7	3
0027	3T	156	629	35	62900	50400	-12500	0.06	0.80	111	89	-22
0027	3T	162	2	0	200	0	-200	0.00	0.00	0	0	0
0027	3T	163	2	0	200	0	-200	0.00	0.00	0	0	0
0027	3T	164	35	1	3500	710	-2790	0.03	0.20	6	1	-5
0027	3T	165	9	1	900	4790	3890	0.11	5.32	1	8	7
0027	3T	213	8	2	800	4300	3500	0.25	5.38	1	7	6
0027	3T	214	89	6	8900	10320	1420	0.07	1.16	15	18	3
0027	3T	215	257	8	25700	13520	-12180	0.03	0.53	45	23	-22
0027	3T	216	367	9	36700	31110	-5590	0.02	0.85	64	55	-9
0027	3T	234	171	9	17100	10070	-7030	0.05	0.59	30	17	-13
0027	3T	235	286	23	28600	29890	1290	0.08	1.05	50	52	2
0027	3T	236	382	16	38200	31010	-7190	0.04	0.81	67	54	-13
0027	3T	245	156	5	15600	7620	-7980	0.03	0.49	27	13	-14
0027	3T	246	106	4	10600	4600	-6000	0.04	0.43	18	8	-10
0027	3T	253	2	0	200	0	-200	0.00	0.00	0	0	0
0027	3T	254	2	0	200	0	-200	0.00	0.00	0	0	0
0027	3T	256	125	0	12500	0	-12500	0.00	0.00	22	0	-22
0046	3T	163	70	3	7000	6190	-810	0.04	0.88	12	10	-2
0046	3T	164	53	3	5300	5140	-160	0.06	0.97	9	9	0
0046	3T	165	24	1	2400	3880	1480	0.04	1.62	4	6	2
0046	3T	213	18	1	1800	830	-970	0.06	0.46	3	1	-2
0046	3T	214	62	0	6200	0	-6200	0.00	0.00	10	0	-10
0046	3T	215	120	1	12000	1330	-10670	0.01	0.11	21	2	-19
0046	3T	216	256	4	25600	8520	-17080	0.02	0.33	45	15	-30
0046	3T	231	340	12	34000	20660	-13340	0.04	0.61	60	36	-24
0046	3T	234	96	1	9600	8690	-910	0.01	0.91	16	15	-1
0046	3T	235	102	2	10200	4020	-6180	0.02	0.39	18	7	-11
0046	3T	236	130	2	13000	2980	-10020	0.02	0.23	23	5	-18
0046	3T	241	674	24	67400	45740	-21660	0.04	0.68	119	80	-39
0046	3T	243	1	0	100	0	-100	0.00	0.00	0	0	0
0046	3T	245	219	3	21900	4440	-17460	0.01	0.20	38	7	-31
0046	3T	246	262	8	26200	43760	17560	0.03	1.67	46	77	31
0046	3T	251	648	17	64800	57330	-7470	0.03	0.88	114	101	-13
0046	3T	253	11	0	1100	0	-1100	0.00	0.00	1	0	-1
0046	3T	254	27	0	2700	0	-2700	0.00	0.00	4	0	-4
0046	3T	256	388	6	38800	9730	-29070	0.02	0.25	68	17	-51
0046	3T	261	379	5	37900	35250	-2650	0.01	0.93	67	62	-5
0046	3T	263	3	0	300	0	-300	0.00	0.00	0	0	0
0046	3T	264	20	0	2000	0	-2000	0.00	0.00	3	0	-3
0046	3T	265	26	0	2600	0	-2600	0.00	0.00	4	0	-4
0014	1T	1	61342	35794	6134200	5717240	-416960	0.58	0.93	10856	10119	-737
0014	1T	2	7227	2249	722700	692150	-30550	0.31	0.96	1279	1225	-54
0014	2F	12	25962	7881	2596200	2250660	-345540	0.30	0.87	4595	3983	-612
0014	2F	13	14548	3700	1454800	1240000	-214800	0.25	0.85	2574	2194	-380
0014	2F	14	9265	1880	926500	737420	-189080	0.20	0.80	1639	1305	-334
0014	2F	15	3758	541	375800	329350	-46450	0.14	0.88	665	582	-83
0014	2F	16	1888	244	188800	149680	-39120	0.13	0.79	334	264	-70
0014	2F	23	1299	169	129900	123380	-6520	0.13	0.95	229	218	-11
0014	2F	24	844	87	84400	64270	-20130	0.10	0.76	149	113	-36
0014	2F	25	591	59	59100	30640	-28460	0.10	0.52	104	54	-50
0014	2F	26	442	44	44200	39100	-5100	0.10	0.88	78	69	-9
0014	2T	12	23560	5503	2356000	1988800	-367200	0.23	0.84	4169	3520	-649
0014	2T	13	14548	2849	1454800	1222660	-232140	0.20	0.84	2574	2164	-410
0014	2T	14	9265	1441	926500	734920	-191580	0.16	0.79	1639	1300	-339
0014	2T	15	3758	416	375800	356230	-19570	0.11	0.95	665	630	-35
0014	2T	16	1888	181	188800	156460	-32340	0.10	0.83	334	276	-58
0014	2T	21	2402	322	240200	233650	-6550	0.13	0.97	425	413	-12
0014	2T	23	1299	94	129900	97630	-32270	0.07	0.75	229	172	-57
0014	2T	24	844	52	84400	61980	-22420	0.06	0.73	149	109	-40
0014	2T	25	591	38	59100	32910	-26190	0.06	0.56	104	58	-46
0014	2T	26	442	32	44200	47870	3670	0.07	1.08	78	84	6
0014	3F	123	11316	2399	1131600	972900	-158700	0.21	0.86	2002	1721	-281
0014	3F	124	8998	1569	899800	699070	-200730	0.17	0.78	1592	1237	-355
0014	3F	125	5348	683	534800	446790	-88010	0.13	0.84	946	790	-156
0014	3F	126	3746	360	374600	298390	-76210	0.10	0.80	663	528	-135
0014	3F	134	5806	899	580600	473210	-107390	0.15	0.82	1027	837	-190
0014	3F	135	3473	387	347300	274950	-72350	0.11	0.79	614	486	-128
0014	3F	136	2320	240	232000	203820	-28180	0.10	0.88	410	360	-50
0014	3F	145	2169	231	216900	187470	-29430	0.11	0.86	383	331	-52
0014	3F	146	1402	106	140200	89810	-50390	0.08	0.64	248	158	-90
0014	3F	156	706	60	70600	71900	1300	0.08	1.02	124	127	3
0014	3F	234	470	35	47000	32530	-14470	0.07	0.69	83	57	-26
0014	3F	235	376	44	37600	51870	14270	0.12	1.38	66	91	25
0014	3F	236	311	25	31100	27280	-3820	0.08	0.88	55	48	-7
0014	3F	245	233	20	23300	9840	-13460	0.09	0.42	41	17	-24
0014	3F	246	212	14	21200	15980	-5220	0.07	0.75	37	28	-9
0014	3F	256	143	6	14300	5270	-9030	0.04	0.37	25	9	-16
0014	3T	123	6882	654	688200	593550	-94650	0.10	0.86	1218	1050	-168
0014	3T	124	5987	479	598700	518110	-80590	0.08	0.87	1059	917	-142
0014	3T	125	3932	249	393200	375150	-18050	0.06	0.95	695	663	-32
0014	3T	126	2860	112	286000	233930	-52070	0.04	0.82	506	414	-92
0014	3T	132	3649	259	364900	328890	-36010	0.07	0.90	645	582	-63
0014	3T	134	3544	247	354400	307300	-47100	0.07	0.87	627	543	-84
0014	3T	135	2557	133	255700	216080	-39620	0.05	0.85	452	382	-70
0014	3T	136	1888	79	188800	133950	-54850	0.04	0.71	334	237	-97
0014	3T	142	2363	124	236300	173090	-63210	0.05	0.73	418	306	-112
0014	3T	143	2262	117	226200	203960	-22240	0.05	0.90	400	360	-40
0014	3T	145	1500	58	150000	105540	-44460	0.04	0.70	265	186	-79
0014	3T	146	1079	42	107900	70920	-36980	0.04	0.66	190	125	-65
0014	3T	152	925	31	92500	62760	-29740	0.03	0.68	163	111	-52
0014	3T	153	916	36	91600	91650	50	0.04	1.00	162	162	0
0014	3T	154	669	12	66900	27380	-39520	0.02	0.41	118	48	-70
0014	3T	156	492	23	49200	68090	18890	0.05	1.38	87	120	33
0014	3T	162	411	10	41100	26200	-14900	0.02	0.64	72	46	-26
0014	3T	163	432	16	43200	45000	1800	0.04	1.04	76	79	3
0014	3T	164	323	6	32300	15930	-16370	0.02	0.49	57	28	-29
0014	3T	165	214	2	21400	3420	-17980	0.01	0.16	37	6	-31
0014	3T	213	601	36	60100	70760	10660	0.06	1.18	106	125	19
0014	3T	214	537	23	53700	45810	-7890	0.04	0.85	95	81	-14
0014	3T	215	410	12	41000	17150	-23850	0.03	0.42	72	30	-42
0014	3T	216	398	6	39800	13870	-25930	0.02	0.35	70	24	-46
0014	3T	231	184	3	18400	7200	-11200	0.02	0.39	32	12	-20
0014	3T	234	287	4	28700	10540	-18160	0.01	0.37	50	18	-32
0014	3T	235	238	10	23800	69860	46060	0.04	2.94	42	123	81
0014	3T	236	220	2	22000	16020	-5980	0.01	0.73	38	28	-10
0014	3T	241	111	3	11100	11570	470	0.03	1.04	19	20	1
0014	3T	243	183	3	18300	4670	-13630	0.02	0.26	32	8	-24
0014	3T	245	135	0	13500	0	-13500	0.00	0.00	23	0	-23
0014	3T	246	139	3	13900	3890	-10010	0.02	0.28	24	6	-18
0014	3T	251	81	1	8100	2380	-5720	0.01	0.29	14	4	-10
0014	3T	253	138	4	13800	8040	-5760	0.03	0.58	24	14	-10
0014	3T	254	98	1	9800	2690	-7110	0.01	0.27	17	4	-13
0014	3T	256	90	2	9000	2760	-6240	0.02	0.31	15	4	-11
0014	3T	261	77	3	7700	11320	3620	0.04	1.47	13	20	7
0014	3T	263	91	1	9100	5270	-3830	0.01	0.58	16	9	-7
0014	3T	264	73	1	7300	2820	-4480	0.01	0.39	12	4	-8
0014	3T	265	53	1	5300	8860	3560	0.02	1.67	9	15	6
0016	3T	253	1	1	100	1720	1620	1.00	17.20	0	3	3
0016	3T	254	2	0	200	0	-200	0.00	0.00	0	0	0
0016	3T	256	47	1	4700	1140	-3560	0.02	0.24	8	2	-6
0016	3T	263	2	0	200	0	-200	0.00	0.00	0	0	0
0016	3T	264	1	0	100	0	-100	0.00	0.00	0	0	0
0016	3T	265	1	0	100	0	-100	0.00	0.00	0	0	0
0028	1T	1	68540	38772	6854000	6270410	-583590	0.57	0.91	12130	11098	-1032
0028	1T	2	4916	1881	491600	449990	-41610	0.38	0.92	870	796	-74
0028	2F	12	42506	13371	4250600	3633660	-616940	0.31	0.85	7523	6431	-1092
0028	2F	13	15455	4791	1545500	1249670	-295830	0.31	0.81	2735	2211	-524
0028	2F	14	7266	2020	726600	572600	-154000	0.28	0.79	1286	1013	-273
0028	2F	15	1268	303	126800	114910	-11890	0.24	0.91	224	203	-21
0028	2F	16	1105	218	110500	103400	-7100	0.20	0.94	195	183	-12
0028	2F	23	390	86	39000	30770	-8230	0.22	0.79	69	54	-15
0028	2F	24	202	32	20200	13000	-7200	0.16	0.64	35	23	-12
0028	2F	25	151	27	15100	11910	-3190	0.18	0.79	26	21	-5
0028	2F	26	205	27	20500	11930	-8570	0.13	0.58	36	21	-15
0028	2T	12	42375	9898	4237500	3464560	-772940	0.23	0.82	7500	6131	-1369
0028	2T	13	15455	3432	1545500	1214220	-331280	0.22	0.79	2735	2149	-586
0028	2T	14	7266	1458	726600	577010	-149590	0.20	0.79	1286	1021	-265
0019	1T	1	62357	36244	6235700	5783470	-452230	0.58	0.93	11036	10236	-800
0019	1T	2	7524	2419	752400	727380	-25020	0.32	0.97	1331	1287	-44
0019	2F	12	24686	7520	2468600	2155840	-312760	0.30	0.87	4369	3815	-554
0019	2F	13	15614	3881	1561400	1316050	-245350	0.25	0.84	2763	2329	-434
0019	2F	14	9449	2005	944900	759400	-185500	0.21	0.80	1672	1344	-328
0019	2F	15	3939	538	393900	309450	-84450	0.14	0.79	697	547	-150
0019	2F	16	1975	254	197500	177810	-19690	0.13	0.90	349	314	-35
0019	2F	23	1508	201	150800	123720	-27080	0.13	0.82	266	218	-48
0019	2F	24	881	120	88100	67390	-20710	0.14	0.76	155	119	-36
0019	2F	25	554	60	55400	41320	-14080	0.11	0.75	98	73	-25
0019	2F	26	352	32	35200	24240	-10960	0.09	0.69	62	42	-20
0019	2T	12	22158	5166	2215800	1872710	-343090	0.23	0.85	3921	3314	-607
0019	2T	13	15614	3003	1561400	1297250	-264150	0.19	0.83	2763	2296	-467
0019	2T	14	9449	1542	944900	771580	-173320	0.16	0.82	1672	1365	-307
0019	2T	15	3939	408	393900	311610	-82290	0.10	0.79	697	551	-146
0019	2T	16	1975	186	197500	178200	-19300	0.09	0.90	349	315	-34
0019	2T	21	2528	340	252800	238600	-14200	0.13	0.94	447	422	-25
0019	2T	23	1508	117	150800	115240	-35560	0.08	0.76	266	203	-63
0019	2T	24	881	76	88100	66410	-21690	0.09	0.75	155	117	-38
0019	2T	25	554	41	55400	49600	-5800	0.07	0.90	98	87	-11
0019	2T	26	352	26	35200	32780	-2420	0.07	0.93	62	58	-4
0019	3F	123	10734	2184	1073400	888620	-184780	0.20	0.83	1899	1572	-327
0019	3F	124	8641	1519	864100	670760	-193340	0.18	0.78	1529	1187	-342
0019	3F	125	5044	626	504400	399070	-105330	0.12	0.79	892	706	-186
0019	3F	126	3905	395	390500	333090	-57410	0.10	0.85	691	589	-102
0019	3F	134	6086	923	608600	471770	-136830	0.15	0.78	1077	834	-243
0019	3F	135	3642	383	364200	252240	-111960	0.11	0.69	644	446	-198
0019	3F	136	2721	280	272100	239540	-32560	0.10	0.88	481	423	-58
0019	3F	145	2341	192	234100	155060	-79040	0.08	0.66	414	274	-140
0019	3F	146	1573	120	157300	102420	-54880	0.08	0.65	278	181	-97
0019	3F	156	845	59	84500	67980	-16520	0.07	0.80	149	120	-29
0019	3F	234	521	67	52100	61510	9410	0.13	1.18	92	108	16
0019	3F	235	388	42	38800	41650	2850	0.11	1.07	68	73	5
0019	3F	236	359	26	35900	21650	-14250	0.07	0.60	63	38	-25
0019	3F	245	251	19	25100	16790	-8310	0.08	0.67	44	29	-15
0019	3F	246	174	15	17400	21750	4350	0.09	1.25	30	38	8
0019	3F	256	142	8	14200	10310	-3890	0.06	0.73	25	18	-7
0019	3T	123	6218	607	621800	568880	-52920	0.10	0.91	1100	1006	-94
0019	3T	124	5664	421	566400	431890	-134510	0.07	0.76	1002	764	-238
0019	3T	125	3650	202	365000	316450	-48550	0.06	0.87	646	560	-86
0019	3T	126	2946	109	294600	225210	-69390	0.04	0.76	521	398	-123
0019	3T	132	3714	278	371400	344780	-26620	0.07	0.93	657	610	-47
0019	3T	134	3760	250	376000	293510	-82490	0.07	0.78	665	519	-146
0019	3T	135	2723	134	272300	209200	-63100	0.05	0.77	481	370	-111
0019	3T	136	2264	108	226400	214570	-11830	0.05	0.95	400	379	-21
0019	3T	142	2300	145	230000	201300	-28700	0.06	0.88	407	356	-51
0019	3T	143	2326	105	232600	164490	-68110	0.05	0.71	411	291	-120
0019	3T	145	1588	49	158800	87450	-71350	0.03	0.55	281	154	-127
0019	3T	146	1195	48	119500	103360	-16140	0.04	0.86	211	182	-29
0019	3T	152	906	32	90600	78450	-12150	0.04	0.87	160	138	-22
0019	3T	153	919	20	91900	35150	-56750	0.02	0.38	162	62	-100
0019	3T	154	753	15	75300	46820	-28480	0.02	0.62	133	82	-51
0019	3T	156	604	18	60400	65350	4950	0.03	1.08	106	115	9
0019	3T	162	448	15	44800	33570	-11230	0.03	0.75	79	59	-20
0019	3T	163	457	10	45700	28940	-16760	0.02	0.63	80	51	-29
0019	3T	164	378	5	37800	11080	-26720	0.01	0.29	66	19	-47
0019	3T	165	241	1	24100	4020	-20080	0.00	0.17	42	7	-35
0007	1T	1	61063	35738	6106300	5679530	-426770	0.59	0.93	10807	10052	-755
0007	1T	2	7171	2268	717100	676620	-40480	0.32	0.94	1269	1197	-72
0007	2F	12	25223	7674	2522300	2182000	-340300	0.30	0.87	4464	3861	-603
0007	2F	13	15000	3733	1500000	1224290	-275710	0.25	0.82	2654	2166	-488
0007	2F	14	9051	1869	905100	713910	-191190	0.21	0.79	1601	1263	-338
0007	2F	15	3795	543	379500	305510	-73990	0.14	0.81	671	540	-131
0007	2F	16	2035	263	203500	177100	-26400	0.13	0.87	360	313	-47
0007	2F	23	1424	184	142400	108040	-34360	0.13	0.76	252	191	-61
0007	2F	24	878	108	87800	83800	-4000	0.12	0.95	155	148	-7
0007	2F	25	573	52	57300	44340	-12960	0.09	0.77	101	78	-23
0007	2F	26	404	36	40400	23860	-16540	0.09	0.59	71	42	-29
0007	2T	12	22967	5425	2296700	1930640	-366060	0.24	0.84	4064	3417	-647
0007	2T	13	15000	2897	1500000	1220150	-279850	0.19	0.81	2654	2159	-495
0007	2T	14	9051	1437	905100	716490	-188610	0.16	0.79	1601	1268	-333
0007	2T	15	3795	414	379500	303240	-76260	0.11	0.80	671	536	-135
0007	2T	16	2035	193	203500	199470	-4030	0.09	0.98	360	353	-7
0007	2T	21	2256	289	225600	212340	-13260	0.13	0.94	399	375	-24
0007	2T	23	1424	94	142400	96370	-46030	0.07	0.68	252	170	-82
0007	2T	24	878	67	87800	79450	-8350	0.08	0.90	155	140	-15
0007	2T	25	573	32	57300	38070	-19230	0.06	0.66	101	67	-34
0007	2T	26	404	25	40400	33720	-6680	0.06	0.83	71	59	-12
0007	3F	123	10762	2306	1076200	926300	-149900	0.21	0.86	1904	1639	-265
0007	3F	124	8756	1546	875600	679440	-196160	0.18	0.78	1549	1202	-347
0007	3F	125	5157	675	515700	408690	-107010	0.13	0.79	912	723	-189
0007	3F	126	4007	429	400700	370420	-30280	0.11	0.92	709	655	-54
0007	3F	134	5745	903	574500	487210	-87290	0.16	0.85	1016	862	-154
0007	3F	135	3477	381	347700	250650	-97050	0.11	0.72	615	443	-172
0007	3F	136	2630	253	263000	207040	-55960	0.10	0.79	465	366	-99
0007	3F	145	2339	211	233900	175280	-58620	0.09	0.75	413	310	-103
0007	3F	146	1528	112	152800	99700	-53100	0.07	0.65	270	176	-94
0007	3F	156	814	59	81400	67340	-14060	0.07	0.83	144	119	-25
0007	3F	234	528	44	52800	34680	-18120	0.08	0.66	93	61	-32
0007	3F	235	376	37	37600	24500	-13100	0.10	0.65	66	43	-23
0007	3F	236	319	34	31900	38040	6140	0.11	1.19	56	67	11
0007	3F	245	253	17	25300	29940	4640	0.07	1.18	44	52	8
0007	3F	246	213	15	21300	15020	-6280	0.07	0.71	37	26	-11
0007	3F	256	143	12	14300	16240	1940	0.08	1.14	25	28	3
0007	3T	123	6391	652	639100	607370	-31730	0.10	0.95	1131	1074	-57
0007	3T	124	5954	482	595400	519920	-75480	0.08	0.87	1053	920	-133
0007	3T	125	3852	237	385200	375370	-9830	0.06	0.97	681	664	-17
0007	3T	126	3060	147	306000	273210	-32790	0.05	0.89	541	483	-58
0007	3T	132	3640	255	364000	324740	-39260	0.07	0.89	644	574	-70
0007	3T	134	3630	257	363000	305550	-57450	0.07	0.84	642	540	-102
0007	3T	135	2622	129	262200	180910	-81290	0.05	0.69	464	320	-144
0007	3T	136	2180	84	218000	140480	-77520	0.04	0.64	385	248	-137
0007	3T	142	2178	124	217800	169320	-48480	0.06	0.78	385	299	-86
0007	3T	143	2115	92	211500	178310	-33190	0.04	0.84	374	315	-59
0007	3T	145	1603	63	160300	100470	-59830	0.04	0.63	283	177	-106
0007	3T	146	1191	32	119100	72190	-46910	0.03	0.61	210	127	-83
0007	3T	152	839	38	83900	79790	-4110	0.05	0.95	148	141	-7
0007	3T	153	855	35	85500	80930	-4570	0.04	0.95	151	143	-8
0007	3T	154	736	17	73600	44810	-28790	0.02	0.61	130	79	-51
0007	3T	156	571	10	57100	24900	-32200	0.02	0.44	101	44	-57
0007	3T	162	484	15	48400	36010	-12390	0.03	0.74	85	63	-22
0007	3T	163	450	16	45000	41530	-3470	0.04	0.92	79	73	-6
0007	3T	164	337	7	33700	26740	-6960	0.02	0.79	59	47	-12
0007	3T	165	243	3	24300	43550	19250	0.01	1.79	43	77	34
0007	3T	213	541	21	54100	40030	-14070	0.04	0.74	95	70	-25
0007	3T	214	506	26	50600	54530	3930	0.05	1.08	89	96	7
0007	3T	215	375	11	37500	18960	-18540	0.03	0.51	66	33	-33
0007	3T	216	402	17	40200	48950	8750	0.04	1.22	71	86	15
0007	3T	231	190	2	19000	7800	-11200	0.01	0.41	33	13	-20
0007	3T	234	326	5	32600	19050	-13550	0.02	0.58	57	33	-24
0007	3T	235	266	4	26600	5600	-21000	0.02	0.21	47	9	-38
0007	3T	236	226	4	22600	19250	-3350	0.02	0.85	40	34	-6
0007	3T	241	118	3	11800	4600	-7200	0.03	0.39	20	8	-12
0007	3T	243	202	7	20200	17500	-2700	0.03	0.87	35	30	-5
0007	3T	245	147	2	14700	75080	60380	0.01	5.11	26	132	106
0007	3T	246	146	2	14600	3580	-11020	0.01	0.25	25	6	-19
0007	3T	251	91	0	9100	0	-9100	0.00	0.00	16	0	-16
0007	3T	253	110	2	11000	7680	-3320	0.02	0.70	19	13	-6
0007	3T	254	106	1	10600	3180	-7420	0.01	0.30	18	5	-13
0007	3T	256	101	1	10100	3240	-6860	0.01	0.32	17	5	-12
0007	3T	261	61	1	6100	5250	-850	0.02	0.86	10	9	-1
0007	3T	263	93	4	9300	11170	1870	0.04	1.20	16	19	3
0007	3T	264	67	2	6700	6280	-420	0.03	0.94	11	11	0
0007	3T	265	42	1	4200	8860	4660	0.02	2.11	7	15	8
0028	2T	15	1268	221	126800	128850	2050	0.17	1.02	224	228	4
0028	2T	16	1105	155	110500	115820	5320	0.14	1.05	195	204	9
0028	2T	21	131	6	13100	6230	-6870	0.05	0.48	23	11	-12
0028	2T	23	390	59	39000	35330	-3670	0.15	0.91	69	62	-7
0028	2T	24	202	16	20200	11380	-8820	0.08	0.56	35	20	-15
0028	2T	25	151	17	15100	15410	310	0.11	1.02	26	27	1
0028	2T	26	205	19	20500	15160	-5340	0.09	0.74	36	26	-10
0028	3F	123	14416	3588	1441600	1198090	-243510	0.25	0.83	2551	2120	-431
0028	3F	124	16780	3409	1678000	1252490	-425510	0.20	0.75	2969	2216	-753
0028	3F	125	5628	1054	562800	492410	-70390	0.19	0.87	996	871	-125
0028	3F	126	4856	702	485600	410740	-74860	0.14	0.85	859	726	-133
0028	3F	134	5125	1133	512500	392740	-119760	0.22	0.77	907	695	-212
0028	3F	135	2984	577	298400	228480	-69920	0.19	0.77	528	404	-124
0028	3F	136	2557	401	255700	184480	-71220	0.16	0.72	452	326	-126
0028	3F	145	1203	204	120300	84350	-35950	0.17	0.70	212	149	-63
0028	3F	146	915	122	91500	63240	-28260	0.13	0.69	161	111	-50
0028	3F	156	234	37	23400	18830	-4570	0.16	0.80	41	33	-8
0028	3F	234	75	12	7500	3900	-3600	0.16	0.52	13	6	-7
0028	3F	235	100	21	10000	6960	-3040	0.21	0.70	17	12	-5
0028	3F	236	100	8	10000	4390	-5610	0.08	0.44	17	7	-10
0028	3F	245	43	4	4300	1460	-2840	0.09	0.34	7	2	-5
0028	3F	246	44	5	4400	3340	-1060	0.11	0.76	7	5	-2
0028	3F	256	28	4	2800	1590	-1210	0.14	0.57	4	2	-2
0028	3T	123	14274	1553	1427400	1212320	-215080	0.11	0.85	2526	2145	-381
0028	3T	124	16700	1388	1670000	1259620	-410380	0.08	0.75	2955	2229	-726
0028	3T	125	5595	435	559500	539370	-20130	0.08	0.96	990	954	-36
0028	3T	126	4825	262	482500	426820	-55680	0.05	0.88	853	755	-98
0028	3T	132	89	10	8900	10630	1730	0.11	1.19	15	18	3
0028	3T	134	4503	427	450300	359060	-91240	0.09	0.80	796	635	-161
0028	3T	135	2925	232	292500	238390	-54110	0.08	0.82	517	421	-96
0028	3T	136	2515	167	251500	200640	-50860	0.07	0.80	445	355	-90
0028	3T	142	77	1	7700	790	-6910	0.01	0.10	13	1	-12
0028	3T	143	622	39	62200	51030	-11170	0.06	0.82	110	90	-20
0028	3T	145	1186	73	118600	93360	-25240	0.06	0.79	209	165	-44
0028	3T	146	901	51	90100	63580	-26520	0.06	0.71	159	112	-47
0028	3T	152	10	1	1000	750	-250	0.10	0.75	1	1	0
0028	3T	153	59	2	5900	10310	4410	0.03	1.75	10	18	8
0028	3T	154	17	1	1700	2940	1240	0.06	1.73	3	5	2
0028	3T	156	227	14	22700	27510	4810	0.06	1.21	40	48	8
0028	3T	162	2	0	200	0	-200	0.00	0.00	0	0	0
0028	3T	163	42	1	4200	2140	-2060	0.02	0.51	7	3	-4
0028	3T	164	14	1	1400	990	-410	0.07	0.71	2	1	-1
0028	3T	165	7	0	700	0	-700	0.00	0.00	1	0	-1
0028	3T	213	23	2	2300	8330	6030	0.09	3.62	4	14	10
0028	3T	214	3	0	300	0	-300	0.00	0.00	0	0	0
0028	3T	215	17	0	1700	0	-1700	0.00	0.00	3	0	-3
0028	3T	216	22	2	2200	7500	5300	0.09	3.41	3	13	10
0028	3T	231	30	2	3000	5660	2660	0.07	1.89	5	10	5
0028	3T	234	71	4	7100	5080	-2020	0.06	0.72	12	8	-4
0028	3T	235	88	6	8800	7860	-940	0.07	0.89	15	13	-2
0028	3T	236	94	1	9400	780	-8620	0.01	0.08	16	1	-15
0028	3T	243	4	0	400	0	-400	0.00	0.00	0	0	0
0028	3T	245	42	0	4200	0	-4200	0.00	0.00	7	0	-7
0028	3T	246	44	1	4400	6240	1840	0.02	1.42	7	11	4
0028	3T	251	6	0	600	0	-600	0.00	0.00	1	0	-1
0028	3T	253	12	1	1200	930	-270	0.08	0.78	2	1	-1
0028	3T	254	1	0	100	0	-100	0.00	0.00	0	0	0
0028	3T	256	28	1	2800	710	-2090	0.04	0.25	4	1	-3
0028	3T	261	7	0	700	0	-700	0.00	0.00	1	0	-1
0028	3T	263	6	0	600	0	-600	0.00	0.00	1	0	-1
0039	1T	1	66415	38429	6641500	6113090	-528410	0.58	0.92	11754	10819	-935
0039	1T	2	5854	2355	585400	524190	-61210	0.40	0.90	1036	927	-109
0039	2F	12	36659	12190	3665900	3104650	-561250	0.33	0.85	6488	5494	-994
0039	2F	13	15735	4981	1573500	1251100	-322400	0.32	0.80	2784	2214	-570
0039	2F	14	8361	2478	836100	655250	-180850	0.30	0.78	1479	1159	-320
0039	2F	15	2563	558	256300	213490	-42810	0.22	0.83	453	377	-76
0039	2F	16	2062	395	206200	177810	-28390	0.19	0.86	364	314	-50
0039	2F	23	316	72	31600	21510	-10090	0.23	0.68	55	38	-17
0039	2F	24	208	46	20800	14800	-6000	0.22	0.71	36	26	-10
0039	2F	25	247	46	24700	16610	-8090	0.19	0.67	43	29	-14
0039	2F	26	390	68	39000	29540	-9460	0.17	0.76	69	52	-17
0039	2T	12	36562	9169	3656200	2977610	-678590	0.25	0.81	6471	5270	-1201
0039	2T	13	15735	3560	1573500	1201240	-372260	0.23	0.76	2784	2126	-658
0039	2T	14	8361	1772	836100	665660	-170440	0.21	0.80	1479	1178	-301
0039	2T	15	2563	387	256300	219690	-36610	0.15	0.86	453	388	-65
0039	2T	16	2062	273	206200	179460	-26740	0.13	0.87	364	317	-47
0039	2T	21	97	11	9700	9380	-320	0.11	0.97	17	16	-1
0039	2T	23	316	41	31600	20450	-11150	0.13	0.65	55	36	-19
0039	2T	24	208	26	20800	13470	-7330	0.13	0.65	36	23	-13
0039	2T	25	247	26	24700	17430	-7270	0.11	0.71	43	30	-13
0039	2T	26	390	37	39000	25610	-13390	0.09	0.66	69	45	-24
0039	3F	123	9623	2572	962300	796960	-165340	0.27	0.83	1703	1410	-293
0039	3F	124	14160	2949	1416000	1033000	-383000	0.21	0.73	2506	1828	-678
0039	3F	125	6051	1129	605100	499460	-105640	0.19	0.83	1070	884	-186
0039	3F	126	5165	770	516500	440980	-75520	0.15	0.85	914	780	-134
0039	3F	134	5230	1223	523000	410030	-112970	0.23	0.78	925	725	-200
0039	3F	135	3201	619	320100	218650	-101450	0.19	0.68	566	386	-180
0039	3F	136	3110	494	311000	243150	-67850	0.16	0.78	550	430	-120
0039	3F	145	1151	213	115100	95560	-19540	0.19	0.83	203	169	-34
0039	3F	146	1052	152	105200	79040	-26160	0.14	0.75	186	139	-47
0039	3F	156	401	57	40100	34650	-5450	0.14	0.86	70	61	-9
0039	3F	234	80	16	8000	4490	-3510	0.20	0.56	14	7	-7
0039	3F	235	71	12	7100	4200	-2900	0.17	0.59	12	7	-5
0039	3F	236	89	18	8900	7340	-1560	0.20	0.82	15	12	-3
0039	3F	245	28	3	2800	1560	-1240	0.11	0.56	4	2	-2
0039	3F	246	34	6	3400	2620	-780	0.18	0.77	6	4	-2
0039	3F	256	35	3	3500	1170	-2330	0.09	0.33	6	2	-4
0039	3T	123	9477	1159	947700	851010	-96690	0.12	0.90	1677	1506	-171
0039	3T	124	14085	1243	1408500	1032360	-376140	0.09	0.73	2492	1827	-665
0039	3T	125	6022	461	602200	518760	-83440	0.08	0.86	1065	918	-147
0039	3T	126	5101	313	510100	448230	-61870	0.06	0.88	902	793	-109
0039	3T	132	135	14	13500	10540	-2960	0.10	0.78	23	18	-5
0039	3T	134	5127	512	512700	404120	-108580	0.10	0.79	907	715	-192
0039	3T	135	3146	238	314600	203540	-111060	0.08	0.65	556	360	-196
0039	3T	136	3084	203	308400	265250	-43150	0.07	0.86	545	469	-76
0039	3T	142	60	4	6000	3370	-2630	0.07	0.56	10	5	-5
0039	3T	143	103	10	10300	10380	80	0.10	1.01	18	18	0
0039	3T	145	1121	71	112100	92690	-19410	0.06	0.83	198	164	-34
0039	3T	146	1019	61	101900	83340	-18560	0.06	0.82	180	147	-33
0039	3T	152	16	0	1600	0	-1600	0.00	0.00	2	0	-2
0039	3T	153	55	3	5500	4690	-810	0.05	0.85	9	8	-1
0039	3T	154	30	3	3000	3180	180	0.10	1.06	5	5	0
0039	3T	156	394	18	39400	34260	-5140	0.05	0.87	69	60	-9
0039	3T	162	7	0	700	0	-700	0.00	0.00	1	0	-1
0039	3T	163	26	1	2600	630	-1970	0.04	0.24	4	1	-3
0039	3T	164	33	3	3300	15330	12030	0.09	4.65	5	27	22
0039	3T	165	7	0	700	0	-700	0.00	0.00	1	0	-1
0039	3T	213	10	0	1000	0	-1000	0.00	0.00	1	0	-1
0039	3T	214	15	0	1500	0	-1500	0.00	0.00	2	0	-2
0039	3T	215	13	2	1300	5360	4060	0.15	4.12	2	9	7
0039	3T	216	57	3	5700	9950	4250	0.05	1.75	10	17	7
0039	3T	231	1	0	100	0	-100	0.00	0.00	0	0	0
0039	3T	234	77	4	7700	3720	-3980	0.05	0.48	13	6	-7
0039	3T	235	66	3	6600	3460	-3140	0.05	0.52	11	6	-5
0039	3T	236	87	6	8700	7100	-1600	0.07	0.82	15	12	-3
0039	3T	243	3	0	300	0	-300	0.00	0.00	0	0	0
0039	3T	245	27	0	2700	0	-2700	0.00	0.00	4	0	-4
0039	3T	246	34	2	3400	2480	-920	0.06	0.73	6	4	-2
0039	3T	253	5	0	500	0	-500	0.00	0.00	0	0	0
0039	3T	254	1	0	100	0	-100	0.00	0.00	0	0	0
0039	3T	256	33	0	3300	0	-3300	0.00	0.00	5	0	-5
0039	3T	263	2	0	200	0	-200	0.00	0.00	0	0	0
0039	3T	265	2	0	200	0	-200	0.00	0.00	0	0	0
0047	1T	1	22959	15481	2295900	2195370	-100530	0.67	0.96	4063	3885	-178
0047	1T	2	12310	3232	1231000	1143490	-87510	0.26	0.93	2178	2023	-155
0047	2F	12	8854	3025	885400	782280	-103120	0.34	0.88	1567	1384	-183
0047	2F	13	4825	1364	482500	430060	-52440	0.28	0.89	853	761	-92
0047	2F	14	4590	1033	459000	379190	-79810	0.23	0.83	812	671	-141
0047	2F	15	3512	462	351200	293360	-57840	0.13	0.84	621	519	-102
0047	2F	16	2730	251	273000	225360	-47640	0.09	0.83	483	398	-85
0047	2F	23	1978	201	197800	138360	-59440	0.10	0.70	350	244	-106
0047	2F	24	1813	169	181300	143460	-37840	0.09	0.79	320	253	-67
0047	2F	25	1829	130	182900	141500	-41400	0.07	0.77	323	250	-73
0047	2F	26	1871	113	187100	132280	-54820	0.06	0.71	331	234	-97
0047	2T	12	5853	1642	585300	507000	-78300	0.28	0.87	1035	897	-138
0047	2T	13	4825	1107	482500	434310	-48190	0.23	0.90	853	768	-85
0047	2T	14	4590	856	459000	384410	-74590	0.19	0.84	812	680	-132
0047	2T	15	3512	368	351200	283870	-67330	0.10	0.81	621	502	-119
0047	2T	16	2730	200	273000	229460	-43540	0.07	0.84	483	406	-77
0047	2T	21	3001	404	300100	325480	25380	0.13	1.08	531	576	45
0047	2T	23	1978	123	197800	149160	-48640	0.06	0.75	350	264	-86
0047	2T	24	1813	105	181300	177860	-3440	0.06	0.98	320	314	-6
0047	2T	25	1829	83	182900	120420	-62480	0.05	0.66	323	213	-110
0047	2T	26	1871	74	187100	144310	-42790	0.04	0.77	331	255	-76
0047	3F	123	3596	820	359600	291320	-68280	0.23	0.81	636	515	-121
0047	3F	124	3382	645	338200	261570	-76630	0.19	0.77	598	462	-136
0047	3F	125	2764	351	276400	210750	-65650	0.13	0.76	489	373	-116
0040	1T	1	62187	37062	6218700	5732370	-486330	0.60	0.92	11006	10145	-861
0040	1T	2	8003	3039	800300	711680	-88620	0.38	0.89	1416	1259	-157
0040	2F	12	30714	10540	3071400	2598990	-472410	0.34	0.85	5436	4599	-837
0040	2F	13	16367	5129	1636700	1296750	-339950	0.31	0.79	2896	2295	-601
0040	2F	14	8704	2509	870400	676020	-194380	0.29	0.78	1540	1196	-344
0040	2F	15	2449	582	244900	202210	-42690	0.24	0.83	433	357	-76
0040	2F	16	1945	397	194500	167590	-26910	0.20	0.86	344	296	-48
0040	2F	23	635	166	63500	59640	-3860	0.26	0.94	112	105	-7
0040	2F	24	447	88	44700	32900	-11800	0.20	0.74	79	58	-21
0040	2F	25	335	66	33500	31020	-2480	0.20	0.93	59	54	-5
0040	2F	26	416	75	41600	34230	-7370	0.18	0.82	73	60	-13
0040	2T	12	30521	7996	3052100	2489020	-563080	0.26	0.82	5401	4405	-996
0040	2T	13	16367	3718	1636700	1249550	-387150	0.23	0.76	2896	2211	-685
0040	2T	14	8704	1833	870400	680380	-190020	0.21	0.78	1540	1204	-336
0040	2T	15	2449	409	244900	207970	-36930	0.17	0.85	433	368	-65
0040	2T	16	1945	276	194500	167850	-26650	0.14	0.86	344	297	-47
0040	2T	21	193	16	19300	10820	-8480	0.08	0.56	34	19	-15
0040	2T	23	635	90	63500	55410	-8090	0.14	0.87	112	98	-14
0040	2T	24	447	48	44700	31360	-13340	0.11	0.70	79	55	-24
0040	2T	25	335	43	33500	33020	-480	0.13	0.99	59	58	-1
0040	2T	26	416	40	41600	32080	-9520	0.10	0.77	73	56	-17
0040	3F	123	5737	1645	573700	470110	-103590	0.29	0.82	1015	832	-183
0040	3F	124	10659	2415	1065900	806160	-259740	0.23	0.76	1886	1426	-460
0040	3F	125	6255	1130	625500	502450	-123050	0.18	0.80	1107	889	-218
0040	3F	126	7145	928	714500	619080	-95420	0.13	0.87	1264	1095	-169
0040	3F	134	4815	1106	481500	372970	-108530	0.23	0.77	852	660	-192
0040	3F	135	4066	743	406600	290480	-116120	0.18	0.71	719	514	-205
0040	3F	136	4256	536	425600	309310	-116290	0.13	0.73	753	547	-206
0040	3F	145	1742	302	174200	127140	-47060	0.17	0.73	308	225	-83
0040	3F	146	1427	221	142700	131250	-11450	0.15	0.92	252	232	-20
0040	3F	156	347	53	34700	28880	-5820	0.15	0.83	61	51	-10
0040	3F	234	128	22	12800	7800	-5000	0.17	0.61	22	13	-9
0040	3F	235	196	30	19600	14700	-4900	0.15	0.75	34	26	-8
0040	3F	236	188	22	18800	10590	-8210	0.12	0.56	33	18	-15
0040	3F	245	103	10	10300	4210	-6090	0.10	0.41	18	7	-11
0040	3F	246	96	18	9600	10600	1000	0.19	1.10	16	18	2
0040	3F	256	39	7	3900	4270	370	0.18	1.09	6	7	1
0040	3T	123	5657	756	565700	475050	-90650	0.13	0.84	1001	840	-161
0040	3T	124	10594	1068	1059400	811980	-247420	0.10	0.77	1875	1437	-438
0040	3T	125	6214	478	621400	514220	-107180	0.08	0.83	1099	910	-189
0040	3T	126	7048	401	704800	610680	-94120	0.06	0.87	1247	1080	-167
0040	3T	132	62	3	6200	2070	-4130	0.05	0.33	10	3	-7
0040	3T	134	4724	479	472400	380560	-91840	0.10	0.81	836	673	-163
0040	3T	135	4022	314	402200	289690	-112510	0.08	0.72	711	512	-199
0040	3T	136	4228	235	422800	307780	-115020	0.06	0.73	748	544	-204
0040	3T	142	17	0	1700	0	-1700	0.00	0.00	3	0	-3
0040	3T	143	91	5	9100	8110	-990	0.05	0.89	16	14	-2
0040	3T	145	1671	99	167100	106740	-60360	0.06	0.64	295	188	-107
0040	3T	146	1358	99	135800	140800	5000	0.07	1.04	240	249	9
0040	3T	152	10	1	1000	1160	160	0.10	1.16	1	2	1
0040	3T	153	44	2	4400	2300	-2100	0.05	0.52	7	4	-3
0040	3T	154	71	4	7100	6250	-850	0.06	0.88	12	11	-1
0040	3T	156	339	17	33900	25130	-8770	0.05	0.74	60	44	-16
0040	3T	162	3	0	300	0	-300	0.00	0.00	0	0	0
0040	3T	163	28	0	2800	0	-2800	0.00	0.00	4	0	-4
0040	3T	164	69	2	6900	3820	-3080	0.03	0.55	12	6	-6
0040	3T	165	8	0	800	0	-800	0.00	0.00	1	0	-1
0040	3T	213	18	1	1800	2190	390	0.06	1.22	3	3	0
0040	3T	214	48	2	4800	3200	-1600	0.04	0.67	8	5	-3
0040	3T	215	31	0	3100	0	-3100	0.00	0.00	5	0	-5
0040	3T	216	94	4	9400	15250	5850	0.04	1.62	16	26	10
0040	3T	234	126	7	12600	12220	-380	0.06	0.97	22	21	-1
0040	3T	235	190	8	19000	16930	-2070	0.04	0.89	33	29	-4
0040	3T	236	188	9	18800	10420	-8380	0.05	0.55	33	18	-15
0040	3T	243	2	0	200	0	-200	0.00	0.00	0	0	0
0040	3T	245	101	5	10100	9040	-1060	0.05	0.90	17	16	-1
0040	3T	246	91	4	9100	3800	-5300	0.04	0.42	16	6	-10
0040	3T	253	6	0	600	0	-600	0.00	0.00	1	0	-1
0040	3T	254	2	0	200	0	-200	0.00	0.00	0	0	0
0040	3T	256	39	1	3900	770	-3130	0.03	0.20	6	1	-5
0040	3T	264	5	1	500	1460	960	0.20	2.92	0	2	2
0047	3F	126	2403	261	240300	215690	-24610	0.11	0.90	425	381	-44
0047	3F	134	2064	348	206400	168400	-38000	0.17	0.82	365	298	-67
0047	3F	135	1610	189	161000	127420	-33580	0.12	0.79	284	225	-59
0047	3F	136	1312	114	131200	111990	-19210	0.09	0.85	232	198	-34
0047	3F	145	1522	149	152200	130350	-21850	0.10	0.86	269	230	-39
0047	3F	146	1198	88	119800	96150	-23650	0.07	0.80	212	170	-42
0047	3F	156	972	48	97200	64570	-32630	0.05	0.66	172	114	-58
0047	3F	234	707	55	70700	42710	-27990	0.08	0.60	125	75	-50
0047	3F	235	654	34	65400	35820	-29580	0.05	0.55	115	63	-52
0047	3F	236	681	28	68100	26650	-41450	0.04	0.39	120	47	-73
0047	3F	245	569	28	56900	38480	-18420	0.05	0.68	100	68	-32
0047	3F	246	574	27	57400	36000	-21400	0.05	0.63	101	63	-38
0047	3F	256	552	16	55200	36240	-18960	0.03	0.66	97	64	-33
0047	3T	123	1511	175	151100	134030	-17070	0.12	0.89	267	237	-30
0047	3T	124	1376	119	137600	107260	-30340	0.09	0.78	243	189	-54
0047	3T	125	1036	59	103600	68280	-35320	0.06	0.66	183	120	-63
0047	3T	126	915	58	91500	120410	28910	0.06	1.32	161	213	52
0047	3T	132	1074	105	107400	109710	2310	0.10	1.02	190	194	4
0047	3T	134	1102	102	110200	101240	-8960	0.09	0.92	195	179	-16
0047	3T	135	935	57	93500	76960	-16540	0.06	0.82	165	136	-29
0047	3T	136	755	33	75500	66620	-8880	0.04	0.88	133	117	-16
0047	3T	142	1024	82	102400	101150	-1250	0.08	0.99	181	179	-2
0047	3T	143	962	49	96200	76850	-19350	0.05	0.80	170	136	-34
0047	3T	145	852	38	85200	75190	-10010	0.04	0.88	150	133	-17
0047	3T	146	707	36	70700	84770	14070	0.05	1.20	125	150	25
0047	3T	152	736	29	73600	49450	-24150	0.04	0.67	130	87	-43
0047	3T	153	675	17	67500	40280	-27220	0.03	0.60	119	71	-48
0047	3T	154	670	12	67000	47870	-19130	0.02	0.71	118	84	-34
0047	3T	156	604	16	60400	64450	4050	0.03	1.07	106	114	8
0047	3T	162	532	18	53200	50560	-2640	0.03	0.95	94	89	-5
0047	3T	163	557	11	55700	35190	-20510	0.02	0.63	98	62	-36
0047	3T	164	491	8	49100	24090	-25010	0.02	0.49	86	42	-44
0047	3T	165	368	1	36800	8020	-28780	0.00	0.22	65	14	-51
0047	3T	213	602	27	60200	69810	9610	0.04	1.16	106	123	17
0047	3T	214	581	26	58100	53790	-4310	0.04	0.93	102	95	-7
0047	3T	215	543	22	54300	93580	39280	0.04	1.72	96	165	69
0047	3T	216	512	12	51200	37060	-14140	0.02	0.72	90	65	-25
0047	3T	231	409	11	40900	51750	10850	0.03	1.27	72	91	19
0047	3T	234	378	11	37800	49630	11830	0.03	1.31	66	87	21
0047	3T	235	342	7	34200	9680	-24520	0.02	0.28	60	17	-43
0047	3T	236	339	3	33900	3620	-30280	0.01	0.11	60	6	-54
0047	3T	241	401	10	40100	37790	-2310	0.02	0.94	70	66	-4
0047	3T	243	329	5	32900	8170	-24730	0.02	0.25	58	14	-44
0047	3T	245	299	7	29900	106970	77070	0.02	3.58	52	189	137
0047	3T	246	285	5	28500	65430	36930	0.02	2.30	50	115	65
0047	3T	251	449	0	44900	0	-44900	0.00	0.00	79	0	-79
0047	3T	253	312	2	31200	4790	-26410	0.01	0.15	55	8	-47
0047	3T	254	270	4	27000	15660	-11340	0.01	0.58	47	27	-20
0047	3T	256	296	1	29600	1380	-28220	0.00	0.05	52	2	-50
0047	3T	261	444	6	44400	34960	-9440	0.01	0.79	78	61	-17
0047	3T	263	342	5	34200	20990	-13210	0.01	0.61	60	37	-23
0047	3T	264	289	4	28900	13940	-14960	0.01	0.48	51	24	-27
0047	3T	265	256	2	25600	6380	-19220	0.01	0.25	45	11	-34
0048	1T	1	22234	15563	2223400	2020270	-203130	0.70	0.91	3935	3575	-360
0048	1T	2	9577	3137	957700	838630	-119070	0.33	0.88	1695	1484	-211
0048	2F	12	8490	3202	849000	692960	-156040	0.38	0.82	1502	1226	-276
0048	2F	13	4829	1509	482900	394100	-88800	0.31	0.82	854	697	-157
0048	2F	14	3830	898	383000	290530	-92470	0.23	0.76	677	514	-163
0048	2F	15	3122	460	312200	264460	-47740	0.15	0.85	552	468	-84
0048	2F	16	2386	240	238600	200570	-38030	0.10	0.84	422	354	-68
0048	2F	23	803	146	80300	58800	-21500	0.18	0.73	142	104	-38
0048	2F	24	1211	171	121100	83310	-37790	0.14	0.69	214	147	-67
0048	2F	25	1884	206	188400	149070	-39330	0.11	0.79	333	263	-70
0048	2F	26	1811	131	181100	126050	-55050	0.07	0.70	320	223	-97
0048	2T	12	7675	2353	767500	598100	-169400	0.31	0.78	1358	1058	-300
0048	2T	13	4829	1190	482900	367200	-115700	0.25	0.76	854	649	-205
0048	2T	14	3830	733	383000	285200	-97800	0.19	0.74	677	504	-173
0048	2T	15	3122	384	312200	269040	-43160	0.12	0.86	552	476	-76
0048	2T	16	2386	213	238600	219310	-19290	0.09	0.92	422	388	-34
0048	2T	21	815	111	81500	73720	-7780	0.14	0.90	144	130	-14
0048	2T	23	803	80	80300	51970	-28330	0.10	0.65	142	91	-51
0048	2T	24	1211	114	121100	84040	-37060	0.09	0.69	214	148	-66
0048	2T	25	1884	140	188400	136760	-51640	0.07	0.73	333	242	-91
0048	2T	26	1811	89	181100	117690	-63410	0.05	0.65	320	208	-112
0048	3F	123	1774	539	177400	149190	-28210	0.30	0.84	313	264	-49
0048	3F	124	3159	700	315900	240700	-75200	0.22	0.76	559	426	-133
0048	3F	125	2014	276	201400	145400	-56000	0.14	0.72	356	257	-99
0048	3F	126	3106	266	310600	224180	-86420	0.09	0.72	549	396	-153
0048	3F	134	1365	261	136500	104390	-32110	0.19	0.76	241	184	-57
0048	3F	135	1060	138	106000	80000	-26000	0.13	0.75	187	141	-46
0048	3F	136	1552	144	155200	127120	-28080	0.09	0.82	274	224	-50
0048	3F	145	975	105	97500	71490	-26010	0.11	0.73	172	126	-46
0048	3F	146	1090	83	109000	77180	-31820	0.08	0.71	192	136	-56
0048	3F	156	994	40	99400	61360	-38040	0.04	0.62	175	108	-67
0048	3F	234	122	10	12200	10100	-2100	0.08	0.83	21	17	-4
0048	3F	235	138	12	13800	8130	-5670	0.09	0.59	24	14	-10
0048	3F	236	152	11	15200	12900	-2300	0.07	0.85	26	22	-4
0048	3F	245	168	13	16800	9370	-7430	0.08	0.56	29	16	-13
0048	3F	246	197	15	19700	15810	-3890	0.08	0.80	34	27	-7
0048	3F	256	334	15	33400	16800	-16600	0.04	0.50	59	29	-30
0048	3T	123	1106	175	110600	90270	-20330	0.16	0.82	195	159	-36
0048	3T	124	2246	234	224600	157020	-67580	0.10	0.70	397	277	-120
0048	3T	125	1174	98	117400	89900	-27500	0.08	0.77	207	159	-48
0048	3T	126	2423	102	242300	172530	-69770	0.04	0.71	428	305	-123
0048	3T	132	294	32	29400	23360	-6040	0.11	0.79	52	41	-11
0048	3T	134	1242	124	124200	98950	-25250	0.10	0.80	219	175	-44
0048	3T	135	889	52	88900	63390	-25510	0.06	0.71	157	112	-45
0048	3T	136	1469	68	146900	122280	-24620	0.05	0.83	260	216	-44
0048	3T	142	216	18	21600	17300	-4300	0.08	0.80	38	30	-8
0048	3T	143	123	8	12300	9340	-2960	0.07	0.76	21	16	-5
0048	3T	145	709	28	70900	42690	-28210	0.04	0.60	125	75	-50
0048	3T	146	968	35	96800	60920	-35880	0.04	0.63	171	107	-64
0048	3T	152	137	6	13700	12890	-810	0.04	0.94	24	22	-2
0048	3T	153	171	7	17100	15660	-1440	0.04	0.92	30	27	-3
0048	3T	154	266	7	26600	28390	1790	0.03	1.07	47	50	3
0048	3T	156	930	20	93000	69390	-23610	0.02	0.75	164	122	-42
0048	3T	162	61	2	6100	2110	-3990	0.03	0.35	10	3	-7
0048	3T	163	83	3	8300	6340	-1960	0.04	0.76	14	11	-3
0048	3T	164	122	2	12200	5150	-7050	0.02	0.42	21	9	-12
0048	3T	165	64	2	6400	14550	8150	0.03	2.27	11	25	14
0048	3T	213	58	5	5800	4180	-1620	0.09	0.72	10	7	-3
0048	3T	214	122	5	12200	7900	-4300	0.04	0.65	21	13	-8
0048	3T	215	131	3	13100	8720	-4380	0.02	0.67	23	15	-8
0048	3T	216	229	3	22900	15610	-7290	0.01	0.68	40	27	-13
0048	3T	231	316	11	31600	28430	-3170	0.03	0.90	55	50	-5
0048	3T	234	119	2	11900	6320	-5580	0.02	0.53	21	11	-10
0048	3T	235	122	1	12200	1000	-11200	0.01	0.08	21	1	-20
0048	3T	236	129	6	12900	26380	13480	0.05	2.04	22	46	24
0048	3T	241	575	25	57500	48020	-9480	0.04	0.84	101	84	-17
0048	3T	243	3	0	300	0	-300	0.00	0.00	0	0	0
0048	3T	245	105	2	10500	3880	-6620	0.02	0.37	18	6	-12
0048	3T	246	161	5	16100	19500	3400	0.03	1.21	28	34	6
0048	3T	251	572	13	57200	33510	-23690	0.02	0.59	101	59	-42
0048	3T	253	16	0	1600	0	-1600	0.00	0.00	2	0	-2
0048	3T	254	63	1	6300	1540	-4760	0.02	0.24	11	2	-9
0048	3T	256	296	6	29600	8050	-21550	0.02	0.27	52	14	-38
0048	3T	261	393	3	39300	8720	-30580	0.01	0.22	69	15	-54
0048	3T	263	23	1	2300	1140	-1160	0.04	0.50	4	2	-2
0048	3T	264	36	0	3600	0	-3600	0.00	0.00	6	0	-6
0048	3T	265	38	0	3800	0	-3800	0.00	0.00	6	0	-6
0049	1T	1	22264	15937	2226400	2030510	-195890	0.72	0.91	3940	3593	-347
0049	1T	2	9925	3313	992500	843280	-149220	0.33	0.85	1756	1492	-264
0049	2F	12	8764	3412	876400	723650	-152750	0.39	0.83	1551	1280	-271
0049	2F	13	4853	1572	485300	395000	-90300	0.32	0.81	858	699	-159
0049	2F	14	4107	976	410700	309000	-101700	0.24	0.75	726	546	-180
0049	2F	15	2958	446	295800	248720	-47080	0.15	0.84	523	440	-83
0049	2F	16	2079	219	207900	174790	-33110	0.11	0.84	367	309	-58
0049	2F	23	815	150	81500	63970	-17530	0.18	0.78	144	113	-31
0049	2F	24	1291	184	129100	88800	-40300	0.14	0.69	228	157	-71
0049	2F	25	1796	198	179600	128070	-51530	0.11	0.71	317	226	-91
0049	2F	26	1803	126	180300	120490	-59810	0.07	0.67	319	213	-106
0049	2T	12	7881	2524	788100	627230	-160870	0.32	0.80	1394	1110	-284
0049	2T	13	4853	1283	485300	382200	-103100	0.26	0.79	858	676	-182
0049	2T	14	4107	796	410700	294040	-116660	0.19	0.72	726	520	-206
0049	2T	15	2958	376	295800	250510	-45290	0.13	0.85	523	443	-80
0049	2T	16	2079	187	207900	175150	-32750	0.09	0.84	367	310	-57
0049	2T	21	883	129	88300	75080	-13220	0.15	0.85	156	132	-24
0049	2T	23	815	86	81500	66980	-14520	0.11	0.82	144	118	-26
0049	2T	24	1291	119	129100	87940	-41160	0.09	0.68	228	155	-73
0049	2T	25	1796	144	179600	120970	-58630	0.08	0.67	317	214	-103
0049	2T	26	1803	100	180300	134930	-45370	0.06	0.75	319	238	-81
0049	3F	123	1563	473	156300	121980	-34320	0.30	0.78	276	215	-61
0049	3F	124	3199	702	319900	232530	-87370	0.22	0.73	566	411	-155
0049	3F	125	2049	297	204900	156000	-48900	0.14	0.76	362	276	-86
0049	3F	126	3225	295	322500	258020	-64480	0.09	0.80	570	456	-114
0049	3F	134	1464	263	146400	108950	-37450	0.18	0.74	259	192	-67
0049	3F	135	1086	133	108600	66070	-42530	0.12	0.61	192	116	-76
0049	3F	136	1578	134	157800	121390	-36410	0.08	0.77	279	214	-65
0049	3F	145	1078	95	107800	59710	-48090	0.09	0.55	190	105	-85
0049	3F	146	1262	106	126200	100910	-25290	0.08	0.80	223	178	-45
0049	3F	156	1038	44	103800	70340	-33460	0.04	0.68	183	124	-59
0049	3F	234	116	15	11600	9620	-1980	0.13	0.83	20	17	-3
0049	3F	235	140	13	14000	7870	-6130	0.09	0.56	24	13	-11
0049	3F	236	170	7	17000	8890	-8110	0.04	0.52	30	15	-15
0049	3F	245	206	14	20600	8350	-12250	0.07	0.41	36	14	-22
0049	3F	246	183	4	18300	2350	-15950	0.02	0.13	32	4	-28
0049	3F	256	278	18	27800	16480	-11320	0.06	0.59	49	29	-20
0049	3T	123	1017	170	101700	85620	-16080	0.17	0.84	180	151	-29
0049	3T	124	2293	252	229300	158700	-70600	0.11	0.69	405	280	-125
0049	3T	125	1257	104	125700	90410	-35290	0.08	0.72	222	160	-62
0049	3T	126	2638	136	263800	212840	-50960	0.05	0.81	466	376	-90
0049	3T	132	165	20	16500	13790	-2710	0.12	0.84	29	24	-5
0049	3T	134	1393	132	139300	113730	-25570	0.09	0.82	246	201	-45
0049	3T	135	913	57	91300	55330	-35970	0.06	0.61	161	97	-64
0049	3T	136	1498	75	149800	132660	-17140	0.05	0.89	265	234	-31
0049	3T	142	175	22	17500	18440	940	0.13	1.05	30	32	2
0049	3T	143	71	7	7100	6170	-930	0.10	0.87	12	10	-2
0049	3T	145	834	28	83400	32500	-50900	0.03	0.39	147	57	-90
0049	3T	146	1136	54	113600	89340	-24260	0.05	0.79	201	158	-43
0049	3T	152	134	2	13400	3170	-10230	0.01	0.24	23	5	-18
0049	3T	153	173	6	17300	8710	-8590	0.03	0.50	30	15	-15
0049	3T	154	244	9	24400	31080	6680	0.04	1.27	43	55	12
0049	3T	156	961	24	96100	76600	-19500	0.02	0.80	170	135	-35
0049	3T	162	53	0	5300	0	-5300	0.00	0.00	9	0	-9
0049	3T	163	80	2	8000	4030	-3970	0.03	0.50	14	7	-7
0049	3T	164	126	3	12600	9260	-3340	0.02	0.73	22	16	-6
0049	3T	165	77	2	7700	8560	860	0.03	1.11	13	15	2
0049	3T	213	69	8	6900	8350	1450	0.12	1.21	12	14	2
0049	3T	214	134	9	13400	11530	-1870	0.07	0.86	23	20	-3
0049	3T	215	146	5	14600	6330	-8270	0.03	0.43	25	11	-14
0049	3T	216	203	6	20300	18220	-2080	0.03	0.90	35	32	-3
0049	3T	231	312	6	31200	7360	-23840	0.02	0.24	55	13	-42
0049	3T	234	113	7	11300	26270	14970	0.06	2.32	20	46	26
0049	3T	235	105	3	10500	5930	-4570	0.03	0.56	18	10	-8
0049	3T	236	150	5	15000	14570	-430	0.03	0.97	26	25	-1
0049	3T	241	597	19	59700	36230	-23470	0.03	0.61	105	64	-41
0049	3T	243	3	1	300	3010	2710	0.33	10.03	0	5	5
0049	3T	245	134	3	13400	6910	-6490	0.02	0.52	23	12	-11
0049	3T	246	158	2	15800	3270	-12530	0.01	0.21	27	5	-22
0049	3T	251	512	10	51200	23950	-27250	0.02	0.47	90	42	-48
0049	3T	253	35	0	3500	0	-3500	0.00	0.00	6	0	-6
0049	3T	254	72	2	7200	5380	-1820	0.03	0.75	12	9	-3
0049	3T	256	255	7	25500	11680	-13820	0.03	0.46	45	20	-25
0049	3T	261	331	3	33100	6010	-27090	0.01	0.18	58	10	-48
0049	3T	263	20	0	2000	0	-2000	0.00	0.00	3	0	-3
0049	3T	264	25	0	2500	0	-2500	0.00	0.00	4	0	-4
0049	3T	265	23	0	2300	0	-2300	0.00	0.00	4	0	-4
0050	1T	1	59073	35246	5907300	5432120	-475180	0.60	0.92	10455	9614	-841
0050	1T	2	7905	2488	790500	718200	-72300	0.31	0.91	1399	1271	-128
0050	2F	12	20372	6315	2037200	1728810	-308390	0.31	0.85	3605	3059	-546
0050	2F	13	13132	3285	1313200	1045690	-267510	0.25	0.80	2324	1850	-474
0050	2F	14	9388	1955	938800	738470	-200330	0.21	0.79	1661	1307	-354
0050	2F	15	5194	727	519400	442890	-76510	0.14	0.85	919	783	-136
0050	2F	16	3062	351	306200	223720	-82480	0.11	0.73	541	395	-146
0050	2F	23	1430	216	143000	122690	-20310	0.15	0.86	253	217	-36
0050	2F	24	1075	146	107500	81080	-26420	0.14	0.75	190	143	-47
0050	2F	25	751	69	75100	44690	-30410	0.09	0.60	132	79	-53
0050	2F	26	576	55	57600	43060	-14540	0.10	0.75	101	76	-25
0050	2T	12	18713	4468	1871300	1524330	-346970	0.24	0.81	3312	2697	-615
0050	2T	13	13132	2558	1313200	1030220	-282980	0.19	0.78	2324	1823	-501
0050	2T	14	9388	1460	938800	722300	-216500	0.16	0.77	1661	1278	-383
0050	2T	15	5194	570	519400	455490	-63910	0.11	0.88	919	806	-113
0050	2T	16	3062	267	306200	239870	-66330	0.09	0.78	541	424	-117
0050	2T	21	1659	195	165900	148310	-17590	0.12	0.89	293	262	-31
0050	2T	23	1430	131	143000	133610	-9390	0.09	0.93	253	236	-17
0050	2T	24	1075	89	107500	74150	-33350	0.08	0.69	190	131	-59
0050	2T	25	751	41	75100	40360	-34740	0.05	0.54	132	71	-61
0050	2T	26	576	31	57600	40040	-17560	0.05	0.70	101	70	-31
0050	3F	123	7401	1642	740100	626730	-113370	0.22	0.85	1309	1109	-200
0050	3F	124	6517	1140	651700	477760	-173940	0.17	0.73	1153	845	-308
0050	3F	125	4353	573	435300	357640	-77660	0.13	0.82	770	632	-138
0050	3F	126	3479	337	347900	259010	-88890	0.10	0.74	615	458	-157
0050	3F	134	4826	722	482600	367130	-115470	0.15	0.76	854	649	-205
0050	3F	135	3210	369	321000	255570	-65430	0.11	0.80	568	452	-116
0050	3F	136	2486	228	248600	150590	-98010	0.09	0.61	440	266	-174
0050	3F	145	2548	247	254800	181220	-73580	0.10	0.71	450	320	-130
0050	3F	146	1854	149	185400	145970	-39430	0.08	0.79	328	258	-70
0050	3F	156	1132	80	113200	94320	-18880	0.07	0.83	200	166	-34
0050	3F	234	507	49	50700	38350	-12350	0.10	0.76	89	67	-22
0050	3F	235	370	31	37000	28140	-8860	0.08	0.76	65	49	-16
0050	3F	236	328	23	32800	21950	-10850	0.07	0.67	58	38	-20
0050	3F	245	296	20	29600	31570	1970	0.07	1.07	52	55	3
0050	3F	246	286	25	28600	16670	-11930	0.09	0.58	50	29	-21
0050	3F	256	218	13	21800	33840	12040	0.06	1.55	38	59	21
0050	3T	123	4384	452	438400	385730	-52670	0.10	0.88	775	682	-93
0050	3T	124	4353	342	435300	298370	-136930	0.08	0.69	770	528	-242
0050	3T	125	3044	194	304400	274070	-30330	0.06	0.90	538	485	-53
0050	3T	126	2572	107	257200	182530	-74670	0.04	0.71	455	323	-132
0050	3T	132	2542	177	254200	195650	-58550	0.07	0.77	449	346	-103
0050	3T	134	2901	201	290100	238200	-51900	0.07	0.82	513	421	-92
0050	3T	135	2222	107	222200	137180	-85020	0.05	0.62	393	242	-151
0050	3T	136	1907	75	190700	103140	-87560	0.04	0.54	337	182	-155
0050	3T	142	1726	100	172600	115280	-57320	0.06	0.67	305	204	-101
0050	3T	143	1925	91	192500	149480	-43020	0.05	0.78	340	264	-76
0050	3T	145	1542	44	154200	77290	-76910	0.03	0.50	272	136	-136
0050	3T	146	1304	47	130400	109470	-20930	0.04	0.84	230	193	-37
0050	3T	152	947	38	94700	74940	-19760	0.04	0.79	167	132	-35
0050	3T	153	988	36	98800	100180	1380	0.04	1.01	174	177	3
0050	3T	154	1006	25	100600	80280	-20320	0.02	0.80	178	142	-36
0050	3T	156	736	25	73600	72390	-1210	0.03	0.98	130	128	-2
0050	3T	162	538	22	53800	57470	3670	0.04	1.07	95	101	6
0050	3T	163	579	15	57900	32610	-25290	0.03	0.56	102	57	-45
0050	3T	164	550	6	55000	24060	-30940	0.01	0.44	97	42	-55
0050	3T	165	396	7	39600	27330	-12270	0.02	0.69	70	48	-22
0050	3T	213	334	9	33400	22130	-11270	0.03	0.66	59	39	-20
0050	3T	214	329	11	32900	32110	-790	0.03	0.98	58	56	-2
0050	3T	215	289	5	28900	5460	-23440	0.02	0.19	51	9	-42
0050	3T	216	304	8	30400	30750	350	0.03	1.01	53	54	1
0050	3T	231	141	1	14100	3510	-10590	0.01	0.25	24	6	-18
0050	3T	234	301	11	30100	43810	13710	0.04	1.46	53	77	24
0050	3T	235	248	5	24800	18920	-5880	0.02	0.76	43	33	-10
0050	3T	236	219	4	21900	12650	-9250	0.02	0.58	38	22	-16
0050	3T	241	109	2	10900	5770	-5130	0.02	0.53	19	10	-9
0050	3T	243	206	6	20600	16050	-4550	0.03	0.78	36	28	-8
0050	3T	245	159	1	15900	2040	-13860	0.01	0.13	28	3	-25
0050	3T	246	204	4	20400	5050	-15350	0.02	0.25	36	8	-28
0050	3T	251	73	2	7300	4910	-2390	0.03	0.67	12	8	-4
0050	3T	253	122	1	12200	1260	-10940	0.01	0.10	21	2	-19
0050	3T	254	137	2	13700	5030	-8670	0.01	0.37	24	8	-16
0050	3T	256	137	0	13700	0	-13700	0.00	0.00	24	0	-24
0050	3T	261	65	1	6500	37600	31100	0.02	5.78	11	66	55
0050	3T	263	109	4	10900	16360	5460	0.04	1.50	19	28	9
0050	3T	264	82	3	8200	4600	-3600	0.04	0.56	14	8	-6
0050	3T	265	81	2	8100	16420	8320	0.02	2.03	14	29	15
0051	1T	1	53555	32637	5355500	4914350	-441150	0.61	0.92	9478	8697	-781
0051	1T	2	9690	3008	969000	866690	-102310	0.31	0.89	1715	1533	-182
0051	2F	12	17888	5604	1788800	1498210	-290590	0.31	0.84	3166	2651	-515
0051	2F	13	11766	3061	1176600	979740	-196860	0.26	0.83	2082	1734	-348
0051	2F	14	8536	1833	853600	691340	-162260	0.21	0.81	1510	1223	-287
0051	2F	15	4943	686	494300	406330	-87970	0.14	0.82	874	719	-155
0051	2F	16	3072	369	307200	258100	-49100	0.12	0.84	543	456	-87
0051	2F	23	1895	286	189500	162050	-27450	0.15	0.86	335	286	-49
0051	2F	24	1314	148	131400	89780	-41620	0.11	0.68	232	158	-74
0051	2F	25	968	87	96800	69110	-27690	0.09	0.71	171	122	-49
0051	2F	26	680	62	68000	41830	-26170	0.09	0.62	120	74	-46
0051	2T	12	15744	3855	1574400	1276610	-297790	0.24	0.81	2786	2259	-527
0051	2T	13	11766	2391	1176600	958240	-218360	0.20	0.81	2082	1696	-386
0051	2T	14	8536	1443	853600	688700	-164900	0.17	0.81	1510	1218	-292
0051	2T	15	4943	508	494300	389720	-104580	0.10	0.79	874	689	-185
0051	2T	16	3072	273	307200	246220	-60980	0.09	0.80	543	435	-108
0051	2T	21	2144	277	214400	175720	-38680	0.13	0.82	379	311	-68
0051	2T	23	1895	156	189500	149280	-40220	0.08	0.79	335	264	-71
0051	2T	24	1314	91	131400	82820	-48580	0.07	0.63	232	146	-86
0051	2T	25	968	60	96800	58750	-38050	0.06	0.61	171	103	-68
0051	2T	26	680	41	68000	43280	-24720	0.06	0.64	120	76	-44
0051	3F	123	6202	1413	620200	531300	-88900	0.23	0.86	1097	940	-157
0051	3F	124	5883	998	588300	440380	-147920	0.17	0.75	1041	779	-262
0051	3F	125	3922	526	392200	316960	-75240	0.13	0.81	694	560	-134
0051	3F	126	3348	336	334800	252210	-82590	0.10	0.75	592	446	-146
0051	3F	134	4117	657	411700	330290	-81410	0.16	0.80	728	584	-144
0051	3F	135	2957	341	295700	217050	-78650	0.12	0.73	523	384	-139
0051	3F	136	2402	253	240200	198420	-41780	0.11	0.83	425	351	-74
0051	3F	145	2451	249	245100	188320	-56780	0.10	0.77	433	333	-100
0051	3F	146	1847	163	184700	161620	-23080	0.09	0.88	326	286	-40
0051	3F	156	1166	71	116600	80350	-36250	0.06	0.69	206	142	-64
0051	3F	234	588	59	58800	54330	-4470	0.10	0.92	104	96	-8
0051	3F	235	486	34	48600	27690	-20910	0.07	0.57	86	49	-37
0051	3F	236	410	38	41000	37160	-3840	0.09	0.91	72	65	-7
0051	3F	245	380	18	38000	16040	-21960	0.05	0.42	67	28	-39
0051	3F	246	323	10	32300	10970	-21330	0.03	0.34	57	19	-38
0051	3F	256	221	7	22100	5050	-17050	0.03	0.23	39	8	-31
0051	3T	123	3367	339	336700	277660	-59040	0.10	0.82	595	491	-104
0051	3T	124	3643	253	364300	248180	-116120	0.07	0.68	644	439	-205
0051	3T	125	2512	146	251200	195180	-56020	0.06	0.78	444	345	-99
0051	3T	126	2361	91	236100	154750	-81350	0.04	0.66	417	273	-144
0051	3T	132	2223	161	222300	185880	-36420	0.07	0.84	393	328	-65
0051	3T	134	2575	190	257500	224580	-32920	0.07	0.87	455	397	-58
0051	3T	135	2077	115	207700	159920	-47780	0.06	0.77	367	283	-84
0051	3T	136	1816	86	181600	148870	-32730	0.05	0.82	321	263	-58
0051	3T	142	1680	95	168000	114080	-53920	0.06	0.68	297	201	-96
0051	3T	143	1542	82	154200	127490	-26710	0.05	0.83	272	225	-47
0051	3T	145	1439	55	143900	103830	-40070	0.04	0.72	254	183	-71
0051	3T	146	1277	44	127700	102660	-25040	0.03	0.80	226	181	-45
0051	3T	152	895	27	89500	61990	-27510	0.03	0.69	158	109	-49
0051	3T	153	880	32	88000	87760	-240	0.04	1.00	155	155	0
0051	3T	154	1012	24	101200	71390	-29810	0.02	0.71	179	126	-53
0051	3T	156	748	11	74800	24790	-50010	0.01	0.33	132	43	-89
0051	3T	162	514	20	51400	49670	-1730	0.04	0.97	90	87	-3
0051	3T	163	586	16	58600	57440	-1160	0.03	0.98	103	101	-2
0051	3T	164	570	19	57000	56830	-170	0.03	1.00	100	100	0
0051	3T	165	418	10	41800	30830	-10970	0.02	0.74	73	54	-19
0051	3T	213	413	21	41300	34060	-7240	0.05	0.82	73	60	-13
0051	3T	214	408	15	40800	26210	-14590	0.04	0.64	72	46	-26
0051	3T	215	400	17	40000	32490	-7510	0.04	0.81	70	57	-13
0051	3T	216	388	12	38800	45590	6790	0.03	1.18	68	80	12
0051	3T	231	199	4	19900	12760	-7140	0.02	0.64	35	22	-13
0051	3T	234	379	13	37900	46410	8510	0.03	1.22	67	82	15
0051	3T	235	325	3	32500	5920	-26580	0.01	0.18	57	10	-47
0051	3T	236	300	5	30000	17770	-12230	0.02	0.59	53	31	-22
0051	3T	241	152	1	15200	1100	-14100	0.01	0.07	26	1	-25
0051	3T	243	209	7	20900	6930	-13970	0.03	0.33	36	12	-24
0051	3T	245	231	1	23100	2140	-20960	0.00	0.09	40	3	-37
0051	3T	246	231	2	23100	3800	-19300	0.01	0.16	40	6	-34
0051	3T	251	115	3	11500	3550	-7950	0.03	0.31	20	6	-14
0051	3T	253	161	3	16100	5860	-10240	0.02	0.36	28	10	-18
0051	3T	254	149	1	14900	2610	-12290	0.01	0.18	26	4	-22
0051	3T	256	135	0	13500	0	-13500	0.00	0.00	23	0	-23
0051	3T	261	85	0	8500	0	-8500	0.00	0.00	15	0	-15
0051	3T	263	110	1	11000	2480	-8520	0.01	0.23	19	4	-15
0051	3T	264	92	0	9200	0	-9200	0.00	0.00	16	0	-16
0051	3T	265	86	0	8600	0	-8600	0.00	0.00	15	0	-15
0019	3T	213	607	41	60700	87450	26750	0.07	1.44	107	154	47
0019	3T	214	574	25	57400	36250	-21150	0.04	0.63	101	64	-37
0019	3T	215	418	15	41800	40730	-1070	0.04	0.97	73	72	-1
0019	3T	216	461	15	46100	33810	-12290	0.03	0.73	81	59	-22
0019	3T	231	195	2	19500	3530	-15970	0.01	0.18	34	6	-28
0019	3T	234	321	7	32100	12390	-19710	0.02	0.39	56	21	-35
0019	3T	235	266	4	26600	8210	-18390	0.02	0.31	47	14	-33
0019	3T	236	267	3	26700	6900	-19800	0.01	0.26	47	12	-35
0019	3T	241	103	3	10300	9350	-950	0.03	0.91	18	16	-2
0019	3T	243	200	8	20000	63610	43610	0.04	3.18	35	112	77
0019	3T	245	153	1	15300	1580	-13720	0.01	0.10	27	2	-25
0019	3T	246	126	2	12600	5110	-7490	0.02	0.41	22	9	-13
0019	3T	251	70	4	7000	72420	65420	0.06	10.35	12	128	116
0019	3T	253	122	4	12200	5690	-6510	0.03	0.47	21	10	-11
0019	3T	254	98	1	9800	2530	-7270	0.01	0.26	17	4	-13
0019	3T	256	96	1	9600	2420	-7180	0.01	0.25	16	4	-12
0019	3T	261	50	2	5000	5710	710	0.04	1.14	8	10	2
0019	3T	263	92	2	9200	1990	-7210	0.02	0.22	16	3	-13
0019	3T	264	48	1	4800	1330	-3470	0.02	0.28	8	2	-6
0019	3T	265	46	0	4600	0	-4600	0.00	0.00	8	0	-8
0022	1T	1	63545	37387	6354500	5842780	-511720	0.59	0.92	11246	10341	-905
0022	1T	2	7193	2748	719300	660330	-58970	0.38	0.92	1273	1168	-105
0022	2F	12	35123	11692	3512300	2979150	-533150	0.33	0.85	6216	5272	-944
0022	2F	13	14649	4639	1464900	1172550	-292350	0.32	0.80	2592	2075	-517
0022	2F	14	8173	2315	817300	626770	-190530	0.28	0.77	1446	1109	-337
0022	2F	15	2421	528	242100	193230	-48870	0.22	0.80	428	342	-86
0022	2F	16	1714	353	171400	152130	-19270	0.21	0.89	303	269	-34
0022	2F	23	542	128	54200	45890	-8310	0.24	0.85	95	81	-14
0022	2F	24	423	81	42300	35230	-7070	0.19	0.83	74	62	-12
0022	2F	25	310	44	31000	18890	-12110	0.14	0.61	54	33	-21
0022	2F	26	467	73	46700	36330	-10370	0.16	0.78	82	64	-18
0022	2T	12	34760	8752	3476000	2821500	-654500	0.25	0.81	6152	4993	-1159
0022	2T	13	14649	3330	1464900	1128810	-336090	0.23	0.77	2592	1997	-595
0022	2T	14	8173	1677	817300	631400	-185900	0.21	0.77	1446	1117	-329
0022	2T	15	2421	363	242100	188720	-53380	0.15	0.78	428	334	-94
0022	2T	16	1714	250	171400	160190	-11210	0.15	0.93	303	283	-20
0022	2T	21	363	34	36300	27470	-8830	0.09	0.76	64	48	-16
0022	2T	23	542	78	54200	44450	-9750	0.14	0.82	95	78	-17
0022	2T	24	423	42	42300	30030	-12270	0.10	0.71	74	53	-21
0022	2T	25	310	27	31000	21800	-9200	0.09	0.70	54	38	-16
0022	2T	26	467	45	46700	35840	-10860	0.10	0.77	82	63	-19
0022	3F	123	7868	2080	786800	643340	-143460	0.26	0.82	1392	1138	-254
0022	3F	124	14143	2962	1414300	1054830	-359470	0.21	0.75	2503	1866	-637
0022	3F	125	6458	1153	645800	518910	-126890	0.18	0.80	1143	918	-225
0022	3F	126	5502	802	550200	501130	-49070	0.15	0.91	973	886	-87
0022	3F	134	4994	1122	499400	402500	-96900	0.22	0.81	883	712	-171
0022	3F	135	3542	647	354200	254310	-99890	0.18	0.72	626	450	-176
0022	3F	136	2758	395	275800	192820	-82980	0.14	0.70	488	341	-147
0022	3F	145	1573	277	157300	121740	-35560	0.18	0.77	278	215	-63
0022	3F	146	1114	147	111400	84970	-26430	0.13	0.76	197	150	-47
0022	3F	156	456	62	45600	35300	-10300	0.14	0.77	80	62	-18
0022	3F	234	131	27	13100	10550	-2550	0.21	0.81	23	18	-5
0022	3F	235	153	31	15300	11200	-4100	0.20	0.73	27	19	-8
0022	3F	236	151	20	15100	12970	-2130	0.13	0.86	26	22	-4
0022	3F	245	105	11	10500	4440	-6060	0.10	0.42	18	7	-11
0022	3F	246	105	13	10500	7890	-2610	0.12	0.75	18	13	-5
0022	3F	256	74	10	7400	5840	-1560	0.14	0.79	13	10	-3
0022	3T	123	7750	916	775000	634880	-140120	0.12	0.82	1371	1123	-248
0022	3T	124	13962	1244	1396200	1009310	-386890	0.09	0.72	2471	1786	-685
0022	3T	125	6319	466	631900	508130	-123770	0.07	0.80	1118	899	-219
0022	3T	126	5335	338	533500	535070	1570	0.06	1.00	944	947	3
0022	3T	132	105	2	10500	1970	-8530	0.02	0.19	18	3	-15
0022	3T	134	4488	423	448800	347200	-101600	0.09	0.77	794	614	-180
0022	3T	135	3419	258	341900	249560	-92340	0.08	0.73	605	441	-164
0022	3T	136	2719	166	271900	206030	-65870	0.06	0.76	481	364	-117
0022	3T	142	102	5	10200	5030	-5170	0.05	0.49	18	8	-10
0022	3T	143	506	39	50600	58920	8320	0.08	1.16	89	104	15
0022	3T	145	1530	94	153000	114670	-38330	0.06	0.75	270	202	-68
0022	3T	146	1060	47	106000	60840	-45160	0.04	0.57	187	107	-80
0022	3T	152	37	1	3700	1550	-2150	0.03	0.42	6	2	-4
0022	3T	153	123	9	12300	17300	5000	0.07	1.41	21	30	9
0022	3T	154	43	0	4300	0	-4300	0.00	0.00	7	0	-7
0022	3T	156	426	20	42600	33570	-9030	0.05	0.79	75	59	-16
0022	3T	162	5	0	500	0	-500	0.00	0.00	0	0	0
0022	3T	163	39	3	3900	2940	-960	0.08	0.75	6	5	-1
0022	3T	164	54	4	5400	4050	-1350	0.07	0.75	9	7	-2
0022	3T	165	30	2	3000	3010	10	0.07	1.00	5	5	0
0022	3T	213	13	1	1300	1740	440	0.08	1.34	2	3	1
0022	3T	214	78	4	7800	7200	-600	0.05	0.92	13	12	-1
0022	3T	215	102	3	10200	6290	-3910	0.03	0.62	18	11	-7
0022	3T	216	162	4	16200	15520	-680	0.02	0.96	28	27	-1
0022	3T	234	127	10	12700	15890	3190	0.08	1.25	22	28	6
0022	3T	235	150	11	15000	14500	-500	0.07	0.97	26	25	-1
0022	3T	236	150	11	15000	16290	1290	0.07	1.09	26	28	2
0022	3T	241	1	0	100	0	-100	0.00	0.00	0	0	0
0022	3T	243	4	0	400	0	-400	0.00	0.00	0	0	0
0022	3T	245	105	2	10500	3860	-6640	0.02	0.37	18	6	-12
0022	3T	246	104	3	10400	5090	-5310	0.03	0.49	18	9	-9
0022	3T	253	3	1	300	1720	1420	0.33	5.73	0	3	3
0022	3T	256	73	1	7300	1730	-5570	0.01	0.24	12	3	-9
0022	3T	263	1	0	100	0	-100	0.00	0.00	0	0	0
0022	3T	264	1	0	100	0	-100	0.00	0.00	0	0	0
0022	3T	265	1	0	100	0	-100	0.00	0.00	0	0	0
0012	1T	1	60872	35830	6087200	5658180	-429020	0.59	0.93	10773	10014	-759
0012	1T	2	7488	2444	748800	708370	-40430	0.33	0.95	1325	1253	-72
0012	2F	12	25175	7834	2517500	2227320	-290180	0.31	0.88	4455	3942	-513
0012	2F	13	14926	3847	1492600	1278070	-214530	0.26	0.86	2641	2262	-379
0012	2F	14	9323	1970	932300	765470	-166830	0.21	0.82	1650	1354	-296
0012	2F	15	3579	507	357900	291620	-66280	0.14	0.81	633	516	-117
0012	2F	16	2039	262	203900	182700	-21200	0.13	0.90	360	323	-37
0012	2F	23	1456	199	145600	122350	-23250	0.14	0.84	257	216	-41
0012	2F	24	844	112	84400	60430	-23970	0.13	0.72	149	106	-43
0012	2F	25	639	69	63900	56140	-7760	0.11	0.88	113	99	-14
0012	2F	26	498	50	49800	38360	-11440	0.10	0.77	88	67	-21
0012	2T	12	22904	5498	2290400	1967320	-323080	0.24	0.86	4053	3481	-572
0012	2T	13	14926	2976	1492600	1248090	-244510	0.20	0.84	2641	2209	-432
0012	2T	14	9323	1501	932300	769840	-162460	0.16	0.83	1650	1362	-288
0012	2T	15	3579	385	357900	299420	-58480	0.11	0.84	633	529	-104
0012	2T	16	2039	192	203900	187130	-16770	0.09	0.92	360	331	-29
0012	2T	21	2271	320	227100	248200	21100	0.14	1.09	401	439	38
0010	1T	1	62591	37046	6259100	5755910	-503190	0.59	0.92	11078	10187	-891
0010	1T	2	8248	2998	824800	742320	-82480	0.36	0.90	1459	1313	-146
0010	2F	12	34783	11470	3478300	2947060	-531240	0.33	0.85	6156	5216	-940
0010	2F	13	14866	4598	1486600	1179000	-307600	0.31	0.79	2631	2086	-545
0010	2F	14	8092	2305	809200	638020	-171180	0.28	0.79	1432	1129	-303
0010	2F	15	2330	515	233000	194630	-38370	0.22	0.84	412	344	-68
0010	2F	16	1658	322	165800	152580	-13220	0.19	0.92	293	270	-23
0010	2F	23	749	163	74900	68030	-6870	0.22	0.91	132	120	-12
0010	2F	24	537	97	53700	36230	-17470	0.18	0.67	95	64	-31
0010	2F	25	317	55	31700	25810	-5890	0.17	0.81	56	45	-11
0010	2F	26	472	80	47200	43630	-3570	0.17	0.92	83	77	-6
0010	2T	12	33726	8516	3372600	2751460	-621140	0.25	0.82	5969	4869	-1100
0010	2T	13	14866	3367	1486600	1148390	-338210	0.23	0.77	2631	2032	-599
0010	2T	14	8092	1695	809200	649330	-159870	0.21	0.80	1432	1149	-283
0010	2T	15	2330	376	233000	205880	-27120	0.16	0.88	412	364	-48
0010	2T	16	1658	230	165800	159150	-6650	0.14	0.96	293	281	-12
0010	2T	21	1057	133	105700	109210	3510	0.13	1.03	187	193	6
0010	2T	23	749	93	74900	65160	-9740	0.12	0.87	132	115	-17
0010	2T	24	537	57	53700	33280	-20420	0.11	0.62	95	58	-37
0010	2T	25	317	30	31700	21570	-10130	0.09	0.68	56	38	-18
0010	2T	26	472	51	47200	45840	-1360	0.11	0.97	83	81	-2
0010	3F	123	6085	1758	608500	507480	-101020	0.29	0.83	1076	898	-178
0010	3F	124	11737	2516	1173700	871400	-302300	0.21	0.74	2077	1542	-535
0010	3F	125	7197	1242	719700	582030	-137670	0.17	0.81	1273	1030	-243
0010	3F	126	8453	1078	845300	761940	-83360	0.13	0.90	1496	1348	-148
0010	3F	134	4087	998	408700	326050	-82650	0.24	0.80	723	577	-146
0010	3F	135	3661	694	366100	280440	-85660	0.19	0.77	647	496	-151
0010	3F	136	4071	573	407100	302260	-104840	0.14	0.74	720	534	-186
0010	3F	145	1818	322	181800	150360	-31440	0.18	0.83	321	266	-55
0010	3F	146	1450	187	145000	128770	-16230	0.13	0.89	256	227	-29
0010	3F	156	531	85	53100	58670	5570	0.16	1.10	93	103	10
0010	3F	234	180	33	18000	14090	-3910	0.18	0.78	31	24	-7
0010	3F	235	212	28	21200	15480	-5720	0.13	0.73	37	27	-10
0010	3F	236	217	23	21700	13020	-8680	0.11	0.60	38	23	-15
0010	3F	245	136	12	13600	4610	-8990	0.09	0.34	24	8	-16
0010	3F	246	138	12	13800	7100	-6700	0.09	0.51	24	12	-12
0010	3F	256	77	4	7700	3500	-4200	0.05	0.45	13	6	-7
0010	3T	123	5846	757	584600	493480	-91120	0.13	0.84	1034	873	-161
0010	3T	124	11489	1050	1148900	874710	-274190	0.09	0.76	2033	1548	-485
0010	3T	125	6864	508	686400	559620	-126780	0.07	0.82	1214	990	-224
0010	3T	126	7848	453	784800	734750	-50050	0.06	0.94	1389	1300	-89
0010	3T	132	234	17	23400	12710	-10690	0.07	0.54	41	22	-19
0010	3T	134	4006	419	400600	335780	-64820	0.10	0.84	709	594	-115
0010	3T	135	3629	297	362900	300360	-62540	0.08	0.83	642	531	-111
0010	3T	136	4068	254	406800	311080	-95720	0.06	0.76	720	550	-170
0010	3T	142	109	11	10900	21000	10100	0.10	1.93	19	37	18
0010	3T	143	81	7	8100	7340	-760	0.09	0.91	14	12	-2
0010	3T	145	1777	109	177700	136590	-41110	0.06	0.77	314	241	-73
0010	3T	146	1402	71	140200	108720	-31480	0.05	0.78	248	192	-56
0010	3T	152	27	1	2700	1780	-920	0.04	0.66	4	3	-1
0010	3T	153	32	2	3200	5730	2530	0.06	1.79	5	10	5
0010	3T	154	41	2	4100	1920	-2180	0.05	0.47	7	3	-4
0010	3T	156	490	30	49000	46400	-2600	0.06	0.95	86	82	-4
0010	3T	162	5	0	500	0	-500	0.00	0.00	0	0	0
0010	3T	163	3	0	300	0	-300	0.00	0.00	0	0	0
0010	3T	164	48	5	4800	5670	870	0.10	1.18	8	10	2
0010	3T	165	41	1	4100	1750	-2350	0.02	0.43	7	3	-4
0010	3T	213	5	0	500	0	-500	0.00	0.00	0	0	0
0010	3T	214	123	3	12300	4200	-8100	0.02	0.34	21	7	-14
0010	3T	215	306	11	30600	23930	-6670	0.04	0.78	54	42	-12
0010	3T	216	600	17	60000	53210	-6790	0.03	0.89	106	94	-12
0010	3T	234	173	14	17300	18500	1200	0.08	1.07	30	32	2
0010	3T	235	211	11	21100	21500	400	0.05	1.02	37	38	1
0010	3T	236	217	5	21700	9460	-12240	0.02	0.44	38	16	-22
0010	3T	241	16	1	1600	2620	1020	0.06	1.64	2	4	2
0010	3T	243	7	0	700	0	-700	0.00	0.00	1	0	-1
0010	3T	245	136	4	13600	6250	-7350	0.03	0.46	24	11	-13
0010	3T	246	138	7	13800	14450	650	0.05	1.05	24	25	1
0010	3T	253	1	0	100	0	-100	0.00	0.00	0	0	0
0010	3T	256	70	2	7000	4140	-2860	0.03	0.59	12	7	-5
0010	3T	265	7	0	700	0	-700	0.00	0.00	1	0	-1
0015	1T	1	66613	38477	6661300	6119050	-542250	0.58	0.92	11789	10830	-959
0015	1T	2	5871	2335	587100	528120	-58980	0.40	0.90	1039	934	-105
0015	2F	12	36615	12155	3661500	3094380	-567120	0.33	0.85	6480	5476	-1004
0015	2F	13	16177	5051	1617700	1293910	-323790	0.31	0.80	2863	2290	-573
0015	2F	14	8437	2389	843700	644870	-198830	0.28	0.76	1493	1141	-352
0015	2F	15	2364	491	236400	196410	-39990	0.21	0.83	418	347	-71
0015	2F	16	1923	374	192300	174950	-17350	0.19	0.91	340	309	-31
0015	2F	23	339	74	33900	24900	-9000	0.22	0.73	60	44	-16
0015	2F	24	258	56	25800	20740	-5060	0.22	0.80	45	36	-9
0015	2F	25	218	26	21800	10340	-11460	0.12	0.47	38	18	-20
0015	2F	26	398	69	39800	32030	-7770	0.17	0.80	70	56	-14
0015	2T	12	36542	9146	3654200	2982390	-671810	0.25	0.82	6467	5278	-1189
0015	2T	13	16177	3583	1617700	1238550	-379150	0.22	0.77	2863	2192	-671
0015	2T	14	8437	1708	843700	661780	-181920	0.20	0.78	1493	1171	-322
0015	2T	15	2364	333	236400	196400	-40000	0.14	0.83	418	347	-71
0015	2T	16	1923	258	192300	177420	-14880	0.13	0.92	340	314	-26
0015	2T	21	73	7	7300	6920	-380	0.10	0.95	12	12	0
0015	2T	23	339	41	33900	22890	-11010	0.12	0.68	60	40	-20
0015	2T	24	258	30	25800	19890	-5910	0.12	0.77	45	35	-10
0015	2T	25	218	15	21800	11760	-10040	0.07	0.54	38	20	-18
0015	2T	26	398	39	39800	28550	-11250	0.10	0.72	70	50	-20
0015	3F	123	9261	2507	926100	759690	-166410	0.27	0.82	1639	1344	-295
0015	3F	124	14966	3182	1496600	1123640	-372960	0.21	0.75	2648	1988	-660
0015	3F	125	5400	1045	540000	463520	-76480	0.19	0.86	955	820	-135
0015	3F	126	5206	750	520600	449020	-71580	0.14	0.86	921	794	-127
0015	3F	134	5098	1155	509800	386330	-123470	0.23	0.76	902	683	-219
0005	1T	1	61402	35741	6140200	5736550	-403650	0.58	0.93	10867	10153	-714
0005	1T	2	7134	2177	713400	685690	-27710	0.31	0.96	1262	1213	-49
0005	2F	12	26182	7897	2618200	2269210	-348990	0.30	0.87	4633	4016	-617
0005	2F	13	14237	3592	1423700	1223150	-200550	0.25	0.86	2519	2164	-355
0005	2F	14	9153	1907	915300	743640	-171660	0.21	0.81	1620	1316	-304
0005	2F	15	3706	521	370600	303840	-66760	0.14	0.82	655	537	-118
0005	2F	16	1860	247	186000	159010	-26990	0.13	0.85	329	281	-48
0005	2F	23	1380	197	138000	111820	-26180	0.14	0.81	244	197	-47
0005	2F	24	850	111	85000	76040	-8960	0.13	0.89	150	134	-16
0005	2F	25	559	48	55900	36640	-19260	0.09	0.66	98	64	-34
0005	2F	26	388	38	38800	37240	-1560	0.10	0.96	68	65	-3
0005	2T	12	23773	5533	2377300	2006170	-371130	0.23	0.84	4207	3550	-657
0005	2T	13	14237	2741	1423700	1200160	-223540	0.19	0.84	2519	2124	-395
0005	2T	14	9153	1460	915300	738520	-176780	0.16	0.81	1620	1307	-313
0005	2T	15	3706	386	370600	303930	-66670	0.10	0.82	655	537	-118
0005	2T	16	1860	181	186000	165100	-20900	0.10	0.89	329	292	-37
0005	2T	21	2409	304	240900	227780	-13120	0.13	0.95	426	403	-23
0005	2T	23	1380	110	138000	108600	-29400	0.08	0.79	244	192	-52
0005	2T	24	850	72	85000	100580	15580	0.08	1.18	150	178	28
0005	2T	25	559	35	55900	40330	-15570	0.06	0.72	98	71	-27
0005	2T	26	388	23	38800	35450	-3350	0.06	0.91	68	62	-6
0005	3F	123	11039	2283	1103900	922450	-181450	0.21	0.84	1953	1632	-321
0005	3F	124	8949	1520	894900	697570	-197330	0.17	0.78	1583	1234	-349
0005	3F	125	5221	642	522100	411240	-110860	0.12	0.79	924	727	-197
0005	3F	126	3957	416	395700	353420	-42280	0.11	0.89	700	625	-75
0005	3F	134	5777	891	577700	460390	-117310	0.15	0.80	1022	814	-208
0005	3F	135	3257	399	325700	273390	-52310	0.12	0.84	576	483	-93
0005	3F	136	2413	268	241300	235040	-6260	0.11	0.97	427	416	-11
0005	3F	145	2200	212	220000	162380	-57620	0.10	0.74	389	287	-102
0005	3F	146	1465	127	146500	114420	-32080	0.09	0.78	259	202	-57
0005	3F	156	775	68	77500	73600	-3900	0.09	0.95	137	130	-7
0005	3F	234	495	56	49500	39110	-10390	0.11	0.79	87	69	-18
0005	3F	235	336	28	33600	31450	-2150	0.08	0.94	59	55	-4
0005	3F	236	267	17	26700	13830	-12870	0.06	0.52	47	24	-23
0005	3F	245	247	14	24700	10220	-14480	0.06	0.41	43	18	-25
0005	3F	246	205	16	20500	21260	760	0.08	1.04	36	37	1
0005	3F	256	135	8	13500	9270	-4230	0.06	0.69	23	16	-7
0005	3T	123	6848	661	684800	594950	-89850	0.10	0.87	1212	1053	-159
0005	3T	124	6085	433	608500	459770	-148730	0.07	0.76	1076	813	-263
0005	3T	125	3827	198	382700	277840	-104860	0.05	0.73	677	491	-186
0005	3T	126	3098	152	309800	288200	-21600	0.05	0.93	548	510	-38
0005	3T	132	3431	243	343100	311500	-31600	0.07	0.91	607	551	-56
0005	3T	134	3610	247	361000	304020	-56980	0.07	0.84	638	538	-100
0005	3T	135	2439	126	243900	201030	-42870	0.05	0.82	431	355	-76
0005	3T	136	1956	89	195600	172500	-23100	0.05	0.88	346	305	-41
0005	3T	142	2242	151	224200	224600	400	0.07	1.00	396	397	1
0005	3T	143	2167	109	216700	192700	-24000	0.05	0.89	383	341	-42
0005	3T	145	1499	55	149900	104500	-45400	0.04	0.70	265	184	-81
0005	3T	146	1186	54	118600	104780	-13820	0.05	0.88	209	185	-24
0005	3T	152	901	33	90100	68530	-21570	0.04	0.76	159	121	-38
0005	3T	153	818	22	81800	77420	-4380	0.03	0.95	144	137	-7
0005	3T	154	701	14	70100	37370	-32730	0.02	0.53	124	66	-58
0005	3T	156	554	16	55400	58140	2740	0.03	1.05	98	102	4
0005	3T	162	395	11	39500	34500	-5000	0.03	0.87	69	61	-8
0005	3T	163	457	19	45700	55760	10060	0.04	1.22	80	98	18
0005	3T	164	279	5	27900	13060	-14840	0.02	0.47	49	23	-26
0005	3T	165	221	5	22100	22820	720	0.02	1.03	39	40	1
0005	3T	213	575	32	57500	70420	12920	0.06	1.22	101	124	23
0005	3T	214	515	22	51500	37830	-13670	0.04	0.73	91	66	-25
0005	3T	215	419	17	41900	43690	1790	0.04	1.04	74	77	3
0005	3T	216	397	10	39700	38350	-1350	0.03	0.97	70	67	-3
0005	3T	231	185	6	18500	29150	10650	0.03	1.58	32	51	19
0005	3T	234	318	13	31800	26270	-5530	0.04	0.83	56	46	-10
0005	3T	235	225	7	22500	24080	1580	0.03	1.07	39	42	3
0005	3T	236	186	2	18600	5940	-12660	0.01	0.32	32	10	-22
0005	3T	241	107	4	10700	14970	4270	0.04	1.40	18	26	8
0005	3T	243	177	6	17700	13160	-4540	0.03	0.74	31	23	-8
0005	3T	245	150	1	15000	1070	-13930	0.01	0.07	26	1	-25
0005	3T	246	129	6	12900	67570	54670	0.05	5.24	22	119	97
0005	3T	251	74	0	7400	0	-7400	0.00	0.00	13	0	-13
0005	3T	253	111	0	11100	0	-11100	0.00	0.00	19	0	-19
0005	3T	254	97	2	9700	14680	4980	0.02	1.51	17	25	8
0005	3T	256	93	2	9300	2300	-7000	0.02	0.25	16	4	-12
0005	3T	261	67	1	6700	1410	-5290	0.01	0.21	11	2	-9
0005	3T	263	81	2	8100	2550	-5550	0.02	0.31	14	4	-10
0005	3T	264	76	2	7600	16700	9100	0.03	2.20	13	29	16
0005	3T	265	42	1	4200	8860	4660	0.02	2.11	7	15	8
0015	3F	135	3353	641	335300	243770	-91530	0.19	0.73	593	431	-162
0015	3F	136	3466	519	346600	268370	-78230	0.15	0.77	613	474	-139
0015	3F	145	1307	235	130700	90720	-39980	0.18	0.69	231	160	-71
0015	3F	146	1292	176	129200	97090	-32110	0.14	0.75	228	171	-57
0015	3F	156	537	71	53700	44290	-9410	0.13	0.82	95	78	-17
0015	3F	234	76	11	7600	3420	-4180	0.14	0.45	13	6	-7
0015	3F	235	65	10	6500	2780	-3720	0.15	0.43	11	4	-7
0015	3F	236	104	17	10400	8830	-1570	0.16	0.85	18	15	-3
0015	3F	245	36	6	3600	2500	-1100	0.17	0.69	6	4	-2
0015	3F	246	66	12	6600	5190	-1410	0.18	0.79	11	9	-2
0015	3F	256	53	6	5300	2200	-3100	0.11	0.42	9	3	-6
0015	3T	123	9183	1120	918300	806310	-111990	0.12	0.88	1625	1427	-198
0015	3T	124	14882	1337	1488200	1106650	-381550	0.09	0.74	2633	1958	-675
0015	3T	125	5381	420	538100	468310	-69790	0.08	0.87	952	828	-124
0015	3T	126	5161	310	516100	462810	-53290	0.06	0.90	913	819	-94
0015	3T	132	77	3	7700	2390	-5310	0.04	0.31	13	4	-9
0015	3T	134	4973	476	497300	399320	-97980	0.10	0.80	880	706	-174
0015	3T	135	3303	259	330300	237000	-93300	0.08	0.72	584	419	-165
0015	3T	136	3435	214	343500	290030	-53470	0.06	0.84	607	513	-94
0015	3T	142	62	9	6200	7620	1420	0.15	1.23	10	13	3
0015	3T	143	125	7	12500	7690	-4810	0.06	0.62	22	13	-9
0015	3T	145	1269	78	126900	88300	-38600	0.06	0.70	224	156	-68
0015	3T	146	1250	58	125000	83890	-41110	0.05	0.67	221	148	-73
0015	3T	152	17	0	1700	0	-1700	0.00	0.00	3	0	-3
0015	3T	153	50	1	5000	660	-4340	0.02	0.13	8	1	-7
0015	3T	154	38	4	3800	4480	680	0.11	1.18	6	7	1
0015	3T	156	523	22	52300	49690	-2610	0.04	0.95	92	87	-5
0015	3T	162	5	0	500	0	-500	0.00	0.00	0	0	0
0015	3T	163	31	1	3100	2860	-240	0.03	0.92	5	5	0
0015	3T	164	42	2	4200	3050	-1150	0.05	0.73	7	5	-2
0015	3T	165	14	2	1400	2930	1530	0.14	2.09	2	5	3
0015	3T	213	1	0	100	0	-100	0.00	0.00	0	0	0
0015	3T	214	22	0	2200	0	-2200	0.00	0.00	3	0	-3
0015	3T	215	2	0	200	0	-200	0.00	0.00	0	0	0
0015	3T	216	40	1	4000	2990	-1010	0.03	0.75	7	5	-2
0015	3T	234	75	3	7500	4940	-2560	0.04	0.66	13	8	-5
0015	3T	235	62	3	6200	2780	-3420	0.05	0.45	10	4	-6
0015	3T	236	102	6	10200	9800	-400	0.06	0.96	18	17	-1
0015	3T	243	1	0	100	0	-100	0.00	0.00	0	0	0
0015	3T	245	33	2	3300	2210	-1090	0.06	0.67	5	3	-2
0015	3T	246	63	3	6300	2680	-3620	0.05	0.43	11	4	-7
0015	3T	253	3	0	300	0	-300	0.00	0.00	0	0	0
0015	3T	254	3	0	300	0	-300	0.00	0.00	0	0	0
0015	3T	256	51	1	5100	1450	-3650	0.02	0.28	9	2	-7
0015	3T	263	2	0	200	0	-200	0.00	0.00	0	0	0
0015	3T	264	3	0	300	0	-300	0.00	0.00	0	0	0
0015	3T	265	2	1	200	1980	1780	0.50	9.90	0	3	3
0012	2T	23	1456	109	145600	130860	-14740	0.07	0.90	257	231	-26
0012	2T	24	844	65	84400	62280	-22120	0.08	0.74	149	110	-39
0012	2T	25	639	48	63900	58920	-4980	0.08	0.92	113	104	-9
0012	2T	26	498	35	49800	40340	-9460	0.07	0.81	88	71	-17
0012	3F	123	11029	2319	1102900	906610	-196290	0.21	0.82	1952	1604	-348
0012	3F	124	8656	1589	865600	694310	-171290	0.18	0.80	1532	1228	-304
0012	3F	125	5069	658	506900	401420	-105480	0.13	0.79	897	710	-187
0012	3F	126	3966	432	396600	363960	-32640	0.11	0.92	701	644	-57
0012	3F	134	5838	928	583800	519850	-63950	0.16	0.89	1033	920	-113
0012	3F	135	3423	387	342300	240060	-102240	0.11	0.70	605	424	-181
0012	3F	136	2583	280	258300	230900	-27400	0.11	0.89	457	408	-49
0012	3F	145	2208	227	220800	175120	-45680	0.10	0.79	390	309	-81
0012	3F	146	1549	115	154900	99940	-54960	0.07	0.65	274	176	-98
0012	3F	156	816	65	81600	74040	-7560	0.08	0.91	144	131	-13
0012	3F	234	485	50	48500	37630	-10870	0.10	0.78	85	66	-19
0012	3F	235	400	50	40000	45030	5030	0.13	1.13	70	79	9
0012	3F	236	365	31	36500	19500	-17000	0.08	0.53	64	34	-30
0012	3F	245	239	24	23900	22870	-1030	0.10	0.96	42	40	-2
0012	3F	246	206	11	20600	15400	-5200	0.05	0.75	36	27	-9
0012	3F	256	193	16	19300	24640	5340	0.08	1.28	34	43	9
0012	3T	123	6626	659	662600	591370	-71230	0.10	0.89	1172	1046	-126
0012	3T	124	5734	494	573400	507380	-66020	0.09	0.88	1014	898	-116
0012	3T	125	3743	220	374300	314470	-59830	0.06	0.84	662	556	-106
0012	3T	126	3037	139	303700	277170	-26530	0.05	0.91	537	490	-47
0012	3T	132	3661	271	366100	342290	-23810	0.07	0.93	647	605	-42
0012	3T	134	3668	258	366800	353800	-13000	0.07	0.96	649	626	-23
0012	3T	135	2626	133	262600	172390	-90210	0.05	0.66	464	305	-159
0012	3T	136	2117	116	211700	213560	1860	0.05	1.01	374	377	3
0012	3T	142	2297	140	229700	182650	-47050	0.06	0.80	406	323	-83
0012	3T	143	2170	116	217000	179100	-37900	0.05	0.83	384	316	-68
0012	3T	145	1580	56	158000	100220	-57780	0.04	0.63	279	177	-102
0012	3T	146	1221	43	122100	88810	-33290	0.04	0.73	216	157	-59
0012	3T	152	870	29	87000	75970	-11030	0.03	0.87	153	134	-19
0012	3T	153	797	21	79700	42480	-37220	0.03	0.53	141	75	-66
0012	3T	154	628	18	62800	63010	210	0.03	1.00	111	111	0
0012	3T	156	564	21	56400	77590	21190	0.04	1.38	99	137	38
0012	3T	162	441	15	44100	33360	-10740	0.03	0.76	78	59	-19
0012	3T	163	466	15	46600	37800	-8800	0.03	0.81	82	66	-16
0012	3T	164	328	8	32800	20350	-12450	0.02	0.62	58	36	-22
0012	3T	165	252	4	25200	13720	-11480	0.02	0.54	44	24	-20
0012	3T	213	547	34	54700	71710	17010	0.06	1.31	96	126	30
0012	3T	214	515	27	51500	72960	21460	0.05	1.42	91	129	38
0012	3T	215	367	22	36700	69040	32340	0.06	1.88	64	122	58
0012	3T	216	414	17	41400	35360	-6040	0.04	0.85	73	62	-11
0012	3T	231	195	1	19500	2230	-17270	0.01	0.11	34	3	-31
0012	3T	234	313	9	31300	28670	-2630	0.03	0.92	55	50	-5
0012	3T	235	269	5	26900	18740	-8160	0.02	0.70	47	33	-14
0012	3T	236	257	7	25700	12600	-13100	0.03	0.49	45	22	-23
0012	3T	241	110	3	11000	4460	-6540	0.03	0.41	19	7	-12
0012	3T	243	172	2	17200	2020	-15180	0.01	0.12	30	3	-27
0012	3T	245	125	2	12500	2200	-10300	0.02	0.18	22	3	-19
0012	3T	246	137	1	13700	9550	-4150	0.01	0.70	24	16	-8
0012	3T	251	89	2	8900	9200	300	0.02	1.03	15	16	1
0012	3T	253	131	4	13100	12850	-250	0.03	0.98	23	22	-1
0012	3T	254	114	2	11400	11740	340	0.02	1.03	20	20	0
0012	3T	256	111	0	11100	0	-11100	0.00	0.00	19	0	-19
0012	3T	261	74	1	7400	13600	6200	0.01	1.84	13	24	11
0012	3T	263	108	4	10800	8520	-2280	0.04	0.79	19	15	-4
0012	3T	264	69	2	6900	2870	-4030	0.03	0.42	12	5	-7
0012	3T	265	82	2	8200	7340	-860	0.02	0.90	14	12	-2
0052	1T	1	52004	31867	5200400	4773790	-426610	0.61	0.92	9204	8449	-755
0052	1T	2	9975	2990	997500	887140	-110360	0.30	0.89	1765	1570	-195
0052	2F	12	17861	5630	1786100	1527530	-258570	0.32	0.86	3161	2703	-458
0052	2F	13	10794	2814	1079400	891650	-187750	0.26	0.83	1910	1578	-332
0052	2F	14	8312	1706	831200	654870	-176330	0.21	0.79	1471	1159	-312
0052	2F	15	4836	694	483600	400400	-83200	0.14	0.83	855	708	-147
0052	2F	16	2970	346	297000	246210	-50790	0.12	0.83	525	435	-90
0052	2F	23	1836	235	183600	131480	-52120	0.13	0.72	324	232	-92
0052	2F	24	1332	134	133200	87100	-46100	0.10	0.65	235	154	-81
0052	2F	25	985	87	98500	57880	-40620	0.09	0.59	174	102	-72
0020	1T	1	63536	37452	6353600	5863780	-489820	0.59	0.92	11245	10378	-867
0020	1T	2	6664	2570	666400	604290	-62110	0.39	0.91	1179	1069	-110
0020	2F	12	36596	12138	3659600	3138360	-521240	0.33	0.86	6477	5554	-923
0020	2F	13	13142	4250	1314200	1056290	-257910	0.32	0.80	2326	1869	-457
0020	2F	14	7573	2169	757300	590250	-167050	0.29	0.78	1340	1044	-296
0020	2F	15	2425	556	242500	203010	-39490	0.23	0.84	429	359	-70
0020	2F	16	1497	322	149700	138430	-11270	0.22	0.92	264	245	-19
0020	2F	23	529	129	52900	45510	-7390	0.24	0.86	93	80	-13
0020	2F	24	247	50	24700	19330	-5370	0.20	0.78	43	34	-9
0020	2F	25	275	49	27500	20170	-7330	0.18	0.73	48	35	-13
0020	2F	26	273	44	27300	22240	-5060	0.16	0.81	48	39	-9
0020	2T	12	36521	9127	3652100	3005930	-646170	0.25	0.82	6463	5320	-1143
0020	2T	13	13142	3047	1314200	1022920	-291280	0.23	0.78	2326	1810	-516
0020	2T	14	7573	1583	757300	592880	-164420	0.21	0.78	1340	1049	-291
0020	2T	15	2425	382	242500	196580	-45920	0.16	0.81	429	347	-82
0020	2T	16	1497	227	149700	144620	-5080	0.15	0.97	264	255	-9
0020	2T	21	75	10	7500	9800	2300	0.13	1.31	13	17	4
0020	2T	23	529	70	52900	43530	-9370	0.13	0.82	93	77	-16
0020	2T	24	247	32	24700	24010	-690	0.13	0.97	43	42	-1
0020	2T	25	275	30	27500	24510	-2990	0.11	0.89	48	43	-5
0020	2T	26	273	25	27300	17740	-9560	0.09	0.65	48	31	-17
0020	3F	123	6011	1761	601100	503610	-97490	0.29	0.84	1063	891	-172
0020	3F	124	17596	3463	1759600	1309060	-450540	0.20	0.74	3114	2316	-798
0020	3F	125	5553	977	555300	446670	-108630	0.18	0.80	982	790	-192
0020	3F	126	6230	875	623000	546090	-76910	0.14	0.88	1102	966	-136
0020	3F	134	4708	1040	470800	354660	-116140	0.22	0.75	833	627	-206
0020	3F	135	2901	568	290100	216100	-74000	0.20	0.74	513	382	-131
0020	3F	136	2803	425	280300	211420	-68880	0.15	0.75	496	374	-122
0020	3F	145	1391	245	139100	106340	-32760	0.18	0.76	246	188	-58
0020	3F	146	1137	157	113700	92260	-21440	0.14	0.81	201	163	-38
0020	3F	156	512	90	51200	50840	-360	0.18	0.99	90	89	-1
0020	3F	234	166	32	16600	12370	-4230	0.19	0.75	29	21	-8
0020	3F	235	103	19	10300	6700	-3600	0.18	0.65	18	11	-7
0020	3F	236	158	21	15800	14600	-1200	0.13	0.92	27	25	-2
0020	3F	245	43	6	4300	2530	-1770	0.14	0.59	7	4	-3
0020	3F	246	53	6	5300	4230	-1070	0.11	0.80	9	7	-2
0020	3F	256	56	6	5600	1790	-3810	0.11	0.32	9	3	-6
0020	3T	123	5846	766	584600	499120	-85480	0.13	0.85	1034	883	-151
0020	3T	124	17431	1490	1743100	1293260	-449840	0.09	0.74	3085	2288	-797
0020	3T	125	5515	386	551500	440470	-111030	0.07	0.80	976	779	-197
0020	3T	126	6203	363	620300	565600	-54700	0.06	0.91	1097	1001	-96
0020	3T	132	154	8	15400	5570	-9830	0.05	0.36	27	9	-18
0020	3T	134	4623	447	462300	368020	-94280	0.10	0.80	818	651	-167
0020	3T	135	2839	237	283900	218360	-65540	0.08	0.77	502	386	-116
0020	3T	136	2792	186	279200	222290	-56910	0.07	0.80	494	393	-101
0020	3T	142	153	9	15300	4900	-10400	0.06	0.32	27	8	-19
0020	3T	143	85	7	8500	6830	-1670	0.08	0.80	15	12	-3
0020	3T	145	1320	87	132000	110090	-21910	0.07	0.83	233	194	-39
0020	3T	146	1102	53	110200	71470	-38730	0.05	0.65	195	126	-69
0020	3T	152	29	1	2900	1780	-1120	0.03	0.61	5	3	-2
0020	3T	153	62	2	6200	3740	-2460	0.03	0.60	10	6	-4
0020	3T	154	71	2	7100	4100	-3000	0.03	0.58	12	7	-5
0020	3T	156	499	28	49900	40930	-8970	0.06	0.82	88	72	-16
0020	3T	162	1	0	100	0	-100	0.00	0.00	0	0	0
0020	3T	163	11	0	1100	0	-1100	0.00	0.00	1	0	-1
0020	3T	164	35	2	3500	15280	11780	0.06	4.37	6	27	21
0020	3T	165	13	1	1300	1080	-220	0.08	0.83	2	1	-1
0020	3T	213	11	1	1100	1630	530	0.09	1.48	1	2	1
0020	3T	214	12	1	1200	1250	50	0.08	1.04	2	2	0
0020	3T	215	9	0	900	0	-900	0.00	0.00	1	0	-1
0020	3T	216	26	1	2600	2440	-160	0.04	0.94	4	4	0
0020	3T	234	160	7	16000	8930	-7070	0.04	0.56	28	15	-13
0020	3T	235	97	5	9700	6320	-3380	0.05	0.65	17	11	-6
0020	3T	236	156	7	15600	9350	-6250	0.04	0.60	27	16	-11
0020	3T	243	6	0	600	0	-600	0.00	0.00	1	0	-1
0020	3T	245	36	2	3600	2250	-1350	0.06	0.63	6	3	-3
0020	3T	246	50	2	5000	7700	2700	0.04	1.54	8	13	5
0020	3T	253	6	0	600	0	-600	0.00	0.00	1	0	-1
0020	3T	254	7	0	700	0	-700	0.00	0.00	1	0	-1
0020	3T	256	55	2	5500	1800	-3700	0.04	0.33	9	3	-6
0020	3T	263	2	0	200	0	-200	0.00	0.00	0	0	0
0020	3T	264	3	0	300	0	-300	0.00	0.00	0	0	0
0020	3T	265	1	0	100	0	-100	0.00	0.00	0	0	0
0017	1T	1	61760	36847	6176000	5698670	-477330	0.60	0.92	10930	10086	-844
0017	1T	2	8132	3050	813200	736260	-76940	0.38	0.91	1439	1303	-136
0017	2F	12	34186	11410	3418600	2907460	-511140	0.33	0.85	6050	5145	-905
0017	2F	13	14321	4578	1432100	1157820	-274280	0.32	0.81	2534	2049	-485
0017	2F	14	7909	2296	790900	607730	-183170	0.29	0.77	1399	1075	-324
0017	2F	15	2280	537	228000	192120	-35880	0.24	0.84	403	340	-63
0017	2F	16	1839	352	183900	160250	-23650	0.19	0.87	325	283	-42
0017	2F	23	612	134	61200	45740	-15460	0.22	0.75	108	80	-28
0017	2F	24	514	104	51400	44210	-7190	0.20	0.86	90	78	-12
0017	2F	25	269	37	26900	15390	-11510	0.14	0.57	47	27	-20
0017	2F	26	533	73	53300	38720	-14580	0.14	0.73	94	68	-26
0017	2T	12	33235	8507	3323500	2710550	-612950	0.26	0.82	5882	4797	-1085
0017	2T	13	14321	3302	1432100	1111590	-320510	0.23	0.78	2534	1967	-567
0017	2T	14	7909	1684	790900	609540	-181360	0.21	0.77	1399	1078	-321
0017	2T	15	2280	384	228000	198170	-29830	0.17	0.87	403	350	-53
0017	2T	16	1839	249	183900	168580	-15320	0.14	0.92	325	298	-27
0017	2T	21	951	136	95100	106440	11340	0.14	1.12	168	188	20
0017	2T	23	612	72	61200	38480	-22720	0.12	0.63	108	68	-40
0017	2T	24	514	56	51400	33710	-17690	0.11	0.66	90	59	-31
0017	2T	25	269	17	26900	12370	-14530	0.06	0.46	47	21	-26
0017	2T	26	533	44	53300	38380	-14920	0.08	0.72	94	67	-27
0017	3F	123	5424	1580	542400	451180	-91220	0.29	0.83	960	798	-162
0017	3F	124	12595	2667	1259500	942300	-317200	0.21	0.75	2229	1667	-562
0017	3F	125	7045	1229	704500	551860	-152640	0.17	0.78	1246	976	-270
0006	1T	1	60953	35738	6095300	5665920	-429380	0.59	0.93	10788	10028	-760
0006	1T	2	7397	2357	739700	687240	-52460	0.32	0.93	1309	1216	-93
0006	2F	12	24220	7452	2422000	2090070	-331930	0.31	0.86	4286	3699	-587
0006	2F	13	14864	3822	1486400	1267550	-218850	0.26	0.85	2630	2243	-387
0006	2F	14	9426	1963	942600	774830	-167770	0.21	0.82	1668	1371	-297
0006	2F	15	3738	525	373800	295980	-77820	0.14	0.79	661	523	-138
0006	2F	16	2120	263	212000	164810	-47190	0.12	0.78	375	291	-84
0006	2F	23	1461	209	146100	136260	-9840	0.14	0.93	258	241	-17
0006	2F	24	823	113	82300	64950	-17350	0.14	0.79	145	114	-31
0006	2F	25	602	55	60200	37850	-22350	0.09	0.63	106	66	-40
0006	2F	26	442	38	44200	27520	-16680	0.09	0.62	78	48	-30
0006	2T	12	21887	5182	2188700	1831090	-357610	0.24	0.84	3873	3240	-633
0006	2T	13	14864	2943	1486400	1239330	-247070	0.20	0.83	2630	2193	-437
0006	2T	14	9426	1508	942600	781070	-161530	0.16	0.83	1668	1382	-286
0006	2T	15	3738	391	373800	306900	-66900	0.10	0.82	661	543	-118
0006	2T	16	2120	191	212000	168020	-43980	0.09	0.79	375	297	-78
0006	2T	21	2333	315	233300	225800	-7500	0.14	0.97	412	399	-13
0006	2T	23	1461	125	146100	143720	-2380	0.09	0.98	258	254	-4
0006	2T	24	823	66	82300	67110	-15190	0.08	0.82	145	118	-27
0006	2T	25	602	38	60200	40310	-19890	0.06	0.67	106	71	-35
0006	2T	26	442	22	44200	17650	-26550	0.05	0.40	78	31	-47
0006	3F	123	10319	2224	1031900	878980	-152920	0.22	0.85	1826	1555	-271
0006	3F	124	8298	1503	829800	660730	-169070	0.18	0.80	1468	1169	-299
0006	3F	125	5050	646	505000	380000	-125000	0.13	0.75	893	672	-221
0006	3F	126	4064	460	406400	379250	-27150	0.11	0.93	719	671	-48
0006	3F	134	5841	929	584100	493310	-90790	0.16	0.84	1033	873	-160
0006	3F	135	3407	401	340700	256740	-83960	0.12	0.75	603	454	-149
0006	3F	136	2638	277	263800	253270	-10530	0.11	0.96	466	448	-18
0006	3F	145	2255	217	225500	163230	-62270	0.10	0.72	399	288	-111
0006	3F	146	1615	134	161500	117970	-43530	0.08	0.73	285	208	-77
0006	3F	156	801	67	80100	71710	-8390	0.08	0.90	141	126	-15
0006	3F	234	488	46	48800	34060	-14740	0.09	0.70	86	60	-26
0006	3F	235	352	37	35200	28490	-6710	0.11	0.81	62	50	-12
0017	3F	126	7982	1018	798200	700740	-97460	0.13	0.88	1412	1240	-172
0017	3F	134	4360	1001	436000	336530	-99470	0.23	0.77	771	595	-176
0017	3F	135	3640	670	364000	267940	-96060	0.18	0.74	644	474	-170
0017	3F	136	3735	513	373500	289450	-84050	0.14	0.77	661	512	-149
0017	3F	145	1647	290	164700	126150	-38550	0.18	0.77	291	223	-68
0017	3F	146	1414	189	141400	110030	-31370	0.13	0.78	250	194	-56
0017	3F	156	541	87	54100	51280	-2820	0.16	0.95	95	90	-5
0017	3F	234	137	28	13700	12410	-1290	0.20	0.91	24	21	-3
0017	3F	235	185	31	18500	11870	-6630	0.17	0.64	32	21	-11
0017	3F	236	180	26	18000	16760	-1240	0.14	0.93	31	29	-2
0017	3F	245	159	27	15900	13340	-2560	0.17	0.84	28	23	-5
0017	3F	246	127	15	12700	10530	-2170	0.12	0.83	22	18	-4
0017	3F	256	63	7	6300	2670	-3630	0.11	0.42	11	4	-7
0017	3T	123	5199	683	519900	434520	-85380	0.13	0.84	920	769	-151
0017	3T	124	12223	1134	1222300	911200	-311100	0.09	0.75	2163	1612	-551
0017	3T	125	6771	493	677100	517620	-159480	0.07	0.76	1198	916	-282
0017	3T	126	7439	430	743900	688460	-55440	0.06	0.93	1316	1218	-98
0017	3T	132	211	24	21100	21410	310	0.11	1.01	37	37	0
0017	3T	134	4326	428	432600	341170	-91430	0.10	0.79	765	603	-162
0017	3T	135	3609	274	360900	270410	-90490	0.08	0.75	638	478	-160
0017	3T	136	3731	226	373100	294530	-78570	0.06	0.79	660	521	-139
0017	3T	142	225	21	22500	20010	-2490	0.09	0.89	39	35	-4
0017	3T	143	34	1	3400	1060	-2340	0.03	0.31	6	1	-5
0017	3T	145	1586	106	158600	121560	-37040	0.07	0.77	280	215	-65
0017	3T	146	1388	71	138800	92780	-46020	0.05	0.67	245	164	-81
0017	3T	152	24	1	2400	1780	-620	0.04	0.74	4	3	-1
0017	3T	153	31	2	3100	2860	-240	0.06	0.92	5	5	0
0017	3T	154	61	2	6100	3430	-2670	0.03	0.56	10	6	-4
0017	3T	156	526	34	52600	52650	50	0.06	1.00	93	93	0
0017	3T	162	4	1	400	740	340	0.25	1.85	0	1	1
0017	3T	163	4	0	400	0	-400	0.00	0.00	0	0	0
0017	3T	164	26	2	2600	2530	-70	0.08	0.97	4	4	0
0017	3T	165	15	1	1500	1080	-420	0.07	0.72	2	1	-1
0017	3T	213	14	1	1400	1150	-250	0.07	0.82	2	2	0
0017	3T	214	144	2	14400	4640	-9760	0.01	0.32	25	8	-17
0017	3T	215	250	6	25000	10460	-14540	0.02	0.42	44	18	-26
0017	3T	216	539	22	53900	56480	2580	0.04	1.05	95	99	4
0017	3T	234	135	10	13500	21960	8460	0.07	1.63	23	38	15
0017	3T	235	184	10	18400	13150	-5250	0.05	0.71	32	23	-9
0017	3T	236	180	10	18000	16350	-1650	0.06	0.91	31	28	-3
0017	3T	241	3	0	300	0	-300	0.00	0.00	0	0	0
0017	3T	243	2	0	200	0	-200	0.00	0.00	0	0	0
0017	3T	245	158	6	15800	13010	-2790	0.04	0.82	27	23	-4
0017	3T	246	126	3	12600	4120	-8480	0.02	0.33	22	7	-15
0017	3T	253	1	0	100	0	-100	0.00	0.00	0	0	0
0017	3T	254	1	0	100	0	-100	0.00	0.00	0	0	0
0017	3T	256	61	1	6100	1030	-5070	0.02	0.17	10	1	-9
0017	3T	264	1	0	100	0	-100	0.00	0.00	0	0	0
0017	3T	265	2	0	200	0	-200	0.00	0.00	0	0	0
0052	2F	26	741	72	74100	58440	-15660	0.10	0.79	131	103	-28
0052	2T	12	15685	3893	1568500	1300190	-268310	0.25	0.83	2776	2301	-475
0052	2T	13	10794	2157	1079400	857960	-221440	0.20	0.79	1910	1518	-392
0052	2T	14	8312	1312	831200	641620	-189580	0.16	0.77	1471	1135	-336
0052	2T	15	4836	542	483600	398630	-84970	0.11	0.82	855	705	-150
0052	2T	16	2970	251	297000	230790	-66210	0.08	0.78	525	408	-117
0052	2T	21	2176	263	217600	204780	-12820	0.12	0.94	385	362	-23
0052	2T	23	1836	144	183600	148260	-35340	0.08	0.81	324	262	-62
0052	2T	24	1332	80	133200	80510	-52690	0.06	0.60	235	142	-93
0052	2T	25	985	62	98500	58700	-39800	0.06	0.60	174	103	-71
0052	2T	26	741	56	74100	69300	-4800	0.08	0.94	131	122	-9
0052	3F	123	6148	1389	614800	522310	-92490	0.23	0.85	1088	924	-164
0052	3F	124	5611	1021	561100	429170	-131930	0.18	0.76	993	759	-234
0052	3F	125	3866	454	386600	293230	-93370	0.12	0.76	684	518	-166
0052	3F	126	3410	388	341000	301760	-39240	0.11	0.88	603	534	-69
0052	3F	134	3889	601	388900	317260	-71640	0.15	0.82	688	561	-127
0052	3F	135	2845	338	284500	208970	-75530	0.12	0.73	503	369	-134
0052	3F	136	2054	190	205400	145860	-59540	0.09	0.71	363	258	-105
0052	3F	145	2300	237	230000	187740	-42260	0.10	0.82	407	332	-75
0052	3F	146	1687	109	168700	96300	-72400	0.06	0.57	298	170	-128
0052	3F	156	1136	72	113600	74310	-39290	0.06	0.65	201	131	-70
0052	3F	234	655	61	65500	50140	-15360	0.09	0.77	115	88	-27
0052	3F	235	518	44	51800	31640	-20160	0.08	0.61	91	56	-35
0052	3F	236	410	30	41000	32890	-8110	0.07	0.80	72	58	-14
0052	3F	245	406	30	40600	23780	-16820	0.07	0.59	71	42	-29
0052	3F	246	346	29	34600	41570	6970	0.08	1.20	61	73	12
0052	3F	256	254	14	25400	20280	-5120	0.06	0.80	44	35	-9
0052	3T	123	3509	401	350900	311000	-39900	0.11	0.89	621	550	-71
0052	3T	124	3450	286	345000	263420	-81580	0.08	0.76	610	466	-144
0052	3T	125	2525	135	252500	203280	-49220	0.05	0.81	446	359	-87
0052	3T	126	2370	118	237000	236910	-90	0.05	1.00	419	419	0
0052	3T	132	2021	149	202100	173260	-28840	0.07	0.86	357	306	-51
0052	3T	134	2327	150	232700	187100	-45600	0.06	0.80	411	331	-80
0052	3T	135	1938	104	193800	126650	-67150	0.05	0.65	343	224	-119
0052	3T	136	1537	62	153700	98860	-54840	0.04	0.64	272	174	-98
0052	3T	142	1575	92	157500	123080	-34420	0.06	0.78	278	217	-61
0052	3T	143	1562	67	156200	118530	-37670	0.04	0.76	276	209	-67
0052	3T	145	1431	67	143100	102690	-40410	0.05	0.72	253	181	-72
0052	3T	146	1184	35	118400	74920	-43480	0.03	0.63	209	132	-77
0052	3T	152	854	27	85400	49990	-35410	0.03	0.59	151	88	-63
0052	3T	153	907	24	90700	68130	-22570	0.03	0.75	160	120	-40
0052	3T	154	869	24	86900	80610	-6290	0.03	0.93	153	142	-11
0052	3T	156	722	24	72200	61080	-11120	0.03	0.85	127	108	-19
0052	3T	162	573	20	57300	60160	2860	0.03	1.05	101	106	5
0052	3T	163	517	13	51700	52790	1090	0.03	1.02	91	93	2
0052	3T	164	503	4	50300	16350	-33950	0.01	0.33	89	28	-61
0052	3T	165	414	10	41400	37380	-4020	0.02	0.90	73	66	-7
0052	3T	213	447	22	44700	48040	3340	0.05	1.07	79	85	6
0052	3T	214	457	27	45700	53830	8130	0.06	1.18	80	95	15
0052	3T	215	389	10	38900	27690	-11210	0.03	0.71	68	49	-19
0052	3T	216	397	14	39700	28940	-10760	0.04	0.73	70	51	-19
0052	3T	231	171	1	17100	9350	-7750	0.01	0.55	30	16	-14
0052	3T	234	406	10	40600	33670	-6930	0.02	0.83	71	59	-12
0052	3T	235	351	7	35100	7520	-27580	0.02	0.21	62	13	-49
0052	3T	236	304	6	30400	18680	-11720	0.02	0.61	53	33	-20
0052	3T	241	129	1	12900	2970	-9930	0.01	0.23	22	5	-17
0052	3T	243	249	4	24900	10180	-14720	0.02	0.41	44	18	-26
0052	3T	245	238	5	23800	24130	330	0.02	1.01	42	42	0
0052	3T	246	214	4	21400	24410	3010	0.02	1.14	37	43	6
0052	3T	251	98	1	9800	9570	-230	0.01	0.98	17	16	-1
0052	3T	253	167	3	16700	4830	-11870	0.02	0.29	29	8	-21
0052	3T	254	168	3	16800	7580	-9220	0.02	0.45	29	13	-16
0052	3T	256	151	4	15100	17830	2730	0.03	1.18	26	31	5
0052	3T	261	70	4	7000	10190	3190	0.06	1.46	12	18	6
0052	3T	263	106	1	10600	3480	-7120	0.01	0.33	18	6	-12
0052	3T	264	132	4	13200	10620	-2580	0.03	0.80	23	18	-5
0052	3T	265	103	1	10300	3060	-7240	0.01	0.30	18	5	-13
0006	3F	236	347	21	34700	12020	-22680	0.06	0.35	61	21	-40
0006	3F	245	221	19	22100	28890	6790	0.09	1.31	39	51	12
0006	3F	246	201	14	20100	17930	-2170	0.07	0.89	35	31	-4
0006	3F	256	180	12	18000	13390	-4610	0.07	0.74	31	23	-8
0006	3T	123	6059	602	605900	544760	-61140	0.10	0.90	1072	964	-108
0006	3T	124	5428	444	542800	436600	-106200	0.08	0.80	960	772	-188
0006	3T	125	3656	221	365600	296080	-69520	0.06	0.81	647	524	-123
0006	3T	126	3093	155	309300	274030	-35270	0.05	0.89	547	485	-62
0006	3T	132	3498	276	349800	336160	-13640	0.08	0.96	619	594	-25
0006	3T	134	3658	246	365800	294490	-71310	0.07	0.81	647	521	-126
0006	3T	135	2599	147	259900	220950	-38950	0.06	0.85	460	391	-69
0006	3T	136	2146	95	214600	203190	-11410	0.04	0.95	379	359	-20
0006	3T	142	2253	141	225300	206370	-18930	0.06	0.92	398	365	-33
0006	3T	143	2183	113	218300	207470	-10830	0.05	0.95	386	367	-19
0006	3T	145	1561	60	156100	110400	-45700	0.04	0.71	276	195	-81
0006	3T	146	1253	41	125300	83340	-41960	0.03	0.67	221	147	-74
0006	3T	152	877	33	87700	56770	-30930	0.04	0.65	155	100	-55
0006	3T	153	808	17	80800	37350	-43450	0.02	0.46	143	66	-77
0006	3T	154	694	19	69400	69560	160	0.03	1.00	122	123	1
0006	3T	156	564	16	56400	45840	-10560	0.03	0.81	99	81	-18
0006	3T	162	484	19	48400	64690	16290	0.04	1.34	85	114	29
0006	3T	163	492	14	49200	25600	-23600	0.03	0.52	87	45	-42
0006	3T	164	362	12	36200	28710	-7490	0.03	0.79	64	50	-14
0006	3T	165	237	1	23700	3440	-20260	0.00	0.15	41	6	-35
0006	3T	213	549	32	54900	49080	-5820	0.06	0.89	97	86	-11
0006	3T	214	487	27	48700	70560	21860	0.06	1.45	86	124	38
0006	3T	215	423	13	42300	33040	-9260	0.03	0.78	74	58	-16
0006	3T	216	417	20	41700	54100	12400	0.05	1.30	73	95	22
0006	3T	231	213	6	21300	10420	-10880	0.03	0.49	37	18	-19
0006	3T	234	328	9	32800	24450	-8350	0.03	0.75	58	43	-15
0006	3T	235	232	6	23200	30630	7430	0.03	1.32	41	54	13
0006	3T	236	257	6	25700	12960	-12740	0.02	0.50	45	22	-23
0006	3T	241	130	3	13000	4680	-8320	0.02	0.36	23	8	-15
0006	3T	243	160	4	16000	6630	-9370	0.03	0.41	28	11	-17
0006	3T	245	133	4	13300	60060	46760	0.03	4.52	23	106	83
0006	3T	246	134	5	13400	19800	6400	0.04	1.48	23	35	12
0006	3T	251	94	0	9400	0	-9400	0.00	0.00	16	0	-16
0006	3T	253	120	2	12000	3770	-8230	0.02	0.31	21	6	-15
0006	3T	254	88	2	8800	7530	-1270	0.02	0.86	15	13	-2
0006	3T	256	114	0	11400	0	-11400	0.00	0.00	20	0	-20
0006	3T	261	70	2	7000	5090	-1910	0.03	0.73	12	9	-3
0006	3T	263	90	3	9000	4440	-4560	0.03	0.49	15	7	-8
0006	3T	264	67	0	6700	0	-6700	0.00	0.00	11	0	-11
0006	3T	265	66	0	6600	0	-6600	0.00	0.00	11	0	-11
0041	1T	1	21327	15295	2132700	1941700	-191000	0.72	0.91	3774	3436	-338
0041	1T	2	10557	3540	1055700	912230	-143470	0.34	0.86	1868	1614	-254
0041	2F	12	9017	3449	901700	737350	-164350	0.38	0.82	1595	1305	-290
0041	2F	13	5358	1720	535800	434670	-101130	0.32	0.81	948	769	-179
0041	2F	14	4499	1036	449900	337580	-112320	0.23	0.75	796	597	-199
0041	2F	15	2906	421	290600	225220	-65380	0.14	0.78	514	398	-116
0041	2F	16	1618	184	161800	140010	-21790	0.11	0.87	286	247	-39
0041	2F	23	523	70	52300	41210	-11090	0.13	0.79	92	72	-20
0041	2F	24	1528	204	152800	110450	-42350	0.13	0.72	270	195	-75
0041	2F	25	2022	204	202200	125710	-76490	0.10	0.62	357	222	-135
0041	2F	26	2005	139	200500	131220	-69280	0.07	0.65	354	232	-122
0041	2T	12	7753	2484	775300	615360	-159940	0.32	0.79	1372	1089	-283
0041	2T	13	4675	1272	467500	367190	-100310	0.27	0.79	827	649	-178
0041	2T	14	4271	808	427100	301400	-125700	0.19	0.71	755	533	-222
0041	2T	15	2772	341	277200	216510	-60690	0.12	0.78	490	383	-107
0041	2T	16	1496	143	149600	129770	-19830	0.10	0.87	264	229	-35
0041	2T	21	1264	177	126400	108550	-17850	0.14	0.86	223	192	-31
0041	2T	23	416	33	41600	26870	-14730	0.08	0.65	73	47	-26
0041	2T	24	1298	112	129800	81410	-48390	0.09	0.63	229	144	-85
0041	2T	25	1843	147	184300	123390	-60910	0.08	0.67	326	218	-108
0041	2T	26	1856	108	185600	138720	-46880	0.06	0.75	328	245	-83
0041	3F	123	1989	579	198900	160210	-38690	0.29	0.81	352	283	-69
0041	3F	124	3530	750	353000	248260	-104740	0.21	0.70	624	439	-185
0041	3F	125	2374	363	237400	181520	-55880	0.15	0.76	420	321	-99
0041	3F	126	2977	297	297700	239900	-57800	0.10	0.81	526	424	-102
0041	3F	134	2059	445	205900	167630	-38270	0.22	0.81	364	296	-68
0041	3F	135	1868	236	186800	126290	-60510	0.13	0.68	330	223	-107
0041	3F	136	1780	159	178000	133210	-44790	0.09	0.75	315	235	-80
0041	3F	145	1626	172	162600	114350	-48250	0.11	0.70	287	202	-85
0041	3F	146	1592	133	159200	124690	-34510	0.08	0.78	281	220	-61
0041	3F	156	902	45	90200	66680	-23520	0.05	0.74	159	118	-41
0041	3F	234	72	5	7200	5770	-1430	0.07	0.80	12	10	-2
0041	3F	235	85	8	8500	10920	2420	0.09	1.28	15	19	4
0041	3F	236	105	3	10500	1660	-8840	0.03	0.16	18	2	-16
0041	3F	245	132	3	13200	4650	-8550	0.02	0.35	23	8	-15
0041	3F	246	160	5	16000	6780	-9220	0.03	0.42	28	12	-16
0041	3F	256	207	8	20700	8860	-11840	0.04	0.43	36	15	-21
0041	3T	123	1500	216	150000	127270	-22730	0.14	0.85	265	225	-40
0041	3T	124	2445	254	244500	161160	-83340	0.10	0.66	432	285	-147
0041	3T	125	1228	119	122800	95630	-27170	0.10	0.78	217	169	-48
0041	3T	126	1949	100	194900	155650	-39250	0.05	0.80	344	275	-69
0041	3T	132	166	19	16600	14380	-2220	0.11	0.87	29	25	-4
0041	3T	134	1223	128	122300	99830	-22470	0.10	0.82	216	176	-40
0041	3T	135	1052	70	105200	63450	-41750	0.07	0.60	186	112	-74
0041	3T	136	1111	66	111100	97400	-13700	0.06	0.88	196	172	-24
0041	3T	142	140	8	14000	8960	-5040	0.06	0.64	24	15	-9
0041	3T	143	124	6	12400	7760	-4640	0.05	0.63	21	13	-8
0041	3T	145	772	38	77200	53000	-24200	0.05	0.69	136	93	-43
0041	3T	146	1084	50	108400	87790	-20610	0.05	0.81	191	155	-36
0041	3T	152	62	0	6200	0	-6200	0.00	0.00	10	0	-10
0041	3T	153	200	6	20000	10710	-9290	0.03	0.54	35	18	-17
0041	3T	154	261	7	26100	23490	-2610	0.03	0.90	46	41	-5
0041	3T	156	689	18	68900	65660	-3240	0.03	0.95	121	116	-5
0041	3T	162	73	0	7300	0	-7300	0.00	0.00	12	0	-12
0041	3T	163	72	3	7200	5850	-1350	0.04	0.81	12	10	-2
0041	3T	164	55	4	5500	12160	6660	0.07	2.21	9	21	12
0041	3T	165	19	0	1900	0	-1900	0.00	0.00	3	0	-3
0041	3T	213	116	10	11600	8460	-3140	0.09	0.73	20	14	-6
0041	3T	214	88	9	8800	14320	5520	0.10	1.63	15	25	10
0041	3T	215	111	2	11100	3050	-8050	0.02	0.27	19	5	-14
0041	3T	216	237	9	23700	24610	910	0.04	1.04	41	43	2
0041	3T	231	192	7	19200	23450	4250	0.04	1.22	33	41	8
0041	3T	234	33	2	3300	6680	3380	0.06	2.02	5	11	6
0041	3T	235	47	0	4700	0	-4700	0.00	0.00	8	0	-8
0041	3T	236	42	1	4200	880	-3320	0.02	0.21	7	1	-6
0041	3T	241	783	23	78300	46300	-32000	0.03	0.59	138	81	-57
0041	3T	243	11	0	1100	0	-1100	0.00	0.00	1	0	-1
0041	3T	245	87	0	8700	0	-8700	0.00	0.00	15	0	-15
0041	3T	246	84	1	8400	3830	-4570	0.01	0.46	14	6	-8
0041	3T	251	950	25	95000	80090	-14910	0.03	0.84	168	141	-27
0041	3T	253	21	1	2100	1480	-620	0.05	0.70	3	2	-1
0041	3T	254	17	0	1700	0	-1700	0.00	0.00	3	0	-3
0041	3T	256	152	4	15200	5340	-9860	0.03	0.35	26	9	-17
0041	3T	261	692	9	69200	34450	-34750	0.01	0.50	122	60	-62
0041	3T	263	22	0	2200	0	-2200	0.00	0.00	3	0	-3
0041	3T	264	15	0	1500	0	-1500	0.00	0.00	2	0	-2
0041	3T	265	7	0	700	0	-700	0.00	0.00	1	0	-1
0042	1T	1	21291	15334	2129100	1935130	-193970	0.72	0.91	3768	3425	-343
0042	1T	2	10978	3673	1097800	955220	-142580	0.33	0.87	1943	1690	-253
0042	2F	12	6939	2782	693900	569480	-124420	0.40	0.82	1228	1007	-221
0042	2F	13	5303	1681	530300	426940	-103360	0.32	0.81	938	755	-183
0042	2F	14	5368	1230	536800	409920	-126880	0.23	0.76	950	725	-225
0042	2F	15	3407	503	340700	279500	-61200	0.15	0.82	603	494	-109
0042	2F	16	1755	208	175500	153360	-22140	0.12	0.87	310	271	-39
0042	2F	23	699	113	69900	60060	-9840	0.16	0.86	123	106	-17
0042	2F	24	1817	238	181700	124870	-56830	0.13	0.69	321	221	-100
0042	2F	25	2289	234	228900	154480	-74420	0.10	0.67	405	273	-132
0042	2F	26	2133	162	213300	127440	-85860	0.08	0.60	377	225	-152
0042	2T	12	5942	2009	594200	475170	-119030	0.34	0.80	1051	841	-210
0042	2T	13	4983	1313	498300	386860	-111440	0.26	0.78	881	684	-197
0042	2T	14	5085	967	508500	375650	-132850	0.19	0.74	900	664	-236
0042	2T	15	3266	409	326600	266830	-59770	0.13	0.82	578	472	-106
0042	2T	16	1617	160	161700	138060	-23640	0.10	0.85	286	244	-42
0042	2T	21	997	122	99700	69390	-30310	0.12	0.70	176	122	-54
0042	2T	23	604	57	60400	42880	-17520	0.09	0.71	106	75	-31
0042	2T	24	1561	135	156100	95880	-60220	0.09	0.61	276	169	-107
0042	2T	25	2143	166	214300	142410	-71890	0.08	0.66	379	252	-127
0042	2T	26	1940	115	194000	117860	-76140	0.06	0.61	343	208	-135
0042	3F	123	1468	438	146800	113960	-32840	0.30	0.78	259	201	-58
0042	3F	124	2764	613	276400	209880	-66520	0.22	0.76	489	371	-118
0042	3F	125	1979	308	197900	167870	-30030	0.16	0.85	350	297	-53
0042	3F	126	2630	281	263000	213030	-49970	0.11	0.81	465	377	-88
0042	3F	134	1819	377	181900	139060	-42840	0.21	0.76	321	246	-75
0042	3F	135	1471	208	147100	104300	-42800	0.14	0.71	260	184	-76
0042	3F	136	2218	189	221800	182060	-39740	0.09	0.82	392	322	-70
0042	3F	145	1514	140	151400	103090	-48310	0.09	0.68	267	182	-85
0042	3F	146	2156	184	215600	192170	-23430	0.09	0.89	381	340	-41
0042	3F	156	1291	51	129100	77410	-51690	0.04	0.60	228	137	-91
0042	3F	234	98	3	9800	2730	-7070	0.03	0.28	17	4	-13
0042	3F	235	105	8	10500	9990	-510	0.08	0.95	18	17	-1
0042	3F	236	112	2	11200	1260	-9940	0.02	0.11	19	2	-17
0042	3F	245	193	12	19300	8320	-10980	0.06	0.43	34	14	-20
0042	3F	246	280	11	28000	9780	-18220	0.04	0.35	49	17	-32
0042	3F	256	376	17	37600	29470	-8130	0.05	0.78	66	52	-14
0042	3T	123	920	147	92000	71910	-20090	0.16	0.78	162	127	-35
0042	3T	124	1599	191	159900	118140	-41760	0.12	0.74	283	209	-74
0042	3T	125	1008	92	100800	74380	-26420	0.09	0.74	178	131	-47
0042	3T	126	1699	94	169900	132110	-37790	0.06	0.78	300	233	-67
0042	3T	132	161	17	16100	13190	-2910	0.11	0.82	28	23	-5
0042	3T	134	1193	123	119300	89930	-29370	0.10	0.75	211	159	-52
0042	3T	135	927	69	92700	71260	-21440	0.07	0.77	164	126	-38
0042	3T	136	1740	82	174000	140070	-33930	0.05	0.81	307	247	-60
0042	3T	142	121	8	12100	8710	-3390	0.07	0.72	21	15	-6
0042	3T	143	68	9	6800	10850	4050	0.13	1.60	12	19	7
0042	3T	145	915	36	91500	54110	-37390	0.04	0.59	161	95	-66
0042	3T	146	1778	81	177800	162290	-15510	0.05	0.91	314	287	-27
0042	3T	152	99	5	9900	7590	-2310	0.05	0.77	17	13	-4
0042	3T	153	94	4	9400	5550	-3850	0.04	0.59	16	9	-7
0042	3T	154	212	11	21200	38960	17760	0.05	1.84	37	68	31
0042	3T	156	1088	21	108800	67920	-40880	0.02	0.62	192	120	-72
0042	3T	162	66	6	6600	14380	7780	0.09	2.18	11	25	14
0042	3T	163	65	2	6500	2260	-4240	0.03	0.35	11	4	-7
0042	3T	164	63	3	6300	11790	5490	0.05	1.87	11	20	9
0042	3T	165	32	0	3200	0	-3200	0.00	0.00	5	0	-5
0042	3T	213	45	3	4500	3030	-1470	0.07	0.67	7	5	-2
0042	3T	214	141	4	14100	5390	-8710	0.03	0.38	24	9	-15
0042	3T	215	159	3	15900	8340	-7560	0.02	0.52	28	14	-14
0042	3T	216	276	7	27600	23960	-3640	0.03	0.87	48	42	-6
0042	3T	231	305	8	30500	12020	-18480	0.03	0.39	53	21	-32
0042	3T	234	74	1	7400	3760	-3640	0.01	0.51	13	6	-7
0042	3T	235	69	1	6900	5370	-1530	0.01	0.78	12	9	-3
0042	3T	236	80	1	8000	880	-7120	0.01	0.11	14	1	-13
0042	3T	241	815	28	81500	60340	-21160	0.03	0.74	144	106	-38
0042	3T	245	154	2	15400	2210	-13190	0.01	0.14	27	3	-24
0042	3T	246	214	1	21400	3830	-17570	0.00	0.18	37	6	-31
0042	3T	251	677	16	67700	56010	-11690	0.02	0.83	119	99	-20
0042	3T	253	10	1	1000	6300	5300	0.10	6.30	1	11	10
0042	3T	254	16	1	1600	5330	3730	0.06	3.33	2	9	7
0042	3T	256	318	4	31800	5270	-26530	0.01	0.17	56	9	-47
0042	3T	261	527	14	52700	57490	4790	0.03	1.09	93	101	8
0042	3T	263	15	0	1500	0	-1500	0.00	0.00	2	0	-2
0042	3T	264	30	0	3000	0	-3000	0.00	0.00	5	0	-5
0042	3T	265	16	0	1600	0	-1600	0.00	0.00	2	0	-2
0043	1T	1	21230	14746	2123000	2018950	-104050	0.69	0.95	3757	3573	-184
0043	1T	2	12471	3350	1247100	1161760	-85340	0.27	0.93	2207	2056	-151
0043	2F	12	8344	2870	834400	724750	-109650	0.34	0.87	1476	1282	-194
0043	2F	13	7061	1949	706100	590150	-115950	0.28	0.84	1249	1044	-205
0043	2F	14	6691	1465	669100	525510	-143590	0.22	0.79	1184	930	-254
0043	2F	15	5000	696	500000	439110	-60890	0.14	0.88	884	777	-107
0043	2F	16	3886	403	388600	315740	-72860	0.10	0.81	687	558	-129
0043	2F	23	3387	313	338700	259280	-79420	0.09	0.77	599	458	-141
0043	2F	24	3416	288	341600	240400	-101200	0.08	0.70	604	425	-179
0043	2F	25	3371	215	337100	240200	-96900	0.06	0.71	596	425	-171
0043	2F	26	3179	188	317900	192470	-125430	0.06	0.61	562	340	-222
0043	2T	12	5326	1530	532600	454730	-77870	0.29	0.85	942	804	-138
0043	2T	13	4487	1047	448700	376250	-72450	0.23	0.84	794	665	-129
0043	2T	14	4437	840	443700	360420	-83280	0.19	0.81	785	637	-148
0043	2T	15	3248	373	324800	284740	-40060	0.11	0.88	574	503	-71
0043	2T	16	2463	222	246300	227650	-18650	0.09	0.92	435	402	-33
0043	2T	21	3018	409	301800	293210	-8590	0.14	0.97	534	518	-16
0043	2T	23	1824	102	182400	152080	-30320	0.06	0.83	322	269	-53
0043	2T	24	1736	104	173600	135980	-37620	0.06	0.78	307	240	-67
0043	2T	25	1932	103	193200	149500	-43700	0.05	0.77	341	264	-77
0043	2T	26	2036	104	203600	164100	-39500	0.05	0.81	360	290	-70
0043	3F	123	4070	960	407000	328940	-78060	0.24	0.81	720	582	-138
0043	3F	124	3971	777	397100	302650	-94450	0.20	0.76	702	535	-167
0043	3F	125	3214	439	321400	281720	-39680	0.14	0.88	568	498	-70
0043	3F	126	2803	296	280300	253520	-26780	0.11	0.90	496	448	-48
0043	3F	134	3583	624	358300	283540	-74760	0.17	0.79	634	501	-133
0043	3F	135	2957	338	295700	202190	-93510	0.11	0.68	523	357	-166
0043	3F	136	2571	259	257100	207260	-49840	0.10	0.81	455	366	-89
0043	3F	145	2871	280	287100	235550	-51550	0.10	0.82	508	416	-92
0043	3F	146	2263	175	226300	141810	-84490	0.08	0.63	400	250	-150
0043	3F	156	2013	120	201300	194880	-6420	0.06	0.97	356	344	-12
0043	3F	234	1999	129	199900	141840	-58060	0.06	0.71	353	251	-102
0043	3F	235	1808	105	180800	109600	-71200	0.06	0.61	320	193	-127
0043	3F	236	1684	64	168400	91600	-76800	0.04	0.54	298	162	-136
0043	3F	245	1719	59	171900	90790	-81110	0.03	0.53	304	160	-144
0043	3F	246	1496	69	149600	113510	-36090	0.05	0.76	264	200	-64
0043	3F	256	1416	51	141600	92830	-48770	0.04	0.66	250	164	-86
0043	3T	123	1373	180	137300	129050	-8250	0.13	0.94	243	228	-15
0043	3T	124	1259	104	125900	82750	-43150	0.08	0.66	222	146	-76
0043	3T	125	999	61	99900	78970	-20930	0.06	0.79	176	139	-37
0043	3T	126	820	41	82000	65380	-16620	0.05	0.80	145	115	-30
0043	3T	132	1014	91	101400	85680	-15720	0.09	0.84	179	151	-28
0043	3T	134	1062	96	106200	98330	-7870	0.09	0.93	187	174	-13
0043	3T	135	819	38	81900	46590	-35310	0.05	0.57	144	82	-62
0043	3T	136	699	38	69900	60020	-9880	0.05	0.86	123	106	-17
0043	3T	142	987	84	98700	85710	-12990	0.09	0.87	174	151	-23
0043	3T	143	959	48	95900	64970	-30930	0.05	0.68	169	114	-55
0043	3T	145	818	35	81800	45970	-35830	0.04	0.56	144	81	-63
0043	3T	146	608	22	60800	36790	-24010	0.04	0.61	107	65	-42
0043	3T	152	659	32	65900	63340	-2560	0.05	0.96	116	112	-4
0043	3T	153	636	20	63600	47140	-16460	0.03	0.74	112	83	-29
0043	3T	154	615	12	61500	29860	-31640	0.02	0.49	108	52	-56
0043	3T	156	520	16	52000	55900	3900	0.03	1.08	92	98	6
0043	3T	162	520	14	52000	40510	-11490	0.03	0.78	92	71	-21
0043	3T	163	502	12	50200	42840	-7360	0.02	0.85	88	75	-13
0043	3T	164	449	9	44900	29060	-15840	0.02	0.65	79	51	-28
0043	3T	165	314	4	31400	7460	-23940	0.01	0.24	55	13	-42
0043	3T	213	566	31	56600	58600	2000	0.05	1.04	100	103	3
0043	3T	214	556	29	55600	46610	-8990	0.05	0.84	98	82	-16
0043	3T	215	542	19	54200	52340	-1860	0.04	0.97	95	92	-3
0043	3T	216	554	16	55400	50250	-5150	0.03	0.91	98	88	-10
0043	3T	231	431	9	43100	46240	3140	0.02	1.07	76	81	5
0043	3T	234	353	4	35300	10450	-24850	0.01	0.30	62	18	-44
0043	3T	235	289	5	28900	30730	1830	0.02	1.06	51	54	3
0043	3T	236	290	5	29000	17830	-11170	0.02	0.61	51	31	-20
0043	3T	241	417	10	41700	41930	230	0.02	1.01	73	74	1
0043	3T	243	302	7	30200	52910	22710	0.02	1.75	53	93	40
0043	3T	245	275	1	27500	2200	-25300	0.00	0.08	48	3	-45
0043	3T	246	270	6	27000	38240	11240	0.02	1.42	47	67	20
0043	3T	251	504	8	50400	23320	-27080	0.02	0.46	89	41	-48
0043	3T	253	300	9	30000	18670	-11330	0.03	0.62	53	33	-20
0043	3T	254	256	1	25600	19000	-6600	0.00	0.74	45	33	-12
0043	3T	256	317	4	31700	10100	-21600	0.01	0.32	56	17	-39
0043	3T	261	547	9	54700	63710	9010	0.02	1.16	96	112	16
0043	3T	263	321	5	32100	27310	-4790	0.02	0.85	56	48	-8
0043	3T	264	281	3	28100	12760	-15340	0.01	0.45	49	22	-27
0043	3T	265	246	5	24600	17860	-6740	0.02	0.73	43	31	-12
0044	1T	1	22337	15332	2233700	2145950	-87750	0.69	0.96	3953	3798	-155
0044	1T	2	12048	3227	1204800	1057690	-147110	0.27	0.88	2132	1872	-260
0044	2F	12	8384	2896	838400	746750	-91650	0.35	0.89	1483	1321	-162
0044	2F	13	7280	1997	728000	610690	-117310	0.27	0.84	1288	1080	-208
0044	2F	14	6814	1519	681400	548580	-132820	0.22	0.81	1206	970	-236
0044	2F	15	4979	660	497900	413540	-84360	0.13	0.83	881	731	-150
0044	2F	16	3814	387	381400	300200	-81200	0.10	0.79	675	531	-144
0044	2F	23	3469	306	346900	248290	-98610	0.09	0.72	613	439	-174
0044	2F	24	3315	288	331500	279040	-52460	0.09	0.84	586	493	-93
0044	2F	25	3417	224	341700	226700	-115000	0.07	0.66	604	401	-203
0044	2F	26	3072	172	307200	197490	-109710	0.06	0.64	543	349	-194
0044	2T	12	5538	1597	553800	483310	-70490	0.29	0.87	980	855	-125
0044	2T	13	4897	1112	489700	410460	-79240	0.23	0.84	866	726	-140
0044	2T	14	4726	883	472600	401030	-71570	0.19	0.85	836	709	-127
0044	2T	15	3309	388	330900	298390	-32510	0.12	0.90	585	528	-57
0044	2T	16	2456	206	245600	203430	-42170	0.08	0.83	434	360	-74
0044	2T	21	2846	375	284600	284840	240	0.13	1.00	503	504	1
0044	2T	23	1919	107	191900	151750	-40150	0.06	0.79	339	268	-71
0044	2T	24	1653	100	165300	140230	-25070	0.06	0.85	292	248	-44
0044	2T	25	1888	86	188800	113540	-75260	0.05	0.60	334	200	-134
0044	2T	26	1787	85	178700	144460	-34240	0.05	0.81	316	255	-61
0044	3F	123	4246	1045	424600	378960	-45640	0.25	0.89	751	670	-81
0044	3F	124	4066	808	406600	334870	-71730	0.20	0.82	719	592	-127
0044	3F	125	3228	418	322800	255610	-67190	0.13	0.79	571	452	-119
0044	3F	126	2791	334	279100	283780	4680	0.12	1.02	493	502	9
0044	3F	134	3617	612	361700	320310	-41390	0.17	0.89	640	566	-74
0044	3F	135	3050	334	305000	214150	-90850	0.11	0.70	539	379	-160
0044	3F	136	2492	219	249200	222500	-26700	0.09	0.89	441	393	-48
0044	3F	145	2795	263	279500	223750	-55750	0.09	0.80	494	396	-98
0044	3F	146	2223	180	222300	179180	-43120	0.08	0.81	393	317	-76
0044	3F	156	1959	108	195900	163360	-32540	0.06	0.83	346	289	-57
0044	3F	234	1998	118	199800	106550	-93250	0.06	0.53	353	188	-165
0044	3F	235	1885	90	188500	96960	-91540	0.05	0.51	333	171	-162
0044	3F	236	1705	67	170500	92270	-78230	0.04	0.54	301	163	-138
0044	3F	245	1658	74	165800	123270	-42530	0.04	0.74	293	218	-75
0044	3F	246	1411	53	141100	97940	-43160	0.04	0.69	249	173	-76
0044	3F	256	1455	40	145500	56180	-89320	0.03	0.39	257	99	-158
0044	3T	123	1416	185	141600	137490	-4110	0.13	0.97	250	243	-7
0044	3T	124	1234	114	123400	105610	-17790	0.09	0.86	218	186	-32
0044	3T	125	1005	79	100500	93220	-7280	0.08	0.93	177	164	-13
0044	3T	126	910	46	91000	95130	4130	0.05	1.05	161	168	7
0044	3T	132	1152	94	115200	96160	-19040	0.08	0.83	203	170	-33
0044	3T	134	1089	93	108900	100870	-8030	0.09	0.93	192	178	-14
0044	3T	135	942	60	94200	68680	-25520	0.06	0.73	166	121	-45
0044	3T	136	732	32	73200	68080	-5120	0.04	0.93	129	120	-9
0044	3T	142	1099	80	109900	101030	-8870	0.07	0.92	194	178	-16
0044	3T	143	996	63	99600	97850	-1750	0.06	0.98	176	173	-3
0044	3T	145	893	40	89300	58690	-30610	0.04	0.66	158	103	-55
0044	3T	146	675	22	67500	46980	-20520	0.03	0.70	119	83	-36
0044	3T	152	703	36	70300	83120	12820	0.05	1.18	124	147	23
0044	3T	153	653	16	65300	46670	-18630	0.02	0.71	115	82	-33
0044	3T	154	630	15	63000	39750	-23250	0.02	0.63	111	70	-41
0044	3T	156	526	21	52600	65140	12540	0.04	1.24	93	115	22
0044	3T	162	525	20	52500	65830	13330	0.04	1.25	92	116	24
0044	3T	163	479	4	47900	9590	-38310	0.01	0.20	84	16	-68
0044	3T	164	420	14	42000	43780	1780	0.03	1.04	74	77	3
0044	3T	165	354	4	35400	55480	20080	0.01	1.57	62	98	36
0044	3T	213	532	24	53200	44140	-9060	0.05	0.83	94	78	-16
0044	3T	214	571	25	57100	48720	-8380	0.04	0.85	101	86	-15
0044	3T	215	499	13	49900	29880	-20020	0.03	0.60	88	52	-36
0044	3T	216	472	17	47200	60290	13090	0.04	1.28	83	106	23
0044	3T	231	434	6	43400	10620	-32780	0.01	0.24	76	18	-58
0044	3T	234	351	4	35100	14710	-20390	0.01	0.42	62	26	-36
0044	3T	235	313	5	31300	34810	3510	0.02	1.11	55	61	6
0044	3T	236	346	5	34600	19480	-15120	0.01	0.56	61	34	-27
0044	3T	241	412	10	41200	56650	15450	0.02	1.38	72	100	28
0044	3T	243	302	6	30200	23540	-6660	0.02	0.78	53	41	-12
0044	3T	245	271	4	27100	74550	47450	0.01	2.75	47	131	84
0044	3T	246	230	6	23000	22660	-340	0.03	0.99	40	40	0
0044	3T	251	486	9	48600	34590	-14010	0.02	0.71	86	61	-25
0044	3T	253	290	3	29000	5080	-23920	0.01	0.18	51	8	-43
0044	3T	254	238	5	23800	25580	1780	0.02	1.07	42	45	3
0044	3T	256	309	3	30900	36240	5340	0.01	1.17	54	64	10
0044	3T	261	430	4	43000	53030	10030	0.01	1.23	76	93	17
0044	3T	263	300	4	30000	34130	4130	0.01	1.14	53	60	7
0044	3T	264	249	3	24900	17980	-6920	0.01	0.72	44	31	-13
0044	3T	265	227	1	22700	8860	-13840	0.00	0.39	40	15	-25
0001	1T	1	20370	11706	2037000	1844290	-192710	0.57	0.91	3605	3264	-341
0001	1T	2	1579	612	157900	143100	-14800	0.39	0.91	279	253	-26
0001	2F	12	11749	3874	1174900	996910	-177990	0.33	0.85	2079	1764	-315
0001	2F	13	4813	1523	481300	391510	-89790	0.32	0.81	851	692	-159
0001	2F	14	2443	708	244300	196260	-48040	0.29	0.80	432	347	-85
0001	2F	15	709	158	70900	64480	-6420	0.22	0.91	125	114	-11
0001	2F	16	478	91	47800	46430	-1370	0.19	0.97	84	82	-2
0001	2F	23	63	11	6300	3340	-2960	0.17	0.53	11	5	-6
0001	2F	24	61	11	6100	3870	-2230	0.18	0.63	10	6	-4
0001	2F	25	77	15	7700	5730	-1970	0.19	0.74	13	10	-3
0001	2F	26	84	14	8400	7110	-1290	0.17	0.85	14	12	-2
0001	2T	12	11740	2878	1174000	951660	-222340	0.25	0.81	2077	1684	-393
0001	2T	13	4813	1112	481300	383730	-97570	0.23	0.80	851	679	-172
0001	2T	14	2443	508	244300	200220	-44080	0.21	0.82	432	354	-78
0001	2T	15	709	113	70900	73920	3020	0.16	1.04	125	130	5
0001	2T	16	478	72	47800	50680	2880	0.15	1.06	84	89	5
0001	2T	21	9	0	900	0	-900	0.00	0.00	1	0	-1
0001	2T	23	63	4	6300	2460	-3840	0.06	0.39	11	4	-7
0001	2T	24	61	6	6100	2940	-3160	0.10	0.48	10	5	-5
0001	2T	25	77	11	7700	7150	-550	0.14	0.93	13	12	-1
0001	2T	26	84	9	8400	7100	-1300	0.11	0.85	14	12	-2
0001	3F	123	3554	947	355400	292360	-63040	0.27	0.82	629	517	-112
0001	3F	124	4313	968	431300	330310	-100990	0.22	0.77	763	584	-179
0001	3F	125	1887	355	188700	160190	-28510	0.19	0.85	333	283	-50
0001	3F	126	1581	256	158100	134180	-23920	0.16	0.85	279	237	-42
0001	3F	134	1284	315	128400	99540	-28860	0.25	0.78	227	176	-51
0001	3F	135	1115	209	111500	75400	-36100	0.19	0.68	197	133	-64
0001	3F	136	1018	158	101800	79940	-21860	0.16	0.79	180	141	-39
0001	3F	145	384	77	38400	29230	-9170	0.20	0.76	67	51	-16
0001	3F	146	344	51	34400	29080	-5320	0.15	0.85	60	51	-9
0001	3F	156	127	21	12700	11460	-1240	0.17	0.90	22	20	-2
0001	3F	234	15	2	1500	450	-1050	0.13	0.30	2	0	-2
0001	3F	235	13	1	1300	360	-940	0.08	0.28	2	0	-2
0001	3F	236	12	3	1200	1500	300	0.25	1.25	2	2	0
0001	3F	245	6	2	600	790	190	0.33	1.32	1	1	0
0001	3F	246	8	1	800	480	-320	0.13	0.60	1	0	-1
0001	3F	256	16	3	1600	830	-770	0.19	0.52	2	1	-1
0001	3T	123	3449	398	344900	279810	-65090	0.12	0.81	610	495	-115
0001	3T	124	4273	415	427300	339090	-88210	0.10	0.79	756	600	-156
0001	3T	125	1887	142	188700	149690	-39010	0.08	0.79	333	264	-69
0001	3T	126	1570	103	157000	138630	-18370	0.07	0.88	277	245	-32
0001	3T	132	105	10	10500	8050	-2450	0.10	0.77	18	14	-4
0001	3T	134	1271	143	127100	114550	-12550	0.11	0.90	224	202	-22
0001	3T	135	1113	87	111300	77910	-33390	0.08	0.70	196	137	-59
0001	3T	136	1014	66	101400	98740	-2660	0.07	0.97	179	174	-5
0001	3T	142	38	5	3800	4760	960	0.13	1.25	6	8	2
0001	3T	143	13	1	1300	670	-630	0.08	0.52	2	1	-1
0001	3T	145	380	23	38000	28820	-9180	0.06	0.76	67	51	-16
0001	3T	146	336	18	33600	21050	-12550	0.05	0.63	59	37	-22
0001	3T	153	2	0	200	0	-200	0.00	0.00	0	0	0
0001	3T	154	4	0	400	0	-400	0.00	0.00	0	0	0
0001	3T	156	115	5	11500	8950	-2550	0.04	0.78	20	15	-5
0001	3T	162	5	0	500	0	-500	0.00	0.00	0	0	0
0001	3T	163	4	1	400	2180	1780	0.25	5.45	0	3	3
0001	3T	164	8	1	800	1260	460	0.13	1.58	1	2	1
0001	3T	165	12	0	1200	0	-1200	0.00	0.00	2	0	-2
0001	3T	214	2	0	200	0	-200	0.00	0.00	0	0	0
0001	3T	216	6	0	600	0	-600	0.00	0.00	1	0	-1
0001	3T	234	15	0	1500	0	-1500	0.00	0.00	2	0	-2
0001	3T	235	12	0	1200	0	-1200	0.00	0.00	2	0	-2
0001	3T	236	11	1	1100	590	-510	0.09	0.54	1	1	0
0001	3T	245	6	1	600	850	250	0.17	1.42	1	1	0
0001	3T	246	6	1	600	1190	590	0.17	1.98	1	2	1
0001	3T	253	1	0	100	0	-100	0.00	0.00	0	0	0
0001	3T	256	14	1	1400	730	-670	0.07	0.52	2	1	-1
0001	3T	263	1	0	100	0	-100	0.00	0.00	0	0	0
0001	3T	264	2	0	200	0	-200	0.00	0.00	0	0	0
0001	3T	265	2	0	200	0	-200	0.00	0.00	0	0	0
0008	1T	1	64318	37654	6431800	5923680	-508120	0.59	0.92	11383	10484	-899
0008	1T	2	6631	2462	663100	583710	-79390	0.37	0.88	1173	1033	-140
0008	2F	12	37243	12159	3724300	3155240	-569060	0.33	0.85	6591	5584	-1007
0008	2F	13	14459	4496	1445900	1145380	-300520	0.31	0.79	2559	2027	-532
0008	2F	14	7474	2136	747400	590820	-156580	0.29	0.79	1322	1045	-277
0008	2F	15	2229	500	222900	188230	-34670	0.22	0.84	394	333	-61
0008	2F	16	1340	281	134000	124590	-9410	0.21	0.93	237	220	-17
0008	2F	23	588	134	58800	51500	-7300	0.23	0.88	104	91	-13
0008	2F	24	263	49	26300	17720	-8580	0.19	0.67	46	31	-15
0008	2F	25	245	34	24500	14860	-9640	0.14	0.61	43	26	-17
0008	2F	26	249	45	24900	18810	-6090	0.18	0.76	44	33	-11
0008	2T	12	37182	9120	3718200	3035220	-682980	0.25	0.82	6580	5372	-1208
0008	2T	13	14459	3256	1445900	1112590	-333310	0.23	0.77	2559	1969	-590
0008	2T	14	7474	1540	747400	582280	-165120	0.21	0.78	1322	1030	-292
0008	2T	15	2229	364	222900	200380	-22520	0.16	0.90	394	354	-40
0008	2T	16	1340	210	134000	132490	-1510	0.16	0.99	237	234	-3
0008	2T	21	61	7	6100	6690	590	0.11	1.10	10	11	1
0008	2T	23	588	81	58800	52660	-6140	0.14	0.90	104	93	-11
0008	2T	24	263	25	26300	14850	-11450	0.10	0.56	46	26	-20
0008	2T	25	245	21	24500	13970	-10530	0.09	0.57	43	24	-19
0008	2T	26	249	27	24900	17750	-7150	0.11	0.71	44	31	-13
0008	3F	123	7166	2012	716600	590100	-126500	0.28	0.82	1268	1044	-224
0008	3F	124	17440	3409	1744000	1295460	-448540	0.20	0.74	3086	2292	-794
0008	3F	125	5492	1012	549200	451810	-97390	0.18	0.82	972	799	-173
0008	3F	126	6004	887	600400	552420	-47980	0.15	0.92	1062	977	-85
0008	3F	134	4882	1075	488200	380990	-107210	0.22	0.78	864	674	-190
0008	3F	135	3401	660	340100	253950	-86150	0.19	0.75	601	449	-152
0008	3F	136	3061	485	306100	232290	-73810	0.16	0.76	541	411	-130
0008	3F	145	1546	266	154600	114380	-40220	0.17	0.74	273	202	-71
0008	3F	146	1064	160	106400	77630	-28770	0.15	0.73	188	137	-51
0008	3F	156	333	68	33300	34990	1690	0.20	1.05	58	61	3
0008	3F	234	223	38	22300	16290	-6010	0.17	0.73	39	28	-11
0008	3F	235	121	20	12100	6810	-5290	0.17	0.56	21	12	-9
0008	3F	236	132	24	13200	14230	1030	0.18	1.08	23	25	2
0008	3F	245	58	4	5800	1160	-4640	0.07	0.20	10	2	-8
0008	3F	246	46	6	4600	3760	-840	0.13	0.82	8	6	-2
0008	3F	256	40	3	4000	980	-3020	0.08	0.25	7	1	-6
0008	3T	123	7020	864	702000	578840	-123160	0.12	0.82	1242	1024	-218
0008	3T	124	17320	1445	1732000	1306650	-425350	0.08	0.75	3065	2312	-753
0008	3T	125	5449	398	544900	455830	-89070	0.07	0.84	964	806	-158
0008	3T	126	5979	351	597900	532210	-65690	0.06	0.89	1058	941	-117
0008	3T	132	138	12	13800	7620	-6180	0.09	0.55	24	13	-11
0008	3T	134	4662	447	466200	380920	-85280	0.10	0.82	825	674	-151
0008	3T	135	3341	276	334100	260460	-73640	0.08	0.78	591	460	-131
0008	3T	136	3043	215	304300	254190	-50110	0.07	0.84	538	449	-89
0008	3T	142	106	4	10600	3920	-6680	0.04	0.37	18	6	-12
0008	3T	143	220	11	22000	9850	-12150	0.05	0.45	38	17	-21
0008	3T	145	1475	95	147500	115330	-32170	0.06	0.78	261	204	-57
0008	3T	146	1031	58	103100	70620	-32480	0.06	0.68	182	124	-58
0008	3T	152	38	3	3800	3350	-450	0.08	0.88	6	5	-1
0008	3T	153	60	3	6000	2880	-3120	0.05	0.48	10	5	-5
0008	3T	154	71	1	7100	1330	-5770	0.01	0.19	12	2	-10
0008	3T	156	327	21	32700	37870	5170	0.06	1.16	57	67	10
0008	3T	162	2	0	200	0	-200	0.00	0.00	0	0	0
0008	3T	163	18	1	1800	1420	-380	0.06	0.79	3	2	-1
0008	3T	164	33	0	3300	0	-3300	0.00	0.00	5	0	-5
0008	3T	165	6	0	600	0	-600	0.00	0.00	1	0	-1
0008	3T	213	8	0	800	0	-800	0.00	0.00	1	0	-1
0008	3T	214	14	1	1400	890	-510	0.07	0.64	2	1	-1
0008	3T	215	5	0	500	0	-500	0.00	0.00	0	0	0
0008	3T	216	23	3	2300	13400	11100	0.13	5.83	4	23	19
0008	3T	234	219	10	21900	13540	-8360	0.05	0.62	38	23	-15
0008	3T	235	109	5	10900	3270	-7630	0.05	0.30	19	5	-14
0008	3T	236	129	8	12900	15270	2370	0.06	1.18	22	27	5
0008	3T	243	4	0	400	0	-400	0.00	0.00	0	0	0
0008	3T	245	49	1	4900	1420	-3480	0.02	0.29	8	2	-6
0008	3T	246	45	0	4500	0	-4500	0.00	0.00	7	0	-7
0008	3T	253	12	0	1200	0	-1200	0.00	0.00	2	0	-2
0008	3T	254	9	0	900	0	-900	0.00	0.00	1	0	-1
0008	3T	256	37	1	3700	730	-2970	0.03	0.20	6	1	-5
0008	3T	263	3	0	300	0	-300	0.00	0.00	0	0	0
0008	3T	264	1	0	100	0	-100	0.00	0.00	0	0	0
0008	3T	265	3	0	300	0	-300	0.00	0.00	0	0	0
0002	1T	1	62436	36957	6243600	5737110	-506490	0.59	0.92	11050	10154	-896
0002	1T	2	7917	2876	791700	704560	-87140	0.36	0.89	1401	1247	-154
0002	2F	12	35594	11687	3559400	3025610	-533790	0.33	0.85	6299	5355	-944
0002	2F	13	14760	4615	1476000	1189940	-286060	0.31	0.81	2612	2106	-506
0002	2F	14	7713	2170	771300	603560	-167740	0.28	0.78	1365	1068	-297
0002	2F	15	2757	543	275700	217130	-58570	0.20	0.79	487	384	-103
0002	2F	16	1456	283	145600	137410	-8190	0.19	0.94	257	243	-14
0002	2F	23	272	70	27200	23820	-3380	0.26	0.88	48	42	-6
0002	2F	24	407	78	40700	29010	-11690	0.19	0.71	72	51	-21
0002	2F	25	582	75	58200	34480	-23720	0.13	0.59	103	61	-42
0002	2F	26	531	85	53100	45270	-7830	0.16	0.85	93	80	-13
0002	2T	12	33882	8621	3388200	2767760	-620440	0.25	0.82	5996	4898	-1098
0002	2T	13	14760	3416	1476000	1165960	-310040	0.23	0.79	2612	2063	-549
0002	2T	14	7713	1592	771300	611050	-160250	0.21	0.79	1365	1081	-284
0002	2T	15	2757	380	275700	214400	-61300	0.14	0.78	487	379	-108
0002	2T	16	1456	203	145600	152570	6970	0.14	1.05	257	270	13
0002	2T	21	1712	182	171200	162770	-8430	0.11	0.95	303	288	-15
0002	2T	23	272	41	27200	22290	-4910	0.15	0.82	48	39	-9
0002	2T	24	407	41	40700	24340	-16360	0.10	0.60	72	43	-29
0002	2T	25	582	44	58200	29720	-28480	0.08	0.51	103	52	-51
0002	2T	26	531	51	53100	42000	-11100	0.10	0.79	93	74	-19
0002	3F	123	7683	1948	768300	618100	-150200	0.25	0.80	1359	1093	-266
0002	3F	124	13822	2885	1382200	1025500	-356700	0.21	0.74	2446	1815	-631
0002	3F	125	7213	1144	721300	550360	-170940	0.16	0.76	1276	974	-302
0002	3F	126	6616	895	661600	546530	-115070	0.14	0.83	1170	967	-203
0002	3F	134	4560	1036	456000	361720	-94280	0.23	0.79	807	640	-167
0002	3F	135	3866	699	386600	280450	-106150	0.18	0.73	684	496	-188
0002	3F	136	3889	570	388900	311420	-77480	0.15	0.80	688	551	-137
0002	3F	145	1935	356	193500	159270	-34230	0.18	0.82	342	281	-61
0002	3F	146	1335	190	133500	116340	-17160	0.14	0.87	236	205	-31
0002	3F	156	698	93	69800	58350	-11450	0.13	0.84	123	103	-20
0002	3F	234	62	12	6200	4720	-1480	0.19	0.76	10	8	-2
0002	3F	235	78	13	7800	4730	-3070	0.17	0.61	13	8	-5
0002	3F	236	96	8	9600	5250	-4350	0.08	0.55	16	9	-7
0002	3F	245	101	10	10100	4660	-5440	0.10	0.46	17	8	-9
0002	3F	246	108	12	10800	8710	-2090	0.11	0.81	19	15	-4
0002	3F	256	170	20	17000	13430	-3570	0.12	0.79	30	23	-7
0002	3T	123	7483	854	748300	622360	-125940	0.11	0.83	1324	1101	-223
0002	3T	124	13449	1200	1344900	984000	-360900	0.09	0.73	2380	1741	-639
0002	3T	125	6778	502	677800	578130	-99670	0.07	0.85	1199	1023	-176
0002	3T	126	5681	351	568100	510880	-57220	0.06	0.90	1005	904	-101
0002	3T	132	141	14	14100	12000	-2100	0.10	0.85	24	21	-3
0002	3T	134	4274	440	427400	359400	-68000	0.10	0.84	756	636	-120
0002	3T	135	3797	295	379700	273510	-106190	0.08	0.72	672	484	-188
0002	3T	136	3861	248	386100	320250	-65850	0.06	0.83	683	566	-117
0002	3T	142	98	10	9800	8780	-1020	0.10	0.90	17	15	-2
0002	3T	143	286	19	28600	26720	-1880	0.07	0.93	50	47	-3
0002	3T	145	1928	117	192800	157900	-34900	0.06	0.82	341	279	-62
0002	3T	146	1310	82	131000	119180	-11820	0.06	0.91	231	210	-21
0002	3T	152	11	1	1100	880	-220	0.09	0.80	1	1	0
0002	3T	153	69	3	6900	7390	490	0.04	1.07	12	13	1
0002	3T	154	7	0	700	0	-700	0.00	0.00	1	0	-1
0002	3T	156	642	32	64200	50000	-14200	0.05	0.78	113	88	-25
0002	3T	162	9	1	900	3000	2100	0.11	3.33	1	5	4
0002	3T	163	28	0	2800	0	-2800	0.00	0.00	4	0	-4
0002	3T	164	25	2	2500	3240	740	0.08	1.30	4	5	1
0002	3T	165	56	2	5600	4360	-1240	0.04	0.78	9	7	-2
0002	3T	213	58	5	5800	6490	690	0.09	1.12	10	11	1
0002	3T	214	272	12	27200	23370	-3830	0.04	0.86	48	41	-7
0002	3T	215	420	11	42000	27610	-14390	0.03	0.66	74	48	-26
0002	3T	216	926	36	92600	119460	26860	0.04	1.29	163	211	48
0002	3T	231	1	0	100	0	-100	0.00	0.00	0	0	0
0002	3T	234	62	4	6200	4880	-1320	0.06	0.79	10	8	-2
0002	3T	235	71	4	7100	2930	-4170	0.06	0.41	12	5	-7
0002	3T	236	96	2	9600	2880	-6720	0.02	0.30	16	5	-11
0002	3T	241	3	0	300	0	-300	0.00	0.00	0	0	0
0002	3T	245	100	2	10000	2320	-7680	0.02	0.23	17	4	-13
0002	3T	246	106	7	10600	8640	-1960	0.07	0.82	18	15	-3
0002	3T	251	4	0	400	0	-400	0.00	0.00	0	0	0
0002	3T	253	7	0	700	0	-700	0.00	0.00	1	0	-1
0002	3T	254	1	0	100	0	-100	0.00	0.00	0	0	0
0002	3T	256	164	5	16400	9910	-6490	0.03	0.60	29	17	-12
0002	3T	264	2	0	200	0	-200	0.00	0.00	0	0	0
0002	3T	265	6	1	600	4810	4210	0.17	8.02	1	8	7
0013	1T	1	61738	36075	6173800	5754100	-419700	0.58	0.93	10927	10184	-743
0013	1T	2	6952	2254	695200	667720	-27480	0.32	0.96	1230	1181	-49
0013	2F	12	26941	8276	2694100	2333330	-360770	0.31	0.87	4768	4129	-639
0013	2F	13	14421	3608	1442100	1198460	-243640	0.25	0.83	2552	2121	-431
0013	2F	14	9157	1965	915700	772620	-143080	0.21	0.84	1620	1367	-253
0013	2F	15	3363	501	336300	283170	-53130	0.15	0.84	595	501	-94
0013	2F	16	1898	259	189800	185690	-4110	0.14	0.98	335	328	-7
0013	2F	23	1402	205	140200	128840	-11360	0.15	0.92	248	228	-20
0013	2F	24	787	119	78700	84340	5640	0.15	1.07	139	149	10
0013	2F	25	574	72	57400	55510	-1890	0.13	0.97	101	98	-3
0013	2F	26	436	46	43600	29360	-14240	0.11	0.67	77	51	-26
0013	2T	12	24949	5851	2494900	2092660	-402240	0.23	0.84	4415	3703	-712
0013	2T	13	14421	2762	1442100	1177270	-264830	0.19	0.82	2552	2083	-469
0013	2T	14	9157	1506	915700	776400	-139300	0.16	0.85	1620	1374	-246
0013	2T	15	3363	375	336300	287980	-48320	0.11	0.86	595	509	-86
0013	2T	16	1898	182	189800	192660	2860	0.10	1.02	335	340	5
0013	2T	21	1992	266	199200	201800	2600	0.13	1.01	352	357	5
0013	2T	23	1402	119	140200	124170	-16030	0.08	0.89	248	219	-29
0013	2T	24	787	78	78700	74620	-4080	0.10	0.95	139	132	-7
0013	2T	25	574	45	57400	68490	11090	0.08	1.19	101	121	20
0013	2T	26	436	30	43600	33310	-10290	0.07	0.76	77	58	-19
0013	3F	123	11562	2395	1156200	947440	-208760	0.21	0.82	2046	1676	-370
0013	3F	124	9352	1685	935200	757280	-177920	0.18	0.81	1655	1340	-315
0013	3F	125	5195	639	519500	381510	-137990	0.12	0.73	919	675	-244
0013	3F	126	3819	411	381900	324210	-57690	0.11	0.85	675	573	-102
0013	3F	134	5947	915	594700	501000	-93700	0.15	0.84	1052	886	-166
0013	3F	135	3171	381	317100	261040	-56060	0.12	0.82	561	462	-99
0013	3F	136	2289	253	228900	193030	-35870	0.11	0.84	405	341	-64
0013	3F	145	2010	220	201000	185130	-15870	0.11	0.92	355	327	-28
0013	3F	146	1445	119	144500	122100	-22400	0.08	0.84	255	216	-39
0013	3F	156	695	55	69500	71930	2430	0.08	1.03	123	127	4
0013	3F	234	496	56	49600	35370	-14230	0.11	0.71	87	62	-25
0013	3F	235	395	38	39500	26410	-13090	0.10	0.67	69	46	-23
0013	3F	236	291	18	29100	21470	-7630	0.06	0.74	51	38	-13
0013	3F	245	231	18	23100	14760	-8340	0.08	0.64	40	26	-14
0013	3F	246	184	13	18400	13610	-4790	0.07	0.74	32	24	-8
0013	3F	256	134	8	13400	5080	-8320	0.06	0.38	23	8	-15
0013	3T	123	7372	729	737200	656050	-81150	0.10	0.89	1304	1161	-143
0013	3T	124	6539	518	653900	569710	-84190	0.08	0.87	1157	1008	-149
0013	3T	125	3996	224	399600	308220	-91380	0.06	0.77	707	545	-162
0013	3T	126	2981	139	298100	244970	-53130	0.05	0.82	527	433	-94
0013	3T	132	3553	248	355300	341630	-13670	0.07	0.96	628	604	-24
0013	3T	134	3668	249	366800	313020	-53780	0.07	0.85	649	554	-95
0013	3T	135	2377	106	237700	157290	-80410	0.04	0.66	420	278	-142
0013	3T	136	1831	89	183100	141930	-41170	0.05	0.78	324	251	-73
0013	3T	142	2288	154	228800	195170	-33630	0.07	0.85	404	345	-59
0013	3T	143	2279	113	227900	210600	-17300	0.05	0.92	403	372	-31
0013	3T	145	1397	56	139700	90340	-49360	0.04	0.65	247	159	-88
0013	3T	146	1122	43	112200	113300	1100	0.04	1.01	198	200	2
0013	3T	152	753	20	75300	38810	-36490	0.03	0.52	133	68	-65
0013	3T	153	794	31	79400	73030	-6370	0.04	0.92	140	129	-11
0013	3T	154	613	17	61300	81820	20520	0.03	1.33	108	144	36
0013	3T	156	494	23	49400	84790	35390	0.05	1.72	87	150	63
0013	3T	162	415	15	41500	40320	-1180	0.04	0.97	73	71	-2
0013	3T	163	458	19	45800	40050	-5750	0.04	0.87	81	70	-11
0013	3T	164	323	7	32300	49740	17440	0.02	1.54	57	88	31
0013	3T	165	201	3	20100	31850	11750	0.01	1.58	35	56	21
0013	3T	213	473	24	47300	44440	-2860	0.05	0.94	83	78	-5
0013	3T	214	427	19	42700	51960	9260	0.04	1.22	75	91	16
0013	3T	215	362	13	36200	28370	-7830	0.04	0.78	64	50	-14
0013	3T	216	340	15	34000	54350	20350	0.04	1.60	60	96	36
0013	3T	231	164	5	16400	11500	-4900	0.03	0.70	29	20	-9
0013	3T	234	307	12	30700	21650	-9050	0.04	0.71	54	38	-16
0013	3T	235	258	8	25800	19240	-6560	0.03	0.75	45	34	-11
0013	3T	236	207	3	20700	6570	-14130	0.01	0.32	36	11	-25
0013	3T	241	98	1	9800	3630	-6170	0.01	0.37	17	6	-11
0013	3T	243	189	4	18900	9280	-9620	0.02	0.49	33	16	-17
0013	3T	245	138	2	13800	4570	-9230	0.01	0.33	24	8	-16
0013	3T	246	107	2	10700	8090	-2610	0.02	0.76	18	14	-4
0013	3T	251	84	2	8400	7980	-420	0.02	0.95	14	14	0
0013	3T	253	137	2	13700	6210	-7490	0.01	0.45	24	10	-14
0013	3T	254	93	1	9300	3200	-6100	0.01	0.34	16	5	-11
0013	3T	256	85	3	8500	4750	-3750	0.04	0.56	15	8	-7
0013	3T	261	83	0	8300	0	-8300	0.00	0.00	14	0	-14
0013	3T	263	84	1	8400	2150	-6250	0.01	0.26	14	3	-11
0013	3T	264	77	1	7700	7970	270	0.01	1.04	13	14	1
0013	3T	265	49	1	4900	1820	-3080	0.02	0.37	8	3	-5
0018	1T	1	63227	37386	6322700	5836140	-486560	0.59	0.92	11190	10329	-861
0018	1T	2	7846	2923	784600	711130	-73470	0.37	0.91	1388	1258	-130
0018	2F	12	35218	11713	3521800	2984140	-537660	0.33	0.85	6233	5281	-952
0018	2F	13	14654	4643	1465400	1178690	-286710	0.32	0.80	2593	2086	-507
0018	2F	14	8150	2335	815000	633120	-181880	0.29	0.78	1442	1120	-322
0018	2F	15	2271	512	227100	183200	-43900	0.23	0.81	401	324	-77
0018	2F	16	1454	297	145400	126160	-19240	0.20	0.87	257	223	-34
0018	2F	23	520	115	52000	43680	-8320	0.22	0.84	92	77	-15
0018	2F	24	457	75	45700	32450	-13250	0.16	0.71	80	57	-23
0018	2F	25	278	40	27800	20210	-7590	0.14	0.73	49	35	-14
0018	2F	26	421	60	42100	28420	-13680	0.14	0.68	74	50	-24
0018	2T	12	34693	8816	3469300	2824720	-644580	0.25	0.81	6140	4999	-1141
0018	2T	13	14654	3319	1465400	1132260	-333140	0.23	0.77	2593	2004	-589
0018	2T	14	8150	1690	815000	634310	-180690	0.21	0.78	1442	1122	-320
0018	2T	15	2271	359	227100	178480	-48620	0.16	0.79	401	315	-86
0018	2T	16	1454	215	145400	134510	-10890	0.15	0.93	257	238	-19
0018	2T	21	525	59	52500	50470	-2030	0.11	0.96	92	89	-3
0018	2T	23	520	63	52000	42910	-9090	0.12	0.83	92	75	-17
0018	2T	24	457	48	45700	30360	-15340	0.11	0.66	80	53	-27
0018	2T	25	278	23	27800	22450	-5350	0.08	0.81	49	39	-10
0018	2T	26	421	30	42100	22250	-19850	0.07	0.53	74	39	-35
0018	3F	123	8456	2223	845600	701440	-144160	0.26	0.83	1496	1241	-255
0018	3F	124	12970	2772	1297000	966730	-330270	0.21	0.75	2295	1711	-584
0018	3F	125	7312	1291	731200	586030	-145170	0.18	0.80	1294	1037	-257
0018	3F	126	4804	722	480400	413580	-66820	0.15	0.86	850	732	-118
0018	3F	134	4723	1057	472300	359570	-112730	0.22	0.76	835	636	-199
0018	3F	135	3662	647	366200	242610	-123590	0.18	0.66	648	429	-219
0018	3F	136	2540	368	254000	181690	-72310	0.14	0.72	449	321	-128
0018	3F	145	1661	286	166100	120800	-45300	0.17	0.73	293	213	-80
0018	3F	146	1052	161	105200	103490	-1710	0.15	0.98	186	183	-3
0018	3F	156	389	59	38900	37040	-1860	0.15	0.95	68	65	-3
0018	3F	234	128	25	12800	9890	-2910	0.20	0.77	22	17	-5
0018	3F	235	152	26	15200	9650	-5550	0.17	0.63	26	17	-9
0018	3F	236	145	23	14500	11500	-3000	0.16	0.79	25	20	-5
0018	3F	245	123	18	12300	7620	-4680	0.15	0.62	21	13	-8
0018	3F	246	109	14	10900	6810	-4090	0.13	0.62	19	12	-7
0018	3F	256	51	4	5100	1290	-3810	0.08	0.25	9	2	-7
0018	3T	123	8343	1007	834300	724050	-110250	0.12	0.87	1476	1281	-195
0018	3T	124	12816	1174	1281600	960250	-321350	0.09	0.75	2268	1699	-569
0018	3T	125	7090	521	709000	559270	-149730	0.07	0.79	1254	989	-265
0018	3T	126	4598	289	459800	432950	-26850	0.06	0.94	813	766	-47
0018	3T	132	99	8	9900	6300	-3600	0.08	0.64	17	11	-6
0018	3T	134	4389	414	438900	348380	-90520	0.09	0.79	776	616	-160
0018	3T	135	3595	263	359500	240540	-118960	0.07	0.67	636	425	-211
0018	3T	136	2529	152	252900	206100	-46800	0.06	0.81	447	364	-83
0018	3T	142	47	3	4700	3230	-1470	0.06	0.69	8	5	-3
0018	3T	143	334	18	33400	25690	-7710	0.05	0.77	59	45	-14
0018	3T	145	1606	95	160600	106560	-54040	0.06	0.66	284	188	-96
0018	3T	146	1000	62	100000	109050	9050	0.06	1.09	176	193	17
0018	3T	152	25	0	2500	0	-2500	0.00	0.00	4	0	-4
0018	3T	153	67	6	6700	6390	-310	0.09	0.95	11	11	0
0018	3T	154	55	7	5500	10160	4660	0.13	1.85	9	17	8
0018	3T	156	376	15	37600	26160	-11440	0.04	0.70	66	46	-20
0018	3T	162	2	0	200	0	-200	0.00	0.00	0	0	0
0018	3T	163	11	0	1100	0	-1100	0.00	0.00	1	0	-1
0018	3T	164	52	2	5200	3610	-1590	0.04	0.69	9	6	-3
0018	3T	165	13	2	1300	7800	6500	0.15	6.00	2	13	11
0018	3T	213	14	1	1400	4260	2860	0.07	3.04	2	7	5
0018	3T	214	107	4	10700	7390	-3310	0.04	0.69	18	13	-5
0018	3T	215	197	6	19700	17780	-1920	0.03	0.90	34	31	-3
0018	3T	216	204	7	20400	21350	950	0.03	1.05	36	37	1
0018	3T	234	108	7	10800	11920	1120	0.06	1.10	19	21	2
0018	3T	235	150	9	15000	15350	350	0.06	1.02	26	27	1
0018	3T	236	145	9	14500	10700	-3800	0.06	0.74	25	18	-7
0018	3T	243	20	0	2000	0	-2000	0.00	0.00	3	0	-3
0018	3T	245	123	5	12300	6270	-6030	0.04	0.51	21	11	-10
0018	3T	246	101	3	10100	5510	-4590	0.03	0.55	17	9	-8
0018	3T	253	2	0	200	0	-200	0.00	0.00	0	0	0
0018	3T	256	49	1	4900	1450	-3450	0.02	0.30	8	2	-6
0018	3T	264	8	1	800	900	100	0.13	1.13	1	1	0
0018	3T	265	2	0	200	0	-200	0.00	0.00	0	0	0
0009	1T	1	63023	37223	6302300	5807420	-494880	0.59	0.92	11154	10278	-876
0009	1T	2	8189	2974	818900	734410	-84490	0.36	0.90	1449	1299	-150
0009	2F	12	31796	10743	3179600	2684390	-495210	0.34	0.84	5627	4751	-876
0009	2F	13	16730	5122	1673000	1336810	-336190	0.31	0.80	2961	2366	-595
0009	2F	14	8948	2508	894800	703410	-191390	0.28	0.79	1583	1244	-339
0009	2F	15	2098	481	209800	179270	-30530	0.23	0.85	371	317	-54
0009	2F	16	1553	319	155300	147330	-7970	0.21	0.95	274	260	-14
0009	2F	23	841	185	84100	73100	-11000	0.22	0.87	148	129	-19
0009	2F	24	464	90	46400	38820	-7580	0.19	0.84	82	68	-14
0009	2F	25	270	30	27000	13330	-13670	0.11	0.49	47	23	-24
0009	2F	26	314	50	31400	22240	-9160	0.16	0.71	55	39	-16
0009	2T	12	31612	8126	3161200	2593720	-567480	0.26	0.82	5595	4590	-1005
0009	2T	13	16730	3749	1673000	1297390	-375610	0.22	0.78	2961	2296	-665
0009	2T	14	8948	1838	894800	711930	-182870	0.21	0.80	1583	1260	-323
0009	2T	15	2098	349	209800	185060	-24740	0.17	0.88	371	327	-44
0009	2T	16	1553	232	155300	158430	3130	0.15	1.02	274	280	6
0009	2T	21	184	20	18400	17460	-940	0.11	0.95	32	30	-2
0009	2T	23	841	100	84100	59700	-24400	0.12	0.71	148	105	-43
0009	2T	24	464	48	46400	36720	-9680	0.10	0.79	82	64	-18
0009	2T	25	270	21	27000	16800	-10200	0.08	0.62	47	29	-18
0009	2T	26	314	27	31400	20300	-11100	0.09	0.65	55	35	-20
0009	3F	123	5186	1521	518600	432770	-85830	0.29	0.83	917	765	-152
0009	3F	124	11358	2492	1135800	855950	-279850	0.22	0.75	2010	1514	-496
0009	3F	125	6445	1159	644500	502680	-141820	0.18	0.78	1140	889	-251
0009	3F	126	7626	996	762600	680720	-81880	0.13	0.89	1349	1204	-145
0009	3F	134	5016	1099	501600	387540	-114060	0.22	0.77	887	685	-202
0009	3F	135	3889	699	388900	281250	-107650	0.18	0.72	688	497	-191
0009	3F	136	4203	563	420300	321930	-98370	0.13	0.77	743	569	-174
0009	3F	145	1832	311	183200	130890	-52310	0.17	0.71	324	231	-93
0009	3F	146	1383	188	138300	111630	-26670	0.14	0.81	244	197	-47
0009	3F	156	293	51	29300	24350	-4950	0.17	0.83	51	43	-8
0009	3F	234	170	26	17000	8950	-8050	0.15	0.53	30	15	-15
0009	3F	235	236	45	23600	21680	-1920	0.19	0.92	41	38	-3
0009	3F	236	262	34	26200	22890	-3310	0.13	0.87	46	40	-6
0009	3F	245	124	13	12400	4570	-7830	0.10	0.37	21	8	-13
0009	3F	246	94	9	9400	11800	2400	0.10	1.26	16	20	4
0009	3F	256	36	5	3600	2930	-670	0.14	0.81	6	5	-1
0009	3T	123	5136	681	513600	439270	-74330	0.13	0.86	909	777	-132
0009	3T	124	11286	1069	1128600	866660	-261940	0.09	0.77	1997	1533	-464
0009	3T	125	6388	486	638800	516530	-122270	0.08	0.81	1130	914	-216
0009	3T	126	7542	429	754200	695000	-59200	0.06	0.92	1334	1230	-104
0009	3T	132	42	3	4200	1740	-2460	0.07	0.41	7	3	-4
0009	3T	134	4921	480	492100	412330	-79770	0.10	0.84	870	729	-141
0009	3T	135	3838	287	383800	292160	-91640	0.07	0.76	679	517	-162
0009	3T	136	4192	249	419200	338450	-80750	0.06	0.81	741	599	-142
0009	3T	142	22	0	2200	0	-2200	0.00	0.00	3	0	-3
0009	3T	143	95	7	9500	8490	-1010	0.07	0.89	16	15	-1
0009	3T	145	1779	106	177900	122090	-55810	0.06	0.69	314	216	-98
0009	3T	146	1340	72	134000	102410	-31590	0.05	0.76	237	181	-56
0009	3T	152	18	0	1800	0	-1800	0.00	0.00	3	0	-3
0009	3T	153	51	3	5100	3520	-1580	0.06	0.69	9	6	-3
0009	3T	154	53	6	5300	10110	4810	0.11	1.91	9	17	8
0009	3T	156	287	19	28700	32080	3380	0.07	1.12	50	56	6
0009	3T	163	11	0	1100	0	-1100	0.00	0.00	1	0	-1
0009	3T	164	43	1	4300	1260	-3040	0.02	0.29	7	2	-5
0009	3T	165	6	1	600	3550	2950	0.17	5.92	1	6	5
0009	3T	213	8	1	800	2190	1390	0.13	2.74	1	3	2
0009	3T	214	50	1	5000	890	-4110	0.02	0.18	8	1	-7
0009	3T	215	39	0	3900	0	-3900	0.00	0.00	6	0	-6
0009	3T	216	84	3	8400	22710	14310	0.04	2.70	14	40	26
0009	3T	234	168	5	16800	6120	-10680	0.03	0.36	29	10	-19
0009	3T	235	232	12	23200	22100	-1100	0.05	0.95	41	39	-2
0009	3T	236	260	12	26000	22900	-3100	0.05	0.88	46	40	-6
0009	3T	243	2	0	200	0	-200	0.00	0.00	0	0	0
0009	3T	245	123	4	12300	5890	-6410	0.03	0.48	21	10	-11
0009	3T	246	94	3	9400	37160	27760	0.03	3.95	16	65	49
0009	3T	253	4	1	400	1100	700	0.25	2.75	0	1	1
0009	3T	254	1	0	100	0	-100	0.00	0.00	0	0	0
0009	3T	256	36	0	3600	0	-3600	0.00	0.00	6	0	-6
0009	3T	263	2	0	200	0	-200	0.00	0.00	0	0	0
0003	1T	1	64293	37127	6429300	5975460	-453840	0.58	0.93	11379	10576	-803
0003	1T	2	6222	2053	622200	602750	-19450	0.33	0.97	1101	1066	-35
0003	2F	12	27173	8333	2717300	2356420	-360880	0.31	0.87	4809	4170	-639
0003	2F	13	15757	4034	1575700	1345680	-230020	0.26	0.85	2788	2381	-407
0003	2F	14	9381	2030	938100	756890	-181210	0.22	0.81	1660	1339	-321
0003	2F	15	3590	547	359000	319210	-39790	0.15	0.89	635	564	-71
0003	2F	16	1823	265	182300	164880	-17420	0.15	0.90	322	291	-31
0003	2F	23	1189	169	118900	100950	-17950	0.14	0.85	210	178	-32
0003	2F	24	669	110	66900	56200	-10700	0.16	0.84	118	99	-19
0003	2F	25	474	47	47400	33890	-13510	0.10	0.71	83	59	-24
0003	2F	26	343	46	34300	28260	-6040	0.13	0.82	60	50	-10
0003	2T	12	25196	5877	2519600	2094290	-425310	0.23	0.83	4459	3706	-753
0003	2T	13	15757	3096	1575700	1322510	-253190	0.20	0.84	2788	2340	-448
0003	2T	14	9381	1526	938100	743410	-194690	0.16	0.79	1660	1315	-345
0003	2T	15	3590	402	359000	313650	-45350	0.11	0.87	635	555	-80
0003	2T	16	1823	190	182300	162750	-19550	0.10	0.89	322	288	-34
0003	2T	21	1977	259	197700	196420	-1280	0.13	0.99	349	347	-2
0003	2T	23	1189	100	118900	111170	-7730	0.08	0.93	210	196	-14
0003	2T	24	669	73	66900	63180	-3720	0.11	0.94	118	111	-7
0003	2T	25	474	31	47400	38460	-8940	0.07	0.81	83	68	-15
0003	2T	26	343	30	34300	29680	-4620	0.09	0.87	60	52	-8
0003	3F	123	11670	2449	1167000	960490	-206510	0.21	0.82	2065	1699	-366
0003	3F	124	9405	1685	940500	729180	-211320	0.18	0.78	1664	1290	-374
0003	3F	125	5400	717	540000	447360	-92640	0.13	0.83	955	791	-164
0003	3F	126	4028	448	402800	370800	-32000	0.11	0.92	712	656	-56
0003	3F	134	6301	1034	630100	522570	-107530	0.16	0.83	1115	924	-191
0003	3F	135	3407	405	340700	237180	-103520	0.12	0.70	603	419	-184
0003	3F	136	2606	279	260600	191490	-69110	0.11	0.73	461	338	-123
0003	3F	145	2096	208	209600	156380	-53220	0.10	0.75	370	276	-94
0003	3F	146	1443	139	144300	112890	-31410	0.10	0.78	255	199	-56
0003	3F	156	732	58	73200	62720	-10480	0.08	0.86	129	111	-18
0003	3F	234	407	56	40700	41210	510	0.14	1.01	72	72	0
0003	3F	235	282	28	28200	28420	220	0.10	1.01	49	50	1
0003	3F	236	296	28	29600	27450	-2150	0.09	0.93	52	48	-4
0003	3F	245	171	13	17100	10480	-6620	0.08	0.61	30	18	-12
0003	3F	246	140	12	14000	16210	2210	0.09	1.16	24	28	4
0003	3F	256	114	7	11400	6170	-5230	0.06	0.54	20	10	-10
0003	3T	123	7289	689	728900	613850	-115050	0.09	0.84	1290	1086	-204
0003	3T	124	6551	498	655100	506060	-149040	0.08	0.77	1159	895	-264
0003	3T	125	4154	252	415400	361560	-53840	0.06	0.87	735	639	-96
0003	3T	126	3192	126	319200	253930	-65270	0.04	0.80	564	449	-115
0003	3T	132	3758	279	375800	338620	-37180	0.07	0.90	665	599	-66
0003	3T	134	3993	312	399300	408580	9280	0.08	1.02	706	723	17
0003	3T	135	2566	139	256600	186900	-69700	0.05	0.73	454	330	-124
0003	3T	136	2165	110	216500	176140	-40360	0.05	0.81	383	311	-72
0003	3T	142	2340	148	234000	206140	-27860	0.06	0.88	414	364	-50
0003	3T	143	2308	118	230800	168000	-62800	0.05	0.73	408	297	-111
0003	3T	145	1473	50	147300	75880	-71420	0.03	0.52	260	134	-126
0003	3T	146	1140	48	114000	98040	-15960	0.04	0.86	201	173	-28
0003	3T	152	829	33	82900	55490	-27410	0.04	0.67	146	98	-48
0003	3T	153	841	28	84100	50160	-33940	0.03	0.60	148	88	-60
0003	3T	154	623	17	62300	49070	-13230	0.03	0.79	110	86	-24
0003	3T	156	545	17	54500	56250	1750	0.03	1.03	96	99	3
0003	3T	162	439	21	43900	47160	3260	0.05	1.07	77	83	6
0003	3T	163	441	12	44100	22530	-21570	0.03	0.51	78	39	-39
0003	3T	164	303	11	30300	20150	-10150	0.04	0.67	53	35	-18
0003	3T	165	187	2	18700	5100	-13600	0.01	0.27	33	9	-24
0003	3T	213	481	29	48100	51870	3770	0.06	1.08	85	91	6
0003	3T	214	414	24	41400	48560	7160	0.06	1.17	73	85	12
0003	3T	215	346	11	34600	23920	-10680	0.03	0.69	61	42	-19
0003	3T	216	340	12	34000	35370	1370	0.04	1.04	60	62	2
0003	3T	231	142	2	14200	3830	-10370	0.01	0.27	25	6	-19
0003	3T	234	244	5	24400	5720	-18680	0.02	0.23	43	10	-33
0003	3T	235	205	4	20500	6630	-13870	0.02	0.32	36	11	-25
0003	3T	236	217	3	21700	9590	-12110	0.01	0.44	38	16	-22
0003	3T	241	100	4	10000	7700	-2300	0.04	0.77	17	13	-4
0003	3T	243	163	10	16300	73980	57680	0.06	4.54	28	130	102
0003	3T	245	84	0	8400	0	-8400	0.00	0.00	14	0	-14
0003	3T	246	96	4	9600	22670	13070	0.04	2.36	16	40	24
0003	3T	251	71	1	7100	1040	-6060	0.01	0.15	12	1	-11
0003	3T	253	77	5	7700	8000	300	0.06	1.04	13	14	1
0003	3T	254	87	0	8700	0	-8700	0.00	0.00	15	0	-15
0003	3T	256	71	0	7100	0	-7100	0.00	0.00	12	0	-12
0003	3T	261	57	4	5700	18900	13200	0.07	3.32	10	33	23
0003	3T	263	79	3	7900	4050	-3850	0.04	0.51	13	7	-6
0003	3T	264	44	0	4400	0	-4400	0.00	0.00	7	0	-7
0003	3T	265	43	0	4300	0	-4300	0.00	0.00	7	0	-7
